Link KawalPemilu,Nama Kelurahan,Nomor TPS,Suara 01,Suara 02,Suara Sah
https://kawalpemilu.org#22331,"FAJARESUK, PRINGSEWU, PRINGSEWU, LAMPUNG",1,137,100,237
https://kawalpemilu.org#22331,"FAJARESUK, PRINGSEWU, PRINGSEWU, LAMPUNG",2,120,57,177
https://kawalpemilu.org#22331,"FAJARESUK, PRINGSEWU, PRINGSEWU, LAMPUNG",3,80,46,126
https://kawalpemilu.org#22331,"FAJARESUK, PRINGSEWU, PRINGSEWU, LAMPUNG",4,138,97,235
https://kawalpemilu.org#22331,"FAJARESUK, PRINGSEWU, PRINGSEWU, LAMPUNG",5,145,73,218
https://kawalpemilu.org#22331,"FAJARESUK, PRINGSEWU, PRINGSEWU, LAMPUNG",6,170,66,236
https://kawalpemilu.org#22331,"FAJARESUK, PRINGSEWU, PRINGSEWU, LAMPUNG",7,105,41,146
https://kawalpemilu.org#22331,"FAJARESUK, PRINGSEWU, PRINGSEWU, LAMPUNG",8,62,68,130
https://kawalpemilu.org#22331,"FAJARESUK, PRINGSEWU, PRINGSEWU, LAMPUNG",9,86,27,113
https://kawalpemilu.org#22331,"FAJARESUK, PRINGSEWU, PRINGSEWU, LAMPUNG",10,70,60,130
https://kawalpemilu.org#22331,"FAJARESUK, PRINGSEWU, PRINGSEWU, LAMPUNG",11,80,67,147
https://kawalpemilu.org#22331,"FAJARESUK, PRINGSEWU, PRINGSEWU, LAMPUNG",12,81,101,182
https://kawalpemilu.org#22331,"FAJARESUK, PRINGSEWU, PRINGSEWU, LAMPUNG",13,62,143,205
https://kawalpemilu.org#22331,"FAJARESUK, PRINGSEWU, PRINGSEWU, LAMPUNG",14,116,100,216
https://kawalpemilu.org#22331,"FAJARESUK, PRINGSEWU, PRINGSEWU, LAMPUNG",15,85,69,154
https://kawalpemilu.org#22331,"FAJARESUK, PRINGSEWU, PRINGSEWU, LAMPUNG",16,93,63,156
https://kawalpemilu.org#22331,"FAJARESUK, PRINGSEWU, PRINGSEWU, LAMPUNG",17,109,18,127
https://kawalpemilu.org#22331,"FAJARESUK, PRINGSEWU, PRINGSEWU, LAMPUNG",18,87,76,163
https://kawalpemilu.org#22331,"FAJARESUK, PRINGSEWU, PRINGSEWU, LAMPUNG",19,89,39,128
https://kawalpemilu.org#22331,"FAJARESUK, PRINGSEWU, PRINGSEWU, LAMPUNG",20,103,74,177
https://kawalpemilu.org#22331,"FAJARESUK, PRINGSEWU, PRINGSEWU, LAMPUNG",21,62,45,107
https://kawalpemilu.org#22331,"FAJARESUK, PRINGSEWU, PRINGSEWU, LAMPUNG",22,67,61,128
https://kawalpemilu.org#22331,"FAJARESUK, PRINGSEWU, PRINGSEWU, LAMPUNG",23,126,27,153
https://kawalpemilu.org#22331,"FAJARESUK, PRINGSEWU, PRINGSEWU, LAMPUNG",24,86,49,135
https://kawalpemilu.org#22331,"FAJARESUK, PRINGSEWU, PRINGSEWU, LAMPUNG",25,127,70,197
https://kawalpemilu.org#22331,"FAJARESUK, PRINGSEWU, PRINGSEWU, LAMPUNG",26,124,31,155
https://kawalpemilu.org#22331,"FAJARESUK, PRINGSEWU, PRINGSEWU, LAMPUNG",27,105,33,138
https://kawalpemilu.org#22331,"FAJARESUK, PRINGSEWU, PRINGSEWU, LAMPUNG",28,103,38,141
https://kawalpemilu.org#22332,"PRINGSEWU UTARA, PRINGSEWU, PRINGSEWU, LAMPUNG",1,83,47,130
https://kawalpemilu.org#22332,"PRINGSEWU UTARA, PRINGSEWU, PRINGSEWU, LAMPUNG",2,88,41,129
https://kawalpemilu.org#22332,"PRINGSEWU UTARA, PRINGSEWU, PRINGSEWU, LAMPUNG",3,66,56,122
https://kawalpemilu.org#22332,"PRINGSEWU UTARA, PRINGSEWU, PRINGSEWU, LAMPUNG",4,106,68,174
https://kawalpemilu.org#22332,"PRINGSEWU UTARA, PRINGSEWU, PRINGSEWU, LAMPUNG",5,46,70,116
https://kawalpemilu.org#22332,"PRINGSEWU UTARA, PRINGSEWU, PRINGSEWU, LAMPUNG",6,108,98,206
https://kawalpemilu.org#22332,"PRINGSEWU UTARA, PRINGSEWU, PRINGSEWU, LAMPUNG",7,103,124,227
https://kawalpemilu.org#22332,"PRINGSEWU UTARA, PRINGSEWU, PRINGSEWU, LAMPUNG",8,89,68,157
https://kawalpemilu.org#22332,"PRINGSEWU UTARA, PRINGSEWU, PRINGSEWU, LAMPUNG",9,121,70,191
https://kawalpemilu.org#22332,"PRINGSEWU UTARA, PRINGSEWU, PRINGSEWU, LAMPUNG",10,90,58,148
https://kawalpemilu.org#22332,"PRINGSEWU UTARA, PRINGSEWU, PRINGSEWU, LAMPUNG",11,113,110,223
https://kawalpemilu.org#22332,"PRINGSEWU UTARA, PRINGSEWU, PRINGSEWU, LAMPUNG",12,81,102,183
https://kawalpemilu.org#22332,"PRINGSEWU UTARA, PRINGSEWU, PRINGSEWU, LAMPUNG",13,112,41,153
https://kawalpemilu.org#22332,"PRINGSEWU UTARA, PRINGSEWU, PRINGSEWU, LAMPUNG",14,115,82,197
https://kawalpemilu.org#22332,"PRINGSEWU UTARA, PRINGSEWU, PRINGSEWU, LAMPUNG",15,72,74,146
https://kawalpemilu.org#22332,"PRINGSEWU UTARA, PRINGSEWU, PRINGSEWU, LAMPUNG",16,141,40,181
https://kawalpemilu.org#22332,"PRINGSEWU UTARA, PRINGSEWU, PRINGSEWU, LAMPUNG",17,67,53,120
https://kawalpemilu.org#22332,"PRINGSEWU UTARA, PRINGSEWU, PRINGSEWU, LAMPUNG",18,122,45,167
https://kawalpemilu.org#22332,"PRINGSEWU UTARA, PRINGSEWU, PRINGSEWU, LAMPUNG",19,149,32,181
https://kawalpemilu.org#22332,"PRINGSEWU UTARA, PRINGSEWU, PRINGSEWU, LAMPUNG",20,73,50,123
https://kawalpemilu.org#22332,"PRINGSEWU UTARA, PRINGSEWU, PRINGSEWU, LAMPUNG",21,70,88,158
https://kawalpemilu.org#22332,"PRINGSEWU UTARA, PRINGSEWU, PRINGSEWU, LAMPUNG",22,96,70,166
https://kawalpemilu.org#22332,"PRINGSEWU UTARA, PRINGSEWU, PRINGSEWU, LAMPUNG",23,51,65,116
https://kawalpemilu.org#22332,"PRINGSEWU UTARA, PRINGSEWU, PRINGSEWU, LAMPUNG",24,89,120,209
https://kawalpemilu.org#22332,"PRINGSEWU UTARA, PRINGSEWU, PRINGSEWU, LAMPUNG",25,81,54,135
https://kawalpemilu.org#22332,"PRINGSEWU UTARA, PRINGSEWU, PRINGSEWU, LAMPUNG",26,109,56,165
https://kawalpemilu.org#22332,"PRINGSEWU UTARA, PRINGSEWU, PRINGSEWU, LAMPUNG",27,76,60,136
https://kawalpemilu.org#22332,"PRINGSEWU UTARA, PRINGSEWU, PRINGSEWU, LAMPUNG",28,53,65,118
https://kawalpemilu.org#22332,"PRINGSEWU UTARA, PRINGSEWU, PRINGSEWU, LAMPUNG",29,82,67,149
https://kawalpemilu.org#22332,"PRINGSEWU UTARA, PRINGSEWU, PRINGSEWU, LAMPUNG",30,96,88,184
https://kawalpemilu.org#22332,"PRINGSEWU UTARA, PRINGSEWU, PRINGSEWU, LAMPUNG",31,79,76,155
https://kawalpemilu.org#22332,"PRINGSEWU UTARA, PRINGSEWU, PRINGSEWU, LAMPUNG",32,113,50,163
https://kawalpemilu.org#22332,"PRINGSEWU UTARA, PRINGSEWU, PRINGSEWU, LAMPUNG",33,73,62,135
https://kawalpemilu.org#22332,"PRINGSEWU UTARA, PRINGSEWU, PRINGSEWU, LAMPUNG",34,111,30,141
https://kawalpemilu.org#22333,"PRINGSEWU SELATAN, PRINGSEWU, PRINGSEWU, LAMPUNG",1,87,116,203
https://kawalpemilu.org#22333,"PRINGSEWU SELATAN, PRINGSEWU, PRINGSEWU, LAMPUNG",2,50,75,125
https://kawalpemilu.org#22333,"PRINGSEWU SELATAN, PRINGSEWU, PRINGSEWU, LAMPUNG",3,52,48,100
https://kawalpemilu.org#22333,"PRINGSEWU SELATAN, PRINGSEWU, PRINGSEWU, LAMPUNG",4,68,85,153
https://kawalpemilu.org#22333,"PRINGSEWU SELATAN, PRINGSEWU, PRINGSEWU, LAMPUNG",5,75,52,127
https://kawalpemilu.org#22333,"PRINGSEWU SELATAN, PRINGSEWU, PRINGSEWU, LAMPUNG",6,65,49,114
https://kawalpemilu.org#22333,"PRINGSEWU SELATAN, PRINGSEWU, PRINGSEWU, LAMPUNG",7,77,78,155
https://kawalpemilu.org#22333,"PRINGSEWU SELATAN, PRINGSEWU, PRINGSEWU, LAMPUNG",8,108,90,198
https://kawalpemilu.org#22333,"PRINGSEWU SELATAN, PRINGSEWU, PRINGSEWU, LAMPUNG",9,67,57,124
https://kawalpemilu.org#22333,"PRINGSEWU SELATAN, PRINGSEWU, PRINGSEWU, LAMPUNG",10,79,80,159
https://kawalpemilu.org#22333,"PRINGSEWU SELATAN, PRINGSEWU, PRINGSEWU, LAMPUNG",11,54,79,133
https://kawalpemilu.org#22333,"PRINGSEWU SELATAN, PRINGSEWU, PRINGSEWU, LAMPUNG",12,42,84,126
https://kawalpemilu.org#22333,"PRINGSEWU SELATAN, PRINGSEWU, PRINGSEWU, LAMPUNG",13,74,28,102
https://kawalpemilu.org#22333,"PRINGSEWU SELATAN, PRINGSEWU, PRINGSEWU, LAMPUNG",14,93,70,163
https://kawalpemilu.org#22333,"PRINGSEWU SELATAN, PRINGSEWU, PRINGSEWU, LAMPUNG",15,78,55,133
https://kawalpemilu.org#22333,"PRINGSEWU SELATAN, PRINGSEWU, PRINGSEWU, LAMPUNG",16,130,76,206
https://kawalpemilu.org#22333,"PRINGSEWU SELATAN, PRINGSEWU, PRINGSEWU, LAMPUNG",17,140,69,209
https://kawalpemilu.org#22333,"PRINGSEWU SELATAN, PRINGSEWU, PRINGSEWU, LAMPUNG",18,69,59,128
https://kawalpemilu.org#22333,"PRINGSEWU SELATAN, PRINGSEWU, PRINGSEWU, LAMPUNG",19,111,65,176
https://kawalpemilu.org#22333,"PRINGSEWU SELATAN, PRINGSEWU, PRINGSEWU, LAMPUNG",20,89,59,148
https://kawalpemilu.org#22333,"PRINGSEWU SELATAN, PRINGSEWU, PRINGSEWU, LAMPUNG",21,113,67,180
https://kawalpemilu.org#22333,"PRINGSEWU SELATAN, PRINGSEWU, PRINGSEWU, LAMPUNG",22,42,125,167
https://kawalpemilu.org#22333,"PRINGSEWU SELATAN, PRINGSEWU, PRINGSEWU, LAMPUNG",23,50,41,91
https://kawalpemilu.org#22333,"PRINGSEWU SELATAN, PRINGSEWU, PRINGSEWU, LAMPUNG",24,61,85,146
https://kawalpemilu.org#22333,"PRINGSEWU SELATAN, PRINGSEWU, PRINGSEWU, LAMPUNG",25,92,61,153
https://kawalpemilu.org#22333,"PRINGSEWU SELATAN, PRINGSEWU, PRINGSEWU, LAMPUNG",26,87,62,149
https://kawalpemilu.org#22333,"PRINGSEWU SELATAN, PRINGSEWU, PRINGSEWU, LAMPUNG",27,73,63,136
https://kawalpemilu.org#22333,"PRINGSEWU SELATAN, PRINGSEWU, PRINGSEWU, LAMPUNG",28,53,51,104
https://kawalpemilu.org#22333,"PRINGSEWU SELATAN, PRINGSEWU, PRINGSEWU, LAMPUNG",29,90,85,175
https://kawalpemilu.org#22333,"PRINGSEWU SELATAN, PRINGSEWU, PRINGSEWU, LAMPUNG",30,71,50,121
https://kawalpemilu.org#22333,"PRINGSEWU SELATAN, PRINGSEWU, PRINGSEWU, LAMPUNG",31,61,78,139
https://kawalpemilu.org#22333,"PRINGSEWU SELATAN, PRINGSEWU, PRINGSEWU, LAMPUNG",32,62,50,112
https://kawalpemilu.org#22333,"PRINGSEWU SELATAN, PRINGSEWU, PRINGSEWU, LAMPUNG",33,37,73,110
https://kawalpemilu.org#22333,"PRINGSEWU SELATAN, PRINGSEWU, PRINGSEWU, LAMPUNG",34,86,0,86
https://kawalpemilu.org#22333,"PRINGSEWU SELATAN, PRINGSEWU, PRINGSEWU, LAMPUNG",35,106,75,181
https://kawalpemilu.org#22333,"PRINGSEWU SELATAN, PRINGSEWU, PRINGSEWU, LAMPUNG",36,73,52,125
https://kawalpemilu.org#22333,"PRINGSEWU SELATAN, PRINGSEWU, PRINGSEWU, LAMPUNG",37,94,59,153
https://kawalpemilu.org#22333,"PRINGSEWU SELATAN, PRINGSEWU, PRINGSEWU, LAMPUNG",38,78,35,113
https://kawalpemilu.org#22333,"PRINGSEWU SELATAN, PRINGSEWU, PRINGSEWU, LAMPUNG",39,133,71,204
https://kawalpemilu.org#22333,"PRINGSEWU SELATAN, PRINGSEWU, PRINGSEWU, LAMPUNG",40,81,87,168
https://kawalpemilu.org#22334,"PRINGSEWU BARAT, PRINGSEWU, PRINGSEWU, LAMPUNG",1,117,103,220
https://kawalpemilu.org#22334,"PRINGSEWU BARAT, PRINGSEWU, PRINGSEWU, LAMPUNG",2,100,130,230
https://kawalpemilu.org#22334,"PRINGSEWU BARAT, PRINGSEWU, PRINGSEWU, LAMPUNG",3,98,52,150
https://kawalpemilu.org#22334,"PRINGSEWU BARAT, PRINGSEWU, PRINGSEWU, LAMPUNG",4,96,48,144
https://kawalpemilu.org#22334,"PRINGSEWU BARAT, PRINGSEWU, PRINGSEWU, LAMPUNG",5,70,62,132
https://kawalpemilu.org#22334,"PRINGSEWU BARAT, PRINGSEWU, PRINGSEWU, LAMPUNG",6,81,86,167
https://kawalpemilu.org#22334,"PRINGSEWU BARAT, PRINGSEWU, PRINGSEWU, LAMPUNG",7,104,77,181
https://kawalpemilu.org#22334,"PRINGSEWU BARAT, PRINGSEWU, PRINGSEWU, LAMPUNG",8,52,94,146
https://kawalpemilu.org#22334,"PRINGSEWU BARAT, PRINGSEWU, PRINGSEWU, LAMPUNG",9,47,81,128
https://kawalpemilu.org#22334,"PRINGSEWU BARAT, PRINGSEWU, PRINGSEWU, LAMPUNG",10,72,70,142
https://kawalpemilu.org#22334,"PRINGSEWU BARAT, PRINGSEWU, PRINGSEWU, LAMPUNG",11,104,79,183
https://kawalpemilu.org#22334,"PRINGSEWU BARAT, PRINGSEWU, PRINGSEWU, LAMPUNG",12,61,132,193
https://kawalpemilu.org#22334,"PRINGSEWU BARAT, PRINGSEWU, PRINGSEWU, LAMPUNG",13,116,87,203
https://kawalpemilu.org#22334,"PRINGSEWU BARAT, PRINGSEWU, PRINGSEWU, LAMPUNG",14,114,70,184
https://kawalpemilu.org#22334,"PRINGSEWU BARAT, PRINGSEWU, PRINGSEWU, LAMPUNG",15,64,53,117
https://kawalpemilu.org#22334,"PRINGSEWU BARAT, PRINGSEWU, PRINGSEWU, LAMPUNG",16,83,120,203
https://kawalpemilu.org#22334,"PRINGSEWU BARAT, PRINGSEWU, PRINGSEWU, LAMPUNG",17,80,146,226
https://kawalpemilu.org#22334,"PRINGSEWU BARAT, PRINGSEWU, PRINGSEWU, LAMPUNG",18,54,79,133
https://kawalpemilu.org#22334,"PRINGSEWU BARAT, PRINGSEWU, PRINGSEWU, LAMPUNG",19,71,67,138
https://kawalpemilu.org#22334,"PRINGSEWU BARAT, PRINGSEWU, PRINGSEWU, LAMPUNG",20,89,85,174
https://kawalpemilu.org#22334,"PRINGSEWU BARAT, PRINGSEWU, PRINGSEWU, LAMPUNG",21,77,64,141
https://kawalpemilu.org#22334,"PRINGSEWU BARAT, PRINGSEWU, PRINGSEWU, LAMPUNG",22,58,74,132
https://kawalpemilu.org#22334,"PRINGSEWU BARAT, PRINGSEWU, PRINGSEWU, LAMPUNG",23,77,59,136
https://kawalpemilu.org#22334,"PRINGSEWU BARAT, PRINGSEWU, PRINGSEWU, LAMPUNG",24,88,75,163
https://kawalpemilu.org#22334,"PRINGSEWU BARAT, PRINGSEWU, PRINGSEWU, LAMPUNG",25,98,80,178
https://kawalpemilu.org#22334,"PRINGSEWU BARAT, PRINGSEWU, PRINGSEWU, LAMPUNG",26,57,102,159
https://kawalpemilu.org#22334,"PRINGSEWU BARAT, PRINGSEWU, PRINGSEWU, LAMPUNG",27,51,62,113
https://kawalpemilu.org#22334,"PRINGSEWU BARAT, PRINGSEWU, PRINGSEWU, LAMPUNG",28,81,74,155
https://kawalpemilu.org#22334,"PRINGSEWU BARAT, PRINGSEWU, PRINGSEWU, LAMPUNG",29,115,69,184
https://kawalpemilu.org#22334,"PRINGSEWU BARAT, PRINGSEWU, PRINGSEWU, LAMPUNG",30,112,89,201
https://kawalpemilu.org#22334,"PRINGSEWU BARAT, PRINGSEWU, PRINGSEWU, LAMPUNG",31,67,57,124
https://kawalpemilu.org#22334,"PRINGSEWU BARAT, PRINGSEWU, PRINGSEWU, LAMPUNG",32,60,67,127
https://kawalpemilu.org#22334,"PRINGSEWU BARAT, PRINGSEWU, PRINGSEWU, LAMPUNG",33,80,63,143
https://kawalpemilu.org#22334,"PRINGSEWU BARAT, PRINGSEWU, PRINGSEWU, LAMPUNG",34,83,53,136
https://kawalpemilu.org#22335,"PRINGSEWU TIMUR, PRINGSEWU, PRINGSEWU, LAMPUNG",1,145,62,207
https://kawalpemilu.org#22335,"PRINGSEWU TIMUR, PRINGSEWU, PRINGSEWU, LAMPUNG",2,144,62,206
https://kawalpemilu.org#22335,"PRINGSEWU TIMUR, PRINGSEWU, PRINGSEWU, LAMPUNG",3,118,108,226
https://kawalpemilu.org#22335,"PRINGSEWU TIMUR, PRINGSEWU, PRINGSEWU, LAMPUNG",4,134,119,253
https://kawalpemilu.org#22335,"PRINGSEWU TIMUR, PRINGSEWU, PRINGSEWU, LAMPUNG",5,82,68,150
https://kawalpemilu.org#22335,"PRINGSEWU TIMUR, PRINGSEWU, PRINGSEWU, LAMPUNG",6,153,55,208
https://kawalpemilu.org#22335,"PRINGSEWU TIMUR, PRINGSEWU, PRINGSEWU, LAMPUNG",7,103,47,150
https://kawalpemilu.org#22335,"PRINGSEWU TIMUR, PRINGSEWU, PRINGSEWU, LAMPUNG",8,162,79,241
https://kawalpemilu.org#22335,"PRINGSEWU TIMUR, PRINGSEWU, PRINGSEWU, LAMPUNG",9,93,47,140
https://kawalpemilu.org#22335,"PRINGSEWU TIMUR, PRINGSEWU, PRINGSEWU, LAMPUNG",10,141,79,220
https://kawalpemilu.org#22335,"PRINGSEWU TIMUR, PRINGSEWU, PRINGSEWU, LAMPUNG",11,83,35,118
https://kawalpemilu.org#22335,"PRINGSEWU TIMUR, PRINGSEWU, PRINGSEWU, LAMPUNG",12,171,10,181
https://kawalpemilu.org#22335,"PRINGSEWU TIMUR, PRINGSEWU, PRINGSEWU, LAMPUNG",13,116,16,132
https://kawalpemilu.org#22335,"PRINGSEWU TIMUR, PRINGSEWU, PRINGSEWU, LAMPUNG",14,131,47,178
https://kawalpemilu.org#22335,"PRINGSEWU TIMUR, PRINGSEWU, PRINGSEWU, LAMPUNG",15,105,55,160
https://kawalpemilu.org#22335,"PRINGSEWU TIMUR, PRINGSEWU, PRINGSEWU, LAMPUNG",16,154,33,187
https://kawalpemilu.org#22335,"PRINGSEWU TIMUR, PRINGSEWU, PRINGSEWU, LAMPUNG",17,110,20,130
https://kawalpemilu.org#22335,"PRINGSEWU TIMUR, PRINGSEWU, PRINGSEWU, LAMPUNG",18,95,44,139
https://kawalpemilu.org#22335,"PRINGSEWU TIMUR, PRINGSEWU, PRINGSEWU, LAMPUNG",19,92,62,154
https://kawalpemilu.org#22335,"PRINGSEWU TIMUR, PRINGSEWU, PRINGSEWU, LAMPUNG",20,85,55,140
https://kawalpemilu.org#22335,"PRINGSEWU TIMUR, PRINGSEWU, PRINGSEWU, LAMPUNG",21,86,36,122
https://kawalpemilu.org#22335,"PRINGSEWU TIMUR, PRINGSEWU, PRINGSEWU, LAMPUNG",22,147,20,167
https://kawalpemilu.org#22335,"PRINGSEWU TIMUR, PRINGSEWU, PRINGSEWU, LAMPUNG",23,134,15,149
https://kawalpemilu.org#22335,"PRINGSEWU TIMUR, PRINGSEWU, PRINGSEWU, LAMPUNG",24,137,43,180
https://kawalpemilu.org#22335,"PRINGSEWU TIMUR, PRINGSEWU, PRINGSEWU, LAMPUNG",25,94,57,151
https://kawalpemilu.org#22335,"PRINGSEWU TIMUR, PRINGSEWU, PRINGSEWU, LAMPUNG",26,125,28,153
https://kawalpemilu.org#22335,"PRINGSEWU TIMUR, PRINGSEWU, PRINGSEWU, LAMPUNG",27,114,10,124
https://kawalpemilu.org#22336,"MARGAKAYA, PRINGSEWU, PRINGSEWU, LAMPUNG",1,94,82,176
https://kawalpemilu.org#22336,"MARGAKAYA, PRINGSEWU, PRINGSEWU, LAMPUNG",2,134,35,169
https://kawalpemilu.org#22336,"MARGAKAYA, PRINGSEWU, PRINGSEWU, LAMPUNG",3,102,44,146
https://kawalpemilu.org#22336,"MARGAKAYA, PRINGSEWU, PRINGSEWU, LAMPUNG",4,92,123,215
https://kawalpemilu.org#22336,"MARGAKAYA, PRINGSEWU, PRINGSEWU, LAMPUNG",5,96,112,208
https://kawalpemilu.org#22336,"MARGAKAYA, PRINGSEWU, PRINGSEWU, LAMPUNG",6,58,74,132
https://kawalpemilu.org#22336,"MARGAKAYA, PRINGSEWU, PRINGSEWU, LAMPUNG",7,71,48,119
https://kawalpemilu.org#22336,"MARGAKAYA, PRINGSEWU, PRINGSEWU, LAMPUNG",8,123,96,219
https://kawalpemilu.org#22336,"MARGAKAYA, PRINGSEWU, PRINGSEWU, LAMPUNG",9,90,103,193
https://kawalpemilu.org#22336,"MARGAKAYA, PRINGSEWU, PRINGSEWU, LAMPUNG",10,100,41,141
https://kawalpemilu.org#22336,"MARGAKAYA, PRINGSEWU, PRINGSEWU, LAMPUNG",11,139,35,174
https://kawalpemilu.org#22336,"MARGAKAYA, PRINGSEWU, PRINGSEWU, LAMPUNG",12,90,52,142
https://kawalpemilu.org#22336,"MARGAKAYA, PRINGSEWU, PRINGSEWU, LAMPUNG",13,124,93,217
https://kawalpemilu.org#22336,"MARGAKAYA, PRINGSEWU, PRINGSEWU, LAMPUNG",14,66,76,142
https://kawalpemilu.org#22336,"MARGAKAYA, PRINGSEWU, PRINGSEWU, LAMPUNG",15,103,26,129
https://kawalpemilu.org#22337,"WALUYOJATI, PRINGSEWU, PRINGSEWU, LAMPUNG",1,128,41,169
https://kawalpemilu.org#22337,"WALUYOJATI, PRINGSEWU, PRINGSEWU, LAMPUNG",2,146,48,194
https://kawalpemilu.org#22337,"WALUYOJATI, PRINGSEWU, PRINGSEWU, LAMPUNG",3,71,60,131
https://kawalpemilu.org#22337,"WALUYOJATI, PRINGSEWU, PRINGSEWU, LAMPUNG",4,67,48,115
https://kawalpemilu.org#22337,"WALUYOJATI, PRINGSEWU, PRINGSEWU, LAMPUNG",5,140,59,199
https://kawalpemilu.org#22337,"WALUYOJATI, PRINGSEWU, PRINGSEWU, LAMPUNG",6,115,43,158
https://kawalpemilu.org#22337,"WALUYOJATI, PRINGSEWU, PRINGSEWU, LAMPUNG",7,174,66,240
https://kawalpemilu.org#22337,"WALUYOJATI, PRINGSEWU, PRINGSEWU, LAMPUNG",8,131,70,201
https://kawalpemilu.org#22337,"WALUYOJATI, PRINGSEWU, PRINGSEWU, LAMPUNG",9,131,97,228
https://kawalpemilu.org#22337,"WALUYOJATI, PRINGSEWU, PRINGSEWU, LAMPUNG",10,103,64,167
https://kawalpemilu.org#22337,"WALUYOJATI, PRINGSEWU, PRINGSEWU, LAMPUNG",11,105,43,148
https://kawalpemilu.org#22337,"WALUYOJATI, PRINGSEWU, PRINGSEWU, LAMPUNG",12,157,63,220
https://kawalpemilu.org#22337,"WALUYOJATI, PRINGSEWU, PRINGSEWU, LAMPUNG",13,68,59,127
https://kawalpemilu.org#22337,"WALUYOJATI, PRINGSEWU, PRINGSEWU, LAMPUNG",14,73,62,135
https://kawalpemilu.org#22337,"WALUYOJATI, PRINGSEWU, PRINGSEWU, LAMPUNG",15,103,32,135
https://kawalpemilu.org#22337,"WALUYOJATI, PRINGSEWU, PRINGSEWU, LAMPUNG",16,115,76,191
https://kawalpemilu.org#22338,"SIDOHARJO, PRINGSEWU, PRINGSEWU, LAMPUNG",1,129,49,178
https://kawalpemilu.org#22338,"SIDOHARJO, PRINGSEWU, PRINGSEWU, LAMPUNG",2,163,50,213
https://kawalpemilu.org#22338,"SIDOHARJO, PRINGSEWU, PRINGSEWU, LAMPUNG",3,99,47,146
https://kawalpemilu.org#22338,"SIDOHARJO, PRINGSEWU, PRINGSEWU, LAMPUNG",4,94,42,136
https://kawalpemilu.org#22338,"SIDOHARJO, PRINGSEWU, PRINGSEWU, LAMPUNG",5,108,79,187
https://kawalpemilu.org#22338,"SIDOHARJO, PRINGSEWU, PRINGSEWU, LAMPUNG",6,146,36,182
https://kawalpemilu.org#22338,"SIDOHARJO, PRINGSEWU, PRINGSEWU, LAMPUNG",7,114,51,165
https://kawalpemilu.org#22338,"SIDOHARJO, PRINGSEWU, PRINGSEWU, LAMPUNG",8,71,59,130
https://kawalpemilu.org#22338,"SIDOHARJO, PRINGSEWU, PRINGSEWU, LAMPUNG",9,184,37,221
https://kawalpemilu.org#22338,"SIDOHARJO, PRINGSEWU, PRINGSEWU, LAMPUNG",10,98,36,134
https://kawalpemilu.org#22338,"SIDOHARJO, PRINGSEWU, PRINGSEWU, LAMPUNG",11,89,56,145
https://kawalpemilu.org#22338,"SIDOHARJO, PRINGSEWU, PRINGSEWU, LAMPUNG",12,79,47,126
https://kawalpemilu.org#22338,"SIDOHARJO, PRINGSEWU, PRINGSEWU, LAMPUNG",13,133,38,171
https://kawalpemilu.org#22338,"SIDOHARJO, PRINGSEWU, PRINGSEWU, LAMPUNG",14,97,76,173
https://kawalpemilu.org#22338,"SIDOHARJO, PRINGSEWU, PRINGSEWU, LAMPUNG",15,161,73,234
https://kawalpemilu.org#22338,"SIDOHARJO, PRINGSEWU, PRINGSEWU, LAMPUNG",17,75,51,126
https://kawalpemilu.org#22338,"SIDOHARJO, PRINGSEWU, PRINGSEWU, LAMPUNG",18,101,82,183
https://kawalpemilu.org#22338,"SIDOHARJO, PRINGSEWU, PRINGSEWU, LAMPUNG",19,146,46,192
https://kawalpemilu.org#22338,"SIDOHARJO, PRINGSEWU, PRINGSEWU, LAMPUNG",20,110,39,149
https://kawalpemilu.org#22338,"SIDOHARJO, PRINGSEWU, PRINGSEWU, LAMPUNG",21,74,54,128
https://kawalpemilu.org#22338,"SIDOHARJO, PRINGSEWU, PRINGSEWU, LAMPUNG",22,92,49,141
https://kawalpemilu.org#22338,"SIDOHARJO, PRINGSEWU, PRINGSEWU, LAMPUNG",23,90,55,145
https://kawalpemilu.org#22338,"SIDOHARJO, PRINGSEWU, PRINGSEWU, LAMPUNG",24,84,45,129
https://kawalpemilu.org#22339,"PODOMORO, PRINGSEWU, PRINGSEWU, LAMPUNG",1,86,83,169
https://kawalpemilu.org#22339,"PODOMORO, PRINGSEWU, PRINGSEWU, LAMPUNG",2,115,52,167
https://kawalpemilu.org#22339,"PODOMORO, PRINGSEWU, PRINGSEWU, LAMPUNG",3,129,38,167
https://kawalpemilu.org#22339,"PODOMORO, PRINGSEWU, PRINGSEWU, LAMPUNG",4,143,45,188
https://kawalpemilu.org#22339,"PODOMORO, PRINGSEWU, PRINGSEWU, LAMPUNG",5,144,41,185
https://kawalpemilu.org#22339,"PODOMORO, PRINGSEWU, PRINGSEWU, LAMPUNG",6,76,54,130
https://kawalpemilu.org#22339,"PODOMORO, PRINGSEWU, PRINGSEWU, LAMPUNG",7,106,62,168
https://kawalpemilu.org#22339,"PODOMORO, PRINGSEWU, PRINGSEWU, LAMPUNG",8,132,23,155
https://kawalpemilu.org#22339,"PODOMORO, PRINGSEWU, PRINGSEWU, LAMPUNG",9,138,74,212
https://kawalpemilu.org#22339,"PODOMORO, PRINGSEWU, PRINGSEWU, LAMPUNG",10,84,67,151
https://kawalpemilu.org#22339,"PODOMORO, PRINGSEWU, PRINGSEWU, LAMPUNG",11,108,40,148
https://kawalpemilu.org#22339,"PODOMORO, PRINGSEWU, PRINGSEWU, LAMPUNG",12,136,36,172
https://kawalpemilu.org#22339,"PODOMORO, PRINGSEWU, PRINGSEWU, LAMPUNG",13,147,47,194
https://kawalpemilu.org#22339,"PODOMORO, PRINGSEWU, PRINGSEWU, LAMPUNG",14,145,33,178
https://kawalpemilu.org#22339,"PODOMORO, PRINGSEWU, PRINGSEWU, LAMPUNG",15,75,57,132
https://kawalpemilu.org#22339,"PODOMORO, PRINGSEWU, PRINGSEWU, LAMPUNG",16,125,45,170
https://kawalpemilu.org#22339,"PODOMORO, PRINGSEWU, PRINGSEWU, LAMPUNG",17,114,31,145
https://kawalpemilu.org#22339,"PODOMORO, PRINGSEWU, PRINGSEWU, LAMPUNG",18,135,69,204
https://kawalpemilu.org#22340,"BUMI ARUM, PRINGSEWU, PRINGSEWU, LAMPUNG",1,124,30,154
https://kawalpemilu.org#22340,"BUMI ARUM, PRINGSEWU, PRINGSEWU, LAMPUNG",2,99,27,126
https://kawalpemilu.org#22340,"BUMI ARUM, PRINGSEWU, PRINGSEWU, LAMPUNG",3,105,28,133
https://kawalpemilu.org#22340,"BUMI ARUM, PRINGSEWU, PRINGSEWU, LAMPUNG",4,86,79,165
https://kawalpemilu.org#22340,"BUMI ARUM, PRINGSEWU, PRINGSEWU, LAMPUNG",5,90,51,141
https://kawalpemilu.org#22340,"BUMI ARUM, PRINGSEWU, PRINGSEWU, LAMPUNG",6,119,38,157
https://kawalpemilu.org#22340,"BUMI ARUM, PRINGSEWU, PRINGSEWU, LAMPUNG",7,136,49,185
https://kawalpemilu.org#22340,"BUMI ARUM, PRINGSEWU, PRINGSEWU, LAMPUNG",8,116,36,152
https://kawalpemilu.org#22340,"BUMI ARUM, PRINGSEWU, PRINGSEWU, LAMPUNG",9,106,17,123
https://kawalpemilu.org#22340,"BUMI ARUM, PRINGSEWU, PRINGSEWU, LAMPUNG",10,93,50,143
https://kawalpemilu.org#22340,"BUMI ARUM, PRINGSEWU, PRINGSEWU, LAMPUNG",11,59,109,168
https://kawalpemilu.org#22340,"BUMI ARUM, PRINGSEWU, PRINGSEWU, LAMPUNG",12,93,43,136
https://kawalpemilu.org#22340,"BUMI ARUM, PRINGSEWU, PRINGSEWU, LAMPUNG",13,111,38,149
https://kawalpemilu.org#22340,"BUMI ARUM, PRINGSEWU, PRINGSEWU, LAMPUNG",14,121,53,174
https://kawalpemilu.org#22341,"FAJAR AGUNG, PRINGSEWU, PRINGSEWU, LAMPUNG",1,141,13,154
https://kawalpemilu.org#22341,"FAJAR AGUNG, PRINGSEWU, PRINGSEWU, LAMPUNG",2,146,72,218
https://kawalpemilu.org#22341,"FAJAR AGUNG, PRINGSEWU, PRINGSEWU, LAMPUNG",3,97,34,131
https://kawalpemilu.org#22341,"FAJAR AGUNG, PRINGSEWU, PRINGSEWU, LAMPUNG",4,98,56,154
https://kawalpemilu.org#22341,"FAJAR AGUNG, PRINGSEWU, PRINGSEWU, LAMPUNG",5,103,40,143
https://kawalpemilu.org#22341,"FAJAR AGUNG, PRINGSEWU, PRINGSEWU, LAMPUNG",6,111,47,158
https://kawalpemilu.org#22341,"FAJAR AGUNG, PRINGSEWU, PRINGSEWU, LAMPUNG",7,117,33,150
https://kawalpemilu.org#22341,"FAJAR AGUNG, PRINGSEWU, PRINGSEWU, LAMPUNG",8,101,36,137
https://kawalpemilu.org#22341,"FAJAR AGUNG, PRINGSEWU, PRINGSEWU, LAMPUNG",9,72,70,142
https://kawalpemilu.org#22341,"FAJAR AGUNG, PRINGSEWU, PRINGSEWU, LAMPUNG",10,122,29,151
https://kawalpemilu.org#22341,"FAJAR AGUNG, PRINGSEWU, PRINGSEWU, LAMPUNG",11,110,32,142
https://kawalpemilu.org#22342,"REJO SARI, PRINGSEWU, PRINGSEWU, LAMPUNG",1,94,76,170
https://kawalpemilu.org#22342,"REJO SARI, PRINGSEWU, PRINGSEWU, LAMPUNG",2,107,82,189
https://kawalpemilu.org#22342,"REJO SARI, PRINGSEWU, PRINGSEWU, LAMPUNG",3,94,68,162
https://kawalpemilu.org#22342,"REJO SARI, PRINGSEWU, PRINGSEWU, LAMPUNG",4,116,20,136
https://kawalpemilu.org#22342,"REJO SARI, PRINGSEWU, PRINGSEWU, LAMPUNG",5,99,42,141
https://kawalpemilu.org#22342,"REJO SARI, PRINGSEWU, PRINGSEWU, LAMPUNG",6,95,60,155
https://kawalpemilu.org#22342,"REJO SARI, PRINGSEWU, PRINGSEWU, LAMPUNG",7,77,41,118
https://kawalpemilu.org#22342,"REJO SARI, PRINGSEWU, PRINGSEWU, LAMPUNG",8,62,61,123
https://kawalpemilu.org#22342,"REJO SARI, PRINGSEWU, PRINGSEWU, LAMPUNG",9,100,61,161
https://kawalpemilu.org#22342,"REJO SARI, PRINGSEWU, PRINGSEWU, LAMPUNG",10,130,61,191
https://kawalpemilu.org#22342,"REJO SARI, PRINGSEWU, PRINGSEWU, LAMPUNG",11,131,44,175
https://kawalpemilu.org#22342,"REJO SARI, PRINGSEWU, PRINGSEWU, LAMPUNG",12,99,41,140
https://kawalpemilu.org#22342,"REJO SARI, PRINGSEWU, PRINGSEWU, LAMPUNG",13,107,38,145
https://kawalpemilu.org#22342,"REJO SARI, PRINGSEWU, PRINGSEWU, LAMPUNG",14,98,67,165
https://kawalpemilu.org#22342,"REJO SARI, PRINGSEWU, PRINGSEWU, LAMPUNG",15,52,58,110
https://kawalpemilu.org#22342,"REJO SARI, PRINGSEWU, PRINGSEWU, LAMPUNG",16,79,40,119
https://kawalpemilu.org#22343,"BUMI AYU, PRINGSEWU, PRINGSEWU, LAMPUNG",1,78,47,125
https://kawalpemilu.org#22343,"BUMI AYU, PRINGSEWU, PRINGSEWU, LAMPUNG",2,78,49,127
https://kawalpemilu.org#22343,"BUMI AYU, PRINGSEWU, PRINGSEWU, LAMPUNG",3,103,24,127
https://kawalpemilu.org#22343,"BUMI AYU, PRINGSEWU, PRINGSEWU, LAMPUNG",4,96,35,131
https://kawalpemilu.org#22343,"BUMI AYU, PRINGSEWU, PRINGSEWU, LAMPUNG",5,77,58,135
https://kawalpemilu.org#22343,"BUMI AYU, PRINGSEWU, PRINGSEWU, LAMPUNG",6,39,94,133
https://kawalpemilu.org#22343,"BUMI AYU, PRINGSEWU, PRINGSEWU, LAMPUNG",7,77,48,125
https://kawalpemilu.org#22343,"BUMI AYU, PRINGSEWU, PRINGSEWU, LAMPUNG",8,77,50,127
https://kawalpemilu.org#87996,"PODOSARI, PRINGSEWU, PRINGSEWU, LAMPUNG",1,106,72,178
https://kawalpemilu.org#87996,"PODOSARI, PRINGSEWU, PRINGSEWU, LAMPUNG",2,82,50,132
https://kawalpemilu.org#87996,"PODOSARI, PRINGSEWU, PRINGSEWU, LAMPUNG",3,114,43,157
https://kawalpemilu.org#87996,"PODOSARI, PRINGSEWU, PRINGSEWU, LAMPUNG",4,129,69,198
https://kawalpemilu.org#87996,"PODOSARI, PRINGSEWU, PRINGSEWU, LAMPUNG",5,161,49,210
https://kawalpemilu.org#87996,"PODOSARI, PRINGSEWU, PRINGSEWU, LAMPUNG",6,119,49,168
https://kawalpemilu.org#87996,"PODOSARI, PRINGSEWU, PRINGSEWU, LAMPUNG",7,64,103,167
https://kawalpemilu.org#87996,"PODOSARI, PRINGSEWU, PRINGSEWU, LAMPUNG",8,52,115,167
https://kawalpemilu.org#87996,"PODOSARI, PRINGSEWU, PRINGSEWU, LAMPUNG",9,131,51,182
https://kawalpemilu.org#87996,"PODOSARI, PRINGSEWU, PRINGSEWU, LAMPUNG",10,89,39,128
https://kawalpemilu.org#87996,"PODOSARI, PRINGSEWU, PRINGSEWU, LAMPUNG",11,106,29,135
https://kawalpemilu.org#87996,"PODOSARI, PRINGSEWU, PRINGSEWU, LAMPUNG",12,115,57,172
https://kawalpemilu.org#87996,"PODOSARI, PRINGSEWU, PRINGSEWU, LAMPUNG",13,145,41,186
https://kawalpemilu.org#87996,"PODOSARI, PRINGSEWU, PRINGSEWU, LAMPUNG",14,119,66,185
https://kawalpemilu.org#87996,"PODOSARI, PRINGSEWU, PRINGSEWU, LAMPUNG",15,47,82,129
https://kawalpemilu.org#87996,"PODOSARI, PRINGSEWU, PRINGSEWU, LAMPUNG",16,45,132,177
https://kawalpemilu.org#87997,"FAJAR AGUNG BARAT, PRINGSEWU, PRINGSEWU, LAMPUNG",1,133,28,161
https://kawalpemilu.org#87997,"FAJAR AGUNG BARAT, PRINGSEWU, PRINGSEWU, LAMPUNG",2,148,36,184
https://kawalpemilu.org#87997,"FAJAR AGUNG BARAT, PRINGSEWU, PRINGSEWU, LAMPUNG",3,87,47,134
https://kawalpemilu.org#87997,"FAJAR AGUNG BARAT, PRINGSEWU, PRINGSEWU, LAMPUNG",4,93,53,146
https://kawalpemilu.org#87997,"FAJAR AGUNG BARAT, PRINGSEWU, PRINGSEWU, LAMPUNG",5,80,74,154
https://kawalpemilu.org#87997,"FAJAR AGUNG BARAT, PRINGSEWU, PRINGSEWU, LAMPUNG",6,115,33,148
https://kawalpemilu.org#87997,"FAJAR AGUNG BARAT, PRINGSEWU, PRINGSEWU, LAMPUNG",7,95,29,124
https://kawalpemilu.org#87997,"FAJAR AGUNG BARAT, PRINGSEWU, PRINGSEWU, LAMPUNG",8,138,43,181
https://kawalpemilu.org#87997,"FAJAR AGUNG BARAT, PRINGSEWU, PRINGSEWU, LAMPUNG",9,87,29,116
https://kawalpemilu.org#87997,"FAJAR AGUNG BARAT, PRINGSEWU, PRINGSEWU, LAMPUNG",10,70,82,152
https://kawalpemilu.org#87997,"FAJAR AGUNG BARAT, PRINGSEWU, PRINGSEWU, LAMPUNG",11,82,63,145
https://kawalpemilu.org#22345,"PAREREJO, GADING REJO, PRINGSEWU, LAMPUNG",1,58,137,195
https://kawalpemilu.org#22345,"PAREREJO, GADING REJO, PRINGSEWU, LAMPUNG",2,74,44,118
https://kawalpemilu.org#22345,"PAREREJO, GADING REJO, PRINGSEWU, LAMPUNG",3,50,72,122
https://kawalpemilu.org#22345,"PAREREJO, GADING REJO, PRINGSEWU, LAMPUNG",4,125,77,202
https://kawalpemilu.org#22345,"PAREREJO, GADING REJO, PRINGSEWU, LAMPUNG",5,123,66,189
https://kawalpemilu.org#22345,"PAREREJO, GADING REJO, PRINGSEWU, LAMPUNG",6,129,45,174
https://kawalpemilu.org#22345,"PAREREJO, GADING REJO, PRINGSEWU, LAMPUNG",7,97,39,136
https://kawalpemilu.org#22345,"PAREREJO, GADING REJO, PRINGSEWU, LAMPUNG",8,89,54,143
https://kawalpemilu.org#22345,"PAREREJO, GADING REJO, PRINGSEWU, LAMPUNG",9,74,51,0
https://kawalpemilu.org#22345,"PAREREJO, GADING REJO, PRINGSEWU, LAMPUNG",10,75,60,135
https://kawalpemilu.org#22345,"PAREREJO, GADING REJO, PRINGSEWU, LAMPUNG",11,69,45,114
https://kawalpemilu.org#22345,"PAREREJO, GADING REJO, PRINGSEWU, LAMPUNG",12,58,74,132
https://kawalpemilu.org#22345,"PAREREJO, GADING REJO, PRINGSEWU, LAMPUNG",13,140,83,223
https://kawalpemilu.org#22345,"PAREREJO, GADING REJO, PRINGSEWU, LAMPUNG",14,82,107,189
https://kawalpemilu.org#22345,"PAREREJO, GADING REJO, PRINGSEWU, LAMPUNG",15,114,60,174
https://kawalpemilu.org#22345,"PAREREJO, GADING REJO, PRINGSEWU, LAMPUNG",16,75,48,123
https://kawalpemilu.org#22345,"PAREREJO, GADING REJO, PRINGSEWU, LAMPUNG",17,98,48,146
https://kawalpemilu.org#22345,"PAREREJO, GADING REJO, PRINGSEWU, LAMPUNG",18,50,70,120
https://kawalpemilu.org#22345,"PAREREJO, GADING REJO, PRINGSEWU, LAMPUNG",19,66,73,139
https://kawalpemilu.org#22346,"BLITAREJO, GADING REJO, PRINGSEWU, LAMPUNG",1,77,69,146
https://kawalpemilu.org#22346,"BLITAREJO, GADING REJO, PRINGSEWU, LAMPUNG",2,99,102,201
https://kawalpemilu.org#22346,"BLITAREJO, GADING REJO, PRINGSEWU, LAMPUNG",3,119,50,169
https://kawalpemilu.org#22346,"BLITAREJO, GADING REJO, PRINGSEWU, LAMPUNG",4,92,55,147
https://kawalpemilu.org#22346,"BLITAREJO, GADING REJO, PRINGSEWU, LAMPUNG",5,90,62,152
https://kawalpemilu.org#22346,"BLITAREJO, GADING REJO, PRINGSEWU, LAMPUNG",6,113,38,151
https://kawalpemilu.org#22346,"BLITAREJO, GADING REJO, PRINGSEWU, LAMPUNG",7,124,34,158
https://kawalpemilu.org#22346,"BLITAREJO, GADING REJO, PRINGSEWU, LAMPUNG",8,158,39,197
https://kawalpemilu.org#22346,"BLITAREJO, GADING REJO, PRINGSEWU, LAMPUNG",9,98,60,158
https://kawalpemilu.org#22346,"BLITAREJO, GADING REJO, PRINGSEWU, LAMPUNG",10,74,78,152
https://kawalpemilu.org#22346,"BLITAREJO, GADING REJO, PRINGSEWU, LAMPUNG",11,100,47,147
https://kawalpemilu.org#22346,"BLITAREJO, GADING REJO, PRINGSEWU, LAMPUNG",12,117,41,158
https://kawalpemilu.org#22347,"PANJEREJO, GADING REJO, PRINGSEWU, LAMPUNG",1,146,23,169
https://kawalpemilu.org#22347,"PANJEREJO, GADING REJO, PRINGSEWU, LAMPUNG",2,133,31,164
https://kawalpemilu.org#22347,"PANJEREJO, GADING REJO, PRINGSEWU, LAMPUNG",3,100,54,154
https://kawalpemilu.org#22347,"PANJEREJO, GADING REJO, PRINGSEWU, LAMPUNG",4,130,39,169
https://kawalpemilu.org#22347,"PANJEREJO, GADING REJO, PRINGSEWU, LAMPUNG",5,82,44,126
https://kawalpemilu.org#22347,"PANJEREJO, GADING REJO, PRINGSEWU, LAMPUNG",6,124,45,169
https://kawalpemilu.org#22347,"PANJEREJO, GADING REJO, PRINGSEWU, LAMPUNG",7,109,49,158
https://kawalpemilu.org#22347,"PANJEREJO, GADING REJO, PRINGSEWU, LAMPUNG",8,75,69,144
https://kawalpemilu.org#22347,"PANJEREJO, GADING REJO, PRINGSEWU, LAMPUNG",9,125,46,171
https://kawalpemilu.org#22347,"PANJEREJO, GADING REJO, PRINGSEWU, LAMPUNG",10,82,60,142
https://kawalpemilu.org#22348,"BULOKARTO, GADING REJO, PRINGSEWU, LAMPUNG",1,157,43,200
https://kawalpemilu.org#22348,"BULOKARTO, GADING REJO, PRINGSEWU, LAMPUNG",2,119,47,166
https://kawalpemilu.org#22348,"BULOKARTO, GADING REJO, PRINGSEWU, LAMPUNG",3,108,39,147
https://kawalpemilu.org#22348,"BULOKARTO, GADING REJO, PRINGSEWU, LAMPUNG",4,85,52,137
https://kawalpemilu.org#22348,"BULOKARTO, GADING REJO, PRINGSEWU, LAMPUNG",5,87,65,152
https://kawalpemilu.org#22348,"BULOKARTO, GADING REJO, PRINGSEWU, LAMPUNG",6,100,134,234
https://kawalpemilu.org#22348,"BULOKARTO, GADING REJO, PRINGSEWU, LAMPUNG",7,61,69,130
https://kawalpemilu.org#22348,"BULOKARTO, GADING REJO, PRINGSEWU, LAMPUNG",8,94,62,156
https://kawalpemilu.org#22348,"BULOKARTO, GADING REJO, PRINGSEWU, LAMPUNG",9,154,42,196
https://kawalpemilu.org#22348,"BULOKARTO, GADING REJO, PRINGSEWU, LAMPUNG",10,134,42,176
https://kawalpemilu.org#22348,"BULOKARTO, GADING REJO, PRINGSEWU, LAMPUNG",11,95,53,148
https://kawalpemilu.org#22348,"BULOKARTO, GADING REJO, PRINGSEWU, LAMPUNG",12,66,71,137
https://kawalpemilu.org#22348,"BULOKARTO, GADING REJO, PRINGSEWU, LAMPUNG",13,70,58,128
https://kawalpemilu.org#22348,"BULOKARTO, GADING REJO, PRINGSEWU, LAMPUNG",14,66,56,122
https://kawalpemilu.org#22348,"BULOKARTO, GADING REJO, PRINGSEWU, LAMPUNG",15,55,73,128
https://kawalpemilu.org#22349,"WATES, GADING REJO, PRINGSEWU, LAMPUNG",1,71,76,147
https://kawalpemilu.org#22349,"WATES, GADING REJO, PRINGSEWU, LAMPUNG",2,150,72,222
https://kawalpemilu.org#22349,"WATES, GADING REJO, PRINGSEWU, LAMPUNG",3,93,77,170
https://kawalpemilu.org#22349,"WATES, GADING REJO, PRINGSEWU, LAMPUNG",4,100,94,194
https://kawalpemilu.org#22349,"WATES, GADING REJO, PRINGSEWU, LAMPUNG",5,146,78,224
https://kawalpemilu.org#22349,"WATES, GADING REJO, PRINGSEWU, LAMPUNG",6,106,61,167
https://kawalpemilu.org#22349,"WATES, GADING REJO, PRINGSEWU, LAMPUNG",7,101,78,179
https://kawalpemilu.org#22349,"WATES, GADING REJO, PRINGSEWU, LAMPUNG",8,84,62,146
https://kawalpemilu.org#22350,"TAMBAHREJO, GADING REJO, PRINGSEWU, LAMPUNG",1,117,51,168
https://kawalpemilu.org#22350,"TAMBAHREJO, GADING REJO, PRINGSEWU, LAMPUNG",2,117,32,149
https://kawalpemilu.org#22350,"TAMBAHREJO, GADING REJO, PRINGSEWU, LAMPUNG",3,135,121,256
https://kawalpemilu.org#22350,"TAMBAHREJO, GADING REJO, PRINGSEWU, LAMPUNG",4,83,88,171
https://kawalpemilu.org#22350,"TAMBAHREJO, GADING REJO, PRINGSEWU, LAMPUNG",5,74,86,160
https://kawalpemilu.org#22350,"TAMBAHREJO, GADING REJO, PRINGSEWU, LAMPUNG",6,87,80,167
https://kawalpemilu.org#22350,"TAMBAHREJO, GADING REJO, PRINGSEWU, LAMPUNG",7,125,43,168
https://kawalpemilu.org#22350,"TAMBAHREJO, GADING REJO, PRINGSEWU, LAMPUNG",8,139,72,211
https://kawalpemilu.org#22350,"TAMBAHREJO, GADING REJO, PRINGSEWU, LAMPUNG",9,113,45,158
https://kawalpemilu.org#22350,"TAMBAHREJO, GADING REJO, PRINGSEWU, LAMPUNG",10,103,46,149
https://kawalpemilu.org#22350,"TAMBAHREJO, GADING REJO, PRINGSEWU, LAMPUNG",11,82,59,141
https://kawalpemilu.org#22350,"TAMBAHREJO, GADING REJO, PRINGSEWU, LAMPUNG",12,91,72,163
https://kawalpemilu.org#22350,"TAMBAHREJO, GADING REJO, PRINGSEWU, LAMPUNG",13,79,77,156
https://kawalpemilu.org#22350,"TAMBAHREJO, GADING REJO, PRINGSEWU, LAMPUNG",14,123,57,180
https://kawalpemilu.org#22350,"TAMBAHREJO, GADING REJO, PRINGSEWU, LAMPUNG",15,100,99,199
https://kawalpemilu.org#22351,"WONODADI, GADING REJO, PRINGSEWU, LAMPUNG",1,41,56,97
https://kawalpemilu.org#22351,"WONODADI, GADING REJO, PRINGSEWU, LAMPUNG",2,41,82,123
https://kawalpemilu.org#22351,"WONODADI, GADING REJO, PRINGSEWU, LAMPUNG",3,49,56,105
https://kawalpemilu.org#22351,"WONODADI, GADING REJO, PRINGSEWU, LAMPUNG",4,58,36,94
https://kawalpemilu.org#22351,"WONODADI, GADING REJO, PRINGSEWU, LAMPUNG",5,69,48,117
https://kawalpemilu.org#22351,"WONODADI, GADING REJO, PRINGSEWU, LAMPUNG",6,54,57,111
https://kawalpemilu.org#22351,"WONODADI, GADING REJO, PRINGSEWU, LAMPUNG",7,69,85,154
https://kawalpemilu.org#22351,"WONODADI, GADING REJO, PRINGSEWU, LAMPUNG",8,59,75,134
https://kawalpemilu.org#22351,"WONODADI, GADING REJO, PRINGSEWU, LAMPUNG",9,76,55,131
https://kawalpemilu.org#22351,"WONODADI, GADING REJO, PRINGSEWU, LAMPUNG",10,47,61,108
https://kawalpemilu.org#22351,"WONODADI, GADING REJO, PRINGSEWU, LAMPUNG",11,61,49,110
https://kawalpemilu.org#22351,"WONODADI, GADING REJO, PRINGSEWU, LAMPUNG",12,112,19,131
https://kawalpemilu.org#22351,"WONODADI, GADING REJO, PRINGSEWU, LAMPUNG",13,73,72,145
https://kawalpemilu.org#22351,"WONODADI, GADING REJO, PRINGSEWU, LAMPUNG",14,88,89,177
https://kawalpemilu.org#22351,"WONODADI, GADING REJO, PRINGSEWU, LAMPUNG",15,64,76,140
https://kawalpemilu.org#22351,"WONODADI, GADING REJO, PRINGSEWU, LAMPUNG",16,62,84,146
https://kawalpemilu.org#22351,"WONODADI, GADING REJO, PRINGSEWU, LAMPUNG",17,57,118,175
https://kawalpemilu.org#22351,"WONODADI, GADING REJO, PRINGSEWU, LAMPUNG",19,54,69,123
https://kawalpemilu.org#22351,"WONODADI, GADING REJO, PRINGSEWU, LAMPUNG",20,58,39,97
https://kawalpemilu.org#22351,"WONODADI, GADING REJO, PRINGSEWU, LAMPUNG",21,114,87,201
https://kawalpemilu.org#22351,"WONODADI, GADING REJO, PRINGSEWU, LAMPUNG",22,32,68,100
https://kawalpemilu.org#22351,"WONODADI, GADING REJO, PRINGSEWU, LAMPUNG",23,53,93,146
https://kawalpemilu.org#22351,"WONODADI, GADING REJO, PRINGSEWU, LAMPUNG",24,51,45,96
https://kawalpemilu.org#22351,"WONODADI, GADING REJO, PRINGSEWU, LAMPUNG",25,77,49,126
https://kawalpemilu.org#22351,"WONODADI, GADING REJO, PRINGSEWU, LAMPUNG",26,55,68,123
https://kawalpemilu.org#22351,"WONODADI, GADING REJO, PRINGSEWU, LAMPUNG",27,51,58,109
https://kawalpemilu.org#22351,"WONODADI, GADING REJO, PRINGSEWU, LAMPUNG",28,74,97,171
https://kawalpemilu.org#22351,"WONODADI, GADING REJO, PRINGSEWU, LAMPUNG",29,105,45,150
https://kawalpemilu.org#22351,"WONODADI, GADING REJO, PRINGSEWU, LAMPUNG",30,86,78,164
https://kawalpemilu.org#22351,"WONODADI, GADING REJO, PRINGSEWU, LAMPUNG",31,54,97,151
https://kawalpemilu.org#22351,"WONODADI, GADING REJO, PRINGSEWU, LAMPUNG",32,74,68,142
https://kawalpemilu.org#22351,"WONODADI, GADING REJO, PRINGSEWU, LAMPUNG",33,99,52,151
https://kawalpemilu.org#22351,"WONODADI, GADING REJO, PRINGSEWU, LAMPUNG",34,60,62,122
https://kawalpemilu.org#22351,"WONODADI, GADING REJO, PRINGSEWU, LAMPUNG",35,58,73,131
https://kawalpemilu.org#22351,"WONODADI, GADING REJO, PRINGSEWU, LAMPUNG",36,92,59,151
https://kawalpemilu.org#22351,"WONODADI, GADING REJO, PRINGSEWU, LAMPUNG",37,63,82,145
https://kawalpemilu.org#22351,"WONODADI, GADING REJO, PRINGSEWU, LAMPUNG",38,55,76,131
https://kawalpemilu.org#22351,"WONODADI, GADING REJO, PRINGSEWU, LAMPUNG",39,75,87,162
https://kawalpemilu.org#22351,"WONODADI, GADING REJO, PRINGSEWU, LAMPUNG",40,79,63,142
https://kawalpemilu.org#22352,"GADING REJO, GADING REJO, PRINGSEWU, LAMPUNG",1,102,57,159
https://kawalpemilu.org#22352,"GADING REJO, GADING REJO, PRINGSEWU, LAMPUNG",2,104,131,235
https://kawalpemilu.org#22352,"GADING REJO, GADING REJO, PRINGSEWU, LAMPUNG",3,61,69,130
https://kawalpemilu.org#22352,"GADING REJO, GADING REJO, PRINGSEWU, LAMPUNG",4,160,77,237
https://kawalpemilu.org#22352,"GADING REJO, GADING REJO, PRINGSEWU, LAMPUNG",5,129,55,184
https://kawalpemilu.org#22352,"GADING REJO, GADING REJO, PRINGSEWU, LAMPUNG",6,133,58,191
https://kawalpemilu.org#22352,"GADING REJO, GADING REJO, PRINGSEWU, LAMPUNG",7,151,92,243
https://kawalpemilu.org#22352,"GADING REJO, GADING REJO, PRINGSEWU, LAMPUNG",8,104,40,144
https://kawalpemilu.org#22352,"GADING REJO, GADING REJO, PRINGSEWU, LAMPUNG",9,142,60,202
https://kawalpemilu.org#22352,"GADING REJO, GADING REJO, PRINGSEWU, LAMPUNG",10,164,51,215
https://kawalpemilu.org#22352,"GADING REJO, GADING REJO, PRINGSEWU, LAMPUNG",11,80,47,127
https://kawalpemilu.org#22352,"GADING REJO, GADING REJO, PRINGSEWU, LAMPUNG",12,61,25,86
https://kawalpemilu.org#22352,"GADING REJO, GADING REJO, PRINGSEWU, LAMPUNG",13,102,55,157
https://kawalpemilu.org#22352,"GADING REJO, GADING REJO, PRINGSEWU, LAMPUNG",14,69,75,144
https://kawalpemilu.org#22352,"GADING REJO, GADING REJO, PRINGSEWU, LAMPUNG",15,154,65,219
https://kawalpemilu.org#22352,"GADING REJO, GADING REJO, PRINGSEWU, LAMPUNG",16,95,61,156
https://kawalpemilu.org#22352,"GADING REJO, GADING REJO, PRINGSEWU, LAMPUNG",17,148,50,198
https://kawalpemilu.org#22352,"GADING REJO, GADING REJO, PRINGSEWU, LAMPUNG",18,101,51,152
https://kawalpemilu.org#22352,"GADING REJO, GADING REJO, PRINGSEWU, LAMPUNG",19,99,79,178
https://kawalpemilu.org#22352,"GADING REJO, GADING REJO, PRINGSEWU, LAMPUNG",20,151,35,186
https://kawalpemilu.org#22352,"GADING REJO, GADING REJO, PRINGSEWU, LAMPUNG",21,107,31,138
https://kawalpemilu.org#22352,"GADING REJO, GADING REJO, PRINGSEWU, LAMPUNG",22,66,46,112
https://kawalpemilu.org#22353,"TEGAL SARI, GADING REJO, PRINGSEWU, LAMPUNG",1,68,107,175
https://kawalpemilu.org#22353,"TEGAL SARI, GADING REJO, PRINGSEWU, LAMPUNG",2,47,87,134
https://kawalpemilu.org#22353,"TEGAL SARI, GADING REJO, PRINGSEWU, LAMPUNG",3,66,66,132
https://kawalpemilu.org#22353,"TEGAL SARI, GADING REJO, PRINGSEWU, LAMPUNG",4,91,80,171
https://kawalpemilu.org#22353,"TEGAL SARI, GADING REJO, PRINGSEWU, LAMPUNG",5,83,114,197
https://kawalpemilu.org#22353,"TEGAL SARI, GADING REJO, PRINGSEWU, LAMPUNG",6,104,69,173
https://kawalpemilu.org#22353,"TEGAL SARI, GADING REJO, PRINGSEWU, LAMPUNG",7,141,59,200
https://kawalpemilu.org#22353,"TEGAL SARI, GADING REJO, PRINGSEWU, LAMPUNG",8,54,79,133
https://kawalpemilu.org#22353,"TEGAL SARI, GADING REJO, PRINGSEWU, LAMPUNG",9,50,79,129
https://kawalpemilu.org#22353,"TEGAL SARI, GADING REJO, PRINGSEWU, LAMPUNG",10,45,122,167
https://kawalpemilu.org#22353,"TEGAL SARI, GADING REJO, PRINGSEWU, LAMPUNG",11,56,81,137
https://kawalpemilu.org#22353,"TEGAL SARI, GADING REJO, PRINGSEWU, LAMPUNG",12,59,83,142
https://kawalpemilu.org#22353,"TEGAL SARI, GADING REJO, PRINGSEWU, LAMPUNG",13,83,70,153
https://kawalpemilu.org#22353,"TEGAL SARI, GADING REJO, PRINGSEWU, LAMPUNG",14,88,123,150
https://kawalpemilu.org#22353,"TEGAL SARI, GADING REJO, PRINGSEWU, LAMPUNG",15,111,65,176
https://kawalpemilu.org#22353,"TEGAL SARI, GADING REJO, PRINGSEWU, LAMPUNG",16,90,78,168
https://kawalpemilu.org#22353,"TEGAL SARI, GADING REJO, PRINGSEWU, LAMPUNG",17,51,89,140
https://kawalpemilu.org#22353,"TEGAL SARI, GADING REJO, PRINGSEWU, LAMPUNG",18,40,66,106
https://kawalpemilu.org#22354,"TULUNG AGUNG, GADING REJO, PRINGSEWU, LAMPUNG",1,124,79,203
https://kawalpemilu.org#22354,"TULUNG AGUNG, GADING REJO, PRINGSEWU, LAMPUNG",2,93,84,177
https://kawalpemilu.org#22354,"TULUNG AGUNG, GADING REJO, PRINGSEWU, LAMPUNG",3,79,95,174
https://kawalpemilu.org#22354,"TULUNG AGUNG, GADING REJO, PRINGSEWU, LAMPUNG",4,74,79,133
https://kawalpemilu.org#22354,"TULUNG AGUNG, GADING REJO, PRINGSEWU, LAMPUNG",5,102,88,190
https://kawalpemilu.org#22354,"TULUNG AGUNG, GADING REJO, PRINGSEWU, LAMPUNG",6,113,96,209
https://kawalpemilu.org#22354,"TULUNG AGUNG, GADING REJO, PRINGSEWU, LAMPUNG",7,147,101,248
https://kawalpemilu.org#22354,"TULUNG AGUNG, GADING REJO, PRINGSEWU, LAMPUNG",8,99,74,173
https://kawalpemilu.org#22354,"TULUNG AGUNG, GADING REJO, PRINGSEWU, LAMPUNG",9,111,91,202
https://kawalpemilu.org#22354,"TULUNG AGUNG, GADING REJO, PRINGSEWU, LAMPUNG",10,84,46,130
https://kawalpemilu.org#22354,"TULUNG AGUNG, GADING REJO, PRINGSEWU, LAMPUNG",11,139,50,189
https://kawalpemilu.org#22354,"TULUNG AGUNG, GADING REJO, PRINGSEWU, LAMPUNG",12,105,61,166
https://kawalpemilu.org#22354,"TULUNG AGUNG, GADING REJO, PRINGSEWU, LAMPUNG",13,119,53,112
https://kawalpemilu.org#22354,"TULUNG AGUNG, GADING REJO, PRINGSEWU, LAMPUNG",14,58,80,138
https://kawalpemilu.org#22354,"TULUNG AGUNG, GADING REJO, PRINGSEWU, LAMPUNG",16,95,91,186
https://kawalpemilu.org#22354,"TULUNG AGUNG, GADING REJO, PRINGSEWU, LAMPUNG",17,69,61,130
https://kawalpemilu.org#22355,"BULUREJO, GADING REJO, PRINGSEWU, LAMPUNG",1,176,46,222
https://kawalpemilu.org#22355,"BULUREJO, GADING REJO, PRINGSEWU, LAMPUNG",2,100,40,140
https://kawalpemilu.org#22355,"BULUREJO, GADING REJO, PRINGSEWU, LAMPUNG",3,131,50,181
https://kawalpemilu.org#22355,"BULUREJO, GADING REJO, PRINGSEWU, LAMPUNG",4,112,67,179
https://kawalpemilu.org#22355,"BULUREJO, GADING REJO, PRINGSEWU, LAMPUNG",5,103,62,165
https://kawalpemilu.org#22355,"BULUREJO, GADING REJO, PRINGSEWU, LAMPUNG",6,155,41,196
https://kawalpemilu.org#22355,"BULUREJO, GADING REJO, PRINGSEWU, LAMPUNG",7,153,43,196
https://kawalpemilu.org#22355,"BULUREJO, GADING REJO, PRINGSEWU, LAMPUNG",8,93,32,125
https://kawalpemilu.org#22355,"BULUREJO, GADING REJO, PRINGSEWU, LAMPUNG",9,141,55,196
https://kawalpemilu.org#22355,"BULUREJO, GADING REJO, PRINGSEWU, LAMPUNG",10,98,59,157
https://kawalpemilu.org#22355,"BULUREJO, GADING REJO, PRINGSEWU, LAMPUNG",11,89,30,119
https://kawalpemilu.org#22355,"BULUREJO, GADING REJO, PRINGSEWU, LAMPUNG",12,117,62,179
https://kawalpemilu.org#22356,"YOGYAKARTA, GADING REJO, PRINGSEWU, LAMPUNG",1,52,81,133
https://kawalpemilu.org#22356,"YOGYAKARTA, GADING REJO, PRINGSEWU, LAMPUNG",2,64,64,128
https://kawalpemilu.org#22356,"YOGYAKARTA, GADING REJO, PRINGSEWU, LAMPUNG",3,89,81,170
https://kawalpemilu.org#22356,"YOGYAKARTA, GADING REJO, PRINGSEWU, LAMPUNG",4,123,91,214
https://kawalpemilu.org#22356,"YOGYAKARTA, GADING REJO, PRINGSEWU, LAMPUNG",5,94,134,228
https://kawalpemilu.org#22356,"YOGYAKARTA, GADING REJO, PRINGSEWU, LAMPUNG",6,91,132,223
https://kawalpemilu.org#22356,"YOGYAKARTA, GADING REJO, PRINGSEWU, LAMPUNG",7,64,82,146
https://kawalpemilu.org#22356,"YOGYAKARTA, GADING REJO, PRINGSEWU, LAMPUNG",8,54,72,126
https://kawalpemilu.org#22356,"YOGYAKARTA, GADING REJO, PRINGSEWU, LAMPUNG",9,58,69,127
https://kawalpemilu.org#22356,"YOGYAKARTA, GADING REJO, PRINGSEWU, LAMPUNG",10,92,76,168
https://kawalpemilu.org#22356,"YOGYAKARTA, GADING REJO, PRINGSEWU, LAMPUNG",11,59,52,111
https://kawalpemilu.org#22357,"KEDIRI, GADING REJO, PRINGSEWU, LAMPUNG",1,93,37,130
https://kawalpemilu.org#22357,"KEDIRI, GADING REJO, PRINGSEWU, LAMPUNG",2,119,63,182
https://kawalpemilu.org#22357,"KEDIRI, GADING REJO, PRINGSEWU, LAMPUNG",3,63,66,129
https://kawalpemilu.org#22357,"KEDIRI, GADING REJO, PRINGSEWU, LAMPUNG",4,146,100,246
https://kawalpemilu.org#22357,"KEDIRI, GADING REJO, PRINGSEWU, LAMPUNG",5,149,65,214
https://kawalpemilu.org#22357,"KEDIRI, GADING REJO, PRINGSEWU, LAMPUNG",6,130,46,176
https://kawalpemilu.org#22357,"KEDIRI, GADING REJO, PRINGSEWU, LAMPUNG",7,80,46,126
https://kawalpemilu.org#22357,"KEDIRI, GADING REJO, PRINGSEWU, LAMPUNG",8,97,34,131
https://kawalpemilu.org#22357,"KEDIRI, GADING REJO, PRINGSEWU, LAMPUNG",9,77,37,114
https://kawalpemilu.org#22357,"KEDIRI, GADING REJO, PRINGSEWU, LAMPUNG",10,72,51,123
https://kawalpemilu.org#22358,"MATARAM, GADING REJO, PRINGSEWU, LAMPUNG",1,97,61,158
https://kawalpemilu.org#22358,"MATARAM, GADING REJO, PRINGSEWU, LAMPUNG",2,108,113,221
https://kawalpemilu.org#22358,"MATARAM, GADING REJO, PRINGSEWU, LAMPUNG",3,133,38,171
https://kawalpemilu.org#22358,"MATARAM, GADING REJO, PRINGSEWU, LAMPUNG",4,100,53,153
https://kawalpemilu.org#22358,"MATARAM, GADING REJO, PRINGSEWU, LAMPUNG",5,100,85,185
https://kawalpemilu.org#22358,"MATARAM, GADING REJO, PRINGSEWU, LAMPUNG",6,129,106,235
https://kawalpemilu.org#22358,"MATARAM, GADING REJO, PRINGSEWU, LAMPUNG",7,87,112,199
https://kawalpemilu.org#22358,"MATARAM, GADING REJO, PRINGSEWU, LAMPUNG",8,104,42,146
https://kawalpemilu.org#22358,"MATARAM, GADING REJO, PRINGSEWU, LAMPUNG",9,160,50,210
https://kawalpemilu.org#22358,"MATARAM, GADING REJO, PRINGSEWU, LAMPUNG",10,106,56,162
https://kawalpemilu.org#22358,"MATARAM, GADING REJO, PRINGSEWU, LAMPUNG",11,100,32,132
https://kawalpemilu.org#22358,"MATARAM, GADING REJO, PRINGSEWU, LAMPUNG",12,110,41,151
https://kawalpemilu.org#22358,"MATARAM, GADING REJO, PRINGSEWU, LAMPUNG",13,96,72,168
https://kawalpemilu.org#22358,"MATARAM, GADING REJO, PRINGSEWU, LAMPUNG",14,112,87,199
https://kawalpemilu.org#22358,"MATARAM, GADING REJO, PRINGSEWU, LAMPUNG",15,104,82,186
https://kawalpemilu.org#22358,"MATARAM, GADING REJO, PRINGSEWU, LAMPUNG",16,89,40,129
https://kawalpemilu.org#22359,"WONOSARI, GADING REJO, PRINGSEWU, LAMPUNG",1,111,107,218
https://kawalpemilu.org#22359,"WONOSARI, GADING REJO, PRINGSEWU, LAMPUNG",2,62,91,153
https://kawalpemilu.org#22359,"WONOSARI, GADING REJO, PRINGSEWU, LAMPUNG",3,109,131,240
https://kawalpemilu.org#22359,"WONOSARI, GADING REJO, PRINGSEWU, LAMPUNG",4,110,98,208
https://kawalpemilu.org#22359,"WONOSARI, GADING REJO, PRINGSEWU, LAMPUNG",5,115,73,188
https://kawalpemilu.org#22359,"WONOSARI, GADING REJO, PRINGSEWU, LAMPUNG",6,90,72,162
https://kawalpemilu.org#22359,"WONOSARI, GADING REJO, PRINGSEWU, LAMPUNG",7,118,73,191
https://kawalpemilu.org#22359,"WONOSARI, GADING REJO, PRINGSEWU, LAMPUNG",8,70,76,146
https://kawalpemilu.org#22359,"WONOSARI, GADING REJO, PRINGSEWU, LAMPUNG",9,113,102,115
https://kawalpemilu.org#22359,"WONOSARI, GADING REJO, PRINGSEWU, LAMPUNG",10,78,90,168
https://kawalpemilu.org#87998,"KLATEN, GADING REJO, PRINGSEWU, LAMPUNG",1,128,56,184
https://kawalpemilu.org#87998,"KLATEN, GADING REJO, PRINGSEWU, LAMPUNG",2,74,79,153
https://kawalpemilu.org#87998,"KLATEN, GADING REJO, PRINGSEWU, LAMPUNG",3,90,57,147
https://kawalpemilu.org#87998,"KLATEN, GADING REJO, PRINGSEWU, LAMPUNG",4,128,60,188
https://kawalpemilu.org#87998,"KLATEN, GADING REJO, PRINGSEWU, LAMPUNG",5,69,81,150
https://kawalpemilu.org#87998,"KLATEN, GADING REJO, PRINGSEWU, LAMPUNG",6,82,71,153
https://kawalpemilu.org#87999,"WATES TIMUR, GADING REJO, PRINGSEWU, LAMPUNG",1,119,91,210
https://kawalpemilu.org#87999,"WATES TIMUR, GADING REJO, PRINGSEWU, LAMPUNG",2,146,40,186
https://kawalpemilu.org#87999,"WATES TIMUR, GADING REJO, PRINGSEWU, LAMPUNG",3,91,72,163
https://kawalpemilu.org#87999,"WATES TIMUR, GADING REJO, PRINGSEWU, LAMPUNG",4,120,52,172
https://kawalpemilu.org#87999,"WATES TIMUR, GADING REJO, PRINGSEWU, LAMPUNG",5,100,90,190
https://kawalpemilu.org#87999,"WATES TIMUR, GADING REJO, PRINGSEWU, LAMPUNG",6,105,64,169
https://kawalpemilu.org#87999,"WATES TIMUR, GADING REJO, PRINGSEWU, LAMPUNG",7,115,53,168
https://kawalpemilu.org#87999,"WATES TIMUR, GADING REJO, PRINGSEWU, LAMPUNG",8,89,79,168
https://kawalpemilu.org#88000,"WATES SELATAN, GADING REJO, PRINGSEWU, LAMPUNG",1,85,77,162
https://kawalpemilu.org#88000,"WATES SELATAN, GADING REJO, PRINGSEWU, LAMPUNG",2,84,92,176
https://kawalpemilu.org#88000,"WATES SELATAN, GADING REJO, PRINGSEWU, LAMPUNG",3,97,124,221
https://kawalpemilu.org#88000,"WATES SELATAN, GADING REJO, PRINGSEWU, LAMPUNG",4,150,104,254
https://kawalpemilu.org#88000,"WATES SELATAN, GADING REJO, PRINGSEWU, LAMPUNG",5,76,84,160
https://kawalpemilu.org#88000,"WATES SELATAN, GADING REJO, PRINGSEWU, LAMPUNG",6,68,84,152
https://kawalpemilu.org#88001,"GADINGREJO TIMUR, GADING REJO, PRINGSEWU, LAMPUNG",1,62,81,143
https://kawalpemilu.org#88001,"GADINGREJO TIMUR, GADING REJO, PRINGSEWU, LAMPUNG",2,90,76,166
https://kawalpemilu.org#88001,"GADINGREJO TIMUR, GADING REJO, PRINGSEWU, LAMPUNG",3,106,112,218
https://kawalpemilu.org#88001,"GADINGREJO TIMUR, GADING REJO, PRINGSEWU, LAMPUNG",4,90,56,146
https://kawalpemilu.org#88001,"GADINGREJO TIMUR, GADING REJO, PRINGSEWU, LAMPUNG",5,45,83,128
https://kawalpemilu.org#88001,"GADINGREJO TIMUR, GADING REJO, PRINGSEWU, LAMPUNG",6,97,76,173
https://kawalpemilu.org#88001,"GADINGREJO TIMUR, GADING REJO, PRINGSEWU, LAMPUNG",7,91,44,135
https://kawalpemilu.org#88002,"GADINGREJO UTARA, GADING REJO, PRINGSEWU, LAMPUNG",1,55,82,137
https://kawalpemilu.org#88002,"GADINGREJO UTARA, GADING REJO, PRINGSEWU, LAMPUNG",2,125,103,228
https://kawalpemilu.org#88002,"GADINGREJO UTARA, GADING REJO, PRINGSEWU, LAMPUNG",3,70,72,142
https://kawalpemilu.org#88002,"GADINGREJO UTARA, GADING REJO, PRINGSEWU, LAMPUNG",4,102,48,150
https://kawalpemilu.org#88002,"GADINGREJO UTARA, GADING REJO, PRINGSEWU, LAMPUNG",5,154,83,237
https://kawalpemilu.org#88002,"GADINGREJO UTARA, GADING REJO, PRINGSEWU, LAMPUNG",6,171,91,262
https://kawalpemilu.org#88002,"GADINGREJO UTARA, GADING REJO, PRINGSEWU, LAMPUNG",7,162,60,222
https://kawalpemilu.org#88002,"GADINGREJO UTARA, GADING REJO, PRINGSEWU, LAMPUNG",8,55,62,117
https://kawalpemilu.org#88002,"GADINGREJO UTARA, GADING REJO, PRINGSEWU, LAMPUNG",9,47,83,130
https://kawalpemilu.org#88002,"GADINGREJO UTARA, GADING REJO, PRINGSEWU, LAMPUNG",10,79,33,112
https://kawalpemilu.org#88002,"GADINGREJO UTARA, GADING REJO, PRINGSEWU, LAMPUNG",11,134,88,222
https://kawalpemilu.org#88002,"GADINGREJO UTARA, GADING REJO, PRINGSEWU, LAMPUNG",12,137,59,196
https://kawalpemilu.org#88003,"TAMBAHREJO BARAT, GADING REJO, PRINGSEWU, LAMPUNG",1,120,61,181
https://kawalpemilu.org#88003,"TAMBAHREJO BARAT, GADING REJO, PRINGSEWU, LAMPUNG",2,95,64,159
https://kawalpemilu.org#88003,"TAMBAHREJO BARAT, GADING REJO, PRINGSEWU, LAMPUNG",3,66,88,154
https://kawalpemilu.org#88003,"TAMBAHREJO BARAT, GADING REJO, PRINGSEWU, LAMPUNG",4,117,71,188
https://kawalpemilu.org#88003,"TAMBAHREJO BARAT, GADING REJO, PRINGSEWU, LAMPUNG",5,117,57,174
https://kawalpemilu.org#88003,"TAMBAHREJO BARAT, GADING REJO, PRINGSEWU, LAMPUNG",6,91,79,170
https://kawalpemilu.org#88003,"TAMBAHREJO BARAT, GADING REJO, PRINGSEWU, LAMPUNG",7,90,60,150
https://kawalpemilu.org#88003,"TAMBAHREJO BARAT, GADING REJO, PRINGSEWU, LAMPUNG",8,113,76,189
https://kawalpemilu.org#88004,"WONODADI UTARA, GADING REJO, PRINGSEWU, LAMPUNG",1,84,136,220
https://kawalpemilu.org#88004,"WONODADI UTARA, GADING REJO, PRINGSEWU, LAMPUNG",2,85,136,221
https://kawalpemilu.org#88004,"WONODADI UTARA, GADING REJO, PRINGSEWU, LAMPUNG",3,63,96,159
https://kawalpemilu.org#88004,"WONODADI UTARA, GADING REJO, PRINGSEWU, LAMPUNG",4,69,74,143
https://kawalpemilu.org#88004,"WONODADI UTARA, GADING REJO, PRINGSEWU, LAMPUNG",5,95,72,167
https://kawalpemilu.org#88004,"WONODADI UTARA, GADING REJO, PRINGSEWU, LAMPUNG",6,87,68,155
https://kawalpemilu.org#88004,"WONODADI UTARA, GADING REJO, PRINGSEWU, LAMPUNG",7,85,52,137
https://kawalpemilu.org#88004,"WONODADI UTARA, GADING REJO, PRINGSEWU, LAMPUNG",8,108,67,175
https://kawalpemilu.org#88005,"YOGYAKARTA SELATAN, GADING REJO, PRINGSEWU, LAMPUNG",1,73,81,154
https://kawalpemilu.org#88005,"YOGYAKARTA SELATAN, GADING REJO, PRINGSEWU, LAMPUNG",2,88,79,167
https://kawalpemilu.org#88005,"YOGYAKARTA SELATAN, GADING REJO, PRINGSEWU, LAMPUNG",4,87,74,161
https://kawalpemilu.org#88005,"YOGYAKARTA SELATAN, GADING REJO, PRINGSEWU, LAMPUNG",5,97,53,150
https://kawalpemilu.org#88005,"YOGYAKARTA SELATAN, GADING REJO, PRINGSEWU, LAMPUNG",6,96,69,165
https://kawalpemilu.org#22361,"AMBARAWA, AMBARAWA, PRINGSEWU, LAMPUNG",1,125,61,186
https://kawalpemilu.org#22361,"AMBARAWA, AMBARAWA, PRINGSEWU, LAMPUNG",2,111,54,165
https://kawalpemilu.org#22361,"AMBARAWA, AMBARAWA, PRINGSEWU, LAMPUNG",3,122,68,190
https://kawalpemilu.org#22361,"AMBARAWA, AMBARAWA, PRINGSEWU, LAMPUNG",4,86,40,126
https://kawalpemilu.org#22361,"AMBARAWA, AMBARAWA, PRINGSEWU, LAMPUNG",5,100,25,125
https://kawalpemilu.org#22361,"AMBARAWA, AMBARAWA, PRINGSEWU, LAMPUNG",6,125,29,154
https://kawalpemilu.org#22361,"AMBARAWA, AMBARAWA, PRINGSEWU, LAMPUNG",7,133,44,177
https://kawalpemilu.org#22361,"AMBARAWA, AMBARAWA, PRINGSEWU, LAMPUNG",8,128,27,155
https://kawalpemilu.org#22361,"AMBARAWA, AMBARAWA, PRINGSEWU, LAMPUNG",9,110,54,164
https://kawalpemilu.org#22361,"AMBARAWA, AMBARAWA, PRINGSEWU, LAMPUNG",10,96,65,161
https://kawalpemilu.org#22361,"AMBARAWA, AMBARAWA, PRINGSEWU, LAMPUNG",11,71,98,169
https://kawalpemilu.org#22361,"AMBARAWA, AMBARAWA, PRINGSEWU, LAMPUNG",12,77,101,178
https://kawalpemilu.org#22361,"AMBARAWA, AMBARAWA, PRINGSEWU, LAMPUNG",13,119,43,162
https://kawalpemilu.org#22361,"AMBARAWA, AMBARAWA, PRINGSEWU, LAMPUNG",14,125,44,169
https://kawalpemilu.org#22361,"AMBARAWA, AMBARAWA, PRINGSEWU, LAMPUNG",15,83,73,156
https://kawalpemilu.org#22361,"AMBARAWA, AMBARAWA, PRINGSEWU, LAMPUNG",16,74,37,111
https://kawalpemilu.org#22361,"AMBARAWA, AMBARAWA, PRINGSEWU, LAMPUNG",17,104,19,123
https://kawalpemilu.org#22361,"AMBARAWA, AMBARAWA, PRINGSEWU, LAMPUNG",18,114,36,150
https://kawalpemilu.org#22361,"AMBARAWA, AMBARAWA, PRINGSEWU, LAMPUNG",19,107,58,165
https://kawalpemilu.org#22361,"AMBARAWA, AMBARAWA, PRINGSEWU, LAMPUNG",20,112,36,151
https://kawalpemilu.org#22361,"AMBARAWA, AMBARAWA, PRINGSEWU, LAMPUNG",21,96,50,146
https://kawalpemilu.org#22361,"AMBARAWA, AMBARAWA, PRINGSEWU, LAMPUNG",22,76,63,139
https://kawalpemilu.org#22361,"AMBARAWA, AMBARAWA, PRINGSEWU, LAMPUNG",23,64,95,159
https://kawalpemilu.org#22361,"AMBARAWA, AMBARAWA, PRINGSEWU, LAMPUNG",24,90,80,170
https://kawalpemilu.org#22361,"AMBARAWA, AMBARAWA, PRINGSEWU, LAMPUNG",25,127,29,156
https://kawalpemilu.org#22362,"AMBARAWA BARAT, AMBARAWA, PRINGSEWU, LAMPUNG",1,153,59,212
https://kawalpemilu.org#22362,"AMBARAWA BARAT, AMBARAWA, PRINGSEWU, LAMPUNG",2,163,79,242
https://kawalpemilu.org#22362,"AMBARAWA BARAT, AMBARAWA, PRINGSEWU, LAMPUNG",3,123,49,172
https://kawalpemilu.org#22362,"AMBARAWA BARAT, AMBARAWA, PRINGSEWU, LAMPUNG",4,125,61,186
https://kawalpemilu.org#22362,"AMBARAWA BARAT, AMBARAWA, PRINGSEWU, LAMPUNG",5,158,68,226
https://kawalpemilu.org#22362,"AMBARAWA BARAT, AMBARAWA, PRINGSEWU, LAMPUNG",6,130,41,171
https://kawalpemilu.org#22362,"AMBARAWA BARAT, AMBARAWA, PRINGSEWU, LAMPUNG",7,186,21,207
https://kawalpemilu.org#22362,"AMBARAWA BARAT, AMBARAWA, PRINGSEWU, LAMPUNG",8,176,33,209
https://kawalpemilu.org#22362,"AMBARAWA BARAT, AMBARAWA, PRINGSEWU, LAMPUNG",9,70,37,107
https://kawalpemilu.org#22362,"AMBARAWA BARAT, AMBARAWA, PRINGSEWU, LAMPUNG",10,103,60,163
https://kawalpemilu.org#22362,"AMBARAWA BARAT, AMBARAWA, PRINGSEWU, LAMPUNG",11,127,52,179
https://kawalpemilu.org#22362,"AMBARAWA BARAT, AMBARAWA, PRINGSEWU, LAMPUNG",12,102,32,134
https://kawalpemilu.org#22362,"AMBARAWA BARAT, AMBARAWA, PRINGSEWU, LAMPUNG",13,108,26,134
https://kawalpemilu.org#22362,"AMBARAWA BARAT, AMBARAWA, PRINGSEWU, LAMPUNG",14,134,37,171
https://kawalpemilu.org#22362,"AMBARAWA BARAT, AMBARAWA, PRINGSEWU, LAMPUNG",15,140,28,168
https://kawalpemilu.org#22362,"AMBARAWA BARAT, AMBARAWA, PRINGSEWU, LAMPUNG",16,131,29,160
https://kawalpemilu.org#22363,"KRESNO MULYO, AMBARAWA, PRINGSEWU, LAMPUNG",1,158,20,178
https://kawalpemilu.org#22363,"KRESNO MULYO, AMBARAWA, PRINGSEWU, LAMPUNG",2,128,32,160
https://kawalpemilu.org#22363,"KRESNO MULYO, AMBARAWA, PRINGSEWU, LAMPUNG",3,104,56,160
https://kawalpemilu.org#22363,"KRESNO MULYO, AMBARAWA, PRINGSEWU, LAMPUNG",4,111,60,171
https://kawalpemilu.org#22363,"KRESNO MULYO, AMBARAWA, PRINGSEWU, LAMPUNG",5,77,95,172
https://kawalpemilu.org#22363,"KRESNO MULYO, AMBARAWA, PRINGSEWU, LAMPUNG",6,77,78,155
https://kawalpemilu.org#22363,"KRESNO MULYO, AMBARAWA, PRINGSEWU, LAMPUNG",8,83,59,142
https://kawalpemilu.org#22363,"KRESNO MULYO, AMBARAWA, PRINGSEWU, LAMPUNG",9,107,44,151
https://kawalpemilu.org#22363,"KRESNO MULYO, AMBARAWA, PRINGSEWU, LAMPUNG",10,116,29,145
https://kawalpemilu.org#22363,"KRESNO MULYO, AMBARAWA, PRINGSEWU, LAMPUNG",11,110,31,141
https://kawalpemilu.org#22363,"KRESNO MULYO, AMBARAWA, PRINGSEWU, LAMPUNG",12,118,38,156
https://kawalpemilu.org#22363,"KRESNO MULYO, AMBARAWA, PRINGSEWU, LAMPUNG",13,76,61,137
https://kawalpemilu.org#22363,"KRESNO MULYO, AMBARAWA, PRINGSEWU, LAMPUNG",14,146,21,167
https://kawalpemilu.org#22363,"KRESNO MULYO, AMBARAWA, PRINGSEWU, LAMPUNG",15,107,50,157
https://kawalpemilu.org#22363,"KRESNO MULYO, AMBARAWA, PRINGSEWU, LAMPUNG",16,117,60,177
https://kawalpemilu.org#22363,"KRESNO MULYO, AMBARAWA, PRINGSEWU, LAMPUNG",17,113,40,153
https://kawalpemilu.org#22363,"KRESNO MULYO, AMBARAWA, PRINGSEWU, LAMPUNG",18,66,89,155
https://kawalpemilu.org#22363,"KRESNO MULYO, AMBARAWA, PRINGSEWU, LAMPUNG",19,81,78,159
https://kawalpemilu.org#22363,"KRESNO MULYO, AMBARAWA, PRINGSEWU, LAMPUNG",20,97,68,165
https://kawalpemilu.org#22363,"KRESNO MULYO, AMBARAWA, PRINGSEWU, LAMPUNG",21,90,53,143
https://kawalpemilu.org#22363,"KRESNO MULYO, AMBARAWA, PRINGSEWU, LAMPUNG",22,87,60,147
https://kawalpemilu.org#22363,"KRESNO MULYO, AMBARAWA, PRINGSEWU, LAMPUNG",23,107,36,143
https://kawalpemilu.org#22363,"KRESNO MULYO, AMBARAWA, PRINGSEWU, LAMPUNG",24,85,49,134
https://kawalpemilu.org#22363,"KRESNO MULYO, AMBARAWA, PRINGSEWU, LAMPUNG",25,76,75,151
https://kawalpemilu.org#22363,"KRESNO MULYO, AMBARAWA, PRINGSEWU, LAMPUNG",26,109,48,157
https://kawalpemilu.org#22364,"SUMBER AGUNG, AMBARAWA, PRINGSEWU, LAMPUNG",1,117,29,146
https://kawalpemilu.org#22364,"SUMBER AGUNG, AMBARAWA, PRINGSEWU, LAMPUNG",2,119,25,144
https://kawalpemilu.org#22364,"SUMBER AGUNG, AMBARAWA, PRINGSEWU, LAMPUNG",3,88,60,148
https://kawalpemilu.org#22364,"SUMBER AGUNG, AMBARAWA, PRINGSEWU, LAMPUNG",4,123,29,152
https://kawalpemilu.org#22364,"SUMBER AGUNG, AMBARAWA, PRINGSEWU, LAMPUNG",5,92,31,123
https://kawalpemilu.org#22364,"SUMBER AGUNG, AMBARAWA, PRINGSEWU, LAMPUNG",6,89,44,133
https://kawalpemilu.org#22364,"SUMBER AGUNG, AMBARAWA, PRINGSEWU, LAMPUNG",7,100,32,132
https://kawalpemilu.org#22364,"SUMBER AGUNG, AMBARAWA, PRINGSEWU, LAMPUNG",9,64,86,150
https://kawalpemilu.org#22364,"SUMBER AGUNG, AMBARAWA, PRINGSEWU, LAMPUNG",10,89,83,172
https://kawalpemilu.org#22364,"SUMBER AGUNG, AMBARAWA, PRINGSEWU, LAMPUNG",11,133,61,194
https://kawalpemilu.org#22364,"SUMBER AGUNG, AMBARAWA, PRINGSEWU, LAMPUNG",12,129,48,177
https://kawalpemilu.org#22364,"SUMBER AGUNG, AMBARAWA, PRINGSEWU, LAMPUNG",13,129,29,158
https://kawalpemilu.org#22364,"SUMBER AGUNG, AMBARAWA, PRINGSEWU, LAMPUNG",14,129,27,156
https://kawalpemilu.org#22364,"SUMBER AGUNG, AMBARAWA, PRINGSEWU, LAMPUNG",15,94,52,146
https://kawalpemilu.org#22364,"SUMBER AGUNG, AMBARAWA, PRINGSEWU, LAMPUNG",17,88,44,132
https://kawalpemilu.org#22364,"SUMBER AGUNG, AMBARAWA, PRINGSEWU, LAMPUNG",18,95,54,149
https://kawalpemilu.org#22364,"SUMBER AGUNG, AMBARAWA, PRINGSEWU, LAMPUNG",19,101,42,143
https://kawalpemilu.org#22364,"SUMBER AGUNG, AMBARAWA, PRINGSEWU, LAMPUNG",20,121,48,169
https://kawalpemilu.org#22364,"SUMBER AGUNG, AMBARAWA, PRINGSEWU, LAMPUNG",21,76,86,162
https://kawalpemilu.org#22364,"SUMBER AGUNG, AMBARAWA, PRINGSEWU, LAMPUNG",22,74,88,162
https://kawalpemilu.org#22364,"SUMBER AGUNG, AMBARAWA, PRINGSEWU, LAMPUNG",23,138,34,172
https://kawalpemilu.org#22364,"SUMBER AGUNG, AMBARAWA, PRINGSEWU, LAMPUNG",24,136,29,165
https://kawalpemilu.org#22365,"TANJUNG ANOM, AMBARAWA, PRINGSEWU, LAMPUNG",1,104,66,170
https://kawalpemilu.org#22365,"TANJUNG ANOM, AMBARAWA, PRINGSEWU, LAMPUNG",2,126,49,175
https://kawalpemilu.org#22365,"TANJUNG ANOM, AMBARAWA, PRINGSEWU, LAMPUNG",3,113,62,175
https://kawalpemilu.org#22365,"TANJUNG ANOM, AMBARAWA, PRINGSEWU, LAMPUNG",4,113,48,161
https://kawalpemilu.org#22365,"TANJUNG ANOM, AMBARAWA, PRINGSEWU, LAMPUNG",5,103,57,160
https://kawalpemilu.org#22365,"TANJUNG ANOM, AMBARAWA, PRINGSEWU, LAMPUNG",6,103,73,176
https://kawalpemilu.org#22365,"TANJUNG ANOM, AMBARAWA, PRINGSEWU, LAMPUNG",7,122,59,181
https://kawalpemilu.org#22365,"TANJUNG ANOM, AMBARAWA, PRINGSEWU, LAMPUNG",8,112,75,187
https://kawalpemilu.org#22366,"JATI AGUNG, AMBARAWA, PRINGSEWU, LAMPUNG",1,102,67,169
https://kawalpemilu.org#22366,"JATI AGUNG, AMBARAWA, PRINGSEWU, LAMPUNG",2,89,69,158
https://kawalpemilu.org#22366,"JATI AGUNG, AMBARAWA, PRINGSEWU, LAMPUNG",3,154,97,251
https://kawalpemilu.org#22366,"JATI AGUNG, AMBARAWA, PRINGSEWU, LAMPUNG",4,91,67,158
https://kawalpemilu.org#22366,"JATI AGUNG, AMBARAWA, PRINGSEWU, LAMPUNG",5,157,78,235
https://kawalpemilu.org#22366,"JATI AGUNG, AMBARAWA, PRINGSEWU, LAMPUNG",6,66,112,178
https://kawalpemilu.org#22366,"JATI AGUNG, AMBARAWA, PRINGSEWU, LAMPUNG",7,144,52,196
https://kawalpemilu.org#22366,"JATI AGUNG, AMBARAWA, PRINGSEWU, LAMPUNG",8,154,72,226
https://kawalpemilu.org#22366,"JATI AGUNG, AMBARAWA, PRINGSEWU, LAMPUNG",9,94,72,166
https://kawalpemilu.org#22366,"JATI AGUNG, AMBARAWA, PRINGSEWU, LAMPUNG",10,131,71,202
https://kawalpemilu.org#22367,"MARGODADI, AMBARAWA, PRINGSEWU, LAMPUNG",2,143,51,194
https://kawalpemilu.org#22367,"MARGODADI, AMBARAWA, PRINGSEWU, LAMPUNG",3,136,47,183
https://kawalpemilu.org#22367,"MARGODADI, AMBARAWA, PRINGSEWU, LAMPUNG",4,133,52,185
https://kawalpemilu.org#22367,"MARGODADI, AMBARAWA, PRINGSEWU, LAMPUNG",5,82,64,146
https://kawalpemilu.org#22367,"MARGODADI, AMBARAWA, PRINGSEWU, LAMPUNG",6,119,80,199
https://kawalpemilu.org#22367,"MARGODADI, AMBARAWA, PRINGSEWU, LAMPUNG",7,133,68,201
https://kawalpemilu.org#22367,"MARGODADI, AMBARAWA, PRINGSEWU, LAMPUNG",8,179,39,218
https://kawalpemilu.org#22367,"MARGODADI, AMBARAWA, PRINGSEWU, LAMPUNG",9,130,81,211
https://kawalpemilu.org#22367,"MARGODADI, AMBARAWA, PRINGSEWU, LAMPUNG",10,170,29,199
https://kawalpemilu.org#22367,"MARGODADI, AMBARAWA, PRINGSEWU, LAMPUNG",11,146,30,176
https://kawalpemilu.org#22367,"MARGODADI, AMBARAWA, PRINGSEWU, LAMPUNG",12,133,62,195
https://kawalpemilu.org#22367,"MARGODADI, AMBARAWA, PRINGSEWU, LAMPUNG",13,72,57,129
https://kawalpemilu.org#22367,"MARGODADI, AMBARAWA, PRINGSEWU, LAMPUNG",14,130,75,205
https://kawalpemilu.org#22367,"MARGODADI, AMBARAWA, PRINGSEWU, LAMPUNG",15,132,52,184
https://kawalpemilu.org#22367,"MARGODADI, AMBARAWA, PRINGSEWU, LAMPUNG",16,182,39,221
https://kawalpemilu.org#84823,"AMBARAWA TIMUR, AMBARAWA, PRINGSEWU, LAMPUNG",1,138,56,194
https://kawalpemilu.org#84823,"AMBARAWA TIMUR, AMBARAWA, PRINGSEWU, LAMPUNG",2,161,71,232
https://kawalpemilu.org#84823,"AMBARAWA TIMUR, AMBARAWA, PRINGSEWU, LAMPUNG",4,159,45,204
https://kawalpemilu.org#22369,"KEDAUNG, PARDASUKA, PRINGSEWU, LAMPUNG",1,108,75,183
https://kawalpemilu.org#22369,"KEDAUNG, PARDASUKA, PRINGSEWU, LAMPUNG",2,104,74,178
https://kawalpemilu.org#22369,"KEDAUNG, PARDASUKA, PRINGSEWU, LAMPUNG",3,107,53,160
https://kawalpemilu.org#22369,"KEDAUNG, PARDASUKA, PRINGSEWU, LAMPUNG",4,71,85,156
https://kawalpemilu.org#22369,"KEDAUNG, PARDASUKA, PRINGSEWU, LAMPUNG",5,85,48,133
https://kawalpemilu.org#22369,"KEDAUNG, PARDASUKA, PRINGSEWU, LAMPUNG",6,60,17,77
https://kawalpemilu.org#22369,"KEDAUNG, PARDASUKA, PRINGSEWU, LAMPUNG",7,81,22,103
https://kawalpemilu.org#22370,"PARDASUKA, PARDASUKA, PRINGSEWU, LAMPUNG",1,30,121,151
https://kawalpemilu.org#22370,"PARDASUKA, PARDASUKA, PRINGSEWU, LAMPUNG",2,37,63,100
https://kawalpemilu.org#22370,"PARDASUKA, PARDASUKA, PRINGSEWU, LAMPUNG",3,52,145,197
https://kawalpemilu.org#22370,"PARDASUKA, PARDASUKA, PRINGSEWU, LAMPUNG",4,65,87,152
https://kawalpemilu.org#22370,"PARDASUKA, PARDASUKA, PRINGSEWU, LAMPUNG",5,90,107,197
https://kawalpemilu.org#22370,"PARDASUKA, PARDASUKA, PRINGSEWU, LAMPUNG",6,76,104,180
https://kawalpemilu.org#22370,"PARDASUKA, PARDASUKA, PRINGSEWU, LAMPUNG",7,86,78,164
https://kawalpemilu.org#22370,"PARDASUKA, PARDASUKA, PRINGSEWU, LAMPUNG",8,60,115,175
https://kawalpemilu.org#22370,"PARDASUKA, PARDASUKA, PRINGSEWU, LAMPUNG",9,53,107,160
https://kawalpemilu.org#22370,"PARDASUKA, PARDASUKA, PRINGSEWU, LAMPUNG",10,54,100,154
https://kawalpemilu.org#22370,"PARDASUKA, PARDASUKA, PRINGSEWU, LAMPUNG",11,52,134,186
https://kawalpemilu.org#22370,"PARDASUKA, PARDASUKA, PRINGSEWU, LAMPUNG",12,84,121,205
https://kawalpemilu.org#22370,"PARDASUKA, PARDASUKA, PRINGSEWU, LAMPUNG",13,97,59,156
https://kawalpemilu.org#22370,"PARDASUKA, PARDASUKA, PRINGSEWU, LAMPUNG",14,84,66,150
https://kawalpemilu.org#22370,"PARDASUKA, PARDASUKA, PRINGSEWU, LAMPUNG",15,87,117,204
https://kawalpemilu.org#22370,"PARDASUKA, PARDASUKA, PRINGSEWU, LAMPUNG",16,166,81,247
https://kawalpemilu.org#22370,"PARDASUKA, PARDASUKA, PRINGSEWU, LAMPUNG",17,60,114,174
https://kawalpemilu.org#22370,"PARDASUKA, PARDASUKA, PRINGSEWU, LAMPUNG",18,57,103,160
https://kawalpemilu.org#22371,"SUKA NEGERI, PARDASUKA, PRINGSEWU, LAMPUNG",1,76,85,161
https://kawalpemilu.org#22371,"SUKA NEGERI, PARDASUKA, PRINGSEWU, LAMPUNG",2,22,92,114
https://kawalpemilu.org#22372,"TANJUNG RUSIA, PARDASUKA, PRINGSEWU, LAMPUNG",1,32,102,134
https://kawalpemilu.org#22372,"TANJUNG RUSIA, PARDASUKA, PRINGSEWU, LAMPUNG",2,60,153,213
https://kawalpemilu.org#22372,"TANJUNG RUSIA, PARDASUKA, PRINGSEWU, LAMPUNG",3,77,61,138
https://kawalpemilu.org#22372,"TANJUNG RUSIA, PARDASUKA, PRINGSEWU, LAMPUNG",4,94,114,208
https://kawalpemilu.org#22372,"TANJUNG RUSIA, PARDASUKA, PRINGSEWU, LAMPUNG",5,118,65,183
https://kawalpemilu.org#22372,"TANJUNG RUSIA, PARDASUKA, PRINGSEWU, LAMPUNG",6,115,70,185
https://kawalpemilu.org#22372,"TANJUNG RUSIA, PARDASUKA, PRINGSEWU, LAMPUNG",7,73,68,141
https://kawalpemilu.org#22372,"TANJUNG RUSIA, PARDASUKA, PRINGSEWU, LAMPUNG",8,132,53,185
https://kawalpemilu.org#22372,"TANJUNG RUSIA, PARDASUKA, PRINGSEWU, LAMPUNG",9,60,82,142
https://kawalpemilu.org#22372,"TANJUNG RUSIA, PARDASUKA, PRINGSEWU, LAMPUNG",10,76,57,133
https://kawalpemilu.org#22373,"WARGA MULYO, PARDASUKA, PRINGSEWU, LAMPUNG",1,111,68,179
https://kawalpemilu.org#22373,"WARGA MULYO, PARDASUKA, PRINGSEWU, LAMPUNG",2,83,61,144
https://kawalpemilu.org#22373,"WARGA MULYO, PARDASUKA, PRINGSEWU, LAMPUNG",3,88,57,145
https://kawalpemilu.org#22373,"WARGA MULYO, PARDASUKA, PRINGSEWU, LAMPUNG",4,140,66,206
https://kawalpemilu.org#22373,"WARGA MULYO, PARDASUKA, PRINGSEWU, LAMPUNG",5,135,35,170
https://kawalpemilu.org#22373,"WARGA MULYO, PARDASUKA, PRINGSEWU, LAMPUNG",6,76,44,120
https://kawalpemilu.org#22373,"WARGA MULYO, PARDASUKA, PRINGSEWU, LAMPUNG",7,112,76,188
https://kawalpemilu.org#22373,"WARGA MULYO, PARDASUKA, PRINGSEWU, LAMPUNG",8,112,41,153
https://kawalpemilu.org#22373,"WARGA MULYO, PARDASUKA, PRINGSEWU, LAMPUNG",9,98,31,129
https://kawalpemilu.org#22373,"WARGA MULYO, PARDASUKA, PRINGSEWU, LAMPUNG",10,115,45,160
https://kawalpemilu.org#22373,"WARGA MULYO, PARDASUKA, PRINGSEWU, LAMPUNG",11,93,62,155
https://kawalpemilu.org#22373,"WARGA MULYO, PARDASUKA, PRINGSEWU, LAMPUNG",12,84,58,142
https://kawalpemilu.org#22373,"WARGA MULYO, PARDASUKA, PRINGSEWU, LAMPUNG",13,96,59,155
https://kawalpemilu.org#22373,"WARGA MULYO, PARDASUKA, PRINGSEWU, LAMPUNG",14,66,27,93
https://kawalpemilu.org#22373,"WARGA MULYO, PARDASUKA, PRINGSEWU, LAMPUNG",15,149,19,168
https://kawalpemilu.org#22373,"WARGA MULYO, PARDASUKA, PRINGSEWU, LAMPUNG",16,94,20,114
https://kawalpemilu.org#22373,"WARGA MULYO, PARDASUKA, PRINGSEWU, LAMPUNG",17,115,45,160
https://kawalpemilu.org#22374,"PUJODADI, PARDASUKA, PRINGSEWU, LAMPUNG",1,85,44,129
https://kawalpemilu.org#22374,"PUJODADI, PARDASUKA, PRINGSEWU, LAMPUNG",2,124,32,156
https://kawalpemilu.org#22374,"PUJODADI, PARDASUKA, PRINGSEWU, LAMPUNG",3,75,61,136
https://kawalpemilu.org#22374,"PUJODADI, PARDASUKA, PRINGSEWU, LAMPUNG",4,76,70,146
https://kawalpemilu.org#22374,"PUJODADI, PARDASUKA, PRINGSEWU, LAMPUNG",5,93,28,121
https://kawalpemilu.org#22374,"PUJODADI, PARDASUKA, PRINGSEWU, LAMPUNG",6,128,38,166
https://kawalpemilu.org#22374,"PUJODADI, PARDASUKA, PRINGSEWU, LAMPUNG",7,92,29,121
https://kawalpemilu.org#22374,"PUJODADI, PARDASUKA, PRINGSEWU, LAMPUNG",8,158,55,213
https://kawalpemilu.org#22374,"PUJODADI, PARDASUKA, PRINGSEWU, LAMPUNG",9,125,31,156
https://kawalpemilu.org#22374,"PUJODADI, PARDASUKA, PRINGSEWU, LAMPUNG",10,102,41,143
https://kawalpemilu.org#22374,"PUJODADI, PARDASUKA, PRINGSEWU, LAMPUNG",11,73,37,110
https://kawalpemilu.org#22374,"PUJODADI, PARDASUKA, PRINGSEWU, LAMPUNG",12,95,39,134
https://kawalpemilu.org#22374,"PUJODADI, PARDASUKA, PRINGSEWU, LAMPUNG",13,80,39,119
https://kawalpemilu.org#22374,"PUJODADI, PARDASUKA, PRINGSEWU, LAMPUNG",14,87,49,136
https://kawalpemilu.org#22374,"PUJODADI, PARDASUKA, PRINGSEWU, LAMPUNG",15,106,44,150
https://kawalpemilu.org#22374,"PUJODADI, PARDASUKA, PRINGSEWU, LAMPUNG",16,110,33,143
https://kawalpemilu.org#22374,"PUJODADI, PARDASUKA, PRINGSEWU, LAMPUNG",17,114,51,165
https://kawalpemilu.org#22374,"PUJODADI, PARDASUKA, PRINGSEWU, LAMPUNG",18,96,46,141
https://kawalpemilu.org#22375,"SUKOREJO, PARDASUKA, PRINGSEWU, LAMPUNG",1,74,122,196
https://kawalpemilu.org#22375,"SUKOREJO, PARDASUKA, PRINGSEWU, LAMPUNG",2,92,102,194
https://kawalpemilu.org#22375,"SUKOREJO, PARDASUKA, PRINGSEWU, LAMPUNG",3,61,44,105
https://kawalpemilu.org#22375,"SUKOREJO, PARDASUKA, PRINGSEWU, LAMPUNG",4,83,55,138
https://kawalpemilu.org#22375,"SUKOREJO, PARDASUKA, PRINGSEWU, LAMPUNG",5,53,91,144
https://kawalpemilu.org#22375,"SUKOREJO, PARDASUKA, PRINGSEWU, LAMPUNG",6,97,143,240
https://kawalpemilu.org#22375,"SUKOREJO, PARDASUKA, PRINGSEWU, LAMPUNG",7,107,72,179
https://kawalpemilu.org#22375,"SUKOREJO, PARDASUKA, PRINGSEWU, LAMPUNG",8,110,56,166
https://kawalpemilu.org#22375,"SUKOREJO, PARDASUKA, PRINGSEWU, LAMPUNG",9,76,46,122
https://kawalpemilu.org#22375,"SUKOREJO, PARDASUKA, PRINGSEWU, LAMPUNG",10,88,59,147
https://kawalpemilu.org#22375,"SUKOREJO, PARDASUKA, PRINGSEWU, LAMPUNG",11,68,55,123
https://kawalpemilu.org#22375,"SUKOREJO, PARDASUKA, PRINGSEWU, LAMPUNG",12,95,45,140
https://kawalpemilu.org#22375,"SUKOREJO, PARDASUKA, PRINGSEWU, LAMPUNG",13,94,56,150
https://kawalpemilu.org#22376,"SELAPAN, PARDASUKA, PRINGSEWU, LAMPUNG",1,122,36,158
https://kawalpemilu.org#22376,"SELAPAN, PARDASUKA, PRINGSEWU, LAMPUNG",2,114,32,146
https://kawalpemilu.org#22376,"SELAPAN, PARDASUKA, PRINGSEWU, LAMPUNG",3,145,40,185
https://kawalpemilu.org#22376,"SELAPAN, PARDASUKA, PRINGSEWU, LAMPUNG",4,201,22,223
https://kawalpemilu.org#22376,"SELAPAN, PARDASUKA, PRINGSEWU, LAMPUNG",5,131,13,144
https://kawalpemilu.org#22376,"SELAPAN, PARDASUKA, PRINGSEWU, LAMPUNG",6,166,6,172
https://kawalpemilu.org#22376,"SELAPAN, PARDASUKA, PRINGSEWU, LAMPUNG",7,87,35,122
https://kawalpemilu.org#22376,"SELAPAN, PARDASUKA, PRINGSEWU, LAMPUNG",8,82,36,118
https://kawalpemilu.org#22377,"RANTAU TIJANG, PARDASUKA, PRINGSEWU, LAMPUNG",1,69,34,103
https://kawalpemilu.org#22377,"RANTAU TIJANG, PARDASUKA, PRINGSEWU, LAMPUNG",2,125,28,153
https://kawalpemilu.org#22377,"RANTAU TIJANG, PARDASUKA, PRINGSEWU, LAMPUNG",3,138,26,164
https://kawalpemilu.org#22377,"RANTAU TIJANG, PARDASUKA, PRINGSEWU, LAMPUNG",4,147,41,188
https://kawalpemilu.org#22377,"RANTAU TIJANG, PARDASUKA, PRINGSEWU, LAMPUNG",5,106,10,116
https://kawalpemilu.org#22377,"RANTAU TIJANG, PARDASUKA, PRINGSEWU, LAMPUNG",6,117,18,135
https://kawalpemilu.org#22377,"RANTAU TIJANG, PARDASUKA, PRINGSEWU, LAMPUNG",7,58,44,102
https://kawalpemilu.org#22377,"RANTAU TIJANG, PARDASUKA, PRINGSEWU, LAMPUNG",8,110,27,137
https://kawalpemilu.org#22378,"SIDODADI, PARDASUKA, PRINGSEWU, LAMPUNG",1,120,73,193
https://kawalpemilu.org#22378,"SIDODADI, PARDASUKA, PRINGSEWU, LAMPUNG",2,122,62,184
https://kawalpemilu.org#22378,"SIDODADI, PARDASUKA, PRINGSEWU, LAMPUNG",3,139,56,195
https://kawalpemilu.org#22378,"SIDODADI, PARDASUKA, PRINGSEWU, LAMPUNG",4,112,44,156
https://kawalpemilu.org#22378,"SIDODADI, PARDASUKA, PRINGSEWU, LAMPUNG",5,91,29,120
https://kawalpemilu.org#22378,"SIDODADI, PARDASUKA, PRINGSEWU, LAMPUNG",6,129,36,164
https://kawalpemilu.org#22378,"SIDODADI, PARDASUKA, PRINGSEWU, LAMPUNG",7,119,59,178
https://kawalpemilu.org#22378,"SIDODADI, PARDASUKA, PRINGSEWU, LAMPUNG",8,125,43,168
https://kawalpemilu.org#22378,"SIDODADI, PARDASUKA, PRINGSEWU, LAMPUNG",9,102,50,152
https://kawalpemilu.org#22378,"SIDODADI, PARDASUKA, PRINGSEWU, LAMPUNG",10,121,51,172
https://kawalpemilu.org#22378,"SIDODADI, PARDASUKA, PRINGSEWU, LAMPUNG",11,106,43,149
https://kawalpemilu.org#22378,"SIDODADI, PARDASUKA, PRINGSEWU, LAMPUNG",12,116,45,161
https://kawalpemilu.org#22379,"PARDASUKA TIMUR, PARDASUKA, PRINGSEWU, LAMPUNG",1,57,67,124
https://kawalpemilu.org#22379,"PARDASUKA TIMUR, PARDASUKA, PRINGSEWU, LAMPUNG",2,73,80,153
https://kawalpemilu.org#22379,"PARDASUKA TIMUR, PARDASUKA, PRINGSEWU, LAMPUNG",3,64,56,120
https://kawalpemilu.org#22379,"PARDASUKA TIMUR, PARDASUKA, PRINGSEWU, LAMPUNG",4,163,31,194
https://kawalpemilu.org#22379,"PARDASUKA TIMUR, PARDASUKA, PRINGSEWU, LAMPUNG",5,57,52,109
https://kawalpemilu.org#22379,"PARDASUKA TIMUR, PARDASUKA, PRINGSEWU, LAMPUNG",6,58,56,114
https://kawalpemilu.org#22380,"TANJUNG RUSIA TIMUR, PARDASUKA, PRINGSEWU, LAMPUNG",1,51,71,122
https://kawalpemilu.org#22380,"TANJUNG RUSIA TIMUR, PARDASUKA, PRINGSEWU, LAMPUNG",2,92,85,177
https://kawalpemilu.org#22380,"TANJUNG RUSIA TIMUR, PARDASUKA, PRINGSEWU, LAMPUNG",3,87,32,119
https://kawalpemilu.org#22380,"TANJUNG RUSIA TIMUR, PARDASUKA, PRINGSEWU, LAMPUNG",4,51,51,102
https://kawalpemilu.org#22380,"TANJUNG RUSIA TIMUR, PARDASUKA, PRINGSEWU, LAMPUNG",5,114,45,159
https://kawalpemilu.org#84824,"PARDASUKA SELATAN, PARDASUKA, PRINGSEWU, LAMPUNG",1,101,85,186
https://kawalpemilu.org#84824,"PARDASUKA SELATAN, PARDASUKA, PRINGSEWU, LAMPUNG",2,47,86,133
https://kawalpemilu.org#84824,"PARDASUKA SELATAN, PARDASUKA, PRINGSEWU, LAMPUNG",3,81,95,176
https://kawalpemilu.org#84824,"PARDASUKA SELATAN, PARDASUKA, PRINGSEWU, LAMPUNG",4,50,44,94
https://kawalpemilu.org#84824,"PARDASUKA SELATAN, PARDASUKA, PRINGSEWU, LAMPUNG",5,40,77,117
https://kawalpemilu.org#22382,"CANDI RETNO, PAGELARAN, PRINGSEWU, LAMPUNG",1,157,31,188
https://kawalpemilu.org#22382,"CANDI RETNO, PAGELARAN, PRINGSEWU, LAMPUNG",2,132,90,222
https://kawalpemilu.org#22382,"CANDI RETNO, PAGELARAN, PRINGSEWU, LAMPUNG",3,154,76,230
https://kawalpemilu.org#22382,"CANDI RETNO, PAGELARAN, PRINGSEWU, LAMPUNG",4,100,112,212
https://kawalpemilu.org#22382,"CANDI RETNO, PAGELARAN, PRINGSEWU, LAMPUNG",5,128,77,205
https://kawalpemilu.org#22382,"CANDI RETNO, PAGELARAN, PRINGSEWU, LAMPUNG",7,163,56,219
https://kawalpemilu.org#22382,"CANDI RETNO, PAGELARAN, PRINGSEWU, LAMPUNG",8,86,121,207
https://kawalpemilu.org#22383,"TANJUNG DALOM, PAGELARAN, PRINGSEWU, LAMPUNG",1,63,149,212
https://kawalpemilu.org#22383,"TANJUNG DALOM, PAGELARAN, PRINGSEWU, LAMPUNG",2,137,79,216
https://kawalpemilu.org#22383,"TANJUNG DALOM, PAGELARAN, PRINGSEWU, LAMPUNG",3,118,102,220
https://kawalpemilu.org#22383,"TANJUNG DALOM, PAGELARAN, PRINGSEWU, LAMPUNG",4,38,197,235
https://kawalpemilu.org#22383,"TANJUNG DALOM, PAGELARAN, PRINGSEWU, LAMPUNG",5,130,93,223
https://kawalpemilu.org#22384,"WAY NGISON, PAGELARAN, PRINGSEWU, LAMPUNG",1,154,83,237
https://kawalpemilu.org#22384,"WAY NGISON, PAGELARAN, PRINGSEWU, LAMPUNG",2,188,56,244
https://kawalpemilu.org#22384,"WAY NGISON, PAGELARAN, PRINGSEWU, LAMPUNG",3,184,49,233
https://kawalpemilu.org#22384,"WAY NGISON, PAGELARAN, PRINGSEWU, LAMPUNG",4,136,84,220
https://kawalpemilu.org#22385,"SUKA WANGI, PAGELARAN, PRINGSEWU, LAMPUNG",1,31,126,157
https://kawalpemilu.org#22385,"SUKA WANGI, PAGELARAN, PRINGSEWU, LAMPUNG",2,24,77,101
https://kawalpemilu.org#22385,"SUKA WANGI, PAGELARAN, PRINGSEWU, LAMPUNG",3,11,108,119
https://kawalpemilu.org#22386,"SUKA RATU, PAGELARAN, PRINGSEWU, LAMPUNG",1,45,139,184
https://kawalpemilu.org#22386,"SUKA RATU, PAGELARAN, PRINGSEWU, LAMPUNG",2,26,160,186
https://kawalpemilu.org#22386,"SUKA RATU, PAGELARAN, PRINGSEWU, LAMPUNG",3,38,108,146
https://kawalpemilu.org#22386,"SUKA RATU, PAGELARAN, PRINGSEWU, LAMPUNG",4,0,0,0
https://kawalpemilu.org#22386,"SUKA RATU, PAGELARAN, PRINGSEWU, LAMPUNG",5,96,58,154
https://kawalpemilu.org#22386,"SUKA RATU, PAGELARAN, PRINGSEWU, LAMPUNG",6,67,61,128
https://kawalpemilu.org#22387,"PAGELARAN, PAGELARAN, PRINGSEWU, LAMPUNG",1,52,167,219
https://kawalpemilu.org#22387,"PAGELARAN, PAGELARAN, PRINGSEWU, LAMPUNG",2,88,118,206
https://kawalpemilu.org#22387,"PAGELARAN, PAGELARAN, PRINGSEWU, LAMPUNG",3,79,166,245
https://kawalpemilu.org#22387,"PAGELARAN, PAGELARAN, PRINGSEWU, LAMPUNG",4,118,132,250
https://kawalpemilu.org#22387,"PAGELARAN, PAGELARAN, PRINGSEWU, LAMPUNG",5,103,130,233
https://kawalpemilu.org#22387,"PAGELARAN, PAGELARAN, PRINGSEWU, LAMPUNG",6,131,96,227
https://kawalpemilu.org#22387,"PAGELARAN, PAGELARAN, PRINGSEWU, LAMPUNG",7,115,112,227
https://kawalpemilu.org#22387,"PAGELARAN, PAGELARAN, PRINGSEWU, LAMPUNG",8,123,107,230
https://kawalpemilu.org#22387,"PAGELARAN, PAGELARAN, PRINGSEWU, LAMPUNG",9,59,142,201
https://kawalpemilu.org#22387,"PAGELARAN, PAGELARAN, PRINGSEWU, LAMPUNG",10,66,141,207
https://kawalpemilu.org#22387,"PAGELARAN, PAGELARAN, PRINGSEWU, LAMPUNG",11,93,62,155
https://kawalpemilu.org#22387,"PAGELARAN, PAGELARAN, PRINGSEWU, LAMPUNG",12,102,94,196
https://kawalpemilu.org#22387,"PAGELARAN, PAGELARAN, PRINGSEWU, LAMPUNG",13,114,76,190
https://kawalpemilu.org#22388,"PATOMAN, PAGELARAN, PRINGSEWU, LAMPUNG",1,203,57,260
https://kawalpemilu.org#22388,"PATOMAN, PAGELARAN, PRINGSEWU, LAMPUNG",2,159,82,241
https://kawalpemilu.org#22388,"PATOMAN, PAGELARAN, PRINGSEWU, LAMPUNG",3,167,69,236
https://kawalpemilu.org#22388,"PATOMAN, PAGELARAN, PRINGSEWU, LAMPUNG",4,152,96,248
https://kawalpemilu.org#22388,"PATOMAN, PAGELARAN, PRINGSEWU, LAMPUNG",5,113,39,152
https://kawalpemilu.org#22388,"PATOMAN, PAGELARAN, PRINGSEWU, LAMPUNG",6,137,94,231
https://kawalpemilu.org#22388,"PATOMAN, PAGELARAN, PRINGSEWU, LAMPUNG",7,143,99,242
https://kawalpemilu.org#22388,"PATOMAN, PAGELARAN, PRINGSEWU, LAMPUNG",8,135,75,210
https://kawalpemilu.org#22388,"PATOMAN, PAGELARAN, PRINGSEWU, LAMPUNG",9,85,106,191
https://kawalpemilu.org#22388,"PATOMAN, PAGELARAN, PRINGSEWU, LAMPUNG",10,171,65,236
https://kawalpemilu.org#22388,"PATOMAN, PAGELARAN, PRINGSEWU, LAMPUNG",11,129,104,233
https://kawalpemilu.org#22389,"KARANG SARI, PAGELARAN, PRINGSEWU, LAMPUNG",1,105,141,246
https://kawalpemilu.org#22389,"KARANG SARI, PAGELARAN, PRINGSEWU, LAMPUNG",2,153,92,245
https://kawalpemilu.org#22389,"KARANG SARI, PAGELARAN, PRINGSEWU, LAMPUNG",3,135,94,229
https://kawalpemilu.org#22389,"KARANG SARI, PAGELARAN, PRINGSEWU, LAMPUNG",4,200,31,231
https://kawalpemilu.org#22389,"KARANG SARI, PAGELARAN, PRINGSEWU, LAMPUNG",5,156,72,228
https://kawalpemilu.org#22389,"KARANG SARI, PAGELARAN, PRINGSEWU, LAMPUNG",6,170,101,271
https://kawalpemilu.org#22389,"KARANG SARI, PAGELARAN, PRINGSEWU, LAMPUNG",7,158,88,246
https://kawalpemilu.org#22389,"KARANG SARI, PAGELARAN, PRINGSEWU, LAMPUNG",8,142,83,225
https://kawalpemilu.org#22389,"KARANG SARI, PAGELARAN, PRINGSEWU, LAMPUNG",9,165,77,242
https://kawalpemilu.org#22390,"GUMUK MAS, PAGELARAN, PRINGSEWU, LAMPUNG",1,129,129,258
https://kawalpemilu.org#22390,"GUMUK MAS, PAGELARAN, PRINGSEWU, LAMPUNG",2,170,82,252
https://kawalpemilu.org#22390,"GUMUK MAS, PAGELARAN, PRINGSEWU, LAMPUNG",3,170,88,258
https://kawalpemilu.org#22390,"GUMUK MAS, PAGELARAN, PRINGSEWU, LAMPUNG",4,104,147,251
https://kawalpemilu.org#22390,"GUMUK MAS, PAGELARAN, PRINGSEWU, LAMPUNG",5,117,147,264
https://kawalpemilu.org#22390,"GUMUK MAS, PAGELARAN, PRINGSEWU, LAMPUNG",6,111,64,175
https://kawalpemilu.org#22390,"GUMUK MAS, PAGELARAN, PRINGSEWU, LAMPUNG",7,81,169,250
https://kawalpemilu.org#22390,"GUMUK MAS, PAGELARAN, PRINGSEWU, LAMPUNG",8,164,79,243
https://kawalpemilu.org#22391,"BUMI RATU, PAGELARAN, PRINGSEWU, LAMPUNG",1,185,62,247
https://kawalpemilu.org#22391,"BUMI RATU, PAGELARAN, PRINGSEWU, LAMPUNG",2,181,69,250
https://kawalpemilu.org#22391,"BUMI RATU, PAGELARAN, PRINGSEWU, LAMPUNG",3,198,48,246
https://kawalpemilu.org#22391,"BUMI RATU, PAGELARAN, PRINGSEWU, LAMPUNG",4,207,26,233
https://kawalpemilu.org#22391,"BUMI RATU, PAGELARAN, PRINGSEWU, LAMPUNG",5,181,72,253
https://kawalpemilu.org#22391,"BUMI RATU, PAGELARAN, PRINGSEWU, LAMPUNG",6,202,50,252
https://kawalpemilu.org#22391,"BUMI RATU, PAGELARAN, PRINGSEWU, LAMPUNG",7,206,44,250
https://kawalpemilu.org#22392,"PANUTAN, PAGELARAN, PRINGSEWU, LAMPUNG",1,155,49,204
https://kawalpemilu.org#22392,"PANUTAN, PAGELARAN, PRINGSEWU, LAMPUNG",2,144,55,199
https://kawalpemilu.org#22392,"PANUTAN, PAGELARAN, PRINGSEWU, LAMPUNG",3,162,61,223
https://kawalpemilu.org#22392,"PANUTAN, PAGELARAN, PRINGSEWU, LAMPUNG",4,117,96,213
https://kawalpemilu.org#22392,"PANUTAN, PAGELARAN, PRINGSEWU, LAMPUNG",5,133,83,216
https://kawalpemilu.org#22392,"PANUTAN, PAGELARAN, PRINGSEWU, LAMPUNG",6,146,74,220
https://kawalpemilu.org#22392,"PANUTAN, PAGELARAN, PRINGSEWU, LAMPUNG",7,130,47,177
https://kawalpemilu.org#22392,"PANUTAN, PAGELARAN, PRINGSEWU, LAMPUNG",8,116,38,154
https://kawalpemilu.org#22392,"PANUTAN, PAGELARAN, PRINGSEWU, LAMPUNG",9,148,54,202
https://kawalpemilu.org#22393,"LUGUSARI, PAGELARAN, PRINGSEWU, LAMPUNG",1,180,45,225
https://kawalpemilu.org#22393,"LUGUSARI, PAGELARAN, PRINGSEWU, LAMPUNG",2,75,154,229
https://kawalpemilu.org#22393,"LUGUSARI, PAGELARAN, PRINGSEWU, LAMPUNG",3,143,81,224
https://kawalpemilu.org#22393,"LUGUSARI, PAGELARAN, PRINGSEWU, LAMPUNG",4,108,100,208
https://kawalpemilu.org#22393,"LUGUSARI, PAGELARAN, PRINGSEWU, LAMPUNG",5,76,115,191
https://kawalpemilu.org#22393,"LUGUSARI, PAGELARAN, PRINGSEWU, LAMPUNG",6,97,111,208
https://kawalpemilu.org#22393,"LUGUSARI, PAGELARAN, PRINGSEWU, LAMPUNG",7,170,40,210
https://kawalpemilu.org#22393,"LUGUSARI, PAGELARAN, PRINGSEWU, LAMPUNG",8,143,79,222
https://kawalpemilu.org#22393,"LUGUSARI, PAGELARAN, PRINGSEWU, LAMPUNG",9,70,109,179
https://kawalpemilu.org#22400,"PAMENANG, PAGELARAN, PRINGSEWU, LAMPUNG",1,188,35,223
https://kawalpemilu.org#22400,"PAMENANG, PAGELARAN, PRINGSEWU, LAMPUNG",2,149,48,197
https://kawalpemilu.org#22400,"PAMENANG, PAGELARAN, PRINGSEWU, LAMPUNG",3,147,66,213
https://kawalpemilu.org#22400,"PAMENANG, PAGELARAN, PRINGSEWU, LAMPUNG",4,132,61,193
https://kawalpemilu.org#22400,"PAMENANG, PAGELARAN, PRINGSEWU, LAMPUNG",5,79,111,190
https://kawalpemilu.org#22400,"PAMENANG, PAGELARAN, PRINGSEWU, LAMPUNG",6,148,61,209
https://kawalpemilu.org#22400,"PAMENANG, PAGELARAN, PRINGSEWU, LAMPUNG",7,127,59,186
https://kawalpemilu.org#22400,"PAMENANG, PAGELARAN, PRINGSEWU, LAMPUNG",8,199,17,216
https://kawalpemilu.org#22400,"PAMENANG, PAGELARAN, PRINGSEWU, LAMPUNG",9,122,75,197
https://kawalpemilu.org#22400,"PAMENANG, PAGELARAN, PRINGSEWU, LAMPUNG",10,122,48,170
https://kawalpemilu.org#22400,"PAMENANG, PAGELARAN, PRINGSEWU, LAMPUNG",11,117,56,173
https://kawalpemilu.org#22400,"PAMENANG, PAGELARAN, PRINGSEWU, LAMPUNG",12,162,44,206
https://kawalpemilu.org#22401,"GEMAH RIPAH, PAGELARAN, PRINGSEWU, LAMPUNG",1,143,56,199
https://kawalpemilu.org#22401,"GEMAH RIPAH, PAGELARAN, PRINGSEWU, LAMPUNG",2,130,64,194
https://kawalpemilu.org#22401,"GEMAH RIPAH, PAGELARAN, PRINGSEWU, LAMPUNG",3,139,75,214
https://kawalpemilu.org#22401,"GEMAH RIPAH, PAGELARAN, PRINGSEWU, LAMPUNG",4,148,61,209
https://kawalpemilu.org#22401,"GEMAH RIPAH, PAGELARAN, PRINGSEWU, LAMPUNG",5,144,41,185
https://kawalpemilu.org#22404,"PASIR UKIR, PAGELARAN, PRINGSEWU, LAMPUNG",1,166,69,235
https://kawalpemilu.org#22404,"PASIR UKIR, PAGELARAN, PRINGSEWU, LAMPUNG",2,170,57,227
https://kawalpemilu.org#22404,"PASIR UKIR, PAGELARAN, PRINGSEWU, LAMPUNG",3,130,76,206
https://kawalpemilu.org#22404,"PASIR UKIR, PAGELARAN, PRINGSEWU, LAMPUNG",4,114,76,190
https://kawalpemilu.org#22404,"PASIR UKIR, PAGELARAN, PRINGSEWU, LAMPUNG",5,121,78,199
https://kawalpemilu.org#22405,"GUMUKREJO, PAGELARAN, PRINGSEWU, LAMPUNG",1,110,118,228
https://kawalpemilu.org#22405,"GUMUKREJO, PAGELARAN, PRINGSEWU, LAMPUNG",2,119,108,227
https://kawalpemilu.org#22405,"GUMUKREJO, PAGELARAN, PRINGSEWU, LAMPUNG",3,165,84,249
https://kawalpemilu.org#22405,"GUMUKREJO, PAGELARAN, PRINGSEWU, LAMPUNG",4,149,80,229
https://kawalpemilu.org#22405,"GUMUKREJO, PAGELARAN, PRINGSEWU, LAMPUNG",5,184,48,232
https://kawalpemilu.org#22405,"GUMUKREJO, PAGELARAN, PRINGSEWU, LAMPUNG",6,206,51,257
https://kawalpemilu.org#22405,"GUMUKREJO, PAGELARAN, PRINGSEWU, LAMPUNG",7,148,94,242
https://kawalpemilu.org#84825,"PUJI HARJO, PAGELARAN, PRINGSEWU, LAMPUNG",1,135,106,241
https://kawalpemilu.org#84825,"PUJI HARJO, PAGELARAN, PRINGSEWU, LAMPUNG",2,139,85,224
https://kawalpemilu.org#84825,"PUJI HARJO, PAGELARAN, PRINGSEWU, LAMPUNG",3,118,94,212
https://kawalpemilu.org#84825,"PUJI HARJO, PAGELARAN, PRINGSEWU, LAMPUNG",4,99,94,193
https://kawalpemilu.org#88006,"PADANG REJO, PAGELARAN, PRINGSEWU, LAMPUNG",1,134,109,243
https://kawalpemilu.org#88006,"PADANG REJO, PAGELARAN, PRINGSEWU, LAMPUNG",2,131,81,212
https://kawalpemilu.org#88006,"PADANG REJO, PAGELARAN, PRINGSEWU, LAMPUNG",3,146,85,231
https://kawalpemilu.org#88006,"PADANG REJO, PAGELARAN, PRINGSEWU, LAMPUNG",4,111,36,147
https://kawalpemilu.org#88007,"SIDODADI, PAGELARAN, PRINGSEWU, LAMPUNG",1,166,53,219
https://kawalpemilu.org#88007,"SIDODADI, PAGELARAN, PRINGSEWU, LAMPUNG",2,155,69,224
https://kawalpemilu.org#88007,"SIDODADI, PAGELARAN, PRINGSEWU, LAMPUNG",3,150,67,217
https://kawalpemilu.org#88007,"SIDODADI, PAGELARAN, PRINGSEWU, LAMPUNG",4,147,37,184
https://kawalpemilu.org#88008,"SUMBER REJO, PAGELARAN, PRINGSEWU, LAMPUNG",1,166,46,212
https://kawalpemilu.org#88008,"SUMBER REJO, PAGELARAN, PRINGSEWU, LAMPUNG",2,191,50,241
https://kawalpemilu.org#88008,"SUMBER REJO, PAGELARAN, PRINGSEWU, LAMPUNG",3,202,50,252
https://kawalpemilu.org#88008,"SUMBER REJO, PAGELARAN, PRINGSEWU, LAMPUNG",4,142,83,225
https://kawalpemilu.org#88008,"SUMBER REJO, PAGELARAN, PRINGSEWU, LAMPUNG",5,209,25,234
https://kawalpemilu.org#88009,"GANJARAN, PAGELARAN, PRINGSEWU, LAMPUNG",1,190,76,266
https://kawalpemilu.org#88009,"GANJARAN, PAGELARAN, PRINGSEWU, LAMPUNG",2,134,101,235
https://kawalpemilu.org#88009,"GANJARAN, PAGELARAN, PRINGSEWU, LAMPUNG",3,119,134,254
https://kawalpemilu.org#88010,"BUMI REJO, PAGELARAN, PRINGSEWU, LAMPUNG",1,89,125,214
https://kawalpemilu.org#88010,"BUMI REJO, PAGELARAN, PRINGSEWU, LAMPUNG",2,109,106,215
https://kawalpemilu.org#88010,"BUMI REJO, PAGELARAN, PRINGSEWU, LAMPUNG",3,75,133,208
https://kawalpemilu.org#88010,"BUMI REJO, PAGELARAN, PRINGSEWU, LAMPUNG",4,104,110,214
https://kawalpemilu.org#22407,"BANYUMAS, BANYUMAS, PRINGSEWU, LAMPUNG",1,106,31,137
https://kawalpemilu.org#22407,"BANYUMAS, BANYUMAS, PRINGSEWU, LAMPUNG",2,137,67,204
https://kawalpemilu.org#22407,"BANYUMAS, BANYUMAS, PRINGSEWU, LAMPUNG",3,95,56,151
https://kawalpemilu.org#22407,"BANYUMAS, BANYUMAS, PRINGSEWU, LAMPUNG",4,115,67,182
https://kawalpemilu.org#22407,"BANYUMAS, BANYUMAS, PRINGSEWU, LAMPUNG",5,140,38,178
https://kawalpemilu.org#22407,"BANYUMAS, BANYUMAS, PRINGSEWU, LAMPUNG",6,141,29,170
https://kawalpemilu.org#22407,"BANYUMAS, BANYUMAS, PRINGSEWU, LAMPUNG",7,121,93,214
https://kawalpemilu.org#22407,"BANYUMAS, BANYUMAS, PRINGSEWU, LAMPUNG",8,109,60,169
https://kawalpemilu.org#22407,"BANYUMAS, BANYUMAS, PRINGSEWU, LAMPUNG",9,78,46,124
https://kawalpemilu.org#22407,"BANYUMAS, BANYUMAS, PRINGSEWU, LAMPUNG",10,81,33,114
https://kawalpemilu.org#22407,"BANYUMAS, BANYUMAS, PRINGSEWU, LAMPUNG",11,101,30,131
https://kawalpemilu.org#22408,"BANYUWANGI, BANYUMAS, PRINGSEWU, LAMPUNG",1,68,94,162
https://kawalpemilu.org#22408,"BANYUWANGI, BANYUMAS, PRINGSEWU, LAMPUNG",2,53,68,121
https://kawalpemilu.org#22408,"BANYUWANGI, BANYUMAS, PRINGSEWU, LAMPUNG",3,108,106,214
https://kawalpemilu.org#22408,"BANYUWANGI, BANYUMAS, PRINGSEWU, LAMPUNG",4,87,82,169
https://kawalpemilu.org#22408,"BANYUWANGI, BANYUMAS, PRINGSEWU, LAMPUNG",5,96,57,153
https://kawalpemilu.org#22408,"BANYUWANGI, BANYUMAS, PRINGSEWU, LAMPUNG",6,76,40,116
https://kawalpemilu.org#22408,"BANYUWANGI, BANYUMAS, PRINGSEWU, LAMPUNG",7,74,49,123
https://kawalpemilu.org#22408,"BANYUWANGI, BANYUMAS, PRINGSEWU, LAMPUNG",8,94,22,116
https://kawalpemilu.org#22408,"BANYUWANGI, BANYUMAS, PRINGSEWU, LAMPUNG",9,76,37,113
https://kawalpemilu.org#22408,"BANYUWANGI, BANYUMAS, PRINGSEWU, LAMPUNG",10,69,78,147
https://kawalpemilu.org#22408,"BANYUWANGI, BANYUMAS, PRINGSEWU, LAMPUNG",11,60,75,135
https://kawalpemilu.org#22408,"BANYUWANGI, BANYUMAS, PRINGSEWU, LAMPUNG",12,103,59,162
https://kawalpemilu.org#22408,"BANYUWANGI, BANYUMAS, PRINGSEWU, LAMPUNG",13,112,41,153
https://kawalpemilu.org#22408,"BANYUWANGI, BANYUMAS, PRINGSEWU, LAMPUNG",14,84,44,128
https://kawalpemilu.org#22408,"BANYUWANGI, BANYUMAS, PRINGSEWU, LAMPUNG",15,111,26,137
https://kawalpemilu.org#22408,"BANYUWANGI, BANYUMAS, PRINGSEWU, LAMPUNG",16,75,33,108
https://kawalpemilu.org#22408,"BANYUWANGI, BANYUMAS, PRINGSEWU, LAMPUNG",17,97,32,129
https://kawalpemilu.org#22409,"SUKAMULYA, BANYUMAS, PRINGSEWU, LAMPUNG",1,129,44,173
https://kawalpemilu.org#22409,"SUKAMULYA, BANYUMAS, PRINGSEWU, LAMPUNG",2,111,74,185
https://kawalpemilu.org#22409,"SUKAMULYA, BANYUMAS, PRINGSEWU, LAMPUNG",3,126,58,184
https://kawalpemilu.org#22409,"SUKAMULYA, BANYUMAS, PRINGSEWU, LAMPUNG",4,107,66,173
https://kawalpemilu.org#22409,"SUKAMULYA, BANYUMAS, PRINGSEWU, LAMPUNG",5,136,77,213
https://kawalpemilu.org#22409,"SUKAMULYA, BANYUMAS, PRINGSEWU, LAMPUNG",6,114,68,182
https://kawalpemilu.org#22409,"SUKAMULYA, BANYUMAS, PRINGSEWU, LAMPUNG",7,146,48,194
https://kawalpemilu.org#22410,"SRIWUNGU, BANYUMAS, PRINGSEWU, LAMPUNG",1,93,50,143
https://kawalpemilu.org#22410,"SRIWUNGU, BANYUMAS, PRINGSEWU, LAMPUNG",2,98,66,164
https://kawalpemilu.org#22410,"SRIWUNGU, BANYUMAS, PRINGSEWU, LAMPUNG",3,73,50,123
https://kawalpemilu.org#22410,"SRIWUNGU, BANYUMAS, PRINGSEWU, LAMPUNG",4,95,50,145
https://kawalpemilu.org#22410,"SRIWUNGU, BANYUMAS, PRINGSEWU, LAMPUNG",5,96,38,134
https://kawalpemilu.org#22411,"BANJAREJO, BANYUMAS, PRINGSEWU, LAMPUNG",1,88,63,151
https://kawalpemilu.org#22411,"BANJAREJO, BANYUMAS, PRINGSEWU, LAMPUNG",2,133,109,242
https://kawalpemilu.org#22411,"BANJAREJO, BANYUMAS, PRINGSEWU, LAMPUNG",3,189,44,233
https://kawalpemilu.org#22411,"BANJAREJO, BANYUMAS, PRINGSEWU, LAMPUNG",4,183,37,220
https://kawalpemilu.org#22411,"BANJAREJO, BANYUMAS, PRINGSEWU, LAMPUNG",5,111,59,170
https://kawalpemilu.org#22411,"BANJAREJO, BANYUMAS, PRINGSEWU, LAMPUNG",6,32,97,129
https://kawalpemilu.org#22411,"BANJAREJO, BANYUMAS, PRINGSEWU, LAMPUNG",7,92,86,178
https://kawalpemilu.org#22412,"WAYA KRUI, BANYUMAS, PRINGSEWU, LAMPUNG",1,121,95,216
https://kawalpemilu.org#22412,"WAYA KRUI, BANYUMAS, PRINGSEWU, LAMPUNG",2,62,68,130
https://kawalpemilu.org#22412,"WAYA KRUI, BANYUMAS, PRINGSEWU, LAMPUNG",3,45,81,126
https://kawalpemilu.org#22413,"SRI RAHAYU, BANYUMAS, PRINGSEWU, LAMPUNG",1,106,104,210
https://kawalpemilu.org#22413,"SRI RAHAYU, BANYUMAS, PRINGSEWU, LAMPUNG",2,116,73,189
https://kawalpemilu.org#22413,"SRI RAHAYU, BANYUMAS, PRINGSEWU, LAMPUNG",3,114,97,211
https://kawalpemilu.org#22413,"SRI RAHAYU, BANYUMAS, PRINGSEWU, LAMPUNG",4,74,97,171
https://kawalpemilu.org#22413,"SRI RAHAYU, BANYUMAS, PRINGSEWU, LAMPUNG",5,110,58,168
https://kawalpemilu.org#22414,"NUSA WUNGU, BANYUMAS, PRINGSEWU, LAMPUNG",1,47,74,121
https://kawalpemilu.org#22414,"NUSA WUNGU, BANYUMAS, PRINGSEWU, LAMPUNG",2,78,57,135
https://kawalpemilu.org#22414,"NUSA WUNGU, BANYUMAS, PRINGSEWU, LAMPUNG",3,140,82,222
https://kawalpemilu.org#22414,"NUSA WUNGU, BANYUMAS, PRINGSEWU, LAMPUNG",4,99,41,140
https://kawalpemilu.org#22414,"NUSA WUNGU, BANYUMAS, PRINGSEWU, LAMPUNG",5,75,61,136
https://kawalpemilu.org#22415,"SINAR MULIA, BANYUMAS, PRINGSEWU, LAMPUNG",1,116,44,160
https://kawalpemilu.org#22415,"SINAR MULIA, BANYUMAS, PRINGSEWU, LAMPUNG",2,113,55,168
https://kawalpemilu.org#22415,"SINAR MULIA, BANYUMAS, PRINGSEWU, LAMPUNG",3,80,64,144
https://kawalpemilu.org#22415,"SINAR MULIA, BANYUMAS, PRINGSEWU, LAMPUNG",4,105,50,155
https://kawalpemilu.org#22415,"SINAR MULIA, BANYUMAS, PRINGSEWU, LAMPUNG",5,110,59,169
https://kawalpemilu.org#22415,"SINAR MULIA, BANYUMAS, PRINGSEWU, LAMPUNG",6,0,0,0
https://kawalpemilu.org#88013,"BANYU URIP, BANYUMAS, PRINGSEWU, LAMPUNG",1,129,47,176
https://kawalpemilu.org#88013,"BANYU URIP, BANYUMAS, PRINGSEWU, LAMPUNG",2,74,60,134
https://kawalpemilu.org#88013,"BANYU URIP, BANYUMAS, PRINGSEWU, LAMPUNG",3,84,46,130
https://kawalpemilu.org#88013,"BANYU URIP, BANYUMAS, PRINGSEWU, LAMPUNG",4,91,32,123
https://kawalpemilu.org#88013,"BANYU URIP, BANYUMAS, PRINGSEWU, LAMPUNG",5,109,73,182
https://kawalpemilu.org#88013,"BANYU URIP, BANYUMAS, PRINGSEWU, LAMPUNG",6,57,67,124
https://kawalpemilu.org#88013,"BANYU URIP, BANYUMAS, PRINGSEWU, LAMPUNG",7,84,36,120
https://kawalpemilu.org#88013,"BANYU URIP, BANYUMAS, PRINGSEWU, LAMPUNG",8,84,29,113
https://kawalpemilu.org#88014,"MULYO REJO, BANYUMAS, PRINGSEWU, LAMPUNG",1,102,47,149
https://kawalpemilu.org#88014,"MULYO REJO, BANYUMAS, PRINGSEWU, LAMPUNG",2,105,23,128
https://kawalpemilu.org#88014,"MULYO REJO, BANYUMAS, PRINGSEWU, LAMPUNG",3,96,41,137
https://kawalpemilu.org#88014,"MULYO REJO, BANYUMAS, PRINGSEWU, LAMPUNG",4,95,20,115
https://kawalpemilu.org#22417,"ADI LUWIH, ADILUWIH, PRINGSEWU, LAMPUNG",1,158,41,199
https://kawalpemilu.org#22417,"ADI LUWIH, ADILUWIH, PRINGSEWU, LAMPUNG",2,149,46,195
https://kawalpemilu.org#22417,"ADI LUWIH, ADILUWIH, PRINGSEWU, LAMPUNG",3,132,60,192
https://kawalpemilu.org#22417,"ADI LUWIH, ADILUWIH, PRINGSEWU, LAMPUNG",4,151,41,192
https://kawalpemilu.org#22417,"ADI LUWIH, ADILUWIH, PRINGSEWU, LAMPUNG",5,154,79,233
https://kawalpemilu.org#22417,"ADI LUWIH, ADILUWIH, PRINGSEWU, LAMPUNG",6,151,67,218
https://kawalpemilu.org#22417,"ADI LUWIH, ADILUWIH, PRINGSEWU, LAMPUNG",7,152,88,240
https://kawalpemilu.org#22417,"ADI LUWIH, ADILUWIH, PRINGSEWU, LAMPUNG",8,156,77,233
https://kawalpemilu.org#22417,"ADI LUWIH, ADILUWIH, PRINGSEWU, LAMPUNG",9,145,62,207
https://kawalpemilu.org#22417,"ADI LUWIH, ADILUWIH, PRINGSEWU, LAMPUNG",10,153,71,224
https://kawalpemilu.org#22418,"BANDUNG BARU, ADILUWIH, PRINGSEWU, LAMPUNG",1,152,57,209
https://kawalpemilu.org#22418,"BANDUNG BARU, ADILUWIH, PRINGSEWU, LAMPUNG",2,145,51,196
https://kawalpemilu.org#22418,"BANDUNG BARU, ADILUWIH, PRINGSEWU, LAMPUNG",3,127,67,194
https://kawalpemilu.org#22418,"BANDUNG BARU, ADILUWIH, PRINGSEWU, LAMPUNG",4,105,124,229
https://kawalpemilu.org#22418,"BANDUNG BARU, ADILUWIH, PRINGSEWU, LAMPUNG",5,115,93,208
https://kawalpemilu.org#22418,"BANDUNG BARU, ADILUWIH, PRINGSEWU, LAMPUNG",6,101,111,212
https://kawalpemilu.org#22418,"BANDUNG BARU, ADILUWIH, PRINGSEWU, LAMPUNG",7,126,87,213
https://kawalpemilu.org#22418,"BANDUNG BARU, ADILUWIH, PRINGSEWU, LAMPUNG",8,122,75,197
https://kawalpemilu.org#22418,"BANDUNG BARU, ADILUWIH, PRINGSEWU, LAMPUNG",9,101,96,197
https://kawalpemilu.org#22418,"BANDUNG BARU, ADILUWIH, PRINGSEWU, LAMPUNG",10,115,96,211
https://kawalpemilu.org#22418,"BANDUNG BARU, ADILUWIH, PRINGSEWU, LAMPUNG",11,117,61,178
https://kawalpemilu.org#22418,"BANDUNG BARU, ADILUWIH, PRINGSEWU, LAMPUNG",12,142,83,225
https://kawalpemilu.org#22418,"BANDUNG BARU, ADILUWIH, PRINGSEWU, LAMPUNG",13,128,51,179
https://kawalpemilu.org#22418,"BANDUNG BARU, ADILUWIH, PRINGSEWU, LAMPUNG",14,105,70,175
https://kawalpemilu.org#22418,"BANDUNG BARU, ADILUWIH, PRINGSEWU, LAMPUNG",15,122,82,204
https://kawalpemilu.org#22418,"BANDUNG BARU, ADILUWIH, PRINGSEWU, LAMPUNG",16,143,66,209
https://kawalpemilu.org#22419,"SINAR WAYA, ADILUWIH, PRINGSEWU, LAMPUNG",1,37,129,166
https://kawalpemilu.org#22419,"SINAR WAYA, ADILUWIH, PRINGSEWU, LAMPUNG",2,38,134,172
https://kawalpemilu.org#22419,"SINAR WAYA, ADILUWIH, PRINGSEWU, LAMPUNG",3,31,122,153
https://kawalpemilu.org#22420,"ENGGAL REJO, ADILUWIH, PRINGSEWU, LAMPUNG",1,117,103,220
https://kawalpemilu.org#22420,"ENGGAL REJO, ADILUWIH, PRINGSEWU, LAMPUNG",2,86,114,200
https://kawalpemilu.org#22420,"ENGGAL REJO, ADILUWIH, PRINGSEWU, LAMPUNG",3,112,111,223
https://kawalpemilu.org#22420,"ENGGAL REJO, ADILUWIH, PRINGSEWU, LAMPUNG",4,134,68,202
https://kawalpemilu.org#22421,"SUKOHARUM, ADILUWIH, PRINGSEWU, LAMPUNG",1,110,48,158
https://kawalpemilu.org#22421,"SUKOHARUM, ADILUWIH, PRINGSEWU, LAMPUNG",2,131,48,179
https://kawalpemilu.org#22421,"SUKOHARUM, ADILUWIH, PRINGSEWU, LAMPUNG",3,160,37,197
https://kawalpemilu.org#22421,"SUKOHARUM, ADILUWIH, PRINGSEWU, LAMPUNG",4,152,42,194
https://kawalpemilu.org#22421,"SUKOHARUM, ADILUWIH, PRINGSEWU, LAMPUNG",5,154,53,207
https://kawalpemilu.org#22421,"SUKOHARUM, ADILUWIH, PRINGSEWU, LAMPUNG",6,123,32,155
https://kawalpemilu.org#22422,"WARINGIN SARI TIMUR, ADILUWIH, PRINGSEWU, LAMPUNG",1,129,85,214
https://kawalpemilu.org#22422,"WARINGIN SARI TIMUR, ADILUWIH, PRINGSEWU, LAMPUNG",2,168,64,232
https://kawalpemilu.org#22422,"WARINGIN SARI TIMUR, ADILUWIH, PRINGSEWU, LAMPUNG",3,68,118,186
https://kawalpemilu.org#22422,"WARINGIN SARI TIMUR, ADILUWIH, PRINGSEWU, LAMPUNG",4,70,127,197
https://kawalpemilu.org#22422,"WARINGIN SARI TIMUR, ADILUWIH, PRINGSEWU, LAMPUNG",5,112,79,191
https://kawalpemilu.org#22422,"WARINGIN SARI TIMUR, ADILUWIH, PRINGSEWU, LAMPUNG",6,137,84,221
https://kawalpemilu.org#22422,"WARINGIN SARI TIMUR, ADILUWIH, PRINGSEWU, LAMPUNG",7,122,76,198
https://kawalpemilu.org#22422,"WARINGIN SARI TIMUR, ADILUWIH, PRINGSEWU, LAMPUNG",8,172,23,195
https://kawalpemilu.org#22422,"WARINGIN SARI TIMUR, ADILUWIH, PRINGSEWU, LAMPUNG",9,145,74,219
https://kawalpemilu.org#22422,"WARINGIN SARI TIMUR, ADILUWIH, PRINGSEWU, LAMPUNG",10,100,107,207
https://kawalpemilu.org#22422,"WARINGIN SARI TIMUR, ADILUWIH, PRINGSEWU, LAMPUNG",11,128,7,135
https://kawalpemilu.org#22422,"WARINGIN SARI TIMUR, ADILUWIH, PRINGSEWU, LAMPUNG",12,121,44,165
https://kawalpemilu.org#22422,"WARINGIN SARI TIMUR, ADILUWIH, PRINGSEWU, LAMPUNG",13,57,86,143
https://kawalpemilu.org#22422,"WARINGIN SARI TIMUR, ADILUWIH, PRINGSEWU, LAMPUNG",14,73,34,107
https://kawalpemilu.org#22422,"WARINGIN SARI TIMUR, ADILUWIH, PRINGSEWU, LAMPUNG",15,130,36,166
https://kawalpemilu.org#22422,"WARINGIN SARI TIMUR, ADILUWIH, PRINGSEWU, LAMPUNG",16,115,7,122
https://kawalpemilu.org#22422,"WARINGIN SARI TIMUR, ADILUWIH, PRINGSEWU, LAMPUNG",17,80,16,96
https://kawalpemilu.org#22423,"TRI TUNGGAL MULYA, ADILUWIH, PRINGSEWU, LAMPUNG",1,154,66,220
https://kawalpemilu.org#22423,"TRI TUNGGAL MULYA, ADILUWIH, PRINGSEWU, LAMPUNG",2,123,92,215
https://kawalpemilu.org#22423,"TRI TUNGGAL MULYA, ADILUWIH, PRINGSEWU, LAMPUNG",3,136,73,209
https://kawalpemilu.org#22423,"TRI TUNGGAL MULYA, ADILUWIH, PRINGSEWU, LAMPUNG",4,135,78,213
https://kawalpemilu.org#22423,"TRI TUNGGAL MULYA, ADILUWIH, PRINGSEWU, LAMPUNG",6,109,13,122
https://kawalpemilu.org#22424,"PURWODADI, ADILUWIH, PRINGSEWU, LAMPUNG",1,166,32,198
https://kawalpemilu.org#22424,"PURWODADI, ADILUWIH, PRINGSEWU, LAMPUNG",2,127,35,162
https://kawalpemilu.org#22424,"PURWODADI, ADILUWIH, PRINGSEWU, LAMPUNG",3,138,63,201
https://kawalpemilu.org#22424,"PURWODADI, ADILUWIH, PRINGSEWU, LAMPUNG",4,180,56,236
https://kawalpemilu.org#22424,"PURWODADI, ADILUWIH, PRINGSEWU, LAMPUNG",5,148,43,191
https://kawalpemilu.org#22424,"PURWODADI, ADILUWIH, PRINGSEWU, LAMPUNG",6,185,34,219
https://kawalpemilu.org#22424,"PURWODADI, ADILUWIH, PRINGSEWU, LAMPUNG",7,149,55,204
https://kawalpemilu.org#22424,"PURWODADI, ADILUWIH, PRINGSEWU, LAMPUNG",8,124,79,203
https://kawalpemilu.org#22424,"PURWODADI, ADILUWIH, PRINGSEWU, LAMPUNG",9,119,69,188
https://kawalpemilu.org#84826,"TUNGGUL PAWENANG, ADILUWIH, PRINGSEWU, LAMPUNG",1,116,118,234
https://kawalpemilu.org#84826,"TUNGGUL PAWENANG, ADILUWIH, PRINGSEWU, LAMPUNG",2,128,96,224
https://kawalpemilu.org#84826,"TUNGGUL PAWENANG, ADILUWIH, PRINGSEWU, LAMPUNG",3,91,64,155
https://kawalpemilu.org#84826,"TUNGGUL PAWENANG, ADILUWIH, PRINGSEWU, LAMPUNG",4,149,62,211
https://kawalpemilu.org#84826,"TUNGGUL PAWENANG, ADILUWIH, PRINGSEWU, LAMPUNG",5,165,42,207
https://kawalpemilu.org#84827,"BANDUNG BARU BARAT, ADILUWIH, PRINGSEWU, LAMPUNG",1,133,93,226
https://kawalpemilu.org#84827,"BANDUNG BARU BARAT, ADILUWIH, PRINGSEWU, LAMPUNG",2,104,104,208
https://kawalpemilu.org#84827,"BANDUNG BARU BARAT, ADILUWIH, PRINGSEWU, LAMPUNG",3,102,67,169
https://kawalpemilu.org#84827,"BANDUNG BARU BARAT, ADILUWIH, PRINGSEWU, LAMPUNG",4,87,73,160
https://kawalpemilu.org#84827,"BANDUNG BARU BARAT, ADILUWIH, PRINGSEWU, LAMPUNG",5,94,96,190
https://kawalpemilu.org#84827,"BANDUNG BARU BARAT, ADILUWIH, PRINGSEWU, LAMPUNG",6,82,120,202
https://kawalpemilu.org#84828,"TOTOKARTO, ADILUWIH, PRINGSEWU, LAMPUNG",1,151,91,242
https://kawalpemilu.org#84828,"TOTOKARTO, ADILUWIH, PRINGSEWU, LAMPUNG",2,143,65,208
https://kawalpemilu.org#84828,"TOTOKARTO, ADILUWIH, PRINGSEWU, LAMPUNG",3,128,48,176
https://kawalpemilu.org#84828,"TOTOKARTO, ADILUWIH, PRINGSEWU, LAMPUNG",4,174,44,218
https://kawalpemilu.org#84828,"TOTOKARTO, ADILUWIH, PRINGSEWU, LAMPUNG",5,140,65,205
https://kawalpemilu.org#84828,"TOTOKARTO, ADILUWIH, PRINGSEWU, LAMPUNG",6,127,42,169
https://kawalpemilu.org#84828,"TOTOKARTO, ADILUWIH, PRINGSEWU, LAMPUNG",7,160,47,207
https://kawalpemilu.org#84828,"TOTOKARTO, ADILUWIH, PRINGSEWU, LAMPUNG",8,99,81,180
https://kawalpemilu.org#84829,"KUTA WARINGIN, ADILUWIH, PRINGSEWU, LAMPUNG",1,115,98,213
https://kawalpemilu.org#84829,"KUTA WARINGIN, ADILUWIH, PRINGSEWU, LAMPUNG",2,62,122,184
https://kawalpemilu.org#84829,"KUTA WARINGIN, ADILUWIH, PRINGSEWU, LAMPUNG",3,167,43,210
https://kawalpemilu.org#84829,"KUTA WARINGIN, ADILUWIH, PRINGSEWU, LAMPUNG",4,154,59,213
https://kawalpemilu.org#84829,"KUTA WARINGIN, ADILUWIH, PRINGSEWU, LAMPUNG",5,127,42,169
https://kawalpemilu.org#84829,"KUTA WARINGIN, ADILUWIH, PRINGSEWU, LAMPUNG",6,118,61,179
https://kawalpemilu.org#84829,"KUTA WARINGIN, ADILUWIH, PRINGSEWU, LAMPUNG",8,109,49,158
https://kawalpemilu.org#84829,"KUTA WARINGIN, ADILUWIH, PRINGSEWU, LAMPUNG",9,50,84,134
https://kawalpemilu.org#84829,"KUTA WARINGIN, ADILUWIH, PRINGSEWU, LAMPUNG",10,61,67,128
https://kawalpemilu.org#88015,"SRIKATON, ADILUWIH, PRINGSEWU, LAMPUNG",1,161,52,213
https://kawalpemilu.org#88015,"SRIKATON, ADILUWIH, PRINGSEWU, LAMPUNG",2,174,51,225
https://kawalpemilu.org#88015,"SRIKATON, ADILUWIH, PRINGSEWU, LAMPUNG",3,169,36,205
https://kawalpemilu.org#88015,"SRIKATON, ADILUWIH, PRINGSEWU, LAMPUNG",4,137,70,207
https://kawalpemilu.org#88015,"SRIKATON, ADILUWIH, PRINGSEWU, LAMPUNG",5,147,62,209
https://kawalpemilu.org#88015,"SRIKATON, ADILUWIH, PRINGSEWU, LAMPUNG",6,154,31,185
https://kawalpemilu.org#88015,"SRIKATON, ADILUWIH, PRINGSEWU, LAMPUNG",7,175,37,212
https://kawalpemilu.org#88015,"SRIKATON, ADILUWIH, PRINGSEWU, LAMPUNG",8,175,54,229
https://kawalpemilu.org#88015,"SRIKATON, ADILUWIH, PRINGSEWU, LAMPUNG",9,149,53,202
https://kawalpemilu.org#22426,"SINAR BARU, SUKOHARJO, PRINGSEWU, LAMPUNG",1,67,89,156
https://kawalpemilu.org#22426,"SINAR BARU, SUKOHARJO, PRINGSEWU, LAMPUNG",2,38,85,123
https://kawalpemilu.org#22426,"SINAR BARU, SUKOHARJO, PRINGSEWU, LAMPUNG",3,153,59,212
https://kawalpemilu.org#22426,"SINAR BARU, SUKOHARJO, PRINGSEWU, LAMPUNG",4,64,82,146
https://kawalpemilu.org#22426,"SINAR BARU, SUKOHARJO, PRINGSEWU, LAMPUNG",5,91,29,120
https://kawalpemilu.org#22426,"SINAR BARU, SUKOHARJO, PRINGSEWU, LAMPUNG",6,129,64,193
https://kawalpemilu.org#22427,"SUKOHARJO I, SUKOHARJO, PRINGSEWU, LAMPUNG",1,155,96,251
https://kawalpemilu.org#22427,"SUKOHARJO I, SUKOHARJO, PRINGSEWU, LAMPUNG",2,139,29,168
https://kawalpemilu.org#22427,"SUKOHARJO I, SUKOHARJO, PRINGSEWU, LAMPUNG",3,170,47,217
https://kawalpemilu.org#22427,"SUKOHARJO I, SUKOHARJO, PRINGSEWU, LAMPUNG",4,84,80,164
https://kawalpemilu.org#22427,"SUKOHARJO I, SUKOHARJO, PRINGSEWU, LAMPUNG",5,103,113,216
https://kawalpemilu.org#22427,"SUKOHARJO I, SUKOHARJO, PRINGSEWU, LAMPUNG",6,123,88,211
https://kawalpemilu.org#22427,"SUKOHARJO I, SUKOHARJO, PRINGSEWU, LAMPUNG",7,86,67,153
https://kawalpemilu.org#22427,"SUKOHARJO I, SUKOHARJO, PRINGSEWU, LAMPUNG",8,126,65,191
https://kawalpemilu.org#22427,"SUKOHARJO I, SUKOHARJO, PRINGSEWU, LAMPUNG",9,126,88,214
https://kawalpemilu.org#22427,"SUKOHARJO I, SUKOHARJO, PRINGSEWU, LAMPUNG",10,105,76,181
https://kawalpemilu.org#22427,"SUKOHARJO I, SUKOHARJO, PRINGSEWU, LAMPUNG",11,82,19,103
https://kawalpemilu.org#22427,"SUKOHARJO I, SUKOHARJO, PRINGSEWU, LAMPUNG",12,47,51,98
https://kawalpemilu.org#22427,"SUKOHARJO I, SUKOHARJO, PRINGSEWU, LAMPUNG",13,87,31,118
https://kawalpemilu.org#22427,"SUKOHARJO I, SUKOHARJO, PRINGSEWU, LAMPUNG",14,125,76,201
https://kawalpemilu.org#22427,"SUKOHARJO I, SUKOHARJO, PRINGSEWU, LAMPUNG",15,69,45,114
https://kawalpemilu.org#22427,"SUKOHARJO I, SUKOHARJO, PRINGSEWU, LAMPUNG",16,100,19,119
https://kawalpemilu.org#22427,"SUKOHARJO I, SUKOHARJO, PRINGSEWU, LAMPUNG",17,102,58,160
https://kawalpemilu.org#22428,"SUKOHARJO II, SUKOHARJO, PRINGSEWU, LAMPUNG",1,120,61,181
https://kawalpemilu.org#22428,"SUKOHARJO II, SUKOHARJO, PRINGSEWU, LAMPUNG",2,107,54,161
https://kawalpemilu.org#22428,"SUKOHARJO II, SUKOHARJO, PRINGSEWU, LAMPUNG",3,89,66,155
https://kawalpemilu.org#22428,"SUKOHARJO II, SUKOHARJO, PRINGSEWU, LAMPUNG",4,153,70,223
https://kawalpemilu.org#22428,"SUKOHARJO II, SUKOHARJO, PRINGSEWU, LAMPUNG",5,122,89,211
https://kawalpemilu.org#22428,"SUKOHARJO II, SUKOHARJO, PRINGSEWU, LAMPUNG",6,145,41,186
https://kawalpemilu.org#22428,"SUKOHARJO II, SUKOHARJO, PRINGSEWU, LAMPUNG",7,126,68,194
https://kawalpemilu.org#22428,"SUKOHARJO II, SUKOHARJO, PRINGSEWU, LAMPUNG",8,130,60,190
https://kawalpemilu.org#22428,"SUKOHARJO II, SUKOHARJO, PRINGSEWU, LAMPUNG",9,139,55,194
https://kawalpemilu.org#22428,"SUKOHARJO II, SUKOHARJO, PRINGSEWU, LAMPUNG",10,167,78,245
https://kawalpemilu.org#22429,"SUKOHARJO III, SUKOHARJO, PRINGSEWU, LAMPUNG",1,77,76,153
https://kawalpemilu.org#22429,"SUKOHARJO III, SUKOHARJO, PRINGSEWU, LAMPUNG",2,45,89,134
https://kawalpemilu.org#22429,"SUKOHARJO III, SUKOHARJO, PRINGSEWU, LAMPUNG",3,125,48,173
https://kawalpemilu.org#22429,"SUKOHARJO III, SUKOHARJO, PRINGSEWU, LAMPUNG",4,129,91,220
https://kawalpemilu.org#22429,"SUKOHARJO III, SUKOHARJO, PRINGSEWU, LAMPUNG",5,127,94,221
https://kawalpemilu.org#22429,"SUKOHARJO III, SUKOHARJO, PRINGSEWU, LAMPUNG",6,95,90,185
https://kawalpemilu.org#22429,"SUKOHARJO III, SUKOHARJO, PRINGSEWU, LAMPUNG",7,71,74,145
https://kawalpemilu.org#22429,"SUKOHARJO III, SUKOHARJO, PRINGSEWU, LAMPUNG",8,102,64,166
https://kawalpemilu.org#22429,"SUKOHARJO III, SUKOHARJO, PRINGSEWU, LAMPUNG",9,68,80,148
https://kawalpemilu.org#22429,"SUKOHARJO III, SUKOHARJO, PRINGSEWU, LAMPUNG",10,107,106,213
https://kawalpemilu.org#22429,"SUKOHARJO III, SUKOHARJO, PRINGSEWU, LAMPUNG",11,68,67,135
https://kawalpemilu.org#22429,"SUKOHARJO III, SUKOHARJO, PRINGSEWU, LAMPUNG",12,33,83,116
https://kawalpemilu.org#22429,"SUKOHARJO III, SUKOHARJO, PRINGSEWU, LAMPUNG",13,93,82,175
https://kawalpemilu.org#22429,"SUKOHARJO III, SUKOHARJO, PRINGSEWU, LAMPUNG",14,72,85,157
https://kawalpemilu.org#22429,"SUKOHARJO III, SUKOHARJO, PRINGSEWU, LAMPUNG",15,98,49,147
https://kawalpemilu.org#22429,"SUKOHARJO III, SUKOHARJO, PRINGSEWU, LAMPUNG",16,80,79,159
https://kawalpemilu.org#22430,"SUKOHARJO IV, SUKOHARJO, PRINGSEWU, LAMPUNG",1,139,44,183
https://kawalpemilu.org#22430,"SUKOHARJO IV, SUKOHARJO, PRINGSEWU, LAMPUNG",2,147,68,215
https://kawalpemilu.org#22430,"SUKOHARJO IV, SUKOHARJO, PRINGSEWU, LAMPUNG",3,112,50,162
https://kawalpemilu.org#22430,"SUKOHARJO IV, SUKOHARJO, PRINGSEWU, LAMPUNG",4,124,58,182
https://kawalpemilu.org#22430,"SUKOHARJO IV, SUKOHARJO, PRINGSEWU, LAMPUNG",5,165,43,208
https://kawalpemilu.org#22431,"PANGGUNG REJO, SUKOHARJO, PRINGSEWU, LAMPUNG",1,197,44,241
https://kawalpemilu.org#22431,"PANGGUNG REJO, SUKOHARJO, PRINGSEWU, LAMPUNG",2,167,64,231
https://kawalpemilu.org#22431,"PANGGUNG REJO, SUKOHARJO, PRINGSEWU, LAMPUNG",3,158,59,217
https://kawalpemilu.org#22431,"PANGGUNG REJO, SUKOHARJO, PRINGSEWU, LAMPUNG",4,177,37,214
https://kawalpemilu.org#22431,"PANGGUNG REJO, SUKOHARJO, PRINGSEWU, LAMPUNG",5,157,63,220
https://kawalpemilu.org#22431,"PANGGUNG REJO, SUKOHARJO, PRINGSEWU, LAMPUNG",6,164,29,193
https://kawalpemilu.org#22432,"PANDAN SARI, SUKOHARJO, PRINGSEWU, LAMPUNG",1,101,42,143
https://kawalpemilu.org#22432,"PANDAN SARI, SUKOHARJO, PRINGSEWU, LAMPUNG",2,210,54,264
https://kawalpemilu.org#22432,"PANDAN SARI, SUKOHARJO, PRINGSEWU, LAMPUNG",3,126,99,225
https://kawalpemilu.org#22432,"PANDAN SARI, SUKOHARJO, PRINGSEWU, LAMPUNG",4,90,50,140
https://kawalpemilu.org#22432,"PANDAN SARI, SUKOHARJO, PRINGSEWU, LAMPUNG",5,190,37,228
https://kawalpemilu.org#22432,"PANDAN SARI, SUKOHARJO, PRINGSEWU, LAMPUNG",6,101,30,131
https://kawalpemilu.org#22432,"PANDAN SARI, SUKOHARJO, PRINGSEWU, LAMPUNG",7,104,56,160
https://kawalpemilu.org#22432,"PANDAN SARI, SUKOHARJO, PRINGSEWU, LAMPUNG",8,98,50,148
https://kawalpemilu.org#22432,"PANDAN SARI, SUKOHARJO, PRINGSEWU, LAMPUNG",9,129,19,148
https://kawalpemilu.org#22432,"PANDAN SARI, SUKOHARJO, PRINGSEWU, LAMPUNG",10,84,55,139
https://kawalpemilu.org#22432,"PANDAN SARI, SUKOHARJO, PRINGSEWU, LAMPUNG",11,94,68,162
https://kawalpemilu.org#22433,"PANDAN SURAT, SUKOHARJO, PRINGSEWU, LAMPUNG",1,105,139,244
https://kawalpemilu.org#22433,"PANDAN SURAT, SUKOHARJO, PRINGSEWU, LAMPUNG",2,101,83,184
https://kawalpemilu.org#22433,"PANDAN SURAT, SUKOHARJO, PRINGSEWU, LAMPUNG",3,156,40,196
https://kawalpemilu.org#22433,"PANDAN SURAT, SUKOHARJO, PRINGSEWU, LAMPUNG",4,121,30,151
https://kawalpemilu.org#22433,"PANDAN SURAT, SUKOHARJO, PRINGSEWU, LAMPUNG",5,129,34,163
https://kawalpemilu.org#22433,"PANDAN SURAT, SUKOHARJO, PRINGSEWU, LAMPUNG",6,136,96,232
https://kawalpemilu.org#22433,"PANDAN SURAT, SUKOHARJO, PRINGSEWU, LAMPUNG",7,94,109,203
https://kawalpemilu.org#22433,"PANDAN SURAT, SUKOHARJO, PRINGSEWU, LAMPUNG",8,87,124,211
https://kawalpemilu.org#22433,"PANDAN SURAT, SUKOHARJO, PRINGSEWU, LAMPUNG",9,101,76,177
https://kawalpemilu.org#22433,"PANDAN SURAT, SUKOHARJO, PRINGSEWU, LAMPUNG",10,130,60,190
https://kawalpemilu.org#22433,"PANDAN SURAT, SUKOHARJO, PRINGSEWU, LAMPUNG",11,115,21,136
https://kawalpemilu.org#22433,"PANDAN SURAT, SUKOHARJO, PRINGSEWU, LAMPUNG",12,152,42,194
https://kawalpemilu.org#22434,"KEPUTRAN, SUKOHARJO, PRINGSEWU, LAMPUNG",1,112,112,224
https://kawalpemilu.org#22434,"KEPUTRAN, SUKOHARJO, PRINGSEWU, LAMPUNG",2,163,59,222
https://kawalpemilu.org#22434,"KEPUTRAN, SUKOHARJO, PRINGSEWU, LAMPUNG",3,90,96,186
https://kawalpemilu.org#22434,"KEPUTRAN, SUKOHARJO, PRINGSEWU, LAMPUNG",4,119,74,193
https://kawalpemilu.org#22434,"KEPUTRAN, SUKOHARJO, PRINGSEWU, LAMPUNG",5,124,110,234
https://kawalpemilu.org#22434,"KEPUTRAN, SUKOHARJO, PRINGSEWU, LAMPUNG",6,80,97,177
https://kawalpemilu.org#22434,"KEPUTRAN, SUKOHARJO, PRINGSEWU, LAMPUNG",7,99,62,161
https://kawalpemilu.org#22434,"KEPUTRAN, SUKOHARJO, PRINGSEWU, LAMPUNG",8,93,93,186
https://kawalpemilu.org#22435,"SUKOYOSO, SUKOHARJO, PRINGSEWU, LAMPUNG",1,112,70,182
https://kawalpemilu.org#22435,"SUKOYOSO, SUKOHARJO, PRINGSEWU, LAMPUNG",2,70,87,157
https://kawalpemilu.org#22435,"SUKOYOSO, SUKOHARJO, PRINGSEWU, LAMPUNG",3,120,54,174
https://kawalpemilu.org#22435,"SUKOYOSO, SUKOHARJO, PRINGSEWU, LAMPUNG",4,97,96,193
https://kawalpemilu.org#22435,"SUKOYOSO, SUKOHARJO, PRINGSEWU, LAMPUNG",5,108,69,177
https://kawalpemilu.org#22435,"SUKOYOSO, SUKOHARJO, PRINGSEWU, LAMPUNG",6,136,41,177
https://kawalpemilu.org#22436,"SILIWANGI, SUKOHARJO, PRINGSEWU, LAMPUNG",1,92,72,164
https://kawalpemilu.org#22436,"SILIWANGI, SUKOHARJO, PRINGSEWU, LAMPUNG",2,97,47,144
https://kawalpemilu.org#22436,"SILIWANGI, SUKOHARJO, PRINGSEWU, LAMPUNG",3,91,100,191
https://kawalpemilu.org#22436,"SILIWANGI, SUKOHARJO, PRINGSEWU, LAMPUNG",4,80,108,188
https://kawalpemilu.org#22436,"SILIWANGI, SUKOHARJO, PRINGSEWU, LAMPUNG",5,86,56,142
https://kawalpemilu.org#22436,"SILIWANGI, SUKOHARJO, PRINGSEWU, LAMPUNG",6,104,57,161
https://kawalpemilu.org#22436,"SILIWANGI, SUKOHARJO, PRINGSEWU, LAMPUNG",7,115,44,159
https://kawalpemilu.org#22436,"SILIWANGI, SUKOHARJO, PRINGSEWU, LAMPUNG",8,98,101,199
https://kawalpemilu.org#22436,"SILIWANGI, SUKOHARJO, PRINGSEWU, LAMPUNG",9,58,139,197
https://kawalpemilu.org#22437,"WARINGIN SARI BARAT, SUKOHARJO, PRINGSEWU, LAMPUNG",1,137,101,238
https://kawalpemilu.org#22437,"WARINGIN SARI BARAT, SUKOHARJO, PRINGSEWU, LAMPUNG",2,140,113,253
https://kawalpemilu.org#22437,"WARINGIN SARI BARAT, SUKOHARJO, PRINGSEWU, LAMPUNG",3,101,94,195
https://kawalpemilu.org#22437,"WARINGIN SARI BARAT, SUKOHARJO, PRINGSEWU, LAMPUNG",4,109,145,254
https://kawalpemilu.org#22437,"WARINGIN SARI BARAT, SUKOHARJO, PRINGSEWU, LAMPUNG",5,121,101,222
https://kawalpemilu.org#22437,"WARINGIN SARI BARAT, SUKOHARJO, PRINGSEWU, LAMPUNG",6,44,113,157
https://kawalpemilu.org#22437,"WARINGIN SARI BARAT, SUKOHARJO, PRINGSEWU, LAMPUNG",7,131,59,190
https://kawalpemilu.org#22437,"WARINGIN SARI BARAT, SUKOHARJO, PRINGSEWU, LAMPUNG",8,100,90,190
https://kawalpemilu.org#22437,"WARINGIN SARI BARAT, SUKOHARJO, PRINGSEWU, LAMPUNG",9,94,65,159
https://kawalpemilu.org#22437,"WARINGIN SARI BARAT, SUKOHARJO, PRINGSEWU, LAMPUNG",10,136,112,248
https://kawalpemilu.org#22437,"WARINGIN SARI BARAT, SUKOHARJO, PRINGSEWU, LAMPUNG",11,113,118,231
https://kawalpemilu.org#22437,"WARINGIN SARI BARAT, SUKOHARJO, PRINGSEWU, LAMPUNG",12,89,92,181
https://kawalpemilu.org#22437,"WARINGIN SARI BARAT, SUKOHARJO, PRINGSEWU, LAMPUNG",13,116,127,243
https://kawalpemilu.org#22437,"WARINGIN SARI BARAT, SUKOHARJO, PRINGSEWU, LAMPUNG",14,124,108,232
https://kawalpemilu.org#22437,"WARINGIN SARI BARAT, SUKOHARJO, PRINGSEWU, LAMPUNG",15,47,91,138
https://kawalpemilu.org#22437,"WARINGIN SARI BARAT, SUKOHARJO, PRINGSEWU, LAMPUNG",16,129,75,204
https://kawalpemilu.org#22437,"WARINGIN SARI BARAT, SUKOHARJO, PRINGSEWU, LAMPUNG",17,83,96,179
https://kawalpemilu.org#22437,"WARINGIN SARI BARAT, SUKOHARJO, PRINGSEWU, LAMPUNG",18,108,53,161
https://kawalpemilu.org#22438,"PANDAN SARI SELATAN, SUKOHARJO, PRINGSEWU, LAMPUNG",1,165,76,241
https://kawalpemilu.org#22438,"PANDAN SARI SELATAN, SUKOHARJO, PRINGSEWU, LAMPUNG",2,107,84,191
https://kawalpemilu.org#22438,"PANDAN SARI SELATAN, SUKOHARJO, PRINGSEWU, LAMPUNG",3,121,29,150
https://kawalpemilu.org#22438,"PANDAN SARI SELATAN, SUKOHARJO, PRINGSEWU, LAMPUNG",4,162,55,217
https://kawalpemilu.org#22438,"PANDAN SARI SELATAN, SUKOHARJO, PRINGSEWU, LAMPUNG",5,123,90,213
https://kawalpemilu.org#22438,"PANDAN SARI SELATAN, SUKOHARJO, PRINGSEWU, LAMPUNG",6,107,75,182
https://kawalpemilu.org#22438,"PANDAN SARI SELATAN, SUKOHARJO, PRINGSEWU, LAMPUNG",7,102,51,153
https://kawalpemilu.org#22438,"PANDAN SARI SELATAN, SUKOHARJO, PRINGSEWU, LAMPUNG",8,107,46,153
https://kawalpemilu.org#22438,"PANDAN SARI SELATAN, SUKOHARJO, PRINGSEWU, LAMPUNG",9,113,51,164
https://kawalpemilu.org#22438,"PANDAN SARI SELATAN, SUKOHARJO, PRINGSEWU, LAMPUNG",10,140,66,206
https://kawalpemilu.org#84830,"SINAR BARU TIMUR, SUKOHARJO, PRINGSEWU, LAMPUNG",1,68,101,169
https://kawalpemilu.org#84830,"SINAR BARU TIMUR, SUKOHARJO, PRINGSEWU, LAMPUNG",2,51,97,148
https://kawalpemilu.org#84830,"SINAR BARU TIMUR, SUKOHARJO, PRINGSEWU, LAMPUNG",3,84,73,157
https://kawalpemilu.org#84830,"SINAR BARU TIMUR, SUKOHARJO, PRINGSEWU, LAMPUNG",4,112,31,143
https://kawalpemilu.org#84830,"SINAR BARU TIMUR, SUKOHARJO, PRINGSEWU, LAMPUNG",5,82,99,181
https://kawalpemilu.org#84830,"SINAR BARU TIMUR, SUKOHARJO, PRINGSEWU, LAMPUNG",6,61,93,154
https://kawalpemilu.org#84830,"SINAR BARU TIMUR, SUKOHARJO, PRINGSEWU, LAMPUNG",7,119,35,154
https://kawalpemilu.org#84831,"PANGGUNG REJO UTARA, SUKOHARJO, PRINGSEWU, LAMPUNG",1,147,54,201
https://kawalpemilu.org#84831,"PANGGUNG REJO UTARA, SUKOHARJO, PRINGSEWU, LAMPUNG",2,106,54,160
https://kawalpemilu.org#84831,"PANGGUNG REJO UTARA, SUKOHARJO, PRINGSEWU, LAMPUNG",3,146,56,202
https://kawalpemilu.org#84831,"PANGGUNG REJO UTARA, SUKOHARJO, PRINGSEWU, LAMPUNG",4,162,30,192
https://kawalpemilu.org#84831,"PANGGUNG REJO UTARA, SUKOHARJO, PRINGSEWU, LAMPUNG",5,123,32,155
https://kawalpemilu.org#84831,"PANGGUNG REJO UTARA, SUKOHARJO, PRINGSEWU, LAMPUNG",6,142,19,161
https://kawalpemilu.org#84832,"SUKOHARJO III BARAT, SUKOHARJO, PRINGSEWU, LAMPUNG",1,74,78,152
https://kawalpemilu.org#84832,"SUKOHARJO III BARAT, SUKOHARJO, PRINGSEWU, LAMPUNG",2,145,92,237
https://kawalpemilu.org#84832,"SUKOHARJO III BARAT, SUKOHARJO, PRINGSEWU, LAMPUNG",3,112,67,179
https://kawalpemilu.org#84832,"SUKOHARJO III BARAT, SUKOHARJO, PRINGSEWU, LAMPUNG",4,71,120,191
https://kawalpemilu.org#84832,"SUKOHARJO III BARAT, SUKOHARJO, PRINGSEWU, LAMPUNG",5,101,89,190
https://kawalpemilu.org#84832,"SUKOHARJO III BARAT, SUKOHARJO, PRINGSEWU, LAMPUNG",6,108,77,185
https://kawalpemilu.org#84832,"SUKOHARJO III BARAT, SUKOHARJO, PRINGSEWU, LAMPUNG",7,89,73,162
https://kawalpemilu.org#84832,"SUKOHARJO III BARAT, SUKOHARJO, PRINGSEWU, LAMPUNG",8,99,76,175
https://kawalpemilu.org#84832,"SUKOHARJO III BARAT, SUKOHARJO, PRINGSEWU, LAMPUNG",9,94,51,145
https://kawalpemilu.org#84832,"SUKOHARJO III BARAT, SUKOHARJO, PRINGSEWU, LAMPUNG",10,84,86,170
https://kawalpemilu.org#84832,"SUKOHARJO III BARAT, SUKOHARJO, PRINGSEWU, LAMPUNG",11,100,78,178
https://kawalpemilu.org#84832,"SUKOHARJO III BARAT, SUKOHARJO, PRINGSEWU, LAMPUNG",12,104,76,180
https://kawalpemilu.org#84832,"SUKOHARJO III BARAT, SUKOHARJO, PRINGSEWU, LAMPUNG",13,84,87,171
https://kawalpemilu.org#84832,"SUKOHARJO III BARAT, SUKOHARJO, PRINGSEWU, LAMPUNG",14,90,75,165
https://kawalpemilu.org#22394,"FAJAR BARU, PAGELARAN UTARA, PRINGSEWU, LAMPUNG",1,116,84,200
https://kawalpemilu.org#22394,"FAJAR BARU, PAGELARAN UTARA, PRINGSEWU, LAMPUNG",2,133,68,201
https://kawalpemilu.org#22394,"FAJAR BARU, PAGELARAN UTARA, PRINGSEWU, LAMPUNG",3,114,99,213
https://kawalpemilu.org#22394,"FAJAR BARU, PAGELARAN UTARA, PRINGSEWU, LAMPUNG",4,90,38,128
https://kawalpemilu.org#22395,"GIRI TUNGGAL, PAGELARAN UTARA, PRINGSEWU, LAMPUNG",1,99,60,159
https://kawalpemilu.org#22395,"GIRI TUNGGAL, PAGELARAN UTARA, PRINGSEWU, LAMPUNG",2,100,59,159
https://kawalpemilu.org#22395,"GIRI TUNGGAL, PAGELARAN UTARA, PRINGSEWU, LAMPUNG",3,108,20,128
https://kawalpemilu.org#22395,"GIRI TUNGGAL, PAGELARAN UTARA, PRINGSEWU, LAMPUNG",4,126,44,170
https://kawalpemilu.org#22395,"GIRI TUNGGAL, PAGELARAN UTARA, PRINGSEWU, LAMPUNG",5,133,29,162
https://kawalpemilu.org#22395,"GIRI TUNGGAL, PAGELARAN UTARA, PRINGSEWU, LAMPUNG",6,89,27,116
https://kawalpemilu.org#22395,"GIRI TUNGGAL, PAGELARAN UTARA, PRINGSEWU, LAMPUNG",7,121,27,148
https://kawalpemilu.org#22396,"MARGOSARI, PAGELARAN UTARA, PRINGSEWU, LAMPUNG",1,122,31,153
https://kawalpemilu.org#22396,"MARGOSARI, PAGELARAN UTARA, PRINGSEWU, LAMPUNG",2,118,52,170
https://kawalpemilu.org#22396,"MARGOSARI, PAGELARAN UTARA, PRINGSEWU, LAMPUNG",3,127,32,159
https://kawalpemilu.org#22396,"MARGOSARI, PAGELARAN UTARA, PRINGSEWU, LAMPUNG",4,81,29,110
https://kawalpemilu.org#22396,"MARGOSARI, PAGELARAN UTARA, PRINGSEWU, LAMPUNG",5,90,69,159
https://kawalpemilu.org#22396,"MARGOSARI, PAGELARAN UTARA, PRINGSEWU, LAMPUNG",6,125,61,186
https://kawalpemilu.org#22396,"MARGOSARI, PAGELARAN UTARA, PRINGSEWU, LAMPUNG",7,110,27,137
https://kawalpemilu.org#22396,"MARGOSARI, PAGELARAN UTARA, PRINGSEWU, LAMPUNG",8,116,47,163
https://kawalpemilu.org#22396,"MARGOSARI, PAGELARAN UTARA, PRINGSEWU, LAMPUNG",9,123,25,148
https://kawalpemilu.org#22396,"MARGOSARI, PAGELARAN UTARA, PRINGSEWU, LAMPUNG",10,88,22,110
https://kawalpemilu.org#22396,"MARGOSARI, PAGELARAN UTARA, PRINGSEWU, LAMPUNG",11,123,18,141
https://kawalpemilu.org#22396,"MARGOSARI, PAGELARAN UTARA, PRINGSEWU, LAMPUNG",12,134,43,177
https://kawalpemilu.org#22397,"SUMBER BANDUNG, PAGELARAN UTARA, PRINGSEWU, LAMPUNG",1,80,101,181
https://kawalpemilu.org#22397,"SUMBER BANDUNG, PAGELARAN UTARA, PRINGSEWU, LAMPUNG",2,97,11,108
https://kawalpemilu.org#22397,"SUMBER BANDUNG, PAGELARAN UTARA, PRINGSEWU, LAMPUNG",3,118,37,155
https://kawalpemilu.org#22397,"SUMBER BANDUNG, PAGELARAN UTARA, PRINGSEWU, LAMPUNG",4,69,92,161
https://kawalpemilu.org#22397,"SUMBER BANDUNG, PAGELARAN UTARA, PRINGSEWU, LAMPUNG",5,27,31,58
https://kawalpemilu.org#22398,"NEGLASARI, PAGELARAN UTARA, PRINGSEWU, LAMPUNG",1,77,83,160
https://kawalpemilu.org#22398,"NEGLASARI, PAGELARAN UTARA, PRINGSEWU, LAMPUNG",2,106,51,157
https://kawalpemilu.org#22398,"NEGLASARI, PAGELARAN UTARA, PRINGSEWU, LAMPUNG",3,100,41,141
https://kawalpemilu.org#22398,"NEGLASARI, PAGELARAN UTARA, PRINGSEWU, LAMPUNG",4,106,56,162
https://kawalpemilu.org#22399,"KEMILIN, PAGELARAN UTARA, PRINGSEWU, LAMPUNG",1,81,93,174
https://kawalpemilu.org#22399,"KEMILIN, PAGELARAN UTARA, PRINGSEWU, LAMPUNG",2,69,22,91
https://kawalpemilu.org#22399,"KEMILIN, PAGELARAN UTARA, PRINGSEWU, LAMPUNG",3,43,65,108
https://kawalpemilu.org#22399,"KEMILIN, PAGELARAN UTARA, PRINGSEWU, LAMPUNG",4,121,58,179
https://kawalpemilu.org#22399,"KEMILIN, PAGELARAN UTARA, PRINGSEWU, LAMPUNG",5,111,33,144
https://kawalpemilu.org#22399,"KEMILIN, PAGELARAN UTARA, PRINGSEWU, LAMPUNG",6,60,74,134
https://kawalpemilu.org#22402,"FAJAR MULIA, PAGELARAN UTARA, PRINGSEWU, LAMPUNG",1,68,61,129
https://kawalpemilu.org#22402,"FAJAR MULIA, PAGELARAN UTARA, PRINGSEWU, LAMPUNG",2,110,36,146
https://kawalpemilu.org#22402,"FAJAR MULIA, PAGELARAN UTARA, PRINGSEWU, LAMPUNG",3,59,90,149
https://kawalpemilu.org#22402,"FAJAR MULIA, PAGELARAN UTARA, PRINGSEWU, LAMPUNG",4,101,44,145
https://kawalpemilu.org#22402,"FAJAR MULIA, PAGELARAN UTARA, PRINGSEWU, LAMPUNG",5,127,50,177
https://kawalpemilu.org#22402,"FAJAR MULIA, PAGELARAN UTARA, PRINGSEWU, LAMPUNG",6,96,75,171
https://kawalpemilu.org#22402,"FAJAR MULIA, PAGELARAN UTARA, PRINGSEWU, LAMPUNG",7,125,43,168
https://kawalpemilu.org#22403,"MADARAYA, PAGELARAN UTARA, PRINGSEWU, LAMPUNG",1,81,85,166
https://kawalpemilu.org#22403,"MADARAYA, PAGELARAN UTARA, PRINGSEWU, LAMPUNG",2,61,54,115
https://kawalpemilu.org#22403,"MADARAYA, PAGELARAN UTARA, PRINGSEWU, LAMPUNG",3,141,24,165
https://kawalpemilu.org#22403,"MADARAYA, PAGELARAN UTARA, PRINGSEWU, LAMPUNG",4,94,33,127
https://kawalpemilu.org#22403,"MADARAYA, PAGELARAN UTARA, PRINGSEWU, LAMPUNG",5,78,25,103
https://kawalpemilu.org#88011,"WAY KUNYIR, PAGELARAN UTARA, PRINGSEWU, LAMPUNG",1,111,29,140
https://kawalpemilu.org#88011,"WAY KUNYIR, PAGELARAN UTARA, PRINGSEWU, LAMPUNG",2,60,50,110
https://kawalpemilu.org#88011,"WAY KUNYIR, PAGELARAN UTARA, PRINGSEWU, LAMPUNG",3,83,13,96
https://kawalpemilu.org#88011,"WAY KUNYIR, PAGELARAN UTARA, PRINGSEWU, LAMPUNG",4,92,25,117
https://kawalpemilu.org#88012,"GUNUNGRAYA, PAGELARAN UTARA, PRINGSEWU, LAMPUNG",1,53,59,112
https://kawalpemilu.org#88012,"GUNUNGRAYA, PAGELARAN UTARA, PRINGSEWU, LAMPUNG",2,111,46,157
https://kawalpemilu.org#88012,"GUNUNGRAYA, PAGELARAN UTARA, PRINGSEWU, LAMPUNG",3,108,53,161
https://kawalpemilu.org#22441,"WIRALAGA I, MESUJI, MESUJI, LAMPUNG",1,135,46,181
https://kawalpemilu.org#22441,"WIRALAGA I, MESUJI, MESUJI, LAMPUNG",2,103,59,162
https://kawalpemilu.org#22441,"WIRALAGA I, MESUJI, MESUJI, LAMPUNG",3,137,42,179
https://kawalpemilu.org#22441,"WIRALAGA I, MESUJI, MESUJI, LAMPUNG",4,139,39,178
https://kawalpemilu.org#22441,"WIRALAGA I, MESUJI, MESUJI, LAMPUNG",5,141,46,187
https://kawalpemilu.org#22441,"WIRALAGA I, MESUJI, MESUJI, LAMPUNG",6,156,50,206
https://kawalpemilu.org#22442,"WIRALAGA II, MESUJI, MESUJI, LAMPUNG",1,164,64,228
https://kawalpemilu.org#22442,"WIRALAGA II, MESUJI, MESUJI, LAMPUNG",2,131,23,154
https://kawalpemilu.org#22442,"WIRALAGA II, MESUJI, MESUJI, LAMPUNG",3,186,27,213
https://kawalpemilu.org#22442,"WIRALAGA II, MESUJI, MESUJI, LAMPUNG",4,168,21,189
https://kawalpemilu.org#22442,"WIRALAGA II, MESUJI, MESUJI, LAMPUNG",5,201,13,214
https://kawalpemilu.org#22442,"WIRALAGA II, MESUJI, MESUJI, LAMPUNG",6,80,4,84
https://kawalpemilu.org#22443,"SUNGAI BADAK, MESUJI, MESUJI, LAMPUNG",1,155,51,206
https://kawalpemilu.org#22443,"SUNGAI BADAK, MESUJI, MESUJI, LAMPUNG",2,192,38,230
https://kawalpemilu.org#22443,"SUNGAI BADAK, MESUJI, MESUJI, LAMPUNG",3,170,74,244
https://kawalpemilu.org#22443,"SUNGAI BADAK, MESUJI, MESUJI, LAMPUNG",4,169,42,211
https://kawalpemilu.org#22443,"SUNGAI BADAK, MESUJI, MESUJI, LAMPUNG",5,170,28,198
https://kawalpemilu.org#22443,"SUNGAI BADAK, MESUJI, MESUJI, LAMPUNG",6,147,51,198
https://kawalpemilu.org#22443,"SUNGAI BADAK, MESUJI, MESUJI, LAMPUNG",7,167,37,204
https://kawalpemilu.org#22443,"SUNGAI BADAK, MESUJI, MESUJI, LAMPUNG",8,206,36,242
https://kawalpemilu.org#22443,"SUNGAI BADAK, MESUJI, MESUJI, LAMPUNG",9,164,37,201
https://kawalpemilu.org#22443,"SUNGAI BADAK, MESUJI, MESUJI, LAMPUNG",10,175,37,212
https://kawalpemilu.org#22444,"NIPAH KUNING, MESUJI, MESUJI, LAMPUNG",1,106,66,172
https://kawalpemilu.org#22444,"NIPAH KUNING, MESUJI, MESUJI, LAMPUNG",2,89,33,122
https://kawalpemilu.org#22444,"NIPAH KUNING, MESUJI, MESUJI, LAMPUNG",3,98,43,141
https://kawalpemilu.org#22445,"SIDO MULYO, MESUJI, MESUJI, LAMPUNG",1,148,45,193
https://kawalpemilu.org#22445,"SIDO MULYO, MESUJI, MESUJI, LAMPUNG",2,180,37,217
https://kawalpemilu.org#22445,"SIDO MULYO, MESUJI, MESUJI, LAMPUNG",3,204,10,214
https://kawalpemilu.org#22445,"SIDO MULYO, MESUJI, MESUJI, LAMPUNG",4,218,20,238
https://kawalpemilu.org#22445,"SIDO MULYO, MESUJI, MESUJI, LAMPUNG",5,159,57,216
https://kawalpemilu.org#22445,"SIDO MULYO, MESUJI, MESUJI, LAMPUNG",6,204,26,230
https://kawalpemilu.org#22445,"SIDO MULYO, MESUJI, MESUJI, LAMPUNG",7,198,40,238
https://kawalpemilu.org#22445,"SIDO MULYO, MESUJI, MESUJI, LAMPUNG",8,147,22,169
https://kawalpemilu.org#22445,"SIDO MULYO, MESUJI, MESUJI, LAMPUNG",9,212,33,245
https://kawalpemilu.org#22445,"SIDO MULYO, MESUJI, MESUJI, LAMPUNG",10,178,25,203
https://kawalpemilu.org#22446,"TIRTALAGA, MESUJI, MESUJI, LAMPUNG",1,195,16,211
https://kawalpemilu.org#22446,"TIRTALAGA, MESUJI, MESUJI, LAMPUNG",2,201,14,215
https://kawalpemilu.org#22446,"TIRTALAGA, MESUJI, MESUJI, LAMPUNG",3,184,22,206
https://kawalpemilu.org#22446,"TIRTALAGA, MESUJI, MESUJI, LAMPUNG",4,191,22,213
https://kawalpemilu.org#22446,"TIRTALAGA, MESUJI, MESUJI, LAMPUNG",5,181,23,204
https://kawalpemilu.org#22447,"TANJUNG SERAYAN, MESUJI, MESUJI, LAMPUNG",1,184,33,217
https://kawalpemilu.org#22447,"TANJUNG SERAYAN, MESUJI, MESUJI, LAMPUNG",2,176,40,216
https://kawalpemilu.org#22447,"TANJUNG SERAYAN, MESUJI, MESUJI, LAMPUNG",3,143,23,166
https://kawalpemilu.org#22447,"TANJUNG SERAYAN, MESUJI, MESUJI, LAMPUNG",4,151,61,212
https://kawalpemilu.org#22447,"TANJUNG SERAYAN, MESUJI, MESUJI, LAMPUNG",5,174,43,217
https://kawalpemilu.org#22448,"SUMBER MAKMUR, MESUJI, MESUJI, LAMPUNG",1,172,30,202
https://kawalpemilu.org#22448,"SUMBER MAKMUR, MESUJI, MESUJI, LAMPUNG",2,172,26,198
https://kawalpemilu.org#22448,"SUMBER MAKMUR, MESUJI, MESUJI, LAMPUNG",3,146,27,173
https://kawalpemilu.org#22448,"SUMBER MAKMUR, MESUJI, MESUJI, LAMPUNG",4,175,16,191
https://kawalpemilu.org#22448,"SUMBER MAKMUR, MESUJI, MESUJI, LAMPUNG",5,146,26,172
https://kawalpemilu.org#22449,"MULYA SARI, MESUJI, MESUJI, LAMPUNG",1,172,29,201
https://kawalpemilu.org#22449,"MULYA SARI, MESUJI, MESUJI, LAMPUNG",2,146,26,172
https://kawalpemilu.org#22449,"MULYA SARI, MESUJI, MESUJI, LAMPUNG",3,191,11,202
https://kawalpemilu.org#22449,"MULYA SARI, MESUJI, MESUJI, LAMPUNG",4,138,23,161
https://kawalpemilu.org#929368,"WIRALAGA MULYA, MESUJI, MESUJI, LAMPUNG",1,159,53,212
https://kawalpemilu.org#929368,"WIRALAGA MULYA, MESUJI, MESUJI, LAMPUNG",2,153,63,216
https://kawalpemilu.org#929368,"WIRALAGA MULYA, MESUJI, MESUJI, LAMPUNG",3,177,37,214
https://kawalpemilu.org#929369,"SUKA MAJU, MESUJI, MESUJI, LAMPUNG",1,145,11,156
https://kawalpemilu.org#929369,"SUKA MAJU, MESUJI, MESUJI, LAMPUNG",2,126,42,168
https://kawalpemilu.org#929369,"SUKA MAJU, MESUJI, MESUJI, LAMPUNG",3,113,20,133
https://kawalpemilu.org#22451,"TALANG BATU, MESUJI TIMUR, MESUJI, LAMPUNG",1,107,49,156
https://kawalpemilu.org#22451,"TALANG BATU, MESUJI TIMUR, MESUJI, LAMPUNG",2,138,20,158
https://kawalpemilu.org#22451,"TALANG BATU, MESUJI TIMUR, MESUJI, LAMPUNG",3,142,6,148
https://kawalpemilu.org#22451,"TALANG BATU, MESUJI TIMUR, MESUJI, LAMPUNG",4,142,14,156
https://kawalpemilu.org#22451,"TALANG BATU, MESUJI TIMUR, MESUJI, LAMPUNG",5,163,25,188
https://kawalpemilu.org#22451,"TALANG BATU, MESUJI TIMUR, MESUJI, LAMPUNG",6,192,27,219
https://kawalpemilu.org#22451,"TALANG BATU, MESUJI TIMUR, MESUJI, LAMPUNG",7,193,14,207
https://kawalpemilu.org#22451,"TALANG BATU, MESUJI TIMUR, MESUJI, LAMPUNG",8,193,14,207
https://kawalpemilu.org#22451,"TALANG BATU, MESUJI TIMUR, MESUJI, LAMPUNG",9,168,35,203
https://kawalpemilu.org#22451,"TALANG BATU, MESUJI TIMUR, MESUJI, LAMPUNG",10,184,20,204
https://kawalpemilu.org#22451,"TALANG BATU, MESUJI TIMUR, MESUJI, LAMPUNG",11,236,23,259
https://kawalpemilu.org#22451,"TALANG BATU, MESUJI TIMUR, MESUJI, LAMPUNG",12,214,13,227
https://kawalpemilu.org#22451,"TALANG BATU, MESUJI TIMUR, MESUJI, LAMPUNG",13,91,8,99
https://kawalpemilu.org#22451,"TALANG BATU, MESUJI TIMUR, MESUJI, LAMPUNG",14,77,12,89
https://kawalpemilu.org#22452,"SUNGAI CAMBAI, MESUJI TIMUR, MESUJI, LAMPUNG",1,142,36,178
https://kawalpemilu.org#22452,"SUNGAI CAMBAI, MESUJI TIMUR, MESUJI, LAMPUNG",2,172,38,210
https://kawalpemilu.org#22452,"SUNGAI CAMBAI, MESUJI TIMUR, MESUJI, LAMPUNG",3,126,19,145
https://kawalpemilu.org#22452,"SUNGAI CAMBAI, MESUJI TIMUR, MESUJI, LAMPUNG",4,104,21,125
https://kawalpemilu.org#22452,"SUNGAI CAMBAI, MESUJI TIMUR, MESUJI, LAMPUNG",5,145,23,168
https://kawalpemilu.org#22453,"TANJUNG MAS MAKMUR, MESUJI TIMUR, MESUJI, LAMPUNG",1,199,39,238
https://kawalpemilu.org#22453,"TANJUNG MAS MAKMUR, MESUJI TIMUR, MESUJI, LAMPUNG",2,156,44,200
https://kawalpemilu.org#22453,"TANJUNG MAS MAKMUR, MESUJI TIMUR, MESUJI, LAMPUNG",3,104,47,151
https://kawalpemilu.org#22453,"TANJUNG MAS MAKMUR, MESUJI TIMUR, MESUJI, LAMPUNG",4,173,44,217
https://kawalpemilu.org#22453,"TANJUNG MAS MAKMUR, MESUJI TIMUR, MESUJI, LAMPUNG",5,181,43,224
https://kawalpemilu.org#22454,"MARGOJADI, MESUJI TIMUR, MESUJI, LAMPUNG",1,136,95,231
https://kawalpemilu.org#22454,"MARGOJADI, MESUJI TIMUR, MESUJI, LAMPUNG",2,91,51,142
https://kawalpemilu.org#22454,"MARGOJADI, MESUJI TIMUR, MESUJI, LAMPUNG",3,124,71,195
https://kawalpemilu.org#22454,"MARGOJADI, MESUJI TIMUR, MESUJI, LAMPUNG",4,108,41,149
https://kawalpemilu.org#22454,"MARGOJADI, MESUJI TIMUR, MESUJI, LAMPUNG",5,103,10,113
https://kawalpemilu.org#22454,"MARGOJADI, MESUJI TIMUR, MESUJI, LAMPUNG",6,145,34,179
https://kawalpemilu.org#22454,"MARGOJADI, MESUJI TIMUR, MESUJI, LAMPUNG",7,153,41,194
https://kawalpemilu.org#22454,"MARGOJADI, MESUJI TIMUR, MESUJI, LAMPUNG",8,105,42,147
https://kawalpemilu.org#22455,"TANJUNG MENANG, MESUJI TIMUR, MESUJI, LAMPUNG",1,179,59,238
https://kawalpemilu.org#22455,"TANJUNG MENANG, MESUJI TIMUR, MESUJI, LAMPUNG",2,156,66,222
https://kawalpemilu.org#22455,"TANJUNG MENANG, MESUJI TIMUR, MESUJI, LAMPUNG",3,121,54,175
https://kawalpemilu.org#22455,"TANJUNG MENANG, MESUJI TIMUR, MESUJI, LAMPUNG",4,83,62,145
https://kawalpemilu.org#22455,"TANJUNG MENANG, MESUJI TIMUR, MESUJI, LAMPUNG",5,161,22,183
https://kawalpemilu.org#22456,"EKA MULYA, MESUJI TIMUR, MESUJI, LAMPUNG",1,158,57,215
https://kawalpemilu.org#22456,"EKA MULYA, MESUJI TIMUR, MESUJI, LAMPUNG",2,179,46,225
https://kawalpemilu.org#22456,"EKA MULYA, MESUJI TIMUR, MESUJI, LAMPUNG",3,125,77,202
https://kawalpemilu.org#22456,"EKA MULYA, MESUJI TIMUR, MESUJI, LAMPUNG",4,163,48,211
https://kawalpemilu.org#22456,"EKA MULYA, MESUJI TIMUR, MESUJI, LAMPUNG",5,195,20,215
https://kawalpemilu.org#22456,"EKA MULYA, MESUJI TIMUR, MESUJI, LAMPUNG",6,158,29,187
https://kawalpemilu.org#22457,"WONOSARI, MESUJI TIMUR, MESUJI, LAMPUNG",1,145,56,201
https://kawalpemilu.org#22457,"WONOSARI, MESUJI TIMUR, MESUJI, LAMPUNG",2,184,33,217
https://kawalpemilu.org#22457,"WONOSARI, MESUJI TIMUR, MESUJI, LAMPUNG",3,166,32,198
https://kawalpemilu.org#22457,"WONOSARI, MESUJI TIMUR, MESUJI, LAMPUNG",4,197,25,222
https://kawalpemilu.org#22457,"WONOSARI, MESUJI TIMUR, MESUJI, LAMPUNG",5,177,20,197
https://kawalpemilu.org#22457,"WONOSARI, MESUJI TIMUR, MESUJI, LAMPUNG",6,196,22,218
https://kawalpemilu.org#22457,"WONOSARI, MESUJI TIMUR, MESUJI, LAMPUNG",7,185,32,217
https://kawalpemilu.org#22457,"WONOSARI, MESUJI TIMUR, MESUJI, LAMPUNG",8,83,21,104
https://kawalpemilu.org#22458,"DWI KARYA MUSTIKA, MESUJI TIMUR, MESUJI, LAMPUNG",1,193,13,206
https://kawalpemilu.org#22458,"DWI KARYA MUSTIKA, MESUJI TIMUR, MESUJI, LAMPUNG",2,199,21,220
https://kawalpemilu.org#22458,"DWI KARYA MUSTIKA, MESUJI TIMUR, MESUJI, LAMPUNG",3,176,22,198
https://kawalpemilu.org#22458,"DWI KARYA MUSTIKA, MESUJI TIMUR, MESUJI, LAMPUNG",4,221,23,244
https://kawalpemilu.org#22458,"DWI KARYA MUSTIKA, MESUJI TIMUR, MESUJI, LAMPUNG",5,223,20,243
https://kawalpemilu.org#22459,"PANGKAL MAS JAYA, MESUJI TIMUR, MESUJI, LAMPUNG",1,129,14,143
https://kawalpemilu.org#22459,"PANGKAL MAS JAYA, MESUJI TIMUR, MESUJI, LAMPUNG",2,124,31,155
https://kawalpemilu.org#22459,"PANGKAL MAS JAYA, MESUJI TIMUR, MESUJI, LAMPUNG",3,99,5,104
https://kawalpemilu.org#22459,"PANGKAL MAS JAYA, MESUJI TIMUR, MESUJI, LAMPUNG",4,116,14,130
https://kawalpemilu.org#22460,"PANGKAL MAS MULYA, MESUJI TIMUR, MESUJI, LAMPUNG",1,201,13,214
https://kawalpemilu.org#22460,"PANGKAL MAS MULYA, MESUJI TIMUR, MESUJI, LAMPUNG",2,179,11,190
https://kawalpemilu.org#22460,"PANGKAL MAS MULYA, MESUJI TIMUR, MESUJI, LAMPUNG",3,220,19,239
https://kawalpemilu.org#22460,"PANGKAL MAS MULYA, MESUJI TIMUR, MESUJI, LAMPUNG",4,206,22,228
https://kawalpemilu.org#22461,"TANJUNG MAS MULYA, MESUJI TIMUR, MESUJI, LAMPUNG",1,157,40,197
https://kawalpemilu.org#22461,"TANJUNG MAS MULYA, MESUJI TIMUR, MESUJI, LAMPUNG",2,157,38,195
https://kawalpemilu.org#22461,"TANJUNG MAS MULYA, MESUJI TIMUR, MESUJI, LAMPUNG",3,163,28,191
https://kawalpemilu.org#22461,"TANJUNG MAS MULYA, MESUJI TIMUR, MESUJI, LAMPUNG",4,146,27,173
https://kawalpemilu.org#22462,"MUARA MAS, MESUJI TIMUR, MESUJI, LAMPUNG",1,147,31,178
https://kawalpemilu.org#22462,"MUARA MAS, MESUJI TIMUR, MESUJI, LAMPUNG",2,157,18,175
https://kawalpemilu.org#22462,"MUARA MAS, MESUJI TIMUR, MESUJI, LAMPUNG",3,153,12,165
https://kawalpemilu.org#22463,"TANJUNG MAS JAYA, MESUJI TIMUR, MESUJI, LAMPUNG",1,187,52,239
https://kawalpemilu.org#22463,"TANJUNG MAS JAYA, MESUJI TIMUR, MESUJI, LAMPUNG",2,178,44,222
https://kawalpemilu.org#22463,"TANJUNG MAS JAYA, MESUJI TIMUR, MESUJI, LAMPUNG",3,163,58,221
https://kawalpemilu.org#929370,"MARGO JAYA, MESUJI TIMUR, MESUJI, LAMPUNG",1,199,37,236
https://kawalpemilu.org#929370,"MARGO JAYA, MESUJI TIMUR, MESUJI, LAMPUNG",2,169,25,194
https://kawalpemilu.org#929370,"MARGO JAYA, MESUJI TIMUR, MESUJI, LAMPUNG",3,166,41,207
https://kawalpemilu.org#929370,"MARGO JAYA, MESUJI TIMUR, MESUJI, LAMPUNG",4,139,7,146
https://kawalpemilu.org#929370,"MARGO JAYA, MESUJI TIMUR, MESUJI, LAMPUNG",5,114,3,117
https://kawalpemilu.org#929371,"PANGKAL MAS, MESUJI TIMUR, MESUJI, LAMPUNG",1,146,24,170
https://kawalpemilu.org#929371,"PANGKAL MAS, MESUJI TIMUR, MESUJI, LAMPUNG",2,140,60,200
https://kawalpemilu.org#929371,"PANGKAL MAS, MESUJI TIMUR, MESUJI, LAMPUNG",3,195,20,215
https://kawalpemilu.org#929372,"TANJUNG MENANG RAYA, MESUJI TIMUR, MESUJI, LAMPUNG",1,166,42,208
https://kawalpemilu.org#929372,"TANJUNG MENANG RAYA, MESUJI TIMUR, MESUJI, LAMPUNG",2,144,56,200
https://kawalpemilu.org#929372,"TANJUNG MENANG RAYA, MESUJI TIMUR, MESUJI, LAMPUNG",3,157,49,206
https://kawalpemilu.org#929372,"TANJUNG MENANG RAYA, MESUJI TIMUR, MESUJI, LAMPUNG",4,182,54,236
https://kawalpemilu.org#929372,"TANJUNG MENANG RAYA, MESUJI TIMUR, MESUJI, LAMPUNG",5,163,52,215
https://kawalpemilu.org#929372,"TANJUNG MENANG RAYA, MESUJI TIMUR, MESUJI, LAMPUNG",6,52,24,76
https://kawalpemilu.org#929373,"TEBING KARYA MANDIRI, MESUJI TIMUR, MESUJI, LAMPUNG",1,135,10,145
https://kawalpemilu.org#929373,"TEBING KARYA MANDIRI, MESUJI TIMUR, MESUJI, LAMPUNG",2,160,22,182
https://kawalpemilu.org#929373,"TEBING KARYA MANDIRI, MESUJI TIMUR, MESUJI, LAMPUNG",3,146,25,171
https://kawalpemilu.org#929373,"TEBING KARYA MANDIRI, MESUJI TIMUR, MESUJI, LAMPUNG",4,161,19,180
https://kawalpemilu.org#929374,"TANJUNG MAS REJO, MESUJI TIMUR, MESUJI, LAMPUNG",1,213,34,247
https://kawalpemilu.org#929374,"TANJUNG MAS REJO, MESUJI TIMUR, MESUJI, LAMPUNG",2,159,68,227
https://kawalpemilu.org#929374,"TANJUNG MAS REJO, MESUJI TIMUR, MESUJI, LAMPUNG",3,163,66,229
https://kawalpemilu.org#929374,"TANJUNG MAS REJO, MESUJI TIMUR, MESUJI, LAMPUNG",4,131,18,149
https://kawalpemilu.org#929375,"MARGO MULYO, MESUJI TIMUR, MESUJI, LAMPUNG",1,123,61,184
https://kawalpemilu.org#929375,"MARGO MULYO, MESUJI TIMUR, MESUJI, LAMPUNG",2,142,30,172
https://kawalpemilu.org#929375,"MARGO MULYO, MESUJI TIMUR, MESUJI, LAMPUNG",3,132,92,224
https://kawalpemilu.org#929375,"MARGO MULYO, MESUJI TIMUR, MESUJI, LAMPUNG",4,135,78,213
https://kawalpemilu.org#929376,"MUARA ASRI, MESUJI TIMUR, MESUJI, LAMPUNG",1,129,79,208
https://kawalpemilu.org#929376,"MUARA ASRI, MESUJI TIMUR, MESUJI, LAMPUNG",2,192,23,215
https://kawalpemilu.org#22465,"SUNGAI BUAYA, RAWA JITU UTARA, MESUJI, LAMPUNG",1,189,25,214
https://kawalpemilu.org#22465,"SUNGAI BUAYA, RAWA JITU UTARA, MESUJI, LAMPUNG",2,148,14,162
https://kawalpemilu.org#22465,"SUNGAI BUAYA, RAWA JITU UTARA, MESUJI, LAMPUNG",3,105,25,130
https://kawalpemilu.org#22465,"SUNGAI BUAYA, RAWA JITU UTARA, MESUJI, LAMPUNG",4,206,20,226
https://kawalpemilu.org#22465,"SUNGAI BUAYA, RAWA JITU UTARA, MESUJI, LAMPUNG",5,148,19,167
https://kawalpemilu.org#22465,"SUNGAI BUAYA, RAWA JITU UTARA, MESUJI, LAMPUNG",6,143,18,161
https://kawalpemilu.org#22465,"SUNGAI BUAYA, RAWA JITU UTARA, MESUJI, LAMPUNG",7,106,22,128
https://kawalpemilu.org#22466,"PANGGUNG JAYA, RAWA JITU UTARA, MESUJI, LAMPUNG",1,207,23,230
https://kawalpemilu.org#22466,"PANGGUNG JAYA, RAWA JITU UTARA, MESUJI, LAMPUNG",2,144,60,204
https://kawalpemilu.org#22466,"PANGGUNG JAYA, RAWA JITU UTARA, MESUJI, LAMPUNG",3,187,18,205
https://kawalpemilu.org#22466,"PANGGUNG JAYA, RAWA JITU UTARA, MESUJI, LAMPUNG",4,183,38,221
https://kawalpemilu.org#22466,"PANGGUNG JAYA, RAWA JITU UTARA, MESUJI, LAMPUNG",5,137,70,207
https://kawalpemilu.org#22466,"PANGGUNG JAYA, RAWA JITU UTARA, MESUJI, LAMPUNG",6,131,58,189
https://kawalpemilu.org#22466,"PANGGUNG JAYA, RAWA JITU UTARA, MESUJI, LAMPUNG",7,158,37,195
https://kawalpemilu.org#22466,"PANGGUNG JAYA, RAWA JITU UTARA, MESUJI, LAMPUNG",8,141,29,170
https://kawalpemilu.org#22466,"PANGGUNG JAYA, RAWA JITU UTARA, MESUJI, LAMPUNG",9,82,39,121
https://kawalpemilu.org#22467,"SUNGAI SIDANG, RAWA JITU UTARA, MESUJI, LAMPUNG",1,136,53,189
https://kawalpemilu.org#22467,"SUNGAI SIDANG, RAWA JITU UTARA, MESUJI, LAMPUNG",2,173,28,201
https://kawalpemilu.org#22467,"SUNGAI SIDANG, RAWA JITU UTARA, MESUJI, LAMPUNG",3,202,52,254
https://kawalpemilu.org#22467,"SUNGAI SIDANG, RAWA JITU UTARA, MESUJI, LAMPUNG",4,126,33,159
https://kawalpemilu.org#22467,"SUNGAI SIDANG, RAWA JITU UTARA, MESUJI, LAMPUNG",5,37,40,77
https://kawalpemilu.org#22467,"SUNGAI SIDANG, RAWA JITU UTARA, MESUJI, LAMPUNG",6,92,44,136
https://kawalpemilu.org#22468,"SIDANG SIDO RAHAYU, RAWA JITU UTARA, MESUJI, LAMPUNG",1,189,38,227
https://kawalpemilu.org#22468,"SIDANG SIDO RAHAYU, RAWA JITU UTARA, MESUJI, LAMPUNG",2,134,70,204
https://kawalpemilu.org#22468,"SIDANG SIDO RAHAYU, RAWA JITU UTARA, MESUJI, LAMPUNG",3,200,32,232
https://kawalpemilu.org#22468,"SIDANG SIDO RAHAYU, RAWA JITU UTARA, MESUJI, LAMPUNG",4,118,33,151
https://kawalpemilu.org#22469,"SIDANG WAY PUJI, RAWA JITU UTARA, MESUJI, LAMPUNG",1,197,45,242
https://kawalpemilu.org#22469,"SIDANG WAY PUJI, RAWA JITU UTARA, MESUJI, LAMPUNG",2,167,49,216
https://kawalpemilu.org#22469,"SIDANG WAY PUJI, RAWA JITU UTARA, MESUJI, LAMPUNG",3,167,34,201
https://kawalpemilu.org#22469,"SIDANG WAY PUJI, RAWA JITU UTARA, MESUJI, LAMPUNG",4,171,55,226
https://kawalpemilu.org#22469,"SIDANG WAY PUJI, RAWA JITU UTARA, MESUJI, LAMPUNG",5,194,33,227
https://kawalpemilu.org#22469,"SIDANG WAY PUJI, RAWA JITU UTARA, MESUJI, LAMPUNG",6,183,32,215
https://kawalpemilu.org#22470,"SIDANG BANDAR ANOM, RAWA JITU UTARA, MESUJI, LAMPUNG",1,195,38,233
https://kawalpemilu.org#22470,"SIDANG BANDAR ANOM, RAWA JITU UTARA, MESUJI, LAMPUNG",2,181,19,200
https://kawalpemilu.org#22470,"SIDANG BANDAR ANOM, RAWA JITU UTARA, MESUJI, LAMPUNG",3,192,24,216
https://kawalpemilu.org#22470,"SIDANG BANDAR ANOM, RAWA JITU UTARA, MESUJI, LAMPUNG",4,147,18,165
https://kawalpemilu.org#22470,"SIDANG BANDAR ANOM, RAWA JITU UTARA, MESUJI, LAMPUNG",5,183,35,218
https://kawalpemilu.org#22470,"SIDANG BANDAR ANOM, RAWA JITU UTARA, MESUJI, LAMPUNG",6,114,19,133
https://kawalpemilu.org#22471,"PANGGUNG REJO, RAWA JITU UTARA, MESUJI, LAMPUNG",1,133,42,175
https://kawalpemilu.org#22471,"PANGGUNG REJO, RAWA JITU UTARA, MESUJI, LAMPUNG",2,135,33,168
https://kawalpemilu.org#22471,"PANGGUNG REJO, RAWA JITU UTARA, MESUJI, LAMPUNG",3,134,63,197
https://kawalpemilu.org#22472,"SIDANG ISO MUKTI, RAWA JITU UTARA, MESUJI, LAMPUNG",1,195,22,217
https://kawalpemilu.org#22472,"SIDANG ISO MUKTI, RAWA JITU UTARA, MESUJI, LAMPUNG",2,209,18,227
https://kawalpemilu.org#22472,"SIDANG ISO MUKTI, RAWA JITU UTARA, MESUJI, LAMPUNG",3,196,19,215
https://kawalpemilu.org#22472,"SIDANG ISO MUKTI, RAWA JITU UTARA, MESUJI, LAMPUNG",4,204,19,223
https://kawalpemilu.org#22472,"SIDANG ISO MUKTI, RAWA JITU UTARA, MESUJI, LAMPUNG",5,197,17,214
https://kawalpemilu.org#22472,"SIDANG ISO MUKTI, RAWA JITU UTARA, MESUJI, LAMPUNG",6,175,21,196
https://kawalpemilu.org#22472,"SIDANG ISO MUKTI, RAWA JITU UTARA, MESUJI, LAMPUNG",7,204,16,220
https://kawalpemilu.org#22472,"SIDANG ISO MUKTI, RAWA JITU UTARA, MESUJI, LAMPUNG",8,191,18,209
https://kawalpemilu.org#22473,"SIDANG KURNIA AGUNG, RAWA JITU UTARA, MESUJI, LAMPUNG",1,152,24,176
https://kawalpemilu.org#22473,"SIDANG KURNIA AGUNG, RAWA JITU UTARA, MESUJI, LAMPUNG",2,185,18,203
https://kawalpemilu.org#22473,"SIDANG KURNIA AGUNG, RAWA JITU UTARA, MESUJI, LAMPUNG",3,217,32,249
https://kawalpemilu.org#22473,"SIDANG KURNIA AGUNG, RAWA JITU UTARA, MESUJI, LAMPUNG",4,173,33,206
https://kawalpemilu.org#22473,"SIDANG KURNIA AGUNG, RAWA JITU UTARA, MESUJI, LAMPUNG",5,201,32,233
https://kawalpemilu.org#22473,"SIDANG KURNIA AGUNG, RAWA JITU UTARA, MESUJI, LAMPUNG",6,148,10,158
https://kawalpemilu.org#22474,"TELOGO REJO, RAWA JITU UTARA, MESUJI, LAMPUNG",1,179,23,202
https://kawalpemilu.org#22474,"TELOGO REJO, RAWA JITU UTARA, MESUJI, LAMPUNG",2,198,15,213
https://kawalpemilu.org#22474,"TELOGO REJO, RAWA JITU UTARA, MESUJI, LAMPUNG",3,155,41,196
https://kawalpemilu.org#22474,"TELOGO REJO, RAWA JITU UTARA, MESUJI, LAMPUNG",4,162,40,202
https://kawalpemilu.org#22474,"TELOGO REJO, RAWA JITU UTARA, MESUJI, LAMPUNG",5,162,29,191
https://kawalpemilu.org#22474,"TELOGO REJO, RAWA JITU UTARA, MESUJI, LAMPUNG",6,212,6,218
https://kawalpemilu.org#22475,"SIDANG GUNUNG TIGA, RAWA JITU UTARA, MESUJI, LAMPUNG",1,117,88,205
https://kawalpemilu.org#22475,"SIDANG GUNUNG TIGA, RAWA JITU UTARA, MESUJI, LAMPUNG",2,128,92,220
https://kawalpemilu.org#22475,"SIDANG GUNUNG TIGA, RAWA JITU UTARA, MESUJI, LAMPUNG",3,180,59,239
https://kawalpemilu.org#22475,"SIDANG GUNUNG TIGA, RAWA JITU UTARA, MESUJI, LAMPUNG",4,156,79,235
https://kawalpemilu.org#22475,"SIDANG GUNUNG TIGA, RAWA JITU UTARA, MESUJI, LAMPUNG",5,131,74,205
https://kawalpemilu.org#22475,"SIDANG GUNUNG TIGA, RAWA JITU UTARA, MESUJI, LAMPUNG",6,147,58,205
https://kawalpemilu.org#929377,"SIDANG MUARA JAYA, RAWA JITU UTARA, MESUJI, LAMPUNG",1,93,31,124
https://kawalpemilu.org#929377,"SIDANG MUARA JAYA, RAWA JITU UTARA, MESUJI, LAMPUNG",2,97,21,118
https://kawalpemilu.org#929377,"SIDANG MUARA JAYA, RAWA JITU UTARA, MESUJI, LAMPUNG",3,150,44,194
https://kawalpemilu.org#929378,"SIDANG MAKMUR, RAWA JITU UTARA, MESUJI, LAMPUNG",1,160,25,185
https://kawalpemilu.org#929378,"SIDANG MAKMUR, RAWA JITU UTARA, MESUJI, LAMPUNG",2,121,35,156
https://kawalpemilu.org#22477,"BUKO POSO, WAY SERDANG, MESUJI, LAMPUNG",1,137,81,218
https://kawalpemilu.org#22477,"BUKO POSO, WAY SERDANG, MESUJI, LAMPUNG",2,175,91,266
https://kawalpemilu.org#22477,"BUKO POSO, WAY SERDANG, MESUJI, LAMPUNG",3,129,88,217
https://kawalpemilu.org#22477,"BUKO POSO, WAY SERDANG, MESUJI, LAMPUNG",4,191,34,225
https://kawalpemilu.org#22477,"BUKO POSO, WAY SERDANG, MESUJI, LAMPUNG",5,60,134,194
https://kawalpemilu.org#22477,"BUKO POSO, WAY SERDANG, MESUJI, LAMPUNG",6,209,44,253
https://kawalpemilu.org#22477,"BUKO POSO, WAY SERDANG, MESUJI, LAMPUNG",7,158,53,211
https://kawalpemilu.org#22477,"BUKO POSO, WAY SERDANG, MESUJI, LAMPUNG",8,169,27,196
https://kawalpemilu.org#22477,"BUKO POSO, WAY SERDANG, MESUJI, LAMPUNG",9,157,65,222
https://kawalpemilu.org#22477,"BUKO POSO, WAY SERDANG, MESUJI, LAMPUNG",10,116,73,189
https://kawalpemilu.org#22477,"BUKO POSO, WAY SERDANG, MESUJI, LAMPUNG",11,140,87,227
https://kawalpemilu.org#22477,"BUKO POSO, WAY SERDANG, MESUJI, LAMPUNG",12,151,69,220
https://kawalpemilu.org#22477,"BUKO POSO, WAY SERDANG, MESUJI, LAMPUNG",13,138,42,180
https://kawalpemilu.org#22477,"BUKO POSO, WAY SERDANG, MESUJI, LAMPUNG",14,43,20,63
https://kawalpemilu.org#22477,"BUKO POSO, WAY SERDANG, MESUJI, LAMPUNG",15,46,23,69
https://kawalpemilu.org#22478,"KEJADIAN, WAY SERDANG, MESUJI, LAMPUNG",1,151,64,215
https://kawalpemilu.org#22478,"KEJADIAN, WAY SERDANG, MESUJI, LAMPUNG",2,144,34,178
https://kawalpemilu.org#22478,"KEJADIAN, WAY SERDANG, MESUJI, LAMPUNG",3,126,53,179
https://kawalpemilu.org#22478,"KEJADIAN, WAY SERDANG, MESUJI, LAMPUNG",4,147,52,199
https://kawalpemilu.org#22478,"KEJADIAN, WAY SERDANG, MESUJI, LAMPUNG",5,175,33,208
https://kawalpemilu.org#22478,"KEJADIAN, WAY SERDANG, MESUJI, LAMPUNG",6,104,69,173
https://kawalpemilu.org#22479,"BUMI HARAPAN, WAY SERDANG, MESUJI, LAMPUNG",1,149,76,225
https://kawalpemilu.org#22479,"BUMI HARAPAN, WAY SERDANG, MESUJI, LAMPUNG",2,165,67,232
https://kawalpemilu.org#22479,"BUMI HARAPAN, WAY SERDANG, MESUJI, LAMPUNG",3,168,59,227
https://kawalpemilu.org#22479,"BUMI HARAPAN, WAY SERDANG, MESUJI, LAMPUNG",4,173,48,221
https://kawalpemilu.org#22480,"KEBUN DALAM, WAY SERDANG, MESUJI, LAMPUNG",1,148,56,204
https://kawalpemilu.org#22480,"KEBUN DALAM, WAY SERDANG, MESUJI, LAMPUNG",2,147,63,210
https://kawalpemilu.org#22480,"KEBUN DALAM, WAY SERDANG, MESUJI, LAMPUNG",3,163,56,219
https://kawalpemilu.org#22480,"KEBUN DALAM, WAY SERDANG, MESUJI, LAMPUNG",4,146,43,189
https://kawalpemilu.org#22480,"KEBUN DALAM, WAY SERDANG, MESUJI, LAMPUNG",5,137,34,172
https://kawalpemilu.org#22480,"KEBUN DALAM, WAY SERDANG, MESUJI, LAMPUNG",6,148,63,211
https://kawalpemilu.org#22480,"KEBUN DALAM, WAY SERDANG, MESUJI, LAMPUNG",7,129,58,187
https://kawalpemilu.org#22480,"KEBUN DALAM, WAY SERDANG, MESUJI, LAMPUNG",8,131,37,168
https://kawalpemilu.org#22480,"KEBUN DALAM, WAY SERDANG, MESUJI, LAMPUNG",9,136,39,175
https://kawalpemilu.org#22481,"PANCA WARNA, WAY SERDANG, MESUJI, LAMPUNG",1,167,44,211
https://kawalpemilu.org#22481,"PANCA WARNA, WAY SERDANG, MESUJI, LAMPUNG",2,144,102,246
https://kawalpemilu.org#22481,"PANCA WARNA, WAY SERDANG, MESUJI, LAMPUNG",3,70,87,157
https://kawalpemilu.org#22481,"PANCA WARNA, WAY SERDANG, MESUJI, LAMPUNG",4,112,94,206
https://kawalpemilu.org#22481,"PANCA WARNA, WAY SERDANG, MESUJI, LAMPUNG",5,152,90,242
https://kawalpemilu.org#22481,"PANCA WARNA, WAY SERDANG, MESUJI, LAMPUNG",6,188,44,232
https://kawalpemilu.org#22481,"PANCA WARNA, WAY SERDANG, MESUJI, LAMPUNG",7,168,52,220
https://kawalpemilu.org#22481,"PANCA WARNA, WAY SERDANG, MESUJI, LAMPUNG",8,162,28,190
https://kawalpemilu.org#22481,"PANCA WARNA, WAY SERDANG, MESUJI, LAMPUNG",9,128,97,225
https://kawalpemilu.org#22482,"GEDUNG BOGA, WAY SERDANG, MESUJI, LAMPUNG",1,180,76,256
https://kawalpemilu.org#22482,"GEDUNG BOGA, WAY SERDANG, MESUJI, LAMPUNG",2,168,65,233
https://kawalpemilu.org#22482,"GEDUNG BOGA, WAY SERDANG, MESUJI, LAMPUNG",3,181,58,239
https://kawalpemilu.org#22482,"GEDUNG BOGA, WAY SERDANG, MESUJI, LAMPUNG",4,145,43,188
https://kawalpemilu.org#22482,"GEDUNG BOGA, WAY SERDANG, MESUJI, LAMPUNG",5,156,65,221
https://kawalpemilu.org#22482,"GEDUNG BOGA, WAY SERDANG, MESUJI, LAMPUNG",6,176,37,213
https://kawalpemilu.org#22482,"GEDUNG BOGA, WAY SERDANG, MESUJI, LAMPUNG",7,154,55,209
https://kawalpemilu.org#22482,"GEDUNG BOGA, WAY SERDANG, MESUJI, LAMPUNG",8,149,90,239
https://kawalpemilu.org#22482,"GEDUNG BOGA, WAY SERDANG, MESUJI, LAMPUNG",9,148,47,195
https://kawalpemilu.org#22483,"SUKA AGUNG, WAY SERDANG, MESUJI, LAMPUNG",1,173,75,248
https://kawalpemilu.org#22483,"SUKA AGUNG, WAY SERDANG, MESUJI, LAMPUNG",2,192,35,227
https://kawalpemilu.org#22483,"SUKA AGUNG, WAY SERDANG, MESUJI, LAMPUNG",3,172,60,232
https://kawalpemilu.org#22483,"SUKA AGUNG, WAY SERDANG, MESUJI, LAMPUNG",4,139,76,215
https://kawalpemilu.org#22483,"SUKA AGUNG, WAY SERDANG, MESUJI, LAMPUNG",5,170,67,237
https://kawalpemilu.org#22484,"REJO MULYO, WAY SERDANG, MESUJI, LAMPUNG",1,131,24,155
https://kawalpemilu.org#22484,"REJO MULYO, WAY SERDANG, MESUJI, LAMPUNG",2,112,52,164
https://kawalpemilu.org#22484,"REJO MULYO, WAY SERDANG, MESUJI, LAMPUNG",3,105,76,181
https://kawalpemilu.org#22484,"REJO MULYO, WAY SERDANG, MESUJI, LAMPUNG",4,134,81,215
https://kawalpemilu.org#22484,"REJO MULYO, WAY SERDANG, MESUJI, LAMPUNG",5,207,53,260
https://kawalpemilu.org#22485,"HADI MULYO, WAY SERDANG, MESUJI, LAMPUNG",1,147,26,173
https://kawalpemilu.org#22485,"HADI MULYO, WAY SERDANG, MESUJI, LAMPUNG",2,138,37,175
https://kawalpemilu.org#22485,"HADI MULYO, WAY SERDANG, MESUJI, LAMPUNG",3,131,27,158
https://kawalpemilu.org#22485,"HADI MULYO, WAY SERDANG, MESUJI, LAMPUNG",4,113,47,160
https://kawalpemilu.org#22485,"HADI MULYO, WAY SERDANG, MESUJI, LAMPUNG",5,161,35,196
https://kawalpemilu.org#22485,"HADI MULYO, WAY SERDANG, MESUJI, LAMPUNG",6,152,40,192
https://kawalpemilu.org#22485,"HADI MULYO, WAY SERDANG, MESUJI, LAMPUNG",7,158,35,193
https://kawalpemilu.org#22485,"HADI MULYO, WAY SERDANG, MESUJI, LAMPUNG",8,139,46,185
https://kawalpemilu.org#22486,"LABUHAN BATIN, WAY SERDANG, MESUJI, LAMPUNG",1,112,34,146
https://kawalpemilu.org#22486,"LABUHAN BATIN, WAY SERDANG, MESUJI, LAMPUNG",2,131,45,176
https://kawalpemilu.org#22486,"LABUHAN BATIN, WAY SERDANG, MESUJI, LAMPUNG",3,173,27,200
https://kawalpemilu.org#22486,"LABUHAN BATIN, WAY SERDANG, MESUJI, LAMPUNG",4,160,47,207
https://kawalpemilu.org#22486,"LABUHAN BATIN, WAY SERDANG, MESUJI, LAMPUNG",5,102,30,132
https://kawalpemilu.org#22486,"LABUHAN BATIN, WAY SERDANG, MESUJI, LAMPUNG",6,151,5,156
https://kawalpemilu.org#22486,"LABUHAN BATIN, WAY SERDANG, MESUJI, LAMPUNG",7,81,9,90
https://kawalpemilu.org#22486,"LABUHAN BATIN, WAY SERDANG, MESUJI, LAMPUNG",8,133,5,138
https://kawalpemilu.org#22486,"LABUHAN BATIN, WAY SERDANG, MESUJI, LAMPUNG",9,143,10,153
https://kawalpemilu.org#22487,"LABUHAN BARU, WAY SERDANG, MESUJI, LAMPUNG",1,119,103,222
https://kawalpemilu.org#22487,"LABUHAN BARU, WAY SERDANG, MESUJI, LAMPUNG",2,128,91,219
https://kawalpemilu.org#22487,"LABUHAN BARU, WAY SERDANG, MESUJI, LAMPUNG",3,112,112,224
https://kawalpemilu.org#22487,"LABUHAN BARU, WAY SERDANG, MESUJI, LAMPUNG",4,127,93,220
https://kawalpemilu.org#22487,"LABUHAN BARU, WAY SERDANG, MESUJI, LAMPUNG",5,137,53,190
https://kawalpemilu.org#22488,"LABUHAN MAKMUR, WAY SERDANG, MESUJI, LAMPUNG",1,123,80,203
https://kawalpemilu.org#22488,"LABUHAN MAKMUR, WAY SERDANG, MESUJI, LAMPUNG",2,159,45,204
https://kawalpemilu.org#22489,"GEDUNG SRI MULYO, WAY SERDANG, MESUJI, LAMPUNG",1,139,62,201
https://kawalpemilu.org#22489,"GEDUNG SRI MULYO, WAY SERDANG, MESUJI, LAMPUNG",2,153,46,199
https://kawalpemilu.org#22489,"GEDUNG SRI MULYO, WAY SERDANG, MESUJI, LAMPUNG",3,140,48,188
https://kawalpemilu.org#22489,"GEDUNG SRI MULYO, WAY SERDANG, MESUJI, LAMPUNG",4,179,30,209
https://kawalpemilu.org#22489,"GEDUNG SRI MULYO, WAY SERDANG, MESUJI, LAMPUNG",5,178,19,197
https://kawalpemilu.org#22489,"GEDUNG SRI MULYO, WAY SERDANG, MESUJI, LAMPUNG",6,180,18,198
https://kawalpemilu.org#22489,"GEDUNG SRI MULYO, WAY SERDANG, MESUJI, LAMPUNG",7,192,23,215
https://kawalpemilu.org#929379,"LABUHAN PERMAI, WAY SERDANG, MESUJI, LAMPUNG",1,177,57,234
https://kawalpemilu.org#929379,"LABUHAN PERMAI, WAY SERDANG, MESUJI, LAMPUNG",2,146,58,204
https://kawalpemilu.org#929380,"SUMBER REJO, WAY SERDANG, MESUJI, LAMPUNG",1,118,95,213
https://kawalpemilu.org#929380,"SUMBER REJO, WAY SERDANG, MESUJI, LAMPUNG",2,124,58,182
https://kawalpemilu.org#929380,"SUMBER REJO, WAY SERDANG, MESUJI, LAMPUNG",3,162,49,211
https://kawalpemilu.org#929381,"MARGO BHAKTI, WAY SERDANG, MESUJI, LAMPUNG",1,192,25,217
https://kawalpemilu.org#929381,"MARGO BHAKTI, WAY SERDANG, MESUJI, LAMPUNG",2,199,32,231
https://kawalpemilu.org#929381,"MARGO BHAKTI, WAY SERDANG, MESUJI, LAMPUNG",3,189,43,232
https://kawalpemilu.org#929381,"MARGO BHAKTI, WAY SERDANG, MESUJI, LAMPUNG",4,210,20,230
https://kawalpemilu.org#929381,"MARGO BHAKTI, WAY SERDANG, MESUJI, LAMPUNG",5,195,33,228
https://kawalpemilu.org#929382,"LABUHAN MULYA, WAY SERDANG, MESUJI, LAMPUNG",1,187,63,250
https://kawalpemilu.org#929382,"LABUHAN MULYA, WAY SERDANG, MESUJI, LAMPUNG",2,149,90,239
https://kawalpemilu.org#929382,"LABUHAN MULYA, WAY SERDANG, MESUJI, LAMPUNG",3,150,77,227
https://kawalpemilu.org#929383,"KARANG MULYA, WAY SERDANG, MESUJI, LAMPUNG",1,178,47,225
https://kawalpemilu.org#929383,"KARANG MULYA, WAY SERDANG, MESUJI, LAMPUNG",2,194,28,222
https://kawalpemilu.org#929384,"TRI TUNGGAL JAYA, WAY SERDANG, MESUJI, LAMPUNG",1,137,70,207
https://kawalpemilu.org#929384,"TRI TUNGGAL JAYA, WAY SERDANG, MESUJI, LAMPUNG",2,169,44,213
https://kawalpemilu.org#929384,"TRI TUNGGAL JAYA, WAY SERDANG, MESUJI, LAMPUNG",3,129,47,176
https://kawalpemilu.org#929384,"TRI TUNGGAL JAYA, WAY SERDANG, MESUJI, LAMPUNG",4,136,30,166
https://kawalpemilu.org#929385,"SUKA MANDIRI, WAY SERDANG, MESUJI, LAMPUNG",1,174,42,216
https://kawalpemilu.org#929385,"SUKA MANDIRI, WAY SERDANG, MESUJI, LAMPUNG",2,131,80,211
https://kawalpemilu.org#929385,"SUKA MANDIRI, WAY SERDANG, MESUJI, LAMPUNG",3,188,32,220
https://kawalpemilu.org#929385,"SUKA MANDIRI, WAY SERDANG, MESUJI, LAMPUNG",4,145,56,201
https://kawalpemilu.org#929385,"SUKA MANDIRI, WAY SERDANG, MESUJI, LAMPUNG",5,131,89,220
https://kawalpemilu.org#22491,"SIMPANG PEMATANG, SIMPANG PEMATANG, MESUJI, LAMPUNG",1,96,163,259
https://kawalpemilu.org#22491,"SIMPANG PEMATANG, SIMPANG PEMATANG, MESUJI, LAMPUNG",2,82,191,273
https://kawalpemilu.org#22491,"SIMPANG PEMATANG, SIMPANG PEMATANG, MESUJI, LAMPUNG",3,101,171,272
https://kawalpemilu.org#22491,"SIMPANG PEMATANG, SIMPANG PEMATANG, MESUJI, LAMPUNG",4,116,113,229
https://kawalpemilu.org#22491,"SIMPANG PEMATANG, SIMPANG PEMATANG, MESUJI, LAMPUNG",5,128,125,253
https://kawalpemilu.org#22491,"SIMPANG PEMATANG, SIMPANG PEMATANG, MESUJI, LAMPUNG",6,97,164,261
https://kawalpemilu.org#22491,"SIMPANG PEMATANG, SIMPANG PEMATANG, MESUJI, LAMPUNG",7,84,167,251
https://kawalpemilu.org#22491,"SIMPANG PEMATANG, SIMPANG PEMATANG, MESUJI, LAMPUNG",8,41,65,106
https://kawalpemilu.org#22492,"BUDI AJI, SIMPANG PEMATANG, MESUJI, LAMPUNG",1,154,84,238
https://kawalpemilu.org#22492,"BUDI AJI, SIMPANG PEMATANG, MESUJI, LAMPUNG",2,65,171,236
https://kawalpemilu.org#22492,"BUDI AJI, SIMPANG PEMATANG, MESUJI, LAMPUNG",3,141,97,238
https://kawalpemilu.org#22492,"BUDI AJI, SIMPANG PEMATANG, MESUJI, LAMPUNG",4,137,108,245
https://kawalpemilu.org#22493,"MARGO RAHAYU, SIMPANG PEMATANG, MESUJI, LAMPUNG",1,158,90,248
https://kawalpemilu.org#22493,"MARGO RAHAYU, SIMPANG PEMATANG, MESUJI, LAMPUNG",2,107,114,221
https://kawalpemilu.org#22493,"MARGO RAHAYU, SIMPANG PEMATANG, MESUJI, LAMPUNG",3,106,96,202
https://kawalpemilu.org#22493,"MARGO RAHAYU, SIMPANG PEMATANG, MESUJI, LAMPUNG",4,129,95,224
https://kawalpemilu.org#22493,"MARGO RAHAYU, SIMPANG PEMATANG, MESUJI, LAMPUNG",5,131,94,225
https://kawalpemilu.org#22494,"HARAPAN JAYA, SIMPANG PEMATANG, MESUJI, LAMPUNG",1,114,62,176
https://kawalpemilu.org#22494,"HARAPAN JAYA, SIMPANG PEMATANG, MESUJI, LAMPUNG",3,126,58,184
https://kawalpemilu.org#22494,"HARAPAN JAYA, SIMPANG PEMATANG, MESUJI, LAMPUNG",4,116,58,174
https://kawalpemilu.org#22495,"WIRA BANGUN, SIMPANG PEMATANG, MESUJI, LAMPUNG",1,131,95,226
https://kawalpemilu.org#22495,"WIRA BANGUN, SIMPANG PEMATANG, MESUJI, LAMPUNG",2,141,69,210
https://kawalpemilu.org#22495,"WIRA BANGUN, SIMPANG PEMATANG, MESUJI, LAMPUNG",3,122,84,206
https://kawalpemilu.org#22495,"WIRA BANGUN, SIMPANG PEMATANG, MESUJI, LAMPUNG",4,116,122,238
https://kawalpemilu.org#22495,"WIRA BANGUN, SIMPANG PEMATANG, MESUJI, LAMPUNG",5,112,130,242
https://kawalpemilu.org#22495,"WIRA BANGUN, SIMPANG PEMATANG, MESUJI, LAMPUNG",6,130,97,227
https://kawalpemilu.org#22495,"WIRA BANGUN, SIMPANG PEMATANG, MESUJI, LAMPUNG",7,110,146,256
https://kawalpemilu.org#22495,"WIRA BANGUN, SIMPANG PEMATANG, MESUJI, LAMPUNG",8,134,107,241
https://kawalpemilu.org#22495,"WIRA BANGUN, SIMPANG PEMATANG, MESUJI, LAMPUNG",9,165,75,240
https://kawalpemilu.org#22495,"WIRA BANGUN, SIMPANG PEMATANG, MESUJI, LAMPUNG",10,88,49,137
https://kawalpemilu.org#22495,"WIRA BANGUN, SIMPANG PEMATANG, MESUJI, LAMPUNG",11,75,82,157
https://kawalpemilu.org#22496,"AGUNG BATIN, SIMPANG PEMATANG, MESUJI, LAMPUNG",1,156,67,223
https://kawalpemilu.org#22496,"AGUNG BATIN, SIMPANG PEMATANG, MESUJI, LAMPUNG",2,150,75,225
https://kawalpemilu.org#22496,"AGUNG BATIN, SIMPANG PEMATANG, MESUJI, LAMPUNG",3,162,68,230
https://kawalpemilu.org#22496,"AGUNG BATIN, SIMPANG PEMATANG, MESUJI, LAMPUNG",4,174,56,230
https://kawalpemilu.org#22497,"BANGUN MULYO, SIMPANG PEMATANG, MESUJI, LAMPUNG",1,175,51,226
https://kawalpemilu.org#22497,"BANGUN MULYO, SIMPANG PEMATANG, MESUJI, LAMPUNG",2,185,40,225
https://kawalpemilu.org#22497,"BANGUN MULYO, SIMPANG PEMATANG, MESUJI, LAMPUNG",3,133,67,200
https://kawalpemilu.org#22497,"BANGUN MULYO, SIMPANG PEMATANG, MESUJI, LAMPUNG",4,123,48,171
https://kawalpemilu.org#22497,"BANGUN MULYO, SIMPANG PEMATANG, MESUJI, LAMPUNG",5,126,56,182
https://kawalpemilu.org#22497,"BANGUN MULYO, SIMPANG PEMATANG, MESUJI, LAMPUNG",6,59,15,74
https://kawalpemilu.org#22498,"JAYA SAKTI, SIMPANG PEMATANG, MESUJI, LAMPUNG",1,144,102,246
https://kawalpemilu.org#22498,"JAYA SAKTI, SIMPANG PEMATANG, MESUJI, LAMPUNG",2,148,87,235
https://kawalpemilu.org#22498,"JAYA SAKTI, SIMPANG PEMATANG, MESUJI, LAMPUNG",3,117,139,256
https://kawalpemilu.org#22498,"JAYA SAKTI, SIMPANG PEMATANG, MESUJI, LAMPUNG",4,145,107,252
https://kawalpemilu.org#22498,"JAYA SAKTI, SIMPANG PEMATANG, MESUJI, LAMPUNG",5,92,127,219
https://kawalpemilu.org#22498,"JAYA SAKTI, SIMPANG PEMATANG, MESUJI, LAMPUNG",6,98,102,200
https://kawalpemilu.org#22499,"REJO BINANGUN, SIMPANG PEMATANG, MESUJI, LAMPUNG",1,179,50,229
https://kawalpemilu.org#22499,"REJO BINANGUN, SIMPANG PEMATANG, MESUJI, LAMPUNG",2,158,67,225
https://kawalpemilu.org#22499,"REJO BINANGUN, SIMPANG PEMATANG, MESUJI, LAMPUNG",3,206,44,250
https://kawalpemilu.org#929386,"SIMPANG MESUJI, SIMPANG PEMATANG, MESUJI, LAMPUNG",1,104,126,230
https://kawalpemilu.org#929386,"SIMPANG MESUJI, SIMPANG PEMATANG, MESUJI, LAMPUNG",2,118,122,240
https://kawalpemilu.org#929386,"SIMPANG MESUJI, SIMPANG PEMATANG, MESUJI, LAMPUNG",3,81,162,243
https://kawalpemilu.org#929386,"SIMPANG MESUJI, SIMPANG PEMATANG, MESUJI, LAMPUNG",4,137,112,249
https://kawalpemilu.org#929386,"SIMPANG MESUJI, SIMPANG PEMATANG, MESUJI, LAMPUNG",5,101,154,255
https://kawalpemilu.org#929386,"SIMPANG MESUJI, SIMPANG PEMATANG, MESUJI, LAMPUNG",6,71,187,258
https://kawalpemilu.org#929386,"SIMPANG MESUJI, SIMPANG PEMATANG, MESUJI, LAMPUNG",7,114,110,224
https://kawalpemilu.org#929386,"SIMPANG MESUJI, SIMPANG PEMATANG, MESUJI, LAMPUNG",8,119,159,278
https://kawalpemilu.org#929386,"SIMPANG MESUJI, SIMPANG PEMATANG, MESUJI, LAMPUNG",9,133,128,261
https://kawalpemilu.org#929386,"SIMPANG MESUJI, SIMPANG PEMATANG, MESUJI, LAMPUNG",10,104,77,181
https://kawalpemilu.org#929387,"MARGO MAKMUR, SIMPANG PEMATANG, MESUJI, LAMPUNG",1,118,77,195
https://kawalpemilu.org#929387,"MARGO MAKMUR, SIMPANG PEMATANG, MESUJI, LAMPUNG",2,135,65,200
https://kawalpemilu.org#929387,"MARGO MAKMUR, SIMPANG PEMATANG, MESUJI, LAMPUNG",3,160,43,0
https://kawalpemilu.org#929387,"MARGO MAKMUR, SIMPANG PEMATANG, MESUJI, LAMPUNG",4,150,49,199
https://kawalpemilu.org#929388,"AJI JAYA, SIMPANG PEMATANG, MESUJI, LAMPUNG",1,144,84,228
https://kawalpemilu.org#929388,"AJI JAYA, SIMPANG PEMATANG, MESUJI, LAMPUNG",2,142,79,221
https://kawalpemilu.org#929388,"AJI JAYA, SIMPANG PEMATANG, MESUJI, LAMPUNG",3,118,102,220
https://kawalpemilu.org#929388,"AJI JAYA, SIMPANG PEMATANG, MESUJI, LAMPUNG",4,133,103,236
https://kawalpemilu.org#929389,"MULYA AGUNG, SIMPANG PEMATANG, MESUJI, LAMPUNG",1,145,63,208
https://kawalpemilu.org#929389,"MULYA AGUNG, SIMPANG PEMATANG, MESUJI, LAMPUNG",2,115,69,184
https://kawalpemilu.org#929389,"MULYA AGUNG, SIMPANG PEMATANG, MESUJI, LAMPUNG",3,136,63,199
https://kawalpemilu.org#929389,"MULYA AGUNG, SIMPANG PEMATANG, MESUJI, LAMPUNG",4,88,93,181
https://kawalpemilu.org#22501,"ADI LUHUR, PANCA JAYA, MESUJI, LAMPUNG",1,158,63,221
https://kawalpemilu.org#22501,"ADI LUHUR, PANCA JAYA, MESUJI, LAMPUNG",2,196,44,240
https://kawalpemilu.org#22501,"ADI LUHUR, PANCA JAYA, MESUJI, LAMPUNG",3,167,59,226
https://kawalpemilu.org#22501,"ADI LUHUR, PANCA JAYA, MESUJI, LAMPUNG",4,207,39,246
https://kawalpemilu.org#22501,"ADI LUHUR, PANCA JAYA, MESUJI, LAMPUNG",5,178,80,258
https://kawalpemilu.org#22501,"ADI LUHUR, PANCA JAYA, MESUJI, LAMPUNG",6,131,103,234
https://kawalpemilu.org#22501,"ADI LUHUR, PANCA JAYA, MESUJI, LAMPUNG",7,132,94,226
https://kawalpemilu.org#22501,"ADI LUHUR, PANCA JAYA, MESUJI, LAMPUNG",8,105,84,189
https://kawalpemilu.org#22501,"ADI LUHUR, PANCA JAYA, MESUJI, LAMPUNG",9,168,67,235
https://kawalpemilu.org#22501,"ADI LUHUR, PANCA JAYA, MESUJI, LAMPUNG",10,112,74,186
https://kawalpemilu.org#22502,"MUKTI KARYA, PANCA JAYA, MESUJI, LAMPUNG",1,131,101,232
https://kawalpemilu.org#22502,"MUKTI KARYA, PANCA JAYA, MESUJI, LAMPUNG",2,133,111,244
https://kawalpemilu.org#22502,"MUKTI KARYA, PANCA JAYA, MESUJI, LAMPUNG",3,109,111,220
https://kawalpemilu.org#22502,"MUKTI KARYA, PANCA JAYA, MESUJI, LAMPUNG",4,135,86,221
https://kawalpemilu.org#22502,"MUKTI KARYA, PANCA JAYA, MESUJI, LAMPUNG",5,120,89,209
https://kawalpemilu.org#22502,"MUKTI KARYA, PANCA JAYA, MESUJI, LAMPUNG",6,78,155,233
https://kawalpemilu.org#22502,"MUKTI KARYA, PANCA JAYA, MESUJI, LAMPUNG",7,140,74,214
https://kawalpemilu.org#22502,"MUKTI KARYA, PANCA JAYA, MESUJI, LAMPUNG",8,123,91,214
https://kawalpemilu.org#22502,"MUKTI KARYA, PANCA JAYA, MESUJI, LAMPUNG",9,131,61,192
https://kawalpemilu.org#22502,"MUKTI KARYA, PANCA JAYA, MESUJI, LAMPUNG",10,188,46,234
https://kawalpemilu.org#22502,"MUKTI KARYA, PANCA JAYA, MESUJI, LAMPUNG",11,88,46,134
https://kawalpemilu.org#22503,"FAJAR BARU, PANCA JAYA, MESUJI, LAMPUNG",1,169,31,200
https://kawalpemilu.org#22503,"FAJAR BARU, PANCA JAYA, MESUJI, LAMPUNG",2,155,76,231
https://kawalpemilu.org#22503,"FAJAR BARU, PANCA JAYA, MESUJI, LAMPUNG",3,147,102,249
https://kawalpemilu.org#22503,"FAJAR BARU, PANCA JAYA, MESUJI, LAMPUNG",4,139,104,243
https://kawalpemilu.org#22503,"FAJAR BARU, PANCA JAYA, MESUJI, LAMPUNG",5,120,89,209
https://kawalpemilu.org#22503,"FAJAR BARU, PANCA JAYA, MESUJI, LAMPUNG",6,109,43,152
https://kawalpemilu.org#22503,"FAJAR BARU, PANCA JAYA, MESUJI, LAMPUNG",7,170,60,230
https://kawalpemilu.org#22503,"FAJAR BARU, PANCA JAYA, MESUJI, LAMPUNG",8,142,76,218
https://kawalpemilu.org#22503,"FAJAR BARU, PANCA JAYA, MESUJI, LAMPUNG",9,74,27,101
https://kawalpemilu.org#22504,"ADI MULYO, PANCA JAYA, MESUJI, LAMPUNG",1,191,55,246
https://kawalpemilu.org#22504,"ADI MULYO, PANCA JAYA, MESUJI, LAMPUNG",2,163,40,203
https://kawalpemilu.org#22504,"ADI MULYO, PANCA JAYA, MESUJI, LAMPUNG",3,137,92,229
https://kawalpemilu.org#22504,"ADI MULYO, PANCA JAYA, MESUJI, LAMPUNG",4,136,44,180
https://kawalpemilu.org#22504,"ADI MULYO, PANCA JAYA, MESUJI, LAMPUNG",5,126,40,166
https://kawalpemilu.org#22504,"ADI MULYO, PANCA JAYA, MESUJI, LAMPUNG",6,177,31,208
https://kawalpemilu.org#22505,"FAJAR ASRI, PANCA JAYA, MESUJI, LAMPUNG",1,175,62,237
https://kawalpemilu.org#22505,"FAJAR ASRI, PANCA JAYA, MESUJI, LAMPUNG",2,128,50,178
https://kawalpemilu.org#22505,"FAJAR ASRI, PANCA JAYA, MESUJI, LAMPUNG",3,132,90,222
https://kawalpemilu.org#22506,"FAJAR INDAH, PANCA JAYA, MESUJI, LAMPUNG",1,150,50,200
https://kawalpemilu.org#22506,"FAJAR INDAH, PANCA JAYA, MESUJI, LAMPUNG",2,113,62,175
https://kawalpemilu.org#22506,"FAJAR INDAH, PANCA JAYA, MESUJI, LAMPUNG",3,101,70,171
https://kawalpemilu.org#22506,"FAJAR INDAH, PANCA JAYA, MESUJI, LAMPUNG",4,122,55,177
https://kawalpemilu.org#22506,"FAJAR INDAH, PANCA JAYA, MESUJI, LAMPUNG",5,145,42,187
https://kawalpemilu.org#22506,"FAJAR INDAH, PANCA JAYA, MESUJI, LAMPUNG",6,119,81,200
https://kawalpemilu.org#22507,"ADI KARYA MULYA, PANCA JAYA, MESUJI, LAMPUNG",1,175,63,238
https://kawalpemilu.org#22507,"ADI KARYA MULYA, PANCA JAYA, MESUJI, LAMPUNG",2,144,67,211
https://kawalpemilu.org#22507,"ADI KARYA MULYA, PANCA JAYA, MESUJI, LAMPUNG",3,87,58,145
https://kawalpemilu.org#22507,"ADI KARYA MULYA, PANCA JAYA, MESUJI, LAMPUNG",4,111,34,145
https://kawalpemilu.org#22509,"BRABASAN, TANJUNG RAYA, MESUJI, LAMPUNG",1,103,128,231
https://kawalpemilu.org#22509,"BRABASAN, TANJUNG RAYA, MESUJI, LAMPUNG",2,100,133,233
https://kawalpemilu.org#22509,"BRABASAN, TANJUNG RAYA, MESUJI, LAMPUNG",3,106,98,204
https://kawalpemilu.org#22509,"BRABASAN, TANJUNG RAYA, MESUJI, LAMPUNG",4,90,140,230
https://kawalpemilu.org#22509,"BRABASAN, TANJUNG RAYA, MESUJI, LAMPUNG",5,94,150,244
https://kawalpemilu.org#22509,"BRABASAN, TANJUNG RAYA, MESUJI, LAMPUNG",6,92,75,167
https://kawalpemilu.org#22509,"BRABASAN, TANJUNG RAYA, MESUJI, LAMPUNG",7,125,56,181
https://kawalpemilu.org#22509,"BRABASAN, TANJUNG RAYA, MESUJI, LAMPUNG",8,127,129,256
https://kawalpemilu.org#22509,"BRABASAN, TANJUNG RAYA, MESUJI, LAMPUNG",9,87,94,181
https://kawalpemilu.org#22509,"BRABASAN, TANJUNG RAYA, MESUJI, LAMPUNG",10,17,32,49
https://kawalpemilu.org#22510,"GEDUNG RAM, TANJUNG RAYA, MESUJI, LAMPUNG",1,184,48,232
https://kawalpemilu.org#22510,"GEDUNG RAM, TANJUNG RAYA, MESUJI, LAMPUNG",2,172,60,232
https://kawalpemilu.org#22510,"GEDUNG RAM, TANJUNG RAYA, MESUJI, LAMPUNG",3,132,67,199
https://kawalpemilu.org#22510,"GEDUNG RAM, TANJUNG RAYA, MESUJI, LAMPUNG",4,132,107,239
https://kawalpemilu.org#22510,"GEDUNG RAM, TANJUNG RAYA, MESUJI, LAMPUNG",5,169,65,234
https://kawalpemilu.org#22510,"GEDUNG RAM, TANJUNG RAYA, MESUJI, LAMPUNG",6,166,84,250
https://kawalpemilu.org#22511,"MEKAR SARI, TANJUNG RAYA, MESUJI, LAMPUNG",1,127,34,161
https://kawalpemilu.org#22511,"MEKAR SARI, TANJUNG RAYA, MESUJI, LAMPUNG",2,148,37,185
https://kawalpemilu.org#22511,"MEKAR SARI, TANJUNG RAYA, MESUJI, LAMPUNG",3,135,24,159
https://kawalpemilu.org#22511,"MEKAR SARI, TANJUNG RAYA, MESUJI, LAMPUNG",4,143,25,168
https://kawalpemilu.org#22511,"MEKAR SARI, TANJUNG RAYA, MESUJI, LAMPUNG",5,122,52,174
https://kawalpemilu.org#22511,"MEKAR SARI, TANJUNG RAYA, MESUJI, LAMPUNG",6,140,40,180
https://kawalpemilu.org#22512,"BUJUNG BURING, TANJUNG RAYA, MESUJI, LAMPUNG",1,159,47,206
https://kawalpemilu.org#22512,"BUJUNG BURING, TANJUNG RAYA, MESUJI, LAMPUNG",2,152,63,215
https://kawalpemilu.org#22512,"BUJUNG BURING, TANJUNG RAYA, MESUJI, LAMPUNG",3,126,89,215
https://kawalpemilu.org#22512,"BUJUNG BURING, TANJUNG RAYA, MESUJI, LAMPUNG",4,145,82,227
https://kawalpemilu.org#22513,"KAGUNGAN DALAM, TANJUNG RAYA, MESUJI, LAMPUNG",1,110,31,141
https://kawalpemilu.org#22513,"KAGUNGAN DALAM, TANJUNG RAYA, MESUJI, LAMPUNG",2,122,19,141
https://kawalpemilu.org#22513,"KAGUNGAN DALAM, TANJUNG RAYA, MESUJI, LAMPUNG",3,113,16,129
https://kawalpemilu.org#22514,"TANJUNG SARI, TANJUNG RAYA, MESUJI, LAMPUNG",1,139,88,227
https://kawalpemilu.org#22514,"TANJUNG SARI, TANJUNG RAYA, MESUJI, LAMPUNG",2,133,103,236
https://kawalpemilu.org#22514,"TANJUNG SARI, TANJUNG RAYA, MESUJI, LAMPUNG",3,107,100,207
https://kawalpemilu.org#22514,"TANJUNG SARI, TANJUNG RAYA, MESUJI, LAMPUNG",4,139,64,203
https://kawalpemilu.org#22514,"TANJUNG SARI, TANJUNG RAYA, MESUJI, LAMPUNG",5,129,96,225
https://kawalpemilu.org#22514,"TANJUNG SARI, TANJUNG RAYA, MESUJI, LAMPUNG",6,92,101,193
https://kawalpemilu.org#22514,"TANJUNG SARI, TANJUNG RAYA, MESUJI, LAMPUNG",7,102,149,251
https://kawalpemilu.org#22514,"TANJUNG SARI, TANJUNG RAYA, MESUJI, LAMPUNG",8,126,61,187
https://kawalpemilu.org#22515,"HARAPAN MUKTI, TANJUNG RAYA, MESUJI, LAMPUNG",1,183,54,237
https://kawalpemilu.org#22515,"HARAPAN MUKTI, TANJUNG RAYA, MESUJI, LAMPUNG",2,168,75,243
https://kawalpemilu.org#22515,"HARAPAN MUKTI, TANJUNG RAYA, MESUJI, LAMPUNG",3,170,63,233
https://kawalpemilu.org#22515,"HARAPAN MUKTI, TANJUNG RAYA, MESUJI, LAMPUNG",4,194,46,240
https://kawalpemilu.org#22515,"HARAPAN MUKTI, TANJUNG RAYA, MESUJI, LAMPUNG",5,141,101,242
https://kawalpemilu.org#22515,"HARAPAN MUKTI, TANJUNG RAYA, MESUJI, LAMPUNG",6,155,44,199
https://kawalpemilu.org#22516,"SRI TANJUNG, TANJUNG RAYA, MESUJI, LAMPUNG",1,109,25,134
https://kawalpemilu.org#22516,"SRI TANJUNG, TANJUNG RAYA, MESUJI, LAMPUNG",2,132,16,148
https://kawalpemilu.org#22516,"SRI TANJUNG, TANJUNG RAYA, MESUJI, LAMPUNG",3,107,21,128
https://kawalpemilu.org#22516,"SRI TANJUNG, TANJUNG RAYA, MESUJI, LAMPUNG",4,144,13,157
https://kawalpemilu.org#22517,"BANGUN JAYA, TANJUNG RAYA, MESUJI, LAMPUNG",1,114,65,179
https://kawalpemilu.org#22517,"BANGUN JAYA, TANJUNG RAYA, MESUJI, LAMPUNG",2,103,76,179
https://kawalpemilu.org#22517,"BANGUN JAYA, TANJUNG RAYA, MESUJI, LAMPUNG",3,121,65,186
https://kawalpemilu.org#22517,"BANGUN JAYA, TANJUNG RAYA, MESUJI, LAMPUNG",4,70,84,154
https://kawalpemilu.org#22517,"BANGUN JAYA, TANJUNG RAYA, MESUJI, LAMPUNG",5,116,59,175
https://kawalpemilu.org#22517,"BANGUN JAYA, TANJUNG RAYA, MESUJI, LAMPUNG",6,85,62,147
https://kawalpemilu.org#22517,"BANGUN JAYA, TANJUNG RAYA, MESUJI, LAMPUNG",7,116,52,168
https://kawalpemilu.org#22517,"BANGUN JAYA, TANJUNG RAYA, MESUJI, LAMPUNG",8,123,51,174
https://kawalpemilu.org#22517,"BANGUN JAYA, TANJUNG RAYA, MESUJI, LAMPUNG",9,102,76,178
https://kawalpemilu.org#22518,"MUARA TENANG, TANJUNG RAYA, MESUJI, LAMPUNG",1,155,71,226
https://kawalpemilu.org#22518,"MUARA TENANG, TANJUNG RAYA, MESUJI, LAMPUNG",2,141,47,188
https://kawalpemilu.org#22518,"MUARA TENANG, TANJUNG RAYA, MESUJI, LAMPUNG",3,131,75,206
https://kawalpemilu.org#22518,"MUARA TENANG, TANJUNG RAYA, MESUJI, LAMPUNG",4,116,80,196
https://kawalpemilu.org#22518,"MUARA TENANG, TANJUNG RAYA, MESUJI, LAMPUNG",5,111,73,184
https://kawalpemilu.org#22518,"MUARA TENANG, TANJUNG RAYA, MESUJI, LAMPUNG",6,136,59,195
https://kawalpemilu.org#22519,"WIRA JAYA, TANJUNG RAYA, MESUJI, LAMPUNG",1,152,49,201
https://kawalpemilu.org#22519,"WIRA JAYA, TANJUNG RAYA, MESUJI, LAMPUNG",2,133,66,199
https://kawalpemilu.org#22519,"WIRA JAYA, TANJUNG RAYA, MESUJI, LAMPUNG",3,130,52,182
https://kawalpemilu.org#22519,"WIRA JAYA, TANJUNG RAYA, MESUJI, LAMPUNG",4,143,79,222
https://kawalpemilu.org#22519,"WIRA JAYA, TANJUNG RAYA, MESUJI, LAMPUNG",5,55,30,85
https://kawalpemilu.org#22520,"SINAR LAGA, TANJUNG RAYA, MESUJI, LAMPUNG",1,68,88,156
https://kawalpemilu.org#22520,"SINAR LAGA, TANJUNG RAYA, MESUJI, LAMPUNG",2,69,85,154
https://kawalpemilu.org#22520,"SINAR LAGA, TANJUNG RAYA, MESUJI, LAMPUNG",3,57,94,151
https://kawalpemilu.org#22520,"SINAR LAGA, TANJUNG RAYA, MESUJI, LAMPUNG",4,49,118,167
https://kawalpemilu.org#22520,"SINAR LAGA, TANJUNG RAYA, MESUJI, LAMPUNG",5,67,126,193
https://kawalpemilu.org#22520,"SINAR LAGA, TANJUNG RAYA, MESUJI, LAMPUNG",6,58,119,177
https://kawalpemilu.org#22520,"SINAR LAGA, TANJUNG RAYA, MESUJI, LAMPUNG",7,61,108,169
https://kawalpemilu.org#22520,"SINAR LAGA, TANJUNG RAYA, MESUJI, LAMPUNG",8,68,73,141
https://kawalpemilu.org#22520,"SINAR LAGA, TANJUNG RAYA, MESUJI, LAMPUNG",9,115,90,205
https://kawalpemilu.org#22521,"TRI KARYA MULYA, TANJUNG RAYA, MESUJI, LAMPUNG",1,136,79,215
https://kawalpemilu.org#22521,"TRI KARYA MULYA, TANJUNG RAYA, MESUJI, LAMPUNG",2,99,70,169
https://kawalpemilu.org#22521,"TRI KARYA MULYA, TANJUNG RAYA, MESUJI, LAMPUNG",3,95,127,222
https://kawalpemilu.org#22521,"TRI KARYA MULYA, TANJUNG RAYA, MESUJI, LAMPUNG",4,116,92,208
https://kawalpemilu.org#22521,"TRI KARYA MULYA, TANJUNG RAYA, MESUJI, LAMPUNG",5,90,81,171
https://kawalpemilu.org#22521,"TRI KARYA MULYA, TANJUNG RAYA, MESUJI, LAMPUNG",6,114,54,168
https://kawalpemilu.org#22521,"TRI KARYA MULYA, TANJUNG RAYA, MESUJI, LAMPUNG",7,85,126,211
https://kawalpemilu.org#929390,"BERASAN MAKMUR, TANJUNG RAYA, MESUJI, LAMPUNG",1,79,108,187
https://kawalpemilu.org#929390,"BERASAN MAKMUR, TANJUNG RAYA, MESUJI, LAMPUNG",2,65,83,148
https://kawalpemilu.org#929390,"BERASAN MAKMUR, TANJUNG RAYA, MESUJI, LAMPUNG",3,113,77,190
https://kawalpemilu.org#929390,"BERASAN MAKMUR, TANJUNG RAYA, MESUJI, LAMPUNG",4,84,124,208
https://kawalpemilu.org#929390,"BERASAN MAKMUR, TANJUNG RAYA, MESUJI, LAMPUNG",5,97,124,221
https://kawalpemilu.org#929390,"BERASAN MAKMUR, TANJUNG RAYA, MESUJI, LAMPUNG",6,98,58,156
https://kawalpemilu.org#929390,"BERASAN MAKMUR, TANJUNG RAYA, MESUJI, LAMPUNG",7,93,66,159
https://kawalpemilu.org#929390,"BERASAN MAKMUR, TANJUNG RAYA, MESUJI, LAMPUNG",8,65,66,131
https://kawalpemilu.org#929390,"BERASAN MAKMUR, TANJUNG RAYA, MESUJI, LAMPUNG",9,129,63,192
https://kawalpemilu.org#929390,"BERASAN MAKMUR, TANJUNG RAYA, MESUJI, LAMPUNG",10,82,85,167
https://kawalpemilu.org#929391,"MEKAR JAYA, TANJUNG RAYA, MESUJI, LAMPUNG",1,169,71,240
https://kawalpemilu.org#929391,"MEKAR JAYA, TANJUNG RAYA, MESUJI, LAMPUNG",2,164,52,216
https://kawalpemilu.org#929391,"MEKAR JAYA, TANJUNG RAYA, MESUJI, LAMPUNG",3,147,80,227
https://kawalpemilu.org#929391,"MEKAR JAYA, TANJUNG RAYA, MESUJI, LAMPUNG",4,186,10,196
https://kawalpemilu.org#929392,"GEDUNG MULYA, TANJUNG RAYA, MESUJI, LAMPUNG",1,117,60,177
https://kawalpemilu.org#929392,"GEDUNG MULYA, TANJUNG RAYA, MESUJI, LAMPUNG",2,132,86,218
https://kawalpemilu.org#929392,"GEDUNG MULYA, TANJUNG RAYA, MESUJI, LAMPUNG",3,68,89,157
https://kawalpemilu.org#929392,"GEDUNG MULYA, TANJUNG RAYA, MESUJI, LAMPUNG",4,94,67,161
https://kawalpemilu.org#929392,"GEDUNG MULYA, TANJUNG RAYA, MESUJI, LAMPUNG",5,105,71,176
https://kawalpemilu.org#929392,"GEDUNG MULYA, TANJUNG RAYA, MESUJI, LAMPUNG",6,70,109,179
https://kawalpemilu.org#929393,"TANJUNG HARAPAN, TANJUNG RAYA, MESUJI, LAMPUNG",1,121,44,165
https://kawalpemilu.org#929393,"TANJUNG HARAPAN, TANJUNG RAYA, MESUJI, LAMPUNG",2,138,18,156
https://kawalpemilu.org#929393,"TANJUNG HARAPAN, TANJUNG RAYA, MESUJI, LAMPUNG",3,127,26,153
https://kawalpemilu.org#929394,"MUARA TENANG TIMUR, TANJUNG RAYA, MESUJI, LAMPUNG",1,97,83,180
https://kawalpemilu.org#929394,"MUARA TENANG TIMUR, TANJUNG RAYA, MESUJI, LAMPUNG",2,93,103,196
https://kawalpemilu.org#929394,"MUARA TENANG TIMUR, TANJUNG RAYA, MESUJI, LAMPUNG",3,117,67,184
https://kawalpemilu.org#929394,"MUARA TENANG TIMUR, TANJUNG RAYA, MESUJI, LAMPUNG",4,76,111,187
https://kawalpemilu.org#929394,"MUARA TENANG TIMUR, TANJUNG RAYA, MESUJI, LAMPUNG",5,54,92,146
https://kawalpemilu.org#929394,"MUARA TENANG TIMUR, TANJUNG RAYA, MESUJI, LAMPUNG",6,136,46,185
https://kawalpemilu.org#929394,"MUARA TENANG TIMUR, TANJUNG RAYA, MESUJI, LAMPUNG",7,138,69,207
https://kawalpemilu.org#929394,"MUARA TENANG TIMUR, TANJUNG RAYA, MESUJI, LAMPUNG",8,162,34,196
https://kawalpemilu.org#929395,"SRIWIJAYA, TANJUNG RAYA, MESUJI, LAMPUNG",1,158,63,221
https://kawalpemilu.org#929395,"SRIWIJAYA, TANJUNG RAYA, MESUJI, LAMPUNG",2,167,55,222
https://kawalpemilu.org#929395,"SRIWIJAYA, TANJUNG RAYA, MESUJI, LAMPUNG",3,193,44,237
https://kawalpemilu.org#929396,"MUKTI JAYA, TANJUNG RAYA, MESUJI, LAMPUNG",1,113,48,161
https://kawalpemilu.org#929396,"MUKTI JAYA, TANJUNG RAYA, MESUJI, LAMPUNG",2,138,47,185
https://kawalpemilu.org#929396,"MUKTI JAYA, TANJUNG RAYA, MESUJI, LAMPUNG",3,116,64,180
https://kawalpemilu.org#929396,"MUKTI JAYA, TANJUNG RAYA, MESUJI, LAMPUNG",4,136,35,171
https://kawalpemilu.org#929396,"MUKTI JAYA, TANJUNG RAYA, MESUJI, LAMPUNG",5,145,32,177
https://kawalpemilu.org#929396,"MUKTI JAYA, TANJUNG RAYA, MESUJI, LAMPUNG",6,153,17,170
https://kawalpemilu.org#929397,"BUJUNG BURING BARU, TANJUNG RAYA, MESUJI, LAMPUNG",1,113,69,182
https://kawalpemilu.org#929397,"BUJUNG BURING BARU, TANJUNG RAYA, MESUJI, LAMPUNG",2,132,78,210
https://kawalpemilu.org#929397,"BUJUNG BURING BARU, TANJUNG RAYA, MESUJI, LAMPUNG",3,119,60,179
https://kawalpemilu.org#929397,"BUJUNG BURING BARU, TANJUNG RAYA, MESUJI, LAMPUNG",4,119,111,230
https://kawalpemilu.org#22525,"PANARAGAN, TULANG BAWANG TENGAH, TULANG BAWANG BARAT, LAMPUNG",1,33,205,238
https://kawalpemilu.org#22525,"PANARAGAN, TULANG BAWANG TENGAH, TULANG BAWANG BARAT, LAMPUNG",2,38,151,189
https://kawalpemilu.org#22525,"PANARAGAN, TULANG BAWANG TENGAH, TULANG BAWANG BARAT, LAMPUNG",4,50,130,180
https://kawalpemilu.org#22525,"PANARAGAN, TULANG BAWANG TENGAH, TULANG BAWANG BARAT, LAMPUNG",5,37,133,170
https://kawalpemilu.org#22525,"PANARAGAN, TULANG BAWANG TENGAH, TULANG BAWANG BARAT, LAMPUNG",6,47,125,172
https://kawalpemilu.org#22525,"PANARAGAN, TULANG BAWANG TENGAH, TULANG BAWANG BARAT, LAMPUNG",7,30,101,131
https://kawalpemilu.org#22525,"PANARAGAN, TULANG BAWANG TENGAH, TULANG BAWANG BARAT, LAMPUNG",8,18,152,170
https://kawalpemilu.org#22525,"PANARAGAN, TULANG BAWANG TENGAH, TULANG BAWANG BARAT, LAMPUNG",9,32,153,185
https://kawalpemilu.org#22525,"PANARAGAN, TULANG BAWANG TENGAH, TULANG BAWANG BARAT, LAMPUNG",10,77,162,239
https://kawalpemilu.org#22525,"PANARAGAN, TULANG BAWANG TENGAH, TULANG BAWANG BARAT, LAMPUNG",11,87,137,224
https://kawalpemilu.org#22525,"PANARAGAN, TULANG BAWANG TENGAH, TULANG BAWANG BARAT, LAMPUNG",12,58,115,173
https://kawalpemilu.org#22525,"PANARAGAN, TULANG BAWANG TENGAH, TULANG BAWANG BARAT, LAMPUNG",13,79,98,177
https://kawalpemilu.org#22525,"PANARAGAN, TULANG BAWANG TENGAH, TULANG BAWANG BARAT, LAMPUNG",14,80,93,173
https://kawalpemilu.org#22525,"PANARAGAN, TULANG BAWANG TENGAH, TULANG BAWANG BARAT, LAMPUNG",15,73,154,227
https://kawalpemilu.org#22525,"PANARAGAN, TULANG BAWANG TENGAH, TULANG BAWANG BARAT, LAMPUNG",16,38,102,140
https://kawalpemilu.org#22525,"PANARAGAN, TULANG BAWANG TENGAH, TULANG BAWANG BARAT, LAMPUNG",17,33,107,140
https://kawalpemilu.org#22525,"PANARAGAN, TULANG BAWANG TENGAH, TULANG BAWANG BARAT, LAMPUNG",18,53,43,96
https://kawalpemilu.org#22525,"PANARAGAN, TULANG BAWANG TENGAH, TULANG BAWANG BARAT, LAMPUNG",19,47,50,97
https://kawalpemilu.org#22525,"PANARAGAN, TULANG BAWANG TENGAH, TULANG BAWANG BARAT, LAMPUNG",20,64,60,124
https://kawalpemilu.org#22526,"BANDAR DEWA, TULANG BAWANG TENGAH, TULANG BAWANG BARAT, LAMPUNG",1,46,136,182
https://kawalpemilu.org#22526,"BANDAR DEWA, TULANG BAWANG TENGAH, TULANG BAWANG BARAT, LAMPUNG",2,12,91,103
https://kawalpemilu.org#22526,"BANDAR DEWA, TULANG BAWANG TENGAH, TULANG BAWANG BARAT, LAMPUNG",3,58,78,136
https://kawalpemilu.org#22526,"BANDAR DEWA, TULANG BAWANG TENGAH, TULANG BAWANG BARAT, LAMPUNG",4,45,98,143
https://kawalpemilu.org#22526,"BANDAR DEWA, TULANG BAWANG TENGAH, TULANG BAWANG BARAT, LAMPUNG",5,104,144,248
https://kawalpemilu.org#22527,"MENGGALA MAS, TULANG BAWANG TENGAH, TULANG BAWANG BARAT, LAMPUNG",1,70,109,179
https://kawalpemilu.org#22527,"MENGGALA MAS, TULANG BAWANG TENGAH, TULANG BAWANG BARAT, LAMPUNG",2,68,77,145
https://kawalpemilu.org#22527,"MENGGALA MAS, TULANG BAWANG TENGAH, TULANG BAWANG BARAT, LAMPUNG",3,39,133,172
https://kawalpemilu.org#22527,"MENGGALA MAS, TULANG BAWANG TENGAH, TULANG BAWANG BARAT, LAMPUNG",4,105,111,216
https://kawalpemilu.org#22528,"PENUMANGAN, TULANG BAWANG TENGAH, TULANG BAWANG BARAT, LAMPUNG",1,102,114,216
https://kawalpemilu.org#22528,"PENUMANGAN, TULANG BAWANG TENGAH, TULANG BAWANG BARAT, LAMPUNG",2,63,86,149
https://kawalpemilu.org#22528,"PENUMANGAN, TULANG BAWANG TENGAH, TULANG BAWANG BARAT, LAMPUNG",3,79,93,172
https://kawalpemilu.org#22528,"PENUMANGAN, TULANG BAWANG TENGAH, TULANG BAWANG BARAT, LAMPUNG",4,72,61,133
https://kawalpemilu.org#22528,"PENUMANGAN, TULANG BAWANG TENGAH, TULANG BAWANG BARAT, LAMPUNG",5,90,109,199
https://kawalpemilu.org#22528,"PENUMANGAN, TULANG BAWANG TENGAH, TULANG BAWANG BARAT, LAMPUNG",6,68,80,148
https://kawalpemilu.org#22528,"PENUMANGAN, TULANG BAWANG TENGAH, TULANG BAWANG BARAT, LAMPUNG",7,79,81,160
https://kawalpemilu.org#22528,"PENUMANGAN, TULANG BAWANG TENGAH, TULANG BAWANG BARAT, LAMPUNG",8,50,98,148
https://kawalpemilu.org#22528,"PENUMANGAN, TULANG BAWANG TENGAH, TULANG BAWANG BARAT, LAMPUNG",9,97,132,229
https://kawalpemilu.org#22528,"PENUMANGAN, TULANG BAWANG TENGAH, TULANG BAWANG BARAT, LAMPUNG",10,89,127,216
https://kawalpemilu.org#22528,"PENUMANGAN, TULANG BAWANG TENGAH, TULANG BAWANG BARAT, LAMPUNG",11,134,113,247
https://kawalpemilu.org#22528,"PENUMANGAN, TULANG BAWANG TENGAH, TULANG BAWANG BARAT, LAMPUNG",12,95,72,167
https://kawalpemilu.org#22528,"PENUMANGAN, TULANG BAWANG TENGAH, TULANG BAWANG BARAT, LAMPUNG",13,137,48,185
https://kawalpemilu.org#22528,"PENUMANGAN, TULANG BAWANG TENGAH, TULANG BAWANG BARAT, LAMPUNG",14,91,51,142
https://kawalpemilu.org#22528,"PENUMANGAN, TULANG BAWANG TENGAH, TULANG BAWANG BARAT, LAMPUNG",15,91,51,142
https://kawalpemilu.org#22528,"PENUMANGAN, TULANG BAWANG TENGAH, TULANG BAWANG BARAT, LAMPUNG",16,67,62,129
https://kawalpemilu.org#22528,"PENUMANGAN, TULANG BAWANG TENGAH, TULANG BAWANG BARAT, LAMPUNG",17,37,25,62
https://kawalpemilu.org#22528,"PENUMANGAN, TULANG BAWANG TENGAH, TULANG BAWANG BARAT, LAMPUNG",18,101,28,129
https://kawalpemilu.org#22529,"PENUMANGAN BARU, TULANG BAWANG TENGAH, TULANG BAWANG BARAT, LAMPUNG",1,59,96,155
https://kawalpemilu.org#22529,"PENUMANGAN BARU, TULANG BAWANG TENGAH, TULANG BAWANG BARAT, LAMPUNG",2,55,89,144
https://kawalpemilu.org#22529,"PENUMANGAN BARU, TULANG BAWANG TENGAH, TULANG BAWANG BARAT, LAMPUNG",3,76,83,159
https://kawalpemilu.org#22529,"PENUMANGAN BARU, TULANG BAWANG TENGAH, TULANG BAWANG BARAT, LAMPUNG",4,84,70,154
https://kawalpemilu.org#22529,"PENUMANGAN BARU, TULANG BAWANG TENGAH, TULANG BAWANG BARAT, LAMPUNG",5,134,108,242
https://kawalpemilu.org#22529,"PENUMANGAN BARU, TULANG BAWANG TENGAH, TULANG BAWANG BARAT, LAMPUNG",6,101,111,212
https://kawalpemilu.org#22529,"PENUMANGAN BARU, TULANG BAWANG TENGAH, TULANG BAWANG BARAT, LAMPUNG",7,150,102,252
https://kawalpemilu.org#22529,"PENUMANGAN BARU, TULANG BAWANG TENGAH, TULANG BAWANG BARAT, LAMPUNG",8,151,96,247
https://kawalpemilu.org#22529,"PENUMANGAN BARU, TULANG BAWANG TENGAH, TULANG BAWANG BARAT, LAMPUNG",9,93,49,142
https://kawalpemilu.org#22529,"PENUMANGAN BARU, TULANG BAWANG TENGAH, TULANG BAWANG BARAT, LAMPUNG",10,115,36,151
https://kawalpemilu.org#22529,"PENUMANGAN BARU, TULANG BAWANG TENGAH, TULANG BAWANG BARAT, LAMPUNG",11,156,100,256
https://kawalpemilu.org#22529,"PENUMANGAN BARU, TULANG BAWANG TENGAH, TULANG BAWANG BARAT, LAMPUNG",12,116,96,212
https://kawalpemilu.org#22531,"TIRTA KENCANA, TULANG BAWANG TENGAH, TULANG BAWANG BARAT, LAMPUNG",1,123,48,171
https://kawalpemilu.org#22531,"TIRTA KENCANA, TULANG BAWANG TENGAH, TULANG BAWANG BARAT, LAMPUNG",2,100,94,194
https://kawalpemilu.org#22531,"TIRTA KENCANA, TULANG BAWANG TENGAH, TULANG BAWANG BARAT, LAMPUNG",3,101,106,207
https://kawalpemilu.org#22531,"TIRTA KENCANA, TULANG BAWANG TENGAH, TULANG BAWANG BARAT, LAMPUNG",4,97,65,162
https://kawalpemilu.org#22531,"TIRTA KENCANA, TULANG BAWANG TENGAH, TULANG BAWANG BARAT, LAMPUNG",5,107,118,225
https://kawalpemilu.org#22531,"TIRTA KENCANA, TULANG BAWANG TENGAH, TULANG BAWANG BARAT, LAMPUNG",6,125,113,238
https://kawalpemilu.org#22531,"TIRTA KENCANA, TULANG BAWANG TENGAH, TULANG BAWANG BARAT, LAMPUNG",7,125,49,174
https://kawalpemilu.org#22531,"TIRTA KENCANA, TULANG BAWANG TENGAH, TULANG BAWANG BARAT, LAMPUNG",8,93,78,171
https://kawalpemilu.org#22531,"TIRTA KENCANA, TULANG BAWANG TENGAH, TULANG BAWANG BARAT, LAMPUNG",9,80,123,204
https://kawalpemilu.org#22531,"TIRTA KENCANA, TULANG BAWANG TENGAH, TULANG BAWANG BARAT, LAMPUNG",10,75,108,183
https://kawalpemilu.org#22531,"TIRTA KENCANA, TULANG BAWANG TENGAH, TULANG BAWANG BARAT, LAMPUNG",11,57,117,174
https://kawalpemilu.org#22531,"TIRTA KENCANA, TULANG BAWANG TENGAH, TULANG BAWANG BARAT, LAMPUNG",12,82,113,195
https://kawalpemilu.org#22531,"TIRTA KENCANA, TULANG BAWANG TENGAH, TULANG BAWANG BARAT, LAMPUNG",13,77,70,147
https://kawalpemilu.org#22531,"TIRTA KENCANA, TULANG BAWANG TENGAH, TULANG BAWANG BARAT, LAMPUNG",14,97,121,218
https://kawalpemilu.org#22531,"TIRTA KENCANA, TULANG BAWANG TENGAH, TULANG BAWANG BARAT, LAMPUNG",15,94,78,172
https://kawalpemilu.org#22531,"TIRTA KENCANA, TULANG BAWANG TENGAH, TULANG BAWANG BARAT, LAMPUNG",16,117,123,240
https://kawalpemilu.org#22532,"PULUNG KENCANA, TULANG BAWANG TENGAH, TULANG BAWANG BARAT, LAMPUNG",1,111,55,166
https://kawalpemilu.org#22532,"PULUNG KENCANA, TULANG BAWANG TENGAH, TULANG BAWANG BARAT, LAMPUNG",2,105,74,179
https://kawalpemilu.org#22532,"PULUNG KENCANA, TULANG BAWANG TENGAH, TULANG BAWANG BARAT, LAMPUNG",3,84,78,162
https://kawalpemilu.org#22532,"PULUNG KENCANA, TULANG BAWANG TENGAH, TULANG BAWANG BARAT, LAMPUNG",4,78,74,152
https://kawalpemilu.org#22532,"PULUNG KENCANA, TULANG BAWANG TENGAH, TULANG BAWANG BARAT, LAMPUNG",5,87,66,153
https://kawalpemilu.org#22532,"PULUNG KENCANA, TULANG BAWANG TENGAH, TULANG BAWANG BARAT, LAMPUNG",6,80,56,136
https://kawalpemilu.org#22532,"PULUNG KENCANA, TULANG BAWANG TENGAH, TULANG BAWANG BARAT, LAMPUNG",7,105,43,148
https://kawalpemilu.org#22532,"PULUNG KENCANA, TULANG BAWANG TENGAH, TULANG BAWANG BARAT, LAMPUNG",8,104,57,161
https://kawalpemilu.org#22532,"PULUNG KENCANA, TULANG BAWANG TENGAH, TULANG BAWANG BARAT, LAMPUNG",9,78,73,151
https://kawalpemilu.org#22532,"PULUNG KENCANA, TULANG BAWANG TENGAH, TULANG BAWANG BARAT, LAMPUNG",10,84,69,153
https://kawalpemilu.org#22532,"PULUNG KENCANA, TULANG BAWANG TENGAH, TULANG BAWANG BARAT, LAMPUNG",11,118,84,202
https://kawalpemilu.org#22532,"PULUNG KENCANA, TULANG BAWANG TENGAH, TULANG BAWANG BARAT, LAMPUNG",13,179,79,258
https://kawalpemilu.org#22532,"PULUNG KENCANA, TULANG BAWANG TENGAH, TULANG BAWANG BARAT, LAMPUNG",14,123,135,258
https://kawalpemilu.org#22532,"PULUNG KENCANA, TULANG BAWANG TENGAH, TULANG BAWANG BARAT, LAMPUNG",15,135,52,187
https://kawalpemilu.org#22532,"PULUNG KENCANA, TULANG BAWANG TENGAH, TULANG BAWANG BARAT, LAMPUNG",16,129,78,207
https://kawalpemilu.org#22532,"PULUNG KENCANA, TULANG BAWANG TENGAH, TULANG BAWANG BARAT, LAMPUNG",17,125,91,216
https://kawalpemilu.org#22532,"PULUNG KENCANA, TULANG BAWANG TENGAH, TULANG BAWANG BARAT, LAMPUNG",18,100,82,182
https://kawalpemilu.org#22532,"PULUNG KENCANA, TULANG BAWANG TENGAH, TULANG BAWANG BARAT, LAMPUNG",19,78,79,157
https://kawalpemilu.org#22532,"PULUNG KENCANA, TULANG BAWANG TENGAH, TULANG BAWANG BARAT, LAMPUNG",20,163,66,229
https://kawalpemilu.org#22532,"PULUNG KENCANA, TULANG BAWANG TENGAH, TULANG BAWANG BARAT, LAMPUNG",21,156,60,216
https://kawalpemilu.org#22532,"PULUNG KENCANA, TULANG BAWANG TENGAH, TULANG BAWANG BARAT, LAMPUNG",22,100,61,161
https://kawalpemilu.org#22532,"PULUNG KENCANA, TULANG BAWANG TENGAH, TULANG BAWANG BARAT, LAMPUNG",23,102,67,169
https://kawalpemilu.org#22532,"PULUNG KENCANA, TULANG BAWANG TENGAH, TULANG BAWANG BARAT, LAMPUNG",24,99,59,158
https://kawalpemilu.org#22532,"PULUNG KENCANA, TULANG BAWANG TENGAH, TULANG BAWANG BARAT, LAMPUNG",25,97,66,163
https://kawalpemilu.org#22532,"PULUNG KENCANA, TULANG BAWANG TENGAH, TULANG BAWANG BARAT, LAMPUNG",26,106,97,203
https://kawalpemilu.org#22532,"PULUNG KENCANA, TULANG BAWANG TENGAH, TULANG BAWANG BARAT, LAMPUNG",27,149,102,251
https://kawalpemilu.org#22533,"MULYA KENCANA, TULANG BAWANG TENGAH, TULANG BAWANG BARAT, LAMPUNG",1,132,77,209
https://kawalpemilu.org#22533,"MULYA KENCANA, TULANG BAWANG TENGAH, TULANG BAWANG BARAT, LAMPUNG",2,132,67,199
https://kawalpemilu.org#22533,"MULYA KENCANA, TULANG BAWANG TENGAH, TULANG BAWANG BARAT, LAMPUNG",3,135,92,227
https://kawalpemilu.org#22533,"MULYA KENCANA, TULANG BAWANG TENGAH, TULANG BAWANG BARAT, LAMPUNG",4,71,107,178
https://kawalpemilu.org#22533,"MULYA KENCANA, TULANG BAWANG TENGAH, TULANG BAWANG BARAT, LAMPUNG",5,165,56,221
https://kawalpemilu.org#22533,"MULYA KENCANA, TULANG BAWANG TENGAH, TULANG BAWANG BARAT, LAMPUNG",6,0,0,0
https://kawalpemilu.org#22533,"MULYA KENCANA, TULANG BAWANG TENGAH, TULANG BAWANG BARAT, LAMPUNG",7,151,120,271
https://kawalpemilu.org#22533,"MULYA KENCANA, TULANG BAWANG TENGAH, TULANG BAWANG BARAT, LAMPUNG",8,160,69,229
https://kawalpemilu.org#22533,"MULYA KENCANA, TULANG BAWANG TENGAH, TULANG BAWANG BARAT, LAMPUNG",9,110,93,203
https://kawalpemilu.org#22533,"MULYA KENCANA, TULANG BAWANG TENGAH, TULANG BAWANG BARAT, LAMPUNG",10,145,86,231
https://kawalpemilu.org#22533,"MULYA KENCANA, TULANG BAWANG TENGAH, TULANG BAWANG BARAT, LAMPUNG",11,134,108,242
https://kawalpemilu.org#22533,"MULYA KENCANA, TULANG BAWANG TENGAH, TULANG BAWANG BARAT, LAMPUNG",12,100,75,175
https://kawalpemilu.org#22533,"MULYA KENCANA, TULANG BAWANG TENGAH, TULANG BAWANG BARAT, LAMPUNG",13,144,64,208
https://kawalpemilu.org#22533,"MULYA KENCANA, TULANG BAWANG TENGAH, TULANG BAWANG BARAT, LAMPUNG",14,188,63,251
https://kawalpemilu.org#22533,"MULYA KENCANA, TULANG BAWANG TENGAH, TULANG BAWANG BARAT, LAMPUNG",15,202,46,248
https://kawalpemilu.org#22534,"CANDRA KENCANA, TULANG BAWANG TENGAH, TULANG BAWANG BARAT, LAMPUNG",1,120,93,213
https://kawalpemilu.org#22534,"CANDRA KENCANA, TULANG BAWANG TENGAH, TULANG BAWANG BARAT, LAMPUNG",2,107,63,170
https://kawalpemilu.org#22534,"CANDRA KENCANA, TULANG BAWANG TENGAH, TULANG BAWANG BARAT, LAMPUNG",3,115,48,163
https://kawalpemilu.org#22534,"CANDRA KENCANA, TULANG BAWANG TENGAH, TULANG BAWANG BARAT, LAMPUNG",4,93,41,134
https://kawalpemilu.org#22534,"CANDRA KENCANA, TULANG BAWANG TENGAH, TULANG BAWANG BARAT, LAMPUNG",5,183,61,244
https://kawalpemilu.org#22534,"CANDRA KENCANA, TULANG BAWANG TENGAH, TULANG BAWANG BARAT, LAMPUNG",6,171,69,240
https://kawalpemilu.org#22534,"CANDRA KENCANA, TULANG BAWANG TENGAH, TULANG BAWANG BARAT, LAMPUNG",7,116,94,210
https://kawalpemilu.org#22534,"CANDRA KENCANA, TULANG BAWANG TENGAH, TULANG BAWANG BARAT, LAMPUNG",8,179,77,256
https://kawalpemilu.org#22534,"CANDRA KENCANA, TULANG BAWANG TENGAH, TULANG BAWANG BARAT, LAMPUNG",9,117,121,238
https://kawalpemilu.org#22534,"CANDRA KENCANA, TULANG BAWANG TENGAH, TULANG BAWANG BARAT, LAMPUNG",10,123,53,176
https://kawalpemilu.org#22534,"CANDRA KENCANA, TULANG BAWANG TENGAH, TULANG BAWANG BARAT, LAMPUNG",11,133,95,228
https://kawalpemilu.org#22534,"CANDRA KENCANA, TULANG BAWANG TENGAH, TULANG BAWANG BARAT, LAMPUNG",12,130,60,190
https://kawalpemilu.org#22535,"TUNAS ASRI, TULANG BAWANG TENGAH, TULANG BAWANG BARAT, LAMPUNG",1,99,75,174
https://kawalpemilu.org#22535,"TUNAS ASRI, TULANG BAWANG TENGAH, TULANG BAWANG BARAT, LAMPUNG",2,67,61,128
https://kawalpemilu.org#22535,"TUNAS ASRI, TULANG BAWANG TENGAH, TULANG BAWANG BARAT, LAMPUNG",3,116,91,207
https://kawalpemilu.org#22535,"TUNAS ASRI, TULANG BAWANG TENGAH, TULANG BAWANG BARAT, LAMPUNG",4,105,54,159
https://kawalpemilu.org#22535,"TUNAS ASRI, TULANG BAWANG TENGAH, TULANG BAWANG BARAT, LAMPUNG",5,105,105,210
https://kawalpemilu.org#22535,"TUNAS ASRI, TULANG BAWANG TENGAH, TULANG BAWANG BARAT, LAMPUNG",6,105,60,165
https://kawalpemilu.org#22535,"TUNAS ASRI, TULANG BAWANG TENGAH, TULANG BAWANG BARAT, LAMPUNG",7,115,35,150
https://kawalpemilu.org#22535,"TUNAS ASRI, TULANG BAWANG TENGAH, TULANG BAWANG BARAT, LAMPUNG",8,70,53,123
https://kawalpemilu.org#22535,"TUNAS ASRI, TULANG BAWANG TENGAH, TULANG BAWANG BARAT, LAMPUNG",9,61,105,166
https://kawalpemilu.org#22535,"TUNAS ASRI, TULANG BAWANG TENGAH, TULANG BAWANG BARAT, LAMPUNG",10,107,136,243
https://kawalpemilu.org#22535,"TUNAS ASRI, TULANG BAWANG TENGAH, TULANG BAWANG BARAT, LAMPUNG",11,92,100,192
https://kawalpemilu.org#22535,"TUNAS ASRI, TULANG BAWANG TENGAH, TULANG BAWANG BARAT, LAMPUNG",12,75,152,227
https://kawalpemilu.org#22535,"TUNAS ASRI, TULANG BAWANG TENGAH, TULANG BAWANG BARAT, LAMPUNG",13,73,93,166
https://kawalpemilu.org#22535,"TUNAS ASRI, TULANG BAWANG TENGAH, TULANG BAWANG BARAT, LAMPUNG",14,135,103,238
https://kawalpemilu.org#22535,"TUNAS ASRI, TULANG BAWANG TENGAH, TULANG BAWANG BARAT, LAMPUNG",15,166,52,218
https://kawalpemilu.org#22535,"TUNAS ASRI, TULANG BAWANG TENGAH, TULANG BAWANG BARAT, LAMPUNG",16,62,42,104
https://kawalpemilu.org#22535,"TUNAS ASRI, TULANG BAWANG TENGAH, TULANG BAWANG BARAT, LAMPUNG",17,111,52,163
https://kawalpemilu.org#22537,"WONO KERTO, TULANG BAWANG TENGAH, TULANG BAWANG BARAT, LAMPUNG",1,120,39,159
https://kawalpemilu.org#22537,"WONO KERTO, TULANG BAWANG TENGAH, TULANG BAWANG BARAT, LAMPUNG",2,98,45,143
https://kawalpemilu.org#22537,"WONO KERTO, TULANG BAWANG TENGAH, TULANG BAWANG BARAT, LAMPUNG",3,139,68,207
https://kawalpemilu.org#22537,"WONO KERTO, TULANG BAWANG TENGAH, TULANG BAWANG BARAT, LAMPUNG",4,157,84,241
https://kawalpemilu.org#22537,"WONO KERTO, TULANG BAWANG TENGAH, TULANG BAWANG BARAT, LAMPUNG",6,52,12,64
https://kawalpemilu.org#22537,"WONO KERTO, TULANG BAWANG TENGAH, TULANG BAWANG BARAT, LAMPUNG",7,129,84,213
https://kawalpemilu.org#22593,"MULYA JAYA, TULANG BAWANG TENGAH, TULANG BAWANG BARAT, LAMPUNG",1,173,63,236
https://kawalpemilu.org#22593,"MULYA JAYA, TULANG BAWANG TENGAH, TULANG BAWANG BARAT, LAMPUNG",2,163,88,251
https://kawalpemilu.org#22593,"MULYA JAYA, TULANG BAWANG TENGAH, TULANG BAWANG BARAT, LAMPUNG",3,86,125,211
https://kawalpemilu.org#22593,"MULYA JAYA, TULANG BAWANG TENGAH, TULANG BAWANG BARAT, LAMPUNG",5,131,85,216
https://kawalpemilu.org#22593,"MULYA JAYA, TULANG BAWANG TENGAH, TULANG BAWANG BARAT, LAMPUNG",6,167,54,221
https://kawalpemilu.org#22593,"MULYA JAYA, TULANG BAWANG TENGAH, TULANG BAWANG BARAT, LAMPUNG",7,144,73,217
https://kawalpemilu.org#22593,"MULYA JAYA, TULANG BAWANG TENGAH, TULANG BAWANG BARAT, LAMPUNG",8,160,75,235
https://kawalpemilu.org#22593,"MULYA JAYA, TULANG BAWANG TENGAH, TULANG BAWANG BARAT, LAMPUNG",10,155,96,251
https://kawalpemilu.org#22593,"MULYA JAYA, TULANG BAWANG TENGAH, TULANG BAWANG BARAT, LAMPUNG",11,132,124,256
https://kawalpemilu.org#84833,"MULYO ASRI, TULANG BAWANG TENGAH, TULANG BAWANG BARAT, LAMPUNG",1,150,119,269
https://kawalpemilu.org#84833,"MULYO ASRI, TULANG BAWANG TENGAH, TULANG BAWANG BARAT, LAMPUNG",2,142,82,224
https://kawalpemilu.org#84833,"MULYO ASRI, TULANG BAWANG TENGAH, TULANG BAWANG BARAT, LAMPUNG",3,127,81,208
https://kawalpemilu.org#84833,"MULYO ASRI, TULANG BAWANG TENGAH, TULANG BAWANG BARAT, LAMPUNG",4,150,74,224
https://kawalpemilu.org#84833,"MULYO ASRI, TULANG BAWANG TENGAH, TULANG BAWANG BARAT, LAMPUNG",5,143,110,253
https://kawalpemilu.org#84833,"MULYO ASRI, TULANG BAWANG TENGAH, TULANG BAWANG BARAT, LAMPUNG",6,134,97,231
https://kawalpemilu.org#84833,"MULYO ASRI, TULANG BAWANG TENGAH, TULANG BAWANG BARAT, LAMPUNG",7,111,127,238
https://kawalpemilu.org#84833,"MULYO ASRI, TULANG BAWANG TENGAH, TULANG BAWANG BARAT, LAMPUNG",8,84,135,219
https://kawalpemilu.org#84833,"MULYO ASRI, TULANG BAWANG TENGAH, TULANG BAWANG BARAT, LAMPUNG",9,68,130,198
https://kawalpemilu.org#84833,"MULYO ASRI, TULANG BAWANG TENGAH, TULANG BAWANG BARAT, LAMPUNG",10,95,135,230
https://kawalpemilu.org#84833,"MULYO ASRI, TULANG BAWANG TENGAH, TULANG BAWANG BARAT, LAMPUNG",11,118,106,224
https://kawalpemilu.org#84833,"MULYO ASRI, TULANG BAWANG TENGAH, TULANG BAWANG BARAT, LAMPUNG",12,97,99,196
https://kawalpemilu.org#84833,"MULYO ASRI, TULANG BAWANG TENGAH, TULANG BAWANG BARAT, LAMPUNG",13,123,114,237
https://kawalpemilu.org#84833,"MULYO ASRI, TULANG BAWANG TENGAH, TULANG BAWANG BARAT, LAMPUNG",14,88,102,190
https://kawalpemilu.org#84833,"MULYO ASRI, TULANG BAWANG TENGAH, TULANG BAWANG BARAT, LAMPUNG",15,134,87,221
https://kawalpemilu.org#84833,"MULYO ASRI, TULANG BAWANG TENGAH, TULANG BAWANG BARAT, LAMPUNG",16,68,130,198
https://kawalpemilu.org#84833,"MULYO ASRI, TULANG BAWANG TENGAH, TULANG BAWANG BARAT, LAMPUNG",17,115,135,250
https://kawalpemilu.org#84833,"MULYO ASRI, TULANG BAWANG TENGAH, TULANG BAWANG BARAT, LAMPUNG",18,125,121,246
https://kawalpemilu.org#84833,"MULYO ASRI, TULANG BAWANG TENGAH, TULANG BAWANG BARAT, LAMPUNG",19,139,88,227
https://kawalpemilu.org#84833,"MULYO ASRI, TULANG BAWANG TENGAH, TULANG BAWANG BARAT, LAMPUNG",20,163,79,242
https://kawalpemilu.org#84833,"MULYO ASRI, TULANG BAWANG TENGAH, TULANG BAWANG BARAT, LAMPUNG",21,146,87,233
https://kawalpemilu.org#84833,"MULYO ASRI, TULANG BAWANG TENGAH, TULANG BAWANG BARAT, LAMPUNG",22,143,109,252
https://kawalpemilu.org#84833,"MULYO ASRI, TULANG BAWANG TENGAH, TULANG BAWANG BARAT, LAMPUNG",23,120,136,256
https://kawalpemilu.org#84833,"MULYO ASRI, TULANG BAWANG TENGAH, TULANG BAWANG BARAT, LAMPUNG",24,143,75,218
https://kawalpemilu.org#84833,"MULYO ASRI, TULANG BAWANG TENGAH, TULANG BAWANG BARAT, LAMPUNG",25,147,82,229
https://kawalpemilu.org#84833,"MULYO ASRI, TULANG BAWANG TENGAH, TULANG BAWANG BARAT, LAMPUNG",26,139,96,235
https://kawalpemilu.org#84833,"MULYO ASRI, TULANG BAWANG TENGAH, TULANG BAWANG BARAT, LAMPUNG",27,153,77,230
https://kawalpemilu.org#84833,"MULYO ASRI, TULANG BAWANG TENGAH, TULANG BAWANG BARAT, LAMPUNG",28,90,143,233
https://kawalpemilu.org#84833,"MULYO ASRI, TULANG BAWANG TENGAH, TULANG BAWANG BARAT, LAMPUNG",29,97,136,233
https://kawalpemilu.org#84833,"MULYO ASRI, TULANG BAWANG TENGAH, TULANG BAWANG BARAT, LAMPUNG",30,144,103,247
https://kawalpemilu.org#84833,"MULYO ASRI, TULANG BAWANG TENGAH, TULANG BAWANG BARAT, LAMPUNG",31,134,94,228
https://kawalpemilu.org#84833,"MULYO ASRI, TULANG BAWANG TENGAH, TULANG BAWANG BARAT, LAMPUNG",32,189,45,234
https://kawalpemilu.org#84833,"MULYO ASRI, TULANG BAWANG TENGAH, TULANG BAWANG BARAT, LAMPUNG",33,128,101,229
https://kawalpemilu.org#84834,"PANARAGAN JAYA INDAH, TULANG BAWANG TENGAH, TULANG BAWANG BARAT, LAMPUNG",1,128,138,266
https://kawalpemilu.org#84834,"PANARAGAN JAYA INDAH, TULANG BAWANG TENGAH, TULANG BAWANG BARAT, LAMPUNG",2,110,126,236
https://kawalpemilu.org#84834,"PANARAGAN JAYA INDAH, TULANG BAWANG TENGAH, TULANG BAWANG BARAT, LAMPUNG",3,104,100,204
https://kawalpemilu.org#84834,"PANARAGAN JAYA INDAH, TULANG BAWANG TENGAH, TULANG BAWANG BARAT, LAMPUNG",4,110,116,226
https://kawalpemilu.org#84835,"PANARAGAN JAYA UTAMA, TULANG BAWANG TENGAH, TULANG BAWANG BARAT, LAMPUNG",1,84,176,260
https://kawalpemilu.org#84835,"PANARAGAN JAYA UTAMA, TULANG BAWANG TENGAH, TULANG BAWANG BARAT, LAMPUNG",2,114,104,218
https://kawalpemilu.org#84835,"PANARAGAN JAYA UTAMA, TULANG BAWANG TENGAH, TULANG BAWANG BARAT, LAMPUNG",3,112,95,207
https://kawalpemilu.org#84835,"PANARAGAN JAYA UTAMA, TULANG BAWANG TENGAH, TULANG BAWANG BARAT, LAMPUNG",4,65,104,169
https://kawalpemilu.org#84835,"PANARAGAN JAYA UTAMA, TULANG BAWANG TENGAH, TULANG BAWANG BARAT, LAMPUNG",5,77,120,197
https://kawalpemilu.org#84835,"PANARAGAN JAYA UTAMA, TULANG BAWANG TENGAH, TULANG BAWANG BARAT, LAMPUNG",6,143,118,261
https://kawalpemilu.org#92001,"PANARAGAN JAYA, TULANG BAWANG TENGAH, TULANG BAWANG BARAT, LAMPUNG",1,103,176,279
https://kawalpemilu.org#92001,"PANARAGAN JAYA, TULANG BAWANG TENGAH, TULANG BAWANG BARAT, LAMPUNG",2,93,136,229
https://kawalpemilu.org#92001,"PANARAGAN JAYA, TULANG BAWANG TENGAH, TULANG BAWANG BARAT, LAMPUNG",3,78,177,255
https://kawalpemilu.org#92001,"PANARAGAN JAYA, TULANG BAWANG TENGAH, TULANG BAWANG BARAT, LAMPUNG",4,89,134,223
https://kawalpemilu.org#92001,"PANARAGAN JAYA, TULANG BAWANG TENGAH, TULANG BAWANG BARAT, LAMPUNG",5,82,139,221
https://kawalpemilu.org#92001,"PANARAGAN JAYA, TULANG BAWANG TENGAH, TULANG BAWANG BARAT, LAMPUNG",6,77,98,175
https://kawalpemilu.org#92001,"PANARAGAN JAYA, TULANG BAWANG TENGAH, TULANG BAWANG BARAT, LAMPUNG",7,128,137,265
https://kawalpemilu.org#92001,"PANARAGAN JAYA, TULANG BAWANG TENGAH, TULANG BAWANG BARAT, LAMPUNG",8,93,153,246
https://kawalpemilu.org#92001,"PANARAGAN JAYA, TULANG BAWANG TENGAH, TULANG BAWANG BARAT, LAMPUNG",9,106,113,219
https://kawalpemilu.org#92001,"PANARAGAN JAYA, TULANG BAWANG TENGAH, TULANG BAWANG BARAT, LAMPUNG",10,109,118,227
https://kawalpemilu.org#92001,"PANARAGAN JAYA, TULANG BAWANG TENGAH, TULANG BAWANG BARAT, LAMPUNG",11,82,161,243
https://kawalpemilu.org#92001,"PANARAGAN JAYA, TULANG BAWANG TENGAH, TULANG BAWANG BARAT, LAMPUNG",12,109,147,256
https://kawalpemilu.org#92001,"PANARAGAN JAYA, TULANG BAWANG TENGAH, TULANG BAWANG BARAT, LAMPUNG",13,134,110,244
https://kawalpemilu.org#92001,"PANARAGAN JAYA, TULANG BAWANG TENGAH, TULANG BAWANG BARAT, LAMPUNG",14,106,98,204
https://kawalpemilu.org#92001,"PANARAGAN JAYA, TULANG BAWANG TENGAH, TULANG BAWANG BARAT, LAMPUNG",15,102,109,211
https://kawalpemilu.org#92001,"PANARAGAN JAYA, TULANG BAWANG TENGAH, TULANG BAWANG BARAT, LAMPUNG",16,100,69,169
https://kawalpemilu.org#92001,"PANARAGAN JAYA, TULANG BAWANG TENGAH, TULANG BAWANG BARAT, LAMPUNG",17,79,167,4
https://kawalpemilu.org#929398,"TIRTA MAKMUR, TULANG BAWANG TENGAH, TULANG BAWANG BARAT, LAMPUNG",1,152,103,255
https://kawalpemilu.org#929398,"TIRTA MAKMUR, TULANG BAWANG TENGAH, TULANG BAWANG BARAT, LAMPUNG",2,158,86,244
https://kawalpemilu.org#929398,"TIRTA MAKMUR, TULANG BAWANG TENGAH, TULANG BAWANG BARAT, LAMPUNG",3,141,87,228
https://kawalpemilu.org#929398,"TIRTA MAKMUR, TULANG BAWANG TENGAH, TULANG BAWANG BARAT, LAMPUNG",4,134,83,217
https://kawalpemilu.org#929398,"TIRTA MAKMUR, TULANG BAWANG TENGAH, TULANG BAWANG BARAT, LAMPUNG",5,95,92,187
https://kawalpemilu.org#929398,"TIRTA MAKMUR, TULANG BAWANG TENGAH, TULANG BAWANG BARAT, LAMPUNG",6,131,79,210
https://kawalpemilu.org#929398,"TIRTA MAKMUR, TULANG BAWANG TENGAH, TULANG BAWANG BARAT, LAMPUNG",7,129,88,217
https://kawalpemilu.org#929398,"TIRTA MAKMUR, TULANG BAWANG TENGAH, TULANG BAWANG BARAT, LAMPUNG",8,97,142,239
https://kawalpemilu.org#929398,"TIRTA MAKMUR, TULANG BAWANG TENGAH, TULANG BAWANG BARAT, LAMPUNG",9,104,104,208
https://kawalpemilu.org#929398,"TIRTA MAKMUR, TULANG BAWANG TENGAH, TULANG BAWANG BARAT, LAMPUNG",10,121,63,184
https://kawalpemilu.org#929398,"TIRTA MAKMUR, TULANG BAWANG TENGAH, TULANG BAWANG BARAT, LAMPUNG",11,138,83,221
https://kawalpemilu.org#929399,"CANDRA MUKTI, TULANG BAWANG TENGAH, TULANG BAWANG BARAT, LAMPUNG",1,78,134,212
https://kawalpemilu.org#929399,"CANDRA MUKTI, TULANG BAWANG TENGAH, TULANG BAWANG BARAT, LAMPUNG",2,122,100,222
https://kawalpemilu.org#929399,"CANDRA MUKTI, TULANG BAWANG TENGAH, TULANG BAWANG BARAT, LAMPUNG",3,109,76,185
https://kawalpemilu.org#929399,"CANDRA MUKTI, TULANG BAWANG TENGAH, TULANG BAWANG BARAT, LAMPUNG",4,92,93,185
https://kawalpemilu.org#929399,"CANDRA MUKTI, TULANG BAWANG TENGAH, TULANG BAWANG BARAT, LAMPUNG",5,70,99,169
https://kawalpemilu.org#929399,"CANDRA MUKTI, TULANG BAWANG TENGAH, TULANG BAWANG BARAT, LAMPUNG",6,103,65,168
https://kawalpemilu.org#929399,"CANDRA MUKTI, TULANG BAWANG TENGAH, TULANG BAWANG BARAT, LAMPUNG",7,95,59,154
https://kawalpemilu.org#929399,"CANDRA MUKTI, TULANG BAWANG TENGAH, TULANG BAWANG BARAT, LAMPUNG",8,54,48,102
https://kawalpemilu.org#929399,"CANDRA MUKTI, TULANG BAWANG TENGAH, TULANG BAWANG BARAT, LAMPUNG",9,80,51,131
https://kawalpemilu.org#929400,"CANDRA JAYA, TULANG BAWANG TENGAH, TULANG BAWANG BARAT, LAMPUNG",1,140,64,204
https://kawalpemilu.org#929400,"CANDRA JAYA, TULANG BAWANG TENGAH, TULANG BAWANG BARAT, LAMPUNG",2,171,89,260
https://kawalpemilu.org#929400,"CANDRA JAYA, TULANG BAWANG TENGAH, TULANG BAWANG BARAT, LAMPUNG",3,133,87,220
https://kawalpemilu.org#929400,"CANDRA JAYA, TULANG BAWANG TENGAH, TULANG BAWANG BARAT, LAMPUNG",4,161,47,208
https://kawalpemilu.org#929400,"CANDRA JAYA, TULANG BAWANG TENGAH, TULANG BAWANG BARAT, LAMPUNG",5,136,59,195
https://kawalpemilu.org#929400,"CANDRA JAYA, TULANG BAWANG TENGAH, TULANG BAWANG BARAT, LAMPUNG",6,96,41,137
https://kawalpemilu.org#929400,"CANDRA JAYA, TULANG BAWANG TENGAH, TULANG BAWANG BARAT, LAMPUNG",7,105,61,166
https://kawalpemilu.org#929400,"CANDRA JAYA, TULANG BAWANG TENGAH, TULANG BAWANG BARAT, LAMPUNG",8,79,81,160
https://kawalpemilu.org#929400,"CANDRA JAYA, TULANG BAWANG TENGAH, TULANG BAWANG BARAT, LAMPUNG",9,77,80,157
https://kawalpemilu.org#929400,"CANDRA JAYA, TULANG BAWANG TENGAH, TULANG BAWANG BARAT, LAMPUNG",10,78,94,172
https://kawalpemilu.org#22539,"KARTA, TULANG BAWANG UDIK, TULANG BAWANG BARAT, LAMPUNG",1,48,210,258
https://kawalpemilu.org#22539,"KARTA, TULANG BAWANG UDIK, TULANG BAWANG BARAT, LAMPUNG",2,50,153,203
https://kawalpemilu.org#22539,"KARTA, TULANG BAWANG UDIK, TULANG BAWANG BARAT, LAMPUNG",3,41,147,188
https://kawalpemilu.org#22539,"KARTA, TULANG BAWANG UDIK, TULANG BAWANG BARAT, LAMPUNG",4,59,148,207
https://kawalpemilu.org#22539,"KARTA, TULANG BAWANG UDIK, TULANG BAWANG BARAT, LAMPUNG",5,66,143,209
https://kawalpemilu.org#22539,"KARTA, TULANG BAWANG UDIK, TULANG BAWANG BARAT, LAMPUNG",6,41,158,199
https://kawalpemilu.org#22539,"KARTA, TULANG BAWANG UDIK, TULANG BAWANG BARAT, LAMPUNG",7,56,130,186
https://kawalpemilu.org#22539,"KARTA, TULANG BAWANG UDIK, TULANG BAWANG BARAT, LAMPUNG",8,64,147,211
https://kawalpemilu.org#22539,"KARTA, TULANG BAWANG UDIK, TULANG BAWANG BARAT, LAMPUNG",9,116,56,172
https://kawalpemilu.org#22539,"KARTA, TULANG BAWANG UDIK, TULANG BAWANG BARAT, LAMPUNG",10,107,46,153
https://kawalpemilu.org#22539,"KARTA, TULANG BAWANG UDIK, TULANG BAWANG BARAT, LAMPUNG",11,106,59,165
https://kawalpemilu.org#22539,"KARTA, TULANG BAWANG UDIK, TULANG BAWANG BARAT, LAMPUNG",12,71,93,164
https://kawalpemilu.org#22539,"KARTA, TULANG BAWANG UDIK, TULANG BAWANG BARAT, LAMPUNG",13,99,87,191
https://kawalpemilu.org#22539,"KARTA, TULANG BAWANG UDIK, TULANG BAWANG BARAT, LAMPUNG",14,48,85,133
https://kawalpemilu.org#22540,"KARTA SARI, TULANG BAWANG UDIK, TULANG BAWANG BARAT, LAMPUNG",1,137,94,231
https://kawalpemilu.org#22540,"KARTA SARI, TULANG BAWANG UDIK, TULANG BAWANG BARAT, LAMPUNG",2,144,92,236
https://kawalpemilu.org#22540,"KARTA SARI, TULANG BAWANG UDIK, TULANG BAWANG BARAT, LAMPUNG",3,80,155,235
https://kawalpemilu.org#22540,"KARTA SARI, TULANG BAWANG UDIK, TULANG BAWANG BARAT, LAMPUNG",4,139,107,246
https://kawalpemilu.org#22540,"KARTA SARI, TULANG BAWANG UDIK, TULANG BAWANG BARAT, LAMPUNG",5,97,143,240
https://kawalpemilu.org#22540,"KARTA SARI, TULANG BAWANG UDIK, TULANG BAWANG BARAT, LAMPUNG",6,129,127,256
https://kawalpemilu.org#22540,"KARTA SARI, TULANG BAWANG UDIK, TULANG BAWANG BARAT, LAMPUNG",7,73,148,221
https://kawalpemilu.org#22541,"KARTA RAHARJA, TULANG BAWANG UDIK, TULANG BAWANG BARAT, LAMPUNG",1,118,120,238
https://kawalpemilu.org#22541,"KARTA RAHARJA, TULANG BAWANG UDIK, TULANG BAWANG BARAT, LAMPUNG",2,185,23,208
https://kawalpemilu.org#22541,"KARTA RAHARJA, TULANG BAWANG UDIK, TULANG BAWANG BARAT, LAMPUNG",3,114,75,189
https://kawalpemilu.org#22541,"KARTA RAHARJA, TULANG BAWANG UDIK, TULANG BAWANG BARAT, LAMPUNG",4,168,54,222
https://kawalpemilu.org#22541,"KARTA RAHARJA, TULANG BAWANG UDIK, TULANG BAWANG BARAT, LAMPUNG",5,97,99,196
https://kawalpemilu.org#22541,"KARTA RAHARJA, TULANG BAWANG UDIK, TULANG BAWANG BARAT, LAMPUNG",6,151,28,179
https://kawalpemilu.org#22541,"KARTA RAHARJA, TULANG BAWANG UDIK, TULANG BAWANG BARAT, LAMPUNG",7,85,130,215
https://kawalpemilu.org#22541,"KARTA RAHARJA, TULANG BAWANG UDIK, TULANG BAWANG BARAT, LAMPUNG",8,94,135,229
https://kawalpemilu.org#22541,"KARTA RAHARJA, TULANG BAWANG UDIK, TULANG BAWANG BARAT, LAMPUNG",9,147,78,225
https://kawalpemilu.org#22541,"KARTA RAHARJA, TULANG BAWANG UDIK, TULANG BAWANG BARAT, LAMPUNG",10,172,44,216
https://kawalpemilu.org#22541,"KARTA RAHARJA, TULANG BAWANG UDIK, TULANG BAWANG BARAT, LAMPUNG",11,140,70,210
https://kawalpemilu.org#22541,"KARTA RAHARJA, TULANG BAWANG UDIK, TULANG BAWANG BARAT, LAMPUNG",12,184,8,192
https://kawalpemilu.org#22541,"KARTA RAHARJA, TULANG BAWANG UDIK, TULANG BAWANG BARAT, LAMPUNG",13,105,87,192
https://kawalpemilu.org#22541,"KARTA RAHARJA, TULANG BAWANG UDIK, TULANG BAWANG BARAT, LAMPUNG",14,133,78,211
https://kawalpemilu.org#22541,"KARTA RAHARJA, TULANG BAWANG UDIK, TULANG BAWANG BARAT, LAMPUNG",15,166,68,243
https://kawalpemilu.org#22541,"KARTA RAHARJA, TULANG BAWANG UDIK, TULANG BAWANG BARAT, LAMPUNG",16,165,75,240
https://kawalpemilu.org#22541,"KARTA RAHARJA, TULANG BAWANG UDIK, TULANG BAWANG BARAT, LAMPUNG",17,207,44,251
https://kawalpemilu.org#22542,"GUNUNG KATUN TANJUNGAN, TULANG BAWANG UDIK, TULANG BAWANG BARAT, LAMPUNG",2,33,116,149
https://kawalpemilu.org#22542,"GUNUNG KATUN TANJUNGAN, TULANG BAWANG UDIK, TULANG BAWANG BARAT, LAMPUNG",3,39,61,100
https://kawalpemilu.org#22542,"GUNUNG KATUN TANJUNGAN, TULANG BAWANG UDIK, TULANG BAWANG BARAT, LAMPUNG",4,37,85,122
https://kawalpemilu.org#22542,"GUNUNG KATUN TANJUNGAN, TULANG BAWANG UDIK, TULANG BAWANG BARAT, LAMPUNG",5,50,142,192
https://kawalpemilu.org#22542,"GUNUNG KATUN TANJUNGAN, TULANG BAWANG UDIK, TULANG BAWANG BARAT, LAMPUNG",6,129,47,176
https://kawalpemilu.org#22543,"GUNUNG KATUN MALAI, TULANG BAWANG UDIK, TULANG BAWANG BARAT, LAMPUNG",1,39,128,167
https://kawalpemilu.org#22543,"GUNUNG KATUN MALAI, TULANG BAWANG UDIK, TULANG BAWANG BARAT, LAMPUNG",2,56,125,181
https://kawalpemilu.org#22543,"GUNUNG KATUN MALAI, TULANG BAWANG UDIK, TULANG BAWANG BARAT, LAMPUNG",3,81,85,166
https://kawalpemilu.org#22544,"GEDUNG RATU, TULANG BAWANG UDIK, TULANG BAWANG BARAT, LAMPUNG",1,67,135,202
https://kawalpemilu.org#22544,"GEDUNG RATU, TULANG BAWANG UDIK, TULANG BAWANG BARAT, LAMPUNG",2,32,83,115
https://kawalpemilu.org#22544,"GEDUNG RATU, TULANG BAWANG UDIK, TULANG BAWANG BARAT, LAMPUNG",3,160,42,202
https://kawalpemilu.org#22544,"GEDUNG RATU, TULANG BAWANG UDIK, TULANG BAWANG BARAT, LAMPUNG",4,104,125,229
https://kawalpemilu.org#22544,"GEDUNG RATU, TULANG BAWANG UDIK, TULANG BAWANG BARAT, LAMPUNG",5,154,128,282
https://kawalpemilu.org#22544,"GEDUNG RATU, TULANG BAWANG UDIK, TULANG BAWANG BARAT, LAMPUNG",6,128,91,219
https://kawalpemilu.org#22544,"GEDUNG RATU, TULANG BAWANG UDIK, TULANG BAWANG BARAT, LAMPUNG",7,197,23,220
https://kawalpemilu.org#22545,"KAGUNGAN RATU, TULANG BAWANG UDIK, TULANG BAWANG BARAT, LAMPUNG",1,138,57,195
https://kawalpemilu.org#22545,"KAGUNGAN RATU, TULANG BAWANG UDIK, TULANG BAWANG BARAT, LAMPUNG",2,101,77,178
https://kawalpemilu.org#22545,"KAGUNGAN RATU, TULANG BAWANG UDIK, TULANG BAWANG BARAT, LAMPUNG",3,125,68,193
https://kawalpemilu.org#22545,"KAGUNGAN RATU, TULANG BAWANG UDIK, TULANG BAWANG BARAT, LAMPUNG",4,96,79,175
https://kawalpemilu.org#22545,"KAGUNGAN RATU, TULANG BAWANG UDIK, TULANG BAWANG BARAT, LAMPUNG",5,95,91,186
https://kawalpemilu.org#22545,"KAGUNGAN RATU, TULANG BAWANG UDIK, TULANG BAWANG BARAT, LAMPUNG",6,103,108,211
https://kawalpemilu.org#22545,"KAGUNGAN RATU, TULANG BAWANG UDIK, TULANG BAWANG BARAT, LAMPUNG",7,94,108,202
https://kawalpemilu.org#22545,"KAGUNGAN RATU, TULANG BAWANG UDIK, TULANG BAWANG BARAT, LAMPUNG",8,85,90,175
https://kawalpemilu.org#22545,"KAGUNGAN RATU, TULANG BAWANG UDIK, TULANG BAWANG BARAT, LAMPUNG",9,118,96,214
https://kawalpemilu.org#22545,"KAGUNGAN RATU, TULANG BAWANG UDIK, TULANG BAWANG BARAT, LAMPUNG",10,110,100,210
https://kawalpemilu.org#22545,"KAGUNGAN RATU, TULANG BAWANG UDIK, TULANG BAWANG BARAT, LAMPUNG",11,154,50,204
https://kawalpemilu.org#22545,"KAGUNGAN RATU, TULANG BAWANG UDIK, TULANG BAWANG BARAT, LAMPUNG",12,142,29,171
https://kawalpemilu.org#22545,"KAGUNGAN RATU, TULANG BAWANG UDIK, TULANG BAWANG BARAT, LAMPUNG",13,136,28,164
https://kawalpemilu.org#22545,"KAGUNGAN RATU, TULANG BAWANG UDIK, TULANG BAWANG BARAT, LAMPUNG",14,149,68,217
https://kawalpemilu.org#22545,"KAGUNGAN RATU, TULANG BAWANG UDIK, TULANG BAWANG BARAT, LAMPUNG",15,98,77,175
https://kawalpemilu.org#22545,"KAGUNGAN RATU, TULANG BAWANG UDIK, TULANG BAWANG BARAT, LAMPUNG",16,128,58,186
https://kawalpemilu.org#22545,"KAGUNGAN RATU, TULANG BAWANG UDIK, TULANG BAWANG BARAT, LAMPUNG",17,145,49,194
https://kawalpemilu.org#22545,"KAGUNGAN RATU, TULANG BAWANG UDIK, TULANG BAWANG BARAT, LAMPUNG",18,110,82,192
https://kawalpemilu.org#22545,"KAGUNGAN RATU, TULANG BAWANG UDIK, TULANG BAWANG BARAT, LAMPUNG",19,80,99,179
https://kawalpemilu.org#22545,"KAGUNGAN RATU, TULANG BAWANG UDIK, TULANG BAWANG BARAT, LAMPUNG",20,112,69,181
https://kawalpemilu.org#22545,"KAGUNGAN RATU, TULANG BAWANG UDIK, TULANG BAWANG BARAT, LAMPUNG",21,88,84,172
https://kawalpemilu.org#22547,"WAY SIDO, TULANG BAWANG UDIK, TULANG BAWANG BARAT, LAMPUNG",1,85,78,163
https://kawalpemilu.org#22547,"WAY SIDO, TULANG BAWANG UDIK, TULANG BAWANG BARAT, LAMPUNG",2,102,61,163
https://kawalpemilu.org#22547,"WAY SIDO, TULANG BAWANG UDIK, TULANG BAWANG BARAT, LAMPUNG",3,134,64,198
https://kawalpemilu.org#22547,"WAY SIDO, TULANG BAWANG UDIK, TULANG BAWANG BARAT, LAMPUNG",4,117,79,196
https://kawalpemilu.org#22547,"WAY SIDO, TULANG BAWANG UDIK, TULANG BAWANG BARAT, LAMPUNG",5,109,89,198
https://kawalpemilu.org#22547,"WAY SIDO, TULANG BAWANG UDIK, TULANG BAWANG BARAT, LAMPUNG",6,87,122,209
https://kawalpemilu.org#22547,"WAY SIDO, TULANG BAWANG UDIK, TULANG BAWANG BARAT, LAMPUNG",7,70,125,195
https://kawalpemilu.org#22547,"WAY SIDO, TULANG BAWANG UDIK, TULANG BAWANG BARAT, LAMPUNG",8,126,77,203
https://kawalpemilu.org#22547,"WAY SIDO, TULANG BAWANG UDIK, TULANG BAWANG BARAT, LAMPUNG",9,134,79,213
https://kawalpemilu.org#22547,"WAY SIDO, TULANG BAWANG UDIK, TULANG BAWANG BARAT, LAMPUNG",10,96,130,226
https://kawalpemilu.org#22547,"WAY SIDO, TULANG BAWANG UDIK, TULANG BAWANG BARAT, LAMPUNG",11,147,65,212
https://kawalpemilu.org#90142,"MARGA KENCANA, TULANG BAWANG UDIK, TULANG BAWANG BARAT, LAMPUNG",1,85,123,208
https://kawalpemilu.org#90142,"MARGA KENCANA, TULANG BAWANG UDIK, TULANG BAWANG BARAT, LAMPUNG",2,171,41,212
https://kawalpemilu.org#90142,"MARGA KENCANA, TULANG BAWANG UDIK, TULANG BAWANG BARAT, LAMPUNG",3,121,78,199
https://kawalpemilu.org#90142,"MARGA KENCANA, TULANG BAWANG UDIK, TULANG BAWANG BARAT, LAMPUNG",4,109,95,204
https://kawalpemilu.org#90142,"MARGA KENCANA, TULANG BAWANG UDIK, TULANG BAWANG BARAT, LAMPUNG",5,134,71,205
https://kawalpemilu.org#90142,"MARGA KENCANA, TULANG BAWANG UDIK, TULANG BAWANG BARAT, LAMPUNG",6,138,49,187
https://kawalpemilu.org#90142,"MARGA KENCANA, TULANG BAWANG UDIK, TULANG BAWANG BARAT, LAMPUNG",7,149,49,198
https://kawalpemilu.org#90142,"MARGA KENCANA, TULANG BAWANG UDIK, TULANG BAWANG BARAT, LAMPUNG",8,121,84,205
https://kawalpemilu.org#90142,"MARGA KENCANA, TULANG BAWANG UDIK, TULANG BAWANG BARAT, LAMPUNG",9,143,69,212
https://kawalpemilu.org#90142,"MARGA KENCANA, TULANG BAWANG UDIK, TULANG BAWANG BARAT, LAMPUNG",10,114,88,202
https://kawalpemilu.org#90142,"MARGA KENCANA, TULANG BAWANG UDIK, TULANG BAWANG BARAT, LAMPUNG",11,113,89,202
https://kawalpemilu.org#90142,"MARGA KENCANA, TULANG BAWANG UDIK, TULANG BAWANG BARAT, LAMPUNG",12,106,99,205
https://kawalpemilu.org#90142,"MARGA KENCANA, TULANG BAWANG UDIK, TULANG BAWANG BARAT, LAMPUNG",13,144,62,206
https://kawalpemilu.org#90142,"MARGA KENCANA, TULANG BAWANG UDIK, TULANG BAWANG BARAT, LAMPUNG",14,105,71,176
https://kawalpemilu.org#90142,"MARGA KENCANA, TULANG BAWANG UDIK, TULANG BAWANG BARAT, LAMPUNG",15,131,78,209
https://kawalpemilu.org#90142,"MARGA KENCANA, TULANG BAWANG UDIK, TULANG BAWANG BARAT, LAMPUNG",16,109,100,209
https://kawalpemilu.org#22549,"TOTO MULYO, GUNUNG TERANG, TULANG BAWANG BARAT, LAMPUNG",1,172,68,240
https://kawalpemilu.org#22549,"TOTO MULYO, GUNUNG TERANG, TULANG BAWANG BARAT, LAMPUNG",2,135,88,223
https://kawalpemilu.org#22549,"TOTO MULYO, GUNUNG TERANG, TULANG BAWANG BARAT, LAMPUNG",3,169,47,216
https://kawalpemilu.org#22549,"TOTO MULYO, GUNUNG TERANG, TULANG BAWANG BARAT, LAMPUNG",4,151,35,186
https://kawalpemilu.org#22549,"TOTO MULYO, GUNUNG TERANG, TULANG BAWANG BARAT, LAMPUNG",5,174,47,221
https://kawalpemilu.org#22549,"TOTO MULYO, GUNUNG TERANG, TULANG BAWANG BARAT, LAMPUNG",6,132,60,192
https://kawalpemilu.org#22549,"TOTO MULYO, GUNUNG TERANG, TULANG BAWANG BARAT, LAMPUNG",7,154,51,205
https://kawalpemilu.org#22551,"SETIA BUMI, GUNUNG TERANG, TULANG BAWANG BARAT, LAMPUNG",1,151,73,224
https://kawalpemilu.org#22551,"SETIA BUMI, GUNUNG TERANG, TULANG BAWANG BARAT, LAMPUNG",2,141,81,222
https://kawalpemilu.org#22551,"SETIA BUMI, GUNUNG TERANG, TULANG BAWANG BARAT, LAMPUNG",3,122,96,218
https://kawalpemilu.org#22551,"SETIA BUMI, GUNUNG TERANG, TULANG BAWANG BARAT, LAMPUNG",4,142,76,218
https://kawalpemilu.org#22551,"SETIA BUMI, GUNUNG TERANG, TULANG BAWANG BARAT, LAMPUNG",5,222,37,259
https://kawalpemilu.org#22551,"SETIA BUMI, GUNUNG TERANG, TULANG BAWANG BARAT, LAMPUNG",6,165,78,243
https://kawalpemilu.org#22551,"SETIA BUMI, GUNUNG TERANG, TULANG BAWANG BARAT, LAMPUNG",8,153,59,212
https://kawalpemilu.org#84836,"KAGUNGAN JAYA, GUNUNG TERANG, TULANG BAWANG BARAT, LAMPUNG",1,191,23,214
https://kawalpemilu.org#84836,"KAGUNGAN JAYA, GUNUNG TERANG, TULANG BAWANG BARAT, LAMPUNG",2,158,12,170
https://kawalpemilu.org#84837,"TERANG MULYA, GUNUNG TERANG, TULANG BAWANG BARAT, LAMPUNG",1,97,37,134
https://kawalpemilu.org#84837,"TERANG MULYA, GUNUNG TERANG, TULANG BAWANG BARAT, LAMPUNG",2,68,29,97
https://kawalpemilu.org#84837,"TERANG MULYA, GUNUNG TERANG, TULANG BAWANG BARAT, LAMPUNG",3,57,32,89
https://kawalpemilu.org#84838,"TERANG BUMI AGUNG, GUNUNG TERANG, TULANG BAWANG BARAT, LAMPUNG",1,203,9,212
https://kawalpemilu.org#84838,"TERANG BUMI AGUNG, GUNUNG TERANG, TULANG BAWANG BARAT, LAMPUNG",2,224,30,254
https://kawalpemilu.org#84838,"TERANG BUMI AGUNG, GUNUNG TERANG, TULANG BAWANG BARAT, LAMPUNG",3,142,23,165
https://kawalpemilu.org#84838,"TERANG BUMI AGUNG, GUNUNG TERANG, TULANG BAWANG BARAT, LAMPUNG",4,138,39,177
https://kawalpemilu.org#90064,"GUNUNGTERANG, GUNUNG TERANG, TULANG BAWANG BARAT, LAMPUNG",2,68,98,166
https://kawalpemilu.org#90064,"GUNUNGTERANG, GUNUNG TERANG, TULANG BAWANG BARAT, LAMPUNG",3,145,84,229
https://kawalpemilu.org#90064,"GUNUNGTERANG, GUNUNG TERANG, TULANG BAWANG BARAT, LAMPUNG",4,0,0,0
https://kawalpemilu.org#90064,"GUNUNGTERANG, GUNUNG TERANG, TULANG BAWANG BARAT, LAMPUNG",5,138,32,170
https://kawalpemilu.org#90064,"GUNUNGTERANG, GUNUNG TERANG, TULANG BAWANG BARAT, LAMPUNG",6,106,18,124
https://kawalpemilu.org#90064,"GUNUNGTERANG, GUNUNG TERANG, TULANG BAWANG BARAT, LAMPUNG",7,125,3,128
https://kawalpemilu.org#90064,"GUNUNGTERANG, GUNUNG TERANG, TULANG BAWANG BARAT, LAMPUNG",8,145,8,153
https://kawalpemilu.org#90064,"GUNUNGTERANG, GUNUNG TERANG, TULANG BAWANG BARAT, LAMPUNG",9,196,14,210
https://kawalpemilu.org#90064,"GUNUNGTERANG, GUNUNG TERANG, TULANG BAWANG BARAT, LAMPUNG",10,221,0,221
https://kawalpemilu.org#91211,"GUNUNGAGUNG, GUNUNG TERANG, TULANG BAWANG BARAT, LAMPUNG",1,29,68,97
https://kawalpemilu.org#91211,"GUNUNGAGUNG, GUNUNG TERANG, TULANG BAWANG BARAT, LAMPUNG",2,169,50,219
https://kawalpemilu.org#91211,"GUNUNGAGUNG, GUNUNG TERANG, TULANG BAWANG BARAT, LAMPUNG",3,166,56,222
https://kawalpemilu.org#91211,"GUNUNGAGUNG, GUNUNG TERANG, TULANG BAWANG BARAT, LAMPUNG",4,133,77,210
https://kawalpemilu.org#91211,"GUNUNGAGUNG, GUNUNG TERANG, TULANG BAWANG BARAT, LAMPUNG",5,180,39,219
https://kawalpemilu.org#91211,"GUNUNGAGUNG, GUNUNG TERANG, TULANG BAWANG BARAT, LAMPUNG",6,176,28,204
https://kawalpemilu.org#91211,"GUNUNGAGUNG, GUNUNG TERANG, TULANG BAWANG BARAT, LAMPUNG",7,144,62,206
https://kawalpemilu.org#91211,"GUNUNGAGUNG, GUNUNG TERANG, TULANG BAWANG BARAT, LAMPUNG",8,42,0,42
https://kawalpemilu.org#91211,"GUNUNGAGUNG, GUNUNG TERANG, TULANG BAWANG BARAT, LAMPUNG",9,93,22,115
https://kawalpemilu.org#929401,"SETIA AGUNG, GUNUNG TERANG, TULANG BAWANG BARAT, LAMPUNG",1,188,26,214
https://kawalpemilu.org#929401,"SETIA AGUNG, GUNUNG TERANG, TULANG BAWANG BARAT, LAMPUNG",2,158,13,171
https://kawalpemilu.org#929401,"SETIA AGUNG, GUNUNG TERANG, TULANG BAWANG BARAT, LAMPUNG",3,201,39,240
https://kawalpemilu.org#929401,"SETIA AGUNG, GUNUNG TERANG, TULANG BAWANG BARAT, LAMPUNG",4,209,46,255
https://kawalpemilu.org#929403,"MULYO JADI, GUNUNG TERANG, TULANG BAWANG BARAT, LAMPUNG",1,160,109,269
https://kawalpemilu.org#929403,"MULYO JADI, GUNUNG TERANG, TULANG BAWANG BARAT, LAMPUNG",2,190,50,240
https://kawalpemilu.org#929403,"MULYO JADI, GUNUNG TERANG, TULANG BAWANG BARAT, LAMPUNG",3,140,77,217
https://kawalpemilu.org#929403,"MULYO JADI, GUNUNG TERANG, TULANG BAWANG BARAT, LAMPUNG",4,115,87,202
https://kawalpemilu.org#929403,"MULYO JADI, GUNUNG TERANG, TULANG BAWANG BARAT, LAMPUNG",5,138,75,213
https://kawalpemilu.org#929406,"TERANG MAKMUR, GUNUNG TERANG, TULANG BAWANG BARAT, LAMPUNG",1,218,19,237
https://kawalpemilu.org#929406,"TERANG MAKMUR, GUNUNG TERANG, TULANG BAWANG BARAT, LAMPUNG",2,186,29,215
https://kawalpemilu.org#22561,"KIBANG BUDI JAYA, LAMBU KIBANG, TULANG BAWANG BARAT, LAMPUNG",1,110,121,231
https://kawalpemilu.org#22561,"KIBANG BUDI JAYA, LAMBU KIBANG, TULANG BAWANG BARAT, LAMPUNG",2,143,97,240
https://kawalpemilu.org#22561,"KIBANG BUDI JAYA, LAMBU KIBANG, TULANG BAWANG BARAT, LAMPUNG",3,137,39,176
https://kawalpemilu.org#22561,"KIBANG BUDI JAYA, LAMBU KIBANG, TULANG BAWANG BARAT, LAMPUNG",4,90,76,166
https://kawalpemilu.org#22561,"KIBANG BUDI JAYA, LAMBU KIBANG, TULANG BAWANG BARAT, LAMPUNG",5,145,35,180
https://kawalpemilu.org#22561,"KIBANG BUDI JAYA, LAMBU KIBANG, TULANG BAWANG BARAT, LAMPUNG",6,155,56,211
https://kawalpemilu.org#22561,"KIBANG BUDI JAYA, LAMBU KIBANG, TULANG BAWANG BARAT, LAMPUNG",7,77,87,164
https://kawalpemilu.org#22561,"KIBANG BUDI JAYA, LAMBU KIBANG, TULANG BAWANG BARAT, LAMPUNG",8,110,99,209
https://kawalpemilu.org#22561,"KIBANG BUDI JAYA, LAMBU KIBANG, TULANG BAWANG BARAT, LAMPUNG",9,104,137,241
https://kawalpemilu.org#22561,"KIBANG BUDI JAYA, LAMBU KIBANG, TULANG BAWANG BARAT, LAMPUNG",10,149,77,226
https://kawalpemilu.org#22561,"KIBANG BUDI JAYA, LAMBU KIBANG, TULANG BAWANG BARAT, LAMPUNG",11,116,56,172
https://kawalpemilu.org#22561,"KIBANG BUDI JAYA, LAMBU KIBANG, TULANG BAWANG BARAT, LAMPUNG",12,130,73,203
https://kawalpemilu.org#22561,"KIBANG BUDI JAYA, LAMBU KIBANG, TULANG BAWANG BARAT, LAMPUNG",13,122,66,188
https://kawalpemilu.org#22561,"KIBANG BUDI JAYA, LAMBU KIBANG, TULANG BAWANG BARAT, LAMPUNG",14,174,43,217
https://kawalpemilu.org#22561,"KIBANG BUDI JAYA, LAMBU KIBANG, TULANG BAWANG BARAT, LAMPUNG",15,144,68,212
https://kawalpemilu.org#22561,"KIBANG BUDI JAYA, LAMBU KIBANG, TULANG BAWANG BARAT, LAMPUNG",16,168,19,187
https://kawalpemilu.org#22561,"KIBANG BUDI JAYA, LAMBU KIBANG, TULANG BAWANG BARAT, LAMPUNG",17,136,30,166
https://kawalpemilu.org#22563,"MEKAR SARI JAYA, LAMBU KIBANG, TULANG BAWANG BARAT, LAMPUNG",1,138,63,201
https://kawalpemilu.org#22563,"MEKAR SARI JAYA, LAMBU KIBANG, TULANG BAWANG BARAT, LAMPUNG",2,120,78,198
https://kawalpemilu.org#22563,"MEKAR SARI JAYA, LAMBU KIBANG, TULANG BAWANG BARAT, LAMPUNG",3,165,79,244
https://kawalpemilu.org#22563,"MEKAR SARI JAYA, LAMBU KIBANG, TULANG BAWANG BARAT, LAMPUNG",4,197,37,234
https://kawalpemilu.org#22564,"PAGAR JAYA, LAMBU KIBANG, TULANG BAWANG BARAT, LAMPUNG",1,115,74,189
https://kawalpemilu.org#22564,"PAGAR JAYA, LAMBU KIBANG, TULANG BAWANG BARAT, LAMPUNG",2,153,42,195
https://kawalpemilu.org#22564,"PAGAR JAYA, LAMBU KIBANG, TULANG BAWANG BARAT, LAMPUNG",3,157,35,192
https://kawalpemilu.org#22564,"PAGAR JAYA, LAMBU KIBANG, TULANG BAWANG BARAT, LAMPUNG",4,156,40,196
https://kawalpemilu.org#22564,"PAGAR JAYA, LAMBU KIBANG, TULANG BAWANG BARAT, LAMPUNG",5,175,48,223
https://kawalpemilu.org#22565,"GUNUNG SARI, LAMBU KIBANG, TULANG BAWANG BARAT, LAMPUNG",1,120,81,201
https://kawalpemilu.org#22565,"GUNUNG SARI, LAMBU KIBANG, TULANG BAWANG BARAT, LAMPUNG",2,94,74,168
https://kawalpemilu.org#22565,"GUNUNG SARI, LAMBU KIBANG, TULANG BAWANG BARAT, LAMPUNG",3,158,67,225
https://kawalpemilu.org#22565,"GUNUNG SARI, LAMBU KIBANG, TULANG BAWANG BARAT, LAMPUNG",4,135,55,190
https://kawalpemilu.org#22565,"GUNUNG SARI, LAMBU KIBANG, TULANG BAWANG BARAT, LAMPUNG",5,122,48,170
https://kawalpemilu.org#22567,"KIBANG TRI JAYA, LAMBU KIBANG, TULANG BAWANG BARAT, LAMPUNG",1,167,46,213
https://kawalpemilu.org#22567,"KIBANG TRI JAYA, LAMBU KIBANG, TULANG BAWANG BARAT, LAMPUNG",2,132,72,204
https://kawalpemilu.org#22567,"KIBANG TRI JAYA, LAMBU KIBANG, TULANG BAWANG BARAT, LAMPUNG",3,145,75,220
https://kawalpemilu.org#22567,"KIBANG TRI JAYA, LAMBU KIBANG, TULANG BAWANG BARAT, LAMPUNG",4,156,65,221
https://kawalpemilu.org#22567,"KIBANG TRI JAYA, LAMBU KIBANG, TULANG BAWANG BARAT, LAMPUNG",5,178,36,214
https://kawalpemilu.org#22567,"KIBANG TRI JAYA, LAMBU KIBANG, TULANG BAWANG BARAT, LAMPUNG",6,140,31,171
https://kawalpemilu.org#22567,"KIBANG TRI JAYA, LAMBU KIBANG, TULANG BAWANG BARAT, LAMPUNG",7,143,21,164
https://kawalpemilu.org#22568,"KIBANG YEKTI JAYA, LAMBU KIBANG, TULANG BAWANG BARAT, LAMPUNG",1,195,37,232
https://kawalpemilu.org#22568,"KIBANG YEKTI JAYA, LAMBU KIBANG, TULANG BAWANG BARAT, LAMPUNG",2,166,45,211
https://kawalpemilu.org#22568,"KIBANG YEKTI JAYA, LAMBU KIBANG, TULANG BAWANG BARAT, LAMPUNG",3,144,103,247
https://kawalpemilu.org#22568,"KIBANG YEKTI JAYA, LAMBU KIBANG, TULANG BAWANG BARAT, LAMPUNG",4,119,85,204
https://kawalpemilu.org#22568,"KIBANG YEKTI JAYA, LAMBU KIBANG, TULANG BAWANG BARAT, LAMPUNG",5,192,21,213
https://kawalpemilu.org#22568,"KIBANG YEKTI JAYA, LAMBU KIBANG, TULANG BAWANG BARAT, LAMPUNG",6,160,9,169
https://kawalpemilu.org#22568,"KIBANG YEKTI JAYA, LAMBU KIBANG, TULANG BAWANG BARAT, LAMPUNG",7,80,6,86
https://kawalpemilu.org#22568,"KIBANG YEKTI JAYA, LAMBU KIBANG, TULANG BAWANG BARAT, LAMPUNG",8,182,25,207
https://kawalpemilu.org#90006,"SUMBER REJO, LAMBU KIBANG, TULANG BAWANG BARAT, LAMPUNG",1,172,32,204
https://kawalpemilu.org#90006,"SUMBER REJO, LAMBU KIBANG, TULANG BAWANG BARAT, LAMPUNG",2,124,65,189
https://kawalpemilu.org#90006,"SUMBER REJO, LAMBU KIBANG, TULANG BAWANG BARAT, LAMPUNG",3,170,35,205
https://kawalpemilu.org#90006,"SUMBER REJO, LAMBU KIBANG, TULANG BAWANG BARAT, LAMPUNG",4,187,14,201
https://kawalpemilu.org#90006,"SUMBER REJO, LAMBU KIBANG, TULANG BAWANG BARAT, LAMPUNG",5,158,16,174
https://kawalpemilu.org#90011,"GILANG TUNGGAL MAKARTA, LAMBU KIBANG, TULANG BAWANG BARAT, LAMPUNG",1,124,100,224
https://kawalpemilu.org#90011,"GILANG TUNGGAL MAKARTA, LAMBU KIBANG, TULANG BAWANG BARAT, LAMPUNG",2,131,78,209
https://kawalpemilu.org#90011,"GILANG TUNGGAL MAKARTA, LAMBU KIBANG, TULANG BAWANG BARAT, LAMPUNG",3,135,83,218
https://kawalpemilu.org#90011,"GILANG TUNGGAL MAKARTA, LAMBU KIBANG, TULANG BAWANG BARAT, LAMPUNG",4,188,35,223
https://kawalpemilu.org#90014,"LESUNG BHAKTI JAYA, LAMBU KIBANG, TULANG BAWANG BARAT, LAMPUNG",1,146,88,234
https://kawalpemilu.org#90014,"LESUNG BHAKTI JAYA, LAMBU KIBANG, TULANG BAWANG BARAT, LAMPUNG",2,109,110,219
https://kawalpemilu.org#90014,"LESUNG BHAKTI JAYA, LAMBU KIBANG, TULANG BAWANG BARAT, LAMPUNG",3,156,62,218
https://kawalpemilu.org#90014,"LESUNG BHAKTI JAYA, LAMBU KIBANG, TULANG BAWANG BARAT, LAMPUNG",4,169,34,203
https://kawalpemilu.org#90014,"LESUNG BHAKTI JAYA, LAMBU KIBANG, TULANG BAWANG BARAT, LAMPUNG",5,136,88,224
https://kawalpemilu.org#929411,"KIBANG MULYA JAYA, LAMBU KIBANG, TULANG BAWANG BARAT, LAMPUNG",1,147,54,201
https://kawalpemilu.org#929411,"KIBANG MULYA JAYA, LAMBU KIBANG, TULANG BAWANG BARAT, LAMPUNG",2,156,43,199
https://kawalpemilu.org#929411,"KIBANG MULYA JAYA, LAMBU KIBANG, TULANG BAWANG BARAT, LAMPUNG",3,192,45,237
https://kawalpemilu.org#929411,"KIBANG MULYA JAYA, LAMBU KIBANG, TULANG BAWANG BARAT, LAMPUNG",4,113,41,154
https://kawalpemilu.org#929411,"KIBANG MULYA JAYA, LAMBU KIBANG, TULANG BAWANG BARAT, LAMPUNG",5,86,59,145
https://kawalpemilu.org#22570,"DAYA MURNI, TUMIJAJAR, TULANG BAWANG BARAT, LAMPUNG",1,127,146,273
https://kawalpemilu.org#22570,"DAYA MURNI, TUMIJAJAR, TULANG BAWANG BARAT, LAMPUNG",2,108,160,268
https://kawalpemilu.org#22570,"DAYA MURNI, TUMIJAJAR, TULANG BAWANG BARAT, LAMPUNG",4,89,145,234
https://kawalpemilu.org#22570,"DAYA MURNI, TUMIJAJAR, TULANG BAWANG BARAT, LAMPUNG",5,95,183,278
https://kawalpemilu.org#22570,"DAYA MURNI, TUMIJAJAR, TULANG BAWANG BARAT, LAMPUNG",6,102,98,200
https://kawalpemilu.org#22570,"DAYA MURNI, TUMIJAJAR, TULANG BAWANG BARAT, LAMPUNG",7,128,87,215
https://kawalpemilu.org#22570,"DAYA MURNI, TUMIJAJAR, TULANG BAWANG BARAT, LAMPUNG",8,116,84,200
https://kawalpemilu.org#22570,"DAYA MURNI, TUMIJAJAR, TULANG BAWANG BARAT, LAMPUNG",9,95,175,270
https://kawalpemilu.org#22570,"DAYA MURNI, TUMIJAJAR, TULANG BAWANG BARAT, LAMPUNG",10,110,69,179
https://kawalpemilu.org#22570,"DAYA MURNI, TUMIJAJAR, TULANG BAWANG BARAT, LAMPUNG",11,127,59,186
https://kawalpemilu.org#22570,"DAYA MURNI, TUMIJAJAR, TULANG BAWANG BARAT, LAMPUNG",12,84,150,234
https://kawalpemilu.org#22570,"DAYA MURNI, TUMIJAJAR, TULANG BAWANG BARAT, LAMPUNG",13,88,187,275
https://kawalpemilu.org#22570,"DAYA MURNI, TUMIJAJAR, TULANG BAWANG BARAT, LAMPUNG",15,89,162,251
https://kawalpemilu.org#22570,"DAYA MURNI, TUMIJAJAR, TULANG BAWANG BARAT, LAMPUNG",16,128,129,257
https://kawalpemilu.org#22570,"DAYA MURNI, TUMIJAJAR, TULANG BAWANG BARAT, LAMPUNG",17,161,103,264
https://kawalpemilu.org#22570,"DAYA MURNI, TUMIJAJAR, TULANG BAWANG BARAT, LAMPUNG",18,168,100,268
https://kawalpemilu.org#22570,"DAYA MURNI, TUMIJAJAR, TULANG BAWANG BARAT, LAMPUNG",19,141,89,230
https://kawalpemilu.org#22570,"DAYA MURNI, TUMIJAJAR, TULANG BAWANG BARAT, LAMPUNG",20,119,33,152
https://kawalpemilu.org#22570,"DAYA MURNI, TUMIJAJAR, TULANG BAWANG BARAT, LAMPUNG",21,150,18,168
https://kawalpemilu.org#22571,"DAYA SAKTI, TUMIJAJAR, TULANG BAWANG BARAT, LAMPUNG",1,197,94,213
https://kawalpemilu.org#22571,"DAYA SAKTI, TUMIJAJAR, TULANG BAWANG BARAT, LAMPUNG",2,159,67,226
https://kawalpemilu.org#22571,"DAYA SAKTI, TUMIJAJAR, TULANG BAWANG BARAT, LAMPUNG",3,160,58,218
https://kawalpemilu.org#22571,"DAYA SAKTI, TUMIJAJAR, TULANG BAWANG BARAT, LAMPUNG",4,131,82,213
https://kawalpemilu.org#22571,"DAYA SAKTI, TUMIJAJAR, TULANG BAWANG BARAT, LAMPUNG",5,124,96,219
https://kawalpemilu.org#22571,"DAYA SAKTI, TUMIJAJAR, TULANG BAWANG BARAT, LAMPUNG",6,99,106,205
https://kawalpemilu.org#22571,"DAYA SAKTI, TUMIJAJAR, TULANG BAWANG BARAT, LAMPUNG",7,101,105,206
https://kawalpemilu.org#22571,"DAYA SAKTI, TUMIJAJAR, TULANG BAWANG BARAT, LAMPUNG",8,126,103,229
https://kawalpemilu.org#22571,"DAYA SAKTI, TUMIJAJAR, TULANG BAWANG BARAT, LAMPUNG",9,121,116,237
https://kawalpemilu.org#22571,"DAYA SAKTI, TUMIJAJAR, TULANG BAWANG BARAT, LAMPUNG",10,184,69,253
https://kawalpemilu.org#22571,"DAYA SAKTI, TUMIJAJAR, TULANG BAWANG BARAT, LAMPUNG",11,177,72,249
https://kawalpemilu.org#22571,"DAYA SAKTI, TUMIJAJAR, TULANG BAWANG BARAT, LAMPUNG",12,185,75,260
https://kawalpemilu.org#22571,"DAYA SAKTI, TUMIJAJAR, TULANG BAWANG BARAT, LAMPUNG",13,178,49,227
https://kawalpemilu.org#22572,"MARGO MULYO, TUMIJAJAR, TULANG BAWANG BARAT, LAMPUNG",1,121,149,210
https://kawalpemilu.org#22572,"MARGO MULYO, TUMIJAJAR, TULANG BAWANG BARAT, LAMPUNG",2,138,121,259
https://kawalpemilu.org#22572,"MARGO MULYO, TUMIJAJAR, TULANG BAWANG BARAT, LAMPUNG",3,158,94,252
https://kawalpemilu.org#22572,"MARGO MULYO, TUMIJAJAR, TULANG BAWANG BARAT, LAMPUNG",4,173,81,254
https://kawalpemilu.org#22572,"MARGO MULYO, TUMIJAJAR, TULANG BAWANG BARAT, LAMPUNG",5,158,94,252
https://kawalpemilu.org#22572,"MARGO MULYO, TUMIJAJAR, TULANG BAWANG BARAT, LAMPUNG",6,176,70,246
https://kawalpemilu.org#22572,"MARGO MULYO, TUMIJAJAR, TULANG BAWANG BARAT, LAMPUNG",7,142,119,261
https://kawalpemilu.org#22572,"MARGO MULYO, TUMIJAJAR, TULANG BAWANG BARAT, LAMPUNG",8,185,69,254
https://kawalpemilu.org#22572,"MARGO MULYO, TUMIJAJAR, TULANG BAWANG BARAT, LAMPUNG",9,154,100,254
https://kawalpemilu.org#22572,"MARGO MULYO, TUMIJAJAR, TULANG BAWANG BARAT, LAMPUNG",10,192,49,241
https://kawalpemilu.org#22572,"MARGO MULYO, TUMIJAJAR, TULANG BAWANG BARAT, LAMPUNG",11,199,51,250
https://kawalpemilu.org#22573,"MAKARTI, TUMIJAJAR, TULANG BAWANG BARAT, LAMPUNG",1,156,84,240
https://kawalpemilu.org#22573,"MAKARTI, TUMIJAJAR, TULANG BAWANG BARAT, LAMPUNG",2,204,38,242
https://kawalpemilu.org#22573,"MAKARTI, TUMIJAJAR, TULANG BAWANG BARAT, LAMPUNG",3,191,48,239
https://kawalpemilu.org#22573,"MAKARTI, TUMIJAJAR, TULANG BAWANG BARAT, LAMPUNG",4,217,25,242
https://kawalpemilu.org#22573,"MAKARTI, TUMIJAJAR, TULANG BAWANG BARAT, LAMPUNG",6,138,77,215
https://kawalpemilu.org#22573,"MAKARTI, TUMIJAJAR, TULANG BAWANG BARAT, LAMPUNG",7,165,64,229
https://kawalpemilu.org#22573,"MAKARTI, TUMIJAJAR, TULANG BAWANG BARAT, LAMPUNG",8,182,26,208
https://kawalpemilu.org#22573,"MAKARTI, TUMIJAJAR, TULANG BAWANG BARAT, LAMPUNG",9,185,42,227
https://kawalpemilu.org#22573,"MAKARTI, TUMIJAJAR, TULANG BAWANG BARAT, LAMPUNG",10,179,68,247
https://kawalpemilu.org#22573,"MAKARTI, TUMIJAJAR, TULANG BAWANG BARAT, LAMPUNG",11,162,61,223
https://kawalpemilu.org#22573,"MAKARTI, TUMIJAJAR, TULANG BAWANG BARAT, LAMPUNG",12,169,44,213
https://kawalpemilu.org#22573,"MAKARTI, TUMIJAJAR, TULANG BAWANG BARAT, LAMPUNG",13,164,54,218
https://kawalpemilu.org#22574,"GUNUNG MENANTI, TUMIJAJAR, TULANG BAWANG BARAT, LAMPUNG",1,95,167,262
https://kawalpemilu.org#22574,"GUNUNG MENANTI, TUMIJAJAR, TULANG BAWANG BARAT, LAMPUNG",2,153,102,255
https://kawalpemilu.org#22574,"GUNUNG MENANTI, TUMIJAJAR, TULANG BAWANG BARAT, LAMPUNG",4,130,122,252
https://kawalpemilu.org#22574,"GUNUNG MENANTI, TUMIJAJAR, TULANG BAWANG BARAT, LAMPUNG",5,49,213,262
https://kawalpemilu.org#22574,"GUNUNG MENANTI, TUMIJAJAR, TULANG BAWANG BARAT, LAMPUNG",6,69,197,266
https://kawalpemilu.org#22574,"GUNUNG MENANTI, TUMIJAJAR, TULANG BAWANG BARAT, LAMPUNG",7,50,143,193
https://kawalpemilu.org#22575,"DAYA ASRI, TUMIJAJAR, TULANG BAWANG BARAT, LAMPUNG",1,113,146,259
https://kawalpemilu.org#22575,"DAYA ASRI, TUMIJAJAR, TULANG BAWANG BARAT, LAMPUNG",2,148,109,257
https://kawalpemilu.org#22575,"DAYA ASRI, TUMIJAJAR, TULANG BAWANG BARAT, LAMPUNG",3,117,136,253
https://kawalpemilu.org#22575,"DAYA ASRI, TUMIJAJAR, TULANG BAWANG BARAT, LAMPUNG",4,126,60,186
https://kawalpemilu.org#22575,"DAYA ASRI, TUMIJAJAR, TULANG BAWANG BARAT, LAMPUNG",5,104,130,234
https://kawalpemilu.org#22575,"DAYA ASRI, TUMIJAJAR, TULANG BAWANG BARAT, LAMPUNG",6,128,125,253
https://kawalpemilu.org#22575,"DAYA ASRI, TUMIJAJAR, TULANG BAWANG BARAT, LAMPUNG",7,130,99,229
https://kawalpemilu.org#22575,"DAYA ASRI, TUMIJAJAR, TULANG BAWANG BARAT, LAMPUNG",9,132,94,226
https://kawalpemilu.org#22575,"DAYA ASRI, TUMIJAJAR, TULANG BAWANG BARAT, LAMPUNG",10,127,116,243
https://kawalpemilu.org#22575,"DAYA ASRI, TUMIJAJAR, TULANG BAWANG BARAT, LAMPUNG",11,139,85,224
https://kawalpemilu.org#22576,"MURNI JAYA, TUMIJAJAR, TULANG BAWANG BARAT, LAMPUNG",1,154,98,252
https://kawalpemilu.org#22576,"MURNI JAYA, TUMIJAJAR, TULANG BAWANG BARAT, LAMPUNG",2,156,86,242
https://kawalpemilu.org#22576,"MURNI JAYA, TUMIJAJAR, TULANG BAWANG BARAT, LAMPUNG",3,158,117,275
https://kawalpemilu.org#22576,"MURNI JAYA, TUMIJAJAR, TULANG BAWANG BARAT, LAMPUNG",4,130,108,238
https://kawalpemilu.org#22576,"MURNI JAYA, TUMIJAJAR, TULANG BAWANG BARAT, LAMPUNG",5,124,98,222
https://kawalpemilu.org#22576,"MURNI JAYA, TUMIJAJAR, TULANG BAWANG BARAT, LAMPUNG",6,111,106,217
https://kawalpemilu.org#22576,"MURNI JAYA, TUMIJAJAR, TULANG BAWANG BARAT, LAMPUNG",7,128,106,234
https://kawalpemilu.org#22576,"MURNI JAYA, TUMIJAJAR, TULANG BAWANG BARAT, LAMPUNG",8,113,84,197
https://kawalpemilu.org#22576,"MURNI JAYA, TUMIJAJAR, TULANG BAWANG BARAT, LAMPUNG",9,137,41,178
https://kawalpemilu.org#22576,"MURNI JAYA, TUMIJAJAR, TULANG BAWANG BARAT, LAMPUNG",10,128,50,178
https://kawalpemilu.org#22576,"MURNI JAYA, TUMIJAJAR, TULANG BAWANG BARAT, LAMPUNG",11,103,44,147
https://kawalpemilu.org#22577,"SUMBER REJO, TUMIJAJAR, TULANG BAWANG BARAT, LAMPUNG",1,177,72,249
https://kawalpemilu.org#22577,"SUMBER REJO, TUMIJAJAR, TULANG BAWANG BARAT, LAMPUNG",2,170,66,236
https://kawalpemilu.org#22577,"SUMBER REJO, TUMIJAJAR, TULANG BAWANG BARAT, LAMPUNG",3,151,75,226
https://kawalpemilu.org#22577,"SUMBER REJO, TUMIJAJAR, TULANG BAWANG BARAT, LAMPUNG",4,190,60,250
https://kawalpemilu.org#22577,"SUMBER REJO, TUMIJAJAR, TULANG BAWANG BARAT, LAMPUNG",5,98,119,217
https://kawalpemilu.org#22577,"SUMBER REJO, TUMIJAJAR, TULANG BAWANG BARAT, LAMPUNG",6,67,183,250
https://kawalpemilu.org#22577,"SUMBER REJO, TUMIJAJAR, TULANG BAWANG BARAT, LAMPUNG",7,119,83,202
https://kawalpemilu.org#22577,"SUMBER REJO, TUMIJAJAR, TULANG BAWANG BARAT, LAMPUNG",8,141,83,224
https://kawalpemilu.org#22577,"SUMBER REJO, TUMIJAJAR, TULANG BAWANG BARAT, LAMPUNG",9,200,33,233
https://kawalpemilu.org#22578,"MARGO DADI, TUMIJAJAR, TULANG BAWANG BARAT, LAMPUNG",1,184,55,239
https://kawalpemilu.org#22578,"MARGO DADI, TUMIJAJAR, TULANG BAWANG BARAT, LAMPUNG",2,232,35,267
https://kawalpemilu.org#22578,"MARGO DADI, TUMIJAJAR, TULANG BAWANG BARAT, LAMPUNG",3,166,67,233
https://kawalpemilu.org#22578,"MARGO DADI, TUMIJAJAR, TULANG BAWANG BARAT, LAMPUNG",4,167,68,235
https://kawalpemilu.org#22578,"MARGO DADI, TUMIJAJAR, TULANG BAWANG BARAT, LAMPUNG",5,165,64,229
https://kawalpemilu.org#22578,"MARGO DADI, TUMIJAJAR, TULANG BAWANG BARAT, LAMPUNG",6,163,71,234
https://kawalpemilu.org#22578,"MARGO DADI, TUMIJAJAR, TULANG BAWANG BARAT, LAMPUNG",7,134,105,239
https://kawalpemilu.org#22578,"MARGO DADI, TUMIJAJAR, TULANG BAWANG BARAT, LAMPUNG",8,124,124,248
https://kawalpemilu.org#22578,"MARGO DADI, TUMIJAJAR, TULANG BAWANG BARAT, LAMPUNG",9,147,89,236
https://kawalpemilu.org#22578,"MARGO DADI, TUMIJAJAR, TULANG BAWANG BARAT, LAMPUNG",10,114,136,250
https://kawalpemilu.org#22578,"MARGO DADI, TUMIJAJAR, TULANG BAWANG BARAT, LAMPUNG",11,88,165,253
https://kawalpemilu.org#22578,"MARGO DADI, TUMIJAJAR, TULANG BAWANG BARAT, LAMPUNG",12,108,140,248
https://kawalpemilu.org#22578,"MARGO DADI, TUMIJAJAR, TULANG BAWANG BARAT, LAMPUNG",13,115,131,246
https://kawalpemilu.org#22578,"MARGO DADI, TUMIJAJAR, TULANG BAWANG BARAT, LAMPUNG",14,162,71,233
https://kawalpemilu.org#22579,"GUNUNG TIMBUL, TUMIJAJAR, TULANG BAWANG BARAT, LAMPUNG",1,194,50,244
https://kawalpemilu.org#22579,"GUNUNG TIMBUL, TUMIJAJAR, TULANG BAWANG BARAT, LAMPUNG",2,146,83,229
https://kawalpemilu.org#22579,"GUNUNG TIMBUL, TUMIJAJAR, TULANG BAWANG BARAT, LAMPUNG",3,157,76,233
https://kawalpemilu.org#22579,"GUNUNG TIMBUL, TUMIJAJAR, TULANG BAWANG BARAT, LAMPUNG",4,153,66,219
https://kawalpemilu.org#22579,"GUNUNG TIMBUL, TUMIJAJAR, TULANG BAWANG BARAT, LAMPUNG",5,147,68,215
https://kawalpemilu.org#22579,"GUNUNG TIMBUL, TUMIJAJAR, TULANG BAWANG BARAT, LAMPUNG",6,124,61,185
https://kawalpemilu.org#22582,"PAGAR DEWA, PAGAR DEWA, TULANG BAWANG BARAT, LAMPUNG",1,50,156,206
https://kawalpemilu.org#22582,"PAGAR DEWA, PAGAR DEWA, TULANG BAWANG BARAT, LAMPUNG",2,51,163,214
https://kawalpemilu.org#22582,"PAGAR DEWA, PAGAR DEWA, TULANG BAWANG BARAT, LAMPUNG",3,40,145,185
https://kawalpemilu.org#22582,"PAGAR DEWA, PAGAR DEWA, TULANG BAWANG BARAT, LAMPUNG",4,79,125,204
https://kawalpemilu.org#22585,"BUJUNG DEWA, PAGAR DEWA, TULANG BAWANG BARAT, LAMPUNG",2,147,58,205
https://kawalpemilu.org#22585,"BUJUNG DEWA, PAGAR DEWA, TULANG BAWANG BARAT, LAMPUNG",3,180,8,188
https://kawalpemilu.org#22586,"BUJUNG SARI MARGA, PAGAR DEWA, TULANG BAWANG BARAT, LAMPUNG",1,151,56,207
https://kawalpemilu.org#22586,"BUJUNG SARI MARGA, PAGAR DEWA, TULANG BAWANG BARAT, LAMPUNG",2,169,26,195
https://kawalpemilu.org#84839,"CAHYOU RANDU, PAGAR DEWA, TULANG BAWANG BARAT, LAMPUNG",1,115,148,263
https://kawalpemilu.org#84839,"CAHYOU RANDU, PAGAR DEWA, TULANG BAWANG BARAT, LAMPUNG",2,188,25,213
https://kawalpemilu.org#84839,"CAHYOU RANDU, PAGAR DEWA, TULANG BAWANG BARAT, LAMPUNG",4,130,133,263
https://kawalpemilu.org#84840,"MARGA JAYA INDAH, PAGAR DEWA, TULANG BAWANG BARAT, LAMPUNG",1,168,26,194
https://kawalpemilu.org#84840,"MARGA JAYA INDAH, PAGAR DEWA, TULANG BAWANG BARAT, LAMPUNG",2,163,55,218
https://kawalpemilu.org#84840,"MARGA JAYA INDAH, PAGAR DEWA, TULANG BAWANG BARAT, LAMPUNG",3,139,48,187
https://kawalpemilu.org#89924,"PAGAR DEWA SUKAMULYA, PAGAR DEWA, TULANG BAWANG BARAT, LAMPUNG",1,164,79,243
https://kawalpemilu.org#89924,"PAGAR DEWA SUKAMULYA, PAGAR DEWA, TULANG BAWANG BARAT, LAMPUNG",2,180,62,242
https://kawalpemilu.org#22588,"TUNAS JAYA, GUNUNG AGUNG, TULANG BAWANG BARAT, LAMPUNG",1,183,33,216
https://kawalpemilu.org#22588,"TUNAS JAYA, GUNUNG AGUNG, TULANG BAWANG BARAT, LAMPUNG",2,190,48,238
https://kawalpemilu.org#22588,"TUNAS JAYA, GUNUNG AGUNG, TULANG BAWANG BARAT, LAMPUNG",3,199,35,234
https://kawalpemilu.org#22588,"TUNAS JAYA, GUNUNG AGUNG, TULANG BAWANG BARAT, LAMPUNG",4,193,45,238
https://kawalpemilu.org#22588,"TUNAS JAYA, GUNUNG AGUNG, TULANG BAWANG BARAT, LAMPUNG",5,175,68,243
https://kawalpemilu.org#22588,"TUNAS JAYA, GUNUNG AGUNG, TULANG BAWANG BARAT, LAMPUNG",6,162,69,231
https://kawalpemilu.org#22588,"TUNAS JAYA, GUNUNG AGUNG, TULANG BAWANG BARAT, LAMPUNG",7,152,48,200
https://kawalpemilu.org#22588,"TUNAS JAYA, GUNUNG AGUNG, TULANG BAWANG BARAT, LAMPUNG",8,171,54,225
https://kawalpemilu.org#22588,"TUNAS JAYA, GUNUNG AGUNG, TULANG BAWANG BARAT, LAMPUNG",9,166,47,213
https://kawalpemilu.org#22588,"TUNAS JAYA, GUNUNG AGUNG, TULANG BAWANG BARAT, LAMPUNG",10,172,59,231
https://kawalpemilu.org#22588,"TUNAS JAYA, GUNUNG AGUNG, TULANG BAWANG BARAT, LAMPUNG",11,200,40,240
https://kawalpemilu.org#22589,"MEKAR JAYA, GUNUNG AGUNG, TULANG BAWANG BARAT, LAMPUNG",1,186,34,220
https://kawalpemilu.org#22589,"MEKAR JAYA, GUNUNG AGUNG, TULANG BAWANG BARAT, LAMPUNG",2,145,70,215
https://kawalpemilu.org#22589,"MEKAR JAYA, GUNUNG AGUNG, TULANG BAWANG BARAT, LAMPUNG",3,182,70,252
https://kawalpemilu.org#22589,"MEKAR JAYA, GUNUNG AGUNG, TULANG BAWANG BARAT, LAMPUNG",4,152,70,222
https://kawalpemilu.org#22589,"MEKAR JAYA, GUNUNG AGUNG, TULANG BAWANG BARAT, LAMPUNG",5,201,45,246
https://kawalpemilu.org#22589,"MEKAR JAYA, GUNUNG AGUNG, TULANG BAWANG BARAT, LAMPUNG",6,158,47,205
https://kawalpemilu.org#22589,"MEKAR JAYA, GUNUNG AGUNG, TULANG BAWANG BARAT, LAMPUNG",7,199,46,245
https://kawalpemilu.org#22589,"MEKAR JAYA, GUNUNG AGUNG, TULANG BAWANG BARAT, LAMPUNG",8,199,38,237
https://kawalpemilu.org#22589,"MEKAR JAYA, GUNUNG AGUNG, TULANG BAWANG BARAT, LAMPUNG",9,187,57,244
https://kawalpemilu.org#22589,"MEKAR JAYA, GUNUNG AGUNG, TULANG BAWANG BARAT, LAMPUNG",10,179,47,226
https://kawalpemilu.org#22590,"MARGA JAYA, GUNUNG AGUNG, TULANG BAWANG BARAT, LAMPUNG",1,215,34,246
https://kawalpemilu.org#22590,"MARGA JAYA, GUNUNG AGUNG, TULANG BAWANG BARAT, LAMPUNG",2,176,39,215
https://kawalpemilu.org#22590,"MARGA JAYA, GUNUNG AGUNG, TULANG BAWANG BARAT, LAMPUNG",3,198,38,236
https://kawalpemilu.org#22590,"MARGA JAYA, GUNUNG AGUNG, TULANG BAWANG BARAT, LAMPUNG",4,180,35,215
https://kawalpemilu.org#22590,"MARGA JAYA, GUNUNG AGUNG, TULANG BAWANG BARAT, LAMPUNG",5,166,46,212
https://kawalpemilu.org#22590,"MARGA JAYA, GUNUNG AGUNG, TULANG BAWANG BARAT, LAMPUNG",6,168,48,216
https://kawalpemilu.org#22590,"MARGA JAYA, GUNUNG AGUNG, TULANG BAWANG BARAT, LAMPUNG",7,188,55,243
https://kawalpemilu.org#22590,"MARGA JAYA, GUNUNG AGUNG, TULANG BAWANG BARAT, LAMPUNG",8,211,31,242
https://kawalpemilu.org#22591,"JAYA MURNI, GUNUNG AGUNG, TULANG BAWANG BARAT, LAMPUNG",1,220,43,263
https://kawalpemilu.org#22591,"JAYA MURNI, GUNUNG AGUNG, TULANG BAWANG BARAT, LAMPUNG",2,138,81,219
https://kawalpemilu.org#22591,"JAYA MURNI, GUNUNG AGUNG, TULANG BAWANG BARAT, LAMPUNG",3,153,34,187
https://kawalpemilu.org#22591,"JAYA MURNI, GUNUNG AGUNG, TULANG BAWANG BARAT, LAMPUNG",4,158,78,236
https://kawalpemilu.org#22591,"JAYA MURNI, GUNUNG AGUNG, TULANG BAWANG BARAT, LAMPUNG",5,132,37,169
https://kawalpemilu.org#22591,"JAYA MURNI, GUNUNG AGUNG, TULANG BAWANG BARAT, LAMPUNG",6,211,36,247
https://kawalpemilu.org#22591,"JAYA MURNI, GUNUNG AGUNG, TULANG BAWANG BARAT, LAMPUNG",7,130,102,232
https://kawalpemilu.org#22591,"JAYA MURNI, GUNUNG AGUNG, TULANG BAWANG BARAT, LAMPUNG",8,154,21,175
https://kawalpemilu.org#22592,"SUKA JAYA, GUNUNG AGUNG, TULANG BAWANG BARAT, LAMPUNG",1,149,54,203
https://kawalpemilu.org#22592,"SUKA JAYA, GUNUNG AGUNG, TULANG BAWANG BARAT, LAMPUNG",2,169,32,201
https://kawalpemilu.org#22592,"SUKA JAYA, GUNUNG AGUNG, TULANG BAWANG BARAT, LAMPUNG",3,161,52,213
https://kawalpemilu.org#22592,"SUKA JAYA, GUNUNG AGUNG, TULANG BAWANG BARAT, LAMPUNG",4,153,38,191
https://kawalpemilu.org#22592,"SUKA JAYA, GUNUNG AGUNG, TULANG BAWANG BARAT, LAMPUNG",5,148,77,225
https://kawalpemilu.org#22592,"SUKA JAYA, GUNUNG AGUNG, TULANG BAWANG BARAT, LAMPUNG",6,175,32,207
https://kawalpemilu.org#22592,"SUKA JAYA, GUNUNG AGUNG, TULANG BAWANG BARAT, LAMPUNG",7,139,31,170
https://kawalpemilu.org#22592,"SUKA JAYA, GUNUNG AGUNG, TULANG BAWANG BARAT, LAMPUNG",8,196,38,234
https://kawalpemilu.org#22592,"SUKA JAYA, GUNUNG AGUNG, TULANG BAWANG BARAT, LAMPUNG",9,186,36,222
https://kawalpemilu.org#22592,"SUKA JAYA, GUNUNG AGUNG, TULANG BAWANG BARAT, LAMPUNG",10,174,45,219
https://kawalpemilu.org#22592,"SUKA JAYA, GUNUNG AGUNG, TULANG BAWANG BARAT, LAMPUNG",11,183,28,211
https://kawalpemilu.org#22592,"SUKA JAYA, GUNUNG AGUNG, TULANG BAWANG BARAT, LAMPUNG",12,156,10,166
https://kawalpemilu.org#22592,"SUKA JAYA, GUNUNG AGUNG, TULANG BAWANG BARAT, LAMPUNG",13,142,12,154
https://kawalpemilu.org#22594,"BANGUN JAYA, GUNUNG AGUNG, TULANG BAWANG BARAT, LAMPUNG",1,174,54,228
https://kawalpemilu.org#22594,"BANGUN JAYA, GUNUNG AGUNG, TULANG BAWANG BARAT, LAMPUNG",2,155,76,231
https://kawalpemilu.org#22594,"BANGUN JAYA, GUNUNG AGUNG, TULANG BAWANG BARAT, LAMPUNG",4,116,50,166
https://kawalpemilu.org#22594,"BANGUN JAYA, GUNUNG AGUNG, TULANG BAWANG BARAT, LAMPUNG",5,168,54,222
https://kawalpemilu.org#22594,"BANGUN JAYA, GUNUNG AGUNG, TULANG BAWANG BARAT, LAMPUNG",6,182,26,208
https://kawalpemilu.org#22595,"SUMBER JAYA, GUNUNG AGUNG, TULANG BAWANG BARAT, LAMPUNG",1,166,42,208
https://kawalpemilu.org#22595,"SUMBER JAYA, GUNUNG AGUNG, TULANG BAWANG BARAT, LAMPUNG",2,145,73,218
https://kawalpemilu.org#22595,"SUMBER JAYA, GUNUNG AGUNG, TULANG BAWANG BARAT, LAMPUNG",3,110,14,124
https://kawalpemilu.org#22595,"SUMBER JAYA, GUNUNG AGUNG, TULANG BAWANG BARAT, LAMPUNG",4,183,51,234
https://kawalpemilu.org#22596,"WONO REJO, GUNUNG AGUNG, TULANG BAWANG BARAT, LAMPUNG",2,162,41,203
https://kawalpemilu.org#22596,"WONO REJO, GUNUNG AGUNG, TULANG BAWANG BARAT, LAMPUNG",3,166,53,219
https://kawalpemilu.org#22596,"WONO REJO, GUNUNG AGUNG, TULANG BAWANG BARAT, LAMPUNG",4,183,18,201
https://kawalpemilu.org#22597,"TRI TUNGGAL JAYA, GUNUNG AGUNG, TULANG BAWANG BARAT, LAMPUNG",2,170,77,247
https://kawalpemilu.org#22597,"TRI TUNGGAL JAYA, GUNUNG AGUNG, TULANG BAWANG BARAT, LAMPUNG",3,153,21,174
https://kawalpemilu.org#89946,"MULYA JAYA, GUNUNG AGUNG, TULANG BAWANG BARAT, LAMPUNG",1,221,28,249
https://kawalpemilu.org#89946,"MULYA JAYA, GUNUNG AGUNG, TULANG BAWANG BARAT, LAMPUNG",2,182,43,225
https://kawalpemilu.org#89946,"MULYA JAYA, GUNUNG AGUNG, TULANG BAWANG BARAT, LAMPUNG",3,127,67,194
https://kawalpemilu.org#89946,"MULYA JAYA, GUNUNG AGUNG, TULANG BAWANG BARAT, LAMPUNG",4,160,58,218
https://kawalpemilu.org#89946,"MULYA JAYA, GUNUNG AGUNG, TULANG BAWANG BARAT, LAMPUNG",5,187,26,213
https://kawalpemilu.org#89946,"MULYA JAYA, GUNUNG AGUNG, TULANG BAWANG BARAT, LAMPUNG",6,166,44,210
https://kawalpemilu.org#89946,"MULYA JAYA, GUNUNG AGUNG, TULANG BAWANG BARAT, LAMPUNG",7,201,16,217
https://kawalpemilu.org#89946,"MULYA JAYA, GUNUNG AGUNG, TULANG BAWANG BARAT, LAMPUNG",8,167,33,200
https://kawalpemilu.org#89946,"MULYA JAYA, GUNUNG AGUNG, TULANG BAWANG BARAT, LAMPUNG",9,144,48,192
https://kawalpemilu.org#89947,"MULYA SARI, GUNUNG AGUNG, TULANG BAWANG BARAT, LAMPUNG",1,163,70,233
https://kawalpemilu.org#89947,"MULYA SARI, GUNUNG AGUNG, TULANG BAWANG BARAT, LAMPUNG",2,179,38,217
https://kawalpemilu.org#89947,"MULYA SARI, GUNUNG AGUNG, TULANG BAWANG BARAT, LAMPUNG",3,182,45,227
https://kawalpemilu.org#89947,"MULYA SARI, GUNUNG AGUNG, TULANG BAWANG BARAT, LAMPUNG",4,193,35,228
https://kawalpemilu.org#929407,"DWIKORA JAYA, GUNUNG AGUNG, TULANG BAWANG BARAT, LAMPUNG",1,175,53,228
https://kawalpemilu.org#929407,"DWIKORA JAYA, GUNUNG AGUNG, TULANG BAWANG BARAT, LAMPUNG",2,191,55,246
https://kawalpemilu.org#929407,"DWIKORA JAYA, GUNUNG AGUNG, TULANG BAWANG BARAT, LAMPUNG",3,161,67,228
https://kawalpemilu.org#929407,"DWIKORA JAYA, GUNUNG AGUNG, TULANG BAWANG BARAT, LAMPUNG",4,0,0,0
https://kawalpemilu.org#929408,"SUMBER REJEKI, GUNUNG AGUNG, TULANG BAWANG BARAT, LAMPUNG",1,222,12,234
https://kawalpemilu.org#929408,"SUMBER REJEKI, GUNUNG AGUNG, TULANG BAWANG BARAT, LAMPUNG",2,184,16,200
https://kawalpemilu.org#22599,"BALAM JAYA, WAY KENANGA, TULANG BAWANG BARAT, LAMPUNG",1,135,82,217
https://kawalpemilu.org#22599,"BALAM JAYA, WAY KENANGA, TULANG BAWANG BARAT, LAMPUNG",2,214,40,254
https://kawalpemilu.org#22599,"BALAM JAYA, WAY KENANGA, TULANG BAWANG BARAT, LAMPUNG",3,212,46,258
https://kawalpemilu.org#22599,"BALAM JAYA, WAY KENANGA, TULANG BAWANG BARAT, LAMPUNG",5,228,43,271
https://kawalpemilu.org#22599,"BALAM JAYA, WAY KENANGA, TULANG BAWANG BARAT, LAMPUNG",6,209,49,258
https://kawalpemilu.org#22600,"MERCU BUANA, WAY KENANGA, TULANG BAWANG BARAT, LAMPUNG",1,126,23,149
https://kawalpemilu.org#22600,"MERCU BUANA, WAY KENANGA, TULANG BAWANG BARAT, LAMPUNG",2,154,93,247
https://kawalpemilu.org#22600,"MERCU BUANA, WAY KENANGA, TULANG BAWANG BARAT, LAMPUNG",3,113,130,243
https://kawalpemilu.org#22600,"MERCU BUANA, WAY KENANGA, TULANG BAWANG BARAT, LAMPUNG",4,102,114,216
https://kawalpemilu.org#22600,"MERCU BUANA, WAY KENANGA, TULANG BAWANG BARAT, LAMPUNG",5,164,92,256
https://kawalpemilu.org#22600,"MERCU BUANA, WAY KENANGA, TULANG BAWANG BARAT, LAMPUNG",6,140,94,234
https://kawalpemilu.org#22601,"AGUNG JAYA, WAY KENANGA, TULANG BAWANG BARAT, LAMPUNG",2,122,33,155
https://kawalpemilu.org#22601,"AGUNG JAYA, WAY KENANGA, TULANG BAWANG BARAT, LAMPUNG",3,177,44,221
https://kawalpemilu.org#22601,"AGUNG JAYA, WAY KENANGA, TULANG BAWANG BARAT, LAMPUNG",4,109,64,173
https://kawalpemilu.org#22601,"AGUNG JAYA, WAY KENANGA, TULANG BAWANG BARAT, LAMPUNG",5,140,93,233
https://kawalpemilu.org#22601,"AGUNG JAYA, WAY KENANGA, TULANG BAWANG BARAT, LAMPUNG",6,163,92,255
https://kawalpemilu.org#22601,"AGUNG JAYA, WAY KENANGA, TULANG BAWANG BARAT, LAMPUNG",7,137,98,235
https://kawalpemilu.org#22601,"AGUNG JAYA, WAY KENANGA, TULANG BAWANG BARAT, LAMPUNG",8,167,28,195
https://kawalpemilu.org#22602,"INDRALOKA I, WAY KENANGA, TULANG BAWANG BARAT, LAMPUNG",1,207,27,234
https://kawalpemilu.org#22602,"INDRALOKA I, WAY KENANGA, TULANG BAWANG BARAT, LAMPUNG",2,186,45,231
https://kawalpemilu.org#22602,"INDRALOKA I, WAY KENANGA, TULANG BAWANG BARAT, LAMPUNG",3,138,53,191
https://kawalpemilu.org#22602,"INDRALOKA I, WAY KENANGA, TULANG BAWANG BARAT, LAMPUNG",4,213,25,238
https://kawalpemilu.org#22602,"INDRALOKA I, WAY KENANGA, TULANG BAWANG BARAT, LAMPUNG",5,194,23,217
https://kawalpemilu.org#22602,"INDRALOKA I, WAY KENANGA, TULANG BAWANG BARAT, LAMPUNG",6,163,47,210
https://kawalpemilu.org#22602,"INDRALOKA I, WAY KENANGA, TULANG BAWANG BARAT, LAMPUNG",7,204,34,238
https://kawalpemilu.org#22603,"INDRALOKA II, WAY KENANGA, TULANG BAWANG BARAT, LAMPUNG",1,186,63,249
https://kawalpemilu.org#22603,"INDRALOKA II, WAY KENANGA, TULANG BAWANG BARAT, LAMPUNG",2,223,45,268
https://kawalpemilu.org#22603,"INDRALOKA II, WAY KENANGA, TULANG BAWANG BARAT, LAMPUNG",3,229,56,285
https://kawalpemilu.org#22603,"INDRALOKA II, WAY KENANGA, TULANG BAWANG BARAT, LAMPUNG",4,194,53,247
https://kawalpemilu.org#22603,"INDRALOKA II, WAY KENANGA, TULANG BAWANG BARAT, LAMPUNG",5,182,33,215
https://kawalpemilu.org#22603,"INDRALOKA II, WAY KENANGA, TULANG BAWANG BARAT, LAMPUNG",6,110,119,229
https://kawalpemilu.org#22604,"PAGAR BUANA, WAY KENANGA, TULANG BAWANG BARAT, LAMPUNG",1,186,34,220
https://kawalpemilu.org#22604,"PAGAR BUANA, WAY KENANGA, TULANG BAWANG BARAT, LAMPUNG",2,194,59,253
https://kawalpemilu.org#22604,"PAGAR BUANA, WAY KENANGA, TULANG BAWANG BARAT, LAMPUNG",3,144,37,181
https://kawalpemilu.org#22604,"PAGAR BUANA, WAY KENANGA, TULANG BAWANG BARAT, LAMPUNG",4,151,53,204
https://kawalpemilu.org#22604,"PAGAR BUANA, WAY KENANGA, TULANG BAWANG BARAT, LAMPUNG",5,165,65,230
https://kawalpemilu.org#84841,"BALAM ASRI, WAY KENANGA, TULANG BAWANG BARAT, LAMPUNG",1,206,43,249
https://kawalpemilu.org#84841,"BALAM ASRI, WAY KENANGA, TULANG BAWANG BARAT, LAMPUNG",2,193,71,264
https://kawalpemilu.org#84841,"BALAM ASRI, WAY KENANGA, TULANG BAWANG BARAT, LAMPUNG",3,226,44,270
https://kawalpemilu.org#84841,"BALAM ASRI, WAY KENANGA, TULANG BAWANG BARAT, LAMPUNG",4,242,14,256
https://kawalpemilu.org#84841,"BALAM ASRI, WAY KENANGA, TULANG BAWANG BARAT, LAMPUNG",5,211,33,244
https://kawalpemilu.org#929409,"INDRALOKA JAYA, WAY KENANGA, TULANG BAWANG BARAT, LAMPUNG",1,170,50,220
https://kawalpemilu.org#929409,"INDRALOKA JAYA, WAY KENANGA, TULANG BAWANG BARAT, LAMPUNG",2,193,46,239
https://kawalpemilu.org#929409,"INDRALOKA JAYA, WAY KENANGA, TULANG BAWANG BARAT, LAMPUNG",3,138,84,222
https://kawalpemilu.org#929409,"INDRALOKA JAYA, WAY KENANGA, TULANG BAWANG BARAT, LAMPUNG",4,162,42,204
https://kawalpemilu.org#929409,"INDRALOKA JAYA, WAY KENANGA, TULANG BAWANG BARAT, LAMPUNG",5,142,57,199
https://kawalpemilu.org#929409,"INDRALOKA JAYA, WAY KENANGA, TULANG BAWANG BARAT, LAMPUNG",6,176,25,201
https://kawalpemilu.org#929409,"INDRALOKA JAYA, WAY KENANGA, TULANG BAWANG BARAT, LAMPUNG",7,175,40,215
https://kawalpemilu.org#929409,"INDRALOKA JAYA, WAY KENANGA, TULANG BAWANG BARAT, LAMPUNG",8,148,26,210
https://kawalpemilu.org#929410,"INDRALOKA MUKTI, WAY KENANGA, TULANG BAWANG BARAT, LAMPUNG",1,213,20,233
https://kawalpemilu.org#929410,"INDRALOKA MUKTI, WAY KENANGA, TULANG BAWANG BARAT, LAMPUNG",2,224,22,246
https://kawalpemilu.org#929410,"INDRALOKA MUKTI, WAY KENANGA, TULANG BAWANG BARAT, LAMPUNG",3,213,30,243
https://kawalpemilu.org#929410,"INDRALOKA MUKTI, WAY KENANGA, TULANG BAWANG BARAT, LAMPUNG",4,170,30,200
https://kawalpemilu.org#929410,"INDRALOKA MUKTI, WAY KENANGA, TULANG BAWANG BARAT, LAMPUNG",5,146,54,200
https://kawalpemilu.org#22550,"TOTO KATON, BATU PUTIH, TULANG BAWANG BARAT, LAMPUNG",1,118,56,174
https://kawalpemilu.org#22550,"TOTO KATON, BATU PUTIH, TULANG BAWANG BARAT, LAMPUNG",2,91,80,171
https://kawalpemilu.org#22550,"TOTO KATON, BATU PUTIH, TULANG BAWANG BARAT, LAMPUNG",3,181,49,230
https://kawalpemilu.org#22550,"TOTO KATON, BATU PUTIH, TULANG BAWANG BARAT, LAMPUNG",4,127,69,196
https://kawalpemilu.org#22550,"TOTO KATON, BATU PUTIH, TULANG BAWANG BARAT, LAMPUNG",5,153,63,216
https://kawalpemilu.org#22550,"TOTO KATON, BATU PUTIH, TULANG BAWANG BARAT, LAMPUNG",6,185,35,220
https://kawalpemilu.org#22553,"SAKTI JAYA, BATU PUTIH, TULANG BAWANG BARAT, LAMPUNG",1,224,20,244
https://kawalpemilu.org#22553,"SAKTI JAYA, BATU PUTIH, TULANG BAWANG BARAT, LAMPUNG",2,202,24,226
https://kawalpemilu.org#22553,"SAKTI JAYA, BATU PUTIH, TULANG BAWANG BARAT, LAMPUNG",3,190,40,230
https://kawalpemilu.org#22553,"SAKTI JAYA, BATU PUTIH, TULANG BAWANG BARAT, LAMPUNG",4,194,49,243
https://kawalpemilu.org#22553,"SAKTI JAYA, BATU PUTIH, TULANG BAWANG BARAT, LAMPUNG",5,217,43,260
https://kawalpemilu.org#22554,"MARGO MULYA, BATU PUTIH, TULANG BAWANG BARAT, LAMPUNG",1,120,44,164
https://kawalpemilu.org#22554,"MARGO MULYA, BATU PUTIH, TULANG BAWANG BARAT, LAMPUNG",2,152,29,181
https://kawalpemilu.org#22554,"MARGO MULYA, BATU PUTIH, TULANG BAWANG BARAT, LAMPUNG",3,164,41,205
https://kawalpemilu.org#22554,"MARGO MULYA, BATU PUTIH, TULANG BAWANG BARAT, LAMPUNG",4,152,51,203
https://kawalpemilu.org#22554,"MARGO MULYA, BATU PUTIH, TULANG BAWANG BARAT, LAMPUNG",5,89,26,115
https://kawalpemilu.org#22554,"MARGO MULYA, BATU PUTIH, TULANG BAWANG BARAT, LAMPUNG",6,143,25,168
https://kawalpemilu.org#22554,"MARGO MULYA, BATU PUTIH, TULANG BAWANG BARAT, LAMPUNG",7,169,13,182
https://kawalpemilu.org#22556,"SIDO MAKMUR, BATU PUTIH, TULANG BAWANG BARAT, LAMPUNG",1,132,52,184
https://kawalpemilu.org#22556,"SIDO MAKMUR, BATU PUTIH, TULANG BAWANG BARAT, LAMPUNG",2,119,42,161
https://kawalpemilu.org#22556,"SIDO MAKMUR, BATU PUTIH, TULANG BAWANG BARAT, LAMPUNG",3,123,58,181
https://kawalpemilu.org#22556,"SIDO MAKMUR, BATU PUTIH, TULANG BAWANG BARAT, LAMPUNG",4,144,20,164
https://kawalpemilu.org#22559,"TOTO WONO DADI, BATU PUTIH, TULANG BAWANG BARAT, LAMPUNG",1,144,24,168
https://kawalpemilu.org#22559,"TOTO WONO DADI, BATU PUTIH, TULANG BAWANG BARAT, LAMPUNG",2,166,19,185
https://kawalpemilu.org#22559,"TOTO WONO DADI, BATU PUTIH, TULANG BAWANG BARAT, LAMPUNG",3,181,26,207
https://kawalpemilu.org#22559,"TOTO WONO DADI, BATU PUTIH, TULANG BAWANG BARAT, LAMPUNG",4,207,15,222
https://kawalpemilu.org#90056,"PANCA MARGA, BATU PUTIH, TULANG BAWANG BARAT, LAMPUNG",1,133,39,172
https://kawalpemilu.org#90056,"PANCA MARGA, BATU PUTIH, TULANG BAWANG BARAT, LAMPUNG",3,171,34,205
https://kawalpemilu.org#90056,"PANCA MARGA, BATU PUTIH, TULANG BAWANG BARAT, LAMPUNG",4,138,88,226
https://kawalpemilu.org#90056,"PANCA MARGA, BATU PUTIH, TULANG BAWANG BARAT, LAMPUNG",5,172,28,200
https://kawalpemilu.org#90060,"MARGA SARI, BATU PUTIH, TULANG BAWANG BARAT, LAMPUNG",1,144,81,225
https://kawalpemilu.org#90060,"MARGA SARI, BATU PUTIH, TULANG BAWANG BARAT, LAMPUNG",2,138,68,206
https://kawalpemilu.org#90060,"MARGA SARI, BATU PUTIH, TULANG BAWANG BARAT, LAMPUNG",3,164,41,205
https://kawalpemilu.org#90060,"MARGA SARI, BATU PUTIH, TULANG BAWANG BARAT, LAMPUNG",4,164,43,207
https://kawalpemilu.org#929402,"MARGO DADI, BATU PUTIH, TULANG BAWANG BARAT, LAMPUNG",1,119,87,206
https://kawalpemilu.org#929402,"MARGO DADI, BATU PUTIH, TULANG BAWANG BARAT, LAMPUNG",2,67,85,152
https://kawalpemilu.org#929402,"MARGO DADI, BATU PUTIH, TULANG BAWANG BARAT, LAMPUNG",3,130,20,150
https://kawalpemilu.org#929402,"MARGO DADI, BATU PUTIH, TULANG BAWANG BARAT, LAMPUNG",4,188,27,215
https://kawalpemilu.org#929404,"MULYO SARI, BATU PUTIH, TULANG BAWANG BARAT, LAMPUNG",1,100,111,211
https://kawalpemilu.org#929404,"MULYO SARI, BATU PUTIH, TULANG BAWANG BARAT, LAMPUNG",2,160,65,225
https://kawalpemilu.org#929404,"MULYO SARI, BATU PUTIH, TULANG BAWANG BARAT, LAMPUNG",3,197,42,239
https://kawalpemilu.org#929405,"TOTO MAKMUR, BATU PUTIH, TULANG BAWANG BARAT, LAMPUNG",1,200,18,218
https://kawalpemilu.org#929405,"TOTO MAKMUR, BATU PUTIH, TULANG BAWANG BARAT, LAMPUNG",2,216,18,234
https://kawalpemilu.org#929405,"TOTO MAKMUR, BATU PUTIH, TULANG BAWANG BARAT, LAMPUNG",3,139,11,150
https://kawalpemilu.org#929405,"TOTO MAKMUR, BATU PUTIH, TULANG BAWANG BARAT, LAMPUNG",4,182,20,202
https://kawalpemilu.org#22607,"HAJIMENA, NATAR, LAMPUNG SELATAN, LAMPUNG",1,40,73,113
https://kawalpemilu.org#22607,"HAJIMENA, NATAR, LAMPUNG SELATAN, LAMPUNG",2,54,172,226
https://kawalpemilu.org#22607,"HAJIMENA, NATAR, LAMPUNG SELATAN, LAMPUNG",3,54,141,195
https://kawalpemilu.org#22607,"HAJIMENA, NATAR, LAMPUNG SELATAN, LAMPUNG",4,100,154,254
https://kawalpemilu.org#22607,"HAJIMENA, NATAR, LAMPUNG SELATAN, LAMPUNG",5,125,115,240
https://kawalpemilu.org#22607,"HAJIMENA, NATAR, LAMPUNG SELATAN, LAMPUNG",6,63,184,247
https://kawalpemilu.org#22607,"HAJIMENA, NATAR, LAMPUNG SELATAN, LAMPUNG",7,54,109,163
https://kawalpemilu.org#22607,"HAJIMENA, NATAR, LAMPUNG SELATAN, LAMPUNG",8,65,143,208
https://kawalpemilu.org#22607,"HAJIMENA, NATAR, LAMPUNG SELATAN, LAMPUNG",9,169,94,263
https://kawalpemilu.org#22607,"HAJIMENA, NATAR, LAMPUNG SELATAN, LAMPUNG",10,59,117,176
https://kawalpemilu.org#22607,"HAJIMENA, NATAR, LAMPUNG SELATAN, LAMPUNG",11,98,94,192
https://kawalpemilu.org#22607,"HAJIMENA, NATAR, LAMPUNG SELATAN, LAMPUNG",12,74,130,204
https://kawalpemilu.org#22607,"HAJIMENA, NATAR, LAMPUNG SELATAN, LAMPUNG",13,55,115,170
https://kawalpemilu.org#22607,"HAJIMENA, NATAR, LAMPUNG SELATAN, LAMPUNG",14,141,56,197
https://kawalpemilu.org#22607,"HAJIMENA, NATAR, LAMPUNG SELATAN, LAMPUNG",15,73,105,178
https://kawalpemilu.org#22607,"HAJIMENA, NATAR, LAMPUNG SELATAN, LAMPUNG",16,42,70,112
https://kawalpemilu.org#22607,"HAJIMENA, NATAR, LAMPUNG SELATAN, LAMPUNG",17,75,147,222
https://kawalpemilu.org#22607,"HAJIMENA, NATAR, LAMPUNG SELATAN, LAMPUNG",18,48,133,181
https://kawalpemilu.org#22607,"HAJIMENA, NATAR, LAMPUNG SELATAN, LAMPUNG",19,50,86,136
https://kawalpemilu.org#22607,"HAJIMENA, NATAR, LAMPUNG SELATAN, LAMPUNG",20,36,78,114
https://kawalpemilu.org#22607,"HAJIMENA, NATAR, LAMPUNG SELATAN, LAMPUNG",21,117,134,251
https://kawalpemilu.org#22607,"HAJIMENA, NATAR, LAMPUNG SELATAN, LAMPUNG",22,72,85,157
https://kawalpemilu.org#22607,"HAJIMENA, NATAR, LAMPUNG SELATAN, LAMPUNG",23,81,77,158
https://kawalpemilu.org#22607,"HAJIMENA, NATAR, LAMPUNG SELATAN, LAMPUNG",24,102,102,204
https://kawalpemilu.org#22607,"HAJIMENA, NATAR, LAMPUNG SELATAN, LAMPUNG",25,79,114,193
https://kawalpemilu.org#22607,"HAJIMENA, NATAR, LAMPUNG SELATAN, LAMPUNG",26,149,45,194
https://kawalpemilu.org#22607,"HAJIMENA, NATAR, LAMPUNG SELATAN, LAMPUNG",27,35,58,93
https://kawalpemilu.org#22607,"HAJIMENA, NATAR, LAMPUNG SELATAN, LAMPUNG",28,50,107,157
https://kawalpemilu.org#22607,"HAJIMENA, NATAR, LAMPUNG SELATAN, LAMPUNG",29,47,103,150
https://kawalpemilu.org#22607,"HAJIMENA, NATAR, LAMPUNG SELATAN, LAMPUNG",30,93,160,253
https://kawalpemilu.org#22607,"HAJIMENA, NATAR, LAMPUNG SELATAN, LAMPUNG",31,74,135,209
https://kawalpemilu.org#22607,"HAJIMENA, NATAR, LAMPUNG SELATAN, LAMPUNG",32,86,89,175
https://kawalpemilu.org#22607,"HAJIMENA, NATAR, LAMPUNG SELATAN, LAMPUNG",33,53,132,185
https://kawalpemilu.org#22607,"HAJIMENA, NATAR, LAMPUNG SELATAN, LAMPUNG",34,111,67,178
https://kawalpemilu.org#22607,"HAJIMENA, NATAR, LAMPUNG SELATAN, LAMPUNG",35,95,81,176
https://kawalpemilu.org#22607,"HAJIMENA, NATAR, LAMPUNG SELATAN, LAMPUNG",36,101,143,244
https://kawalpemilu.org#22607,"HAJIMENA, NATAR, LAMPUNG SELATAN, LAMPUNG",37,42,67,109
https://kawalpemilu.org#22607,"HAJIMENA, NATAR, LAMPUNG SELATAN, LAMPUNG",39,52,101,152
https://kawalpemilu.org#22607,"HAJIMENA, NATAR, LAMPUNG SELATAN, LAMPUNG",40,81,94,175
https://kawalpemilu.org#22607,"HAJIMENA, NATAR, LAMPUNG SELATAN, LAMPUNG",41,64,140,204
https://kawalpemilu.org#22607,"HAJIMENA, NATAR, LAMPUNG SELATAN, LAMPUNG",42,37,76,113
https://kawalpemilu.org#22607,"HAJIMENA, NATAR, LAMPUNG SELATAN, LAMPUNG",43,45,86,131
https://kawalpemilu.org#22608,"SIDOSARI, NATAR, LAMPUNG SELATAN, LAMPUNG",1,129,100,229
https://kawalpemilu.org#22608,"SIDOSARI, NATAR, LAMPUNG SELATAN, LAMPUNG",2,94,85,179
https://kawalpemilu.org#22608,"SIDOSARI, NATAR, LAMPUNG SELATAN, LAMPUNG",3,86,118,204
https://kawalpemilu.org#22608,"SIDOSARI, NATAR, LAMPUNG SELATAN, LAMPUNG",4,85,122,207
https://kawalpemilu.org#22608,"SIDOSARI, NATAR, LAMPUNG SELATAN, LAMPUNG",5,98,30,128
https://kawalpemilu.org#22608,"SIDOSARI, NATAR, LAMPUNG SELATAN, LAMPUNG",6,101,53,154
https://kawalpemilu.org#22608,"SIDOSARI, NATAR, LAMPUNG SELATAN, LAMPUNG",7,133,74,207
https://kawalpemilu.org#22608,"SIDOSARI, NATAR, LAMPUNG SELATAN, LAMPUNG",8,110,74,184
https://kawalpemilu.org#22608,"SIDOSARI, NATAR, LAMPUNG SELATAN, LAMPUNG",9,124,76,202
https://kawalpemilu.org#22608,"SIDOSARI, NATAR, LAMPUNG SELATAN, LAMPUNG",10,131,41,172
https://kawalpemilu.org#22608,"SIDOSARI, NATAR, LAMPUNG SELATAN, LAMPUNG",11,89,86,175
https://kawalpemilu.org#22608,"SIDOSARI, NATAR, LAMPUNG SELATAN, LAMPUNG",12,84,43,127
https://kawalpemilu.org#22608,"SIDOSARI, NATAR, LAMPUNG SELATAN, LAMPUNG",13,132,72,104
https://kawalpemilu.org#22608,"SIDOSARI, NATAR, LAMPUNG SELATAN, LAMPUNG",14,140,53,193
https://kawalpemilu.org#22608,"SIDOSARI, NATAR, LAMPUNG SELATAN, LAMPUNG",15,118,67,185
https://kawalpemilu.org#22608,"SIDOSARI, NATAR, LAMPUNG SELATAN, LAMPUNG",16,142,44,186
https://kawalpemilu.org#22609,"PEMANGGILAN, NATAR, LAMPUNG SELATAN, LAMPUNG",1,57,92,149
https://kawalpemilu.org#22609,"PEMANGGILAN, NATAR, LAMPUNG SELATAN, LAMPUNG",2,170,128,298
https://kawalpemilu.org#22609,"PEMANGGILAN, NATAR, LAMPUNG SELATAN, LAMPUNG",3,106,86,192
https://kawalpemilu.org#22609,"PEMANGGILAN, NATAR, LAMPUNG SELATAN, LAMPUNG",4,88,110,198
https://kawalpemilu.org#22609,"PEMANGGILAN, NATAR, LAMPUNG SELATAN, LAMPUNG",5,110,70,180
https://kawalpemilu.org#22609,"PEMANGGILAN, NATAR, LAMPUNG SELATAN, LAMPUNG",6,93,83,176
https://kawalpemilu.org#22609,"PEMANGGILAN, NATAR, LAMPUNG SELATAN, LAMPUNG",7,89,119,201
https://kawalpemilu.org#22609,"PEMANGGILAN, NATAR, LAMPUNG SELATAN, LAMPUNG",8,108,89,197
https://kawalpemilu.org#22609,"PEMANGGILAN, NATAR, LAMPUNG SELATAN, LAMPUNG",9,134,122,256
https://kawalpemilu.org#22609,"PEMANGGILAN, NATAR, LAMPUNG SELATAN, LAMPUNG",10,116,128,244
https://kawalpemilu.org#22609,"PEMANGGILAN, NATAR, LAMPUNG SELATAN, LAMPUNG",11,134,64,205
https://kawalpemilu.org#22609,"PEMANGGILAN, NATAR, LAMPUNG SELATAN, LAMPUNG",12,141,84,225
https://kawalpemilu.org#22609,"PEMANGGILAN, NATAR, LAMPUNG SELATAN, LAMPUNG",13,168,35,203
https://kawalpemilu.org#22609,"PEMANGGILAN, NATAR, LAMPUNG SELATAN, LAMPUNG",14,119,36,155
https://kawalpemilu.org#22609,"PEMANGGILAN, NATAR, LAMPUNG SELATAN, LAMPUNG",15,56,122,178
https://kawalpemilu.org#22609,"PEMANGGILAN, NATAR, LAMPUNG SELATAN, LAMPUNG",16,62,69,131
https://kawalpemilu.org#22609,"PEMANGGILAN, NATAR, LAMPUNG SELATAN, LAMPUNG",17,93,61,154
https://kawalpemilu.org#22609,"PEMANGGILAN, NATAR, LAMPUNG SELATAN, LAMPUNG",18,66,57,123
https://kawalpemilu.org#22609,"PEMANGGILAN, NATAR, LAMPUNG SELATAN, LAMPUNG",19,91,37,128
https://kawalpemilu.org#22609,"PEMANGGILAN, NATAR, LAMPUNG SELATAN, LAMPUNG",20,115,93,208
https://kawalpemilu.org#22609,"PEMANGGILAN, NATAR, LAMPUNG SELATAN, LAMPUNG",21,111,94,205
https://kawalpemilu.org#22609,"PEMANGGILAN, NATAR, LAMPUNG SELATAN, LAMPUNG",22,96,84,180
https://kawalpemilu.org#22609,"PEMANGGILAN, NATAR, LAMPUNG SELATAN, LAMPUNG",23,143,22,165
https://kawalpemilu.org#22609,"PEMANGGILAN, NATAR, LAMPUNG SELATAN, LAMPUNG",24,158,19,177
https://kawalpemilu.org#22609,"PEMANGGILAN, NATAR, LAMPUNG SELATAN, LAMPUNG",25,126,32,158
https://kawalpemilu.org#22610,"NATAR, NATAR, LAMPUNG SELATAN, LAMPUNG",1,43,125,168
https://kawalpemilu.org#22610,"NATAR, NATAR, LAMPUNG SELATAN, LAMPUNG",2,47,138,185
https://kawalpemilu.org#22610,"NATAR, NATAR, LAMPUNG SELATAN, LAMPUNG",3,67,153,220
https://kawalpemilu.org#22610,"NATAR, NATAR, LAMPUNG SELATAN, LAMPUNG",4,63,97,160
https://kawalpemilu.org#22610,"NATAR, NATAR, LAMPUNG SELATAN, LAMPUNG",5,72,57,129
https://kawalpemilu.org#22610,"NATAR, NATAR, LAMPUNG SELATAN, LAMPUNG",6,81,95,176
https://kawalpemilu.org#22610,"NATAR, NATAR, LAMPUNG SELATAN, LAMPUNG",7,78,80,158
https://kawalpemilu.org#22610,"NATAR, NATAR, LAMPUNG SELATAN, LAMPUNG",8,56,92,148
https://kawalpemilu.org#22610,"NATAR, NATAR, LAMPUNG SELATAN, LAMPUNG",9,107,132,239
https://kawalpemilu.org#22610,"NATAR, NATAR, LAMPUNG SELATAN, LAMPUNG",10,104,89,193
https://kawalpemilu.org#22610,"NATAR, NATAR, LAMPUNG SELATAN, LAMPUNG",11,115,78,193
https://kawalpemilu.org#22610,"NATAR, NATAR, LAMPUNG SELATAN, LAMPUNG",12,143,83,226
https://kawalpemilu.org#22610,"NATAR, NATAR, LAMPUNG SELATAN, LAMPUNG",13,122,60,182
https://kawalpemilu.org#22610,"NATAR, NATAR, LAMPUNG SELATAN, LAMPUNG",14,158,53,211
https://kawalpemilu.org#22610,"NATAR, NATAR, LAMPUNG SELATAN, LAMPUNG",15,94,129,223
https://kawalpemilu.org#22610,"NATAR, NATAR, LAMPUNG SELATAN, LAMPUNG",16,92,123,215
https://kawalpemilu.org#22610,"NATAR, NATAR, LAMPUNG SELATAN, LAMPUNG",17,77,58,135
https://kawalpemilu.org#22610,"NATAR, NATAR, LAMPUNG SELATAN, LAMPUNG",18,103,97,200
https://kawalpemilu.org#22610,"NATAR, NATAR, LAMPUNG SELATAN, LAMPUNG",19,83,109,192
https://kawalpemilu.org#22610,"NATAR, NATAR, LAMPUNG SELATAN, LAMPUNG",20,80,80,160
https://kawalpemilu.org#22610,"NATAR, NATAR, LAMPUNG SELATAN, LAMPUNG",21,121,116,237
https://kawalpemilu.org#22610,"NATAR, NATAR, LAMPUNG SELATAN, LAMPUNG",22,128,55,183
https://kawalpemilu.org#22610,"NATAR, NATAR, LAMPUNG SELATAN, LAMPUNG",23,45,46,91
https://kawalpemilu.org#22610,"NATAR, NATAR, LAMPUNG SELATAN, LAMPUNG",24,105,110,215
https://kawalpemilu.org#22610,"NATAR, NATAR, LAMPUNG SELATAN, LAMPUNG",25,155,65,220
https://kawalpemilu.org#22610,"NATAR, NATAR, LAMPUNG SELATAN, LAMPUNG",26,128,74,202
https://kawalpemilu.org#22610,"NATAR, NATAR, LAMPUNG SELATAN, LAMPUNG",27,82,73,155
https://kawalpemilu.org#22610,"NATAR, NATAR, LAMPUNG SELATAN, LAMPUNG",28,78,58,136
https://kawalpemilu.org#22610,"NATAR, NATAR, LAMPUNG SELATAN, LAMPUNG",29,61,80,141
https://kawalpemilu.org#22610,"NATAR, NATAR, LAMPUNG SELATAN, LAMPUNG",30,42,91,133
https://kawalpemilu.org#22610,"NATAR, NATAR, LAMPUNG SELATAN, LAMPUNG",31,98,96,194
https://kawalpemilu.org#22610,"NATAR, NATAR, LAMPUNG SELATAN, LAMPUNG",32,118,67,185
https://kawalpemilu.org#22610,"NATAR, NATAR, LAMPUNG SELATAN, LAMPUNG",33,65,76,141
https://kawalpemilu.org#22610,"NATAR, NATAR, LAMPUNG SELATAN, LAMPUNG",34,36,54,90
https://kawalpemilu.org#22610,"NATAR, NATAR, LAMPUNG SELATAN, LAMPUNG",35,67,55,122
https://kawalpemilu.org#22610,"NATAR, NATAR, LAMPUNG SELATAN, LAMPUNG",36,82,104,186
https://kawalpemilu.org#22610,"NATAR, NATAR, LAMPUNG SELATAN, LAMPUNG",37,68,45,113
https://kawalpemilu.org#22610,"NATAR, NATAR, LAMPUNG SELATAN, LAMPUNG",38,71,75,146
https://kawalpemilu.org#22610,"NATAR, NATAR, LAMPUNG SELATAN, LAMPUNG",39,102,137,239
https://kawalpemilu.org#22610,"NATAR, NATAR, LAMPUNG SELATAN, LAMPUNG",40,95,56,151
https://kawalpemilu.org#22610,"NATAR, NATAR, LAMPUNG SELATAN, LAMPUNG",41,90,54,144
https://kawalpemilu.org#22610,"NATAR, NATAR, LAMPUNG SELATAN, LAMPUNG",42,131,67,198
https://kawalpemilu.org#22610,"NATAR, NATAR, LAMPUNG SELATAN, LAMPUNG",43,53,118,171
https://kawalpemilu.org#22610,"NATAR, NATAR, LAMPUNG SELATAN, LAMPUNG",44,71,44,115
https://kawalpemilu.org#22610,"NATAR, NATAR, LAMPUNG SELATAN, LAMPUNG",45,40,41,81
https://kawalpemilu.org#22610,"NATAR, NATAR, LAMPUNG SELATAN, LAMPUNG",46,72,58,130
https://kawalpemilu.org#22610,"NATAR, NATAR, LAMPUNG SELATAN, LAMPUNG",47,55,30,85
https://kawalpemilu.org#22610,"NATAR, NATAR, LAMPUNG SELATAN, LAMPUNG",48,82,98,180
https://kawalpemilu.org#22610,"NATAR, NATAR, LAMPUNG SELATAN, LAMPUNG",49,110,70,180
https://kawalpemilu.org#22610,"NATAR, NATAR, LAMPUNG SELATAN, LAMPUNG",50,94,50,144
https://kawalpemilu.org#22610,"NATAR, NATAR, LAMPUNG SELATAN, LAMPUNG",51,124,36,160
https://kawalpemilu.org#22610,"NATAR, NATAR, LAMPUNG SELATAN, LAMPUNG",52,69,50,119
https://kawalpemilu.org#22610,"NATAR, NATAR, LAMPUNG SELATAN, LAMPUNG",53,57,37,94
https://kawalpemilu.org#22610,"NATAR, NATAR, LAMPUNG SELATAN, LAMPUNG",54,95,21,116
https://kawalpemilu.org#22610,"NATAR, NATAR, LAMPUNG SELATAN, LAMPUNG",55,38,55,93
https://kawalpemilu.org#22611,"MUARA PUTIH, NATAR, LAMPUNG SELATAN, LAMPUNG",1,69,137,206
https://kawalpemilu.org#22611,"MUARA PUTIH, NATAR, LAMPUNG SELATAN, LAMPUNG",2,32,55,87
https://kawalpemilu.org#22611,"MUARA PUTIH, NATAR, LAMPUNG SELATAN, LAMPUNG",3,153,45,198
https://kawalpemilu.org#22611,"MUARA PUTIH, NATAR, LAMPUNG SELATAN, LAMPUNG",4,161,59,220
https://kawalpemilu.org#22611,"MUARA PUTIH, NATAR, LAMPUNG SELATAN, LAMPUNG",5,40,213,253
https://kawalpemilu.org#22611,"MUARA PUTIH, NATAR, LAMPUNG SELATAN, LAMPUNG",6,122,27,149
https://kawalpemilu.org#22611,"MUARA PUTIH, NATAR, LAMPUNG SELATAN, LAMPUNG",7,128,66,194
https://kawalpemilu.org#22611,"MUARA PUTIH, NATAR, LAMPUNG SELATAN, LAMPUNG",8,180,17,197
https://kawalpemilu.org#22611,"MUARA PUTIH, NATAR, LAMPUNG SELATAN, LAMPUNG",9,176,44,220
https://kawalpemilu.org#22611,"MUARA PUTIH, NATAR, LAMPUNG SELATAN, LAMPUNG",10,172,25,197
https://kawalpemilu.org#22611,"MUARA PUTIH, NATAR, LAMPUNG SELATAN, LAMPUNG",11,25,64,89
https://kawalpemilu.org#22611,"MUARA PUTIH, NATAR, LAMPUNG SELATAN, LAMPUNG",12,89,108,197
https://kawalpemilu.org#22611,"MUARA PUTIH, NATAR, LAMPUNG SELATAN, LAMPUNG",13,114,52,166
https://kawalpemilu.org#22611,"MUARA PUTIH, NATAR, LAMPUNG SELATAN, LAMPUNG",14,170,56,226
https://kawalpemilu.org#22611,"MUARA PUTIH, NATAR, LAMPUNG SELATAN, LAMPUNG",15,64,105,169
https://kawalpemilu.org#22611,"MUARA PUTIH, NATAR, LAMPUNG SELATAN, LAMPUNG",16,80,46,126
https://kawalpemilu.org#22611,"MUARA PUTIH, NATAR, LAMPUNG SELATAN, LAMPUNG",17,80,24,104
https://kawalpemilu.org#22611,"MUARA PUTIH, NATAR, LAMPUNG SELATAN, LAMPUNG",18,134,7,141
https://kawalpemilu.org#22611,"MUARA PUTIH, NATAR, LAMPUNG SELATAN, LAMPUNG",19,156,22,178
https://kawalpemilu.org#22611,"MUARA PUTIH, NATAR, LAMPUNG SELATAN, LAMPUNG",20,91,17,108
https://kawalpemilu.org#22611,"MUARA PUTIH, NATAR, LAMPUNG SELATAN, LAMPUNG",21,145,19,164
https://kawalpemilu.org#22612,"NEGARA RATU, NATAR, LAMPUNG SELATAN, LAMPUNG",1,103,141,244
https://kawalpemilu.org#22612,"NEGARA RATU, NATAR, LAMPUNG SELATAN, LAMPUNG",2,101,127,228
https://kawalpemilu.org#22612,"NEGARA RATU, NATAR, LAMPUNG SELATAN, LAMPUNG",3,130,103,233
https://kawalpemilu.org#22612,"NEGARA RATU, NATAR, LAMPUNG SELATAN, LAMPUNG",4,121,61,182
https://kawalpemilu.org#22612,"NEGARA RATU, NATAR, LAMPUNG SELATAN, LAMPUNG",5,151,85,236
https://kawalpemilu.org#22612,"NEGARA RATU, NATAR, LAMPUNG SELATAN, LAMPUNG",6,122,100,222
https://kawalpemilu.org#22612,"NEGARA RATU, NATAR, LAMPUNG SELATAN, LAMPUNG",7,110,119,229
https://kawalpemilu.org#22612,"NEGARA RATU, NATAR, LAMPUNG SELATAN, LAMPUNG",8,123,86,209
https://kawalpemilu.org#22612,"NEGARA RATU, NATAR, LAMPUNG SELATAN, LAMPUNG",9,129,68,197
https://kawalpemilu.org#22612,"NEGARA RATU, NATAR, LAMPUNG SELATAN, LAMPUNG",10,120,94,214
https://kawalpemilu.org#22612,"NEGARA RATU, NATAR, LAMPUNG SELATAN, LAMPUNG",11,120,97,217
https://kawalpemilu.org#22612,"NEGARA RATU, NATAR, LAMPUNG SELATAN, LAMPUNG",12,146,41,187
https://kawalpemilu.org#22612,"NEGARA RATU, NATAR, LAMPUNG SELATAN, LAMPUNG",14,47,72,119
https://kawalpemilu.org#22612,"NEGARA RATU, NATAR, LAMPUNG SELATAN, LAMPUNG",15,15,256,271
https://kawalpemilu.org#22612,"NEGARA RATU, NATAR, LAMPUNG SELATAN, LAMPUNG",16,119,138,257
https://kawalpemilu.org#22612,"NEGARA RATU, NATAR, LAMPUNG SELATAN, LAMPUNG",17,55,111,166
https://kawalpemilu.org#22612,"NEGARA RATU, NATAR, LAMPUNG SELATAN, LAMPUNG",18,151,76,227
https://kawalpemilu.org#22612,"NEGARA RATU, NATAR, LAMPUNG SELATAN, LAMPUNG",19,118,84,202
https://kawalpemilu.org#22612,"NEGARA RATU, NATAR, LAMPUNG SELATAN, LAMPUNG",20,111,92,203
https://kawalpemilu.org#22612,"NEGARA RATU, NATAR, LAMPUNG SELATAN, LAMPUNG",21,109,87,196
https://kawalpemilu.org#22612,"NEGARA RATU, NATAR, LAMPUNG SELATAN, LAMPUNG",22,102,114,216
https://kawalpemilu.org#22612,"NEGARA RATU, NATAR, LAMPUNG SELATAN, LAMPUNG",23,76,112,188
https://kawalpemilu.org#22612,"NEGARA RATU, NATAR, LAMPUNG SELATAN, LAMPUNG",24,127,79,206
https://kawalpemilu.org#22612,"NEGARA RATU, NATAR, LAMPUNG SELATAN, LAMPUNG",25,105,49,154
https://kawalpemilu.org#22612,"NEGARA RATU, NATAR, LAMPUNG SELATAN, LAMPUNG",26,101,91,192
https://kawalpemilu.org#22612,"NEGARA RATU, NATAR, LAMPUNG SELATAN, LAMPUNG",27,88,112,200
https://kawalpemilu.org#22612,"NEGARA RATU, NATAR, LAMPUNG SELATAN, LAMPUNG",28,107,50,157
https://kawalpemilu.org#22612,"NEGARA RATU, NATAR, LAMPUNG SELATAN, LAMPUNG",29,141,78,219
https://kawalpemilu.org#22612,"NEGARA RATU, NATAR, LAMPUNG SELATAN, LAMPUNG",31,115,56,171
https://kawalpemilu.org#22612,"NEGARA RATU, NATAR, LAMPUNG SELATAN, LAMPUNG",32,165,43,208
https://kawalpemilu.org#22612,"NEGARA RATU, NATAR, LAMPUNG SELATAN, LAMPUNG",33,6,257,263
https://kawalpemilu.org#22612,"NEGARA RATU, NATAR, LAMPUNG SELATAN, LAMPUNG",34,4,249,253
https://kawalpemilu.org#22612,"NEGARA RATU, NATAR, LAMPUNG SELATAN, LAMPUNG",35,62,77,139
https://kawalpemilu.org#22612,"NEGARA RATU, NATAR, LAMPUNG SELATAN, LAMPUNG",36,146,93,239
https://kawalpemilu.org#22613,"MERAK BATIN, NATAR, LAMPUNG SELATAN, LAMPUNG",1,58,117,175
https://kawalpemilu.org#22613,"MERAK BATIN, NATAR, LAMPUNG SELATAN, LAMPUNG",2,58,138,196
https://kawalpemilu.org#22613,"MERAK BATIN, NATAR, LAMPUNG SELATAN, LAMPUNG",3,57,121,178
https://kawalpemilu.org#22613,"MERAK BATIN, NATAR, LAMPUNG SELATAN, LAMPUNG",4,102,123,225
https://kawalpemilu.org#22613,"MERAK BATIN, NATAR, LAMPUNG SELATAN, LAMPUNG",5,81,82,163
https://kawalpemilu.org#22613,"MERAK BATIN, NATAR, LAMPUNG SELATAN, LAMPUNG",6,93,117,210
https://kawalpemilu.org#22613,"MERAK BATIN, NATAR, LAMPUNG SELATAN, LAMPUNG",7,91,94,185
https://kawalpemilu.org#22613,"MERAK BATIN, NATAR, LAMPUNG SELATAN, LAMPUNG",8,75,113,188
https://kawalpemilu.org#22613,"MERAK BATIN, NATAR, LAMPUNG SELATAN, LAMPUNG",9,105,143,248
https://kawalpemilu.org#22613,"MERAK BATIN, NATAR, LAMPUNG SELATAN, LAMPUNG",10,60,149,209
https://kawalpemilu.org#22613,"MERAK BATIN, NATAR, LAMPUNG SELATAN, LAMPUNG",11,107,111,218
https://kawalpemilu.org#22613,"MERAK BATIN, NATAR, LAMPUNG SELATAN, LAMPUNG",12,81,144,225
https://kawalpemilu.org#22613,"MERAK BATIN, NATAR, LAMPUNG SELATAN, LAMPUNG",13,114,98,212
https://kawalpemilu.org#22613,"MERAK BATIN, NATAR, LAMPUNG SELATAN, LAMPUNG",14,139,111,250
https://kawalpemilu.org#22613,"MERAK BATIN, NATAR, LAMPUNG SELATAN, LAMPUNG",15,93,140,233
https://kawalpemilu.org#22613,"MERAK BATIN, NATAR, LAMPUNG SELATAN, LAMPUNG",16,117,56,173
https://kawalpemilu.org#22613,"MERAK BATIN, NATAR, LAMPUNG SELATAN, LAMPUNG",17,78,144,222
https://kawalpemilu.org#22613,"MERAK BATIN, NATAR, LAMPUNG SELATAN, LAMPUNG",18,107,116,223
https://kawalpemilu.org#22613,"MERAK BATIN, NATAR, LAMPUNG SELATAN, LAMPUNG",19,143,89,232
https://kawalpemilu.org#22613,"MERAK BATIN, NATAR, LAMPUNG SELATAN, LAMPUNG",20,107,121,228
https://kawalpemilu.org#22613,"MERAK BATIN, NATAR, LAMPUNG SELATAN, LAMPUNG",21,107,71,178
https://kawalpemilu.org#22613,"MERAK BATIN, NATAR, LAMPUNG SELATAN, LAMPUNG",22,166,44,210
https://kawalpemilu.org#22613,"MERAK BATIN, NATAR, LAMPUNG SELATAN, LAMPUNG",24,162,56,218
https://kawalpemilu.org#22613,"MERAK BATIN, NATAR, LAMPUNG SELATAN, LAMPUNG",25,159,45,204
https://kawalpemilu.org#22613,"MERAK BATIN, NATAR, LAMPUNG SELATAN, LAMPUNG",26,179,45,224
https://kawalpemilu.org#22613,"MERAK BATIN, NATAR, LAMPUNG SELATAN, LAMPUNG",27,165,39,204
https://kawalpemilu.org#22613,"MERAK BATIN, NATAR, LAMPUNG SELATAN, LAMPUNG",28,49,84,133
https://kawalpemilu.org#22613,"MERAK BATIN, NATAR, LAMPUNG SELATAN, LAMPUNG",29,80,111,191
https://kawalpemilu.org#22613,"MERAK BATIN, NATAR, LAMPUNG SELATAN, LAMPUNG",30,69,95,164
https://kawalpemilu.org#22613,"MERAK BATIN, NATAR, LAMPUNG SELATAN, LAMPUNG",31,88,120,208
https://kawalpemilu.org#22613,"MERAK BATIN, NATAR, LAMPUNG SELATAN, LAMPUNG",32,61,114,175
https://kawalpemilu.org#22613,"MERAK BATIN, NATAR, LAMPUNG SELATAN, LAMPUNG",33,80,166,246
https://kawalpemilu.org#22613,"MERAK BATIN, NATAR, LAMPUNG SELATAN, LAMPUNG",34,73,90,163
https://kawalpemilu.org#22613,"MERAK BATIN, NATAR, LAMPUNG SELATAN, LAMPUNG",35,94,112,206
https://kawalpemilu.org#22613,"MERAK BATIN, NATAR, LAMPUNG SELATAN, LAMPUNG",36,79,145,224
https://kawalpemilu.org#22613,"MERAK BATIN, NATAR, LAMPUNG SELATAN, LAMPUNG",37,89,105,194
https://kawalpemilu.org#22613,"MERAK BATIN, NATAR, LAMPUNG SELATAN, LAMPUNG",38,93,71,164
https://kawalpemilu.org#22613,"MERAK BATIN, NATAR, LAMPUNG SELATAN, LAMPUNG",39,115,67,182
https://kawalpemilu.org#22613,"MERAK BATIN, NATAR, LAMPUNG SELATAN, LAMPUNG",40,83,50,133
https://kawalpemilu.org#22613,"MERAK BATIN, NATAR, LAMPUNG SELATAN, LAMPUNG",41,124,32,165
https://kawalpemilu.org#22613,"MERAK BATIN, NATAR, LAMPUNG SELATAN, LAMPUNG",42,148,44,192
https://kawalpemilu.org#22613,"MERAK BATIN, NATAR, LAMPUNG SELATAN, LAMPUNG",43,136,34,170
https://kawalpemilu.org#22614,"TANJUNG SARI, NATAR, LAMPUNG SELATAN, LAMPUNG",1,69,74,143
https://kawalpemilu.org#22614,"TANJUNG SARI, NATAR, LAMPUNG SELATAN, LAMPUNG",2,155,77,232
https://kawalpemilu.org#22614,"TANJUNG SARI, NATAR, LAMPUNG SELATAN, LAMPUNG",3,129,70,199
https://kawalpemilu.org#22614,"TANJUNG SARI, NATAR, LAMPUNG SELATAN, LAMPUNG",4,155,66,221
https://kawalpemilu.org#22614,"TANJUNG SARI, NATAR, LAMPUNG SELATAN, LAMPUNG",5,176,34,210
https://kawalpemilu.org#22614,"TANJUNG SARI, NATAR, LAMPUNG SELATAN, LAMPUNG",6,169,46,215
https://kawalpemilu.org#22614,"TANJUNG SARI, NATAR, LAMPUNG SELATAN, LAMPUNG",7,192,69,261
https://kawalpemilu.org#22614,"TANJUNG SARI, NATAR, LAMPUNG SELATAN, LAMPUNG",8,144,50,194
https://kawalpemilu.org#22614,"TANJUNG SARI, NATAR, LAMPUNG SELATAN, LAMPUNG",9,127,52,179
https://kawalpemilu.org#22614,"TANJUNG SARI, NATAR, LAMPUNG SELATAN, LAMPUNG",10,176,37,213
https://kawalpemilu.org#22614,"TANJUNG SARI, NATAR, LAMPUNG SELATAN, LAMPUNG",11,166,57,223
https://kawalpemilu.org#22614,"TANJUNG SARI, NATAR, LAMPUNG SELATAN, LAMPUNG",12,189,46,235
https://kawalpemilu.org#22614,"TANJUNG SARI, NATAR, LAMPUNG SELATAN, LAMPUNG",13,192,29,221
https://kawalpemilu.org#22614,"TANJUNG SARI, NATAR, LAMPUNG SELATAN, LAMPUNG",14,233,23,256
https://kawalpemilu.org#22614,"TANJUNG SARI, NATAR, LAMPUNG SELATAN, LAMPUNG",15,97,45,142
https://kawalpemilu.org#22614,"TANJUNG SARI, NATAR, LAMPUNG SELATAN, LAMPUNG",16,179,61,240
https://kawalpemilu.org#22614,"TANJUNG SARI, NATAR, LAMPUNG SELATAN, LAMPUNG",17,73,59,132
https://kawalpemilu.org#22614,"TANJUNG SARI, NATAR, LAMPUNG SELATAN, LAMPUNG",18,157,80,237
https://kawalpemilu.org#22614,"TANJUNG SARI, NATAR, LAMPUNG SELATAN, LAMPUNG",19,147,25,172
https://kawalpemilu.org#22614,"TANJUNG SARI, NATAR, LAMPUNG SELATAN, LAMPUNG",20,166,33,199
https://kawalpemilu.org#22614,"TANJUNG SARI, NATAR, LAMPUNG SELATAN, LAMPUNG",21,77,39,116
https://kawalpemilu.org#22614,"TANJUNG SARI, NATAR, LAMPUNG SELATAN, LAMPUNG",22,136,41,177
https://kawalpemilu.org#22614,"TANJUNG SARI, NATAR, LAMPUNG SELATAN, LAMPUNG",23,183,30,213
https://kawalpemilu.org#22614,"TANJUNG SARI, NATAR, LAMPUNG SELATAN, LAMPUNG",24,155,57,212
https://kawalpemilu.org#22614,"TANJUNG SARI, NATAR, LAMPUNG SELATAN, LAMPUNG",25,155,42,197
https://kawalpemilu.org#22614,"TANJUNG SARI, NATAR, LAMPUNG SELATAN, LAMPUNG",26,138,31,169
https://kawalpemilu.org#22614,"TANJUNG SARI, NATAR, LAMPUNG SELATAN, LAMPUNG",27,140,78,218
https://kawalpemilu.org#22614,"TANJUNG SARI, NATAR, LAMPUNG SELATAN, LAMPUNG",28,174,25,199
https://kawalpemilu.org#22614,"TANJUNG SARI, NATAR, LAMPUNG SELATAN, LAMPUNG",29,182,41,223
https://kawalpemilu.org#22615,"BUMI SARI, NATAR, LAMPUNG SELATAN, LAMPUNG",1,144,53,197
https://kawalpemilu.org#22615,"BUMI SARI, NATAR, LAMPUNG SELATAN, LAMPUNG",2,119,86,205
https://kawalpemilu.org#22615,"BUMI SARI, NATAR, LAMPUNG SELATAN, LAMPUNG",3,157,64,221
https://kawalpemilu.org#22615,"BUMI SARI, NATAR, LAMPUNG SELATAN, LAMPUNG",4,91,121,212
https://kawalpemilu.org#22615,"BUMI SARI, NATAR, LAMPUNG SELATAN, LAMPUNG",5,163,68,231
https://kawalpemilu.org#22615,"BUMI SARI, NATAR, LAMPUNG SELATAN, LAMPUNG",6,93,96,189
https://kawalpemilu.org#22615,"BUMI SARI, NATAR, LAMPUNG SELATAN, LAMPUNG",7,120,64,184
https://kawalpemilu.org#22615,"BUMI SARI, NATAR, LAMPUNG SELATAN, LAMPUNG",8,75,93,168
https://kawalpemilu.org#22615,"BUMI SARI, NATAR, LAMPUNG SELATAN, LAMPUNG",9,126,75,201
https://kawalpemilu.org#22615,"BUMI SARI, NATAR, LAMPUNG SELATAN, LAMPUNG",10,141,82,223
https://kawalpemilu.org#22615,"BUMI SARI, NATAR, LAMPUNG SELATAN, LAMPUNG",11,141,69,210
https://kawalpemilu.org#22615,"BUMI SARI, NATAR, LAMPUNG SELATAN, LAMPUNG",12,157,60,217
https://kawalpemilu.org#22615,"BUMI SARI, NATAR, LAMPUNG SELATAN, LAMPUNG",13,124,91,215
https://kawalpemilu.org#22615,"BUMI SARI, NATAR, LAMPUNG SELATAN, LAMPUNG",14,144,67,211
https://kawalpemilu.org#22615,"BUMI SARI, NATAR, LAMPUNG SELATAN, LAMPUNG",15,118,58,176
https://kawalpemilu.org#22615,"BUMI SARI, NATAR, LAMPUNG SELATAN, LAMPUNG",16,116,84,200
https://kawalpemilu.org#22615,"BUMI SARI, NATAR, LAMPUNG SELATAN, LAMPUNG",17,85,47,132
https://kawalpemilu.org#22615,"BUMI SARI, NATAR, LAMPUNG SELATAN, LAMPUNG",18,112,85,197
https://kawalpemilu.org#22615,"BUMI SARI, NATAR, LAMPUNG SELATAN, LAMPUNG",19,109,115,224
https://kawalpemilu.org#22615,"BUMI SARI, NATAR, LAMPUNG SELATAN, LAMPUNG",20,106,69,175
https://kawalpemilu.org#22615,"BUMI SARI, NATAR, LAMPUNG SELATAN, LAMPUNG",21,79,91,170
https://kawalpemilu.org#22615,"BUMI SARI, NATAR, LAMPUNG SELATAN, LAMPUNG",22,115,91,206
https://kawalpemilu.org#22615,"BUMI SARI, NATAR, LAMPUNG SELATAN, LAMPUNG",23,109,77,186
https://kawalpemilu.org#22616,"CANDIMAS, NATAR, LAMPUNG SELATAN, LAMPUNG",2,116,88,204
https://kawalpemilu.org#22616,"CANDIMAS, NATAR, LAMPUNG SELATAN, LAMPUNG",3,142,47,189
https://kawalpemilu.org#22616,"CANDIMAS, NATAR, LAMPUNG SELATAN, LAMPUNG",4,114,108,222
https://kawalpemilu.org#22616,"CANDIMAS, NATAR, LAMPUNG SELATAN, LAMPUNG",5,115,74,189
https://kawalpemilu.org#22616,"CANDIMAS, NATAR, LAMPUNG SELATAN, LAMPUNG",6,98,91,189
https://kawalpemilu.org#22616,"CANDIMAS, NATAR, LAMPUNG SELATAN, LAMPUNG",8,74,129,203
https://kawalpemilu.org#22616,"CANDIMAS, NATAR, LAMPUNG SELATAN, LAMPUNG",9,94,57,151
https://kawalpemilu.org#22616,"CANDIMAS, NATAR, LAMPUNG SELATAN, LAMPUNG",10,66,120,186
https://kawalpemilu.org#22616,"CANDIMAS, NATAR, LAMPUNG SELATAN, LAMPUNG",11,182,57,239
https://kawalpemilu.org#22616,"CANDIMAS, NATAR, LAMPUNG SELATAN, LAMPUNG",12,93,99,192
https://kawalpemilu.org#22616,"CANDIMAS, NATAR, LAMPUNG SELATAN, LAMPUNG",13,65,137,202
https://kawalpemilu.org#22616,"CANDIMAS, NATAR, LAMPUNG SELATAN, LAMPUNG",14,100,113,213
https://kawalpemilu.org#22616,"CANDIMAS, NATAR, LAMPUNG SELATAN, LAMPUNG",15,74,135,209
https://kawalpemilu.org#22616,"CANDIMAS, NATAR, LAMPUNG SELATAN, LAMPUNG",16,97,124,221
https://kawalpemilu.org#22616,"CANDIMAS, NATAR, LAMPUNG SELATAN, LAMPUNG",17,163,87,250
https://kawalpemilu.org#22616,"CANDIMAS, NATAR, LAMPUNG SELATAN, LAMPUNG",18,111,80,191
https://kawalpemilu.org#22616,"CANDIMAS, NATAR, LAMPUNG SELATAN, LAMPUNG",19,122,95,217
https://kawalpemilu.org#22616,"CANDIMAS, NATAR, LAMPUNG SELATAN, LAMPUNG",20,128,51,179
https://kawalpemilu.org#22616,"CANDIMAS, NATAR, LAMPUNG SELATAN, LAMPUNG",21,71,121,192
https://kawalpemilu.org#22616,"CANDIMAS, NATAR, LAMPUNG SELATAN, LAMPUNG",22,87,97,184
https://kawalpemilu.org#22616,"CANDIMAS, NATAR, LAMPUNG SELATAN, LAMPUNG",23,135,32,167
https://kawalpemilu.org#22616,"CANDIMAS, NATAR, LAMPUNG SELATAN, LAMPUNG",24,74,123,197
https://kawalpemilu.org#22616,"CANDIMAS, NATAR, LAMPUNG SELATAN, LAMPUNG",25,82,99,181
https://kawalpemilu.org#22616,"CANDIMAS, NATAR, LAMPUNG SELATAN, LAMPUNG",26,70,87,157
https://kawalpemilu.org#22616,"CANDIMAS, NATAR, LAMPUNG SELATAN, LAMPUNG",27,72,132,204
https://kawalpemilu.org#22616,"CANDIMAS, NATAR, LAMPUNG SELATAN, LAMPUNG",28,78,128,206
https://kawalpemilu.org#22616,"CANDIMAS, NATAR, LAMPUNG SELATAN, LAMPUNG",29,119,56,175
https://kawalpemilu.org#22616,"CANDIMAS, NATAR, LAMPUNG SELATAN, LAMPUNG",30,80,108,188
https://kawalpemilu.org#22616,"CANDIMAS, NATAR, LAMPUNG SELATAN, LAMPUNG",31,98,107,205
https://kawalpemilu.org#22616,"CANDIMAS, NATAR, LAMPUNG SELATAN, LAMPUNG",32,69,106,175
https://kawalpemilu.org#22617,"BRANTI RAYA, NATAR, LAMPUNG SELATAN, LAMPUNG",1,61,81,142
https://kawalpemilu.org#22617,"BRANTI RAYA, NATAR, LAMPUNG SELATAN, LAMPUNG",2,105,118,223
https://kawalpemilu.org#22617,"BRANTI RAYA, NATAR, LAMPUNG SELATAN, LAMPUNG",3,99,83,182
https://kawalpemilu.org#22617,"BRANTI RAYA, NATAR, LAMPUNG SELATAN, LAMPUNG",4,113,109,222
https://kawalpemilu.org#22617,"BRANTI RAYA, NATAR, LAMPUNG SELATAN, LAMPUNG",5,135,89,224
https://kawalpemilu.org#22617,"BRANTI RAYA, NATAR, LAMPUNG SELATAN, LAMPUNG",6,122,91,213
https://kawalpemilu.org#22617,"BRANTI RAYA, NATAR, LAMPUNG SELATAN, LAMPUNG",7,117,101,218
https://kawalpemilu.org#22617,"BRANTI RAYA, NATAR, LAMPUNG SELATAN, LAMPUNG",8,122,104,226
https://kawalpemilu.org#22617,"BRANTI RAYA, NATAR, LAMPUNG SELATAN, LAMPUNG",9,137,84,221
https://kawalpemilu.org#22617,"BRANTI RAYA, NATAR, LAMPUNG SELATAN, LAMPUNG",10,97,112,209
https://kawalpemilu.org#22617,"BRANTI RAYA, NATAR, LAMPUNG SELATAN, LAMPUNG",11,102,104,206
https://kawalpemilu.org#22617,"BRANTI RAYA, NATAR, LAMPUNG SELATAN, LAMPUNG",12,116,111,227
https://kawalpemilu.org#22617,"BRANTI RAYA, NATAR, LAMPUNG SELATAN, LAMPUNG",13,70,73,143
https://kawalpemilu.org#22617,"BRANTI RAYA, NATAR, LAMPUNG SELATAN, LAMPUNG",14,96,52,148
https://kawalpemilu.org#22617,"BRANTI RAYA, NATAR, LAMPUNG SELATAN, LAMPUNG",15,99,97,196
https://kawalpemilu.org#22617,"BRANTI RAYA, NATAR, LAMPUNG SELATAN, LAMPUNG",16,107,64,171
https://kawalpemilu.org#22617,"BRANTI RAYA, NATAR, LAMPUNG SELATAN, LAMPUNG",17,116,65,181
https://kawalpemilu.org#22617,"BRANTI RAYA, NATAR, LAMPUNG SELATAN, LAMPUNG",18,162,69,231
https://kawalpemilu.org#22617,"BRANTI RAYA, NATAR, LAMPUNG SELATAN, LAMPUNG",19,142,49,191
https://kawalpemilu.org#22617,"BRANTI RAYA, NATAR, LAMPUNG SELATAN, LAMPUNG",20,130,28,158
https://kawalpemilu.org#22617,"BRANTI RAYA, NATAR, LAMPUNG SELATAN, LAMPUNG",21,95,40,135
https://kawalpemilu.org#22617,"BRANTI RAYA, NATAR, LAMPUNG SELATAN, LAMPUNG",22,112,56,168
https://kawalpemilu.org#22617,"BRANTI RAYA, NATAR, LAMPUNG SELATAN, LAMPUNG",23,67,123,190
https://kawalpemilu.org#22617,"BRANTI RAYA, NATAR, LAMPUNG SELATAN, LAMPUNG",24,69,113,182
https://kawalpemilu.org#22617,"BRANTI RAYA, NATAR, LAMPUNG SELATAN, LAMPUNG",25,95,100,195
https://kawalpemilu.org#22617,"BRANTI RAYA, NATAR, LAMPUNG SELATAN, LAMPUNG",26,114,104,218
https://kawalpemilu.org#22617,"BRANTI RAYA, NATAR, LAMPUNG SELATAN, LAMPUNG",27,81,61,142
https://kawalpemilu.org#22617,"BRANTI RAYA, NATAR, LAMPUNG SELATAN, LAMPUNG",28,78,89,167
https://kawalpemilu.org#22617,"BRANTI RAYA, NATAR, LAMPUNG SELATAN, LAMPUNG",29,84,46,130
https://kawalpemilu.org#22617,"BRANTI RAYA, NATAR, LAMPUNG SELATAN, LAMPUNG",30,80,128,208
https://kawalpemilu.org#22617,"BRANTI RAYA, NATAR, LAMPUNG SELATAN, LAMPUNG",31,122,45,167
https://kawalpemilu.org#22617,"BRANTI RAYA, NATAR, LAMPUNG SELATAN, LAMPUNG",32,143,29,172
https://kawalpemilu.org#22617,"BRANTI RAYA, NATAR, LAMPUNG SELATAN, LAMPUNG",33,148,34,182
https://kawalpemilu.org#22617,"BRANTI RAYA, NATAR, LAMPUNG SELATAN, LAMPUNG",34,123,46,169
https://kawalpemilu.org#22618,"HADUYANG, NATAR, LAMPUNG SELATAN, LAMPUNG",1,62,117,179
https://kawalpemilu.org#22618,"HADUYANG, NATAR, LAMPUNG SELATAN, LAMPUNG",2,85,113,198
https://kawalpemilu.org#22618,"HADUYANG, NATAR, LAMPUNG SELATAN, LAMPUNG",3,121,101,222
https://kawalpemilu.org#22618,"HADUYANG, NATAR, LAMPUNG SELATAN, LAMPUNG",4,107,105,212
https://kawalpemilu.org#22618,"HADUYANG, NATAR, LAMPUNG SELATAN, LAMPUNG",5,105,73,178
https://kawalpemilu.org#22618,"HADUYANG, NATAR, LAMPUNG SELATAN, LAMPUNG",6,152,100,252
https://kawalpemilu.org#22618,"HADUYANG, NATAR, LAMPUNG SELATAN, LAMPUNG",7,160,105,265
https://kawalpemilu.org#22618,"HADUYANG, NATAR, LAMPUNG SELATAN, LAMPUNG",8,157,43,200
https://kawalpemilu.org#22618,"HADUYANG, NATAR, LAMPUNG SELATAN, LAMPUNG",9,175,27,202
https://kawalpemilu.org#22618,"HADUYANG, NATAR, LAMPUNG SELATAN, LAMPUNG",10,120,67,187
https://kawalpemilu.org#22618,"HADUYANG, NATAR, LAMPUNG SELATAN, LAMPUNG",11,116,93,209
https://kawalpemilu.org#22618,"HADUYANG, NATAR, LAMPUNG SELATAN, LAMPUNG",12,105,52,157
https://kawalpemilu.org#22618,"HADUYANG, NATAR, LAMPUNG SELATAN, LAMPUNG",13,169,37,206
https://kawalpemilu.org#22618,"HADUYANG, NATAR, LAMPUNG SELATAN, LAMPUNG",14,99,40,139
https://kawalpemilu.org#22618,"HADUYANG, NATAR, LAMPUNG SELATAN, LAMPUNG",15,76,73,149
https://kawalpemilu.org#22618,"HADUYANG, NATAR, LAMPUNG SELATAN, LAMPUNG",16,71,77,148
https://kawalpemilu.org#22618,"HADUYANG, NATAR, LAMPUNG SELATAN, LAMPUNG",17,103,82,185
https://kawalpemilu.org#22618,"HADUYANG, NATAR, LAMPUNG SELATAN, LAMPUNG",18,95,81,176
https://kawalpemilu.org#22618,"HADUYANG, NATAR, LAMPUNG SELATAN, LAMPUNG",19,110,70,180
https://kawalpemilu.org#22618,"HADUYANG, NATAR, LAMPUNG SELATAN, LAMPUNG",20,138,28,166
https://kawalpemilu.org#22618,"HADUYANG, NATAR, LAMPUNG SELATAN, LAMPUNG",21,115,54,169
https://kawalpemilu.org#22618,"HADUYANG, NATAR, LAMPUNG SELATAN, LAMPUNG",22,106,79,185
https://kawalpemilu.org#22618,"HADUYANG, NATAR, LAMPUNG SELATAN, LAMPUNG",23,133,52,185
https://kawalpemilu.org#22619,"BANJAR NEGERI, NATAR, LAMPUNG SELATAN, LAMPUNG",1,64,164,228
https://kawalpemilu.org#22619,"BANJAR NEGERI, NATAR, LAMPUNG SELATAN, LAMPUNG",2,56,128,184
https://kawalpemilu.org#22619,"BANJAR NEGERI, NATAR, LAMPUNG SELATAN, LAMPUNG",3,49,126,175
https://kawalpemilu.org#22619,"BANJAR NEGERI, NATAR, LAMPUNG SELATAN, LAMPUNG",4,100,134,234
https://kawalpemilu.org#22619,"BANJAR NEGERI, NATAR, LAMPUNG SELATAN, LAMPUNG",5,145,63,208
https://kawalpemilu.org#22619,"BANJAR NEGERI, NATAR, LAMPUNG SELATAN, LAMPUNG",6,153,90,243
https://kawalpemilu.org#22619,"BANJAR NEGERI, NATAR, LAMPUNG SELATAN, LAMPUNG",7,176,74,250
https://kawalpemilu.org#22619,"BANJAR NEGERI, NATAR, LAMPUNG SELATAN, LAMPUNG",8,180,46,226
https://kawalpemilu.org#22619,"BANJAR NEGERI, NATAR, LAMPUNG SELATAN, LAMPUNG",9,64,103,167
https://kawalpemilu.org#22619,"BANJAR NEGERI, NATAR, LAMPUNG SELATAN, LAMPUNG",10,62,117,179
https://kawalpemilu.org#22619,"BANJAR NEGERI, NATAR, LAMPUNG SELATAN, LAMPUNG",11,132,98,230
https://kawalpemilu.org#22619,"BANJAR NEGERI, NATAR, LAMPUNG SELATAN, LAMPUNG",12,116,72,188
https://kawalpemilu.org#22619,"BANJAR NEGERI, NATAR, LAMPUNG SELATAN, LAMPUNG",13,158,81,239
https://kawalpemilu.org#22619,"BANJAR NEGERI, NATAR, LAMPUNG SELATAN, LAMPUNG",14,61,19,80
https://kawalpemilu.org#22620,"MANDAH, NATAR, LAMPUNG SELATAN, LAMPUNG",1,74,128,202
https://kawalpemilu.org#22620,"MANDAH, NATAR, LAMPUNG SELATAN, LAMPUNG",2,67,121,188
https://kawalpemilu.org#22620,"MANDAH, NATAR, LAMPUNG SELATAN, LAMPUNG",3,109,123,232
https://kawalpemilu.org#22620,"MANDAH, NATAR, LAMPUNG SELATAN, LAMPUNG",4,113,146,259
https://kawalpemilu.org#22620,"MANDAH, NATAR, LAMPUNG SELATAN, LAMPUNG",5,124,73,197
https://kawalpemilu.org#22620,"MANDAH, NATAR, LAMPUNG SELATAN, LAMPUNG",6,174,32,206
https://kawalpemilu.org#22620,"MANDAH, NATAR, LAMPUNG SELATAN, LAMPUNG",7,177,6,183
https://kawalpemilu.org#22620,"MANDAH, NATAR, LAMPUNG SELATAN, LAMPUNG",8,132,116,248
https://kawalpemilu.org#22620,"MANDAH, NATAR, LAMPUNG SELATAN, LAMPUNG",9,142,103,245
https://kawalpemilu.org#22620,"MANDAH, NATAR, LAMPUNG SELATAN, LAMPUNG",10,93,35,128
https://kawalpemilu.org#22620,"MANDAH, NATAR, LAMPUNG SELATAN, LAMPUNG",11,164,48,212
https://kawalpemilu.org#22620,"MANDAH, NATAR, LAMPUNG SELATAN, LAMPUNG",12,204,10,214
https://kawalpemilu.org#22620,"MANDAH, NATAR, LAMPUNG SELATAN, LAMPUNG",13,144,13,157
https://kawalpemilu.org#22621,"RULUNG HELOK, NATAR, LAMPUNG SELATAN, LAMPUNG",1,94,109,203
https://kawalpemilu.org#22621,"RULUNG HELOK, NATAR, LAMPUNG SELATAN, LAMPUNG",2,98,101,199
https://kawalpemilu.org#22621,"RULUNG HELOK, NATAR, LAMPUNG SELATAN, LAMPUNG",3,113,85,198
https://kawalpemilu.org#22621,"RULUNG HELOK, NATAR, LAMPUNG SELATAN, LAMPUNG",4,106,6,112
https://kawalpemilu.org#22621,"RULUNG HELOK, NATAR, LAMPUNG SELATAN, LAMPUNG",5,200,34,234
https://kawalpemilu.org#22621,"RULUNG HELOK, NATAR, LAMPUNG SELATAN, LAMPUNG",6,158,27,185
https://kawalpemilu.org#22621,"RULUNG HELOK, NATAR, LAMPUNG SELATAN, LAMPUNG",7,79,86,165
https://kawalpemilu.org#22621,"RULUNG HELOK, NATAR, LAMPUNG SELATAN, LAMPUNG",8,129,62,191
https://kawalpemilu.org#22621,"RULUNG HELOK, NATAR, LAMPUNG SELATAN, LAMPUNG",9,99,58,157
https://kawalpemilu.org#22622,"BANDAR REJO, NATAR, LAMPUNG SELATAN, LAMPUNG",1,144,38,182
https://kawalpemilu.org#22622,"BANDAR REJO, NATAR, LAMPUNG SELATAN, LAMPUNG",2,131,34,165
https://kawalpemilu.org#22622,"BANDAR REJO, NATAR, LAMPUNG SELATAN, LAMPUNG",3,101,52,153
https://kawalpemilu.org#22622,"BANDAR REJO, NATAR, LAMPUNG SELATAN, LAMPUNG",4,113,87,200
https://kawalpemilu.org#22622,"BANDAR REJO, NATAR, LAMPUNG SELATAN, LAMPUNG",5,85,59,144
https://kawalpemilu.org#22622,"BANDAR REJO, NATAR, LAMPUNG SELATAN, LAMPUNG",6,130,37,167
https://kawalpemilu.org#22622,"BANDAR REJO, NATAR, LAMPUNG SELATAN, LAMPUNG",7,135,50,185
https://kawalpemilu.org#22622,"BANDAR REJO, NATAR, LAMPUNG SELATAN, LAMPUNG",8,137,37,174
https://kawalpemilu.org#22622,"BANDAR REJO, NATAR, LAMPUNG SELATAN, LAMPUNG",9,126,36,162
https://kawalpemilu.org#22622,"BANDAR REJO, NATAR, LAMPUNG SELATAN, LAMPUNG",10,120,67,187
https://kawalpemilu.org#22622,"BANDAR REJO, NATAR, LAMPUNG SELATAN, LAMPUNG",11,94,54,148
https://kawalpemilu.org#22622,"BANDAR REJO, NATAR, LAMPUNG SELATAN, LAMPUNG",12,129,73,202
https://kawalpemilu.org#22623,"SUKA DAMAI, NATAR, LAMPUNG SELATAN, LAMPUNG",1,121,29,150
https://kawalpemilu.org#22623,"SUKA DAMAI, NATAR, LAMPUNG SELATAN, LAMPUNG",2,119,58,177
https://kawalpemilu.org#22623,"SUKA DAMAI, NATAR, LAMPUNG SELATAN, LAMPUNG",3,160,13,173
https://kawalpemilu.org#22623,"SUKA DAMAI, NATAR, LAMPUNG SELATAN, LAMPUNG",4,158,28,186
https://kawalpemilu.org#22623,"SUKA DAMAI, NATAR, LAMPUNG SELATAN, LAMPUNG",5,166,35,201
https://kawalpemilu.org#22623,"SUKA DAMAI, NATAR, LAMPUNG SELATAN, LAMPUNG",6,136,39,175
https://kawalpemilu.org#22623,"SUKA DAMAI, NATAR, LAMPUNG SELATAN, LAMPUNG",7,122,43,165
https://kawalpemilu.org#22623,"SUKA DAMAI, NATAR, LAMPUNG SELATAN, LAMPUNG",8,145,39,184
https://kawalpemilu.org#22623,"SUKA DAMAI, NATAR, LAMPUNG SELATAN, LAMPUNG",9,175,25,200
https://kawalpemilu.org#22623,"SUKA DAMAI, NATAR, LAMPUNG SELATAN, LAMPUNG",10,156,33,189
https://kawalpemilu.org#22623,"SUKA DAMAI, NATAR, LAMPUNG SELATAN, LAMPUNG",11,166,26,192
https://kawalpemilu.org#22623,"SUKA DAMAI, NATAR, LAMPUNG SELATAN, LAMPUNG",12,216,41,257
https://kawalpemilu.org#22623,"SUKA DAMAI, NATAR, LAMPUNG SELATAN, LAMPUNG",13,167,11,178
https://kawalpemilu.org#22623,"SUKA DAMAI, NATAR, LAMPUNG SELATAN, LAMPUNG",14,168,21,189
https://kawalpemilu.org#22623,"SUKA DAMAI, NATAR, LAMPUNG SELATAN, LAMPUNG",15,90,68,158
https://kawalpemilu.org#22623,"SUKA DAMAI, NATAR, LAMPUNG SELATAN, LAMPUNG",16,167,19,186
https://kawalpemilu.org#22623,"SUKA DAMAI, NATAR, LAMPUNG SELATAN, LAMPUNG",17,173,35,208
https://kawalpemilu.org#22623,"SUKA DAMAI, NATAR, LAMPUNG SELATAN, LAMPUNG",18,124,33,157
https://kawalpemilu.org#22623,"SUKA DAMAI, NATAR, LAMPUNG SELATAN, LAMPUNG",19,149,11,160
https://kawalpemilu.org#22623,"SUKA DAMAI, NATAR, LAMPUNG SELATAN, LAMPUNG",20,180,13,193
https://kawalpemilu.org#22623,"SUKA DAMAI, NATAR, LAMPUNG SELATAN, LAMPUNG",21,188,35,223
https://kawalpemilu.org#22624,"PURWOSARI, NATAR, LAMPUNG SELATAN, LAMPUNG",1,144,55,199
https://kawalpemilu.org#22624,"PURWOSARI, NATAR, LAMPUNG SELATAN, LAMPUNG",2,117,53,170
https://kawalpemilu.org#22624,"PURWOSARI, NATAR, LAMPUNG SELATAN, LAMPUNG",3,140,73,213
https://kawalpemilu.org#22624,"PURWOSARI, NATAR, LAMPUNG SELATAN, LAMPUNG",4,183,18,201
https://kawalpemilu.org#22624,"PURWOSARI, NATAR, LAMPUNG SELATAN, LAMPUNG",5,145,40,185
https://kawalpemilu.org#22624,"PURWOSARI, NATAR, LAMPUNG SELATAN, LAMPUNG",6,139,30,169
https://kawalpemilu.org#22624,"PURWOSARI, NATAR, LAMPUNG SELATAN, LAMPUNG",7,138,51,189
https://kawalpemilu.org#22624,"PURWOSARI, NATAR, LAMPUNG SELATAN, LAMPUNG",8,162,19,181
https://kawalpemilu.org#22624,"PURWOSARI, NATAR, LAMPUNG SELATAN, LAMPUNG",9,133,58,191
https://kawalpemilu.org#22624,"PURWOSARI, NATAR, LAMPUNG SELATAN, LAMPUNG",10,136,30,166
https://kawalpemilu.org#22624,"PURWOSARI, NATAR, LAMPUNG SELATAN, LAMPUNG",11,133,26,159
https://kawalpemilu.org#22625,"PANCASILA, NATAR, LAMPUNG SELATAN, LAMPUNG",1,69,133,202
https://kawalpemilu.org#22625,"PANCASILA, NATAR, LAMPUNG SELATAN, LAMPUNG",2,115,71,186
https://kawalpemilu.org#22625,"PANCASILA, NATAR, LAMPUNG SELATAN, LAMPUNG",3,116,77,193
https://kawalpemilu.org#22625,"PANCASILA, NATAR, LAMPUNG SELATAN, LAMPUNG",4,137,60,197
https://kawalpemilu.org#22625,"PANCASILA, NATAR, LAMPUNG SELATAN, LAMPUNG",5,166,26,192
https://kawalpemilu.org#22625,"PANCASILA, NATAR, LAMPUNG SELATAN, LAMPUNG",6,133,72,205
https://kawalpemilu.org#22625,"PANCASILA, NATAR, LAMPUNG SELATAN, LAMPUNG",7,116,75,191
https://kawalpemilu.org#22625,"PANCASILA, NATAR, LAMPUNG SELATAN, LAMPUNG",8,122,69,191
https://kawalpemilu.org#22625,"PANCASILA, NATAR, LAMPUNG SELATAN, LAMPUNG",9,91,92,183
https://kawalpemilu.org#22626,"REJOSARI, NATAR, LAMPUNG SELATAN, LAMPUNG",1,64,118,182
https://kawalpemilu.org#22626,"REJOSARI, NATAR, LAMPUNG SELATAN, LAMPUNG",2,37,98,135
https://kawalpemilu.org#22626,"REJOSARI, NATAR, LAMPUNG SELATAN, LAMPUNG",3,85,101,186
https://kawalpemilu.org#22626,"REJOSARI, NATAR, LAMPUNG SELATAN, LAMPUNG",4,72,82,154
https://kawalpemilu.org#22626,"REJOSARI, NATAR, LAMPUNG SELATAN, LAMPUNG",5,133,67,200
https://kawalpemilu.org#22626,"REJOSARI, NATAR, LAMPUNG SELATAN, LAMPUNG",6,61,135,196
https://kawalpemilu.org#22626,"REJOSARI, NATAR, LAMPUNG SELATAN, LAMPUNG",7,74,58,132
https://kawalpemilu.org#22626,"REJOSARI, NATAR, LAMPUNG SELATAN, LAMPUNG",8,95,60,155
https://kawalpemilu.org#22626,"REJOSARI, NATAR, LAMPUNG SELATAN, LAMPUNG",9,45,73,118
https://kawalpemilu.org#22626,"REJOSARI, NATAR, LAMPUNG SELATAN, LAMPUNG",10,57,68,125
https://kawalpemilu.org#22626,"REJOSARI, NATAR, LAMPUNG SELATAN, LAMPUNG",11,82,91,173
https://kawalpemilu.org#22626,"REJOSARI, NATAR, LAMPUNG SELATAN, LAMPUNG",12,80,82,162
https://kawalpemilu.org#22626,"REJOSARI, NATAR, LAMPUNG SELATAN, LAMPUNG",13,86,56,142
https://kawalpemilu.org#22626,"REJOSARI, NATAR, LAMPUNG SELATAN, LAMPUNG",14,63,74,137
https://kawalpemilu.org#22626,"REJOSARI, NATAR, LAMPUNG SELATAN, LAMPUNG",15,83,85,168
https://kawalpemilu.org#22627,"RULUNG RAYA, NATAR, LAMPUNG SELATAN, LAMPUNG",1,101,107,208
https://kawalpemilu.org#22627,"RULUNG RAYA, NATAR, LAMPUNG SELATAN, LAMPUNG",2,109,57,166
https://kawalpemilu.org#22627,"RULUNG RAYA, NATAR, LAMPUNG SELATAN, LAMPUNG",3,127,51,178
https://kawalpemilu.org#22627,"RULUNG RAYA, NATAR, LAMPUNG SELATAN, LAMPUNG",4,94,67,161
https://kawalpemilu.org#22627,"RULUNG RAYA, NATAR, LAMPUNG SELATAN, LAMPUNG",5,108,60,168
https://kawalpemilu.org#22627,"RULUNG RAYA, NATAR, LAMPUNG SELATAN, LAMPUNG",6,86,72,158
https://kawalpemilu.org#22627,"RULUNG RAYA, NATAR, LAMPUNG SELATAN, LAMPUNG",7,134,61,195
https://kawalpemilu.org#22627,"RULUNG RAYA, NATAR, LAMPUNG SELATAN, LAMPUNG",8,152,22,174
https://kawalpemilu.org#22627,"RULUNG RAYA, NATAR, LAMPUNG SELATAN, LAMPUNG",9,134,7,141
https://kawalpemilu.org#22627,"RULUNG RAYA, NATAR, LAMPUNG SELATAN, LAMPUNG",10,120,23,143
https://kawalpemilu.org#22627,"RULUNG RAYA, NATAR, LAMPUNG SELATAN, LAMPUNG",11,98,70,168
https://kawalpemilu.org#22627,"RULUNG RAYA, NATAR, LAMPUNG SELATAN, LAMPUNG",12,108,45,153
https://kawalpemilu.org#22627,"RULUNG RAYA, NATAR, LAMPUNG SELATAN, LAMPUNG",14,135,32,167
https://kawalpemilu.org#22627,"RULUNG RAYA, NATAR, LAMPUNG SELATAN, LAMPUNG",15,130,32,162
https://kawalpemilu.org#22627,"RULUNG RAYA, NATAR, LAMPUNG SELATAN, LAMPUNG",16,146,30,176
https://kawalpemilu.org#22628,"KRAWANG SARI, NATAR, LAMPUNG SELATAN, LAMPUNG",1,138,54,192
https://kawalpemilu.org#22628,"KRAWANG SARI, NATAR, LAMPUNG SELATAN, LAMPUNG",2,106,107,213
https://kawalpemilu.org#22628,"KRAWANG SARI, NATAR, LAMPUNG SELATAN, LAMPUNG",3,118,61,179
https://kawalpemilu.org#22628,"KRAWANG SARI, NATAR, LAMPUNG SELATAN, LAMPUNG",4,136,16,152
https://kawalpemilu.org#22628,"KRAWANG SARI, NATAR, LAMPUNG SELATAN, LAMPUNG",5,157,41,198
https://kawalpemilu.org#22628,"KRAWANG SARI, NATAR, LAMPUNG SELATAN, LAMPUNG",6,205,36,241
https://kawalpemilu.org#22628,"KRAWANG SARI, NATAR, LAMPUNG SELATAN, LAMPUNG",7,205,21,226
https://kawalpemilu.org#22628,"KRAWANG SARI, NATAR, LAMPUNG SELATAN, LAMPUNG",8,189,31,222
https://kawalpemilu.org#22628,"KRAWANG SARI, NATAR, LAMPUNG SELATAN, LAMPUNG",9,114,56,170
https://kawalpemilu.org#22628,"KRAWANG SARI, NATAR, LAMPUNG SELATAN, LAMPUNG",10,91,98,189
https://kawalpemilu.org#22628,"KRAWANG SARI, NATAR, LAMPUNG SELATAN, LAMPUNG",11,151,70,221
https://kawalpemilu.org#22628,"KRAWANG SARI, NATAR, LAMPUNG SELATAN, LAMPUNG",12,149,34,183
https://kawalpemilu.org#22628,"KRAWANG SARI, NATAR, LAMPUNG SELATAN, LAMPUNG",13,174,30,204
https://kawalpemilu.org#91291,"WAI SARI, NATAR, LAMPUNG SELATAN, LAMPUNG",1,155,28,183
https://kawalpemilu.org#91291,"WAI SARI, NATAR, LAMPUNG SELATAN, LAMPUNG",2,150,65,215
https://kawalpemilu.org#91291,"WAI SARI, NATAR, LAMPUNG SELATAN, LAMPUNG",3,149,48,197
https://kawalpemilu.org#91291,"WAI SARI, NATAR, LAMPUNG SELATAN, LAMPUNG",4,123,54,177
https://kawalpemilu.org#91291,"WAI SARI, NATAR, LAMPUNG SELATAN, LAMPUNG",5,139,61,200
https://kawalpemilu.org#91291,"WAI SARI, NATAR, LAMPUNG SELATAN, LAMPUNG",6,121,73,194
https://kawalpemilu.org#91292,"KALI SARI, NATAR, LAMPUNG SELATAN, LAMPUNG",1,97,102,199
https://kawalpemilu.org#91292,"KALI SARI, NATAR, LAMPUNG SELATAN, LAMPUNG",2,120,94,214
https://kawalpemilu.org#91292,"KALI SARI, NATAR, LAMPUNG SELATAN, LAMPUNG",3,133,56,189
https://kawalpemilu.org#91292,"KALI SARI, NATAR, LAMPUNG SELATAN, LAMPUNG",4,144,60,204
https://kawalpemilu.org#91292,"KALI SARI, NATAR, LAMPUNG SELATAN, LAMPUNG",5,165,58,223
https://kawalpemilu.org#91292,"KALI SARI, NATAR, LAMPUNG SELATAN, LAMPUNG",6,178,60,238
https://kawalpemilu.org#91292,"KALI SARI, NATAR, LAMPUNG SELATAN, LAMPUNG",8,115,66,181
https://kawalpemilu.org#91292,"KALI SARI, NATAR, LAMPUNG SELATAN, LAMPUNG",9,107,96,203
https://kawalpemilu.org#91292,"KALI SARI, NATAR, LAMPUNG SELATAN, LAMPUNG",10,156,72,228
https://kawalpemilu.org#91292,"KALI SARI, NATAR, LAMPUNG SELATAN, LAMPUNG",11,92,59,151
https://kawalpemilu.org#91292,"KALI SARI, NATAR, LAMPUNG SELATAN, LAMPUNG",12,104,60,164
https://kawalpemilu.org#91292,"KALI SARI, NATAR, LAMPUNG SELATAN, LAMPUNG",13,117,61,178
https://kawalpemilu.org#91292,"KALI SARI, NATAR, LAMPUNG SELATAN, LAMPUNG",14,108,62,170
https://kawalpemilu.org#91292,"KALI SARI, NATAR, LAMPUNG SELATAN, LAMPUNG",15,110,72,182
https://kawalpemilu.org#91292,"KALI SARI, NATAR, LAMPUNG SELATAN, LAMPUNG",16,152,56,208
https://kawalpemilu.org#91292,"KALI SARI, NATAR, LAMPUNG SELATAN, LAMPUNG",17,165,47,212
https://kawalpemilu.org#91292,"KALI SARI, NATAR, LAMPUNG SELATAN, LAMPUNG",18,183,23,206
https://kawalpemilu.org#91292,"KALI SARI, NATAR, LAMPUNG SELATAN, LAMPUNG",19,114,64,178
https://kawalpemilu.org#91292,"KALI SARI, NATAR, LAMPUNG SELATAN, LAMPUNG",20,150,44,6
https://kawalpemilu.org#91292,"KALI SARI, NATAR, LAMPUNG SELATAN, LAMPUNG",21,152,60,212
https://kawalpemilu.org#91292,"KALI SARI, NATAR, LAMPUNG SELATAN, LAMPUNG",22,114,32,146
https://kawalpemilu.org#91292,"KALI SARI, NATAR, LAMPUNG SELATAN, LAMPUNG",23,109,40,149
https://kawalpemilu.org#91293,"RULUNG SARI, NATAR, LAMPUNG SELATAN, LAMPUNG",1,183,48,231
https://kawalpemilu.org#91293,"RULUNG SARI, NATAR, LAMPUNG SELATAN, LAMPUNG",2,181,48,229
https://kawalpemilu.org#91293,"RULUNG SARI, NATAR, LAMPUNG SELATAN, LAMPUNG",3,177,35,212
https://kawalpemilu.org#91293,"RULUNG SARI, NATAR, LAMPUNG SELATAN, LAMPUNG",4,213,16,229
https://kawalpemilu.org#91293,"RULUNG SARI, NATAR, LAMPUNG SELATAN, LAMPUNG",5,168,38,206
https://kawalpemilu.org#91293,"RULUNG SARI, NATAR, LAMPUNG SELATAN, LAMPUNG",6,197,25,222
https://kawalpemilu.org#91293,"RULUNG SARI, NATAR, LAMPUNG SELATAN, LAMPUNG",7,155,56,211
https://kawalpemilu.org#91293,"RULUNG SARI, NATAR, LAMPUNG SELATAN, LAMPUNG",8,187,40,227
https://kawalpemilu.org#91293,"RULUNG SARI, NATAR, LAMPUNG SELATAN, LAMPUNG",9,203,23,226
https://kawalpemilu.org#91293,"RULUNG SARI, NATAR, LAMPUNG SELATAN, LAMPUNG",10,167,33,200
https://kawalpemilu.org#91293,"RULUNG SARI, NATAR, LAMPUNG SELATAN, LAMPUNG",11,164,34,198
https://kawalpemilu.org#91294,"RULUNG MULYA, NATAR, LAMPUNG SELATAN, LAMPUNG",1,156,19,175
https://kawalpemilu.org#91294,"RULUNG MULYA, NATAR, LAMPUNG SELATAN, LAMPUNG",2,155,24,179
https://kawalpemilu.org#91294,"RULUNG MULYA, NATAR, LAMPUNG SELATAN, LAMPUNG",3,126,24,150
https://kawalpemilu.org#91294,"RULUNG MULYA, NATAR, LAMPUNG SELATAN, LAMPUNG",4,156,8,164
https://kawalpemilu.org#91294,"RULUNG MULYA, NATAR, LAMPUNG SELATAN, LAMPUNG",5,101,101,202
https://kawalpemilu.org#91294,"RULUNG MULYA, NATAR, LAMPUNG SELATAN, LAMPUNG",6,107,31,138
https://kawalpemilu.org#22630,"KALI ASIN, TANJUNG BINTANG, LAMPUNG SELATAN, LAMPUNG",1,137,54,191
https://kawalpemilu.org#22630,"KALI ASIN, TANJUNG BINTANG, LAMPUNG SELATAN, LAMPUNG",2,177,54,231
https://kawalpemilu.org#22630,"KALI ASIN, TANJUNG BINTANG, LAMPUNG SELATAN, LAMPUNG",3,149,60,209
https://kawalpemilu.org#22630,"KALI ASIN, TANJUNG BINTANG, LAMPUNG SELATAN, LAMPUNG",4,114,75,189
https://kawalpemilu.org#22630,"KALI ASIN, TANJUNG BINTANG, LAMPUNG SELATAN, LAMPUNG",5,87,116,203
https://kawalpemilu.org#22630,"KALI ASIN, TANJUNG BINTANG, LAMPUNG SELATAN, LAMPUNG",6,99,103,202
https://kawalpemilu.org#22630,"KALI ASIN, TANJUNG BINTANG, LAMPUNG SELATAN, LAMPUNG",7,70,84,154
https://kawalpemilu.org#22630,"KALI ASIN, TANJUNG BINTANG, LAMPUNG SELATAN, LAMPUNG",8,117,103,220
https://kawalpemilu.org#22630,"KALI ASIN, TANJUNG BINTANG, LAMPUNG SELATAN, LAMPUNG",9,111,114,225
https://kawalpemilu.org#22630,"KALI ASIN, TANJUNG BINTANG, LAMPUNG SELATAN, LAMPUNG",10,79,110,189
https://kawalpemilu.org#22630,"KALI ASIN, TANJUNG BINTANG, LAMPUNG SELATAN, LAMPUNG",11,73,99,172
https://kawalpemilu.org#22631,"LEMATANG, TANJUNG BINTANG, LAMPUNG SELATAN, LAMPUNG",1,60,75,135
https://kawalpemilu.org#22631,"LEMATANG, TANJUNG BINTANG, LAMPUNG SELATAN, LAMPUNG",2,110,111,221
https://kawalpemilu.org#22631,"LEMATANG, TANJUNG BINTANG, LAMPUNG SELATAN, LAMPUNG",3,133,68,201
https://kawalpemilu.org#22631,"LEMATANG, TANJUNG BINTANG, LAMPUNG SELATAN, LAMPUNG",4,53,45,98
https://kawalpemilu.org#22631,"LEMATANG, TANJUNG BINTANG, LAMPUNG SELATAN, LAMPUNG",5,103,74,177
https://kawalpemilu.org#22631,"LEMATANG, TANJUNG BINTANG, LAMPUNG SELATAN, LAMPUNG",6,133,37,170
https://kawalpemilu.org#22631,"LEMATANG, TANJUNG BINTANG, LAMPUNG SELATAN, LAMPUNG",7,92,67,159
https://kawalpemilu.org#22631,"LEMATANG, TANJUNG BINTANG, LAMPUNG SELATAN, LAMPUNG",8,110,48,158
https://kawalpemilu.org#22631,"LEMATANG, TANJUNG BINTANG, LAMPUNG SELATAN, LAMPUNG",9,90,43,133
https://kawalpemilu.org#22631,"LEMATANG, TANJUNG BINTANG, LAMPUNG SELATAN, LAMPUNG",10,67,28,95
https://kawalpemilu.org#22631,"LEMATANG, TANJUNG BINTANG, LAMPUNG SELATAN, LAMPUNG",11,123,23,146
https://kawalpemilu.org#22632,"SUKA NEGARA, TANJUNG BINTANG, LAMPUNG SELATAN, LAMPUNG",1,133,95,228
https://kawalpemilu.org#22632,"SUKA NEGARA, TANJUNG BINTANG, LAMPUNG SELATAN, LAMPUNG",2,127,86,213
https://kawalpemilu.org#22632,"SUKA NEGARA, TANJUNG BINTANG, LAMPUNG SELATAN, LAMPUNG",3,131,80,219
https://kawalpemilu.org#22632,"SUKA NEGARA, TANJUNG BINTANG, LAMPUNG SELATAN, LAMPUNG",4,140,58,198
https://kawalpemilu.org#22632,"SUKA NEGARA, TANJUNG BINTANG, LAMPUNG SELATAN, LAMPUNG",5,138,53,191
https://kawalpemilu.org#22632,"SUKA NEGARA, TANJUNG BINTANG, LAMPUNG SELATAN, LAMPUNG",6,91,119,210
https://kawalpemilu.org#22632,"SUKA NEGARA, TANJUNG BINTANG, LAMPUNG SELATAN, LAMPUNG",7,130,80,210
https://kawalpemilu.org#22632,"SUKA NEGARA, TANJUNG BINTANG, LAMPUNG SELATAN, LAMPUNG",8,143,72,215
https://kawalpemilu.org#22632,"SUKA NEGARA, TANJUNG BINTANG, LAMPUNG SELATAN, LAMPUNG",9,135,72,207
https://kawalpemilu.org#22632,"SUKA NEGARA, TANJUNG BINTANG, LAMPUNG SELATAN, LAMPUNG",10,130,87,217
https://kawalpemilu.org#22632,"SUKA NEGARA, TANJUNG BINTANG, LAMPUNG SELATAN, LAMPUNG",11,118,97,215
https://kawalpemilu.org#22632,"SUKA NEGARA, TANJUNG BINTANG, LAMPUNG SELATAN, LAMPUNG",12,72,109,181
https://kawalpemilu.org#22632,"SUKA NEGARA, TANJUNG BINTANG, LAMPUNG SELATAN, LAMPUNG",13,86,97,183
https://kawalpemilu.org#22632,"SUKA NEGARA, TANJUNG BINTANG, LAMPUNG SELATAN, LAMPUNG",14,65,80,145
https://kawalpemilu.org#22632,"SUKA NEGARA, TANJUNG BINTANG, LAMPUNG SELATAN, LAMPUNG",15,92,78,170
https://kawalpemilu.org#22632,"SUKA NEGARA, TANJUNG BINTANG, LAMPUNG SELATAN, LAMPUNG",16,99,116,215
https://kawalpemilu.org#22632,"SUKA NEGARA, TANJUNG BINTANG, LAMPUNG SELATAN, LAMPUNG",17,115,88,203
https://kawalpemilu.org#22632,"SUKA NEGARA, TANJUNG BINTANG, LAMPUNG SELATAN, LAMPUNG",18,173,52,225
https://kawalpemilu.org#22633,"SERDANG, TANJUNG BINTANG, LAMPUNG SELATAN, LAMPUNG",1,111,72,183
https://kawalpemilu.org#22633,"SERDANG, TANJUNG BINTANG, LAMPUNG SELATAN, LAMPUNG",2,140,71,211
https://kawalpemilu.org#22633,"SERDANG, TANJUNG BINTANG, LAMPUNG SELATAN, LAMPUNG",3,128,57,185
https://kawalpemilu.org#22633,"SERDANG, TANJUNG BINTANG, LAMPUNG SELATAN, LAMPUNG",4,76,48,124
https://kawalpemilu.org#22633,"SERDANG, TANJUNG BINTANG, LAMPUNG SELATAN, LAMPUNG",5,116,40,156
https://kawalpemilu.org#22633,"SERDANG, TANJUNG BINTANG, LAMPUNG SELATAN, LAMPUNG",6,100,50,150
https://kawalpemilu.org#22633,"SERDANG, TANJUNG BINTANG, LAMPUNG SELATAN, LAMPUNG",7,90,40,130
https://kawalpemilu.org#22633,"SERDANG, TANJUNG BINTANG, LAMPUNG SELATAN, LAMPUNG",8,115,48,163
https://kawalpemilu.org#22633,"SERDANG, TANJUNG BINTANG, LAMPUNG SELATAN, LAMPUNG",9,120,51,171
https://kawalpemilu.org#22633,"SERDANG, TANJUNG BINTANG, LAMPUNG SELATAN, LAMPUNG",10,134,79,213
https://kawalpemilu.org#22633,"SERDANG, TANJUNG BINTANG, LAMPUNG SELATAN, LAMPUNG",11,108,103,211
https://kawalpemilu.org#22633,"SERDANG, TANJUNG BINTANG, LAMPUNG SELATAN, LAMPUNG",12,116,46,162
https://kawalpemilu.org#22633,"SERDANG, TANJUNG BINTANG, LAMPUNG SELATAN, LAMPUNG",13,204,62,266
https://kawalpemilu.org#22633,"SERDANG, TANJUNG BINTANG, LAMPUNG SELATAN, LAMPUNG",14,97,65,162
https://kawalpemilu.org#22633,"SERDANG, TANJUNG BINTANG, LAMPUNG SELATAN, LAMPUNG",15,104,107,211
https://kawalpemilu.org#22633,"SERDANG, TANJUNG BINTANG, LAMPUNG SELATAN, LAMPUNG",16,100,140,240
https://kawalpemilu.org#22633,"SERDANG, TANJUNG BINTANG, LAMPUNG SELATAN, LAMPUNG",17,133,88,221
https://kawalpemilu.org#22633,"SERDANG, TANJUNG BINTANG, LAMPUNG SELATAN, LAMPUNG",18,103,110,213
https://kawalpemilu.org#22633,"SERDANG, TANJUNG BINTANG, LAMPUNG SELATAN, LAMPUNG",19,71,130,201
https://kawalpemilu.org#22633,"SERDANG, TANJUNG BINTANG, LAMPUNG SELATAN, LAMPUNG",20,111,92,203
https://kawalpemilu.org#22633,"SERDANG, TANJUNG BINTANG, LAMPUNG SELATAN, LAMPUNG",21,130,80,210
https://kawalpemilu.org#22633,"SERDANG, TANJUNG BINTANG, LAMPUNG SELATAN, LAMPUNG",22,112,109,221
https://kawalpemilu.org#22633,"SERDANG, TANJUNG BINTANG, LAMPUNG SELATAN, LAMPUNG",23,88,76,164
https://kawalpemilu.org#22633,"SERDANG, TANJUNG BINTANG, LAMPUNG SELATAN, LAMPUNG",24,134,112,246
https://kawalpemilu.org#22633,"SERDANG, TANJUNG BINTANG, LAMPUNG SELATAN, LAMPUNG",25,138,104,242
https://kawalpemilu.org#22633,"SERDANG, TANJUNG BINTANG, LAMPUNG SELATAN, LAMPUNG",26,90,69,159
https://kawalpemilu.org#22633,"SERDANG, TANJUNG BINTANG, LAMPUNG SELATAN, LAMPUNG",27,77,46,123
https://kawalpemilu.org#22633,"SERDANG, TANJUNG BINTANG, LAMPUNG SELATAN, LAMPUNG",28,89,55,144
https://kawalpemilu.org#22633,"SERDANG, TANJUNG BINTANG, LAMPUNG SELATAN, LAMPUNG",29,89,72,161
https://kawalpemilu.org#22633,"SERDANG, TANJUNG BINTANG, LAMPUNG SELATAN, LAMPUNG",30,95,60,155
https://kawalpemilu.org#22634,"SINAR OGAN, TANJUNG BINTANG, LAMPUNG SELATAN, LAMPUNG",1,126,73,199
https://kawalpemilu.org#22634,"SINAR OGAN, TANJUNG BINTANG, LAMPUNG SELATAN, LAMPUNG",2,101,84,185
https://kawalpemilu.org#22634,"SINAR OGAN, TANJUNG BINTANG, LAMPUNG SELATAN, LAMPUNG",3,156,46,202
https://kawalpemilu.org#22634,"SINAR OGAN, TANJUNG BINTANG, LAMPUNG SELATAN, LAMPUNG",4,171,34,205
https://kawalpemilu.org#22634,"SINAR OGAN, TANJUNG BINTANG, LAMPUNG SELATAN, LAMPUNG",5,120,20,140
https://kawalpemilu.org#22634,"SINAR OGAN, TANJUNG BINTANG, LAMPUNG SELATAN, LAMPUNG",6,114,27,141
https://kawalpemilu.org#22634,"SINAR OGAN, TANJUNG BINTANG, LAMPUNG SELATAN, LAMPUNG",7,93,8,101
https://kawalpemilu.org#22635,"JATI BARU, TANJUNG BINTANG, LAMPUNG SELATAN, LAMPUNG",1,117,108,225
https://kawalpemilu.org#22635,"JATI BARU, TANJUNG BINTANG, LAMPUNG SELATAN, LAMPUNG",2,144,80,224
https://kawalpemilu.org#22635,"JATI BARU, TANJUNG BINTANG, LAMPUNG SELATAN, LAMPUNG",3,140,73,213
https://kawalpemilu.org#22635,"JATI BARU, TANJUNG BINTANG, LAMPUNG SELATAN, LAMPUNG",4,76,85,161
https://kawalpemilu.org#22635,"JATI BARU, TANJUNG BINTANG, LAMPUNG SELATAN, LAMPUNG",5,89,82,171
https://kawalpemilu.org#22635,"JATI BARU, TANJUNG BINTANG, LAMPUNG SELATAN, LAMPUNG",6,99,86,185
https://kawalpemilu.org#22635,"JATI BARU, TANJUNG BINTANG, LAMPUNG SELATAN, LAMPUNG",7,105,96,201
https://kawalpemilu.org#22635,"JATI BARU, TANJUNG BINTANG, LAMPUNG SELATAN, LAMPUNG",8,83,107,190
https://kawalpemilu.org#22635,"JATI BARU, TANJUNG BINTANG, LAMPUNG SELATAN, LAMPUNG",9,161,87,248
https://kawalpemilu.org#22635,"JATI BARU, TANJUNG BINTANG, LAMPUNG SELATAN, LAMPUNG",10,127,116,243
https://kawalpemilu.org#22635,"JATI BARU, TANJUNG BINTANG, LAMPUNG SELATAN, LAMPUNG",11,122,74,196
https://kawalpemilu.org#22635,"JATI BARU, TANJUNG BINTANG, LAMPUNG SELATAN, LAMPUNG",12,116,93,209
https://kawalpemilu.org#22635,"JATI BARU, TANJUNG BINTANG, LAMPUNG SELATAN, LAMPUNG",13,110,67,177
https://kawalpemilu.org#22635,"JATI BARU, TANJUNG BINTANG, LAMPUNG SELATAN, LAMPUNG",14,151,91,242
https://kawalpemilu.org#22635,"JATI BARU, TANJUNG BINTANG, LAMPUNG SELATAN, LAMPUNG",15,184,40,224
https://kawalpemilu.org#22635,"JATI BARU, TANJUNG BINTANG, LAMPUNG SELATAN, LAMPUNG",16,190,50,240
https://kawalpemilu.org#22635,"JATI BARU, TANJUNG BINTANG, LAMPUNG SELATAN, LAMPUNG",17,163,86,249
https://kawalpemilu.org#22635,"JATI BARU, TANJUNG BINTANG, LAMPUNG SELATAN, LAMPUNG",18,129,66,195
https://kawalpemilu.org#22635,"JATI BARU, TANJUNG BINTANG, LAMPUNG SELATAN, LAMPUNG",19,145,63,208
https://kawalpemilu.org#22635,"JATI BARU, TANJUNG BINTANG, LAMPUNG SELATAN, LAMPUNG",20,177,26,203
https://kawalpemilu.org#22635,"JATI BARU, TANJUNG BINTANG, LAMPUNG SELATAN, LAMPUNG",21,141,53,194
https://kawalpemilu.org#22635,"JATI BARU, TANJUNG BINTANG, LAMPUNG SELATAN, LAMPUNG",22,116,45,161
https://kawalpemilu.org#22635,"JATI BARU, TANJUNG BINTANG, LAMPUNG SELATAN, LAMPUNG",23,158,48,206
https://kawalpemilu.org#22635,"JATI BARU, TANJUNG BINTANG, LAMPUNG SELATAN, LAMPUNG",24,132,70,202
https://kawalpemilu.org#22635,"JATI BARU, TANJUNG BINTANG, LAMPUNG SELATAN, LAMPUNG",25,157,35,192
https://kawalpemilu.org#22635,"JATI BARU, TANJUNG BINTANG, LAMPUNG SELATAN, LAMPUNG",27,156,30,186
https://kawalpemilu.org#22635,"JATI BARU, TANJUNG BINTANG, LAMPUNG SELATAN, LAMPUNG",28,178,14,192
https://kawalpemilu.org#22635,"JATI BARU, TANJUNG BINTANG, LAMPUNG SELATAN, LAMPUNG",29,94,24,118
https://kawalpemilu.org#22635,"JATI BARU, TANJUNG BINTANG, LAMPUNG SELATAN, LAMPUNG",30,90,36,126
https://kawalpemilu.org#22636,"SABAH BALAU, TANJUNG BINTANG, LAMPUNG SELATAN, LAMPUNG",1,184,51,235
https://kawalpemilu.org#22636,"SABAH BALAU, TANJUNG BINTANG, LAMPUNG SELATAN, LAMPUNG",2,160,59,219
https://kawalpemilu.org#22636,"SABAH BALAU, TANJUNG BINTANG, LAMPUNG SELATAN, LAMPUNG",3,54,141,195
https://kawalpemilu.org#22636,"SABAH BALAU, TANJUNG BINTANG, LAMPUNG SELATAN, LAMPUNG",4,97,120,217
https://kawalpemilu.org#22636,"SABAH BALAU, TANJUNG BINTANG, LAMPUNG SELATAN, LAMPUNG",5,84,83,167
https://kawalpemilu.org#22636,"SABAH BALAU, TANJUNG BINTANG, LAMPUNG SELATAN, LAMPUNG",6,104,112,216
https://kawalpemilu.org#22636,"SABAH BALAU, TANJUNG BINTANG, LAMPUNG SELATAN, LAMPUNG",7,108,107,215
https://kawalpemilu.org#22636,"SABAH BALAU, TANJUNG BINTANG, LAMPUNG SELATAN, LAMPUNG",8,110,57,167
https://kawalpemilu.org#22636,"SABAH BALAU, TANJUNG BINTANG, LAMPUNG SELATAN, LAMPUNG",9,153,74,227
https://kawalpemilu.org#22636,"SABAH BALAU, TANJUNG BINTANG, LAMPUNG SELATAN, LAMPUNG",10,118,58,176
https://kawalpemilu.org#22636,"SABAH BALAU, TANJUNG BINTANG, LAMPUNG SELATAN, LAMPUNG",11,166,62,228
https://kawalpemilu.org#22636,"SABAH BALAU, TANJUNG BINTANG, LAMPUNG SELATAN, LAMPUNG",12,123,50,173
https://kawalpemilu.org#22636,"SABAH BALAU, TANJUNG BINTANG, LAMPUNG SELATAN, LAMPUNG",13,125,50,175
https://kawalpemilu.org#22636,"SABAH BALAU, TANJUNG BINTANG, LAMPUNG SELATAN, LAMPUNG",14,116,75,191
https://kawalpemilu.org#22636,"SABAH BALAU, TANJUNG BINTANG, LAMPUNG SELATAN, LAMPUNG",15,119,36,155
https://kawalpemilu.org#22636,"SABAH BALAU, TANJUNG BINTANG, LAMPUNG SELATAN, LAMPUNG",16,150,63,213
https://kawalpemilu.org#22636,"SABAH BALAU, TANJUNG BINTANG, LAMPUNG SELATAN, LAMPUNG",17,131,50,181
https://kawalpemilu.org#22637,"BUDI LESTARI, TANJUNG BINTANG, LAMPUNG SELATAN, LAMPUNG",1,147,45,192
https://kawalpemilu.org#22637,"BUDI LESTARI, TANJUNG BINTANG, LAMPUNG SELATAN, LAMPUNG",2,160,31,191
https://kawalpemilu.org#22637,"BUDI LESTARI, TANJUNG BINTANG, LAMPUNG SELATAN, LAMPUNG",3,172,31,203
https://kawalpemilu.org#22637,"BUDI LESTARI, TANJUNG BINTANG, LAMPUNG SELATAN, LAMPUNG",4,141,36,177
https://kawalpemilu.org#22637,"BUDI LESTARI, TANJUNG BINTANG, LAMPUNG SELATAN, LAMPUNG",5,192,25,217
https://kawalpemilu.org#22637,"BUDI LESTARI, TANJUNG BINTANG, LAMPUNG SELATAN, LAMPUNG",6,136,39,175
https://kawalpemilu.org#22637,"BUDI LESTARI, TANJUNG BINTANG, LAMPUNG SELATAN, LAMPUNG",7,135,21,156
https://kawalpemilu.org#22637,"BUDI LESTARI, TANJUNG BINTANG, LAMPUNG SELATAN, LAMPUNG",8,172,32,204
https://kawalpemilu.org#22637,"BUDI LESTARI, TANJUNG BINTANG, LAMPUNG SELATAN, LAMPUNG",9,110,39,149
https://kawalpemilu.org#22637,"BUDI LESTARI, TANJUNG BINTANG, LAMPUNG SELATAN, LAMPUNG",10,180,22,202
https://kawalpemilu.org#22637,"BUDI LESTARI, TANJUNG BINTANG, LAMPUNG SELATAN, LAMPUNG",11,154,26,180
https://kawalpemilu.org#22637,"BUDI LESTARI, TANJUNG BINTANG, LAMPUNG SELATAN, LAMPUNG",12,119,39,158
https://kawalpemilu.org#22637,"BUDI LESTARI, TANJUNG BINTANG, LAMPUNG SELATAN, LAMPUNG",13,152,30,182
https://kawalpemilu.org#22638,"TRIMULYO, TANJUNG BINTANG, LAMPUNG SELATAN, LAMPUNG",1,194,20,214
https://kawalpemilu.org#22638,"TRIMULYO, TANJUNG BINTANG, LAMPUNG SELATAN, LAMPUNG",2,193,25,218
https://kawalpemilu.org#22638,"TRIMULYO, TANJUNG BINTANG, LAMPUNG SELATAN, LAMPUNG",3,161,62,223
https://kawalpemilu.org#22638,"TRIMULYO, TANJUNG BINTANG, LAMPUNG SELATAN, LAMPUNG",4,213,6,219
https://kawalpemilu.org#22638,"TRIMULYO, TANJUNG BINTANG, LAMPUNG SELATAN, LAMPUNG",5,126,72,198
https://kawalpemilu.org#22638,"TRIMULYO, TANJUNG BINTANG, LAMPUNG SELATAN, LAMPUNG",6,137,33,170
https://kawalpemilu.org#22638,"TRIMULYO, TANJUNG BINTANG, LAMPUNG SELATAN, LAMPUNG",8,162,49,211
https://kawalpemilu.org#22638,"TRIMULYO, TANJUNG BINTANG, LAMPUNG SELATAN, LAMPUNG",9,145,18,163
https://kawalpemilu.org#22639,"JATI INDAH, TANJUNG BINTANG, LAMPUNG SELATAN, LAMPUNG",1,206,48,254
https://kawalpemilu.org#22639,"JATI INDAH, TANJUNG BINTANG, LAMPUNG SELATAN, LAMPUNG",2,170,59,229
https://kawalpemilu.org#22639,"JATI INDAH, TANJUNG BINTANG, LAMPUNG SELATAN, LAMPUNG",3,139,54,193
https://kawalpemilu.org#22639,"JATI INDAH, TANJUNG BINTANG, LAMPUNG SELATAN, LAMPUNG",4,183,75,258
https://kawalpemilu.org#22639,"JATI INDAH, TANJUNG BINTANG, LAMPUNG SELATAN, LAMPUNG",5,162,46,208
https://kawalpemilu.org#22639,"JATI INDAH, TANJUNG BINTANG, LAMPUNG SELATAN, LAMPUNG",6,109,85,194
https://kawalpemilu.org#22639,"JATI INDAH, TANJUNG BINTANG, LAMPUNG SELATAN, LAMPUNG",7,187,47,234
https://kawalpemilu.org#22639,"JATI INDAH, TANJUNG BINTANG, LAMPUNG SELATAN, LAMPUNG",8,168,58,226
https://kawalpemilu.org#22639,"JATI INDAH, TANJUNG BINTANG, LAMPUNG SELATAN, LAMPUNG",9,112,51,163
https://kawalpemilu.org#22639,"JATI INDAH, TANJUNG BINTANG, LAMPUNG SELATAN, LAMPUNG",10,153,39,192
https://kawalpemilu.org#22639,"JATI INDAH, TANJUNG BINTANG, LAMPUNG SELATAN, LAMPUNG",11,149,66,215
https://kawalpemilu.org#22639,"JATI INDAH, TANJUNG BINTANG, LAMPUNG SELATAN, LAMPUNG",12,136,100,236
https://kawalpemilu.org#22640,"WAY GALIH, TANJUNG BINTANG, LAMPUNG SELATAN, LAMPUNG",1,115,64,179
https://kawalpemilu.org#22640,"WAY GALIH, TANJUNG BINTANG, LAMPUNG SELATAN, LAMPUNG",2,112,58,170
https://kawalpemilu.org#22640,"WAY GALIH, TANJUNG BINTANG, LAMPUNG SELATAN, LAMPUNG",3,83,102,185
https://kawalpemilu.org#22640,"WAY GALIH, TANJUNG BINTANG, LAMPUNG SELATAN, LAMPUNG",4,99,83,182
https://kawalpemilu.org#22640,"WAY GALIH, TANJUNG BINTANG, LAMPUNG SELATAN, LAMPUNG",5,105,86,191
https://kawalpemilu.org#22640,"WAY GALIH, TANJUNG BINTANG, LAMPUNG SELATAN, LAMPUNG",6,157,75,232
https://kawalpemilu.org#22640,"WAY GALIH, TANJUNG BINTANG, LAMPUNG SELATAN, LAMPUNG",7,153,73,226
https://kawalpemilu.org#22640,"WAY GALIH, TANJUNG BINTANG, LAMPUNG SELATAN, LAMPUNG",8,168,84,252
https://kawalpemilu.org#22640,"WAY GALIH, TANJUNG BINTANG, LAMPUNG SELATAN, LAMPUNG",9,144,74,218
https://kawalpemilu.org#22640,"WAY GALIH, TANJUNG BINTANG, LAMPUNG SELATAN, LAMPUNG",10,156,77,233
https://kawalpemilu.org#22640,"WAY GALIH, TANJUNG BINTANG, LAMPUNG SELATAN, LAMPUNG",11,173,62,235
https://kawalpemilu.org#22640,"WAY GALIH, TANJUNG BINTANG, LAMPUNG SELATAN, LAMPUNG",12,184,59,243
https://kawalpemilu.org#22640,"WAY GALIH, TANJUNG BINTANG, LAMPUNG SELATAN, LAMPUNG",13,189,61,250
https://kawalpemilu.org#22640,"WAY GALIH, TANJUNG BINTANG, LAMPUNG SELATAN, LAMPUNG",14,177,56,233
https://kawalpemilu.org#22640,"WAY GALIH, TANJUNG BINTANG, LAMPUNG SELATAN, LAMPUNG",15,135,72,207
https://kawalpemilu.org#22640,"WAY GALIH, TANJUNG BINTANG, LAMPUNG SELATAN, LAMPUNG",16,153,45,198
https://kawalpemilu.org#22640,"WAY GALIH, TANJUNG BINTANG, LAMPUNG SELATAN, LAMPUNG",17,127,62,189
https://kawalpemilu.org#22640,"WAY GALIH, TANJUNG BINTANG, LAMPUNG SELATAN, LAMPUNG",18,195,45,240
https://kawalpemilu.org#22640,"WAY GALIH, TANJUNG BINTANG, LAMPUNG SELATAN, LAMPUNG",19,196,50,246
https://kawalpemilu.org#22640,"WAY GALIH, TANJUNG BINTANG, LAMPUNG SELATAN, LAMPUNG",20,136,53,189
https://kawalpemilu.org#22641,"SINDANG SARI, TANJUNG BINTANG, LAMPUNG SELATAN, LAMPUNG",1,173,74,247
https://kawalpemilu.org#22641,"SINDANG SARI, TANJUNG BINTANG, LAMPUNG SELATAN, LAMPUNG",2,184,65,249
https://kawalpemilu.org#22641,"SINDANG SARI, TANJUNG BINTANG, LAMPUNG SELATAN, LAMPUNG",3,137,68,205
https://kawalpemilu.org#22641,"SINDANG SARI, TANJUNG BINTANG, LAMPUNG SELATAN, LAMPUNG",4,124,88,212
https://kawalpemilu.org#22641,"SINDANG SARI, TANJUNG BINTANG, LAMPUNG SELATAN, LAMPUNG",5,193,64,257
https://kawalpemilu.org#22641,"SINDANG SARI, TANJUNG BINTANG, LAMPUNG SELATAN, LAMPUNG",6,155,85,240
https://kawalpemilu.org#22641,"SINDANG SARI, TANJUNG BINTANG, LAMPUNG SELATAN, LAMPUNG",7,154,80,234
https://kawalpemilu.org#22641,"SINDANG SARI, TANJUNG BINTANG, LAMPUNG SELATAN, LAMPUNG",8,160,85,245
https://kawalpemilu.org#22641,"SINDANG SARI, TANJUNG BINTANG, LAMPUNG SELATAN, LAMPUNG",9,126,108,234
https://kawalpemilu.org#22641,"SINDANG SARI, TANJUNG BINTANG, LAMPUNG SELATAN, LAMPUNG",10,180,55,235
https://kawalpemilu.org#22641,"SINDANG SARI, TANJUNG BINTANG, LAMPUNG SELATAN, LAMPUNG",11,120,44,164
https://kawalpemilu.org#22641,"SINDANG SARI, TANJUNG BINTANG, LAMPUNG SELATAN, LAMPUNG",12,183,32,215
https://kawalpemilu.org#22641,"SINDANG SARI, TANJUNG BINTANG, LAMPUNG SELATAN, LAMPUNG",13,173,36,209
https://kawalpemilu.org#22641,"SINDANG SARI, TANJUNG BINTANG, LAMPUNG SELATAN, LAMPUNG",14,108,20,128
https://kawalpemilu.org#22642,"PURWODADI SIMPANG, TANJUNG BINTANG, LAMPUNG SELATAN, LAMPUNG",1,145,67,212
https://kawalpemilu.org#22642,"PURWODADI SIMPANG, TANJUNG BINTANG, LAMPUNG SELATAN, LAMPUNG",2,133,75,208
https://kawalpemilu.org#22642,"PURWODADI SIMPANG, TANJUNG BINTANG, LAMPUNG SELATAN, LAMPUNG",3,156,61,217
https://kawalpemilu.org#22642,"PURWODADI SIMPANG, TANJUNG BINTANG, LAMPUNG SELATAN, LAMPUNG",4,113,70,183
https://kawalpemilu.org#22642,"PURWODADI SIMPANG, TANJUNG BINTANG, LAMPUNG SELATAN, LAMPUNG",5,91,103,194
https://kawalpemilu.org#22642,"PURWODADI SIMPANG, TANJUNG BINTANG, LAMPUNG SELATAN, LAMPUNG",6,158,65,223
https://kawalpemilu.org#22642,"PURWODADI SIMPANG, TANJUNG BINTANG, LAMPUNG SELATAN, LAMPUNG",7,113,65,178
https://kawalpemilu.org#22642,"PURWODADI SIMPANG, TANJUNG BINTANG, LAMPUNG SELATAN, LAMPUNG",8,143,45,188
https://kawalpemilu.org#22642,"PURWODADI SIMPANG, TANJUNG BINTANG, LAMPUNG SELATAN, LAMPUNG",10,110,71,181
https://kawalpemilu.org#22642,"PURWODADI SIMPANG, TANJUNG BINTANG, LAMPUNG SELATAN, LAMPUNG",11,110,50,160
https://kawalpemilu.org#22642,"PURWODADI SIMPANG, TANJUNG BINTANG, LAMPUNG SELATAN, LAMPUNG",12,147,81,228
https://kawalpemilu.org#22642,"PURWODADI SIMPANG, TANJUNG BINTANG, LAMPUNG SELATAN, LAMPUNG",13,93,87,180
https://kawalpemilu.org#22642,"PURWODADI SIMPANG, TANJUNG BINTANG, LAMPUNG SELATAN, LAMPUNG",14,110,80,190
https://kawalpemilu.org#22643,"GALIH LUNIK, TANJUNG BINTANG, LAMPUNG SELATAN, LAMPUNG",1,53,160,213
https://kawalpemilu.org#22643,"GALIH LUNIK, TANJUNG BINTANG, LAMPUNG SELATAN, LAMPUNG",2,53,175,228
https://kawalpemilu.org#22643,"GALIH LUNIK, TANJUNG BINTANG, LAMPUNG SELATAN, LAMPUNG",3,111,113,224
https://kawalpemilu.org#22643,"GALIH LUNIK, TANJUNG BINTANG, LAMPUNG SELATAN, LAMPUNG",4,160,66,226
https://kawalpemilu.org#22643,"GALIH LUNIK, TANJUNG BINTANG, LAMPUNG SELATAN, LAMPUNG",5,149,71,220
https://kawalpemilu.org#22643,"GALIH LUNIK, TANJUNG BINTANG, LAMPUNG SELATAN, LAMPUNG",6,127,80,207
https://kawalpemilu.org#22643,"GALIH LUNIK, TANJUNG BINTANG, LAMPUNG SELATAN, LAMPUNG",7,67,128,195
https://kawalpemilu.org#22644,"SRIKATON, TANJUNG BINTANG, LAMPUNG SELATAN, LAMPUNG",1,203,25,228
https://kawalpemilu.org#22644,"SRIKATON, TANJUNG BINTANG, LAMPUNG SELATAN, LAMPUNG",2,176,20,196
https://kawalpemilu.org#22644,"SRIKATON, TANJUNG BINTANG, LAMPUNG SELATAN, LAMPUNG",3,170,24,194
https://kawalpemilu.org#22644,"SRIKATON, TANJUNG BINTANG, LAMPUNG SELATAN, LAMPUNG",4,187,39,226
https://kawalpemilu.org#22644,"SRIKATON, TANJUNG BINTANG, LAMPUNG SELATAN, LAMPUNG",5,173,44,217
https://kawalpemilu.org#22644,"SRIKATON, TANJUNG BINTANG, LAMPUNG SELATAN, LAMPUNG",6,159,57,216
https://kawalpemilu.org#22644,"SRIKATON, TANJUNG BINTANG, LAMPUNG SELATAN, LAMPUNG",7,150,48,198
https://kawalpemilu.org#22644,"SRIKATON, TANJUNG BINTANG, LAMPUNG SELATAN, LAMPUNG",8,173,40,213
https://kawalpemilu.org#22645,"REJOMULYO, TANJUNG BINTANG, LAMPUNG SELATAN, LAMPUNG",1,158,75,233
https://kawalpemilu.org#22645,"REJOMULYO, TANJUNG BINTANG, LAMPUNG SELATAN, LAMPUNG",2,145,90,235
https://kawalpemilu.org#22645,"REJOMULYO, TANJUNG BINTANG, LAMPUNG SELATAN, LAMPUNG",3,133,84,217
https://kawalpemilu.org#22645,"REJOMULYO, TANJUNG BINTANG, LAMPUNG SELATAN, LAMPUNG",4,106,138,244
https://kawalpemilu.org#22645,"REJOMULYO, TANJUNG BINTANG, LAMPUNG SELATAN, LAMPUNG",5,97,79,176
https://kawalpemilu.org#22645,"REJOMULYO, TANJUNG BINTANG, LAMPUNG SELATAN, LAMPUNG",6,166,39,205
https://kawalpemilu.org#22645,"REJOMULYO, TANJUNG BINTANG, LAMPUNG SELATAN, LAMPUNG",7,129,39,168
https://kawalpemilu.org#22647,"BUMI AGUNG, KALIANDA, LAMPUNG SELATAN, LAMPUNG",1,112,105,217
https://kawalpemilu.org#22647,"BUMI AGUNG, KALIANDA, LAMPUNG SELATAN, LAMPUNG",2,90,109,199
https://kawalpemilu.org#22647,"BUMI AGUNG, KALIANDA, LAMPUNG SELATAN, LAMPUNG",3,65,88,153
https://kawalpemilu.org#22647,"BUMI AGUNG, KALIANDA, LAMPUNG SELATAN, LAMPUNG",4,79,106,185
https://kawalpemilu.org#22647,"BUMI AGUNG, KALIANDA, LAMPUNG SELATAN, LAMPUNG",5,89,110,199
https://kawalpemilu.org#22647,"BUMI AGUNG, KALIANDA, LAMPUNG SELATAN, LAMPUNG",6,102,86,188
https://kawalpemilu.org#22647,"BUMI AGUNG, KALIANDA, LAMPUNG SELATAN, LAMPUNG",7,116,31,147
https://kawalpemilu.org#22647,"BUMI AGUNG, KALIANDA, LAMPUNG SELATAN, LAMPUNG",8,93,99,192
https://kawalpemilu.org#22647,"BUMI AGUNG, KALIANDA, LAMPUNG SELATAN, LAMPUNG",9,39,104,143
https://kawalpemilu.org#22647,"BUMI AGUNG, KALIANDA, LAMPUNG SELATAN, LAMPUNG",10,107,99,206
https://kawalpemilu.org#22647,"BUMI AGUNG, KALIANDA, LAMPUNG SELATAN, LAMPUNG",11,107,83,190
https://kawalpemilu.org#22647,"BUMI AGUNG, KALIANDA, LAMPUNG SELATAN, LAMPUNG",12,97,152,249
https://kawalpemilu.org#22647,"BUMI AGUNG, KALIANDA, LAMPUNG SELATAN, LAMPUNG",13,112,101,213
https://kawalpemilu.org#22648,"KALIANDA, KALIANDA, LAMPUNG SELATAN, LAMPUNG",1,125,92,217
https://kawalpemilu.org#22648,"KALIANDA, KALIANDA, LAMPUNG SELATAN, LAMPUNG",2,73,136,209
https://kawalpemilu.org#22648,"KALIANDA, KALIANDA, LAMPUNG SELATAN, LAMPUNG",3,139,61,200
https://kawalpemilu.org#22648,"KALIANDA, KALIANDA, LAMPUNG SELATAN, LAMPUNG",4,94,103,197
https://kawalpemilu.org#22648,"KALIANDA, KALIANDA, LAMPUNG SELATAN, LAMPUNG",5,110,150,260
https://kawalpemilu.org#22648,"KALIANDA, KALIANDA, LAMPUNG SELATAN, LAMPUNG",6,128,102,230
https://kawalpemilu.org#22648,"KALIANDA, KALIANDA, LAMPUNG SELATAN, LAMPUNG",7,110,146,256
https://kawalpemilu.org#22648,"KALIANDA, KALIANDA, LAMPUNG SELATAN, LAMPUNG",8,91,170,261
https://kawalpemilu.org#22648,"KALIANDA, KALIANDA, LAMPUNG SELATAN, LAMPUNG",9,61,140,201
https://kawalpemilu.org#22648,"KALIANDA, KALIANDA, LAMPUNG SELATAN, LAMPUNG",10,105,95,200
https://kawalpemilu.org#22648,"KALIANDA, KALIANDA, LAMPUNG SELATAN, LAMPUNG",11,58,153,211
https://kawalpemilu.org#22648,"KALIANDA, KALIANDA, LAMPUNG SELATAN, LAMPUNG",12,107,99,206
https://kawalpemilu.org#22648,"KALIANDA, KALIANDA, LAMPUNG SELATAN, LAMPUNG",13,104,69,173
https://kawalpemilu.org#22648,"KALIANDA, KALIANDA, LAMPUNG SELATAN, LAMPUNG",14,56,126,182
https://kawalpemilu.org#22648,"KALIANDA, KALIANDA, LAMPUNG SELATAN, LAMPUNG",15,79,89,168
https://kawalpemilu.org#22648,"KALIANDA, KALIANDA, LAMPUNG SELATAN, LAMPUNG",16,28,75,103
https://kawalpemilu.org#22649,"WAY URANG, KALIANDA, LAMPUNG SELATAN, LAMPUNG",1,98,136,234
https://kawalpemilu.org#22649,"WAY URANG, KALIANDA, LAMPUNG SELATAN, LAMPUNG",2,124,167,291
https://kawalpemilu.org#22649,"WAY URANG, KALIANDA, LAMPUNG SELATAN, LAMPUNG",3,96,142,238
https://kawalpemilu.org#22649,"WAY URANG, KALIANDA, LAMPUNG SELATAN, LAMPUNG",4,95,130,225
https://kawalpemilu.org#22649,"WAY URANG, KALIANDA, LAMPUNG SELATAN, LAMPUNG",5,55,133,188
https://kawalpemilu.org#22649,"WAY URANG, KALIANDA, LAMPUNG SELATAN, LAMPUNG",6,60,144,204
https://kawalpemilu.org#22649,"WAY URANG, KALIANDA, LAMPUNG SELATAN, LAMPUNG",7,117,81,198
https://kawalpemilu.org#22649,"WAY URANG, KALIANDA, LAMPUNG SELATAN, LAMPUNG",8,77,108,185
https://kawalpemilu.org#22649,"WAY URANG, KALIANDA, LAMPUNG SELATAN, LAMPUNG",9,107,107,214
https://kawalpemilu.org#22649,"WAY URANG, KALIANDA, LAMPUNG SELATAN, LAMPUNG",10,115,79,194
https://kawalpemilu.org#22649,"WAY URANG, KALIANDA, LAMPUNG SELATAN, LAMPUNG",11,106,99,205
https://kawalpemilu.org#22649,"WAY URANG, KALIANDA, LAMPUNG SELATAN, LAMPUNG",12,82,149,231
https://kawalpemilu.org#22649,"WAY URANG, KALIANDA, LAMPUNG SELATAN, LAMPUNG",13,130,44,174
https://kawalpemilu.org#22649,"WAY URANG, KALIANDA, LAMPUNG SELATAN, LAMPUNG",14,36,162,198
https://kawalpemilu.org#22649,"WAY URANG, KALIANDA, LAMPUNG SELATAN, LAMPUNG",15,51,120,171
https://kawalpemilu.org#22649,"WAY URANG, KALIANDA, LAMPUNG SELATAN, LAMPUNG",16,57,171,228
https://kawalpemilu.org#22649,"WAY URANG, KALIANDA, LAMPUNG SELATAN, LAMPUNG",17,80,163,243
https://kawalpemilu.org#22649,"WAY URANG, KALIANDA, LAMPUNG SELATAN, LAMPUNG",18,78,155,233
https://kawalpemilu.org#22649,"WAY URANG, KALIANDA, LAMPUNG SELATAN, LAMPUNG",19,44,140,184
https://kawalpemilu.org#22649,"WAY URANG, KALIANDA, LAMPUNG SELATAN, LAMPUNG",20,68,143,211
https://kawalpemilu.org#22649,"WAY URANG, KALIANDA, LAMPUNG SELATAN, LAMPUNG",21,116,116,232
https://kawalpemilu.org#22649,"WAY URANG, KALIANDA, LAMPUNG SELATAN, LAMPUNG",22,89,94,183
https://kawalpemilu.org#22649,"WAY URANG, KALIANDA, LAMPUNG SELATAN, LAMPUNG",23,76,118,194
https://kawalpemilu.org#22649,"WAY URANG, KALIANDA, LAMPUNG SELATAN, LAMPUNG",24,62,109,171
https://kawalpemilu.org#22649,"WAY URANG, KALIANDA, LAMPUNG SELATAN, LAMPUNG",25,38,88,126
https://kawalpemilu.org#22649,"WAY URANG, KALIANDA, LAMPUNG SELATAN, LAMPUNG",26,87,61,148
https://kawalpemilu.org#22649,"WAY URANG, KALIANDA, LAMPUNG SELATAN, LAMPUNG",27,119,89,208
https://kawalpemilu.org#22649,"WAY URANG, KALIANDA, LAMPUNG SELATAN, LAMPUNG",28,105,106,211
https://kawalpemilu.org#22649,"WAY URANG, KALIANDA, LAMPUNG SELATAN, LAMPUNG",29,74,101,175
https://kawalpemilu.org#22649,"WAY URANG, KALIANDA, LAMPUNG SELATAN, LAMPUNG",30,120,44,164
https://kawalpemilu.org#22649,"WAY URANG, KALIANDA, LAMPUNG SELATAN, LAMPUNG",31,59,128,187
https://kawalpemilu.org#22649,"WAY URANG, KALIANDA, LAMPUNG SELATAN, LAMPUNG",32,65,179,244
https://kawalpemilu.org#22649,"WAY URANG, KALIANDA, LAMPUNG SELATAN, LAMPUNG",33,59,169,228
https://kawalpemilu.org#22649,"WAY URANG, KALIANDA, LAMPUNG SELATAN, LAMPUNG",34,58,160,218
https://kawalpemilu.org#22649,"WAY URANG, KALIANDA, LAMPUNG SELATAN, LAMPUNG",35,38,121,159
https://kawalpemilu.org#22649,"WAY URANG, KALIANDA, LAMPUNG SELATAN, LAMPUNG",36,44,121,165
https://kawalpemilu.org#22649,"WAY URANG, KALIANDA, LAMPUNG SELATAN, LAMPUNG",37,87,132,219
https://kawalpemilu.org#22649,"WAY URANG, KALIANDA, LAMPUNG SELATAN, LAMPUNG",38,70,101,171
https://kawalpemilu.org#22650,"JONDONG, KALIANDA, LAMPUNG SELATAN, LAMPUNG",1,80,85,165
https://kawalpemilu.org#22650,"JONDONG, KALIANDA, LAMPUNG SELATAN, LAMPUNG",2,92,88,180
https://kawalpemilu.org#22650,"JONDONG, KALIANDA, LAMPUNG SELATAN, LAMPUNG",3,51,110,161
https://kawalpemilu.org#22650,"JONDONG, KALIANDA, LAMPUNG SELATAN, LAMPUNG",4,74,77,151
https://kawalpemilu.org#22650,"JONDONG, KALIANDA, LAMPUNG SELATAN, LAMPUNG",5,75,81,156
https://kawalpemilu.org#22651,"TENGKUJUH, KALIANDA, LAMPUNG SELATAN, LAMPUNG",1,61,119,180
https://kawalpemilu.org#22651,"TENGKUJUH, KALIANDA, LAMPUNG SELATAN, LAMPUNG",2,72,100,172
https://kawalpemilu.org#22651,"TENGKUJUH, KALIANDA, LAMPUNG SELATAN, LAMPUNG",3,54,101,155
https://kawalpemilu.org#22651,"TENGKUJUH, KALIANDA, LAMPUNG SELATAN, LAMPUNG",4,79,72,151
https://kawalpemilu.org#22652,"PAUH TANJUNG IMAN, KALIANDA, LAMPUNG SELATAN, LAMPUNG",1,104,85,189
https://kawalpemilu.org#22652,"PAUH TANJUNG IMAN, KALIANDA, LAMPUNG SELATAN, LAMPUNG",2,52,147,199
https://kawalpemilu.org#22652,"PAUH TANJUNG IMAN, KALIANDA, LAMPUNG SELATAN, LAMPUNG",3,96,94,190
https://kawalpemilu.org#22652,"PAUH TANJUNG IMAN, KALIANDA, LAMPUNG SELATAN, LAMPUNG",4,81,108,189
https://kawalpemilu.org#22653,"SUMUR KUMBANG, KALIANDA, LAMPUNG SELATAN, LAMPUNG",1,94,106,200
https://kawalpemilu.org#22653,"SUMUR KUMBANG, KALIANDA, LAMPUNG SELATAN, LAMPUNG",2,108,86,194
https://kawalpemilu.org#22653,"SUMUR KUMBANG, KALIANDA, LAMPUNG SELATAN, LAMPUNG",3,116,72,188
https://kawalpemilu.org#22653,"SUMUR KUMBANG, KALIANDA, LAMPUNG SELATAN, LAMPUNG",4,126,71,197
https://kawalpemilu.org#22654,"MAJA, KALIANDA, LAMPUNG SELATAN, LAMPUNG",1,51,178,229
https://kawalpemilu.org#22654,"MAJA, KALIANDA, LAMPUNG SELATAN, LAMPUNG",2,73,140,213
https://kawalpemilu.org#22654,"MAJA, KALIANDA, LAMPUNG SELATAN, LAMPUNG",3,83,83,166
https://kawalpemilu.org#22654,"MAJA, KALIANDA, LAMPUNG SELATAN, LAMPUNG",4,69,121,190
https://kawalpemilu.org#22655,"BUAH BERAK, KALIANDA, LAMPUNG SELATAN, LAMPUNG",1,56,184,240
https://kawalpemilu.org#22655,"BUAH BERAK, KALIANDA, LAMPUNG SELATAN, LAMPUNG",2,44,131,175
https://kawalpemilu.org#22655,"BUAH BERAK, KALIANDA, LAMPUNG SELATAN, LAMPUNG",3,68,103,171
https://kawalpemilu.org#22655,"BUAH BERAK, KALIANDA, LAMPUNG SELATAN, LAMPUNG",4,115,81,196
https://kawalpemilu.org#22655,"BUAH BERAK, KALIANDA, LAMPUNG SELATAN, LAMPUNG",5,136,61,197
https://kawalpemilu.org#22656,"KESUGIHAN, KALIANDA, LAMPUNG SELATAN, LAMPUNG",1,65,175,240
https://kawalpemilu.org#22656,"KESUGIHAN, KALIANDA, LAMPUNG SELATAN, LAMPUNG",2,78,112,190
https://kawalpemilu.org#22656,"KESUGIHAN, KALIANDA, LAMPUNG SELATAN, LAMPUNG",3,124,65,189
https://kawalpemilu.org#22656,"KESUGIHAN, KALIANDA, LAMPUNG SELATAN, LAMPUNG",4,57,116,173
https://kawalpemilu.org#22656,"KESUGIHAN, KALIANDA, LAMPUNG SELATAN, LAMPUNG",5,77,144,221
https://kawalpemilu.org#22657,"PEMATANG, KALIANDA, LAMPUNG SELATAN, LAMPUNG",1,39,105,144
https://kawalpemilu.org#22657,"PEMATANG, KALIANDA, LAMPUNG SELATAN, LAMPUNG",2,41,135,176
https://kawalpemilu.org#22657,"PEMATANG, KALIANDA, LAMPUNG SELATAN, LAMPUNG",3,55,130,185
https://kawalpemilu.org#22657,"PEMATANG, KALIANDA, LAMPUNG SELATAN, LAMPUNG",4,61,173,234
https://kawalpemilu.org#22657,"PEMATANG, KALIANDA, LAMPUNG SELATAN, LAMPUNG",5,29,130,159
https://kawalpemilu.org#22657,"PEMATANG, KALIANDA, LAMPUNG SELATAN, LAMPUNG",6,47,154,201
https://kawalpemilu.org#22657,"PEMATANG, KALIANDA, LAMPUNG SELATAN, LAMPUNG",7,86,118,204
https://kawalpemilu.org#22658,"KECAPI, KALIANDA, LAMPUNG SELATAN, LAMPUNG",1,38,127,165
https://kawalpemilu.org#22658,"KECAPI, KALIANDA, LAMPUNG SELATAN, LAMPUNG",2,52,111,163
https://kawalpemilu.org#22658,"KECAPI, KALIANDA, LAMPUNG SELATAN, LAMPUNG",3,59,142,201
https://kawalpemilu.org#22658,"KECAPI, KALIANDA, LAMPUNG SELATAN, LAMPUNG",4,35,136,171
https://kawalpemilu.org#22658,"KECAPI, KALIANDA, LAMPUNG SELATAN, LAMPUNG",5,65,118,183
https://kawalpemilu.org#22658,"KECAPI, KALIANDA, LAMPUNG SELATAN, LAMPUNG",6,79,94,173
https://kawalpemilu.org#22659,"BABULANG, KALIANDA, LAMPUNG SELATAN, LAMPUNG",1,46,160,206
https://kawalpemilu.org#22659,"BABULANG, KALIANDA, LAMPUNG SELATAN, LAMPUNG",2,71,129,200
https://kawalpemilu.org#22659,"BABULANG, KALIANDA, LAMPUNG SELATAN, LAMPUNG",3,47,104,151
https://kawalpemilu.org#22659,"BABULANG, KALIANDA, LAMPUNG SELATAN, LAMPUNG",4,76,125,201
https://kawalpemilu.org#22660,"SUKARATU, KALIANDA, LAMPUNG SELATAN, LAMPUNG",1,78,142,220
https://kawalpemilu.org#22660,"SUKARATU, KALIANDA, LAMPUNG SELATAN, LAMPUNG",2,69,127,196
https://kawalpemilu.org#22660,"SUKARATU, KALIANDA, LAMPUNG SELATAN, LAMPUNG",3,46,81,127
https://kawalpemilu.org#22660,"SUKARATU, KALIANDA, LAMPUNG SELATAN, LAMPUNG",4,78,129,207
https://kawalpemilu.org#22660,"SUKARATU, KALIANDA, LAMPUNG SELATAN, LAMPUNG",5,63,102,165
https://kawalpemilu.org#22660,"SUKARATU, KALIANDA, LAMPUNG SELATAN, LAMPUNG",6,73,69,142
https://kawalpemilu.org#22661,"PALEMBAPANG, KALIANDA, LAMPUNG SELATAN, LAMPUNG",1,64,129,193
https://kawalpemilu.org#22661,"PALEMBAPANG, KALIANDA, LAMPUNG SELATAN, LAMPUNG",2,49,155,204
https://kawalpemilu.org#22661,"PALEMBAPANG, KALIANDA, LAMPUNG SELATAN, LAMPUNG",3,34,148,182
https://kawalpemilu.org#22661,"PALEMBAPANG, KALIANDA, LAMPUNG SELATAN, LAMPUNG",4,72,129,201
https://kawalpemilu.org#22661,"PALEMBAPANG, KALIANDA, LAMPUNG SELATAN, LAMPUNG",5,59,141,200
https://kawalpemilu.org#22661,"PALEMBAPANG, KALIANDA, LAMPUNG SELATAN, LAMPUNG",6,46,82,128
https://kawalpemilu.org#22661,"PALEMBAPANG, KALIANDA, LAMPUNG SELATAN, LAMPUNG",7,48,101,149
https://kawalpemilu.org#22661,"PALEMBAPANG, KALIANDA, LAMPUNG SELATAN, LAMPUNG",8,43,125,168
https://kawalpemilu.org#22661,"PALEMBAPANG, KALIANDA, LAMPUNG SELATAN, LAMPUNG",9,40,122,162
https://kawalpemilu.org#22661,"PALEMBAPANG, KALIANDA, LAMPUNG SELATAN, LAMPUNG",10,54,106,160
https://kawalpemilu.org#22661,"PALEMBAPANG, KALIANDA, LAMPUNG SELATAN, LAMPUNG",11,89,99,188
https://kawalpemilu.org#22661,"PALEMBAPANG, KALIANDA, LAMPUNG SELATAN, LAMPUNG",12,127,64,191
https://kawalpemilu.org#22661,"PALEMBAPANG, KALIANDA, LAMPUNG SELATAN, LAMPUNG",13,100,66,166
https://kawalpemilu.org#22662,"TAJIMALELA, KALIANDA, LAMPUNG SELATAN, LAMPUNG",1,70,162,232
https://kawalpemilu.org#22662,"TAJIMALELA, KALIANDA, LAMPUNG SELATAN, LAMPUNG",2,60,165,225
https://kawalpemilu.org#22662,"TAJIMALELA, KALIANDA, LAMPUNG SELATAN, LAMPUNG",3,66,168,234
https://kawalpemilu.org#22662,"TAJIMALELA, KALIANDA, LAMPUNG SELATAN, LAMPUNG",4,64,133,197
https://kawalpemilu.org#22662,"TAJIMALELA, KALIANDA, LAMPUNG SELATAN, LAMPUNG",5,177,46,223
https://kawalpemilu.org#22662,"TAJIMALELA, KALIANDA, LAMPUNG SELATAN, LAMPUNG",6,85,70,155
https://kawalpemilu.org#22662,"TAJIMALELA, KALIANDA, LAMPUNG SELATAN, LAMPUNG",7,84,108,192
https://kawalpemilu.org#22662,"TAJIMALELA, KALIANDA, LAMPUNG SELATAN, LAMPUNG",8,73,143,216
https://kawalpemilu.org#22662,"TAJIMALELA, KALIANDA, LAMPUNG SELATAN, LAMPUNG",9,46,151,197
https://kawalpemilu.org#22662,"TAJIMALELA, KALIANDA, LAMPUNG SELATAN, LAMPUNG",10,63,144,207
https://kawalpemilu.org#22662,"TAJIMALELA, KALIANDA, LAMPUNG SELATAN, LAMPUNG",11,73,127,200
https://kawalpemilu.org#22662,"TAJIMALELA, KALIANDA, LAMPUNG SELATAN, LAMPUNG",12,90,76,166
https://kawalpemilu.org#22662,"TAJIMALELA, KALIANDA, LAMPUNG SELATAN, LAMPUNG",13,89,90,179
https://kawalpemilu.org#22662,"TAJIMALELA, KALIANDA, LAMPUNG SELATAN, LAMPUNG",14,77,83,160
https://kawalpemilu.org#22663,"CANGGU, KALIANDA, LAMPUNG SELATAN, LAMPUNG",1,68,130,198
https://kawalpemilu.org#22663,"CANGGU, KALIANDA, LAMPUNG SELATAN, LAMPUNG",2,76,134,210
https://kawalpemilu.org#22663,"CANGGU, KALIANDA, LAMPUNG SELATAN, LAMPUNG",3,59,140,199
https://kawalpemilu.org#22663,"CANGGU, KALIANDA, LAMPUNG SELATAN, LAMPUNG",4,65,140,205
https://kawalpemilu.org#22663,"CANGGU, KALIANDA, LAMPUNG SELATAN, LAMPUNG",5,60,135,195
https://kawalpemilu.org#22663,"CANGGU, KALIANDA, LAMPUNG SELATAN, LAMPUNG",6,156,92,248
https://kawalpemilu.org#22663,"CANGGU, KALIANDA, LAMPUNG SELATAN, LAMPUNG",7,126,59,185
https://kawalpemilu.org#22663,"CANGGU, KALIANDA, LAMPUNG SELATAN, LAMPUNG",8,99,67,166
https://kawalpemilu.org#22663,"CANGGU, KALIANDA, LAMPUNG SELATAN, LAMPUNG",9,86,44,130
https://kawalpemilu.org#22664,"KEDATON, KALIANDA, LAMPUNG SELATAN, LAMPUNG",1,92,159,251
https://kawalpemilu.org#22664,"KEDATON, KALIANDA, LAMPUNG SELATAN, LAMPUNG",2,103,161,264
https://kawalpemilu.org#22664,"KEDATON, KALIANDA, LAMPUNG SELATAN, LAMPUNG",3,133,64,197
https://kawalpemilu.org#22664,"KEDATON, KALIANDA, LAMPUNG SELATAN, LAMPUNG",4,89,125,214
https://kawalpemilu.org#22664,"KEDATON, KALIANDA, LAMPUNG SELATAN, LAMPUNG",5,125,136,261
https://kawalpemilu.org#22664,"KEDATON, KALIANDA, LAMPUNG SELATAN, LAMPUNG",6,90,115,205
https://kawalpemilu.org#22664,"KEDATON, KALIANDA, LAMPUNG SELATAN, LAMPUNG",7,76,120,196
https://kawalpemilu.org#22664,"KEDATON, KALIANDA, LAMPUNG SELATAN, LAMPUNG",8,108,109,217
https://kawalpemilu.org#22664,"KEDATON, KALIANDA, LAMPUNG SELATAN, LAMPUNG",9,58,102,160
https://kawalpemilu.org#22664,"KEDATON, KALIANDA, LAMPUNG SELATAN, LAMPUNG",10,81,91,172
https://kawalpemilu.org#22664,"KEDATON, KALIANDA, LAMPUNG SELATAN, LAMPUNG",11,104,129,233
https://kawalpemilu.org#22664,"KEDATON, KALIANDA, LAMPUNG SELATAN, LAMPUNG",12,80,136,216
https://kawalpemilu.org#22665,"MERAK BELANTUNG, KALIANDA, LAMPUNG SELATAN, LAMPUNG",1,78,106,184
https://kawalpemilu.org#22665,"MERAK BELANTUNG, KALIANDA, LAMPUNG SELATAN, LAMPUNG",2,102,80,182
https://kawalpemilu.org#22665,"MERAK BELANTUNG, KALIANDA, LAMPUNG SELATAN, LAMPUNG",3,123,105,228
https://kawalpemilu.org#22665,"MERAK BELANTUNG, KALIANDA, LAMPUNG SELATAN, LAMPUNG",4,96,120,216
https://kawalpemilu.org#22665,"MERAK BELANTUNG, KALIANDA, LAMPUNG SELATAN, LAMPUNG",5,70,140,210
https://kawalpemilu.org#22665,"MERAK BELANTUNG, KALIANDA, LAMPUNG SELATAN, LAMPUNG",6,63,134,197
https://kawalpemilu.org#22665,"MERAK BELANTUNG, KALIANDA, LAMPUNG SELATAN, LAMPUNG",7,116,80,196
https://kawalpemilu.org#22665,"MERAK BELANTUNG, KALIANDA, LAMPUNG SELATAN, LAMPUNG",8,60,114,174
https://kawalpemilu.org#22665,"MERAK BELANTUNG, KALIANDA, LAMPUNG SELATAN, LAMPUNG",9,94,103,197
https://kawalpemilu.org#22665,"MERAK BELANTUNG, KALIANDA, LAMPUNG SELATAN, LAMPUNG",10,102,42,144
https://kawalpemilu.org#22665,"MERAK BELANTUNG, KALIANDA, LAMPUNG SELATAN, LAMPUNG",11,89,104,193
https://kawalpemilu.org#22665,"MERAK BELANTUNG, KALIANDA, LAMPUNG SELATAN, LAMPUNG",12,78,115,193
https://kawalpemilu.org#22665,"MERAK BELANTUNG, KALIANDA, LAMPUNG SELATAN, LAMPUNG",13,73,130,203
https://kawalpemilu.org#22666,"BULOK, KALIANDA, LAMPUNG SELATAN, LAMPUNG",1,78,114,192
https://kawalpemilu.org#22666,"BULOK, KALIANDA, LAMPUNG SELATAN, LAMPUNG",2,80,107,187
https://kawalpemilu.org#22666,"BULOK, KALIANDA, LAMPUNG SELATAN, LAMPUNG",3,101,70,171
https://kawalpemilu.org#22666,"BULOK, KALIANDA, LAMPUNG SELATAN, LAMPUNG",4,62,106,168
https://kawalpemilu.org#22666,"BULOK, KALIANDA, LAMPUNG SELATAN, LAMPUNG",5,124,26,150
https://kawalpemilu.org#22666,"BULOK, KALIANDA, LAMPUNG SELATAN, LAMPUNG",6,95,87,182
https://kawalpemilu.org#22666,"BULOK, KALIANDA, LAMPUNG SELATAN, LAMPUNG",7,107,87,194
https://kawalpemilu.org#22667,"MUNJUK SEMPURNA, KALIANDA, LAMPUNG SELATAN, LAMPUNG",1,66,151,217
https://kawalpemilu.org#22667,"MUNJUK SEMPURNA, KALIANDA, LAMPUNG SELATAN, LAMPUNG",2,140,35,175
https://kawalpemilu.org#22667,"MUNJUK SEMPURNA, KALIANDA, LAMPUNG SELATAN, LAMPUNG",3,114,56,170
https://kawalpemilu.org#22667,"MUNJUK SEMPURNA, KALIANDA, LAMPUNG SELATAN, LAMPUNG",4,158,43,201
https://kawalpemilu.org#22667,"MUNJUK SEMPURNA, KALIANDA, LAMPUNG SELATAN, LAMPUNG",5,124,41,165
https://kawalpemilu.org#22667,"MUNJUK SEMPURNA, KALIANDA, LAMPUNG SELATAN, LAMPUNG",6,153,49,202
https://kawalpemilu.org#22667,"MUNJUK SEMPURNA, KALIANDA, LAMPUNG SELATAN, LAMPUNG",7,78,85,163
https://kawalpemilu.org#22668,"GUNUNG TERANG, KALIANDA, LAMPUNG SELATAN, LAMPUNG",1,38,133,171
https://kawalpemilu.org#22668,"GUNUNG TERANG, KALIANDA, LAMPUNG SELATAN, LAMPUNG",2,74,108,182
https://kawalpemilu.org#22668,"GUNUNG TERANG, KALIANDA, LAMPUNG SELATAN, LAMPUNG",3,83,102,185
https://kawalpemilu.org#22668,"GUNUNG TERANG, KALIANDA, LAMPUNG SELATAN, LAMPUNG",4,21,129,150
https://kawalpemilu.org#22668,"GUNUNG TERANG, KALIANDA, LAMPUNG SELATAN, LAMPUNG",5,49,124,173
https://kawalpemilu.org#22668,"GUNUNG TERANG, KALIANDA, LAMPUNG SELATAN, LAMPUNG",6,56,119,175
https://kawalpemilu.org#22668,"GUNUNG TERANG, KALIANDA, LAMPUNG SELATAN, LAMPUNG",7,51,139,190
https://kawalpemilu.org#22668,"GUNUNG TERANG, KALIANDA, LAMPUNG SELATAN, LAMPUNG",8,82,103,185
https://kawalpemilu.org#22669,"MARGA CATUR, KALIANDA, LAMPUNG SELATAN, LAMPUNG",1,156,27,183
https://kawalpemilu.org#22669,"MARGA CATUR, KALIANDA, LAMPUNG SELATAN, LAMPUNG",2,157,19,176
https://kawalpemilu.org#22669,"MARGA CATUR, KALIANDA, LAMPUNG SELATAN, LAMPUNG",3,172,16,188
https://kawalpemilu.org#22669,"MARGA CATUR, KALIANDA, LAMPUNG SELATAN, LAMPUNG",4,91,66,157
https://kawalpemilu.org#22669,"MARGA CATUR, KALIANDA, LAMPUNG SELATAN, LAMPUNG",5,141,24,165
https://kawalpemilu.org#22669,"MARGA CATUR, KALIANDA, LAMPUNG SELATAN, LAMPUNG",6,141,46,187
https://kawalpemilu.org#22670,"SUKATANI, KALIANDA, LAMPUNG SELATAN, LAMPUNG",1,158,35,193
https://kawalpemilu.org#22670,"SUKATANI, KALIANDA, LAMPUNG SELATAN, LAMPUNG",2,110,96,206
https://kawalpemilu.org#22670,"SUKATANI, KALIANDA, LAMPUNG SELATAN, LAMPUNG",3,137,73,210
https://kawalpemilu.org#22670,"SUKATANI, KALIANDA, LAMPUNG SELATAN, LAMPUNG",4,139,53,192
https://kawalpemilu.org#22670,"SUKATANI, KALIANDA, LAMPUNG SELATAN, LAMPUNG",5,149,32,181
https://kawalpemilu.org#22670,"SUKATANI, KALIANDA, LAMPUNG SELATAN, LAMPUNG",6,135,71,206
https://kawalpemilu.org#22670,"SUKATANI, KALIANDA, LAMPUNG SELATAN, LAMPUNG",7,89,82,171
https://kawalpemilu.org#22670,"SUKATANI, KALIANDA, LAMPUNG SELATAN, LAMPUNG",8,141,32,173
https://kawalpemilu.org#22670,"SUKATANI, KALIANDA, LAMPUNG SELATAN, LAMPUNG",9,122,21,143
https://kawalpemilu.org#22670,"SUKATANI, KALIANDA, LAMPUNG SELATAN, LAMPUNG",10,97,26,123
https://kawalpemilu.org#22671,"AGOM, KALIANDA, LAMPUNG SELATAN, LAMPUNG",1,87,118,205
https://kawalpemilu.org#22671,"AGOM, KALIANDA, LAMPUNG SELATAN, LAMPUNG",2,132,77,209
https://kawalpemilu.org#22671,"AGOM, KALIANDA, LAMPUNG SELATAN, LAMPUNG",3,123,62,185
https://kawalpemilu.org#22671,"AGOM, KALIANDA, LAMPUNG SELATAN, LAMPUNG",4,182,33,215
https://kawalpemilu.org#22671,"AGOM, KALIANDA, LAMPUNG SELATAN, LAMPUNG",5,115,71,186
https://kawalpemilu.org#22671,"AGOM, KALIANDA, LAMPUNG SELATAN, LAMPUNG",6,93,107,200
https://kawalpemilu.org#22671,"AGOM, KALIANDA, LAMPUNG SELATAN, LAMPUNG",7,131,88,219
https://kawalpemilu.org#22671,"AGOM, KALIANDA, LAMPUNG SELATAN, LAMPUNG",8,139,56,195
https://kawalpemilu.org#22671,"AGOM, KALIANDA, LAMPUNG SELATAN, LAMPUNG",9,141,42,183
https://kawalpemilu.org#22672,"NEGERI PANDAN, KALIANDA, LAMPUNG SELATAN, LAMPUNG",1,72,125,197
https://kawalpemilu.org#22672,"NEGERI PANDAN, KALIANDA, LAMPUNG SELATAN, LAMPUNG",2,81,131,212
https://kawalpemilu.org#22672,"NEGERI PANDAN, KALIANDA, LAMPUNG SELATAN, LAMPUNG",3,56,140,196
https://kawalpemilu.org#22672,"NEGERI PANDAN, KALIANDA, LAMPUNG SELATAN, LAMPUNG",4,48,143,191
https://kawalpemilu.org#22672,"NEGERI PANDAN, KALIANDA, LAMPUNG SELATAN, LAMPUNG",5,60,78,138
https://kawalpemilu.org#22672,"NEGERI PANDAN, KALIANDA, LAMPUNG SELATAN, LAMPUNG",6,92,65,157
https://kawalpemilu.org#22672,"NEGERI PANDAN, KALIANDA, LAMPUNG SELATAN, LAMPUNG",7,63,66,129
https://kawalpemilu.org#22672,"NEGERI PANDAN, KALIANDA, LAMPUNG SELATAN, LAMPUNG",8,126,25,151
https://kawalpemilu.org#22672,"NEGERI PANDAN, KALIANDA, LAMPUNG SELATAN, LAMPUNG",9,105,44,149
https://kawalpemilu.org#22672,"NEGERI PANDAN, KALIANDA, LAMPUNG SELATAN, LAMPUNG",10,33,44,77
https://kawalpemilu.org#22672,"NEGERI PANDAN, KALIANDA, LAMPUNG SELATAN, LAMPUNG",11,16,29,45
https://kawalpemilu.org#22673,"TAMAN AGUNG, KALIANDA, LAMPUNG SELATAN, LAMPUNG",1,124,36,160
https://kawalpemilu.org#22673,"TAMAN AGUNG, KALIANDA, LAMPUNG SELATAN, LAMPUNG",2,149,48,197
https://kawalpemilu.org#22673,"TAMAN AGUNG, KALIANDA, LAMPUNG SELATAN, LAMPUNG",3,129,50,179
https://kawalpemilu.org#22673,"TAMAN AGUNG, KALIANDA, LAMPUNG SELATAN, LAMPUNG",4,142,70,212
https://kawalpemilu.org#22673,"TAMAN AGUNG, KALIANDA, LAMPUNG SELATAN, LAMPUNG",5,131,44,175
https://kawalpemilu.org#22673,"TAMAN AGUNG, KALIANDA, LAMPUNG SELATAN, LAMPUNG",6,123,50,173
https://kawalpemilu.org#22673,"TAMAN AGUNG, KALIANDA, LAMPUNG SELATAN, LAMPUNG",7,114,47,161
https://kawalpemilu.org#22673,"TAMAN AGUNG, KALIANDA, LAMPUNG SELATAN, LAMPUNG",8,69,4,73
https://kawalpemilu.org#22673,"TAMAN AGUNG, KALIANDA, LAMPUNG SELATAN, LAMPUNG",9,143,47,190
https://kawalpemilu.org#22673,"TAMAN AGUNG, KALIANDA, LAMPUNG SELATAN, LAMPUNG",10,155,58,213
https://kawalpemilu.org#22673,"TAMAN AGUNG, KALIANDA, LAMPUNG SELATAN, LAMPUNG",11,126,41,167
https://kawalpemilu.org#22673,"TAMAN AGUNG, KALIANDA, LAMPUNG SELATAN, LAMPUNG",12,74,47,121
https://kawalpemilu.org#91295,"WAI LUBUK, KALIANDA, LAMPUNG SELATAN, LAMPUNG",1,100,159,259
https://kawalpemilu.org#91295,"WAI LUBUK, KALIANDA, LAMPUNG SELATAN, LAMPUNG",2,113,111,224
https://kawalpemilu.org#91295,"WAI LUBUK, KALIANDA, LAMPUNG SELATAN, LAMPUNG",3,90,101,191
https://kawalpemilu.org#91295,"WAI LUBUK, KALIANDA, LAMPUNG SELATAN, LAMPUNG",4,126,90,216
https://kawalpemilu.org#91295,"WAI LUBUK, KALIANDA, LAMPUNG SELATAN, LAMPUNG",5,165,61,226
https://kawalpemilu.org#91295,"WAI LUBUK, KALIANDA, LAMPUNG SELATAN, LAMPUNG",6,114,82,196
https://kawalpemilu.org#91295,"WAI LUBUK, KALIANDA, LAMPUNG SELATAN, LAMPUNG",7,84,101,185
https://kawalpemilu.org#91295,"WAI LUBUK, KALIANDA, LAMPUNG SELATAN, LAMPUNG",8,111,63,174
https://kawalpemilu.org#91295,"WAI LUBUK, KALIANDA, LAMPUNG SELATAN, LAMPUNG",9,81,129,210
https://kawalpemilu.org#91295,"WAI LUBUK, KALIANDA, LAMPUNG SELATAN, LAMPUNG",10,116,65,181
https://kawalpemilu.org#91295,"WAI LUBUK, KALIANDA, LAMPUNG SELATAN, LAMPUNG",11,139,64,203
https://kawalpemilu.org#91296,"HARA BANJAR MANIS, KALIANDA, LAMPUNG SELATAN, LAMPUNG",1,75,131,206
https://kawalpemilu.org#91296,"HARA BANJAR MANIS, KALIANDA, LAMPUNG SELATAN, LAMPUNG",2,80,126,206
https://kawalpemilu.org#91296,"HARA BANJAR MANIS, KALIANDA, LAMPUNG SELATAN, LAMPUNG",3,105,107,212
https://kawalpemilu.org#91296,"HARA BANJAR MANIS, KALIANDA, LAMPUNG SELATAN, LAMPUNG",4,87,147,234
https://kawalpemilu.org#91296,"HARA BANJAR MANIS, KALIANDA, LAMPUNG SELATAN, LAMPUNG",5,65,62,127
https://kawalpemilu.org#91296,"HARA BANJAR MANIS, KALIANDA, LAMPUNG SELATAN, LAMPUNG",6,80,45,125
https://kawalpemilu.org#22675,"BANDAR DALAM, SIDOMULYO, LAMPUNG SELATAN, LAMPUNG",1,116,112,228
https://kawalpemilu.org#22675,"BANDAR DALAM, SIDOMULYO, LAMPUNG SELATAN, LAMPUNG",2,127,87,214
https://kawalpemilu.org#22675,"BANDAR DALAM, SIDOMULYO, LAMPUNG SELATAN, LAMPUNG",3,111,42,153
https://kawalpemilu.org#22675,"BANDAR DALAM, SIDOMULYO, LAMPUNG SELATAN, LAMPUNG",4,209,48,257
https://kawalpemilu.org#22675,"BANDAR DALAM, SIDOMULYO, LAMPUNG SELATAN, LAMPUNG",5,121,30,151
https://kawalpemilu.org#22675,"BANDAR DALAM, SIDOMULYO, LAMPUNG SELATAN, LAMPUNG",6,135,64,199
https://kawalpemilu.org#22675,"BANDAR DALAM, SIDOMULYO, LAMPUNG SELATAN, LAMPUNG",7,89,31,120
https://kawalpemilu.org#22675,"BANDAR DALAM, SIDOMULYO, LAMPUNG SELATAN, LAMPUNG",8,126,117,243
https://kawalpemilu.org#22675,"BANDAR DALAM, SIDOMULYO, LAMPUNG SELATAN, LAMPUNG",9,160,36,196
https://kawalpemilu.org#22675,"BANDAR DALAM, SIDOMULYO, LAMPUNG SELATAN, LAMPUNG",10,168,32,200
https://kawalpemilu.org#22675,"BANDAR DALAM, SIDOMULYO, LAMPUNG SELATAN, LAMPUNG",11,97,82,179
https://kawalpemilu.org#22675,"BANDAR DALAM, SIDOMULYO, LAMPUNG SELATAN, LAMPUNG",12,183,72,255
https://kawalpemilu.org#22675,"BANDAR DALAM, SIDOMULYO, LAMPUNG SELATAN, LAMPUNG",13,150,24,174
https://kawalpemilu.org#22676,"CAMPANG TIGA, SIDOMULYO, LAMPUNG SELATAN, LAMPUNG",1,69,131,200
https://kawalpemilu.org#22676,"CAMPANG TIGA, SIDOMULYO, LAMPUNG SELATAN, LAMPUNG",2,152,48,200
https://kawalpemilu.org#22676,"CAMPANG TIGA, SIDOMULYO, LAMPUNG SELATAN, LAMPUNG",3,163,61,224
https://kawalpemilu.org#22676,"CAMPANG TIGA, SIDOMULYO, LAMPUNG SELATAN, LAMPUNG",4,143,47,190
https://kawalpemilu.org#22676,"CAMPANG TIGA, SIDOMULYO, LAMPUNG SELATAN, LAMPUNG",5,165,33,198
https://kawalpemilu.org#22676,"CAMPANG TIGA, SIDOMULYO, LAMPUNG SELATAN, LAMPUNG",6,162,24,186
https://kawalpemilu.org#22676,"CAMPANG TIGA, SIDOMULYO, LAMPUNG SELATAN, LAMPUNG",7,97,12,109
https://kawalpemilu.org#22676,"CAMPANG TIGA, SIDOMULYO, LAMPUNG SELATAN, LAMPUNG",8,108,88,196
https://kawalpemilu.org#22676,"CAMPANG TIGA, SIDOMULYO, LAMPUNG SELATAN, LAMPUNG",9,110,87,197
https://kawalpemilu.org#22676,"CAMPANG TIGA, SIDOMULYO, LAMPUNG SELATAN, LAMPUNG",10,169,25,194
https://kawalpemilu.org#22677,"TALANG BARU, SIDOMULYO, LAMPUNG SELATAN, LAMPUNG",1,85,117,202
https://kawalpemilu.org#22677,"TALANG BARU, SIDOMULYO, LAMPUNG SELATAN, LAMPUNG",2,23,94,117
https://kawalpemilu.org#22677,"TALANG BARU, SIDOMULYO, LAMPUNG SELATAN, LAMPUNG",3,86,56,142
https://kawalpemilu.org#22677,"TALANG BARU, SIDOMULYO, LAMPUNG SELATAN, LAMPUNG",4,125,26,151
https://kawalpemilu.org#22677,"TALANG BARU, SIDOMULYO, LAMPUNG SELATAN, LAMPUNG",5,110,94,204
https://kawalpemilu.org#22677,"TALANG BARU, SIDOMULYO, LAMPUNG SELATAN, LAMPUNG",6,22,75,97
https://kawalpemilu.org#22677,"TALANG BARU, SIDOMULYO, LAMPUNG SELATAN, LAMPUNG",7,55,31,86
https://kawalpemilu.org#22677,"TALANG BARU, SIDOMULYO, LAMPUNG SELATAN, LAMPUNG",8,34,41,75
https://kawalpemilu.org#22677,"TALANG BARU, SIDOMULYO, LAMPUNG SELATAN, LAMPUNG",9,105,38,143
https://kawalpemilu.org#22678,"SUKABANJAR, SIDOMULYO, LAMPUNG SELATAN, LAMPUNG",1,74,74,148
https://kawalpemilu.org#22678,"SUKABANJAR, SIDOMULYO, LAMPUNG SELATAN, LAMPUNG",2,71,66,137
https://kawalpemilu.org#22678,"SUKABANJAR, SIDOMULYO, LAMPUNG SELATAN, LAMPUNG",3,130,47,177
https://kawalpemilu.org#22678,"SUKABANJAR, SIDOMULYO, LAMPUNG SELATAN, LAMPUNG",4,109,116,225
https://kawalpemilu.org#22678,"SUKABANJAR, SIDOMULYO, LAMPUNG SELATAN, LAMPUNG",5,135,78,213
https://kawalpemilu.org#22678,"SUKABANJAR, SIDOMULYO, LAMPUNG SELATAN, LAMPUNG",6,135,45,180
https://kawalpemilu.org#22678,"SUKABANJAR, SIDOMULYO, LAMPUNG SELATAN, LAMPUNG",7,107,43,150
https://kawalpemilu.org#22678,"SUKABANJAR, SIDOMULYO, LAMPUNG SELATAN, LAMPUNG",8,151,53,204
https://kawalpemilu.org#22678,"SUKABANJAR, SIDOMULYO, LAMPUNG SELATAN, LAMPUNG",9,98,92,190
https://kawalpemilu.org#22678,"SUKABANJAR, SIDOMULYO, LAMPUNG SELATAN, LAMPUNG",10,136,58,194
https://kawalpemilu.org#22678,"SUKABANJAR, SIDOMULYO, LAMPUNG SELATAN, LAMPUNG",11,110,78,188
https://kawalpemilu.org#22678,"SUKABANJAR, SIDOMULYO, LAMPUNG SELATAN, LAMPUNG",12,150,48,198
https://kawalpemilu.org#22678,"SUKABANJAR, SIDOMULYO, LAMPUNG SELATAN, LAMPUNG",13,118,25,143
https://kawalpemilu.org#22678,"SUKABANJAR, SIDOMULYO, LAMPUNG SELATAN, LAMPUNG",14,134,38,172
https://kawalpemilu.org#22678,"SUKABANJAR, SIDOMULYO, LAMPUNG SELATAN, LAMPUNG",15,60,76,136
https://kawalpemilu.org#22679,"KOTA DALAM, SIDOMULYO, LAMPUNG SELATAN, LAMPUNG",1,61,166,227
https://kawalpemilu.org#22679,"KOTA DALAM, SIDOMULYO, LAMPUNG SELATAN, LAMPUNG",2,58,145,203
https://kawalpemilu.org#22679,"KOTA DALAM, SIDOMULYO, LAMPUNG SELATAN, LAMPUNG",3,64,155,219
https://kawalpemilu.org#22679,"KOTA DALAM, SIDOMULYO, LAMPUNG SELATAN, LAMPUNG",4,149,26,175
https://kawalpemilu.org#22679,"KOTA DALAM, SIDOMULYO, LAMPUNG SELATAN, LAMPUNG",5,110,135,245
https://kawalpemilu.org#22679,"KOTA DALAM, SIDOMULYO, LAMPUNG SELATAN, LAMPUNG",7,112,74,186
https://kawalpemilu.org#22679,"KOTA DALAM, SIDOMULYO, LAMPUNG SELATAN, LAMPUNG",8,80,22,102
https://kawalpemilu.org#22680,"BUDI DAYA, SIDOMULYO, LAMPUNG SELATAN, LAMPUNG",1,84,94,178
https://kawalpemilu.org#22680,"BUDI DAYA, SIDOMULYO, LAMPUNG SELATAN, LAMPUNG",2,115,40,155
https://kawalpemilu.org#22680,"BUDI DAYA, SIDOMULYO, LAMPUNG SELATAN, LAMPUNG",3,105,74,179
https://kawalpemilu.org#22680,"BUDI DAYA, SIDOMULYO, LAMPUNG SELATAN, LAMPUNG",4,165,14,179
https://kawalpemilu.org#22680,"BUDI DAYA, SIDOMULYO, LAMPUNG SELATAN, LAMPUNG",5,138,47,185
https://kawalpemilu.org#22680,"BUDI DAYA, SIDOMULYO, LAMPUNG SELATAN, LAMPUNG",6,159,13,172
https://kawalpemilu.org#22680,"BUDI DAYA, SIDOMULYO, LAMPUNG SELATAN, LAMPUNG",7,114,16,130
https://kawalpemilu.org#22681,"SIRING JAHA, SIDOMULYO, LAMPUNG SELATAN, LAMPUNG",1,75,114,189
https://kawalpemilu.org#22681,"SIRING JAHA, SIDOMULYO, LAMPUNG SELATAN, LAMPUNG",2,146,74,220
https://kawalpemilu.org#22681,"SIRING JAHA, SIDOMULYO, LAMPUNG SELATAN, LAMPUNG",3,144,67,211
https://kawalpemilu.org#22681,"SIRING JAHA, SIDOMULYO, LAMPUNG SELATAN, LAMPUNG",4,99,31,130
https://kawalpemilu.org#22681,"SIRING JAHA, SIDOMULYO, LAMPUNG SELATAN, LAMPUNG",5,98,80,178
https://kawalpemilu.org#22681,"SIRING JAHA, SIDOMULYO, LAMPUNG SELATAN, LAMPUNG",6,73,18,91
https://kawalpemilu.org#22682,"SUAK, SIDOMULYO, LAMPUNG SELATAN, LAMPUNG",1,77,125,202
https://kawalpemilu.org#22682,"SUAK, SIDOMULYO, LAMPUNG SELATAN, LAMPUNG",2,143,51,194
https://kawalpemilu.org#22682,"SUAK, SIDOMULYO, LAMPUNG SELATAN, LAMPUNG",3,104,119,223
https://kawalpemilu.org#22682,"SUAK, SIDOMULYO, LAMPUNG SELATAN, LAMPUNG",4,130,82,212
https://kawalpemilu.org#22682,"SUAK, SIDOMULYO, LAMPUNG SELATAN, LAMPUNG",5,122,44,166
https://kawalpemilu.org#22682,"SUAK, SIDOMULYO, LAMPUNG SELATAN, LAMPUNG",6,158,22,180
https://kawalpemilu.org#22682,"SUAK, SIDOMULYO, LAMPUNG SELATAN, LAMPUNG",7,79,78,157
https://kawalpemilu.org#22682,"SUAK, SIDOMULYO, LAMPUNG SELATAN, LAMPUNG",8,154,46,200
https://kawalpemilu.org#22682,"SUAK, SIDOMULYO, LAMPUNG SELATAN, LAMPUNG",9,59,103,162
https://kawalpemilu.org#22682,"SUAK, SIDOMULYO, LAMPUNG SELATAN, LAMPUNG",10,113,88,201
https://kawalpemilu.org#22682,"SUAK, SIDOMULYO, LAMPUNG SELATAN, LAMPUNG",11,64,89,153
https://kawalpemilu.org#22682,"SUAK, SIDOMULYO, LAMPUNG SELATAN, LAMPUNG",12,125,31,156
https://kawalpemilu.org#22682,"SUAK, SIDOMULYO, LAMPUNG SELATAN, LAMPUNG",13,86,53,139
https://kawalpemilu.org#22683,"SUKAMAJU, SIDOMULYO, LAMPUNG SELATAN, LAMPUNG",1,83,111,194
https://kawalpemilu.org#22683,"SUKAMAJU, SIDOMULYO, LAMPUNG SELATAN, LAMPUNG",2,118,77,195
https://kawalpemilu.org#22683,"SUKAMAJU, SIDOMULYO, LAMPUNG SELATAN, LAMPUNG",3,109,48,157
https://kawalpemilu.org#22683,"SUKAMAJU, SIDOMULYO, LAMPUNG SELATAN, LAMPUNG",4,152,44,196
https://kawalpemilu.org#22683,"SUKAMAJU, SIDOMULYO, LAMPUNG SELATAN, LAMPUNG",5,78,71,149
https://kawalpemilu.org#22684,"SUKAMARGA, SIDOMULYO, LAMPUNG SELATAN, LAMPUNG",1,57,142,199
https://kawalpemilu.org#22684,"SUKAMARGA, SIDOMULYO, LAMPUNG SELATAN, LAMPUNG",2,102,88,190
https://kawalpemilu.org#22684,"SUKAMARGA, SIDOMULYO, LAMPUNG SELATAN, LAMPUNG",3,94,50,144
https://kawalpemilu.org#22684,"SUKAMARGA, SIDOMULYO, LAMPUNG SELATAN, LAMPUNG",4,141,68,209
https://kawalpemilu.org#22684,"SUKAMARGA, SIDOMULYO, LAMPUNG SELATAN, LAMPUNG",5,57,121,178
https://kawalpemilu.org#22684,"SUKAMARGA, SIDOMULYO, LAMPUNG SELATAN, LAMPUNG",6,31,78,109
https://kawalpemilu.org#22685,"SELORETNO, SIDOMULYO, LAMPUNG SELATAN, LAMPUNG",1,114,82,196
https://kawalpemilu.org#22685,"SELORETNO, SIDOMULYO, LAMPUNG SELATAN, LAMPUNG",2,75,37,112
https://kawalpemilu.org#22685,"SELORETNO, SIDOMULYO, LAMPUNG SELATAN, LAMPUNG",3,133,51,184
https://kawalpemilu.org#22685,"SELORETNO, SIDOMULYO, LAMPUNG SELATAN, LAMPUNG",4,107,78,185
https://kawalpemilu.org#22685,"SELORETNO, SIDOMULYO, LAMPUNG SELATAN, LAMPUNG",5,63,155,218
https://kawalpemilu.org#22685,"SELORETNO, SIDOMULYO, LAMPUNG SELATAN, LAMPUNG",6,119,81,200
https://kawalpemilu.org#22685,"SELORETNO, SIDOMULYO, LAMPUNG SELATAN, LAMPUNG",7,91,52,143
https://kawalpemilu.org#22685,"SELORETNO, SIDOMULYO, LAMPUNG SELATAN, LAMPUNG",8,132,58,190
https://kawalpemilu.org#22685,"SELORETNO, SIDOMULYO, LAMPUNG SELATAN, LAMPUNG",9,128,65,193
https://kawalpemilu.org#22685,"SELORETNO, SIDOMULYO, LAMPUNG SELATAN, LAMPUNG",10,67,158,225
https://kawalpemilu.org#22685,"SELORETNO, SIDOMULYO, LAMPUNG SELATAN, LAMPUNG",11,69,123,192
https://kawalpemilu.org#22685,"SELORETNO, SIDOMULYO, LAMPUNG SELATAN, LAMPUNG",12,78,52,130
https://kawalpemilu.org#22686,"SIDODADI, SIDOMULYO, LAMPUNG SELATAN, LAMPUNG",1,176,26,202
https://kawalpemilu.org#22686,"SIDODADI, SIDOMULYO, LAMPUNG SELATAN, LAMPUNG",2,184,31,215
https://kawalpemilu.org#22686,"SIDODADI, SIDOMULYO, LAMPUNG SELATAN, LAMPUNG",3,155,54,209
https://kawalpemilu.org#22686,"SIDODADI, SIDOMULYO, LAMPUNG SELATAN, LAMPUNG",4,88,79,167
https://kawalpemilu.org#22686,"SIDODADI, SIDOMULYO, LAMPUNG SELATAN, LAMPUNG",5,182,59,241
https://kawalpemilu.org#22686,"SIDODADI, SIDOMULYO, LAMPUNG SELATAN, LAMPUNG",6,87,106,193
https://kawalpemilu.org#22686,"SIDODADI, SIDOMULYO, LAMPUNG SELATAN, LAMPUNG",7,82,96,178
https://kawalpemilu.org#22686,"SIDODADI, SIDOMULYO, LAMPUNG SELATAN, LAMPUNG",8,117,109,226
https://kawalpemilu.org#22686,"SIDODADI, SIDOMULYO, LAMPUNG SELATAN, LAMPUNG",9,111,51,162
https://kawalpemilu.org#22686,"SIDODADI, SIDOMULYO, LAMPUNG SELATAN, LAMPUNG",10,74,88,162
https://kawalpemilu.org#22686,"SIDODADI, SIDOMULYO, LAMPUNG SELATAN, LAMPUNG",11,82,51,133
https://kawalpemilu.org#22686,"SIDODADI, SIDOMULYO, LAMPUNG SELATAN, LAMPUNG",12,94,126,220
https://kawalpemilu.org#22686,"SIDODADI, SIDOMULYO, LAMPUNG SELATAN, LAMPUNG",13,226,13,239
https://kawalpemilu.org#22686,"SIDODADI, SIDOMULYO, LAMPUNG SELATAN, LAMPUNG",15,146,53,199
https://kawalpemilu.org#22686,"SIDODADI, SIDOMULYO, LAMPUNG SELATAN, LAMPUNG",16,159,73,232
https://kawalpemilu.org#22686,"SIDODADI, SIDOMULYO, LAMPUNG SELATAN, LAMPUNG",17,65,74,139
https://kawalpemilu.org#22686,"SIDODADI, SIDOMULYO, LAMPUNG SELATAN, LAMPUNG",18,29,101,130
https://kawalpemilu.org#22686,"SIDODADI, SIDOMULYO, LAMPUNG SELATAN, LAMPUNG",19,102,46,148
https://kawalpemilu.org#22686,"SIDODADI, SIDOMULYO, LAMPUNG SELATAN, LAMPUNG",20,106,78,184
https://kawalpemilu.org#22686,"SIDODADI, SIDOMULYO, LAMPUNG SELATAN, LAMPUNG",22,93,68,161
https://kawalpemilu.org#22686,"SIDODADI, SIDOMULYO, LAMPUNG SELATAN, LAMPUNG",23,92,101,193
https://kawalpemilu.org#22687,"SIDOREJO, SIDOMULYO, LAMPUNG SELATAN, LAMPUNG",1,186,19,205
https://kawalpemilu.org#22687,"SIDOREJO, SIDOMULYO, LAMPUNG SELATAN, LAMPUNG",2,129,46,175
https://kawalpemilu.org#22687,"SIDOREJO, SIDOMULYO, LAMPUNG SELATAN, LAMPUNG",3,82,103,185
https://kawalpemilu.org#22687,"SIDOREJO, SIDOMULYO, LAMPUNG SELATAN, LAMPUNG",4,122,82,204
https://kawalpemilu.org#22687,"SIDOREJO, SIDOMULYO, LAMPUNG SELATAN, LAMPUNG",5,96,82,178
https://kawalpemilu.org#22687,"SIDOREJO, SIDOMULYO, LAMPUNG SELATAN, LAMPUNG",6,104,82,186
https://kawalpemilu.org#22687,"SIDOREJO, SIDOMULYO, LAMPUNG SELATAN, LAMPUNG",7,145,56,201
https://kawalpemilu.org#22687,"SIDOREJO, SIDOMULYO, LAMPUNG SELATAN, LAMPUNG",8,117,67,184
https://kawalpemilu.org#22687,"SIDOREJO, SIDOMULYO, LAMPUNG SELATAN, LAMPUNG",9,133,40,173
https://kawalpemilu.org#22687,"SIDOREJO, SIDOMULYO, LAMPUNG SELATAN, LAMPUNG",10,129,57,186
https://kawalpemilu.org#22687,"SIDOREJO, SIDOMULYO, LAMPUNG SELATAN, LAMPUNG",11,147,48,195
https://kawalpemilu.org#22687,"SIDOREJO, SIDOMULYO, LAMPUNG SELATAN, LAMPUNG",12,172,23,195
https://kawalpemilu.org#22687,"SIDOREJO, SIDOMULYO, LAMPUNG SELATAN, LAMPUNG",13,166,36,202
https://kawalpemilu.org#22687,"SIDOREJO, SIDOMULYO, LAMPUNG SELATAN, LAMPUNG",14,142,55,197
https://kawalpemilu.org#22687,"SIDOREJO, SIDOMULYO, LAMPUNG SELATAN, LAMPUNG",15,100,68,168
https://kawalpemilu.org#22687,"SIDOREJO, SIDOMULYO, LAMPUNG SELATAN, LAMPUNG",16,97,89,186
https://kawalpemilu.org#22687,"SIDOREJO, SIDOMULYO, LAMPUNG SELATAN, LAMPUNG",17,0,0,0
https://kawalpemilu.org#22687,"SIDOREJO, SIDOMULYO, LAMPUNG SELATAN, LAMPUNG",18,82,95,177
https://kawalpemilu.org#22687,"SIDOREJO, SIDOMULYO, LAMPUNG SELATAN, LAMPUNG",19,140,42,182
https://kawalpemilu.org#22687,"SIDOREJO, SIDOMULYO, LAMPUNG SELATAN, LAMPUNG",20,120,60,180
https://kawalpemilu.org#22687,"SIDOREJO, SIDOMULYO, LAMPUNG SELATAN, LAMPUNG",21,187,21,208
https://kawalpemilu.org#22687,"SIDOREJO, SIDOMULYO, LAMPUNG SELATAN, LAMPUNG",23,113,44,157
https://kawalpemilu.org#22688,"SIDOMULYO, SIDOMULYO, LAMPUNG SELATAN, LAMPUNG",1,92,114,206
https://kawalpemilu.org#22688,"SIDOMULYO, SIDOMULYO, LAMPUNG SELATAN, LAMPUNG",2,137,58,195
https://kawalpemilu.org#22688,"SIDOMULYO, SIDOMULYO, LAMPUNG SELATAN, LAMPUNG",3,168,43,211
https://kawalpemilu.org#22688,"SIDOMULYO, SIDOMULYO, LAMPUNG SELATAN, LAMPUNG",4,166,39,205
https://kawalpemilu.org#22688,"SIDOMULYO, SIDOMULYO, LAMPUNG SELATAN, LAMPUNG",5,173,34,207
https://kawalpemilu.org#22688,"SIDOMULYO, SIDOMULYO, LAMPUNG SELATAN, LAMPUNG",6,137,28,165
https://kawalpemilu.org#22688,"SIDOMULYO, SIDOMULYO, LAMPUNG SELATAN, LAMPUNG",7,100,21,121
https://kawalpemilu.org#22688,"SIDOMULYO, SIDOMULYO, LAMPUNG SELATAN, LAMPUNG",8,139,68,207
https://kawalpemilu.org#22688,"SIDOMULYO, SIDOMULYO, LAMPUNG SELATAN, LAMPUNG",9,65,120,185
https://kawalpemilu.org#22688,"SIDOMULYO, SIDOMULYO, LAMPUNG SELATAN, LAMPUNG",10,120,48,168
https://kawalpemilu.org#22688,"SIDOMULYO, SIDOMULYO, LAMPUNG SELATAN, LAMPUNG",11,92,73,165
https://kawalpemilu.org#22688,"SIDOMULYO, SIDOMULYO, LAMPUNG SELATAN, LAMPUNG",12,147,50,197
https://kawalpemilu.org#22688,"SIDOMULYO, SIDOMULYO, LAMPUNG SELATAN, LAMPUNG",13,125,17,142
https://kawalpemilu.org#22688,"SIDOMULYO, SIDOMULYO, LAMPUNG SELATAN, LAMPUNG",14,139,26,165
https://kawalpemilu.org#22688,"SIDOMULYO, SIDOMULYO, LAMPUNG SELATAN, LAMPUNG",15,216,9,225
https://kawalpemilu.org#22688,"SIDOMULYO, SIDOMULYO, LAMPUNG SELATAN, LAMPUNG",16,157,42,199
https://kawalpemilu.org#22688,"SIDOMULYO, SIDOMULYO, LAMPUNG SELATAN, LAMPUNG",17,145,28,173
https://kawalpemilu.org#22688,"SIDOMULYO, SIDOMULYO, LAMPUNG SELATAN, LAMPUNG",18,223,46,269
https://kawalpemilu.org#22688,"SIDOMULYO, SIDOMULYO, LAMPUNG SELATAN, LAMPUNG",19,195,49,244
https://kawalpemilu.org#22689,"SIDOWALUYO, SIDOMULYO, LAMPUNG SELATAN, LAMPUNG",1,175,7,182
https://kawalpemilu.org#22689,"SIDOWALUYO, SIDOMULYO, LAMPUNG SELATAN, LAMPUNG",2,151,35,186
https://kawalpemilu.org#22689,"SIDOWALUYO, SIDOMULYO, LAMPUNG SELATAN, LAMPUNG",3,146,23,169
https://kawalpemilu.org#22689,"SIDOWALUYO, SIDOMULYO, LAMPUNG SELATAN, LAMPUNG",4,118,54,172
https://kawalpemilu.org#22689,"SIDOWALUYO, SIDOMULYO, LAMPUNG SELATAN, LAMPUNG",5,165,31,196
https://kawalpemilu.org#22689,"SIDOWALUYO, SIDOMULYO, LAMPUNG SELATAN, LAMPUNG",6,131,34,165
https://kawalpemilu.org#22689,"SIDOWALUYO, SIDOMULYO, LAMPUNG SELATAN, LAMPUNG",7,139,40,179
https://kawalpemilu.org#22689,"SIDOWALUYO, SIDOMULYO, LAMPUNG SELATAN, LAMPUNG",8,132,81,213
https://kawalpemilu.org#22689,"SIDOWALUYO, SIDOMULYO, LAMPUNG SELATAN, LAMPUNG",9,140,6,146
https://kawalpemilu.org#22689,"SIDOWALUYO, SIDOMULYO, LAMPUNG SELATAN, LAMPUNG",10,138,15,153
https://kawalpemilu.org#22689,"SIDOWALUYO, SIDOMULYO, LAMPUNG SELATAN, LAMPUNG",11,151,22,173
https://kawalpemilu.org#22689,"SIDOWALUYO, SIDOMULYO, LAMPUNG SELATAN, LAMPUNG",12,185,31,216
https://kawalpemilu.org#22689,"SIDOWALUYO, SIDOMULYO, LAMPUNG SELATAN, LAMPUNG",13,130,11,141
https://kawalpemilu.org#22689,"SIDOWALUYO, SIDOMULYO, LAMPUNG SELATAN, LAMPUNG",14,162,28,190
https://kawalpemilu.org#22689,"SIDOWALUYO, SIDOMULYO, LAMPUNG SELATAN, LAMPUNG",15,138,16,154
https://kawalpemilu.org#22689,"SIDOWALUYO, SIDOMULYO, LAMPUNG SELATAN, LAMPUNG",16,136,33,169
https://kawalpemilu.org#22689,"SIDOWALUYO, SIDOMULYO, LAMPUNG SELATAN, LAMPUNG",17,115,28,143
https://kawalpemilu.org#22689,"SIDOWALUYO, SIDOMULYO, LAMPUNG SELATAN, LAMPUNG",18,130,38,168
https://kawalpemilu.org#22689,"SIDOWALUYO, SIDOMULYO, LAMPUNG SELATAN, LAMPUNG",19,150,37,187
https://kawalpemilu.org#22689,"SIDOWALUYO, SIDOMULYO, LAMPUNG SELATAN, LAMPUNG",21,114,2,116
https://kawalpemilu.org#22689,"SIDOWALUYO, SIDOMULYO, LAMPUNG SELATAN, LAMPUNG",22,130,24,154
https://kawalpemilu.org#22689,"SIDOWALUYO, SIDOMULYO, LAMPUNG SELATAN, LAMPUNG",23,110,18,128
https://kawalpemilu.org#22689,"SIDOWALUYO, SIDOMULYO, LAMPUNG SELATAN, LAMPUNG",24,91,17,108
https://kawalpemilu.org#927462,"BANJAR SURI, SIDOMULYO, LAMPUNG SELATAN, LAMPUNG",1,150,31,181
https://kawalpemilu.org#927462,"BANJAR SURI, SIDOMULYO, LAMPUNG SELATAN, LAMPUNG",2,195,20,215
https://kawalpemilu.org#927462,"BANJAR SURI, SIDOMULYO, LAMPUNG SELATAN, LAMPUNG",3,187,16,203
https://kawalpemilu.org#927462,"BANJAR SURI, SIDOMULYO, LAMPUNG SELATAN, LAMPUNG",4,139,35,174
https://kawalpemilu.org#927462,"BANJAR SURI, SIDOMULYO, LAMPUNG SELATAN, LAMPUNG",5,157,30,187
https://kawalpemilu.org#927462,"BANJAR SURI, SIDOMULYO, LAMPUNG SELATAN, LAMPUNG",6,145,22,167
https://kawalpemilu.org#927462,"BANJAR SURI, SIDOMULYO, LAMPUNG SELATAN, LAMPUNG",7,142,36,178
https://kawalpemilu.org#22691,"TARAHAN, KATIBUNG, LAMPUNG SELATAN, LAMPUNG",1,153,67,220
https://kawalpemilu.org#22691,"TARAHAN, KATIBUNG, LAMPUNG SELATAN, LAMPUNG",2,60,143,203
https://kawalpemilu.org#22691,"TARAHAN, KATIBUNG, LAMPUNG SELATAN, LAMPUNG",3,63,106,169
https://kawalpemilu.org#22691,"TARAHAN, KATIBUNG, LAMPUNG SELATAN, LAMPUNG",4,128,99,227
https://kawalpemilu.org#22691,"TARAHAN, KATIBUNG, LAMPUNG SELATAN, LAMPUNG",5,119,122,241
https://kawalpemilu.org#22691,"TARAHAN, KATIBUNG, LAMPUNG SELATAN, LAMPUNG",6,102,140,242
https://kawalpemilu.org#22691,"TARAHAN, KATIBUNG, LAMPUNG SELATAN, LAMPUNG",7,118,86,204
https://kawalpemilu.org#22691,"TARAHAN, KATIBUNG, LAMPUNG SELATAN, LAMPUNG",8,140,94,234
https://kawalpemilu.org#22691,"TARAHAN, KATIBUNG, LAMPUNG SELATAN, LAMPUNG",9,158,93,251
https://kawalpemilu.org#22691,"TARAHAN, KATIBUNG, LAMPUNG SELATAN, LAMPUNG",10,126,70,196
https://kawalpemilu.org#22691,"TARAHAN, KATIBUNG, LAMPUNG SELATAN, LAMPUNG",11,161,29,190
https://kawalpemilu.org#22691,"TARAHAN, KATIBUNG, LAMPUNG SELATAN, LAMPUNG",12,113,101,214
https://kawalpemilu.org#22691,"TARAHAN, KATIBUNG, LAMPUNG SELATAN, LAMPUNG",13,124,89,213
https://kawalpemilu.org#22691,"TARAHAN, KATIBUNG, LAMPUNG SELATAN, LAMPUNG",14,123,109,232
https://kawalpemilu.org#22691,"TARAHAN, KATIBUNG, LAMPUNG SELATAN, LAMPUNG",15,91,89,180
https://kawalpemilu.org#22691,"TARAHAN, KATIBUNG, LAMPUNG SELATAN, LAMPUNG",16,107,68,178
https://kawalpemilu.org#22691,"TARAHAN, KATIBUNG, LAMPUNG SELATAN, LAMPUNG",17,80,66,146
https://kawalpemilu.org#22691,"TARAHAN, KATIBUNG, LAMPUNG SELATAN, LAMPUNG",18,170,65,235
https://kawalpemilu.org#22691,"TARAHAN, KATIBUNG, LAMPUNG SELATAN, LAMPUNG",19,187,42,229
https://kawalpemilu.org#22692,"BABATAN, KATIBUNG, LAMPUNG SELATAN, LAMPUNG",1,53,148,201
https://kawalpemilu.org#22692,"BABATAN, KATIBUNG, LAMPUNG SELATAN, LAMPUNG",2,116,71,187
https://kawalpemilu.org#22692,"BABATAN, KATIBUNG, LAMPUNG SELATAN, LAMPUNG",3,99,145,244
https://kawalpemilu.org#22692,"BABATAN, KATIBUNG, LAMPUNG SELATAN, LAMPUNG",4,102,96,198
https://kawalpemilu.org#22692,"BABATAN, KATIBUNG, LAMPUNG SELATAN, LAMPUNG",5,141,97,238
https://kawalpemilu.org#22692,"BABATAN, KATIBUNG, LAMPUNG SELATAN, LAMPUNG",6,62,80,142
https://kawalpemilu.org#22692,"BABATAN, KATIBUNG, LAMPUNG SELATAN, LAMPUNG",7,103,102,205
https://kawalpemilu.org#22692,"BABATAN, KATIBUNG, LAMPUNG SELATAN, LAMPUNG",8,92,58,150
https://kawalpemilu.org#22692,"BABATAN, KATIBUNG, LAMPUNG SELATAN, LAMPUNG",9,76,73,149
https://kawalpemilu.org#22692,"BABATAN, KATIBUNG, LAMPUNG SELATAN, LAMPUNG",10,167,82,249
https://kawalpemilu.org#22692,"BABATAN, KATIBUNG, LAMPUNG SELATAN, LAMPUNG",11,67,49,116
https://kawalpemilu.org#22692,"BABATAN, KATIBUNG, LAMPUNG SELATAN, LAMPUNG",12,131,82,213
https://kawalpemilu.org#22692,"BABATAN, KATIBUNG, LAMPUNG SELATAN, LAMPUNG",13,94,118,212
https://kawalpemilu.org#22692,"BABATAN, KATIBUNG, LAMPUNG SELATAN, LAMPUNG",14,106,25,131
https://kawalpemilu.org#22692,"BABATAN, KATIBUNG, LAMPUNG SELATAN, LAMPUNG",15,112,31,143
https://kawalpemilu.org#22692,"BABATAN, KATIBUNG, LAMPUNG SELATAN, LAMPUNG",16,183,48,231
https://kawalpemilu.org#22693,"PARDASUKA, KATIBUNG, LAMPUNG SELATAN, LAMPUNG",1,87,114,201
https://kawalpemilu.org#22693,"PARDASUKA, KATIBUNG, LAMPUNG SELATAN, LAMPUNG",2,108,128,236
https://kawalpemilu.org#22693,"PARDASUKA, KATIBUNG, LAMPUNG SELATAN, LAMPUNG",3,83,81,164
https://kawalpemilu.org#22693,"PARDASUKA, KATIBUNG, LAMPUNG SELATAN, LAMPUNG",4,144,57,201
https://kawalpemilu.org#22693,"PARDASUKA, KATIBUNG, LAMPUNG SELATAN, LAMPUNG",5,130,54,184
https://kawalpemilu.org#22693,"PARDASUKA, KATIBUNG, LAMPUNG SELATAN, LAMPUNG",6,134,113,247
https://kawalpemilu.org#22693,"PARDASUKA, KATIBUNG, LAMPUNG SELATAN, LAMPUNG",7,91,119,210
https://kawalpemilu.org#22693,"PARDASUKA, KATIBUNG, LAMPUNG SELATAN, LAMPUNG",8,105,81,186
https://kawalpemilu.org#22693,"PARDASUKA, KATIBUNG, LAMPUNG SELATAN, LAMPUNG",9,105,58,163
https://kawalpemilu.org#22693,"PARDASUKA, KATIBUNG, LAMPUNG SELATAN, LAMPUNG",10,92,127,219
https://kawalpemilu.org#22693,"PARDASUKA, KATIBUNG, LAMPUNG SELATAN, LAMPUNG",11,97,117,214
https://kawalpemilu.org#22693,"PARDASUKA, KATIBUNG, LAMPUNG SELATAN, LAMPUNG",12,104,66,170
https://kawalpemilu.org#22693,"PARDASUKA, KATIBUNG, LAMPUNG SELATAN, LAMPUNG",13,111,75,186
https://kawalpemilu.org#22693,"PARDASUKA, KATIBUNG, LAMPUNG SELATAN, LAMPUNG",14,138,58,196
https://kawalpemilu.org#22693,"PARDASUKA, KATIBUNG, LAMPUNG SELATAN, LAMPUNG",15,107,52,159
https://kawalpemilu.org#22693,"PARDASUKA, KATIBUNG, LAMPUNG SELATAN, LAMPUNG",16,115,68,183
https://kawalpemilu.org#22693,"PARDASUKA, KATIBUNG, LAMPUNG SELATAN, LAMPUNG",17,149,33,182
https://kawalpemilu.org#22693,"PARDASUKA, KATIBUNG, LAMPUNG SELATAN, LAMPUNG",18,160,31,191
https://kawalpemilu.org#22693,"PARDASUKA, KATIBUNG, LAMPUNG SELATAN, LAMPUNG",19,150,72,222
https://kawalpemilu.org#22693,"PARDASUKA, KATIBUNG, LAMPUNG SELATAN, LAMPUNG",20,118,55,173
https://kawalpemilu.org#22693,"PARDASUKA, KATIBUNG, LAMPUNG SELATAN, LAMPUNG",21,137,57,194
https://kawalpemilu.org#22693,"PARDASUKA, KATIBUNG, LAMPUNG SELATAN, LAMPUNG",22,129,51,180
https://kawalpemilu.org#22693,"PARDASUKA, KATIBUNG, LAMPUNG SELATAN, LAMPUNG",23,122,52,174
https://kawalpemilu.org#22693,"PARDASUKA, KATIBUNG, LAMPUNG SELATAN, LAMPUNG",24,117,25,142
https://kawalpemilu.org#22693,"PARDASUKA, KATIBUNG, LAMPUNG SELATAN, LAMPUNG",25,110,49,159
https://kawalpemilu.org#22693,"PARDASUKA, KATIBUNG, LAMPUNG SELATAN, LAMPUNG",26,166,57,223
https://kawalpemilu.org#22693,"PARDASUKA, KATIBUNG, LAMPUNG SELATAN, LAMPUNG",27,134,51,185
https://kawalpemilu.org#22693,"PARDASUKA, KATIBUNG, LAMPUNG SELATAN, LAMPUNG",29,153,47,200
https://kawalpemilu.org#22694,"SUKAJAYA, KATIBUNG, LAMPUNG SELATAN, LAMPUNG",1,113,135,248
https://kawalpemilu.org#22694,"SUKAJAYA, KATIBUNG, LAMPUNG SELATAN, LAMPUNG",2,54,101,155
https://kawalpemilu.org#22694,"SUKAJAYA, KATIBUNG, LAMPUNG SELATAN, LAMPUNG",3,105,128,233
https://kawalpemilu.org#22694,"SUKAJAYA, KATIBUNG, LAMPUNG SELATAN, LAMPUNG",4,86,73,159
https://kawalpemilu.org#22694,"SUKAJAYA, KATIBUNG, LAMPUNG SELATAN, LAMPUNG",5,57,161,218
https://kawalpemilu.org#22694,"SUKAJAYA, KATIBUNG, LAMPUNG SELATAN, LAMPUNG",6,101,121,222
https://kawalpemilu.org#22694,"SUKAJAYA, KATIBUNG, LAMPUNG SELATAN, LAMPUNG",7,79,63,142
https://kawalpemilu.org#22695,"TANJUNG RATU, KATIBUNG, LAMPUNG SELATAN, LAMPUNG",1,128,79,207
https://kawalpemilu.org#22695,"TANJUNG RATU, KATIBUNG, LAMPUNG SELATAN, LAMPUNG",2,107,89,196
https://kawalpemilu.org#22695,"TANJUNG RATU, KATIBUNG, LAMPUNG SELATAN, LAMPUNG",3,113,117,230
https://kawalpemilu.org#22695,"TANJUNG RATU, KATIBUNG, LAMPUNG SELATAN, LAMPUNG",4,112,89,201
https://kawalpemilu.org#22695,"TANJUNG RATU, KATIBUNG, LAMPUNG SELATAN, LAMPUNG",5,128,72,200
https://kawalpemilu.org#22695,"TANJUNG RATU, KATIBUNG, LAMPUNG SELATAN, LAMPUNG",6,141,49,190
https://kawalpemilu.org#22695,"TANJUNG RATU, KATIBUNG, LAMPUNG SELATAN, LAMPUNG",7,96,43,139
https://kawalpemilu.org#22695,"TANJUNG RATU, KATIBUNG, LAMPUNG SELATAN, LAMPUNG",8,162,48,210
https://kawalpemilu.org#22695,"TANJUNG RATU, KATIBUNG, LAMPUNG SELATAN, LAMPUNG",9,167,48,215
https://kawalpemilu.org#22695,"TANJUNG RATU, KATIBUNG, LAMPUNG SELATAN, LAMPUNG",10,157,41,198
https://kawalpemilu.org#22695,"TANJUNG RATU, KATIBUNG, LAMPUNG SELATAN, LAMPUNG",11,146,50,196
https://kawalpemilu.org#22695,"TANJUNG RATU, KATIBUNG, LAMPUNG SELATAN, LAMPUNG",12,142,68,210
https://kawalpemilu.org#22695,"TANJUNG RATU, KATIBUNG, LAMPUNG SELATAN, LAMPUNG",13,91,141,232
https://kawalpemilu.org#22695,"TANJUNG RATU, KATIBUNG, LAMPUNG SELATAN, LAMPUNG",14,87,114,201
https://kawalpemilu.org#22695,"TANJUNG RATU, KATIBUNG, LAMPUNG SELATAN, LAMPUNG",15,120,37,157
https://kawalpemilu.org#22695,"TANJUNG RATU, KATIBUNG, LAMPUNG SELATAN, LAMPUNG",16,116,28,144
https://kawalpemilu.org#22695,"TANJUNG RATU, KATIBUNG, LAMPUNG SELATAN, LAMPUNG",17,119,47,166
https://kawalpemilu.org#22695,"TANJUNG RATU, KATIBUNG, LAMPUNG SELATAN, LAMPUNG",18,107,101,208
https://kawalpemilu.org#22695,"TANJUNG RATU, KATIBUNG, LAMPUNG SELATAN, LAMPUNG",19,187,12,199
https://kawalpemilu.org#22695,"TANJUNG RATU, KATIBUNG, LAMPUNG SELATAN, LAMPUNG",20,167,22,189
https://kawalpemilu.org#22695,"TANJUNG RATU, KATIBUNG, LAMPUNG SELATAN, LAMPUNG",21,156,29,185
https://kawalpemilu.org#22695,"TANJUNG RATU, KATIBUNG, LAMPUNG SELATAN, LAMPUNG",22,155,43,198
https://kawalpemilu.org#22695,"TANJUNG RATU, KATIBUNG, LAMPUNG SELATAN, LAMPUNG",23,123,25,148
https://kawalpemilu.org#22695,"TANJUNG RATU, KATIBUNG, LAMPUNG SELATAN, LAMPUNG",24,108,11,119
https://kawalpemilu.org#22696,"TANJUNG AGUNG, KATIBUNG, LAMPUNG SELATAN, LAMPUNG",1,67,179,246
https://kawalpemilu.org#22696,"TANJUNG AGUNG, KATIBUNG, LAMPUNG SELATAN, LAMPUNG",2,66,136,202
https://kawalpemilu.org#22696,"TANJUNG AGUNG, KATIBUNG, LAMPUNG SELATAN, LAMPUNG",3,82,127,209
https://kawalpemilu.org#22696,"TANJUNG AGUNG, KATIBUNG, LAMPUNG SELATAN, LAMPUNG",5,113,130,243
https://kawalpemilu.org#22696,"TANJUNG AGUNG, KATIBUNG, LAMPUNG SELATAN, LAMPUNG",6,163,67,230
https://kawalpemilu.org#22696,"TANJUNG AGUNG, KATIBUNG, LAMPUNG SELATAN, LAMPUNG",7,145,58,203
https://kawalpemilu.org#22696,"TANJUNG AGUNG, KATIBUNG, LAMPUNG SELATAN, LAMPUNG",8,218,33,251
https://kawalpemilu.org#22696,"TANJUNG AGUNG, KATIBUNG, LAMPUNG SELATAN, LAMPUNG",9,113,51,164
https://kawalpemilu.org#22696,"TANJUNG AGUNG, KATIBUNG, LAMPUNG SELATAN, LAMPUNG",10,48,106,154
https://kawalpemilu.org#22696,"TANJUNG AGUNG, KATIBUNG, LAMPUNG SELATAN, LAMPUNG",11,118,73,191
https://kawalpemilu.org#22696,"TANJUNG AGUNG, KATIBUNG, LAMPUNG SELATAN, LAMPUNG",12,138,51,189
https://kawalpemilu.org#22696,"TANJUNG AGUNG, KATIBUNG, LAMPUNG SELATAN, LAMPUNG",13,149,42,191
https://kawalpemilu.org#22696,"TANJUNG AGUNG, KATIBUNG, LAMPUNG SELATAN, LAMPUNG",14,142,40,182
https://kawalpemilu.org#22696,"TANJUNG AGUNG, KATIBUNG, LAMPUNG SELATAN, LAMPUNG",15,81,145,226
https://kawalpemilu.org#22696,"TANJUNG AGUNG, KATIBUNG, LAMPUNG SELATAN, LAMPUNG",16,133,76,209
https://kawalpemilu.org#22696,"TANJUNG AGUNG, KATIBUNG, LAMPUNG SELATAN, LAMPUNG",17,191,38,229
https://kawalpemilu.org#22696,"TANJUNG AGUNG, KATIBUNG, LAMPUNG SELATAN, LAMPUNG",18,178,40,218
https://kawalpemilu.org#22696,"TANJUNG AGUNG, KATIBUNG, LAMPUNG SELATAN, LAMPUNG",19,122,20,142
https://kawalpemilu.org#22696,"TANJUNG AGUNG, KATIBUNG, LAMPUNG SELATAN, LAMPUNG",20,55,95,150
https://kawalpemilu.org#22696,"TANJUNG AGUNG, KATIBUNG, LAMPUNG SELATAN, LAMPUNG",21,150,45,195
https://kawalpemilu.org#22697,"TANJUNGAN, KATIBUNG, LAMPUNG SELATAN, LAMPUNG",1,83,114,197
https://kawalpemilu.org#22697,"TANJUNGAN, KATIBUNG, LAMPUNG SELATAN, LAMPUNG",2,85,109,194
https://kawalpemilu.org#22697,"TANJUNGAN, KATIBUNG, LAMPUNG SELATAN, LAMPUNG",3,104,89,193
https://kawalpemilu.org#22697,"TANJUNGAN, KATIBUNG, LAMPUNG SELATAN, LAMPUNG",4,96,88,184
https://kawalpemilu.org#22697,"TANJUNGAN, KATIBUNG, LAMPUNG SELATAN, LAMPUNG",5,123,90,213
https://kawalpemilu.org#22697,"TANJUNGAN, KATIBUNG, LAMPUNG SELATAN, LAMPUNG",6,139,55,294
https://kawalpemilu.org#22697,"TANJUNGAN, KATIBUNG, LAMPUNG SELATAN, LAMPUNG",7,151,48,199
https://kawalpemilu.org#22697,"TANJUNGAN, KATIBUNG, LAMPUNG SELATAN, LAMPUNG",8,150,62,212
https://kawalpemilu.org#22697,"TANJUNGAN, KATIBUNG, LAMPUNG SELATAN, LAMPUNG",9,117,39,156
https://kawalpemilu.org#22697,"TANJUNGAN, KATIBUNG, LAMPUNG SELATAN, LAMPUNG",10,109,71,180
https://kawalpemilu.org#22697,"TANJUNGAN, KATIBUNG, LAMPUNG SELATAN, LAMPUNG",11,128,65,193
https://kawalpemilu.org#22697,"TANJUNGAN, KATIBUNG, LAMPUNG SELATAN, LAMPUNG",12,80,39,119
https://kawalpemilu.org#22698,"TRANS TANJUNGAN, KATIBUNG, LAMPUNG SELATAN, LAMPUNG",1,109,59,168
https://kawalpemilu.org#22698,"TRANS TANJUNGAN, KATIBUNG, LAMPUNG SELATAN, LAMPUNG",2,165,18,183
https://kawalpemilu.org#22698,"TRANS TANJUNGAN, KATIBUNG, LAMPUNG SELATAN, LAMPUNG",3,142,66,208
https://kawalpemilu.org#22698,"TRANS TANJUNGAN, KATIBUNG, LAMPUNG SELATAN, LAMPUNG",5,155,38,193
https://kawalpemilu.org#22698,"TRANS TANJUNGAN, KATIBUNG, LAMPUNG SELATAN, LAMPUNG",6,131,32,163
https://kawalpemilu.org#22698,"TRANS TANJUNGAN, KATIBUNG, LAMPUNG SELATAN, LAMPUNG",7,136,34,170
https://kawalpemilu.org#22698,"TRANS TANJUNGAN, KATIBUNG, LAMPUNG SELATAN, LAMPUNG",8,179,23,202
https://kawalpemilu.org#22698,"TRANS TANJUNGAN, KATIBUNG, LAMPUNG SELATAN, LAMPUNG",9,112,41,153
https://kawalpemilu.org#22698,"TRANS TANJUNGAN, KATIBUNG, LAMPUNG SELATAN, LAMPUNG",10,165,30,195
https://kawalpemilu.org#22698,"TRANS TANJUNGAN, KATIBUNG, LAMPUNG SELATAN, LAMPUNG",11,155,36,191
https://kawalpemilu.org#22698,"TRANS TANJUNGAN, KATIBUNG, LAMPUNG SELATAN, LAMPUNG",12,122,29,151
https://kawalpemilu.org#22698,"TRANS TANJUNGAN, KATIBUNG, LAMPUNG SELATAN, LAMPUNG",13,148,30,178
https://kawalpemilu.org#22698,"TRANS TANJUNGAN, KATIBUNG, LAMPUNG SELATAN, LAMPUNG",14,151,38,189
https://kawalpemilu.org#22698,"TRANS TANJUNGAN, KATIBUNG, LAMPUNG SELATAN, LAMPUNG",15,150,29,179
https://kawalpemilu.org#22698,"TRANS TANJUNGAN, KATIBUNG, LAMPUNG SELATAN, LAMPUNG",16,171,14,185
https://kawalpemilu.org#22699,"NEGLASARI, KATIBUNG, LAMPUNG SELATAN, LAMPUNG",1,155,16,171
https://kawalpemilu.org#22699,"NEGLASARI, KATIBUNG, LAMPUNG SELATAN, LAMPUNG",2,144,37,181
https://kawalpemilu.org#22699,"NEGLASARI, KATIBUNG, LAMPUNG SELATAN, LAMPUNG",3,115,46,161
https://kawalpemilu.org#22699,"NEGLASARI, KATIBUNG, LAMPUNG SELATAN, LAMPUNG",4,88,32,120
https://kawalpemilu.org#22699,"NEGLASARI, KATIBUNG, LAMPUNG SELATAN, LAMPUNG",5,186,37,223
https://kawalpemilu.org#22699,"NEGLASARI, KATIBUNG, LAMPUNG SELATAN, LAMPUNG",6,166,20,186
https://kawalpemilu.org#22699,"NEGLASARI, KATIBUNG, LAMPUNG SELATAN, LAMPUNG",7,192,23,215
https://kawalpemilu.org#22699,"NEGLASARI, KATIBUNG, LAMPUNG SELATAN, LAMPUNG",8,169,50,219
https://kawalpemilu.org#22699,"NEGLASARI, KATIBUNG, LAMPUNG SELATAN, LAMPUNG",9,150,21,171
https://kawalpemilu.org#22699,"NEGLASARI, KATIBUNG, LAMPUNG SELATAN, LAMPUNG",10,116,27,143
https://kawalpemilu.org#22699,"NEGLASARI, KATIBUNG, LAMPUNG SELATAN, LAMPUNG",11,103,31,134
https://kawalpemilu.org#22699,"NEGLASARI, KATIBUNG, LAMPUNG SELATAN, LAMPUNG",12,154,34,188
https://kawalpemilu.org#22699,"NEGLASARI, KATIBUNG, LAMPUNG SELATAN, LAMPUNG",13,156,21,177
https://kawalpemilu.org#22699,"NEGLASARI, KATIBUNG, LAMPUNG SELATAN, LAMPUNG",14,160,39,199
https://kawalpemilu.org#22701,"KARYA TUNGGAL, KATIBUNG, LAMPUNG SELATAN, LAMPUNG",1,153,49,202
https://kawalpemilu.org#22701,"KARYA TUNGGAL, KATIBUNG, LAMPUNG SELATAN, LAMPUNG",2,137,42,179
https://kawalpemilu.org#22701,"KARYA TUNGGAL, KATIBUNG, LAMPUNG SELATAN, LAMPUNG",3,113,62,175
https://kawalpemilu.org#22701,"KARYA TUNGGAL, KATIBUNG, LAMPUNG SELATAN, LAMPUNG",4,98,44,142
https://kawalpemilu.org#22701,"KARYA TUNGGAL, KATIBUNG, LAMPUNG SELATAN, LAMPUNG",5,133,54,187
https://kawalpemilu.org#22701,"KARYA TUNGGAL, KATIBUNG, LAMPUNG SELATAN, LAMPUNG",6,107,44,151
https://kawalpemilu.org#22701,"KARYA TUNGGAL, KATIBUNG, LAMPUNG SELATAN, LAMPUNG",7,93,96,189
https://kawalpemilu.org#22701,"KARYA TUNGGAL, KATIBUNG, LAMPUNG SELATAN, LAMPUNG",8,129,11,140
https://kawalpemilu.org#22702,"RANGAI TRI TUNGGAL, KATIBUNG, LAMPUNG SELATAN, LAMPUNG",1,137,93,230
https://kawalpemilu.org#22702,"RANGAI TRI TUNGGAL, KATIBUNG, LAMPUNG SELATAN, LAMPUNG",2,94,81,175
https://kawalpemilu.org#22702,"RANGAI TRI TUNGGAL, KATIBUNG, LAMPUNG SELATAN, LAMPUNG",3,118,106,224
https://kawalpemilu.org#22702,"RANGAI TRI TUNGGAL, KATIBUNG, LAMPUNG SELATAN, LAMPUNG",4,100,102,202
https://kawalpemilu.org#22702,"RANGAI TRI TUNGGAL, KATIBUNG, LAMPUNG SELATAN, LAMPUNG",5,111,83,194
https://kawalpemilu.org#22702,"RANGAI TRI TUNGGAL, KATIBUNG, LAMPUNG SELATAN, LAMPUNG",6,93,70,163
https://kawalpemilu.org#22702,"RANGAI TRI TUNGGAL, KATIBUNG, LAMPUNG SELATAN, LAMPUNG",7,112,70,182
https://kawalpemilu.org#22702,"RANGAI TRI TUNGGAL, KATIBUNG, LAMPUNG SELATAN, LAMPUNG",8,92,73,165
https://kawalpemilu.org#22702,"RANGAI TRI TUNGGAL, KATIBUNG, LAMPUNG SELATAN, LAMPUNG",9,105,83,188
https://kawalpemilu.org#22702,"RANGAI TRI TUNGGAL, KATIBUNG, LAMPUNG SELATAN, LAMPUNG",10,101,105,206
https://kawalpemilu.org#22702,"RANGAI TRI TUNGGAL, KATIBUNG, LAMPUNG SELATAN, LAMPUNG",11,75,105,180
https://kawalpemilu.org#22702,"RANGAI TRI TUNGGAL, KATIBUNG, LAMPUNG SELATAN, LAMPUNG",12,135,76,211
https://kawalpemilu.org#22702,"RANGAI TRI TUNGGAL, KATIBUNG, LAMPUNG SELATAN, LAMPUNG",13,142,49,191
https://kawalpemilu.org#22702,"RANGAI TRI TUNGGAL, KATIBUNG, LAMPUNG SELATAN, LAMPUNG",14,87,80,167
https://kawalpemilu.org#22702,"RANGAI TRI TUNGGAL, KATIBUNG, LAMPUNG SELATAN, LAMPUNG",15,90,119,209
https://kawalpemilu.org#22702,"RANGAI TRI TUNGGAL, KATIBUNG, LAMPUNG SELATAN, LAMPUNG",16,90,88,178
https://kawalpemilu.org#22702,"RANGAI TRI TUNGGAL, KATIBUNG, LAMPUNG SELATAN, LAMPUNG",17,101,101,202
https://kawalpemilu.org#22702,"RANGAI TRI TUNGGAL, KATIBUNG, LAMPUNG SELATAN, LAMPUNG",18,89,81,170
https://kawalpemilu.org#22702,"RANGAI TRI TUNGGAL, KATIBUNG, LAMPUNG SELATAN, LAMPUNG",19,110,99,209
https://kawalpemilu.org#22702,"RANGAI TRI TUNGGAL, KATIBUNG, LAMPUNG SELATAN, LAMPUNG",20,83,108,191
https://kawalpemilu.org#22702,"RANGAI TRI TUNGGAL, KATIBUNG, LAMPUNG SELATAN, LAMPUNG",21,93,66,159
https://kawalpemilu.org#22702,"RANGAI TRI TUNGGAL, KATIBUNG, LAMPUNG SELATAN, LAMPUNG",22,102,76,178
https://kawalpemilu.org#22702,"RANGAI TRI TUNGGAL, KATIBUNG, LAMPUNG SELATAN, LAMPUNG",23,74,100,174
https://kawalpemilu.org#22702,"RANGAI TRI TUNGGAL, KATIBUNG, LAMPUNG SELATAN, LAMPUNG",24,86,129,215
https://kawalpemilu.org#22703,"SIDOMEKAR, KATIBUNG, LAMPUNG SELATAN, LAMPUNG",1,104,63,167
https://kawalpemilu.org#22703,"SIDOMEKAR, KATIBUNG, LAMPUNG SELATAN, LAMPUNG",2,147,32,179
https://kawalpemilu.org#22703,"SIDOMEKAR, KATIBUNG, LAMPUNG SELATAN, LAMPUNG",3,125,63,188
https://kawalpemilu.org#22703,"SIDOMEKAR, KATIBUNG, LAMPUNG SELATAN, LAMPUNG",4,120,42,162
https://kawalpemilu.org#22703,"SIDOMEKAR, KATIBUNG, LAMPUNG SELATAN, LAMPUNG",5,146,26,172
https://kawalpemilu.org#22703,"SIDOMEKAR, KATIBUNG, LAMPUNG SELATAN, LAMPUNG",6,97,52,149
https://kawalpemilu.org#22703,"SIDOMEKAR, KATIBUNG, LAMPUNG SELATAN, LAMPUNG",7,84,77,161
https://kawalpemilu.org#22703,"SIDOMEKAR, KATIBUNG, LAMPUNG SELATAN, LAMPUNG",8,43,83,126
https://kawalpemilu.org#22703,"SIDOMEKAR, KATIBUNG, LAMPUNG SELATAN, LAMPUNG",9,91,7,98
https://kawalpemilu.org#22703,"SIDOMEKAR, KATIBUNG, LAMPUNG SELATAN, LAMPUNG",10,124,58,182
https://kawalpemilu.org#22705,"KEKILING, PENENGAHAN, LAMPUNG SELATAN, LAMPUNG",1,80,128,208
https://kawalpemilu.org#22705,"KEKILING, PENENGAHAN, LAMPUNG SELATAN, LAMPUNG",2,65,153,218
https://kawalpemilu.org#22705,"KEKILING, PENENGAHAN, LAMPUNG SELATAN, LAMPUNG",3,83,139,222
https://kawalpemilu.org#22705,"KEKILING, PENENGAHAN, LAMPUNG SELATAN, LAMPUNG",4,84,102,186
https://kawalpemilu.org#22705,"KEKILING, PENENGAHAN, LAMPUNG SELATAN, LAMPUNG",5,97,106,203
https://kawalpemilu.org#22705,"KEKILING, PENENGAHAN, LAMPUNG SELATAN, LAMPUNG",7,79,76,155
https://kawalpemilu.org#22706,"BELAMBANGAN, PENENGAHAN, LAMPUNG SELATAN, LAMPUNG",1,101,118,219
https://kawalpemilu.org#22706,"BELAMBANGAN, PENENGAHAN, LAMPUNG SELATAN, LAMPUNG",3,82,68,150
https://kawalpemilu.org#22706,"BELAMBANGAN, PENENGAHAN, LAMPUNG SELATAN, LAMPUNG",4,118,88,206
https://kawalpemilu.org#22706,"BELAMBANGAN, PENENGAHAN, LAMPUNG SELATAN, LAMPUNG",5,134,81,215
https://kawalpemilu.org#22707,"RAWI, PENENGAHAN, LAMPUNG SELATAN, LAMPUNG",1,79,99,178
https://kawalpemilu.org#22707,"RAWI, PENENGAHAN, LAMPUNG SELATAN, LAMPUNG",2,94,111,205
https://kawalpemilu.org#22707,"RAWI, PENENGAHAN, LAMPUNG SELATAN, LAMPUNG",3,98,107,205
https://kawalpemilu.org#22707,"RAWI, PENENGAHAN, LAMPUNG SELATAN, LAMPUNG",4,81,118,199
https://kawalpemilu.org#22707,"RAWI, PENENGAHAN, LAMPUNG SELATAN, LAMPUNG",5,150,76,226
https://kawalpemilu.org#22707,"RAWI, PENENGAHAN, LAMPUNG SELATAN, LAMPUNG",6,110,29,139
https://kawalpemilu.org#22708,"PADAN, PENENGAHAN, LAMPUNG SELATAN, LAMPUNG",1,71,116,187
https://kawalpemilu.org#22708,"PADAN, PENENGAHAN, LAMPUNG SELATAN, LAMPUNG",2,81,91,172
https://kawalpemilu.org#22708,"PADAN, PENENGAHAN, LAMPUNG SELATAN, LAMPUNG",3,56,97,153
https://kawalpemilu.org#22708,"PADAN, PENENGAHAN, LAMPUNG SELATAN, LAMPUNG",4,57,82,139
https://kawalpemilu.org#22708,"PADAN, PENENGAHAN, LAMPUNG SELATAN, LAMPUNG",5,89,37,126
https://kawalpemilu.org#22708,"PADAN, PENENGAHAN, LAMPUNG SELATAN, LAMPUNG",6,94,76,170
https://kawalpemilu.org#22708,"PADAN, PENENGAHAN, LAMPUNG SELATAN, LAMPUNG",7,76,74,150
https://kawalpemilu.org#22708,"PADAN, PENENGAHAN, LAMPUNG SELATAN, LAMPUNG",8,91,35,126
https://kawalpemilu.org#22709,"KURIPAN, PENENGAHAN, LAMPUNG SELATAN, LAMPUNG",1,32,162,194
https://kawalpemilu.org#22709,"KURIPAN, PENENGAHAN, LAMPUNG SELATAN, LAMPUNG",2,59,141,200
https://kawalpemilu.org#22709,"KURIPAN, PENENGAHAN, LAMPUNG SELATAN, LAMPUNG",3,54,121,175
https://kawalpemilu.org#22709,"KURIPAN, PENENGAHAN, LAMPUNG SELATAN, LAMPUNG",4,52,107,159
https://kawalpemilu.org#22709,"KURIPAN, PENENGAHAN, LAMPUNG SELATAN, LAMPUNG",5,203,25,228
https://kawalpemilu.org#22709,"KURIPAN, PENENGAHAN, LAMPUNG SELATAN, LAMPUNG",6,160,31,191
https://kawalpemilu.org#22709,"KURIPAN, PENENGAHAN, LAMPUNG SELATAN, LAMPUNG",7,185,21,206
https://kawalpemilu.org#22709,"KURIPAN, PENENGAHAN, LAMPUNG SELATAN, LAMPUNG",8,47,70,117
https://kawalpemilu.org#22710,"TAMAN BARU, PENENGAHAN, LAMPUNG SELATAN, LAMPUNG",1,88,117,205
https://kawalpemilu.org#22710,"TAMAN BARU, PENENGAHAN, LAMPUNG SELATAN, LAMPUNG",2,81,99,180
https://kawalpemilu.org#22710,"TAMAN BARU, PENENGAHAN, LAMPUNG SELATAN, LAMPUNG",3,85,112,197
https://kawalpemilu.org#22711,"KELAU, PENENGAHAN, LAMPUNG SELATAN, LAMPUNG",1,78,113,191
https://kawalpemilu.org#22711,"KELAU, PENENGAHAN, LAMPUNG SELATAN, LAMPUNG",2,53,114,167
https://kawalpemilu.org#22711,"KELAU, PENENGAHAN, LAMPUNG SELATAN, LAMPUNG",3,34,106,140
https://kawalpemilu.org#22711,"KELAU, PENENGAHAN, LAMPUNG SELATAN, LAMPUNG",4,103,62,165
https://kawalpemilu.org#22712,"RUANG TENGAH, PENENGAHAN, LAMPUNG SELATAN, LAMPUNG",1,46,58,104
https://kawalpemilu.org#22712,"RUANG TENGAH, PENENGAHAN, LAMPUNG SELATAN, LAMPUNG",2,47,65,112
https://kawalpemilu.org#22712,"RUANG TENGAH, PENENGAHAN, LAMPUNG SELATAN, LAMPUNG",3,76,133,209
https://kawalpemilu.org#22712,"RUANG TENGAH, PENENGAHAN, LAMPUNG SELATAN, LAMPUNG",4,129,30,159
https://kawalpemilu.org#22712,"RUANG TENGAH, PENENGAHAN, LAMPUNG SELATAN, LAMPUNG",5,36,94,130
https://kawalpemilu.org#22713,"PASURUAN, PENENGAHAN, LAMPUNG SELATAN, LAMPUNG",1,158,57,215
https://kawalpemilu.org#22713,"PASURUAN, PENENGAHAN, LAMPUNG SELATAN, LAMPUNG",2,172,48,220
https://kawalpemilu.org#22713,"PASURUAN, PENENGAHAN, LAMPUNG SELATAN, LAMPUNG",3,143,72,215
https://kawalpemilu.org#22713,"PASURUAN, PENENGAHAN, LAMPUNG SELATAN, LAMPUNG",4,126,132,258
https://kawalpemilu.org#22713,"PASURUAN, PENENGAHAN, LAMPUNG SELATAN, LAMPUNG",5,130,82,212
https://kawalpemilu.org#22713,"PASURUAN, PENENGAHAN, LAMPUNG SELATAN, LAMPUNG",6,145,99,244
https://kawalpemilu.org#22713,"PASURUAN, PENENGAHAN, LAMPUNG SELATAN, LAMPUNG",7,149,98,247
https://kawalpemilu.org#22713,"PASURUAN, PENENGAHAN, LAMPUNG SELATAN, LAMPUNG",8,144,73,217
https://kawalpemilu.org#22713,"PASURUAN, PENENGAHAN, LAMPUNG SELATAN, LAMPUNG",9,106,32,138
https://kawalpemilu.org#22713,"PASURUAN, PENENGAHAN, LAMPUNG SELATAN, LAMPUNG",10,116,93,209
https://kawalpemilu.org#22713,"PASURUAN, PENENGAHAN, LAMPUNG SELATAN, LAMPUNG",11,98,127,225
https://kawalpemilu.org#22713,"PASURUAN, PENENGAHAN, LAMPUNG SELATAN, LAMPUNG",12,106,85,191
https://kawalpemilu.org#22714,"KLATEN, PENENGAHAN, LAMPUNG SELATAN, LAMPUNG",1,173,42,215
https://kawalpemilu.org#22714,"KLATEN, PENENGAHAN, LAMPUNG SELATAN, LAMPUNG",2,124,89,213
https://kawalpemilu.org#22714,"KLATEN, PENENGAHAN, LAMPUNG SELATAN, LAMPUNG",3,137,68,205
https://kawalpemilu.org#22714,"KLATEN, PENENGAHAN, LAMPUNG SELATAN, LAMPUNG",4,149,70,219
https://kawalpemilu.org#22714,"KLATEN, PENENGAHAN, LAMPUNG SELATAN, LAMPUNG",5,131,87,218
https://kawalpemilu.org#22714,"KLATEN, PENENGAHAN, LAMPUNG SELATAN, LAMPUNG",6,162,43,205
https://kawalpemilu.org#22714,"KLATEN, PENENGAHAN, LAMPUNG SELATAN, LAMPUNG",7,77,56,133
https://kawalpemilu.org#22714,"KLATEN, PENENGAHAN, LAMPUNG SELATAN, LAMPUNG",8,163,45,208
https://kawalpemilu.org#22714,"KLATEN, PENENGAHAN, LAMPUNG SELATAN, LAMPUNG",9,128,55,183
https://kawalpemilu.org#22714,"KLATEN, PENENGAHAN, LAMPUNG SELATAN, LAMPUNG",10,67,39,106
https://kawalpemilu.org#22715,"KAMPUNG BARU, PENENGAHAN, LAMPUNG SELATAN, LAMPUNG",1,94,64,158
https://kawalpemilu.org#22715,"KAMPUNG BARU, PENENGAHAN, LAMPUNG SELATAN, LAMPUNG",2,89,66,155
https://kawalpemilu.org#22715,"KAMPUNG BARU, PENENGAHAN, LAMPUNG SELATAN, LAMPUNG",3,88,67,155
https://kawalpemilu.org#22716,"BANJAR MASIN, PENENGAHAN, LAMPUNG SELATAN, LAMPUNG",1,69,128,197
https://kawalpemilu.org#22716,"BANJAR MASIN, PENENGAHAN, LAMPUNG SELATAN, LAMPUNG",2,65,162,227
https://kawalpemilu.org#22716,"BANJAR MASIN, PENENGAHAN, LAMPUNG SELATAN, LAMPUNG",3,107,85,192
https://kawalpemilu.org#22716,"BANJAR MASIN, PENENGAHAN, LAMPUNG SELATAN, LAMPUNG",4,81,110,191
https://kawalpemilu.org#22716,"BANJAR MASIN, PENENGAHAN, LAMPUNG SELATAN, LAMPUNG",5,80,122,202
https://kawalpemilu.org#22716,"BANJAR MASIN, PENENGAHAN, LAMPUNG SELATAN, LAMPUNG",6,69,101,170
https://kawalpemilu.org#22717,"WAY KALAM, PENENGAHAN, LAMPUNG SELATAN, LAMPUNG",1,77,86,163
https://kawalpemilu.org#22717,"WAY KALAM, PENENGAHAN, LAMPUNG SELATAN, LAMPUNG",2,66,118,184
https://kawalpemilu.org#22717,"WAY KALAM, PENENGAHAN, LAMPUNG SELATAN, LAMPUNG",3,88,56,144
https://kawalpemilu.org#22717,"WAY KALAM, PENENGAHAN, LAMPUNG SELATAN, LAMPUNG",4,83,70,153
https://kawalpemilu.org#22718,"GEDUNG HARTA, PENENGAHAN, LAMPUNG SELATAN, LAMPUNG",1,75,120,195
https://kawalpemilu.org#22718,"GEDUNG HARTA, PENENGAHAN, LAMPUNG SELATAN, LAMPUNG",2,61,125,186
https://kawalpemilu.org#22718,"GEDUNG HARTA, PENENGAHAN, LAMPUNG SELATAN, LAMPUNG",3,69,108,177
https://kawalpemilu.org#22718,"GEDUNG HARTA, PENENGAHAN, LAMPUNG SELATAN, LAMPUNG",4,79,127,206
https://kawalpemilu.org#22719,"GAYAM, PENENGAHAN, LAMPUNG SELATAN, LAMPUNG",1,67,95,162
https://kawalpemilu.org#22719,"GAYAM, PENENGAHAN, LAMPUNG SELATAN, LAMPUNG",2,41,105,146
https://kawalpemilu.org#22719,"GAYAM, PENENGAHAN, LAMPUNG SELATAN, LAMPUNG",3,60,128,188
https://kawalpemilu.org#22719,"GAYAM, PENENGAHAN, LAMPUNG SELATAN, LAMPUNG",4,70,86,156
https://kawalpemilu.org#22719,"GAYAM, PENENGAHAN, LAMPUNG SELATAN, LAMPUNG",5,58,110,168
https://kawalpemilu.org#22719,"GAYAM, PENENGAHAN, LAMPUNG SELATAN, LAMPUNG",6,82,104,186
https://kawalpemilu.org#22720,"PENENGAHAN, PENENGAHAN, LAMPUNG SELATAN, LAMPUNG",1,109,72,181
https://kawalpemilu.org#22720,"PENENGAHAN, PENENGAHAN, LAMPUNG SELATAN, LAMPUNG",2,76,128,204
https://kawalpemilu.org#22720,"PENENGAHAN, PENENGAHAN, LAMPUNG SELATAN, LAMPUNG",3,94,121,215
https://kawalpemilu.org#22720,"PENENGAHAN, PENENGAHAN, LAMPUNG SELATAN, LAMPUNG",4,155,41,196
https://kawalpemilu.org#22720,"PENENGAHAN, PENENGAHAN, LAMPUNG SELATAN, LAMPUNG",5,139,33,172
https://kawalpemilu.org#22720,"PENENGAHAN, PENENGAHAN, LAMPUNG SELATAN, LAMPUNG",6,102,101,203
https://kawalpemilu.org#22721,"SUKAJAYA, PENENGAHAN, LAMPUNG SELATAN, LAMPUNG",1,73,111,184
https://kawalpemilu.org#22721,"SUKAJAYA, PENENGAHAN, LAMPUNG SELATAN, LAMPUNG",2,70,76,146
https://kawalpemilu.org#22721,"SUKAJAYA, PENENGAHAN, LAMPUNG SELATAN, LAMPUNG",3,45,52,97
https://kawalpemilu.org#22722,"TETAAN, PENENGAHAN, LAMPUNG SELATAN, LAMPUNG",1,81,107,188
https://kawalpemilu.org#22722,"TETAAN, PENENGAHAN, LAMPUNG SELATAN, LAMPUNG",2,73,118,191
https://kawalpemilu.org#22722,"TETAAN, PENENGAHAN, LAMPUNG SELATAN, LAMPUNG",3,88,110,198
https://kawalpemilu.org#22722,"TETAAN, PENENGAHAN, LAMPUNG SELATAN, LAMPUNG",4,84,86,170
https://kawalpemilu.org#22722,"TETAAN, PENENGAHAN, LAMPUNG SELATAN, LAMPUNG",5,52,97,150
https://kawalpemilu.org#22722,"TETAAN, PENENGAHAN, LAMPUNG SELATAN, LAMPUNG",6,107,83,190
https://kawalpemilu.org#22723,"SUKABARU, PENENGAHAN, LAMPUNG SELATAN, LAMPUNG",1,78,131,209
https://kawalpemilu.org#22723,"SUKABARU, PENENGAHAN, LAMPUNG SELATAN, LAMPUNG",2,67,150,217
https://kawalpemilu.org#22723,"SUKABARU, PENENGAHAN, LAMPUNG SELATAN, LAMPUNG",3,128,54,182
https://kawalpemilu.org#22723,"SUKABARU, PENENGAHAN, LAMPUNG SELATAN, LAMPUNG",4,149,21,170
https://kawalpemilu.org#22723,"SUKABARU, PENENGAHAN, LAMPUNG SELATAN, LAMPUNG",5,161,19,180
https://kawalpemilu.org#22723,"SUKABARU, PENENGAHAN, LAMPUNG SELATAN, LAMPUNG",6,57,116,173
https://kawalpemilu.org#22723,"SUKABARU, PENENGAHAN, LAMPUNG SELATAN, LAMPUNG",7,71,139,210
https://kawalpemilu.org#22723,"SUKABARU, PENENGAHAN, LAMPUNG SELATAN, LAMPUNG",8,138,52,190
https://kawalpemilu.org#22723,"SUKABARU, PENENGAHAN, LAMPUNG SELATAN, LAMPUNG",9,158,14,172
https://kawalpemilu.org#22724,"PISANG, PENENGAHAN, LAMPUNG SELATAN, LAMPUNG",1,33,125,158
https://kawalpemilu.org#22724,"PISANG, PENENGAHAN, LAMPUNG SELATAN, LAMPUNG",2,29,156,185
https://kawalpemilu.org#22724,"PISANG, PENENGAHAN, LAMPUNG SELATAN, LAMPUNG",3,42,120,162
https://kawalpemilu.org#22724,"PISANG, PENENGAHAN, LAMPUNG SELATAN, LAMPUNG",4,39,134,173
https://kawalpemilu.org#22725,"TANJUNG HERAN, PENENGAHAN, LAMPUNG SELATAN, LAMPUNG",1,123,48,171
https://kawalpemilu.org#22725,"TANJUNG HERAN, PENENGAHAN, LAMPUNG SELATAN, LAMPUNG",2,78,69,147
https://kawalpemilu.org#22725,"TANJUNG HERAN, PENENGAHAN, LAMPUNG SELATAN, LAMPUNG",3,105,109,214
https://kawalpemilu.org#22725,"TANJUNG HERAN, PENENGAHAN, LAMPUNG SELATAN, LAMPUNG",4,86,80,166
https://kawalpemilu.org#22725,"TANJUNG HERAN, PENENGAHAN, LAMPUNG SELATAN, LAMPUNG",5,141,41,182
https://kawalpemilu.org#22726,"GANDRI, PENENGAHAN, LAMPUNG SELATAN, LAMPUNG",1,90,104,194
https://kawalpemilu.org#22726,"GANDRI, PENENGAHAN, LAMPUNG SELATAN, LAMPUNG",2,105,86,191
https://kawalpemilu.org#22726,"GANDRI, PENENGAHAN, LAMPUNG SELATAN, LAMPUNG",3,117,64,181
https://kawalpemilu.org#22726,"GANDRI, PENENGAHAN, LAMPUNG SELATAN, LAMPUNG",4,134,47,181
https://kawalpemilu.org#22728,"SUKARAJA, PALAS, LAMPUNG SELATAN, LAMPUNG",1,96,110,206
https://kawalpemilu.org#22728,"SUKARAJA, PALAS, LAMPUNG SELATAN, LAMPUNG",2,111,102,213
https://kawalpemilu.org#22728,"SUKARAJA, PALAS, LAMPUNG SELATAN, LAMPUNG",3,120,58,178
https://kawalpemilu.org#22728,"SUKARAJA, PALAS, LAMPUNG SELATAN, LAMPUNG",4,133,55,188
https://kawalpemilu.org#22728,"SUKARAJA, PALAS, LAMPUNG SELATAN, LAMPUNG",5,132,22,154
https://kawalpemilu.org#22728,"SUKARAJA, PALAS, LAMPUNG SELATAN, LAMPUNG",6,131,44,175
https://kawalpemilu.org#22728,"SUKARAJA, PALAS, LAMPUNG SELATAN, LAMPUNG",7,188,23,211
https://kawalpemilu.org#22728,"SUKARAJA, PALAS, LAMPUNG SELATAN, LAMPUNG",8,143,39,182
https://kawalpemilu.org#22728,"SUKARAJA, PALAS, LAMPUNG SELATAN, LAMPUNG",9,111,46,157
https://kawalpemilu.org#22728,"SUKARAJA, PALAS, LAMPUNG SELATAN, LAMPUNG",10,87,31,118
https://kawalpemilu.org#22728,"SUKARAJA, PALAS, LAMPUNG SELATAN, LAMPUNG",11,130,41,171
https://kawalpemilu.org#22728,"SUKARAJA, PALAS, LAMPUNG SELATAN, LAMPUNG",12,107,68,175
https://kawalpemilu.org#22729,"SUKABAKTI, PALAS, LAMPUNG SELATAN, LAMPUNG",2,138,33,171
https://kawalpemilu.org#22729,"SUKABAKTI, PALAS, LAMPUNG SELATAN, LAMPUNG",3,131,18,149
https://kawalpemilu.org#22729,"SUKABAKTI, PALAS, LAMPUNG SELATAN, LAMPUNG",4,120,28,148
https://kawalpemilu.org#22729,"SUKABAKTI, PALAS, LAMPUNG SELATAN, LAMPUNG",5,104,29,133
https://kawalpemilu.org#22729,"SUKABAKTI, PALAS, LAMPUNG SELATAN, LAMPUNG",6,136,28,164
https://kawalpemilu.org#22729,"SUKABAKTI, PALAS, LAMPUNG SELATAN, LAMPUNG",7,140,12,152
https://kawalpemilu.org#22729,"SUKABAKTI, PALAS, LAMPUNG SELATAN, LAMPUNG",8,131,10,141
https://kawalpemilu.org#22730,"SUKAMULYA, PALAS, LAMPUNG SELATAN, LAMPUNG",1,140,51,191
https://kawalpemilu.org#22730,"SUKAMULYA, PALAS, LAMPUNG SELATAN, LAMPUNG",2,167,21,188
https://kawalpemilu.org#22730,"SUKAMULYA, PALAS, LAMPUNG SELATAN, LAMPUNG",3,158,32,190
https://kawalpemilu.org#22730,"SUKAMULYA, PALAS, LAMPUNG SELATAN, LAMPUNG",4,156,46,202
https://kawalpemilu.org#22730,"SUKAMULYA, PALAS, LAMPUNG SELATAN, LAMPUNG",5,152,19,171
https://kawalpemilu.org#22730,"SUKAMULYA, PALAS, LAMPUNG SELATAN, LAMPUNG",6,146,40,186
https://kawalpemilu.org#22730,"SUKAMULYA, PALAS, LAMPUNG SELATAN, LAMPUNG",7,200,29,229
https://kawalpemilu.org#22730,"SUKAMULYA, PALAS, LAMPUNG SELATAN, LAMPUNG",8,164,30,194
https://kawalpemilu.org#22730,"SUKAMULYA, PALAS, LAMPUNG SELATAN, LAMPUNG",9,69,47,116
https://kawalpemilu.org#22730,"SUKAMULYA, PALAS, LAMPUNG SELATAN, LAMPUNG",10,67,55,122
https://kawalpemilu.org#22731,"TANJUNG SARI, PALAS, LAMPUNG SELATAN, LAMPUNG",1,162,32,194
https://kawalpemilu.org#22731,"TANJUNG SARI, PALAS, LAMPUNG SELATAN, LAMPUNG",2,152,38,190
https://kawalpemilu.org#22731,"TANJUNG SARI, PALAS, LAMPUNG SELATAN, LAMPUNG",3,130,40,170
https://kawalpemilu.org#22731,"TANJUNG SARI, PALAS, LAMPUNG SELATAN, LAMPUNG",4,114,64,178
https://kawalpemilu.org#22731,"TANJUNG SARI, PALAS, LAMPUNG SELATAN, LAMPUNG",5,160,37,197
https://kawalpemilu.org#22731,"TANJUNG SARI, PALAS, LAMPUNG SELATAN, LAMPUNG",6,131,21,152
https://kawalpemilu.org#22731,"TANJUNG SARI, PALAS, LAMPUNG SELATAN, LAMPUNG",7,145,11,156
https://kawalpemilu.org#22731,"TANJUNG SARI, PALAS, LAMPUNG SELATAN, LAMPUNG",8,136,22,158
https://kawalpemilu.org#22731,"TANJUNG SARI, PALAS, LAMPUNG SELATAN, LAMPUNG",9,123,9,132
https://kawalpemilu.org#22731,"TANJUNG SARI, PALAS, LAMPUNG SELATAN, LAMPUNG",10,137,19,156
https://kawalpemilu.org#22731,"TANJUNG SARI, PALAS, LAMPUNG SELATAN, LAMPUNG",11,189,14,203
https://kawalpemilu.org#22731,"TANJUNG SARI, PALAS, LAMPUNG SELATAN, LAMPUNG",12,179,12,191
https://kawalpemilu.org#22732,"BANGUNAN, PALAS, LAMPUNG SELATAN, LAMPUNG",1,133,51,184
https://kawalpemilu.org#22732,"BANGUNAN, PALAS, LAMPUNG SELATAN, LAMPUNG",2,145,31,176
https://kawalpemilu.org#22732,"BANGUNAN, PALAS, LAMPUNG SELATAN, LAMPUNG",3,179,33,211
https://kawalpemilu.org#22732,"BANGUNAN, PALAS, LAMPUNG SELATAN, LAMPUNG",4,113,93,206
https://kawalpemilu.org#22732,"BANGUNAN, PALAS, LAMPUNG SELATAN, LAMPUNG",5,119,74,193
https://kawalpemilu.org#22732,"BANGUNAN, PALAS, LAMPUNG SELATAN, LAMPUNG",6,134,59,193
https://kawalpemilu.org#22732,"BANGUNAN, PALAS, LAMPUNG SELATAN, LAMPUNG",7,129,16,145
https://kawalpemilu.org#22732,"BANGUNAN, PALAS, LAMPUNG SELATAN, LAMPUNG",8,142,44,186
https://kawalpemilu.org#22732,"BANGUNAN, PALAS, LAMPUNG SELATAN, LAMPUNG",9,146,30,176
https://kawalpemilu.org#22732,"BANGUNAN, PALAS, LAMPUNG SELATAN, LAMPUNG",10,166,23,189
https://kawalpemilu.org#22732,"BANGUNAN, PALAS, LAMPUNG SELATAN, LAMPUNG",11,152,34,186
https://kawalpemilu.org#22732,"BANGUNAN, PALAS, LAMPUNG SELATAN, LAMPUNG",12,164,19,183
https://kawalpemilu.org#22732,"BANGUNAN, PALAS, LAMPUNG SELATAN, LAMPUNG",13,155,9,164
https://kawalpemilu.org#22732,"BANGUNAN, PALAS, LAMPUNG SELATAN, LAMPUNG",14,175,29,204
https://kawalpemilu.org#22732,"BANGUNAN, PALAS, LAMPUNG SELATAN, LAMPUNG",15,183,15,198
https://kawalpemilu.org#22733,"REJO MULYO, PALAS, LAMPUNG SELATAN, LAMPUNG",1,142,50,192
https://kawalpemilu.org#22733,"REJO MULYO, PALAS, LAMPUNG SELATAN, LAMPUNG",2,94,86,180
https://kawalpemilu.org#22733,"REJO MULYO, PALAS, LAMPUNG SELATAN, LAMPUNG",3,172,38,210
https://kawalpemilu.org#22733,"REJO MULYO, PALAS, LAMPUNG SELATAN, LAMPUNG",4,155,52,207
https://kawalpemilu.org#22733,"REJO MULYO, PALAS, LAMPUNG SELATAN, LAMPUNG",5,177,34,211
https://kawalpemilu.org#22733,"REJO MULYO, PALAS, LAMPUNG SELATAN, LAMPUNG",6,190,21,211
https://kawalpemilu.org#22733,"REJO MULYO, PALAS, LAMPUNG SELATAN, LAMPUNG",7,170,24,194
https://kawalpemilu.org#22733,"REJO MULYO, PALAS, LAMPUNG SELATAN, LAMPUNG",8,99,27,126
https://kawalpemilu.org#22734,"PALAS AJI, PALAS, LAMPUNG SELATAN, LAMPUNG",1,71,90,161
https://kawalpemilu.org#22734,"PALAS AJI, PALAS, LAMPUNG SELATAN, LAMPUNG",2,31,79,110
https://kawalpemilu.org#22734,"PALAS AJI, PALAS, LAMPUNG SELATAN, LAMPUNG",3,66,89,155
https://kawalpemilu.org#22734,"PALAS AJI, PALAS, LAMPUNG SELATAN, LAMPUNG",4,88,85,173
https://kawalpemilu.org#22735,"PALAS PASEMAH, PALAS, LAMPUNG SELATAN, LAMPUNG",1,89,98,187
https://kawalpemilu.org#22735,"PALAS PASEMAH, PALAS, LAMPUNG SELATAN, LAMPUNG",2,112,98,210
https://kawalpemilu.org#22735,"PALAS PASEMAH, PALAS, LAMPUNG SELATAN, LAMPUNG",3,123,75,198
https://kawalpemilu.org#22735,"PALAS PASEMAH, PALAS, LAMPUNG SELATAN, LAMPUNG",4,117,70,187
https://kawalpemilu.org#22735,"PALAS PASEMAH, PALAS, LAMPUNG SELATAN, LAMPUNG",5,101,81,182
https://kawalpemilu.org#22735,"PALAS PASEMAH, PALAS, LAMPUNG SELATAN, LAMPUNG",6,115,67,182
https://kawalpemilu.org#22735,"PALAS PASEMAH, PALAS, LAMPUNG SELATAN, LAMPUNG",7,109,92,201
https://kawalpemilu.org#22736,"PALAS JAYA, PALAS, LAMPUNG SELATAN, LAMPUNG",1,76,102,178
https://kawalpemilu.org#22736,"PALAS JAYA, PALAS, LAMPUNG SELATAN, LAMPUNG",2,108,72,180
https://kawalpemilu.org#22736,"PALAS JAYA, PALAS, LAMPUNG SELATAN, LAMPUNG",3,96,85,181
https://kawalpemilu.org#22736,"PALAS JAYA, PALAS, LAMPUNG SELATAN, LAMPUNG",4,174,85,259
https://kawalpemilu.org#22736,"PALAS JAYA, PALAS, LAMPUNG SELATAN, LAMPUNG",5,154,33,187
https://kawalpemilu.org#22736,"PALAS JAYA, PALAS, LAMPUNG SELATAN, LAMPUNG",6,201,34,235
https://kawalpemilu.org#22736,"PALAS JAYA, PALAS, LAMPUNG SELATAN, LAMPUNG",7,164,56,220
https://kawalpemilu.org#22737,"BANDAN HURIP, PALAS, LAMPUNG SELATAN, LAMPUNG",1,139,75,214
https://kawalpemilu.org#22737,"BANDAN HURIP, PALAS, LAMPUNG SELATAN, LAMPUNG",2,164,46,210
https://kawalpemilu.org#22737,"BANDAN HURIP, PALAS, LAMPUNG SELATAN, LAMPUNG",3,165,62,227
https://kawalpemilu.org#22737,"BANDAN HURIP, PALAS, LAMPUNG SELATAN, LAMPUNG",4,152,51,203
https://kawalpemilu.org#22737,"BANDAN HURIP, PALAS, LAMPUNG SELATAN, LAMPUNG",5,145,66,211
https://kawalpemilu.org#22737,"BANDAN HURIP, PALAS, LAMPUNG SELATAN, LAMPUNG",6,137,61,198
https://kawalpemilu.org#22738,"PULAU TENGAH, PALAS, LAMPUNG SELATAN, LAMPUNG",1,140,22,162
https://kawalpemilu.org#22738,"PULAU TENGAH, PALAS, LAMPUNG SELATAN, LAMPUNG",2,137,27,164
https://kawalpemilu.org#22738,"PULAU TENGAH, PALAS, LAMPUNG SELATAN, LAMPUNG",3,152,26,178
https://kawalpemilu.org#22739,"BALI AGUNG, PALAS, LAMPUNG SELATAN, LAMPUNG",1,158,37,195
https://kawalpemilu.org#22739,"BALI AGUNG, PALAS, LAMPUNG SELATAN, LAMPUNG",2,169,8,177
https://kawalpemilu.org#22739,"BALI AGUNG, PALAS, LAMPUNG SELATAN, LAMPUNG",3,182,14,196
https://kawalpemilu.org#22739,"BALI AGUNG, PALAS, LAMPUNG SELATAN, LAMPUNG",4,134,65,199
https://kawalpemilu.org#22739,"BALI AGUNG, PALAS, LAMPUNG SELATAN, LAMPUNG",5,162,14,176
https://kawalpemilu.org#22739,"BALI AGUNG, PALAS, LAMPUNG SELATAN, LAMPUNG",6,165,11,176
https://kawalpemilu.org#22739,"BALI AGUNG, PALAS, LAMPUNG SELATAN, LAMPUNG",7,157,5,162
https://kawalpemilu.org#22739,"BALI AGUNG, PALAS, LAMPUNG SELATAN, LAMPUNG",8,176,6,182
https://kawalpemilu.org#22739,"BALI AGUNG, PALAS, LAMPUNG SELATAN, LAMPUNG",9,158,27,185
https://kawalpemilu.org#22739,"BALI AGUNG, PALAS, LAMPUNG SELATAN, LAMPUNG",10,130,15,145
https://kawalpemilu.org#22740,"BUMI DAYA, PALAS, LAMPUNG SELATAN, LAMPUNG",1,166,11,177
https://kawalpemilu.org#22740,"BUMI DAYA, PALAS, LAMPUNG SELATAN, LAMPUNG",2,142,14,156
https://kawalpemilu.org#22740,"BUMI DAYA, PALAS, LAMPUNG SELATAN, LAMPUNG",3,158,20,178
https://kawalpemilu.org#22740,"BUMI DAYA, PALAS, LAMPUNG SELATAN, LAMPUNG",4,164,21,185
https://kawalpemilu.org#22740,"BUMI DAYA, PALAS, LAMPUNG SELATAN, LAMPUNG",5,175,9,184
https://kawalpemilu.org#22740,"BUMI DAYA, PALAS, LAMPUNG SELATAN, LAMPUNG",6,106,19,125
https://kawalpemilu.org#22740,"BUMI DAYA, PALAS, LAMPUNG SELATAN, LAMPUNG",7,114,16,130
https://kawalpemilu.org#22740,"BUMI DAYA, PALAS, LAMPUNG SELATAN, LAMPUNG",8,161,18,179
https://kawalpemilu.org#22740,"BUMI DAYA, PALAS, LAMPUNG SELATAN, LAMPUNG",9,85,93,178
https://kawalpemilu.org#22740,"BUMI DAYA, PALAS, LAMPUNG SELATAN, LAMPUNG",10,135,63,198
https://kawalpemilu.org#22740,"BUMI DAYA, PALAS, LAMPUNG SELATAN, LAMPUNG",11,112,77,189
https://kawalpemilu.org#22740,"BUMI DAYA, PALAS, LAMPUNG SELATAN, LAMPUNG",12,119,55,174
https://kawalpemilu.org#22740,"BUMI DAYA, PALAS, LAMPUNG SELATAN, LAMPUNG",13,118,16,134
https://kawalpemilu.org#22740,"BUMI DAYA, PALAS, LAMPUNG SELATAN, LAMPUNG",14,156,15,171
https://kawalpemilu.org#22740,"BUMI DAYA, PALAS, LAMPUNG SELATAN, LAMPUNG",15,174,12,186
https://kawalpemilu.org#22740,"BUMI DAYA, PALAS, LAMPUNG SELATAN, LAMPUNG",16,140,17,157
https://kawalpemilu.org#22740,"BUMI DAYA, PALAS, LAMPUNG SELATAN, LAMPUNG",17,160,16,176
https://kawalpemilu.org#22741,"TANJUNG JAYA, PALAS, LAMPUNG SELATAN, LAMPUNG",1,136,76,212
https://kawalpemilu.org#22741,"TANJUNG JAYA, PALAS, LAMPUNG SELATAN, LAMPUNG",2,120,75,195
https://kawalpemilu.org#22741,"TANJUNG JAYA, PALAS, LAMPUNG SELATAN, LAMPUNG",3,192,36,228
https://kawalpemilu.org#22741,"TANJUNG JAYA, PALAS, LAMPUNG SELATAN, LAMPUNG",4,132,50,182
https://kawalpemilu.org#22741,"TANJUNG JAYA, PALAS, LAMPUNG SELATAN, LAMPUNG",5,130,63,193
https://kawalpemilu.org#22741,"TANJUNG JAYA, PALAS, LAMPUNG SELATAN, LAMPUNG",6,173,28,201
https://kawalpemilu.org#22741,"TANJUNG JAYA, PALAS, LAMPUNG SELATAN, LAMPUNG",7,175,28,203
https://kawalpemilu.org#22742,"BUMI RESTU, PALAS, LAMPUNG SELATAN, LAMPUNG",1,219,10,229
https://kawalpemilu.org#22742,"BUMI RESTU, PALAS, LAMPUNG SELATAN, LAMPUNG",2,168,16,184
https://kawalpemilu.org#22742,"BUMI RESTU, PALAS, LAMPUNG SELATAN, LAMPUNG",3,199,16,215
https://kawalpemilu.org#22742,"BUMI RESTU, PALAS, LAMPUNG SELATAN, LAMPUNG",4,194,6,200
https://kawalpemilu.org#22742,"BUMI RESTU, PALAS, LAMPUNG SELATAN, LAMPUNG",5,156,37,193
https://kawalpemilu.org#22742,"BUMI RESTU, PALAS, LAMPUNG SELATAN, LAMPUNG",6,166,20,186
https://kawalpemilu.org#22742,"BUMI RESTU, PALAS, LAMPUNG SELATAN, LAMPUNG",7,181,12,193
https://kawalpemilu.org#22742,"BUMI RESTU, PALAS, LAMPUNG SELATAN, LAMPUNG",8,177,9,186
https://kawalpemilu.org#22742,"BUMI RESTU, PALAS, LAMPUNG SELATAN, LAMPUNG",9,171,19,190
https://kawalpemilu.org#22742,"BUMI RESTU, PALAS, LAMPUNG SELATAN, LAMPUNG",10,190,20,210
https://kawalpemilu.org#22742,"BUMI RESTU, PALAS, LAMPUNG SELATAN, LAMPUNG",11,146,17,163
https://kawalpemilu.org#22742,"BUMI RESTU, PALAS, LAMPUNG SELATAN, LAMPUNG",12,156,17,173
https://kawalpemilu.org#22742,"BUMI RESTU, PALAS, LAMPUNG SELATAN, LAMPUNG",13,182,11,193
https://kawalpemilu.org#22742,"BUMI RESTU, PALAS, LAMPUNG SELATAN, LAMPUNG",14,164,11,2
https://kawalpemilu.org#22742,"BUMI RESTU, PALAS, LAMPUNG SELATAN, LAMPUNG",15,192,17,209
https://kawalpemilu.org#22743,"PEMATANG BARU, PALAS, LAMPUNG SELATAN, LAMPUNG",1,141,37,178
https://kawalpemilu.org#22743,"PEMATANG BARU, PALAS, LAMPUNG SELATAN, LAMPUNG",2,147,29,176
https://kawalpemilu.org#22743,"PEMATANG BARU, PALAS, LAMPUNG SELATAN, LAMPUNG",3,162,13,175
https://kawalpemilu.org#22743,"PEMATANG BARU, PALAS, LAMPUNG SELATAN, LAMPUNG",4,170,19,189
https://kawalpemilu.org#22744,"MEKAR MULYA, PALAS, LAMPUNG SELATAN, LAMPUNG",1,104,102,206
https://kawalpemilu.org#22744,"MEKAR MULYA, PALAS, LAMPUNG SELATAN, LAMPUNG",2,124,78,202
https://kawalpemilu.org#22744,"MEKAR MULYA, PALAS, LAMPUNG SELATAN, LAMPUNG",3,114,71,185
https://kawalpemilu.org#22744,"MEKAR MULYA, PALAS, LAMPUNG SELATAN, LAMPUNG",4,87,96,183
https://kawalpemilu.org#22744,"MEKAR MULYA, PALAS, LAMPUNG SELATAN, LAMPUNG",5,58,134,192
https://kawalpemilu.org#22744,"MEKAR MULYA, PALAS, LAMPUNG SELATAN, LAMPUNG",6,56,144,200
https://kawalpemilu.org#22744,"MEKAR MULYA, PALAS, LAMPUNG SELATAN, LAMPUNG",7,81,64,145
https://kawalpemilu.org#22744,"MEKAR MULYA, PALAS, LAMPUNG SELATAN, LAMPUNG",8,135,65,200
https://kawalpemilu.org#22744,"MEKAR MULYA, PALAS, LAMPUNG SELATAN, LAMPUNG",9,148,34,182
https://kawalpemilu.org#22744,"MEKAR MULYA, PALAS, LAMPUNG SELATAN, LAMPUNG",10,98,111,209
https://kawalpemilu.org#22744,"MEKAR MULYA, PALAS, LAMPUNG SELATAN, LAMPUNG",11,47,63,110
https://kawalpemilu.org#22744,"MEKAR MULYA, PALAS, LAMPUNG SELATAN, LAMPUNG",12,70,58,128
https://kawalpemilu.org#22744,"MEKAR MULYA, PALAS, LAMPUNG SELATAN, LAMPUNG",13,75,87,162
https://kawalpemilu.org#22744,"MEKAR MULYA, PALAS, LAMPUNG SELATAN, LAMPUNG",14,105,79,184
https://kawalpemilu.org#22744,"MEKAR MULYA, PALAS, LAMPUNG SELATAN, LAMPUNG",15,107,74,181
https://kawalpemilu.org#22745,"BUMI ASIH, PALAS, LAMPUNG SELATAN, LAMPUNG",1,171,55,226
https://kawalpemilu.org#22745,"BUMI ASIH, PALAS, LAMPUNG SELATAN, LAMPUNG",2,176,9,185
https://kawalpemilu.org#22745,"BUMI ASIH, PALAS, LAMPUNG SELATAN, LAMPUNG",3,124,37,161
https://kawalpemilu.org#22745,"BUMI ASIH, PALAS, LAMPUNG SELATAN, LAMPUNG",4,125,9,134
https://kawalpemilu.org#22746,"KALIREJO, PALAS, LAMPUNG SELATAN, LAMPUNG",1,139,63,202
https://kawalpemilu.org#22746,"KALIREJO, PALAS, LAMPUNG SELATAN, LAMPUNG",2,139,20,159
https://kawalpemilu.org#22746,"KALIREJO, PALAS, LAMPUNG SELATAN, LAMPUNG",3,171,14,185
https://kawalpemilu.org#22746,"KALIREJO, PALAS, LAMPUNG SELATAN, LAMPUNG",4,152,44,196
https://kawalpemilu.org#22746,"KALIREJO, PALAS, LAMPUNG SELATAN, LAMPUNG",5,163,38,201
https://kawalpemilu.org#22746,"KALIREJO, PALAS, LAMPUNG SELATAN, LAMPUNG",6,175,32,207
https://kawalpemilu.org#22746,"KALIREJO, PALAS, LAMPUNG SELATAN, LAMPUNG",7,130,28,158
https://kawalpemilu.org#22746,"KALIREJO, PALAS, LAMPUNG SELATAN, LAMPUNG",8,132,49,181
https://kawalpemilu.org#22746,"KALIREJO, PALAS, LAMPUNG SELATAN, LAMPUNG",9,133,33,166
https://kawalpemilu.org#22746,"KALIREJO, PALAS, LAMPUNG SELATAN, LAMPUNG",10,156,17,173
https://kawalpemilu.org#22746,"KALIREJO, PALAS, LAMPUNG SELATAN, LAMPUNG",11,149,26,175
https://kawalpemilu.org#22747,"BUMI ASRI, PALAS, LAMPUNG SELATAN, LAMPUNG",1,139,16,155
https://kawalpemilu.org#22747,"BUMI ASRI, PALAS, LAMPUNG SELATAN, LAMPUNG",2,135,19,154
https://kawalpemilu.org#22747,"BUMI ASRI, PALAS, LAMPUNG SELATAN, LAMPUNG",3,70,22,92
https://kawalpemilu.org#22747,"BUMI ASRI, PALAS, LAMPUNG SELATAN, LAMPUNG",4,113,14,127
https://kawalpemilu.org#22748,"PULAU JAYA, PALAS, LAMPUNG SELATAN, LAMPUNG",1,181,3,184
https://kawalpemilu.org#22748,"PULAU JAYA, PALAS, LAMPUNG SELATAN, LAMPUNG",2,177,10,187
https://kawalpemilu.org#22748,"PULAU JAYA, PALAS, LAMPUNG SELATAN, LAMPUNG",3,169,7,176
https://kawalpemilu.org#22748,"PULAU JAYA, PALAS, LAMPUNG SELATAN, LAMPUNG",4,148,12,160
https://kawalpemilu.org#22748,"PULAU JAYA, PALAS, LAMPUNG SELATAN, LAMPUNG",5,161,18,179
https://kawalpemilu.org#22750,"WAY HUWI, JATI AGUNG, LAMPUNG SELATAN, LAMPUNG",1,90,73,163
https://kawalpemilu.org#22750,"WAY HUWI, JATI AGUNG, LAMPUNG SELATAN, LAMPUNG",2,105,156,261
https://kawalpemilu.org#22750,"WAY HUWI, JATI AGUNG, LAMPUNG SELATAN, LAMPUNG",3,139,91,230
https://kawalpemilu.org#22750,"WAY HUWI, JATI AGUNG, LAMPUNG SELATAN, LAMPUNG",4,63,103,166
https://kawalpemilu.org#22750,"WAY HUWI, JATI AGUNG, LAMPUNG SELATAN, LAMPUNG",5,122,77,199
https://kawalpemilu.org#22750,"WAY HUWI, JATI AGUNG, LAMPUNG SELATAN, LAMPUNG",6,72,71,143
https://kawalpemilu.org#22750,"WAY HUWI, JATI AGUNG, LAMPUNG SELATAN, LAMPUNG",7,110,125,235
https://kawalpemilu.org#22750,"WAY HUWI, JATI AGUNG, LAMPUNG SELATAN, LAMPUNG",9,92,88,180
https://kawalpemilu.org#22750,"WAY HUWI, JATI AGUNG, LAMPUNG SELATAN, LAMPUNG",10,83,79,162
https://kawalpemilu.org#22750,"WAY HUWI, JATI AGUNG, LAMPUNG SELATAN, LAMPUNG",11,76,71,147
https://kawalpemilu.org#22750,"WAY HUWI, JATI AGUNG, LAMPUNG SELATAN, LAMPUNG",12,96,119,215
https://kawalpemilu.org#22750,"WAY HUWI, JATI AGUNG, LAMPUNG SELATAN, LAMPUNG",13,105,84,189
https://kawalpemilu.org#22750,"WAY HUWI, JATI AGUNG, LAMPUNG SELATAN, LAMPUNG",14,108,84,192
https://kawalpemilu.org#22750,"WAY HUWI, JATI AGUNG, LAMPUNG SELATAN, LAMPUNG",15,136,79,215
https://kawalpemilu.org#22750,"WAY HUWI, JATI AGUNG, LAMPUNG SELATAN, LAMPUNG",16,98,72,170
https://kawalpemilu.org#22750,"WAY HUWI, JATI AGUNG, LAMPUNG SELATAN, LAMPUNG",17,97,38,135
https://kawalpemilu.org#22750,"WAY HUWI, JATI AGUNG, LAMPUNG SELATAN, LAMPUNG",18,62,138,200
https://kawalpemilu.org#22750,"WAY HUWI, JATI AGUNG, LAMPUNG SELATAN, LAMPUNG",19,43,80,123
https://kawalpemilu.org#22750,"WAY HUWI, JATI AGUNG, LAMPUNG SELATAN, LAMPUNG",20,37,74,111
https://kawalpemilu.org#22750,"WAY HUWI, JATI AGUNG, LAMPUNG SELATAN, LAMPUNG",21,74,97,171
https://kawalpemilu.org#22750,"WAY HUWI, JATI AGUNG, LAMPUNG SELATAN, LAMPUNG",22,102,158,260
https://kawalpemilu.org#22750,"WAY HUWI, JATI AGUNG, LAMPUNG SELATAN, LAMPUNG",23,100,66,166
https://kawalpemilu.org#22750,"WAY HUWI, JATI AGUNG, LAMPUNG SELATAN, LAMPUNG",24,140,73,213
https://kawalpemilu.org#22750,"WAY HUWI, JATI AGUNG, LAMPUNG SELATAN, LAMPUNG",25,109,75,184
https://kawalpemilu.org#22750,"WAY HUWI, JATI AGUNG, LAMPUNG SELATAN, LAMPUNG",26,56,102,158
https://kawalpemilu.org#22750,"WAY HUWI, JATI AGUNG, LAMPUNG SELATAN, LAMPUNG",27,36,61,99
https://kawalpemilu.org#22750,"WAY HUWI, JATI AGUNG, LAMPUNG SELATAN, LAMPUNG",28,85,65,150
https://kawalpemilu.org#22750,"WAY HUWI, JATI AGUNG, LAMPUNG SELATAN, LAMPUNG",29,49,56,105
https://kawalpemilu.org#22750,"WAY HUWI, JATI AGUNG, LAMPUNG SELATAN, LAMPUNG",30,65,42,107
https://kawalpemilu.org#22750,"WAY HUWI, JATI AGUNG, LAMPUNG SELATAN, LAMPUNG",31,96,104,200
https://kawalpemilu.org#22750,"WAY HUWI, JATI AGUNG, LAMPUNG SELATAN, LAMPUNG",32,155,83,238
https://kawalpemilu.org#22750,"WAY HUWI, JATI AGUNG, LAMPUNG SELATAN, LAMPUNG",33,117,112,229
https://kawalpemilu.org#22750,"WAY HUWI, JATI AGUNG, LAMPUNG SELATAN, LAMPUNG",34,41,53,94
https://kawalpemilu.org#22750,"WAY HUWI, JATI AGUNG, LAMPUNG SELATAN, LAMPUNG",35,63,63,126
https://kawalpemilu.org#22750,"WAY HUWI, JATI AGUNG, LAMPUNG SELATAN, LAMPUNG",36,20,46,66
https://kawalpemilu.org#22750,"WAY HUWI, JATI AGUNG, LAMPUNG SELATAN, LAMPUNG",37,68,52,120
https://kawalpemilu.org#22750,"WAY HUWI, JATI AGUNG, LAMPUNG SELATAN, LAMPUNG",38,56,89,145
https://kawalpemilu.org#22750,"WAY HUWI, JATI AGUNG, LAMPUNG SELATAN, LAMPUNG",39,95,77,172
https://kawalpemilu.org#22750,"WAY HUWI, JATI AGUNG, LAMPUNG SELATAN, LAMPUNG",40,58,151,209
https://kawalpemilu.org#22750,"WAY HUWI, JATI AGUNG, LAMPUNG SELATAN, LAMPUNG",41,55,104,159
https://kawalpemilu.org#22750,"WAY HUWI, JATI AGUNG, LAMPUNG SELATAN, LAMPUNG",42,32,48,80
https://kawalpemilu.org#22750,"WAY HUWI, JATI AGUNG, LAMPUNG SELATAN, LAMPUNG",43,59,69,128
https://kawalpemilu.org#22750,"WAY HUWI, JATI AGUNG, LAMPUNG SELATAN, LAMPUNG",44,118,34,152
https://kawalpemilu.org#22751,"SIDODADI ASRI, JATI AGUNG, LAMPUNG SELATAN, LAMPUNG",1,180,21,201
https://kawalpemilu.org#22751,"SIDODADI ASRI, JATI AGUNG, LAMPUNG SELATAN, LAMPUNG",2,170,42,212
https://kawalpemilu.org#22751,"SIDODADI ASRI, JATI AGUNG, LAMPUNG SELATAN, LAMPUNG",3,173,31,204
https://kawalpemilu.org#22751,"SIDODADI ASRI, JATI AGUNG, LAMPUNG SELATAN, LAMPUNG",4,94,80,174
https://kawalpemilu.org#22751,"SIDODADI ASRI, JATI AGUNG, LAMPUNG SELATAN, LAMPUNG",5,106,29,135
https://kawalpemilu.org#22751,"SIDODADI ASRI, JATI AGUNG, LAMPUNG SELATAN, LAMPUNG",6,166,43,209
https://kawalpemilu.org#22751,"SIDODADI ASRI, JATI AGUNG, LAMPUNG SELATAN, LAMPUNG",7,135,54,189
https://kawalpemilu.org#22751,"SIDODADI ASRI, JATI AGUNG, LAMPUNG SELATAN, LAMPUNG",8,192,10,202
https://kawalpemilu.org#22751,"SIDODADI ASRI, JATI AGUNG, LAMPUNG SELATAN, LAMPUNG",9,156,5,161
https://kawalpemilu.org#22751,"SIDODADI ASRI, JATI AGUNG, LAMPUNG SELATAN, LAMPUNG",10,183,30,213
https://kawalpemilu.org#22751,"SIDODADI ASRI, JATI AGUNG, LAMPUNG SELATAN, LAMPUNG",11,156,30,186
https://kawalpemilu.org#22751,"SIDODADI ASRI, JATI AGUNG, LAMPUNG SELATAN, LAMPUNG",12,108,20,128
https://kawalpemilu.org#22751,"SIDODADI ASRI, JATI AGUNG, LAMPUNG SELATAN, LAMPUNG",13,159,30,189
https://kawalpemilu.org#22751,"SIDODADI ASRI, JATI AGUNG, LAMPUNG SELATAN, LAMPUNG",14,90,74,164
https://kawalpemilu.org#22751,"SIDODADI ASRI, JATI AGUNG, LAMPUNG SELATAN, LAMPUNG",15,87,36,123
https://kawalpemilu.org#22751,"SIDODADI ASRI, JATI AGUNG, LAMPUNG SELATAN, LAMPUNG",17,159,65,224
https://kawalpemilu.org#22751,"SIDODADI ASRI, JATI AGUNG, LAMPUNG SELATAN, LAMPUNG",18,191,19,210
https://kawalpemilu.org#22751,"SIDODADI ASRI, JATI AGUNG, LAMPUNG SELATAN, LAMPUNG",19,177,7,184
https://kawalpemilu.org#22752,"MARGO MULYO, JATI AGUNG, LAMPUNG SELATAN, LAMPUNG",1,89,99,188
https://kawalpemilu.org#22752,"MARGO MULYO, JATI AGUNG, LAMPUNG SELATAN, LAMPUNG",2,121,75,196
https://kawalpemilu.org#22752,"MARGO MULYO, JATI AGUNG, LAMPUNG SELATAN, LAMPUNG",3,158,43,201
https://kawalpemilu.org#22752,"MARGO MULYO, JATI AGUNG, LAMPUNG SELATAN, LAMPUNG",4,89,99,188
https://kawalpemilu.org#22752,"MARGO MULYO, JATI AGUNG, LAMPUNG SELATAN, LAMPUNG",5,106,80,186
https://kawalpemilu.org#22752,"MARGO MULYO, JATI AGUNG, LAMPUNG SELATAN, LAMPUNG",6,101,56,157
https://kawalpemilu.org#22752,"MARGO MULYO, JATI AGUNG, LAMPUNG SELATAN, LAMPUNG",7,166,48,214
https://kawalpemilu.org#22752,"MARGO MULYO, JATI AGUNG, LAMPUNG SELATAN, LAMPUNG",8,121,69,190
https://kawalpemilu.org#22752,"MARGO MULYO, JATI AGUNG, LAMPUNG SELATAN, LAMPUNG",9,139,55,194
https://kawalpemilu.org#22753,"GEDUNG AGUNG, JATI AGUNG, LAMPUNG SELATAN, LAMPUNG",1,113,18,131
https://kawalpemilu.org#22753,"GEDUNG AGUNG, JATI AGUNG, LAMPUNG SELATAN, LAMPUNG",2,91,103,194
https://kawalpemilu.org#22753,"GEDUNG AGUNG, JATI AGUNG, LAMPUNG SELATAN, LAMPUNG",3,101,68,169
https://kawalpemilu.org#22753,"GEDUNG AGUNG, JATI AGUNG, LAMPUNG SELATAN, LAMPUNG",4,150,47,197
https://kawalpemilu.org#22753,"GEDUNG AGUNG, JATI AGUNG, LAMPUNG SELATAN, LAMPUNG",5,129,62,191
https://kawalpemilu.org#22753,"GEDUNG AGUNG, JATI AGUNG, LAMPUNG SELATAN, LAMPUNG",6,126,53,179
https://kawalpemilu.org#22754,"MARGODADI, JATI AGUNG, LAMPUNG SELATAN, LAMPUNG",1,189,34,223
https://kawalpemilu.org#22754,"MARGODADI, JATI AGUNG, LAMPUNG SELATAN, LAMPUNG",2,176,27,203
https://kawalpemilu.org#22754,"MARGODADI, JATI AGUNG, LAMPUNG SELATAN, LAMPUNG",3,101,92,193
https://kawalpemilu.org#22754,"MARGODADI, JATI AGUNG, LAMPUNG SELATAN, LAMPUNG",4,186,39,225
https://kawalpemilu.org#22754,"MARGODADI, JATI AGUNG, LAMPUNG SELATAN, LAMPUNG",5,171,38,209
https://kawalpemilu.org#22754,"MARGODADI, JATI AGUNG, LAMPUNG SELATAN, LAMPUNG",6,92,48,140
https://kawalpemilu.org#22754,"MARGODADI, JATI AGUNG, LAMPUNG SELATAN, LAMPUNG",7,98,88,186
https://kawalpemilu.org#22754,"MARGODADI, JATI AGUNG, LAMPUNG SELATAN, LAMPUNG",8,67,126,193
https://kawalpemilu.org#22754,"MARGODADI, JATI AGUNG, LAMPUNG SELATAN, LAMPUNG",9,89,87,176
https://kawalpemilu.org#22755,"GEDUNG HARAPAN, JATI AGUNG, LAMPUNG SELATAN, LAMPUNG",1,70,103,174
https://kawalpemilu.org#22755,"GEDUNG HARAPAN, JATI AGUNG, LAMPUNG SELATAN, LAMPUNG",2,97,97,194
https://kawalpemilu.org#22756,"MARGA AGUNG, JATI AGUNG, LAMPUNG SELATAN, LAMPUNG",1,160,54,214
https://kawalpemilu.org#22756,"MARGA AGUNG, JATI AGUNG, LAMPUNG SELATAN, LAMPUNG",2,180,47,227
https://kawalpemilu.org#22756,"MARGA AGUNG, JATI AGUNG, LAMPUNG SELATAN, LAMPUNG",3,87,139,226
https://kawalpemilu.org#22756,"MARGA AGUNG, JATI AGUNG, LAMPUNG SELATAN, LAMPUNG",4,170,50,220
https://kawalpemilu.org#22756,"MARGA AGUNG, JATI AGUNG, LAMPUNG SELATAN, LAMPUNG",5,137,88,225
https://kawalpemilu.org#22756,"MARGA AGUNG, JATI AGUNG, LAMPUNG SELATAN, LAMPUNG",6,160,29,189
https://kawalpemilu.org#22756,"MARGA AGUNG, JATI AGUNG, LAMPUNG SELATAN, LAMPUNG",7,177,63,240
https://kawalpemilu.org#22756,"MARGA AGUNG, JATI AGUNG, LAMPUNG SELATAN, LAMPUNG",8,181,52,233
https://kawalpemilu.org#22756,"MARGA AGUNG, JATI AGUNG, LAMPUNG SELATAN, LAMPUNG",9,107,107,214
https://kawalpemilu.org#22756,"MARGA AGUNG, JATI AGUNG, LAMPUNG SELATAN, LAMPUNG",10,148,83,231
https://kawalpemilu.org#22756,"MARGA AGUNG, JATI AGUNG, LAMPUNG SELATAN, LAMPUNG",11,105,94,199
https://kawalpemilu.org#22756,"MARGA AGUNG, JATI AGUNG, LAMPUNG SELATAN, LAMPUNG",12,135,36,171
https://kawalpemilu.org#22756,"MARGA AGUNG, JATI AGUNG, LAMPUNG SELATAN, LAMPUNG",13,150,56,206
https://kawalpemilu.org#22757,"JATI MULYO, JATI AGUNG, LAMPUNG SELATAN, LAMPUNG",1,144,73,217
https://kawalpemilu.org#22757,"JATI MULYO, JATI AGUNG, LAMPUNG SELATAN, LAMPUNG",2,167,90,257
https://kawalpemilu.org#22757,"JATI MULYO, JATI AGUNG, LAMPUNG SELATAN, LAMPUNG",3,133,87,220
https://kawalpemilu.org#22757,"JATI MULYO, JATI AGUNG, LAMPUNG SELATAN, LAMPUNG",4,87,94,181
https://kawalpemilu.org#22757,"JATI MULYO, JATI AGUNG, LAMPUNG SELATAN, LAMPUNG",5,160,84,244
https://kawalpemilu.org#22757,"JATI MULYO, JATI AGUNG, LAMPUNG SELATAN, LAMPUNG",6,156,100,256
https://kawalpemilu.org#22757,"JATI MULYO, JATI AGUNG, LAMPUNG SELATAN, LAMPUNG",7,145,139,284
https://kawalpemilu.org#22757,"JATI MULYO, JATI AGUNG, LAMPUNG SELATAN, LAMPUNG",8,143,68,211
https://kawalpemilu.org#22757,"JATI MULYO, JATI AGUNG, LAMPUNG SELATAN, LAMPUNG",9,189,68,257
https://kawalpemilu.org#22757,"JATI MULYO, JATI AGUNG, LAMPUNG SELATAN, LAMPUNG",10,133,83,216
https://kawalpemilu.org#22757,"JATI MULYO, JATI AGUNG, LAMPUNG SELATAN, LAMPUNG",11,166,134,300
https://kawalpemilu.org#22757,"JATI MULYO, JATI AGUNG, LAMPUNG SELATAN, LAMPUNG",12,134,161,295
https://kawalpemilu.org#22757,"JATI MULYO, JATI AGUNG, LAMPUNG SELATAN, LAMPUNG",13,143,66,209
https://kawalpemilu.org#22757,"JATI MULYO, JATI AGUNG, LAMPUNG SELATAN, LAMPUNG",14,212,59,271
https://kawalpemilu.org#22757,"JATI MULYO, JATI AGUNG, LAMPUNG SELATAN, LAMPUNG",15,142,118,260
https://kawalpemilu.org#22757,"JATI MULYO, JATI AGUNG, LAMPUNG SELATAN, LAMPUNG",16,126,88,214
https://kawalpemilu.org#22757,"JATI MULYO, JATI AGUNG, LAMPUNG SELATAN, LAMPUNG",17,133,111,244
https://kawalpemilu.org#22757,"JATI MULYO, JATI AGUNG, LAMPUNG SELATAN, LAMPUNG",18,162,68,230
https://kawalpemilu.org#22757,"JATI MULYO, JATI AGUNG, LAMPUNG SELATAN, LAMPUNG",19,183,40,223
https://kawalpemilu.org#22757,"JATI MULYO, JATI AGUNG, LAMPUNG SELATAN, LAMPUNG",20,127,85,212
https://kawalpemilu.org#22757,"JATI MULYO, JATI AGUNG, LAMPUNG SELATAN, LAMPUNG",21,123,86,209
https://kawalpemilu.org#22757,"JATI MULYO, JATI AGUNG, LAMPUNG SELATAN, LAMPUNG",22,161,49,210
https://kawalpemilu.org#22757,"JATI MULYO, JATI AGUNG, LAMPUNG SELATAN, LAMPUNG",24,148,80,228
https://kawalpemilu.org#22757,"JATI MULYO, JATI AGUNG, LAMPUNG SELATAN, LAMPUNG",25,96,41,137
https://kawalpemilu.org#22757,"JATI MULYO, JATI AGUNG, LAMPUNG SELATAN, LAMPUNG",26,93,50,143
https://kawalpemilu.org#22757,"JATI MULYO, JATI AGUNG, LAMPUNG SELATAN, LAMPUNG",27,110,73,183
https://kawalpemilu.org#22757,"JATI MULYO, JATI AGUNG, LAMPUNG SELATAN, LAMPUNG",29,118,50,168
https://kawalpemilu.org#22757,"JATI MULYO, JATI AGUNG, LAMPUNG SELATAN, LAMPUNG",30,141,73,214
https://kawalpemilu.org#22757,"JATI MULYO, JATI AGUNG, LAMPUNG SELATAN, LAMPUNG",31,158,82,240
https://kawalpemilu.org#22757,"JATI MULYO, JATI AGUNG, LAMPUNG SELATAN, LAMPUNG",32,169,49,218
https://kawalpemilu.org#22757,"JATI MULYO, JATI AGUNG, LAMPUNG SELATAN, LAMPUNG",33,167,79,246
https://kawalpemilu.org#22757,"JATI MULYO, JATI AGUNG, LAMPUNG SELATAN, LAMPUNG",34,125,127,252
https://kawalpemilu.org#22757,"JATI MULYO, JATI AGUNG, LAMPUNG SELATAN, LAMPUNG",35,94,88,182
https://kawalpemilu.org#22757,"JATI MULYO, JATI AGUNG, LAMPUNG SELATAN, LAMPUNG",36,150,102,252
https://kawalpemilu.org#22757,"JATI MULYO, JATI AGUNG, LAMPUNG SELATAN, LAMPUNG",37,176,76,252
https://kawalpemilu.org#22757,"JATI MULYO, JATI AGUNG, LAMPUNG SELATAN, LAMPUNG",38,182,61,243
https://kawalpemilu.org#22757,"JATI MULYO, JATI AGUNG, LAMPUNG SELATAN, LAMPUNG",39,182,72,254
https://kawalpemilu.org#22757,"JATI MULYO, JATI AGUNG, LAMPUNG SELATAN, LAMPUNG",40,140,38,178
https://kawalpemilu.org#22757,"JATI MULYO, JATI AGUNG, LAMPUNG SELATAN, LAMPUNG",41,120,70,190
https://kawalpemilu.org#22757,"JATI MULYO, JATI AGUNG, LAMPUNG SELATAN, LAMPUNG",42,151,73,224
https://kawalpemilu.org#22757,"JATI MULYO, JATI AGUNG, LAMPUNG SELATAN, LAMPUNG",43,161,85,246
https://kawalpemilu.org#22758,"FAJAR BARU, JATI AGUNG, LAMPUNG SELATAN, LAMPUNG",1,88,44,132
https://kawalpemilu.org#22758,"FAJAR BARU, JATI AGUNG, LAMPUNG SELATAN, LAMPUNG",2,62,62,124
https://kawalpemilu.org#22758,"FAJAR BARU, JATI AGUNG, LAMPUNG SELATAN, LAMPUNG",3,89,164,253
https://kawalpemilu.org#22758,"FAJAR BARU, JATI AGUNG, LAMPUNG SELATAN, LAMPUNG",4,71,104,175
https://kawalpemilu.org#22758,"FAJAR BARU, JATI AGUNG, LAMPUNG SELATAN, LAMPUNG",5,82,97,179
https://kawalpemilu.org#22758,"FAJAR BARU, JATI AGUNG, LAMPUNG SELATAN, LAMPUNG",6,65,80,145
https://kawalpemilu.org#22758,"FAJAR BARU, JATI AGUNG, LAMPUNG SELATAN, LAMPUNG",7,102,90,192
https://kawalpemilu.org#22758,"FAJAR BARU, JATI AGUNG, LAMPUNG SELATAN, LAMPUNG",8,165,34,199
https://kawalpemilu.org#22758,"FAJAR BARU, JATI AGUNG, LAMPUNG SELATAN, LAMPUNG",9,140,68,208
https://kawalpemilu.org#22758,"FAJAR BARU, JATI AGUNG, LAMPUNG SELATAN, LAMPUNG",10,124,54,178
https://kawalpemilu.org#22758,"FAJAR BARU, JATI AGUNG, LAMPUNG SELATAN, LAMPUNG",11,130,50,180
https://kawalpemilu.org#22758,"FAJAR BARU, JATI AGUNG, LAMPUNG SELATAN, LAMPUNG",12,95,63,158
https://kawalpemilu.org#22758,"FAJAR BARU, JATI AGUNG, LAMPUNG SELATAN, LAMPUNG",13,99,65,164
https://kawalpemilu.org#22758,"FAJAR BARU, JATI AGUNG, LAMPUNG SELATAN, LAMPUNG",14,98,126,224
https://kawalpemilu.org#22758,"FAJAR BARU, JATI AGUNG, LAMPUNG SELATAN, LAMPUNG",15,109,124,233
https://kawalpemilu.org#22758,"FAJAR BARU, JATI AGUNG, LAMPUNG SELATAN, LAMPUNG",16,67,115,182
https://kawalpemilu.org#22758,"FAJAR BARU, JATI AGUNG, LAMPUNG SELATAN, LAMPUNG",17,68,63,131
https://kawalpemilu.org#22758,"FAJAR BARU, JATI AGUNG, LAMPUNG SELATAN, LAMPUNG",19,79,96,175
https://kawalpemilu.org#22758,"FAJAR BARU, JATI AGUNG, LAMPUNG SELATAN, LAMPUNG",20,87,75,162
https://kawalpemilu.org#22758,"FAJAR BARU, JATI AGUNG, LAMPUNG SELATAN, LAMPUNG",21,141,63,204
https://kawalpemilu.org#22758,"FAJAR BARU, JATI AGUNG, LAMPUNG SELATAN, LAMPUNG",22,163,51,214
https://kawalpemilu.org#22759,"KARANG ANYAR, JATI AGUNG, LAMPUNG SELATAN, LAMPUNG",1,156,80,236
https://kawalpemilu.org#22759,"KARANG ANYAR, JATI AGUNG, LAMPUNG SELATAN, LAMPUNG",2,169,89,258
https://kawalpemilu.org#22759,"KARANG ANYAR, JATI AGUNG, LAMPUNG SELATAN, LAMPUNG",3,187,35,222
https://kawalpemilu.org#22759,"KARANG ANYAR, JATI AGUNG, LAMPUNG SELATAN, LAMPUNG",4,189,95,284
https://kawalpemilu.org#22759,"KARANG ANYAR, JATI AGUNG, LAMPUNG SELATAN, LAMPUNG",6,184,61,245
https://kawalpemilu.org#22759,"KARANG ANYAR, JATI AGUNG, LAMPUNG SELATAN, LAMPUNG",7,160,59,219
https://kawalpemilu.org#22759,"KARANG ANYAR, JATI AGUNG, LAMPUNG SELATAN, LAMPUNG",8,106,79,185
https://kawalpemilu.org#22759,"KARANG ANYAR, JATI AGUNG, LAMPUNG SELATAN, LAMPUNG",9,113,154,267
https://kawalpemilu.org#22759,"KARANG ANYAR, JATI AGUNG, LAMPUNG SELATAN, LAMPUNG",10,125,119,244
https://kawalpemilu.org#22759,"KARANG ANYAR, JATI AGUNG, LAMPUNG SELATAN, LAMPUNG",11,133,71,204
https://kawalpemilu.org#22759,"KARANG ANYAR, JATI AGUNG, LAMPUNG SELATAN, LAMPUNG",13,166,77,243
https://kawalpemilu.org#22759,"KARANG ANYAR, JATI AGUNG, LAMPUNG SELATAN, LAMPUNG",14,181,83,264
https://kawalpemilu.org#22759,"KARANG ANYAR, JATI AGUNG, LAMPUNG SELATAN, LAMPUNG",15,173,47,220
https://kawalpemilu.org#22759,"KARANG ANYAR, JATI AGUNG, LAMPUNG SELATAN, LAMPUNG",16,158,54,212
https://kawalpemilu.org#22759,"KARANG ANYAR, JATI AGUNG, LAMPUNG SELATAN, LAMPUNG",17,152,58,210
https://kawalpemilu.org#22759,"KARANG ANYAR, JATI AGUNG, LAMPUNG SELATAN, LAMPUNG",18,177,29,206
https://kawalpemilu.org#22759,"KARANG ANYAR, JATI AGUNG, LAMPUNG SELATAN, LAMPUNG",19,110,128,238
https://kawalpemilu.org#22759,"KARANG ANYAR, JATI AGUNG, LAMPUNG SELATAN, LAMPUNG",20,54,72,126
https://kawalpemilu.org#22759,"KARANG ANYAR, JATI AGUNG, LAMPUNG SELATAN, LAMPUNG",21,110,137,247
https://kawalpemilu.org#22759,"KARANG ANYAR, JATI AGUNG, LAMPUNG SELATAN, LAMPUNG",22,126,68,194
https://kawalpemilu.org#22759,"KARANG ANYAR, JATI AGUNG, LAMPUNG SELATAN, LAMPUNG",23,139,134,273
https://kawalpemilu.org#22759,"KARANG ANYAR, JATI AGUNG, LAMPUNG SELATAN, LAMPUNG",24,155,99,254
https://kawalpemilu.org#22759,"KARANG ANYAR, JATI AGUNG, LAMPUNG SELATAN, LAMPUNG",25,146,86,232
https://kawalpemilu.org#22759,"KARANG ANYAR, JATI AGUNG, LAMPUNG SELATAN, LAMPUNG",26,178,38,216
https://kawalpemilu.org#22759,"KARANG ANYAR, JATI AGUNG, LAMPUNG SELATAN, LAMPUNG",27,106,59,165
https://kawalpemilu.org#22759,"KARANG ANYAR, JATI AGUNG, LAMPUNG SELATAN, LAMPUNG",28,158,51,209
https://kawalpemilu.org#22759,"KARANG ANYAR, JATI AGUNG, LAMPUNG SELATAN, LAMPUNG",29,144,63,207
https://kawalpemilu.org#22759,"KARANG ANYAR, JATI AGUNG, LAMPUNG SELATAN, LAMPUNG",30,148,64,212
https://kawalpemilu.org#22759,"KARANG ANYAR, JATI AGUNG, LAMPUNG SELATAN, LAMPUNG",31,93,40,133
https://kawalpemilu.org#22759,"KARANG ANYAR, JATI AGUNG, LAMPUNG SELATAN, LAMPUNG",32,141,96,237
https://kawalpemilu.org#22759,"KARANG ANYAR, JATI AGUNG, LAMPUNG SELATAN, LAMPUNG",33,140,67,207
https://kawalpemilu.org#22759,"KARANG ANYAR, JATI AGUNG, LAMPUNG SELATAN, LAMPUNG",34,142,83,225
https://kawalpemilu.org#22759,"KARANG ANYAR, JATI AGUNG, LAMPUNG SELATAN, LAMPUNG",35,132,75,211
https://kawalpemilu.org#22759,"KARANG ANYAR, JATI AGUNG, LAMPUNG SELATAN, LAMPUNG",36,123,69,192
https://kawalpemilu.org#22759,"KARANG ANYAR, JATI AGUNG, LAMPUNG SELATAN, LAMPUNG",37,117,31,148
https://kawalpemilu.org#22759,"KARANG ANYAR, JATI AGUNG, LAMPUNG SELATAN, LAMPUNG",38,133,47,180
https://kawalpemilu.org#22759,"KARANG ANYAR, JATI AGUNG, LAMPUNG SELATAN, LAMPUNG",39,148,42,190
https://kawalpemilu.org#22759,"KARANG ANYAR, JATI AGUNG, LAMPUNG SELATAN, LAMPUNG",40,180,29,209
https://kawalpemilu.org#22759,"KARANG ANYAR, JATI AGUNG, LAMPUNG SELATAN, LAMPUNG",41,165,19,184
https://kawalpemilu.org#22759,"KARANG ANYAR, JATI AGUNG, LAMPUNG SELATAN, LAMPUNG",42,141,38,179
https://kawalpemilu.org#22759,"KARANG ANYAR, JATI AGUNG, LAMPUNG SELATAN, LAMPUNG",43,65,22,87
https://kawalpemilu.org#22759,"KARANG ANYAR, JATI AGUNG, LAMPUNG SELATAN, LAMPUNG",44,158,27,185
https://kawalpemilu.org#22759,"KARANG ANYAR, JATI AGUNG, LAMPUNG SELATAN, LAMPUNG",45,90,87,177
https://kawalpemilu.org#22759,"KARANG ANYAR, JATI AGUNG, LAMPUNG SELATAN, LAMPUNG",46,95,113,208
https://kawalpemilu.org#22760,"MARGA KAYA, JATI AGUNG, LAMPUNG SELATAN, LAMPUNG",1,122,64,186
https://kawalpemilu.org#22760,"MARGA KAYA, JATI AGUNG, LAMPUNG SELATAN, LAMPUNG",2,158,49,207
https://kawalpemilu.org#22760,"MARGA KAYA, JATI AGUNG, LAMPUNG SELATAN, LAMPUNG",3,217,26,243
https://kawalpemilu.org#22760,"MARGA KAYA, JATI AGUNG, LAMPUNG SELATAN, LAMPUNG",4,164,82,246
https://kawalpemilu.org#22760,"MARGA KAYA, JATI AGUNG, LAMPUNG SELATAN, LAMPUNG",5,211,25,236
https://kawalpemilu.org#22760,"MARGA KAYA, JATI AGUNG, LAMPUNG SELATAN, LAMPUNG",6,201,29,230
https://kawalpemilu.org#22760,"MARGA KAYA, JATI AGUNG, LAMPUNG SELATAN, LAMPUNG",7,168,32,200
https://kawalpemilu.org#22760,"MARGA KAYA, JATI AGUNG, LAMPUNG SELATAN, LAMPUNG",8,153,30,183
https://kawalpemilu.org#22760,"MARGA KAYA, JATI AGUNG, LAMPUNG SELATAN, LAMPUNG",9,144,18,162
https://kawalpemilu.org#22760,"MARGA KAYA, JATI AGUNG, LAMPUNG SELATAN, LAMPUNG",10,119,38,157
https://kawalpemilu.org#22760,"MARGA KAYA, JATI AGUNG, LAMPUNG SELATAN, LAMPUNG",11,163,20,183
https://kawalpemilu.org#22761,"MARGO LESTARI, JATI AGUNG, LAMPUNG SELATAN, LAMPUNG",1,165,67,232
https://kawalpemilu.org#22761,"MARGO LESTARI, JATI AGUNG, LAMPUNG SELATAN, LAMPUNG",2,180,37,217
https://kawalpemilu.org#22761,"MARGO LESTARI, JATI AGUNG, LAMPUNG SELATAN, LAMPUNG",3,211,16,227
https://kawalpemilu.org#22761,"MARGO LESTARI, JATI AGUNG, LAMPUNG SELATAN, LAMPUNG",4,184,11,195
https://kawalpemilu.org#22761,"MARGO LESTARI, JATI AGUNG, LAMPUNG SELATAN, LAMPUNG",5,114,15,129
https://kawalpemilu.org#22761,"MARGO LESTARI, JATI AGUNG, LAMPUNG SELATAN, LAMPUNG",6,163,41,204
https://kawalpemilu.org#22761,"MARGO LESTARI, JATI AGUNG, LAMPUNG SELATAN, LAMPUNG",7,173,25,198
https://kawalpemilu.org#22761,"MARGO LESTARI, JATI AGUNG, LAMPUNG SELATAN, LAMPUNG",8,194,15,209
https://kawalpemilu.org#22761,"MARGO LESTARI, JATI AGUNG, LAMPUNG SELATAN, LAMPUNG",9,127,5,132
https://kawalpemilu.org#22762,"SUMBER JAYA, JATI AGUNG, LAMPUNG SELATAN, LAMPUNG",1,128,64,192
https://kawalpemilu.org#22762,"SUMBER JAYA, JATI AGUNG, LAMPUNG SELATAN, LAMPUNG",2,138,14,152
https://kawalpemilu.org#22762,"SUMBER JAYA, JATI AGUNG, LAMPUNG SELATAN, LAMPUNG",3,176,23,199
https://kawalpemilu.org#22762,"SUMBER JAYA, JATI AGUNG, LAMPUNG SELATAN, LAMPUNG",4,175,24,199
https://kawalpemilu.org#22762,"SUMBER JAYA, JATI AGUNG, LAMPUNG SELATAN, LAMPUNG",5,136,19,155
https://kawalpemilu.org#22762,"SUMBER JAYA, JATI AGUNG, LAMPUNG SELATAN, LAMPUNG",6,147,67,214
https://kawalpemilu.org#22762,"SUMBER JAYA, JATI AGUNG, LAMPUNG SELATAN, LAMPUNG",7,170,33,203
https://kawalpemilu.org#22762,"SUMBER JAYA, JATI AGUNG, LAMPUNG SELATAN, LAMPUNG",8,133,23,156
https://kawalpemilu.org#22762,"SUMBER JAYA, JATI AGUNG, LAMPUNG SELATAN, LAMPUNG",9,140,46,186
https://kawalpemilu.org#22762,"SUMBER JAYA, JATI AGUNG, LAMPUNG SELATAN, LAMPUNG",10,150,14,164
https://kawalpemilu.org#22762,"SUMBER JAYA, JATI AGUNG, LAMPUNG SELATAN, LAMPUNG",11,140,55,195
https://kawalpemilu.org#22762,"SUMBER JAYA, JATI AGUNG, LAMPUNG SELATAN, LAMPUNG",12,125,36,161
https://kawalpemilu.org#22762,"SUMBER JAYA, JATI AGUNG, LAMPUNG SELATAN, LAMPUNG",13,147,28,175
https://kawalpemilu.org#22762,"SUMBER JAYA, JATI AGUNG, LAMPUNG SELATAN, LAMPUNG",14,159,31,190
https://kawalpemilu.org#22763,"SINAR REJEKI, JATI AGUNG, LAMPUNG SELATAN, LAMPUNG",1,204,26,230
https://kawalpemilu.org#22763,"SINAR REJEKI, JATI AGUNG, LAMPUNG SELATAN, LAMPUNG",2,207,24,231
https://kawalpemilu.org#22763,"SINAR REJEKI, JATI AGUNG, LAMPUNG SELATAN, LAMPUNG",3,181,22,203
https://kawalpemilu.org#22763,"SINAR REJEKI, JATI AGUNG, LAMPUNG SELATAN, LAMPUNG",4,163,32,195
https://kawalpemilu.org#22763,"SINAR REJEKI, JATI AGUNG, LAMPUNG SELATAN, LAMPUNG",5,0,0,0
https://kawalpemilu.org#22763,"SINAR REJEKI, JATI AGUNG, LAMPUNG SELATAN, LAMPUNG",6,146,56,202
https://kawalpemilu.org#22763,"SINAR REJEKI, JATI AGUNG, LAMPUNG SELATAN, LAMPUNG",7,188,34,222
https://kawalpemilu.org#22763,"SINAR REJEKI, JATI AGUNG, LAMPUNG SELATAN, LAMPUNG",8,170,42,212
https://kawalpemilu.org#22763,"SINAR REJEKI, JATI AGUNG, LAMPUNG SELATAN, LAMPUNG",9,135,56,191
https://kawalpemilu.org#22763,"SINAR REJEKI, JATI AGUNG, LAMPUNG SELATAN, LAMPUNG",10,207,29,236
https://kawalpemilu.org#22763,"SINAR REJEKI, JATI AGUNG, LAMPUNG SELATAN, LAMPUNG",11,165,42,207
https://kawalpemilu.org#22763,"SINAR REJEKI, JATI AGUNG, LAMPUNG SELATAN, LAMPUNG",12,148,47,195
https://kawalpemilu.org#22763,"SINAR REJEKI, JATI AGUNG, LAMPUNG SELATAN, LAMPUNG",13,192,63,255
https://kawalpemilu.org#22763,"SINAR REJEKI, JATI AGUNG, LAMPUNG SELATAN, LAMPUNG",14,177,24,207
https://kawalpemilu.org#22763,"SINAR REJEKI, JATI AGUNG, LAMPUNG SELATAN, LAMPUNG",15,182,21,203
https://kawalpemilu.org#22763,"SINAR REJEKI, JATI AGUNG, LAMPUNG SELATAN, LAMPUNG",16,120,46,166
https://kawalpemilu.org#22763,"SINAR REJEKI, JATI AGUNG, LAMPUNG SELATAN, LAMPUNG",17,194,19,213
https://kawalpemilu.org#22763,"SINAR REJEKI, JATI AGUNG, LAMPUNG SELATAN, LAMPUNG",18,126,69,200
https://kawalpemilu.org#22763,"SINAR REJEKI, JATI AGUNG, LAMPUNG SELATAN, LAMPUNG",19,186,48,234
https://kawalpemilu.org#22763,"SINAR REJEKI, JATI AGUNG, LAMPUNG SELATAN, LAMPUNG",20,171,37,208
https://kawalpemilu.org#22763,"SINAR REJEKI, JATI AGUNG, LAMPUNG SELATAN, LAMPUNG",21,170,19,189
https://kawalpemilu.org#22764,"SIDOHARJO, JATI AGUNG, LAMPUNG SELATAN, LAMPUNG",1,173,60,233
https://kawalpemilu.org#22764,"SIDOHARJO, JATI AGUNG, LAMPUNG SELATAN, LAMPUNG",2,205,13,218
https://kawalpemilu.org#22764,"SIDOHARJO, JATI AGUNG, LAMPUNG SELATAN, LAMPUNG",3,112,100,212
https://kawalpemilu.org#22764,"SIDOHARJO, JATI AGUNG, LAMPUNG SELATAN, LAMPUNG",4,181,39,220
https://kawalpemilu.org#22764,"SIDOHARJO, JATI AGUNG, LAMPUNG SELATAN, LAMPUNG",5,127,18,145
https://kawalpemilu.org#22764,"SIDOHARJO, JATI AGUNG, LAMPUNG SELATAN, LAMPUNG",6,165,68,233
https://kawalpemilu.org#22764,"SIDOHARJO, JATI AGUNG, LAMPUNG SELATAN, LAMPUNG",7,156,58,214
https://kawalpemilu.org#22764,"SIDOHARJO, JATI AGUNG, LAMPUNG SELATAN, LAMPUNG",8,183,41,224
https://kawalpemilu.org#22764,"SIDOHARJO, JATI AGUNG, LAMPUNG SELATAN, LAMPUNG",9,131,41,172
https://kawalpemilu.org#22765,"REJOMULYO, JATI AGUNG, LAMPUNG SELATAN, LAMPUNG",1,134,84,218
https://kawalpemilu.org#22765,"REJOMULYO, JATI AGUNG, LAMPUNG SELATAN, LAMPUNG",2,128,85,213
https://kawalpemilu.org#22765,"REJOMULYO, JATI AGUNG, LAMPUNG SELATAN, LAMPUNG",3,154,81,0
https://kawalpemilu.org#22765,"REJOMULYO, JATI AGUNG, LAMPUNG SELATAN, LAMPUNG",4,132,82,214
https://kawalpemilu.org#22765,"REJOMULYO, JATI AGUNG, LAMPUNG SELATAN, LAMPUNG",5,129,99,228
https://kawalpemilu.org#22765,"REJOMULYO, JATI AGUNG, LAMPUNG SELATAN, LAMPUNG",6,131,80,211
https://kawalpemilu.org#22765,"REJOMULYO, JATI AGUNG, LAMPUNG SELATAN, LAMPUNG",7,167,59,226
https://kawalpemilu.org#22765,"REJOMULYO, JATI AGUNG, LAMPUNG SELATAN, LAMPUNG",8,128,93,221
https://kawalpemilu.org#22765,"REJOMULYO, JATI AGUNG, LAMPUNG SELATAN, LAMPUNG",10,157,32,189
https://kawalpemilu.org#22765,"REJOMULYO, JATI AGUNG, LAMPUNG SELATAN, LAMPUNG",11,57,156,213
https://kawalpemilu.org#22765,"REJOMULYO, JATI AGUNG, LAMPUNG SELATAN, LAMPUNG",12,131,90,221
https://kawalpemilu.org#22765,"REJOMULYO, JATI AGUNG, LAMPUNG SELATAN, LAMPUNG",13,162,42,204
https://kawalpemilu.org#22765,"REJOMULYO, JATI AGUNG, LAMPUNG SELATAN, LAMPUNG",14,102,103,205
https://kawalpemilu.org#22765,"REJOMULYO, JATI AGUNG, LAMPUNG SELATAN, LAMPUNG",15,145,61,206
https://kawalpemilu.org#22765,"REJOMULYO, JATI AGUNG, LAMPUNG SELATAN, LAMPUNG",16,129,64,193
https://kawalpemilu.org#22765,"REJOMULYO, JATI AGUNG, LAMPUNG SELATAN, LAMPUNG",17,119,33,152
https://kawalpemilu.org#22766,"PURWOTANI, JATI AGUNG, LAMPUNG SELATAN, LAMPUNG",1,188,62,250
https://kawalpemilu.org#22766,"PURWOTANI, JATI AGUNG, LAMPUNG SELATAN, LAMPUNG",2,181,29,210
https://kawalpemilu.org#22766,"PURWOTANI, JATI AGUNG, LAMPUNG SELATAN, LAMPUNG",3,185,47,232
https://kawalpemilu.org#22766,"PURWOTANI, JATI AGUNG, LAMPUNG SELATAN, LAMPUNG",4,193,11,204
https://kawalpemilu.org#22766,"PURWOTANI, JATI AGUNG, LAMPUNG SELATAN, LAMPUNG",5,190,8,198
https://kawalpemilu.org#22766,"PURWOTANI, JATI AGUNG, LAMPUNG SELATAN, LAMPUNG",6,147,40,187
https://kawalpemilu.org#22766,"PURWOTANI, JATI AGUNG, LAMPUNG SELATAN, LAMPUNG",7,180,17,197
https://kawalpemilu.org#22767,"BANJAR AGUNG, JATI AGUNG, LAMPUNG SELATAN, LAMPUNG",1,165,30,195
https://kawalpemilu.org#22767,"BANJAR AGUNG, JATI AGUNG, LAMPUNG SELATAN, LAMPUNG",2,166,44,210
https://kawalpemilu.org#22767,"BANJAR AGUNG, JATI AGUNG, LAMPUNG SELATAN, LAMPUNG",3,202,34,236
https://kawalpemilu.org#22767,"BANJAR AGUNG, JATI AGUNG, LAMPUNG SELATAN, LAMPUNG",4,217,21,238
https://kawalpemilu.org#22767,"BANJAR AGUNG, JATI AGUNG, LAMPUNG SELATAN, LAMPUNG",5,142,58,200
https://kawalpemilu.org#22767,"BANJAR AGUNG, JATI AGUNG, LAMPUNG SELATAN, LAMPUNG",6,160,45,205
https://kawalpemilu.org#22767,"BANJAR AGUNG, JATI AGUNG, LAMPUNG SELATAN, LAMPUNG",7,159,50,209
https://kawalpemilu.org#22768,"KARANG SARI, JATI AGUNG, LAMPUNG SELATAN, LAMPUNG",1,137,115,252
https://kawalpemilu.org#22768,"KARANG SARI, JATI AGUNG, LAMPUNG SELATAN, LAMPUNG",2,118,92,210
https://kawalpemilu.org#22768,"KARANG SARI, JATI AGUNG, LAMPUNG SELATAN, LAMPUNG",4,169,46,215
https://kawalpemilu.org#22768,"KARANG SARI, JATI AGUNG, LAMPUNG SELATAN, LAMPUNG",5,143,77,220
https://kawalpemilu.org#22768,"KARANG SARI, JATI AGUNG, LAMPUNG SELATAN, LAMPUNG",6,129,86,215
https://kawalpemilu.org#22768,"KARANG SARI, JATI AGUNG, LAMPUNG SELATAN, LAMPUNG",7,129,121,250
https://kawalpemilu.org#22768,"KARANG SARI, JATI AGUNG, LAMPUNG SELATAN, LAMPUNG",8,152,101,253
https://kawalpemilu.org#22768,"KARANG SARI, JATI AGUNG, LAMPUNG SELATAN, LAMPUNG",9,122,101,223
https://kawalpemilu.org#22768,"KARANG SARI, JATI AGUNG, LAMPUNG SELATAN, LAMPUNG",10,125,68,193
https://kawalpemilu.org#22768,"KARANG SARI, JATI AGUNG, LAMPUNG SELATAN, LAMPUNG",11,136,71,207
https://kawalpemilu.org#22768,"KARANG SARI, JATI AGUNG, LAMPUNG SELATAN, LAMPUNG",12,115,105,220
https://kawalpemilu.org#22769,"KARANG REJO, JATI AGUNG, LAMPUNG SELATAN, LAMPUNG",1,158,28,186
https://kawalpemilu.org#22769,"KARANG REJO, JATI AGUNG, LAMPUNG SELATAN, LAMPUNG",2,187,26,213
https://kawalpemilu.org#22769,"KARANG REJO, JATI AGUNG, LAMPUNG SELATAN, LAMPUNG",3,135,29,164
https://kawalpemilu.org#22769,"KARANG REJO, JATI AGUNG, LAMPUNG SELATAN, LAMPUNG",4,169,5,174
https://kawalpemilu.org#22769,"KARANG REJO, JATI AGUNG, LAMPUNG SELATAN, LAMPUNG",5,172,12,184
https://kawalpemilu.org#22769,"KARANG REJO, JATI AGUNG, LAMPUNG SELATAN, LAMPUNG",6,147,18,165
https://kawalpemilu.org#22769,"KARANG REJO, JATI AGUNG, LAMPUNG SELATAN, LAMPUNG",7,165,12,177
https://kawalpemilu.org#22769,"KARANG REJO, JATI AGUNG, LAMPUNG SELATAN, LAMPUNG",8,175,10,185
https://kawalpemilu.org#22769,"KARANG REJO, JATI AGUNG, LAMPUNG SELATAN, LAMPUNG",9,162,6,168
https://kawalpemilu.org#22769,"KARANG REJO, JATI AGUNG, LAMPUNG SELATAN, LAMPUNG",10,160,49,209
https://kawalpemilu.org#22769,"KARANG REJO, JATI AGUNG, LAMPUNG SELATAN, LAMPUNG",11,97,31,128
https://kawalpemilu.org#22769,"KARANG REJO, JATI AGUNG, LAMPUNG SELATAN, LAMPUNG",12,214,17,231
https://kawalpemilu.org#22769,"KARANG REJO, JATI AGUNG, LAMPUNG SELATAN, LAMPUNG",13,216,22,238
https://kawalpemilu.org#22769,"KARANG REJO, JATI AGUNG, LAMPUNG SELATAN, LAMPUNG",14,163,32,195
https://kawalpemilu.org#22769,"KARANG REJO, JATI AGUNG, LAMPUNG SELATAN, LAMPUNG",15,160,22,182
https://kawalpemilu.org#22770,"MARGOREJO, JATI AGUNG, LAMPUNG SELATAN, LAMPUNG",1,171,38,209
https://kawalpemilu.org#22770,"MARGOREJO, JATI AGUNG, LAMPUNG SELATAN, LAMPUNG",2,180,38,218
https://kawalpemilu.org#22770,"MARGOREJO, JATI AGUNG, LAMPUNG SELATAN, LAMPUNG",3,180,36,216
https://kawalpemilu.org#22770,"MARGOREJO, JATI AGUNG, LAMPUNG SELATAN, LAMPUNG",4,186,50,236
https://kawalpemilu.org#22770,"MARGOREJO, JATI AGUNG, LAMPUNG SELATAN, LAMPUNG",5,108,61,169
https://kawalpemilu.org#22770,"MARGOREJO, JATI AGUNG, LAMPUNG SELATAN, LAMPUNG",6,135,30,165
https://kawalpemilu.org#22772,"BANGUN REJO, KETAPANG, LAMPUNG SELATAN, LAMPUNG",1,98,50,148
https://kawalpemilu.org#22772,"BANGUN REJO, KETAPANG, LAMPUNG SELATAN, LAMPUNG",2,179,40,219
https://kawalpemilu.org#22772,"BANGUN REJO, KETAPANG, LAMPUNG SELATAN, LAMPUNG",3,123,57,180
https://kawalpemilu.org#22772,"BANGUN REJO, KETAPANG, LAMPUNG SELATAN, LAMPUNG",4,124,56,180
https://kawalpemilu.org#22772,"BANGUN REJO, KETAPANG, LAMPUNG SELATAN, LAMPUNG",5,184,4,188
https://kawalpemilu.org#22772,"BANGUN REJO, KETAPANG, LAMPUNG SELATAN, LAMPUNG",6,150,33,183
https://kawalpemilu.org#22772,"BANGUN REJO, KETAPANG, LAMPUNG SELATAN, LAMPUNG",7,82,32,114
https://kawalpemilu.org#22772,"BANGUN REJO, KETAPANG, LAMPUNG SELATAN, LAMPUNG",8,108,18,126
https://kawalpemilu.org#22772,"BANGUN REJO, KETAPANG, LAMPUNG SELATAN, LAMPUNG",9,128,74,202
https://kawalpemilu.org#22772,"BANGUN REJO, KETAPANG, LAMPUNG SELATAN, LAMPUNG",10,99,8,107
https://kawalpemilu.org#22773,"SRI PENDOWO, KETAPANG, LAMPUNG SELATAN, LAMPUNG",1,127,21,148
https://kawalpemilu.org#22773,"SRI PENDOWO, KETAPANG, LAMPUNG SELATAN, LAMPUNG",2,79,45,124
https://kawalpemilu.org#22773,"SRI PENDOWO, KETAPANG, LAMPUNG SELATAN, LAMPUNG",3,103,45,148
https://kawalpemilu.org#22773,"SRI PENDOWO, KETAPANG, LAMPUNG SELATAN, LAMPUNG",4,158,60,218
https://kawalpemilu.org#22773,"SRI PENDOWO, KETAPANG, LAMPUNG SELATAN, LAMPUNG",5,91,43,134
https://kawalpemilu.org#22773,"SRI PENDOWO, KETAPANG, LAMPUNG SELATAN, LAMPUNG",6,110,14,124
https://kawalpemilu.org#22773,"SRI PENDOWO, KETAPANG, LAMPUNG SELATAN, LAMPUNG",8,132,17,149
https://kawalpemilu.org#22773,"SRI PENDOWO, KETAPANG, LAMPUNG SELATAN, LAMPUNG",9,132,17,149
https://kawalpemilu.org#22773,"SRI PENDOWO, KETAPANG, LAMPUNG SELATAN, LAMPUNG",10,141,30,171
https://kawalpemilu.org#22773,"SRI PENDOWO, KETAPANG, LAMPUNG SELATAN, LAMPUNG",11,119,68,187
https://kawalpemilu.org#22773,"SRI PENDOWO, KETAPANG, LAMPUNG SELATAN, LAMPUNG",12,139,16,155
https://kawalpemilu.org#22774,"KARANG SARI, KETAPANG, LAMPUNG SELATAN, LAMPUNG",1,195,81,276
https://kawalpemilu.org#22774,"KARANG SARI, KETAPANG, LAMPUNG SELATAN, LAMPUNG",2,131,52,183
https://kawalpemilu.org#22774,"KARANG SARI, KETAPANG, LAMPUNG SELATAN, LAMPUNG",3,120,78,198
https://kawalpemilu.org#22774,"KARANG SARI, KETAPANG, LAMPUNG SELATAN, LAMPUNG",4,187,23,210
https://kawalpemilu.org#22774,"KARANG SARI, KETAPANG, LAMPUNG SELATAN, LAMPUNG",5,169,38,207
https://kawalpemilu.org#22774,"KARANG SARI, KETAPANG, LAMPUNG SELATAN, LAMPUNG",6,180,11,191
https://kawalpemilu.org#22774,"KARANG SARI, KETAPANG, LAMPUNG SELATAN, LAMPUNG",7,83,28,111
https://kawalpemilu.org#22774,"KARANG SARI, KETAPANG, LAMPUNG SELATAN, LAMPUNG",8,132,14,146
https://kawalpemilu.org#22774,"KARANG SARI, KETAPANG, LAMPUNG SELATAN, LAMPUNG",9,167,85,252
https://kawalpemilu.org#22774,"KARANG SARI, KETAPANG, LAMPUNG SELATAN, LAMPUNG",10,113,78,191
https://kawalpemilu.org#22774,"KARANG SARI, KETAPANG, LAMPUNG SELATAN, LAMPUNG",11,168,27,195
https://kawalpemilu.org#22774,"KARANG SARI, KETAPANG, LAMPUNG SELATAN, LAMPUNG",12,108,31,139
https://kawalpemilu.org#22775,"KETAPANG, KETAPANG, LAMPUNG SELATAN, LAMPUNG",1,172,74,246
https://kawalpemilu.org#22775,"KETAPANG, KETAPANG, LAMPUNG SELATAN, LAMPUNG",2,98,95,93
https://kawalpemilu.org#22775,"KETAPANG, KETAPANG, LAMPUNG SELATAN, LAMPUNG",3,88,88,176
https://kawalpemilu.org#22775,"KETAPANG, KETAPANG, LAMPUNG SELATAN, LAMPUNG",4,66,126,192
https://kawalpemilu.org#22775,"KETAPANG, KETAPANG, LAMPUNG SELATAN, LAMPUNG",5,163,81,244
https://kawalpemilu.org#22775,"KETAPANG, KETAPANG, LAMPUNG SELATAN, LAMPUNG",6,163,32,195
https://kawalpemilu.org#22775,"KETAPANG, KETAPANG, LAMPUNG SELATAN, LAMPUNG",7,202,26,228
https://kawalpemilu.org#22775,"KETAPANG, KETAPANG, LAMPUNG SELATAN, LAMPUNG",8,149,27,176
https://kawalpemilu.org#22775,"KETAPANG, KETAPANG, LAMPUNG SELATAN, LAMPUNG",9,129,83,212
https://kawalpemilu.org#22775,"KETAPANG, KETAPANG, LAMPUNG SELATAN, LAMPUNG",10,93,87,180
https://kawalpemilu.org#22775,"KETAPANG, KETAPANG, LAMPUNG SELATAN, LAMPUNG",11,0,0,180
https://kawalpemilu.org#22775,"KETAPANG, KETAPANG, LAMPUNG SELATAN, LAMPUNG",12,170,56,226
https://kawalpemilu.org#22775,"KETAPANG, KETAPANG, LAMPUNG SELATAN, LAMPUNG",13,185,45,230
https://kawalpemilu.org#22775,"KETAPANG, KETAPANG, LAMPUNG SELATAN, LAMPUNG",14,141,69,210
https://kawalpemilu.org#22776,"LEGUNDI, KETAPANG, LAMPUNG SELATAN, LAMPUNG",1,64,121,185
https://kawalpemilu.org#22776,"LEGUNDI, KETAPANG, LAMPUNG SELATAN, LAMPUNG",2,165,40,205
https://kawalpemilu.org#22776,"LEGUNDI, KETAPANG, LAMPUNG SELATAN, LAMPUNG",3,141,28,169
https://kawalpemilu.org#22776,"LEGUNDI, KETAPANG, LAMPUNG SELATAN, LAMPUNG",4,165,26,191
https://kawalpemilu.org#22776,"LEGUNDI, KETAPANG, LAMPUNG SELATAN, LAMPUNG",5,95,24,119
https://kawalpemilu.org#22776,"LEGUNDI, KETAPANG, LAMPUNG SELATAN, LAMPUNG",6,82,129,211
https://kawalpemilu.org#22776,"LEGUNDI, KETAPANG, LAMPUNG SELATAN, LAMPUNG",7,193,9,202
https://kawalpemilu.org#22776,"LEGUNDI, KETAPANG, LAMPUNG SELATAN, LAMPUNG",8,109,18,127
https://kawalpemilu.org#22776,"LEGUNDI, KETAPANG, LAMPUNG SELATAN, LAMPUNG",9,109,11,120
https://kawalpemilu.org#22776,"LEGUNDI, KETAPANG, LAMPUNG SELATAN, LAMPUNG",10,114,39,153
https://kawalpemilu.org#22777,"TRI DHARMA YOGA, KETAPANG, LAMPUNG SELATAN, LAMPUNG",1,130,12,142
https://kawalpemilu.org#22777,"TRI DHARMA YOGA, KETAPANG, LAMPUNG SELATAN, LAMPUNG",2,154,7,161
https://kawalpemilu.org#22777,"TRI DHARMA YOGA, KETAPANG, LAMPUNG SELATAN, LAMPUNG",3,189,4,193
https://kawalpemilu.org#22777,"TRI DHARMA YOGA, KETAPANG, LAMPUNG SELATAN, LAMPUNG",4,105,27,132
https://kawalpemilu.org#22777,"TRI DHARMA YOGA, KETAPANG, LAMPUNG SELATAN, LAMPUNG",5,198,18,216
https://kawalpemilu.org#22778,"RUGUK, KETAPANG, LAMPUNG SELATAN, LAMPUNG",1,83,75,158
https://kawalpemilu.org#22778,"RUGUK, KETAPANG, LAMPUNG SELATAN, LAMPUNG",2,96,26,122
https://kawalpemilu.org#22778,"RUGUK, KETAPANG, LAMPUNG SELATAN, LAMPUNG",3,136,16,152
https://kawalpemilu.org#22778,"RUGUK, KETAPANG, LAMPUNG SELATAN, LAMPUNG",4,78,108,186
https://kawalpemilu.org#22778,"RUGUK, KETAPANG, LAMPUNG SELATAN, LAMPUNG",5,121,18,139
https://kawalpemilu.org#22778,"RUGUK, KETAPANG, LAMPUNG SELATAN, LAMPUNG",6,116,36,152
https://kawalpemilu.org#22778,"RUGUK, KETAPANG, LAMPUNG SELATAN, LAMPUNG",7,149,3,152
https://kawalpemilu.org#22778,"RUGUK, KETAPANG, LAMPUNG SELATAN, LAMPUNG",8,110,32,142
https://kawalpemilu.org#22778,"RUGUK, KETAPANG, LAMPUNG SELATAN, LAMPUNG",9,130,76,206
https://kawalpemilu.org#22778,"RUGUK, KETAPANG, LAMPUNG SELATAN, LAMPUNG",10,136,45,181
https://kawalpemilu.org#22778,"RUGUK, KETAPANG, LAMPUNG SELATAN, LAMPUNG",11,108,45,153
https://kawalpemilu.org#22778,"RUGUK, KETAPANG, LAMPUNG SELATAN, LAMPUNG",12,109,17,126
https://kawalpemilu.org#22778,"RUGUK, KETAPANG, LAMPUNG SELATAN, LAMPUNG",13,70,47,117
https://kawalpemilu.org#22778,"RUGUK, KETAPANG, LAMPUNG SELATAN, LAMPUNG",14,87,18,105
https://kawalpemilu.org#22778,"RUGUK, KETAPANG, LAMPUNG SELATAN, LAMPUNG",15,136,32,168
https://kawalpemilu.org#22778,"RUGUK, KETAPANG, LAMPUNG SELATAN, LAMPUNG",16,98,81,179
https://kawalpemilu.org#22778,"RUGUK, KETAPANG, LAMPUNG SELATAN, LAMPUNG",17,103,14,117
https://kawalpemilu.org#22778,"RUGUK, KETAPANG, LAMPUNG SELATAN, LAMPUNG",18,112,21,133
https://kawalpemilu.org#22778,"RUGUK, KETAPANG, LAMPUNG SELATAN, LAMPUNG",19,87,39,126
https://kawalpemilu.org#22778,"RUGUK, KETAPANG, LAMPUNG SELATAN, LAMPUNG",20,160,47,207
https://kawalpemilu.org#22779,"SUMUR, KETAPANG, LAMPUNG SELATAN, LAMPUNG",2,103,72,175
https://kawalpemilu.org#22779,"SUMUR, KETAPANG, LAMPUNG SELATAN, LAMPUNG",3,103,46,149
https://kawalpemilu.org#22779,"SUMUR, KETAPANG, LAMPUNG SELATAN, LAMPUNG",4,114,54,168
https://kawalpemilu.org#22779,"SUMUR, KETAPANG, LAMPUNG SELATAN, LAMPUNG",5,181,59,240
https://kawalpemilu.org#22779,"SUMUR, KETAPANG, LAMPUNG SELATAN, LAMPUNG",6,100,45,145
https://kawalpemilu.org#22779,"SUMUR, KETAPANG, LAMPUNG SELATAN, LAMPUNG",7,205,5,210
https://kawalpemilu.org#22779,"SUMUR, KETAPANG, LAMPUNG SELATAN, LAMPUNG",8,142,44,186
https://kawalpemilu.org#22779,"SUMUR, KETAPANG, LAMPUNG SELATAN, LAMPUNG",9,190,2,192
https://kawalpemilu.org#22779,"SUMUR, KETAPANG, LAMPUNG SELATAN, LAMPUNG",10,132,29,161
https://kawalpemilu.org#22779,"SUMUR, KETAPANG, LAMPUNG SELATAN, LAMPUNG",11,142,7,149
https://kawalpemilu.org#22779,"SUMUR, KETAPANG, LAMPUNG SELATAN, LAMPUNG",12,53,37,90
https://kawalpemilu.org#22779,"SUMUR, KETAPANG, LAMPUNG SELATAN, LAMPUNG",13,173,21,174
https://kawalpemilu.org#22779,"SUMUR, KETAPANG, LAMPUNG SELATAN, LAMPUNG",14,126,67,193
https://kawalpemilu.org#22779,"SUMUR, KETAPANG, LAMPUNG SELATAN, LAMPUNG",15,101,37,138
https://kawalpemilu.org#22779,"SUMUR, KETAPANG, LAMPUNG SELATAN, LAMPUNG",16,226,5,231
https://kawalpemilu.org#22779,"SUMUR, KETAPANG, LAMPUNG SELATAN, LAMPUNG",17,85,33,118
https://kawalpemilu.org#22779,"SUMUR, KETAPANG, LAMPUNG SELATAN, LAMPUNG",18,78,29,107
https://kawalpemilu.org#22780,"SUMBER NADI, KETAPANG, LAMPUNG SELATAN, LAMPUNG",1,183,6,189
https://kawalpemilu.org#22780,"SUMBER NADI, KETAPANG, LAMPUNG SELATAN, LAMPUNG",2,137,2,139
https://kawalpemilu.org#22780,"SUMBER NADI, KETAPANG, LAMPUNG SELATAN, LAMPUNG",3,186,5,191
https://kawalpemilu.org#22780,"SUMBER NADI, KETAPANG, LAMPUNG SELATAN, LAMPUNG",4,160,3,163
https://kawalpemilu.org#22781,"SIDO ASIH, KETAPANG, LAMPUNG SELATAN, LAMPUNG",1,151,38,189
https://kawalpemilu.org#22781,"SIDO ASIH, KETAPANG, LAMPUNG SELATAN, LAMPUNG",2,137,59,196
https://kawalpemilu.org#22781,"SIDO ASIH, KETAPANG, LAMPUNG SELATAN, LAMPUNG",3,172,31,203
https://kawalpemilu.org#22781,"SIDO ASIH, KETAPANG, LAMPUNG SELATAN, LAMPUNG",4,137,18,155
https://kawalpemilu.org#22781,"SIDO ASIH, KETAPANG, LAMPUNG SELATAN, LAMPUNG",5,129,33,162
https://kawalpemilu.org#22781,"SIDO ASIH, KETAPANG, LAMPUNG SELATAN, LAMPUNG",6,160,36,196
https://kawalpemilu.org#22781,"SIDO ASIH, KETAPANG, LAMPUNG SELATAN, LAMPUNG",7,181,39,220
https://kawalpemilu.org#22781,"SIDO ASIH, KETAPANG, LAMPUNG SELATAN, LAMPUNG",8,134,29,163
https://kawalpemilu.org#22782,"PEMATANG PASIR, KETAPANG, LAMPUNG SELATAN, LAMPUNG",1,168,36,204
https://kawalpemilu.org#22782,"PEMATANG PASIR, KETAPANG, LAMPUNG SELATAN, LAMPUNG",2,219,42,261
https://kawalpemilu.org#22782,"PEMATANG PASIR, KETAPANG, LAMPUNG SELATAN, LAMPUNG",4,124,13,137
https://kawalpemilu.org#22782,"PEMATANG PASIR, KETAPANG, LAMPUNG SELATAN, LAMPUNG",5,159,20,179
https://kawalpemilu.org#22782,"PEMATANG PASIR, KETAPANG, LAMPUNG SELATAN, LAMPUNG",6,157,34,191
https://kawalpemilu.org#22782,"PEMATANG PASIR, KETAPANG, LAMPUNG SELATAN, LAMPUNG",7,151,37,188
https://kawalpemilu.org#22782,"PEMATANG PASIR, KETAPANG, LAMPUNG SELATAN, LAMPUNG",8,189,18,207
https://kawalpemilu.org#22782,"PEMATANG PASIR, KETAPANG, LAMPUNG SELATAN, LAMPUNG",9,174,31,205
https://kawalpemilu.org#22782,"PEMATANG PASIR, KETAPANG, LAMPUNG SELATAN, LAMPUNG",10,195,20,215
https://kawalpemilu.org#22782,"PEMATANG PASIR, KETAPANG, LAMPUNG SELATAN, LAMPUNG",11,136,35,172
https://kawalpemilu.org#22782,"PEMATANG PASIR, KETAPANG, LAMPUNG SELATAN, LAMPUNG",12,159,26,185
https://kawalpemilu.org#22783,"BERUNDUNG, KETAPANG, LAMPUNG SELATAN, LAMPUNG",1,190,21,211
https://kawalpemilu.org#22783,"BERUNDUNG, KETAPANG, LAMPUNG SELATAN, LAMPUNG",2,183,47,230
https://kawalpemilu.org#22783,"BERUNDUNG, KETAPANG, LAMPUNG SELATAN, LAMPUNG",3,157,30,187
https://kawalpemilu.org#22783,"BERUNDUNG, KETAPANG, LAMPUNG SELATAN, LAMPUNG",4,103,64,167
https://kawalpemilu.org#22783,"BERUNDUNG, KETAPANG, LAMPUNG SELATAN, LAMPUNG",5,160,14,174
https://kawalpemilu.org#22783,"BERUNDUNG, KETAPANG, LAMPUNG SELATAN, LAMPUNG",6,129,35,164
https://kawalpemilu.org#22783,"BERUNDUNG, KETAPANG, LAMPUNG SELATAN, LAMPUNG",7,125,41,166
https://kawalpemilu.org#22783,"BERUNDUNG, KETAPANG, LAMPUNG SELATAN, LAMPUNG",8,84,72,156
https://kawalpemilu.org#22784,"TAMAN SARI, KETAPANG, LAMPUNG SELATAN, LAMPUNG",1,208,26,234
https://kawalpemilu.org#22784,"TAMAN SARI, KETAPANG, LAMPUNG SELATAN, LAMPUNG",2,185,23,208
https://kawalpemilu.org#22784,"TAMAN SARI, KETAPANG, LAMPUNG SELATAN, LAMPUNG",3,182,28,210
https://kawalpemilu.org#22784,"TAMAN SARI, KETAPANG, LAMPUNG SELATAN, LAMPUNG",4,174,20,194
https://kawalpemilu.org#22784,"TAMAN SARI, KETAPANG, LAMPUNG SELATAN, LAMPUNG",5,196,21,217
https://kawalpemilu.org#22784,"TAMAN SARI, KETAPANG, LAMPUNG SELATAN, LAMPUNG",6,197,45,242
https://kawalpemilu.org#22784,"TAMAN SARI, KETAPANG, LAMPUNG SELATAN, LAMPUNG",7,197,23,220
https://kawalpemilu.org#22784,"TAMAN SARI, KETAPANG, LAMPUNG SELATAN, LAMPUNG",8,168,25,193
https://kawalpemilu.org#22785,"KEMUKUS, KETAPANG, LAMPUNG SELATAN, LAMPUNG",1,150,35,185
https://kawalpemilu.org#22785,"KEMUKUS, KETAPANG, LAMPUNG SELATAN, LAMPUNG",2,167,37,204
https://kawalpemilu.org#22785,"KEMUKUS, KETAPANG, LAMPUNG SELATAN, LAMPUNG",3,190,26,216
https://kawalpemilu.org#22785,"KEMUKUS, KETAPANG, LAMPUNG SELATAN, LAMPUNG",4,151,28,178
https://kawalpemilu.org#22785,"KEMUKUS, KETAPANG, LAMPUNG SELATAN, LAMPUNG",5,144,57,201
https://kawalpemilu.org#22785,"KEMUKUS, KETAPANG, LAMPUNG SELATAN, LAMPUNG",6,191,14,205
https://kawalpemilu.org#22786,"LEBUNG NALA, KETAPANG, LAMPUNG SELATAN, LAMPUNG",1,183,25,208
https://kawalpemilu.org#22786,"LEBUNG NALA, KETAPANG, LAMPUNG SELATAN, LAMPUNG",2,194,19,213
https://kawalpemilu.org#22786,"LEBUNG NALA, KETAPANG, LAMPUNG SELATAN, LAMPUNG",3,178,40,218
https://kawalpemilu.org#22787,"SIDO LUHUR, KETAPANG, LAMPUNG SELATAN, LAMPUNG",1,222,2,224
https://kawalpemilu.org#22787,"SIDO LUHUR, KETAPANG, LAMPUNG SELATAN, LAMPUNG",2,158,35,193
https://kawalpemilu.org#22787,"SIDO LUHUR, KETAPANG, LAMPUNG SELATAN, LAMPUNG",3,114,40,154
https://kawalpemilu.org#22787,"SIDO LUHUR, KETAPANG, LAMPUNG SELATAN, LAMPUNG",4,131,43,174
https://kawalpemilu.org#22787,"SIDO LUHUR, KETAPANG, LAMPUNG SELATAN, LAMPUNG",5,82,90,172
https://kawalpemilu.org#91299,"WAI SIDOMUKTI, KETAPANG, LAMPUNG SELATAN, LAMPUNG",1,208,32,240
https://kawalpemilu.org#91299,"WAI SIDOMUKTI, KETAPANG, LAMPUNG SELATAN, LAMPUNG",2,194,28,222
https://kawalpemilu.org#91299,"WAI SIDOMUKTI, KETAPANG, LAMPUNG SELATAN, LAMPUNG",3,158,30,188
https://kawalpemilu.org#91299,"WAI SIDOMUKTI, KETAPANG, LAMPUNG SELATAN, LAMPUNG",4,197,29,226
https://kawalpemilu.org#91299,"WAI SIDOMUKTI, KETAPANG, LAMPUNG SELATAN, LAMPUNG",5,161,28,189
https://kawalpemilu.org#22789,"KUALA SEKAMPUNG, SRAGI, LAMPUNG SELATAN, LAMPUNG",1,129,59,188
https://kawalpemilu.org#22789,"KUALA SEKAMPUNG, SRAGI, LAMPUNG SELATAN, LAMPUNG",2,147,22,169
https://kawalpemilu.org#22789,"KUALA SEKAMPUNG, SRAGI, LAMPUNG SELATAN, LAMPUNG",3,140,30,170
https://kawalpemilu.org#22789,"KUALA SEKAMPUNG, SRAGI, LAMPUNG SELATAN, LAMPUNG",4,137,38,175
https://kawalpemilu.org#22789,"KUALA SEKAMPUNG, SRAGI, LAMPUNG SELATAN, LAMPUNG",5,115,41,156
https://kawalpemilu.org#22789,"KUALA SEKAMPUNG, SRAGI, LAMPUNG SELATAN, LAMPUNG",6,99,24,123
https://kawalpemilu.org#22789,"KUALA SEKAMPUNG, SRAGI, LAMPUNG SELATAN, LAMPUNG",7,160,37,197
https://kawalpemilu.org#22789,"KUALA SEKAMPUNG, SRAGI, LAMPUNG SELATAN, LAMPUNG",8,140,32,172
https://kawalpemilu.org#22789,"KUALA SEKAMPUNG, SRAGI, LAMPUNG SELATAN, LAMPUNG",9,144,44,188
https://kawalpemilu.org#22789,"KUALA SEKAMPUNG, SRAGI, LAMPUNG SELATAN, LAMPUNG",10,131,35,166
https://kawalpemilu.org#22789,"KUALA SEKAMPUNG, SRAGI, LAMPUNG SELATAN, LAMPUNG",11,107,59,166
https://kawalpemilu.org#22790,"BAKTI RASA, SRAGI, LAMPUNG SELATAN, LAMPUNG",1,126,90,216
https://kawalpemilu.org#22790,"BAKTI RASA, SRAGI, LAMPUNG SELATAN, LAMPUNG",2,82,104,186
https://kawalpemilu.org#22790,"BAKTI RASA, SRAGI, LAMPUNG SELATAN, LAMPUNG",3,93,82,175
https://kawalpemilu.org#22790,"BAKTI RASA, SRAGI, LAMPUNG SELATAN, LAMPUNG",5,102,67,169
https://kawalpemilu.org#22790,"BAKTI RASA, SRAGI, LAMPUNG SELATAN, LAMPUNG",6,124,67,191
https://kawalpemilu.org#22790,"BAKTI RASA, SRAGI, LAMPUNG SELATAN, LAMPUNG",7,152,38,190
https://kawalpemilu.org#22790,"BAKTI RASA, SRAGI, LAMPUNG SELATAN, LAMPUNG",8,129,42,171
https://kawalpemilu.org#22790,"BAKTI RASA, SRAGI, LAMPUNG SELATAN, LAMPUNG",9,174,20,194
https://kawalpemilu.org#22790,"BAKTI RASA, SRAGI, LAMPUNG SELATAN, LAMPUNG",10,125,88,213
https://kawalpemilu.org#22790,"BAKTI RASA, SRAGI, LAMPUNG SELATAN, LAMPUNG",11,114,93,207
https://kawalpemilu.org#22790,"BAKTI RASA, SRAGI, LAMPUNG SELATAN, LAMPUNG",12,88,55,143
https://kawalpemilu.org#22790,"BAKTI RASA, SRAGI, LAMPUNG SELATAN, LAMPUNG",13,69,50,119
https://kawalpemilu.org#22790,"BAKTI RASA, SRAGI, LAMPUNG SELATAN, LAMPUNG",17,136,19,155
https://kawalpemilu.org#22790,"BAKTI RASA, SRAGI, LAMPUNG SELATAN, LAMPUNG",18,92,48,140
https://kawalpemilu.org#22790,"BAKTI RASA, SRAGI, LAMPUNG SELATAN, LAMPUNG",19,125,45,170
https://kawalpemilu.org#22791,"MANDALASARI, SRAGI, LAMPUNG SELATAN, LAMPUNG",1,133,60,193
https://kawalpemilu.org#22791,"MANDALASARI, SRAGI, LAMPUNG SELATAN, LAMPUNG",2,154,38,192
https://kawalpemilu.org#22791,"MANDALASARI, SRAGI, LAMPUNG SELATAN, LAMPUNG",3,139,25,164
https://kawalpemilu.org#22791,"MANDALASARI, SRAGI, LAMPUNG SELATAN, LAMPUNG",4,173,28,201
https://kawalpemilu.org#22791,"MANDALASARI, SRAGI, LAMPUNG SELATAN, LAMPUNG",5,119,30,149
https://kawalpemilu.org#22791,"MANDALASARI, SRAGI, LAMPUNG SELATAN, LAMPUNG",6,137,46,183
https://kawalpemilu.org#22791,"MANDALASARI, SRAGI, LAMPUNG SELATAN, LAMPUNG",7,131,59,190
https://kawalpemilu.org#22791,"MANDALASARI, SRAGI, LAMPUNG SELATAN, LAMPUNG",8,116,29,145
https://kawalpemilu.org#22791,"MANDALASARI, SRAGI, LAMPUNG SELATAN, LAMPUNG",9,100,24,124
https://kawalpemilu.org#22791,"MANDALASARI, SRAGI, LAMPUNG SELATAN, LAMPUNG",10,154,44,198
https://kawalpemilu.org#22792,"SUKA PURA, SRAGI, LAMPUNG SELATAN, LAMPUNG",1,106,89,195
https://kawalpemilu.org#22792,"SUKA PURA, SRAGI, LAMPUNG SELATAN, LAMPUNG",2,136,59,195
https://kawalpemilu.org#22792,"SUKA PURA, SRAGI, LAMPUNG SELATAN, LAMPUNG",3,117,50,167
https://kawalpemilu.org#22792,"SUKA PURA, SRAGI, LAMPUNG SELATAN, LAMPUNG",4,126,48,174
https://kawalpemilu.org#22792,"SUKA PURA, SRAGI, LAMPUNG SELATAN, LAMPUNG",5,129,38,167
https://kawalpemilu.org#22792,"SUKA PURA, SRAGI, LAMPUNG SELATAN, LAMPUNG",6,99,55,154
https://kawalpemilu.org#22792,"SUKA PURA, SRAGI, LAMPUNG SELATAN, LAMPUNG",7,187,19,206
https://kawalpemilu.org#22792,"SUKA PURA, SRAGI, LAMPUNG SELATAN, LAMPUNG",8,106,109,215
https://kawalpemilu.org#22792,"SUKA PURA, SRAGI, LAMPUNG SELATAN, LAMPUNG",9,104,56,160
https://kawalpemilu.org#22792,"SUKA PURA, SRAGI, LAMPUNG SELATAN, LAMPUNG",10,96,42,138
https://kawalpemilu.org#22792,"SUKA PURA, SRAGI, LAMPUNG SELATAN, LAMPUNG",11,149,27,176
https://kawalpemilu.org#22792,"SUKA PURA, SRAGI, LAMPUNG SELATAN, LAMPUNG",12,117,33,150
https://kawalpemilu.org#22792,"SUKA PURA, SRAGI, LAMPUNG SELATAN, LAMPUNG",13,192,21,213
https://kawalpemilu.org#22793,"SUMBER AGUNG, SRAGI, LAMPUNG SELATAN, LAMPUNG",1,180,16,196
https://kawalpemilu.org#22793,"SUMBER AGUNG, SRAGI, LAMPUNG SELATAN, LAMPUNG",2,141,23,164
https://kawalpemilu.org#22793,"SUMBER AGUNG, SRAGI, LAMPUNG SELATAN, LAMPUNG",3,192,15,207
https://kawalpemilu.org#22793,"SUMBER AGUNG, SRAGI, LAMPUNG SELATAN, LAMPUNG",4,168,9,177
https://kawalpemilu.org#22793,"SUMBER AGUNG, SRAGI, LAMPUNG SELATAN, LAMPUNG",5,169,20,189
https://kawalpemilu.org#22793,"SUMBER AGUNG, SRAGI, LAMPUNG SELATAN, LAMPUNG",6,209,7,216
https://kawalpemilu.org#22793,"SUMBER AGUNG, SRAGI, LAMPUNG SELATAN, LAMPUNG",7,168,11,179
https://kawalpemilu.org#22793,"SUMBER AGUNG, SRAGI, LAMPUNG SELATAN, LAMPUNG",8,157,5,162
https://kawalpemilu.org#22793,"SUMBER AGUNG, SRAGI, LAMPUNG SELATAN, LAMPUNG",9,180,22,202
https://kawalpemilu.org#22793,"SUMBER AGUNG, SRAGI, LAMPUNG SELATAN, LAMPUNG",10,190,7,197
https://kawalpemilu.org#22793,"SUMBER AGUNG, SRAGI, LAMPUNG SELATAN, LAMPUNG",11,99,88,187
https://kawalpemilu.org#22794,"MARGA JASA, SRAGI, LAMPUNG SELATAN, LAMPUNG",1,109,51,160
https://kawalpemilu.org#22794,"MARGA JASA, SRAGI, LAMPUNG SELATAN, LAMPUNG",2,95,64,159
https://kawalpemilu.org#22794,"MARGA JASA, SRAGI, LAMPUNG SELATAN, LAMPUNG",3,43,81,124
https://kawalpemilu.org#22794,"MARGA JASA, SRAGI, LAMPUNG SELATAN, LAMPUNG",4,127,64,191
https://kawalpemilu.org#22794,"MARGA JASA, SRAGI, LAMPUNG SELATAN, LAMPUNG",5,88,87,175
https://kawalpemilu.org#22794,"MARGA JASA, SRAGI, LAMPUNG SELATAN, LAMPUNG",6,167,14,181
https://kawalpemilu.org#22794,"MARGA JASA, SRAGI, LAMPUNG SELATAN, LAMPUNG",7,129,18,147
https://kawalpemilu.org#22794,"MARGA JASA, SRAGI, LAMPUNG SELATAN, LAMPUNG",8,126,7,133
https://kawalpemilu.org#22795,"SUMBER SARI, SRAGI, LAMPUNG SELATAN, LAMPUNG",1,210,10,220
https://kawalpemilu.org#22795,"SUMBER SARI, SRAGI, LAMPUNG SELATAN, LAMPUNG",2,191,21,212
https://kawalpemilu.org#22795,"SUMBER SARI, SRAGI, LAMPUNG SELATAN, LAMPUNG",3,184,25,209
https://kawalpemilu.org#22795,"SUMBER SARI, SRAGI, LAMPUNG SELATAN, LAMPUNG",4,190,21,211
https://kawalpemilu.org#22795,"SUMBER SARI, SRAGI, LAMPUNG SELATAN, LAMPUNG",5,211,13,224
https://kawalpemilu.org#22795,"SUMBER SARI, SRAGI, LAMPUNG SELATAN, LAMPUNG",6,107,6,113
https://kawalpemilu.org#22795,"SUMBER SARI, SRAGI, LAMPUNG SELATAN, LAMPUNG",7,190,15,205
https://kawalpemilu.org#22796,"BANDAR AGUNG, SRAGI, LAMPUNG SELATAN, LAMPUNG",1,136,27,163
https://kawalpemilu.org#22796,"BANDAR AGUNG, SRAGI, LAMPUNG SELATAN, LAMPUNG",2,109,76,185
https://kawalpemilu.org#22796,"BANDAR AGUNG, SRAGI, LAMPUNG SELATAN, LAMPUNG",3,65,129,194
https://kawalpemilu.org#22796,"BANDAR AGUNG, SRAGI, LAMPUNG SELATAN, LAMPUNG",4,115,70,185
https://kawalpemilu.org#22796,"BANDAR AGUNG, SRAGI, LAMPUNG SELATAN, LAMPUNG",5,152,19,171
https://kawalpemilu.org#22796,"BANDAR AGUNG, SRAGI, LAMPUNG SELATAN, LAMPUNG",6,77,40,117
https://kawalpemilu.org#22796,"BANDAR AGUNG, SRAGI, LAMPUNG SELATAN, LAMPUNG",7,113,74,187
https://kawalpemilu.org#22796,"BANDAR AGUNG, SRAGI, LAMPUNG SELATAN, LAMPUNG",8,101,39,140
https://kawalpemilu.org#22796,"BANDAR AGUNG, SRAGI, LAMPUNG SELATAN, LAMPUNG",9,116,46,162
https://kawalpemilu.org#22796,"BANDAR AGUNG, SRAGI, LAMPUNG SELATAN, LAMPUNG",10,78,8,86
https://kawalpemilu.org#22796,"BANDAR AGUNG, SRAGI, LAMPUNG SELATAN, LAMPUNG",11,79,77,156
https://kawalpemilu.org#22796,"BANDAR AGUNG, SRAGI, LAMPUNG SELATAN, LAMPUNG",12,160,44,204
https://kawalpemilu.org#22796,"BANDAR AGUNG, SRAGI, LAMPUNG SELATAN, LAMPUNG",13,149,40,189
https://kawalpemilu.org#22796,"BANDAR AGUNG, SRAGI, LAMPUNG SELATAN, LAMPUNG",14,101,48,149
https://kawalpemilu.org#22796,"BANDAR AGUNG, SRAGI, LAMPUNG SELATAN, LAMPUNG",15,126,47,173
https://kawalpemilu.org#22797,"KEDAUNG, SRAGI, LAMPUNG SELATAN, LAMPUNG",1,150,48,198
https://kawalpemilu.org#22797,"KEDAUNG, SRAGI, LAMPUNG SELATAN, LAMPUNG",2,169,24,193
https://kawalpemilu.org#22797,"KEDAUNG, SRAGI, LAMPUNG SELATAN, LAMPUNG",3,157,56,213
https://kawalpemilu.org#22797,"KEDAUNG, SRAGI, LAMPUNG SELATAN, LAMPUNG",4,201,14,215
https://kawalpemilu.org#22797,"KEDAUNG, SRAGI, LAMPUNG SELATAN, LAMPUNG",5,123,56,179
https://kawalpemilu.org#22797,"KEDAUNG, SRAGI, LAMPUNG SELATAN, LAMPUNG",6,133,17,150
https://kawalpemilu.org#22797,"KEDAUNG, SRAGI, LAMPUNG SELATAN, LAMPUNG",7,132,54,186
https://kawalpemilu.org#22797,"KEDAUNG, SRAGI, LAMPUNG SELATAN, LAMPUNG",8,141,41,182
https://kawalpemilu.org#22797,"KEDAUNG, SRAGI, LAMPUNG SELATAN, LAMPUNG",9,139,37,176
https://kawalpemilu.org#22797,"KEDAUNG, SRAGI, LAMPUNG SELATAN, LAMPUNG",10,125,63,188
https://kawalpemilu.org#22797,"KEDAUNG, SRAGI, LAMPUNG SELATAN, LAMPUNG",11,181,14,195
https://kawalpemilu.org#22798,"MARGA SARI, SRAGI, LAMPUNG SELATAN, LAMPUNG",1,138,36,174
https://kawalpemilu.org#22798,"MARGA SARI, SRAGI, LAMPUNG SELATAN, LAMPUNG",2,99,80,179
https://kawalpemilu.org#22798,"MARGA SARI, SRAGI, LAMPUNG SELATAN, LAMPUNG",3,120,57,177
https://kawalpemilu.org#22800,"BANDING, RAJA BASA, LAMPUNG SELATAN, LAMPUNG",1,91,138,229
https://kawalpemilu.org#22800,"BANDING, RAJA BASA, LAMPUNG SELATAN, LAMPUNG",2,72,74,146
https://kawalpemilu.org#22800,"BANDING, RAJA BASA, LAMPUNG SELATAN, LAMPUNG",3,99,123,222
https://kawalpemilu.org#22800,"BANDING, RAJA BASA, LAMPUNG SELATAN, LAMPUNG",4,91,69,160
https://kawalpemilu.org#22800,"BANDING, RAJA BASA, LAMPUNG SELATAN, LAMPUNG",5,61,156,217
https://kawalpemilu.org#22800,"BANDING, RAJA BASA, LAMPUNG SELATAN, LAMPUNG",6,106,99,205
https://kawalpemilu.org#22801,"BETUNG, RAJA BASA, LAMPUNG SELATAN, LAMPUNG",1,51,144,195
https://kawalpemilu.org#22801,"BETUNG, RAJA BASA, LAMPUNG SELATAN, LAMPUNG",2,50,75,125
https://kawalpemilu.org#22801,"BETUNG, RAJA BASA, LAMPUNG SELATAN, LAMPUNG",3,59,108,167
https://kawalpemilu.org#22801,"BETUNG, RAJA BASA, LAMPUNG SELATAN, LAMPUNG",4,82,79,161
https://kawalpemilu.org#22802,"BATU BALAK, RAJA BASA, LAMPUNG SELATAN, LAMPUNG",1,69,116,185
https://kawalpemilu.org#22802,"BATU BALAK, RAJA BASA, LAMPUNG SELATAN, LAMPUNG",2,99,70,169
https://kawalpemilu.org#22803,"CANTI, RAJA BASA, LAMPUNG SELATAN, LAMPUNG",1,97,63,160
https://kawalpemilu.org#22803,"CANTI, RAJA BASA, LAMPUNG SELATAN, LAMPUNG",2,87,92,179
https://kawalpemilu.org#22803,"CANTI, RAJA BASA, LAMPUNG SELATAN, LAMPUNG",3,72,104,176
https://kawalpemilu.org#22803,"CANTI, RAJA BASA, LAMPUNG SELATAN, LAMPUNG",4,138,89,227
https://kawalpemilu.org#22803,"CANTI, RAJA BASA, LAMPUNG SELATAN, LAMPUNG",5,111,54,165
https://kawalpemilu.org#22803,"CANTI, RAJA BASA, LAMPUNG SELATAN, LAMPUNG",6,56,132,188
https://kawalpemilu.org#22804,"CANGGUNG, RAJA BASA, LAMPUNG SELATAN, LAMPUNG",1,63,131,194
https://kawalpemilu.org#22804,"CANGGUNG, RAJA BASA, LAMPUNG SELATAN, LAMPUNG",2,85,132,217
https://kawalpemilu.org#22804,"CANGGUNG, RAJA BASA, LAMPUNG SELATAN, LAMPUNG",3,109,104,213
https://kawalpemilu.org#22804,"CANGGUNG, RAJA BASA, LAMPUNG SELATAN, LAMPUNG",4,59,131,190
https://kawalpemilu.org#22804,"CANGGUNG, RAJA BASA, LAMPUNG SELATAN, LAMPUNG",5,61,109,170
https://kawalpemilu.org#22805,"CUGUNG, RAJA BASA, LAMPUNG SELATAN, LAMPUNG",1,60,100,160
https://kawalpemilu.org#22805,"CUGUNG, RAJA BASA, LAMPUNG SELATAN, LAMPUNG",2,56,87,143
https://kawalpemilu.org#22805,"CUGUNG, RAJA BASA, LAMPUNG SELATAN, LAMPUNG",3,89,65,154
https://kawalpemilu.org#22805,"CUGUNG, RAJA BASA, LAMPUNG SELATAN, LAMPUNG",4,64,82,146
https://kawalpemilu.org#22805,"CUGUNG, RAJA BASA, LAMPUNG SELATAN, LAMPUNG",5,53,54,107
https://kawalpemilu.org#22805,"CUGUNG, RAJA BASA, LAMPUNG SELATAN, LAMPUNG",6,52,62,114
https://kawalpemilu.org#22806,"HARGO PANCURAN, RAJA BASA, LAMPUNG SELATAN, LAMPUNG",1,123,90,213
https://kawalpemilu.org#22806,"HARGO PANCURAN, RAJA BASA, LAMPUNG SELATAN, LAMPUNG",2,138,55,193
https://kawalpemilu.org#22807,"KERINJING, RAJA BASA, LAMPUNG SELATAN, LAMPUNG",1,52,58,110
https://kawalpemilu.org#22807,"KERINJING, RAJA BASA, LAMPUNG SELATAN, LAMPUNG",2,46,55,101
https://kawalpemilu.org#22807,"KERINJING, RAJA BASA, LAMPUNG SELATAN, LAMPUNG",3,78,94,172
https://kawalpemilu.org#22808,"KUNJIR, RAJA BASA, LAMPUNG SELATAN, LAMPUNG",1,103,66,169
https://kawalpemilu.org#22808,"KUNJIR, RAJA BASA, LAMPUNG SELATAN, LAMPUNG",2,65,117,182
https://kawalpemilu.org#22808,"KUNJIR, RAJA BASA, LAMPUNG SELATAN, LAMPUNG",3,66,112,178
https://kawalpemilu.org#22808,"KUNJIR, RAJA BASA, LAMPUNG SELATAN, LAMPUNG",4,103,66,169
https://kawalpemilu.org#22808,"KUNJIR, RAJA BASA, LAMPUNG SELATAN, LAMPUNG",5,71,98,169
https://kawalpemilu.org#22808,"KUNJIR, RAJA BASA, LAMPUNG SELATAN, LAMPUNG",6,57,97,157
https://kawalpemilu.org#22809,"KOTA GURING, RAJA BASA, LAMPUNG SELATAN, LAMPUNG",1,30,160,190
https://kawalpemilu.org#22809,"KOTA GURING, RAJA BASA, LAMPUNG SELATAN, LAMPUNG",2,50,129,179
https://kawalpemilu.org#22810,"RAJA BASA, RAJA BASA, LAMPUNG SELATAN, LAMPUNG",1,84,84,168
https://kawalpemilu.org#22810,"RAJA BASA, RAJA BASA, LAMPUNG SELATAN, LAMPUNG",2,86,120,206
https://kawalpemilu.org#22810,"RAJA BASA, RAJA BASA, LAMPUNG SELATAN, LAMPUNG",3,59,108,167
https://kawalpemilu.org#22810,"RAJA BASA, RAJA BASA, LAMPUNG SELATAN, LAMPUNG",4,97,81,178
https://kawalpemilu.org#22811,"SUKA RAJA, RAJA BASA, LAMPUNG SELATAN, LAMPUNG",1,96,118,214
https://kawalpemilu.org#22811,"SUKA RAJA, RAJA BASA, LAMPUNG SELATAN, LAMPUNG",2,88,67,155
https://kawalpemilu.org#22811,"SUKA RAJA, RAJA BASA, LAMPUNG SELATAN, LAMPUNG",3,110,56,166
https://kawalpemilu.org#22811,"SUKA RAJA, RAJA BASA, LAMPUNG SELATAN, LAMPUNG",4,150,49,199
https://kawalpemilu.org#22811,"SUKA RAJA, RAJA BASA, LAMPUNG SELATAN, LAMPUNG",5,88,70,158
https://kawalpemilu.org#22811,"SUKA RAJA, RAJA BASA, LAMPUNG SELATAN, LAMPUNG",6,76,93,169
https://kawalpemilu.org#22811,"SUKA RAJA, RAJA BASA, LAMPUNG SELATAN, LAMPUNG",7,119,69,188
https://kawalpemilu.org#22811,"SUKA RAJA, RAJA BASA, LAMPUNG SELATAN, LAMPUNG",8,126,56,182
https://kawalpemilu.org#22812,"TANJUNG GADING, RAJA BASA, LAMPUNG SELATAN, LAMPUNG",1,73,115,188
https://kawalpemilu.org#22813,"TEJANG PULAU SEBESI, RAJA BASA, LAMPUNG SELATAN, LAMPUNG",1,140,66,206
https://kawalpemilu.org#22813,"TEJANG PULAU SEBESI, RAJA BASA, LAMPUNG SELATAN, LAMPUNG",2,173,48,221
https://kawalpemilu.org#22813,"TEJANG PULAU SEBESI, RAJA BASA, LAMPUNG SELATAN, LAMPUNG",3,140,46,186
https://kawalpemilu.org#22813,"TEJANG PULAU SEBESI, RAJA BASA, LAMPUNG SELATAN, LAMPUNG",4,137,35,172
https://kawalpemilu.org#22813,"TEJANG PULAU SEBESI, RAJA BASA, LAMPUNG SELATAN, LAMPUNG",5,84,28,112
https://kawalpemilu.org#22813,"TEJANG PULAU SEBESI, RAJA BASA, LAMPUNG SELATAN, LAMPUNG",6,133,65,198
https://kawalpemilu.org#22813,"TEJANG PULAU SEBESI, RAJA BASA, LAMPUNG SELATAN, LAMPUNG",7,157,38,195
https://kawalpemilu.org#22813,"TEJANG PULAU SEBESI, RAJA BASA, LAMPUNG SELATAN, LAMPUNG",8,112,31,143
https://kawalpemilu.org#22814,"WAY MULI, RAJA BASA, LAMPUNG SELATAN, LAMPUNG",1,148,79,227
https://kawalpemilu.org#22814,"WAY MULI, RAJA BASA, LAMPUNG SELATAN, LAMPUNG",2,125,96,221
https://kawalpemilu.org#22814,"WAY MULI, RAJA BASA, LAMPUNG SELATAN, LAMPUNG",3,139,64,203
https://kawalpemilu.org#22814,"WAY MULI, RAJA BASA, LAMPUNG SELATAN, LAMPUNG",4,137,70,207
https://kawalpemilu.org#22814,"WAY MULI, RAJA BASA, LAMPUNG SELATAN, LAMPUNG",5,111,84,195
https://kawalpemilu.org#22814,"WAY MULI, RAJA BASA, LAMPUNG SELATAN, LAMPUNG",6,101,47,148
https://kawalpemilu.org#22814,"WAY MULI, RAJA BASA, LAMPUNG SELATAN, LAMPUNG",7,116,41,157
https://kawalpemilu.org#91300,"WAI MULI TIMUR, RAJA BASA, LAMPUNG SELATAN, LAMPUNG",1,127,63,190
https://kawalpemilu.org#91300,"WAI MULI TIMUR, RAJA BASA, LAMPUNG SELATAN, LAMPUNG",2,126,55,181
https://kawalpemilu.org#91300,"WAI MULI TIMUR, RAJA BASA, LAMPUNG SELATAN, LAMPUNG",3,116,44,160
https://kawalpemilu.org#91300,"WAI MULI TIMUR, RAJA BASA, LAMPUNG SELATAN, LAMPUNG",4,111,47,158
https://kawalpemilu.org#22816,"BATU LIMAN INDAH, CANDIPURO, LAMPUNG SELATAN, LAMPUNG",1,109,70,179
https://kawalpemilu.org#22816,"BATU LIMAN INDAH, CANDIPURO, LAMPUNG SELATAN, LAMPUNG",2,157,43,200
https://kawalpemilu.org#22816,"BATU LIMAN INDAH, CANDIPURO, LAMPUNG SELATAN, LAMPUNG",3,147,50,197
https://kawalpemilu.org#22816,"BATU LIMAN INDAH, CANDIPURO, LAMPUNG SELATAN, LAMPUNG",4,157,17,174
https://kawalpemilu.org#22816,"BATU LIMAN INDAH, CANDIPURO, LAMPUNG SELATAN, LAMPUNG",5,97,76,173
https://kawalpemilu.org#22816,"BATU LIMAN INDAH, CANDIPURO, LAMPUNG SELATAN, LAMPUNG",6,143,72,215
https://kawalpemilu.org#22816,"BATU LIMAN INDAH, CANDIPURO, LAMPUNG SELATAN, LAMPUNG",7,154,55,209
https://kawalpemilu.org#22816,"BATU LIMAN INDAH, CANDIPURO, LAMPUNG SELATAN, LAMPUNG",8,164,26,190
https://kawalpemilu.org#22816,"BATU LIMAN INDAH, CANDIPURO, LAMPUNG SELATAN, LAMPUNG",9,145,40,185
https://kawalpemilu.org#22816,"BATU LIMAN INDAH, CANDIPURO, LAMPUNG SELATAN, LAMPUNG",10,157,42,199
https://kawalpemilu.org#22816,"BATU LIMAN INDAH, CANDIPURO, LAMPUNG SELATAN, LAMPUNG",11,125,21,146
https://kawalpemilu.org#22816,"BATU LIMAN INDAH, CANDIPURO, LAMPUNG SELATAN, LAMPUNG",12,140,14,154
https://kawalpemilu.org#22817,"SINAR PALEMBANG, CANDIPURO, LAMPUNG SELATAN, LAMPUNG",1,117,57,174
https://kawalpemilu.org#22817,"SINAR PALEMBANG, CANDIPURO, LAMPUNG SELATAN, LAMPUNG",2,109,78,187
https://kawalpemilu.org#22817,"SINAR PALEMBANG, CANDIPURO, LAMPUNG SELATAN, LAMPUNG",3,117,57,174
https://kawalpemilu.org#22817,"SINAR PALEMBANG, CANDIPURO, LAMPUNG SELATAN, LAMPUNG",4,159,29,188
https://kawalpemilu.org#22817,"SINAR PALEMBANG, CANDIPURO, LAMPUNG SELATAN, LAMPUNG",5,152,50,202
https://kawalpemilu.org#22817,"SINAR PALEMBANG, CANDIPURO, LAMPUNG SELATAN, LAMPUNG",6,108,74,182
https://kawalpemilu.org#22818,"RANTAU MINYAK, CANDIPURO, LAMPUNG SELATAN, LAMPUNG",1,162,35,197
https://kawalpemilu.org#22818,"RANTAU MINYAK, CANDIPURO, LAMPUNG SELATAN, LAMPUNG",2,118,72,190
https://kawalpemilu.org#22818,"RANTAU MINYAK, CANDIPURO, LAMPUNG SELATAN, LAMPUNG",3,108,104,212
https://kawalpemilu.org#22818,"RANTAU MINYAK, CANDIPURO, LAMPUNG SELATAN, LAMPUNG",4,106,34,140
https://kawalpemilu.org#22818,"RANTAU MINYAK, CANDIPURO, LAMPUNG SELATAN, LAMPUNG",5,158,37,195
https://kawalpemilu.org#22818,"RANTAU MINYAK, CANDIPURO, LAMPUNG SELATAN, LAMPUNG",6,84,27,111
https://kawalpemilu.org#22819,"SIDOASRI, CANDIPURO, LAMPUNG SELATAN, LAMPUNG",1,137,54,191
https://kawalpemilu.org#22819,"SIDOASRI, CANDIPURO, LAMPUNG SELATAN, LAMPUNG",2,149,55,204
https://kawalpemilu.org#22819,"SIDOASRI, CANDIPURO, LAMPUNG SELATAN, LAMPUNG",3,122,76,198
https://kawalpemilu.org#22819,"SIDOASRI, CANDIPURO, LAMPUNG SELATAN, LAMPUNG",4,166,44,210
https://kawalpemilu.org#22819,"SIDOASRI, CANDIPURO, LAMPUNG SELATAN, LAMPUNG",5,125,68,193
https://kawalpemilu.org#22819,"SIDOASRI, CANDIPURO, LAMPUNG SELATAN, LAMPUNG",6,151,59,210
https://kawalpemilu.org#22819,"SIDOASRI, CANDIPURO, LAMPUNG SELATAN, LAMPUNG",7,174,56,230
https://kawalpemilu.org#22819,"SIDOASRI, CANDIPURO, LAMPUNG SELATAN, LAMPUNG",8,121,61,182
https://kawalpemilu.org#22819,"SIDOASRI, CANDIPURO, LAMPUNG SELATAN, LAMPUNG",9,104,61,165
https://kawalpemilu.org#22819,"SIDOASRI, CANDIPURO, LAMPUNG SELATAN, LAMPUNG",10,133,47,180
https://kawalpemilu.org#22819,"SIDOASRI, CANDIPURO, LAMPUNG SELATAN, LAMPUNG",11,126,40,166
https://kawalpemilu.org#22819,"SIDOASRI, CANDIPURO, LAMPUNG SELATAN, LAMPUNG",12,160,41,201
https://kawalpemilu.org#22819,"SIDOASRI, CANDIPURO, LAMPUNG SELATAN, LAMPUNG",13,163,49,212
https://kawalpemilu.org#22820,"WAY GELAM, CANDIPURO, LAMPUNG SELATAN, LAMPUNG",1,148,28,176
https://kawalpemilu.org#22820,"WAY GELAM, CANDIPURO, LAMPUNG SELATAN, LAMPUNG",2,116,88,204
https://kawalpemilu.org#22820,"WAY GELAM, CANDIPURO, LAMPUNG SELATAN, LAMPUNG",3,158,55,213
https://kawalpemilu.org#22820,"WAY GELAM, CANDIPURO, LAMPUNG SELATAN, LAMPUNG",4,147,52,199
https://kawalpemilu.org#22820,"WAY GELAM, CANDIPURO, LAMPUNG SELATAN, LAMPUNG",5,143,34,177
https://kawalpemilu.org#22820,"WAY GELAM, CANDIPURO, LAMPUNG SELATAN, LAMPUNG",6,133,60,193
https://kawalpemilu.org#22820,"WAY GELAM, CANDIPURO, LAMPUNG SELATAN, LAMPUNG",7,152,49,201
https://kawalpemilu.org#22821,"CINTA MULYA, CANDIPURO, LAMPUNG SELATAN, LAMPUNG",1,121,64,185
https://kawalpemilu.org#22821,"CINTA MULYA, CANDIPURO, LAMPUNG SELATAN, LAMPUNG",2,134,45,179
https://kawalpemilu.org#22821,"CINTA MULYA, CANDIPURO, LAMPUNG SELATAN, LAMPUNG",3,134,37,171
https://kawalpemilu.org#22821,"CINTA MULYA, CANDIPURO, LAMPUNG SELATAN, LAMPUNG",4,100,65,165
https://kawalpemilu.org#22821,"CINTA MULYA, CANDIPURO, LAMPUNG SELATAN, LAMPUNG",5,135,55,190
https://kawalpemilu.org#22821,"CINTA MULYA, CANDIPURO, LAMPUNG SELATAN, LAMPUNG",6,166,18,184
https://kawalpemilu.org#22821,"CINTA MULYA, CANDIPURO, LAMPUNG SELATAN, LAMPUNG",7,164,33,197
https://kawalpemilu.org#22821,"CINTA MULYA, CANDIPURO, LAMPUNG SELATAN, LAMPUNG",8,172,19,191
https://kawalpemilu.org#22821,"CINTA MULYA, CANDIPURO, LAMPUNG SELATAN, LAMPUNG",9,173,31,204
https://kawalpemilu.org#22821,"CINTA MULYA, CANDIPURO, LAMPUNG SELATAN, LAMPUNG",10,127,35,162
https://kawalpemilu.org#22821,"CINTA MULYA, CANDIPURO, LAMPUNG SELATAN, LAMPUNG",11,173,18,191
https://kawalpemilu.org#22821,"CINTA MULYA, CANDIPURO, LAMPUNG SELATAN, LAMPUNG",12,128,46,174
https://kawalpemilu.org#22821,"CINTA MULYA, CANDIPURO, LAMPUNG SELATAN, LAMPUNG",13,147,25,172
https://kawalpemilu.org#22821,"CINTA MULYA, CANDIPURO, LAMPUNG SELATAN, LAMPUNG",14,161,36,197
https://kawalpemilu.org#22821,"CINTA MULYA, CANDIPURO, LAMPUNG SELATAN, LAMPUNG",15,158,24,182
https://kawalpemilu.org#22822,"BANYUMAS, CANDIPURO, LAMPUNG SELATAN, LAMPUNG",1,125,65,190
https://kawalpemilu.org#22822,"BANYUMAS, CANDIPURO, LAMPUNG SELATAN, LAMPUNG",2,55,110,165
https://kawalpemilu.org#22822,"BANYUMAS, CANDIPURO, LAMPUNG SELATAN, LAMPUNG",3,145,20,165
https://kawalpemilu.org#22822,"BANYUMAS, CANDIPURO, LAMPUNG SELATAN, LAMPUNG",4,49,115,164
https://kawalpemilu.org#22822,"BANYUMAS, CANDIPURO, LAMPUNG SELATAN, LAMPUNG",5,113,62,175
https://kawalpemilu.org#22822,"BANYUMAS, CANDIPURO, LAMPUNG SELATAN, LAMPUNG",6,95,78,173
https://kawalpemilu.org#22822,"BANYUMAS, CANDIPURO, LAMPUNG SELATAN, LAMPUNG",7,111,103,214
https://kawalpemilu.org#22822,"BANYUMAS, CANDIPURO, LAMPUNG SELATAN, LAMPUNG",8,96,37,133
https://kawalpemilu.org#22822,"BANYUMAS, CANDIPURO, LAMPUNG SELATAN, LAMPUNG",9,78,92,170
https://kawalpemilu.org#22822,"BANYUMAS, CANDIPURO, LAMPUNG SELATAN, LAMPUNG",10,53,65,118
https://kawalpemilu.org#22823,"BERINGIN KENCANA, CANDIPURO, LAMPUNG SELATAN, LAMPUNG",1,151,62,213
https://kawalpemilu.org#22823,"BERINGIN KENCANA, CANDIPURO, LAMPUNG SELATAN, LAMPUNG",2,135,15,150
https://kawalpemilu.org#22823,"BERINGIN KENCANA, CANDIPURO, LAMPUNG SELATAN, LAMPUNG",3,125,34,159
https://kawalpemilu.org#22823,"BERINGIN KENCANA, CANDIPURO, LAMPUNG SELATAN, LAMPUNG",4,161,38,199
https://kawalpemilu.org#22823,"BERINGIN KENCANA, CANDIPURO, LAMPUNG SELATAN, LAMPUNG",5,184,25,209
https://kawalpemilu.org#22823,"BERINGIN KENCANA, CANDIPURO, LAMPUNG SELATAN, LAMPUNG",6,168,42,210
https://kawalpemilu.org#22823,"BERINGIN KENCANA, CANDIPURO, LAMPUNG SELATAN, LAMPUNG",7,156,38,194
https://kawalpemilu.org#22823,"BERINGIN KENCANA, CANDIPURO, LAMPUNG SELATAN, LAMPUNG",8,161,20,181
https://kawalpemilu.org#22823,"BERINGIN KENCANA, CANDIPURO, LAMPUNG SELATAN, LAMPUNG",9,178,40,218
https://kawalpemilu.org#22823,"BERINGIN KENCANA, CANDIPURO, LAMPUNG SELATAN, LAMPUNG",10,147,45,192
https://kawalpemilu.org#22823,"BERINGIN KENCANA, CANDIPURO, LAMPUNG SELATAN, LAMPUNG",11,124,50,174
https://kawalpemilu.org#22823,"BERINGIN KENCANA, CANDIPURO, LAMPUNG SELATAN, LAMPUNG",12,142,37,179
https://kawalpemilu.org#22823,"BERINGIN KENCANA, CANDIPURO, LAMPUNG SELATAN, LAMPUNG",13,147,42,189
https://kawalpemilu.org#22823,"BERINGIN KENCANA, CANDIPURO, LAMPUNG SELATAN, LAMPUNG",14,148,26,174
https://kawalpemilu.org#22823,"BERINGIN KENCANA, CANDIPURO, LAMPUNG SELATAN, LAMPUNG",15,119,42,161
https://kawalpemilu.org#22823,"BERINGIN KENCANA, CANDIPURO, LAMPUNG SELATAN, LAMPUNG",16,150,46,196
https://kawalpemilu.org#22823,"BERINGIN KENCANA, CANDIPURO, LAMPUNG SELATAN, LAMPUNG",17,124,30,154
https://kawalpemilu.org#22823,"BERINGIN KENCANA, CANDIPURO, LAMPUNG SELATAN, LAMPUNG",18,158,38,196
https://kawalpemilu.org#22823,"BERINGIN KENCANA, CANDIPURO, LAMPUNG SELATAN, LAMPUNG",19,130,46,176
https://kawalpemilu.org#22823,"BERINGIN KENCANA, CANDIPURO, LAMPUNG SELATAN, LAMPUNG",20,171,49,220
https://kawalpemilu.org#22824,"SINAR PASEMAH, CANDIPURO, LAMPUNG SELATAN, LAMPUNG",1,68,120,188
https://kawalpemilu.org#22824,"SINAR PASEMAH, CANDIPURO, LAMPUNG SELATAN, LAMPUNG",2,98,60,158
https://kawalpemilu.org#22824,"SINAR PASEMAH, CANDIPURO, LAMPUNG SELATAN, LAMPUNG",3,118,60,178
https://kawalpemilu.org#22824,"SINAR PASEMAH, CANDIPURO, LAMPUNG SELATAN, LAMPUNG",4,161,29,190
https://kawalpemilu.org#22824,"SINAR PASEMAH, CANDIPURO, LAMPUNG SELATAN, LAMPUNG",5,157,50,207
https://kawalpemilu.org#22824,"SINAR PASEMAH, CANDIPURO, LAMPUNG SELATAN, LAMPUNG",6,145,54,199
https://kawalpemilu.org#22824,"SINAR PASEMAH, CANDIPURO, LAMPUNG SELATAN, LAMPUNG",7,98,38,136
https://kawalpemilu.org#22824,"SINAR PASEMAH, CANDIPURO, LAMPUNG SELATAN, LAMPUNG",8,115,35,150
https://kawalpemilu.org#22824,"SINAR PASEMAH, CANDIPURO, LAMPUNG SELATAN, LAMPUNG",9,126,63,189
https://kawalpemilu.org#22824,"SINAR PASEMAH, CANDIPURO, LAMPUNG SELATAN, LAMPUNG",10,137,38,175
https://kawalpemilu.org#22824,"SINAR PASEMAH, CANDIPURO, LAMPUNG SELATAN, LAMPUNG",11,142,23,165
https://kawalpemilu.org#22825,"RAWA SELAPAN, CANDIPURO, LAMPUNG SELATAN, LAMPUNG",1,156,21,177
https://kawalpemilu.org#22825,"RAWA SELAPAN, CANDIPURO, LAMPUNG SELATAN, LAMPUNG",2,144,14,158
https://kawalpemilu.org#22825,"RAWA SELAPAN, CANDIPURO, LAMPUNG SELATAN, LAMPUNG",3,148,19,167
https://kawalpemilu.org#22825,"RAWA SELAPAN, CANDIPURO, LAMPUNG SELATAN, LAMPUNG",4,172,57,229
https://kawalpemilu.org#22825,"RAWA SELAPAN, CANDIPURO, LAMPUNG SELATAN, LAMPUNG",5,147,53,200
https://kawalpemilu.org#22825,"RAWA SELAPAN, CANDIPURO, LAMPUNG SELATAN, LAMPUNG",6,180,31,211
https://kawalpemilu.org#22825,"RAWA SELAPAN, CANDIPURO, LAMPUNG SELATAN, LAMPUNG",8,183,25,208
https://kawalpemilu.org#22825,"RAWA SELAPAN, CANDIPURO, LAMPUNG SELATAN, LAMPUNG",9,165,20,185
https://kawalpemilu.org#22825,"RAWA SELAPAN, CANDIPURO, LAMPUNG SELATAN, LAMPUNG",10,135,16,151
https://kawalpemilu.org#22825,"RAWA SELAPAN, CANDIPURO, LAMPUNG SELATAN, LAMPUNG",11,146,50,196
https://kawalpemilu.org#22825,"RAWA SELAPAN, CANDIPURO, LAMPUNG SELATAN, LAMPUNG",12,198,32,230
https://kawalpemilu.org#22825,"RAWA SELAPAN, CANDIPURO, LAMPUNG SELATAN, LAMPUNG",13,151,35,186
https://kawalpemilu.org#22825,"RAWA SELAPAN, CANDIPURO, LAMPUNG SELATAN, LAMPUNG",14,164,17,181
https://kawalpemilu.org#22826,"BUMI JAYA, CANDIPURO, LAMPUNG SELATAN, LAMPUNG",1,123,37,160
https://kawalpemilu.org#22826,"BUMI JAYA, CANDIPURO, LAMPUNG SELATAN, LAMPUNG",2,70,116,186
https://kawalpemilu.org#22826,"BUMI JAYA, CANDIPURO, LAMPUNG SELATAN, LAMPUNG",3,137,54,191
https://kawalpemilu.org#22826,"BUMI JAYA, CANDIPURO, LAMPUNG SELATAN, LAMPUNG",4,110,72,182
https://kawalpemilu.org#22826,"BUMI JAYA, CANDIPURO, LAMPUNG SELATAN, LAMPUNG",5,103,72,175
https://kawalpemilu.org#22826,"BUMI JAYA, CANDIPURO, LAMPUNG SELATAN, LAMPUNG",6,116,40,156
https://kawalpemilu.org#22826,"BUMI JAYA, CANDIPURO, LAMPUNG SELATAN, LAMPUNG",7,152,42,194
https://kawalpemilu.org#22826,"BUMI JAYA, CANDIPURO, LAMPUNG SELATAN, LAMPUNG",8,69,90,159
https://kawalpemilu.org#22826,"BUMI JAYA, CANDIPURO, LAMPUNG SELATAN, LAMPUNG",9,121,43,164
https://kawalpemilu.org#22826,"BUMI JAYA, CANDIPURO, LAMPUNG SELATAN, LAMPUNG",10,140,43,183
https://kawalpemilu.org#22826,"BUMI JAYA, CANDIPURO, LAMPUNG SELATAN, LAMPUNG",11,140,59,199
https://kawalpemilu.org#22826,"BUMI JAYA, CANDIPURO, LAMPUNG SELATAN, LAMPUNG",12,108,47,149
https://kawalpemilu.org#22827,"TRIMO MUKTI, CANDIPURO, LAMPUNG SELATAN, LAMPUNG",1,146,26,172
https://kawalpemilu.org#22827,"TRIMO MUKTI, CANDIPURO, LAMPUNG SELATAN, LAMPUNG",2,123,28,151
https://kawalpemilu.org#22827,"TRIMO MUKTI, CANDIPURO, LAMPUNG SELATAN, LAMPUNG",3,143,28,171
https://kawalpemilu.org#22827,"TRIMO MUKTI, CANDIPURO, LAMPUNG SELATAN, LAMPUNG",4,191,21,212
https://kawalpemilu.org#22827,"TRIMO MUKTI, CANDIPURO, LAMPUNG SELATAN, LAMPUNG",5,213,13,226
https://kawalpemilu.org#22827,"TRIMO MUKTI, CANDIPURO, LAMPUNG SELATAN, LAMPUNG",6,196,16,212
https://kawalpemilu.org#22827,"TRIMO MUKTI, CANDIPURO, LAMPUNG SELATAN, LAMPUNG",7,184,8,192
https://kawalpemilu.org#22827,"TRIMO MUKTI, CANDIPURO, LAMPUNG SELATAN, LAMPUNG",8,118,22,140
https://kawalpemilu.org#22827,"TRIMO MUKTI, CANDIPURO, LAMPUNG SELATAN, LAMPUNG",9,112,34,146
https://kawalpemilu.org#22827,"TRIMO MUKTI, CANDIPURO, LAMPUNG SELATAN, LAMPUNG",10,115,44,159
https://kawalpemilu.org#22827,"TRIMO MUKTI, CANDIPURO, LAMPUNG SELATAN, LAMPUNG",11,131,22,153
https://kawalpemilu.org#22827,"TRIMO MUKTI, CANDIPURO, LAMPUNG SELATAN, LAMPUNG",12,111,14,125
https://kawalpemilu.org#22827,"TRIMO MUKTI, CANDIPURO, LAMPUNG SELATAN, LAMPUNG",13,147,46,193
https://kawalpemilu.org#22827,"TRIMO MUKTI, CANDIPURO, LAMPUNG SELATAN, LAMPUNG",14,148,33,181
https://kawalpemilu.org#22828,"TITIWANGI, CANDIPURO, LAMPUNG SELATAN, LAMPUNG",1,154,48,202
https://kawalpemilu.org#22828,"TITIWANGI, CANDIPURO, LAMPUNG SELATAN, LAMPUNG",2,111,52,163
https://kawalpemilu.org#22828,"TITIWANGI, CANDIPURO, LAMPUNG SELATAN, LAMPUNG",3,157,62,219
https://kawalpemilu.org#22828,"TITIWANGI, CANDIPURO, LAMPUNG SELATAN, LAMPUNG",4,146,48,194
https://kawalpemilu.org#22828,"TITIWANGI, CANDIPURO, LAMPUNG SELATAN, LAMPUNG",5,106,68,174
https://kawalpemilu.org#22828,"TITIWANGI, CANDIPURO, LAMPUNG SELATAN, LAMPUNG",6,121,44,165
https://kawalpemilu.org#22828,"TITIWANGI, CANDIPURO, LAMPUNG SELATAN, LAMPUNG",7,127,57,184
https://kawalpemilu.org#22828,"TITIWANGI, CANDIPURO, LAMPUNG SELATAN, LAMPUNG",8,117,46,163
https://kawalpemilu.org#22828,"TITIWANGI, CANDIPURO, LAMPUNG SELATAN, LAMPUNG",9,122,48,170
https://kawalpemilu.org#22828,"TITIWANGI, CANDIPURO, LAMPUNG SELATAN, LAMPUNG",10,108,73,181
https://kawalpemilu.org#22828,"TITIWANGI, CANDIPURO, LAMPUNG SELATAN, LAMPUNG",11,156,27,183
https://kawalpemilu.org#22828,"TITIWANGI, CANDIPURO, LAMPUNG SELATAN, LAMPUNG",12,171,32,203
https://kawalpemilu.org#22828,"TITIWANGI, CANDIPURO, LAMPUNG SELATAN, LAMPUNG",13,133,42,175
https://kawalpemilu.org#22828,"TITIWANGI, CANDIPURO, LAMPUNG SELATAN, LAMPUNG",14,151,44,195
https://kawalpemilu.org#22828,"TITIWANGI, CANDIPURO, LAMPUNG SELATAN, LAMPUNG",15,175,38,213
https://kawalpemilu.org#22828,"TITIWANGI, CANDIPURO, LAMPUNG SELATAN, LAMPUNG",16,152,65,217
https://kawalpemilu.org#22828,"TITIWANGI, CANDIPURO, LAMPUNG SELATAN, LAMPUNG",17,153,66,219
https://kawalpemilu.org#22828,"TITIWANGI, CANDIPURO, LAMPUNG SELATAN, LAMPUNG",18,131,74,205
https://kawalpemilu.org#22829,"KARYA MULYA SARI, CANDIPURO, LAMPUNG SELATAN, LAMPUNG",1,113,34,147
https://kawalpemilu.org#22829,"KARYA MULYA SARI, CANDIPURO, LAMPUNG SELATAN, LAMPUNG",2,130,27,157
https://kawalpemilu.org#22829,"KARYA MULYA SARI, CANDIPURO, LAMPUNG SELATAN, LAMPUNG",3,131,43,174
https://kawalpemilu.org#22829,"KARYA MULYA SARI, CANDIPURO, LAMPUNG SELATAN, LAMPUNG",4,164,20,184
https://kawalpemilu.org#22829,"KARYA MULYA SARI, CANDIPURO, LAMPUNG SELATAN, LAMPUNG",5,158,34,192
https://kawalpemilu.org#22829,"KARYA MULYA SARI, CANDIPURO, LAMPUNG SELATAN, LAMPUNG",6,98,76,174
https://kawalpemilu.org#22829,"KARYA MULYA SARI, CANDIPURO, LAMPUNG SELATAN, LAMPUNG",7,124,68,192
https://kawalpemilu.org#22829,"KARYA MULYA SARI, CANDIPURO, LAMPUNG SELATAN, LAMPUNG",8,152,35,187
https://kawalpemilu.org#22829,"KARYA MULYA SARI, CANDIPURO, LAMPUNG SELATAN, LAMPUNG",9,128,34,162
https://kawalpemilu.org#22829,"KARYA MULYA SARI, CANDIPURO, LAMPUNG SELATAN, LAMPUNG",10,103,43,146
https://kawalpemilu.org#22829,"KARYA MULYA SARI, CANDIPURO, LAMPUNG SELATAN, LAMPUNG",11,142,33,175
https://kawalpemilu.org#22829,"KARYA MULYA SARI, CANDIPURO, LAMPUNG SELATAN, LAMPUNG",12,83,41,124
https://kawalpemilu.org#22831,"MERBAU MATARAM, MERBAU MATARAM, LAMPUNG SELATAN, LAMPUNG",1,125,85,210
https://kawalpemilu.org#22831,"MERBAU MATARAM, MERBAU MATARAM, LAMPUNG SELATAN, LAMPUNG",2,131,46,177
https://kawalpemilu.org#22831,"MERBAU MATARAM, MERBAU MATARAM, LAMPUNG SELATAN, LAMPUNG",3,121,87,208
https://kawalpemilu.org#22831,"MERBAU MATARAM, MERBAU MATARAM, LAMPUNG SELATAN, LAMPUNG",5,112,97,209
https://kawalpemilu.org#22831,"MERBAU MATARAM, MERBAU MATARAM, LAMPUNG SELATAN, LAMPUNG",6,135,62,197
https://kawalpemilu.org#22831,"MERBAU MATARAM, MERBAU MATARAM, LAMPUNG SELATAN, LAMPUNG",7,109,97,206
https://kawalpemilu.org#22831,"MERBAU MATARAM, MERBAU MATARAM, LAMPUNG SELATAN, LAMPUNG",8,85,124,209
https://kawalpemilu.org#22831,"MERBAU MATARAM, MERBAU MATARAM, LAMPUNG SELATAN, LAMPUNG",9,115,89,204
https://kawalpemilu.org#22831,"MERBAU MATARAM, MERBAU MATARAM, LAMPUNG SELATAN, LAMPUNG",10,107,115,222
https://kawalpemilu.org#22831,"MERBAU MATARAM, MERBAU MATARAM, LAMPUNG SELATAN, LAMPUNG",11,109,72,181
https://kawalpemilu.org#22831,"MERBAU MATARAM, MERBAU MATARAM, LAMPUNG SELATAN, LAMPUNG",12,106,49,155
https://kawalpemilu.org#22831,"MERBAU MATARAM, MERBAU MATARAM, LAMPUNG SELATAN, LAMPUNG",13,118,65,183
https://kawalpemilu.org#22831,"MERBAU MATARAM, MERBAU MATARAM, LAMPUNG SELATAN, LAMPUNG",14,114,72,186
https://kawalpemilu.org#22831,"MERBAU MATARAM, MERBAU MATARAM, LAMPUNG SELATAN, LAMPUNG",15,128,93,221
https://kawalpemilu.org#22831,"MERBAU MATARAM, MERBAU MATARAM, LAMPUNG SELATAN, LAMPUNG",16,113,59,172
https://kawalpemilu.org#22831,"MERBAU MATARAM, MERBAU MATARAM, LAMPUNG SELATAN, LAMPUNG",17,88,95,183
https://kawalpemilu.org#22831,"MERBAU MATARAM, MERBAU MATARAM, LAMPUNG SELATAN, LAMPUNG",18,137,79,216
https://kawalpemilu.org#22831,"MERBAU MATARAM, MERBAU MATARAM, LAMPUNG SELATAN, LAMPUNG",19,110,121,231
https://kawalpemilu.org#22832,"SUBAN, MERBAU MATARAM, LAMPUNG SELATAN, LAMPUNG",1,61,107,168
https://kawalpemilu.org#22832,"SUBAN, MERBAU MATARAM, LAMPUNG SELATAN, LAMPUNG",2,65,110,175
https://kawalpemilu.org#22832,"SUBAN, MERBAU MATARAM, LAMPUNG SELATAN, LAMPUNG",3,85,118,203
https://kawalpemilu.org#22832,"SUBAN, MERBAU MATARAM, LAMPUNG SELATAN, LAMPUNG",4,116,56,172
https://kawalpemilu.org#22832,"SUBAN, MERBAU MATARAM, LAMPUNG SELATAN, LAMPUNG",5,118,46,164
https://kawalpemilu.org#22832,"SUBAN, MERBAU MATARAM, LAMPUNG SELATAN, LAMPUNG",6,75,95,170
https://kawalpemilu.org#22832,"SUBAN, MERBAU MATARAM, LAMPUNG SELATAN, LAMPUNG",7,200,29,229
https://kawalpemilu.org#22832,"SUBAN, MERBAU MATARAM, LAMPUNG SELATAN, LAMPUNG",8,122,39,161
https://kawalpemilu.org#22832,"SUBAN, MERBAU MATARAM, LAMPUNG SELATAN, LAMPUNG",9,113,37,150
https://kawalpemilu.org#22832,"SUBAN, MERBAU MATARAM, LAMPUNG SELATAN, LAMPUNG",10,101,79,180
https://kawalpemilu.org#22832,"SUBAN, MERBAU MATARAM, LAMPUNG SELATAN, LAMPUNG",11,62,105,167
https://kawalpemilu.org#22832,"SUBAN, MERBAU MATARAM, LAMPUNG SELATAN, LAMPUNG",12,80,106,186
https://kawalpemilu.org#22832,"SUBAN, MERBAU MATARAM, LAMPUNG SELATAN, LAMPUNG",13,93,52,145
https://kawalpemilu.org#22832,"SUBAN, MERBAU MATARAM, LAMPUNG SELATAN, LAMPUNG",14,124,21,145
https://kawalpemilu.org#22832,"SUBAN, MERBAU MATARAM, LAMPUNG SELATAN, LAMPUNG",15,112,37,149
https://kawalpemilu.org#22832,"SUBAN, MERBAU MATARAM, LAMPUNG SELATAN, LAMPUNG",16,153,48,201
https://kawalpemilu.org#22833,"TANJUNG BARU, MERBAU MATARAM, LAMPUNG SELATAN, LAMPUNG",1,106,40,146
https://kawalpemilu.org#22833,"TANJUNG BARU, MERBAU MATARAM, LAMPUNG SELATAN, LAMPUNG",2,119,65,184
https://kawalpemilu.org#22833,"TANJUNG BARU, MERBAU MATARAM, LAMPUNG SELATAN, LAMPUNG",3,76,137,213
https://kawalpemilu.org#22833,"TANJUNG BARU, MERBAU MATARAM, LAMPUNG SELATAN, LAMPUNG",4,125,117,242
https://kawalpemilu.org#22833,"TANJUNG BARU, MERBAU MATARAM, LAMPUNG SELATAN, LAMPUNG",5,160,55,215
https://kawalpemilu.org#22833,"TANJUNG BARU, MERBAU MATARAM, LAMPUNG SELATAN, LAMPUNG",6,96,86,182
https://kawalpemilu.org#22833,"TANJUNG BARU, MERBAU MATARAM, LAMPUNG SELATAN, LAMPUNG",7,91,97,188
https://kawalpemilu.org#22833,"TANJUNG BARU, MERBAU MATARAM, LAMPUNG SELATAN, LAMPUNG",8,98,145,243
https://kawalpemilu.org#22833,"TANJUNG BARU, MERBAU MATARAM, LAMPUNG SELATAN, LAMPUNG",9,157,69,226
https://kawalpemilu.org#22833,"TANJUNG BARU, MERBAU MATARAM, LAMPUNG SELATAN, LAMPUNG",10,159,68,227
https://kawalpemilu.org#22833,"TANJUNG BARU, MERBAU MATARAM, LAMPUNG SELATAN, LAMPUNG",11,105,72,177
https://kawalpemilu.org#22833,"TANJUNG BARU, MERBAU MATARAM, LAMPUNG SELATAN, LAMPUNG",12,128,49,177
https://kawalpemilu.org#22833,"TANJUNG BARU, MERBAU MATARAM, LAMPUNG SELATAN, LAMPUNG",13,63,30,93
https://kawalpemilu.org#22833,"TANJUNG BARU, MERBAU MATARAM, LAMPUNG SELATAN, LAMPUNG",14,106,115,221
https://kawalpemilu.org#22833,"TANJUNG BARU, MERBAU MATARAM, LAMPUNG SELATAN, LAMPUNG",15,156,51,207
https://kawalpemilu.org#22833,"TANJUNG BARU, MERBAU MATARAM, LAMPUNG SELATAN, LAMPUNG",16,147,61,208
https://kawalpemilu.org#22833,"TANJUNG BARU, MERBAU MATARAM, LAMPUNG SELATAN, LAMPUNG",17,88,66,154
https://kawalpemilu.org#22833,"TANJUNG BARU, MERBAU MATARAM, LAMPUNG SELATAN, LAMPUNG",18,93,91,184
https://kawalpemilu.org#22833,"TANJUNG BARU, MERBAU MATARAM, LAMPUNG SELATAN, LAMPUNG",19,83,146,229
https://kawalpemilu.org#22833,"TANJUNG BARU, MERBAU MATARAM, LAMPUNG SELATAN, LAMPUNG",20,131,49,180
https://kawalpemilu.org#22833,"TANJUNG BARU, MERBAU MATARAM, LAMPUNG SELATAN, LAMPUNG",21,135,65,200
https://kawalpemilu.org#22833,"TANJUNG BARU, MERBAU MATARAM, LAMPUNG SELATAN, LAMPUNG",22,101,73,174
https://kawalpemilu.org#22834,"BARU RANJI, MERBAU MATARAM, LAMPUNG SELATAN, LAMPUNG",1,114,30,144
https://kawalpemilu.org#22834,"BARU RANJI, MERBAU MATARAM, LAMPUNG SELATAN, LAMPUNG",2,87,81,168
https://kawalpemilu.org#22834,"BARU RANJI, MERBAU MATARAM, LAMPUNG SELATAN, LAMPUNG",3,62,80,142
https://kawalpemilu.org#22834,"BARU RANJI, MERBAU MATARAM, LAMPUNG SELATAN, LAMPUNG",4,78,88,166
https://kawalpemilu.org#22834,"BARU RANJI, MERBAU MATARAM, LAMPUNG SELATAN, LAMPUNG",5,136,65,201
https://kawalpemilu.org#22834,"BARU RANJI, MERBAU MATARAM, LAMPUNG SELATAN, LAMPUNG",6,64,66,130
https://kawalpemilu.org#22834,"BARU RANJI, MERBAU MATARAM, LAMPUNG SELATAN, LAMPUNG",7,63,64,127
https://kawalpemilu.org#22834,"BARU RANJI, MERBAU MATARAM, LAMPUNG SELATAN, LAMPUNG",8,43,136,179
https://kawalpemilu.org#22834,"BARU RANJI, MERBAU MATARAM, LAMPUNG SELATAN, LAMPUNG",9,148,66,214
https://kawalpemilu.org#22834,"BARU RANJI, MERBAU MATARAM, LAMPUNG SELATAN, LAMPUNG",10,91,87,178
https://kawalpemilu.org#22834,"BARU RANJI, MERBAU MATARAM, LAMPUNG SELATAN, LAMPUNG",11,97,51,148
https://kawalpemilu.org#22834,"BARU RANJI, MERBAU MATARAM, LAMPUNG SELATAN, LAMPUNG",12,61,90,151
https://kawalpemilu.org#22834,"BARU RANJI, MERBAU MATARAM, LAMPUNG SELATAN, LAMPUNG",13,78,38,116
https://kawalpemilu.org#22834,"BARU RANJI, MERBAU MATARAM, LAMPUNG SELATAN, LAMPUNG",14,77,47,124
https://kawalpemilu.org#22834,"BARU RANJI, MERBAU MATARAM, LAMPUNG SELATAN, LAMPUNG",15,53,47,100
https://kawalpemilu.org#22834,"BARU RANJI, MERBAU MATARAM, LAMPUNG SELATAN, LAMPUNG",16,97,60,157
https://kawalpemilu.org#22834,"BARU RANJI, MERBAU MATARAM, LAMPUNG SELATAN, LAMPUNG",17,86,43,129
https://kawalpemilu.org#22834,"BARU RANJI, MERBAU MATARAM, LAMPUNG SELATAN, LAMPUNG",18,79,69,148
https://kawalpemilu.org#22834,"BARU RANJI, MERBAU MATARAM, LAMPUNG SELATAN, LAMPUNG",19,65,46,111
https://kawalpemilu.org#22834,"BARU RANJI, MERBAU MATARAM, LAMPUNG SELATAN, LAMPUNG",20,67,61,128
https://kawalpemilu.org#22834,"BARU RANJI, MERBAU MATARAM, LAMPUNG SELATAN, LAMPUNG",21,124,88,212
https://kawalpemilu.org#22834,"BARU RANJI, MERBAU MATARAM, LAMPUNG SELATAN, LAMPUNG",22,32,87,119
https://kawalpemilu.org#22834,"BARU RANJI, MERBAU MATARAM, LAMPUNG SELATAN, LAMPUNG",23,47,96,143
https://kawalpemilu.org#22835,"KARANG RAJA, MERBAU MATARAM, LAMPUNG SELATAN, LAMPUNG",1,70,83,153
https://kawalpemilu.org#22835,"KARANG RAJA, MERBAU MATARAM, LAMPUNG SELATAN, LAMPUNG",2,71,95,166
https://kawalpemilu.org#22835,"KARANG RAJA, MERBAU MATARAM, LAMPUNG SELATAN, LAMPUNG",3,99,111,210
https://kawalpemilu.org#22835,"KARANG RAJA, MERBAU MATARAM, LAMPUNG SELATAN, LAMPUNG",4,168,34,202
https://kawalpemilu.org#22835,"KARANG RAJA, MERBAU MATARAM, LAMPUNG SELATAN, LAMPUNG",5,73,98,171
https://kawalpemilu.org#22835,"KARANG RAJA, MERBAU MATARAM, LAMPUNG SELATAN, LAMPUNG",6,49,91,140
https://kawalpemilu.org#22835,"KARANG RAJA, MERBAU MATARAM, LAMPUNG SELATAN, LAMPUNG",7,146,80,226
https://kawalpemilu.org#22835,"KARANG RAJA, MERBAU MATARAM, LAMPUNG SELATAN, LAMPUNG",8,83,97,180
https://kawalpemilu.org#22835,"KARANG RAJA, MERBAU MATARAM, LAMPUNG SELATAN, LAMPUNG",9,68,85,153
https://kawalpemilu.org#22836,"TALANG JAWA, MERBAU MATARAM, LAMPUNG SELATAN, LAMPUNG",1,80,125,205
https://kawalpemilu.org#22836,"TALANG JAWA, MERBAU MATARAM, LAMPUNG SELATAN, LAMPUNG",2,143,51,194
https://kawalpemilu.org#22836,"TALANG JAWA, MERBAU MATARAM, LAMPUNG SELATAN, LAMPUNG",3,173,43,216
https://kawalpemilu.org#22836,"TALANG JAWA, MERBAU MATARAM, LAMPUNG SELATAN, LAMPUNG",4,63,101,164
https://kawalpemilu.org#22836,"TALANG JAWA, MERBAU MATARAM, LAMPUNG SELATAN, LAMPUNG",5,157,45,202
https://kawalpemilu.org#22836,"TALANG JAWA, MERBAU MATARAM, LAMPUNG SELATAN, LAMPUNG",6,118,83,201
https://kawalpemilu.org#22836,"TALANG JAWA, MERBAU MATARAM, LAMPUNG SELATAN, LAMPUNG",7,126,84,210
https://kawalpemilu.org#22836,"TALANG JAWA, MERBAU MATARAM, LAMPUNG SELATAN, LAMPUNG",8,69,95,164
https://kawalpemilu.org#22836,"TALANG JAWA, MERBAU MATARAM, LAMPUNG SELATAN, LAMPUNG",9,151,51,202
https://kawalpemilu.org#22837,"LEBUNG SARI, MERBAU MATARAM, LAMPUNG SELATAN, LAMPUNG",1,100,61,161
https://kawalpemilu.org#22837,"LEBUNG SARI, MERBAU MATARAM, LAMPUNG SELATAN, LAMPUNG",2,112,76,188
https://kawalpemilu.org#22837,"LEBUNG SARI, MERBAU MATARAM, LAMPUNG SELATAN, LAMPUNG",3,96,71,167
https://kawalpemilu.org#22837,"LEBUNG SARI, MERBAU MATARAM, LAMPUNG SELATAN, LAMPUNG",4,118,21,139
https://kawalpemilu.org#22837,"LEBUNG SARI, MERBAU MATARAM, LAMPUNG SELATAN, LAMPUNG",5,103,76,179
https://kawalpemilu.org#22838,"PUJI RAHAYU, MERBAU MATARAM, LAMPUNG SELATAN, LAMPUNG",1,153,32,185
https://kawalpemilu.org#22838,"PUJI RAHAYU, MERBAU MATARAM, LAMPUNG SELATAN, LAMPUNG",2,127,50,177
https://kawalpemilu.org#22838,"PUJI RAHAYU, MERBAU MATARAM, LAMPUNG SELATAN, LAMPUNG",3,111,52,163
https://kawalpemilu.org#22838,"PUJI RAHAYU, MERBAU MATARAM, LAMPUNG SELATAN, LAMPUNG",4,115,75,190
https://kawalpemilu.org#22838,"PUJI RAHAYU, MERBAU MATARAM, LAMPUNG SELATAN, LAMPUNG",5,114,49,163
https://kawalpemilu.org#22839,"BATU AGUNG, MERBAU MATARAM, LAMPUNG SELATAN, LAMPUNG",1,150,18,168
https://kawalpemilu.org#22839,"BATU AGUNG, MERBAU MATARAM, LAMPUNG SELATAN, LAMPUNG",2,147,43,190
https://kawalpemilu.org#22839,"BATU AGUNG, MERBAU MATARAM, LAMPUNG SELATAN, LAMPUNG",3,129,29,158
https://kawalpemilu.org#22839,"BATU AGUNG, MERBAU MATARAM, LAMPUNG SELATAN, LAMPUNG",4,136,57,193
https://kawalpemilu.org#22839,"BATU AGUNG, MERBAU MATARAM, LAMPUNG SELATAN, LAMPUNG",5,169,13,182
https://kawalpemilu.org#22840,"TANJUNG HARAPAN, MERBAU MATARAM, LAMPUNG SELATAN, LAMPUNG",1,93,83,176
https://kawalpemilu.org#22840,"TANJUNG HARAPAN, MERBAU MATARAM, LAMPUNG SELATAN, LAMPUNG",2,145,40,185
https://kawalpemilu.org#22840,"TANJUNG HARAPAN, MERBAU MATARAM, LAMPUNG SELATAN, LAMPUNG",3,143,27,170
https://kawalpemilu.org#22840,"TANJUNG HARAPAN, MERBAU MATARAM, LAMPUNG SELATAN, LAMPUNG",4,151,11,162
https://kawalpemilu.org#22840,"TANJUNG HARAPAN, MERBAU MATARAM, LAMPUNG SELATAN, LAMPUNG",5,119,50,169
https://kawalpemilu.org#22840,"TANJUNG HARAPAN, MERBAU MATARAM, LAMPUNG SELATAN, LAMPUNG",6,119,54,173
https://kawalpemilu.org#22841,"SINAR KARYA, MERBAU MATARAM, LAMPUNG SELATAN, LAMPUNG",1,147,32,179
https://kawalpemilu.org#22841,"SINAR KARYA, MERBAU MATARAM, LAMPUNG SELATAN, LAMPUNG",2,129,37,166
https://kawalpemilu.org#22841,"SINAR KARYA, MERBAU MATARAM, LAMPUNG SELATAN, LAMPUNG",3,124,13,137
https://kawalpemilu.org#22841,"SINAR KARYA, MERBAU MATARAM, LAMPUNG SELATAN, LAMPUNG",4,121,23,144
https://kawalpemilu.org#22841,"SINAR KARYA, MERBAU MATARAM, LAMPUNG SELATAN, LAMPUNG",5,88,43,131
https://kawalpemilu.org#22842,"TRI HARJO, MERBAU MATARAM, LAMPUNG SELATAN, LAMPUNG",1,155,49,204
https://kawalpemilu.org#22842,"TRI HARJO, MERBAU MATARAM, LAMPUNG SELATAN, LAMPUNG",2,128,50,178
https://kawalpemilu.org#22842,"TRI HARJO, MERBAU MATARAM, LAMPUNG SELATAN, LAMPUNG",3,154,49,203
https://kawalpemilu.org#22842,"TRI HARJO, MERBAU MATARAM, LAMPUNG SELATAN, LAMPUNG",4,133,57,190
https://kawalpemilu.org#22842,"TRI HARJO, MERBAU MATARAM, LAMPUNG SELATAN, LAMPUNG",5,182,38,220
https://kawalpemilu.org#22842,"TRI HARJO, MERBAU MATARAM, LAMPUNG SELATAN, LAMPUNG",7,172,42,214
https://kawalpemilu.org#22842,"TRI HARJO, MERBAU MATARAM, LAMPUNG SELATAN, LAMPUNG",8,141,29,170
https://kawalpemilu.org#22842,"TRI HARJO, MERBAU MATARAM, LAMPUNG SELATAN, LAMPUNG",9,158,50,208
https://kawalpemilu.org#22842,"TRI HARJO, MERBAU MATARAM, LAMPUNG SELATAN, LAMPUNG",11,135,44,179
https://kawalpemilu.org#22842,"TRI HARJO, MERBAU MATARAM, LAMPUNG SELATAN, LAMPUNG",12,156,41,197
https://kawalpemilu.org#22842,"TRI HARJO, MERBAU MATARAM, LAMPUNG SELATAN, LAMPUNG",13,192,26,218
https://kawalpemilu.org#22843,"PANCA TUNGGAL, MERBAU MATARAM, LAMPUNG SELATAN, LAMPUNG",1,169,34,203
https://kawalpemilu.org#22843,"PANCA TUNGGAL, MERBAU MATARAM, LAMPUNG SELATAN, LAMPUNG",2,188,13,201
https://kawalpemilu.org#22843,"PANCA TUNGGAL, MERBAU MATARAM, LAMPUNG SELATAN, LAMPUNG",3,195,17,212
https://kawalpemilu.org#22843,"PANCA TUNGGAL, MERBAU MATARAM, LAMPUNG SELATAN, LAMPUNG",4,204,15,219
https://kawalpemilu.org#22843,"PANCA TUNGGAL, MERBAU MATARAM, LAMPUNG SELATAN, LAMPUNG",5,159,29,188
https://kawalpemilu.org#22843,"PANCA TUNGGAL, MERBAU MATARAM, LAMPUNG SELATAN, LAMPUNG",6,172,36,208
https://kawalpemilu.org#22843,"PANCA TUNGGAL, MERBAU MATARAM, LAMPUNG SELATAN, LAMPUNG",7,123,49,172
https://kawalpemilu.org#22843,"PANCA TUNGGAL, MERBAU MATARAM, LAMPUNG SELATAN, LAMPUNG",8,173,23,196
https://kawalpemilu.org#22843,"PANCA TUNGGAL, MERBAU MATARAM, LAMPUNG SELATAN, LAMPUNG",9,168,26,194
https://kawalpemilu.org#22843,"PANCA TUNGGAL, MERBAU MATARAM, LAMPUNG SELATAN, LAMPUNG",10,190,25,215
https://kawalpemilu.org#22843,"PANCA TUNGGAL, MERBAU MATARAM, LAMPUNG SELATAN, LAMPUNG",11,163,30,193
https://kawalpemilu.org#22843,"PANCA TUNGGAL, MERBAU MATARAM, LAMPUNG SELATAN, LAMPUNG",12,140,32,172
https://kawalpemilu.org#22843,"PANCA TUNGGAL, MERBAU MATARAM, LAMPUNG SELATAN, LAMPUNG",13,135,32,167
https://kawalpemilu.org#22844,"MEKARJAYA, MERBAU MATARAM, LAMPUNG SELATAN, LAMPUNG",1,108,92,200
https://kawalpemilu.org#22844,"MEKARJAYA, MERBAU MATARAM, LAMPUNG SELATAN, LAMPUNG",2,74,104,178
https://kawalpemilu.org#22844,"MEKARJAYA, MERBAU MATARAM, LAMPUNG SELATAN, LAMPUNG",3,90,111,201
https://kawalpemilu.org#22844,"MEKARJAYA, MERBAU MATARAM, LAMPUNG SELATAN, LAMPUNG",4,124,81,205
https://kawalpemilu.org#22844,"MEKARJAYA, MERBAU MATARAM, LAMPUNG SELATAN, LAMPUNG",5,106,84,190
https://kawalpemilu.org#22844,"MEKARJAYA, MERBAU MATARAM, LAMPUNG SELATAN, LAMPUNG",6,153,49,202
https://kawalpemilu.org#22844,"MEKARJAYA, MERBAU MATARAM, LAMPUNG SELATAN, LAMPUNG",7,99,79,178
https://kawalpemilu.org#22844,"MEKARJAYA, MERBAU MATARAM, LAMPUNG SELATAN, LAMPUNG",8,60,129,189
https://kawalpemilu.org#22844,"MEKARJAYA, MERBAU MATARAM, LAMPUNG SELATAN, LAMPUNG",9,89,84,173
https://kawalpemilu.org#22844,"MEKARJAYA, MERBAU MATARAM, LAMPUNG SELATAN, LAMPUNG",10,156,60,216
https://kawalpemilu.org#22844,"MEKARJAYA, MERBAU MATARAM, LAMPUNG SELATAN, LAMPUNG",11,104,93,197
https://kawalpemilu.org#22845,"KARANG JAYA, MERBAU MATARAM, LAMPUNG SELATAN, LAMPUNG",1,113,78,191
https://kawalpemilu.org#22845,"KARANG JAYA, MERBAU MATARAM, LAMPUNG SELATAN, LAMPUNG",2,99,82,181
https://kawalpemilu.org#22845,"KARANG JAYA, MERBAU MATARAM, LAMPUNG SELATAN, LAMPUNG",3,85,133,218
https://kawalpemilu.org#22845,"KARANG JAYA, MERBAU MATARAM, LAMPUNG SELATAN, LAMPUNG",4,44,32,76
https://kawalpemilu.org#22845,"KARANG JAYA, MERBAU MATARAM, LAMPUNG SELATAN, LAMPUNG",5,61,146,207
https://kawalpemilu.org#22845,"KARANG JAYA, MERBAU MATARAM, LAMPUNG SELATAN, LAMPUNG",6,44,22,66
https://kawalpemilu.org#22847,"SEMANAK, BAKAUHENI, LAMPUNG SELATAN, LAMPUNG",1,138,36,174
https://kawalpemilu.org#22847,"SEMANAK, BAKAUHENI, LAMPUNG SELATAN, LAMPUNG",2,121,36,157
https://kawalpemilu.org#22847,"SEMANAK, BAKAUHENI, LAMPUNG SELATAN, LAMPUNG",3,128,39,167
https://kawalpemilu.org#22847,"SEMANAK, BAKAUHENI, LAMPUNG SELATAN, LAMPUNG",4,99,41,140
https://kawalpemilu.org#22848,"TOTO HARJO, BAKAUHENI, LAMPUNG SELATAN, LAMPUNG",1,128,22,150
https://kawalpemilu.org#22848,"TOTO HARJO, BAKAUHENI, LAMPUNG SELATAN, LAMPUNG",2,150,26,176
https://kawalpemilu.org#22848,"TOTO HARJO, BAKAUHENI, LAMPUNG SELATAN, LAMPUNG",3,126,20,146
https://kawalpemilu.org#22848,"TOTO HARJO, BAKAUHENI, LAMPUNG SELATAN, LAMPUNG",4,100,40,140
https://kawalpemilu.org#22848,"TOTO HARJO, BAKAUHENI, LAMPUNG SELATAN, LAMPUNG",5,115,34,149
https://kawalpemilu.org#22848,"TOTO HARJO, BAKAUHENI, LAMPUNG SELATAN, LAMPUNG",6,123,42,165
https://kawalpemilu.org#22848,"TOTO HARJO, BAKAUHENI, LAMPUNG SELATAN, LAMPUNG",7,142,18,160
https://kawalpemilu.org#22848,"TOTO HARJO, BAKAUHENI, LAMPUNG SELATAN, LAMPUNG",8,89,9,98
https://kawalpemilu.org#22849,"HATTA, BAKAUHENI, LAMPUNG SELATAN, LAMPUNG",1,150,69,219
https://kawalpemilu.org#22849,"HATTA, BAKAUHENI, LAMPUNG SELATAN, LAMPUNG",2,139,84,223
https://kawalpemilu.org#22849,"HATTA, BAKAUHENI, LAMPUNG SELATAN, LAMPUNG",3,167,44,211
https://kawalpemilu.org#22849,"HATTA, BAKAUHENI, LAMPUNG SELATAN, LAMPUNG",4,138,37,175
https://kawalpemilu.org#22849,"HATTA, BAKAUHENI, LAMPUNG SELATAN, LAMPUNG",5,173,26,199
https://kawalpemilu.org#22849,"HATTA, BAKAUHENI, LAMPUNG SELATAN, LAMPUNG",6,95,48,143
https://kawalpemilu.org#22849,"HATTA, BAKAUHENI, LAMPUNG SELATAN, LAMPUNG",7,152,31,183
https://kawalpemilu.org#22849,"HATTA, BAKAUHENI, LAMPUNG SELATAN, LAMPUNG",8,165,6,171
https://kawalpemilu.org#22849,"HATTA, BAKAUHENI, LAMPUNG SELATAN, LAMPUNG",9,122,83,205
https://kawalpemilu.org#22849,"HATTA, BAKAUHENI, LAMPUNG SELATAN, LAMPUNG",10,82,18,100
https://kawalpemilu.org#22849,"HATTA, BAKAUHENI, LAMPUNG SELATAN, LAMPUNG",11,83,44,127
https://kawalpemilu.org#22850,"BAKAUHENI, BAKAUHENI, LAMPUNG SELATAN, LAMPUNG",1,128,69,197
https://kawalpemilu.org#22850,"BAKAUHENI, BAKAUHENI, LAMPUNG SELATAN, LAMPUNG",2,118,67,185
https://kawalpemilu.org#22850,"BAKAUHENI, BAKAUHENI, LAMPUNG SELATAN, LAMPUNG",3,154,75,229
https://kawalpemilu.org#22850,"BAKAUHENI, BAKAUHENI, LAMPUNG SELATAN, LAMPUNG",4,30,66,96
https://kawalpemilu.org#22850,"BAKAUHENI, BAKAUHENI, LAMPUNG SELATAN, LAMPUNG",5,80,77,157
https://kawalpemilu.org#22850,"BAKAUHENI, BAKAUHENI, LAMPUNG SELATAN, LAMPUNG",6,125,58,183
https://kawalpemilu.org#22850,"BAKAUHENI, BAKAUHENI, LAMPUNG SELATAN, LAMPUNG",7,113,59,172
https://kawalpemilu.org#22850,"BAKAUHENI, BAKAUHENI, LAMPUNG SELATAN, LAMPUNG",8,123,41,164
https://kawalpemilu.org#22850,"BAKAUHENI, BAKAUHENI, LAMPUNG SELATAN, LAMPUNG",9,122,60,182
https://kawalpemilu.org#22850,"BAKAUHENI, BAKAUHENI, LAMPUNG SELATAN, LAMPUNG",10,99,71,170
https://kawalpemilu.org#22850,"BAKAUHENI, BAKAUHENI, LAMPUNG SELATAN, LAMPUNG",11,92,52,144
https://kawalpemilu.org#22850,"BAKAUHENI, BAKAUHENI, LAMPUNG SELATAN, LAMPUNG",12,159,32,191
https://kawalpemilu.org#22850,"BAKAUHENI, BAKAUHENI, LAMPUNG SELATAN, LAMPUNG",14,89,61,150
https://kawalpemilu.org#22850,"BAKAUHENI, BAKAUHENI, LAMPUNG SELATAN, LAMPUNG",15,98,79,177
https://kawalpemilu.org#22850,"BAKAUHENI, BAKAUHENI, LAMPUNG SELATAN, LAMPUNG",17,106,87,193
https://kawalpemilu.org#22850,"BAKAUHENI, BAKAUHENI, LAMPUNG SELATAN, LAMPUNG",18,127,57,184
https://kawalpemilu.org#22850,"BAKAUHENI, BAKAUHENI, LAMPUNG SELATAN, LAMPUNG",19,100,71,171
https://kawalpemilu.org#22850,"BAKAUHENI, BAKAUHENI, LAMPUNG SELATAN, LAMPUNG",20,89,84,173
https://kawalpemilu.org#22850,"BAKAUHENI, BAKAUHENI, LAMPUNG SELATAN, LAMPUNG",21,120,75,195
https://kawalpemilu.org#22850,"BAKAUHENI, BAKAUHENI, LAMPUNG SELATAN, LAMPUNG",22,131,76,207
https://kawalpemilu.org#22850,"BAKAUHENI, BAKAUHENI, LAMPUNG SELATAN, LAMPUNG",23,118,64,182
https://kawalpemilu.org#22850,"BAKAUHENI, BAKAUHENI, LAMPUNG SELATAN, LAMPUNG",24,168,62,230
https://kawalpemilu.org#22850,"BAKAUHENI, BAKAUHENI, LAMPUNG SELATAN, LAMPUNG",25,107,36,143
https://kawalpemilu.org#22850,"BAKAUHENI, BAKAUHENI, LAMPUNG SELATAN, LAMPUNG",26,123,38,161
https://kawalpemilu.org#22850,"BAKAUHENI, BAKAUHENI, LAMPUNG SELATAN, LAMPUNG",27,87,45,132
https://kawalpemilu.org#22850,"BAKAUHENI, BAKAUHENI, LAMPUNG SELATAN, LAMPUNG",28,85,97,182
https://kawalpemilu.org#22850,"BAKAUHENI, BAKAUHENI, LAMPUNG SELATAN, LAMPUNG",29,115,83,198
https://kawalpemilu.org#22850,"BAKAUHENI, BAKAUHENI, LAMPUNG SELATAN, LAMPUNG",30,125,57,182
https://kawalpemilu.org#22850,"BAKAUHENI, BAKAUHENI, LAMPUNG SELATAN, LAMPUNG",31,69,67,136
https://kawalpemilu.org#22850,"BAKAUHENI, BAKAUHENI, LAMPUNG SELATAN, LAMPUNG",32,157,59,216
https://kawalpemilu.org#22850,"BAKAUHENI, BAKAUHENI, LAMPUNG SELATAN, LAMPUNG",33,111,64,175
https://kawalpemilu.org#22850,"BAKAUHENI, BAKAUHENI, LAMPUNG SELATAN, LAMPUNG",34,166,32,198
https://kawalpemilu.org#22850,"BAKAUHENI, BAKAUHENI, LAMPUNG SELATAN, LAMPUNG",35,102,65,167
https://kawalpemilu.org#22850,"BAKAUHENI, BAKAUHENI, LAMPUNG SELATAN, LAMPUNG",36,88,83,171
https://kawalpemilu.org#22850,"BAKAUHENI, BAKAUHENI, LAMPUNG SELATAN, LAMPUNG",37,141,92,233
https://kawalpemilu.org#22850,"BAKAUHENI, BAKAUHENI, LAMPUNG SELATAN, LAMPUNG",38,79,88,167
https://kawalpemilu.org#22851,"KELAWI, BAKAUHENI, LAMPUNG SELATAN, LAMPUNG",1,154,85,239
https://kawalpemilu.org#22851,"KELAWI, BAKAUHENI, LAMPUNG SELATAN, LAMPUNG",2,90,66,156
https://kawalpemilu.org#22851,"KELAWI, BAKAUHENI, LAMPUNG SELATAN, LAMPUNG",3,105,45,150
https://kawalpemilu.org#22851,"KELAWI, BAKAUHENI, LAMPUNG SELATAN, LAMPUNG",4,88,42,130
https://kawalpemilu.org#22851,"KELAWI, BAKAUHENI, LAMPUNG SELATAN, LAMPUNG",5,94,42,136
https://kawalpemilu.org#22851,"KELAWI, BAKAUHENI, LAMPUNG SELATAN, LAMPUNG",6,130,58,188
https://kawalpemilu.org#22851,"KELAWI, BAKAUHENI, LAMPUNG SELATAN, LAMPUNG",7,105,24,129
https://kawalpemilu.org#22851,"KELAWI, BAKAUHENI, LAMPUNG SELATAN, LAMPUNG",8,111,37,148
https://kawalpemilu.org#22851,"KELAWI, BAKAUHENI, LAMPUNG SELATAN, LAMPUNG",9,137,7,144
https://kawalpemilu.org#22851,"KELAWI, BAKAUHENI, LAMPUNG SELATAN, LAMPUNG",10,123,91,214
https://kawalpemilu.org#22851,"KELAWI, BAKAUHENI, LAMPUNG SELATAN, LAMPUNG",11,95,64,159
https://kawalpemilu.org#22851,"KELAWI, BAKAUHENI, LAMPUNG SELATAN, LAMPUNG",12,99,26,125
https://kawalpemilu.org#22851,"KELAWI, BAKAUHENI, LAMPUNG SELATAN, LAMPUNG",13,59,60,119
https://kawalpemilu.org#22851,"KELAWI, BAKAUHENI, LAMPUNG SELATAN, LAMPUNG",14,91,26,117
https://kawalpemilu.org#22851,"KELAWI, BAKAUHENI, LAMPUNG SELATAN, LAMPUNG",15,99,30,129
https://kawalpemilu.org#22853,"BANGUN SARI, TANJUNG SARI, LAMPUNG SELATAN, LAMPUNG",1,130,14,144
https://kawalpemilu.org#22853,"BANGUN SARI, TANJUNG SARI, LAMPUNG SELATAN, LAMPUNG",2,121,20,141
https://kawalpemilu.org#22853,"BANGUN SARI, TANJUNG SARI, LAMPUNG SELATAN, LAMPUNG",3,148,52,200
https://kawalpemilu.org#22853,"BANGUN SARI, TANJUNG SARI, LAMPUNG SELATAN, LAMPUNG",4,140,18,158
https://kawalpemilu.org#22853,"BANGUN SARI, TANJUNG SARI, LAMPUNG SELATAN, LAMPUNG",5,102,22,126
https://kawalpemilu.org#22853,"BANGUN SARI, TANJUNG SARI, LAMPUNG SELATAN, LAMPUNG",7,128,21,149
https://kawalpemilu.org#22854,"PURWODADI DALAM, TANJUNG SARI, LAMPUNG SELATAN, LAMPUNG",1,146,45,191
https://kawalpemilu.org#22854,"PURWODADI DALAM, TANJUNG SARI, LAMPUNG SELATAN, LAMPUNG",2,145,69,214
https://kawalpemilu.org#22854,"PURWODADI DALAM, TANJUNG SARI, LAMPUNG SELATAN, LAMPUNG",3,136,65,201
https://kawalpemilu.org#22854,"PURWODADI DALAM, TANJUNG SARI, LAMPUNG SELATAN, LAMPUNG",4,139,73,212
https://kawalpemilu.org#22854,"PURWODADI DALAM, TANJUNG SARI, LAMPUNG SELATAN, LAMPUNG",5,136,44,180
https://kawalpemilu.org#22854,"PURWODADI DALAM, TANJUNG SARI, LAMPUNG SELATAN, LAMPUNG",6,98,88,186
https://kawalpemilu.org#22854,"PURWODADI DALAM, TANJUNG SARI, LAMPUNG SELATAN, LAMPUNG",7,137,58,195
https://kawalpemilu.org#22854,"PURWODADI DALAM, TANJUNG SARI, LAMPUNG SELATAN, LAMPUNG",8,117,77,194
https://kawalpemilu.org#22854,"PURWODADI DALAM, TANJUNG SARI, LAMPUNG SELATAN, LAMPUNG",9,138,86,224
https://kawalpemilu.org#22854,"PURWODADI DALAM, TANJUNG SARI, LAMPUNG SELATAN, LAMPUNG",10,122,115,237
https://kawalpemilu.org#22854,"PURWODADI DALAM, TANJUNG SARI, LAMPUNG SELATAN, LAMPUNG",11,112,84,196
https://kawalpemilu.org#22854,"PURWODADI DALAM, TANJUNG SARI, LAMPUNG SELATAN, LAMPUNG",12,125,58,183
https://kawalpemilu.org#22854,"PURWODADI DALAM, TANJUNG SARI, LAMPUNG SELATAN, LAMPUNG",13,81,87,168
https://kawalpemilu.org#22854,"PURWODADI DALAM, TANJUNG SARI, LAMPUNG SELATAN, LAMPUNG",14,129,70,199
https://kawalpemilu.org#22855,"SIDO MUKTI, TANJUNG SARI, LAMPUNG SELATAN, LAMPUNG",1,170,57,227
https://kawalpemilu.org#22855,"SIDO MUKTI, TANJUNG SARI, LAMPUNG SELATAN, LAMPUNG",2,185,34,219
https://kawalpemilu.org#22855,"SIDO MUKTI, TANJUNG SARI, LAMPUNG SELATAN, LAMPUNG",3,151,22,173
https://kawalpemilu.org#22855,"SIDO MUKTI, TANJUNG SARI, LAMPUNG SELATAN, LAMPUNG",4,60,86,146
https://kawalpemilu.org#22855,"SIDO MUKTI, TANJUNG SARI, LAMPUNG SELATAN, LAMPUNG",5,123,32,159
https://kawalpemilu.org#22855,"SIDO MUKTI, TANJUNG SARI, LAMPUNG SELATAN, LAMPUNG",6,147,33,180
https://kawalpemilu.org#22855,"SIDO MUKTI, TANJUNG SARI, LAMPUNG SELATAN, LAMPUNG",7,56,62,118
https://kawalpemilu.org#22856,"WAWASAN, TANJUNG SARI, LAMPUNG SELATAN, LAMPUNG",1,182,13,195
https://kawalpemilu.org#22856,"WAWASAN, TANJUNG SARI, LAMPUNG SELATAN, LAMPUNG",2,137,63,200
https://kawalpemilu.org#22856,"WAWASAN, TANJUNG SARI, LAMPUNG SELATAN, LAMPUNG",3,148,74,222
https://kawalpemilu.org#22856,"WAWASAN, TANJUNG SARI, LAMPUNG SELATAN, LAMPUNG",4,107,19,126
https://kawalpemilu.org#22856,"WAWASAN, TANJUNG SARI, LAMPUNG SELATAN, LAMPUNG",5,136,26,162
https://kawalpemilu.org#22856,"WAWASAN, TANJUNG SARI, LAMPUNG SELATAN, LAMPUNG",6,123,35,158
https://kawalpemilu.org#22856,"WAWASAN, TANJUNG SARI, LAMPUNG SELATAN, LAMPUNG",7,137,19,156
https://kawalpemilu.org#22856,"WAWASAN, TANJUNG SARI, LAMPUNG SELATAN, LAMPUNG",8,163,35,198
https://kawalpemilu.org#22856,"WAWASAN, TANJUNG SARI, LAMPUNG SELATAN, LAMPUNG",9,98,15,113
https://kawalpemilu.org#22856,"WAWASAN, TANJUNG SARI, LAMPUNG SELATAN, LAMPUNG",10,122,28,150
https://kawalpemilu.org#22856,"WAWASAN, TANJUNG SARI, LAMPUNG SELATAN, LAMPUNG",11,147,35,182
https://kawalpemilu.org#22857,"MULYOSARI, TANJUNG SARI, LAMPUNG SELATAN, LAMPUNG",1,166,52,218
https://kawalpemilu.org#22857,"MULYOSARI, TANJUNG SARI, LAMPUNG SELATAN, LAMPUNG",2,130,81,211
https://kawalpemilu.org#22857,"MULYOSARI, TANJUNG SARI, LAMPUNG SELATAN, LAMPUNG",3,176,56,232
https://kawalpemilu.org#22857,"MULYOSARI, TANJUNG SARI, LAMPUNG SELATAN, LAMPUNG",4,146,36,182
https://kawalpemilu.org#22857,"MULYOSARI, TANJUNG SARI, LAMPUNG SELATAN, LAMPUNG",5,157,27,184
https://kawalpemilu.org#22857,"MULYOSARI, TANJUNG SARI, LAMPUNG SELATAN, LAMPUNG",6,181,29,210
https://kawalpemilu.org#22857,"MULYOSARI, TANJUNG SARI, LAMPUNG SELATAN, LAMPUNG",7,62,67,129
https://kawalpemilu.org#22857,"MULYOSARI, TANJUNG SARI, LAMPUNG SELATAN, LAMPUNG",8,107,43,150
https://kawalpemilu.org#22857,"MULYOSARI, TANJUNG SARI, LAMPUNG SELATAN, LAMPUNG",9,92,129,221
https://kawalpemilu.org#22857,"MULYOSARI, TANJUNG SARI, LAMPUNG SELATAN, LAMPUNG",10,106,98,204
https://kawalpemilu.org#22858,"WONODADI, TANJUNG SARI, LAMPUNG SELATAN, LAMPUNG",1,90,77,167
https://kawalpemilu.org#22858,"WONODADI, TANJUNG SARI, LAMPUNG SELATAN, LAMPUNG",2,143,59,202
https://kawalpemilu.org#22858,"WONODADI, TANJUNG SARI, LAMPUNG SELATAN, LAMPUNG",3,114,39,153
https://kawalpemilu.org#22858,"WONODADI, TANJUNG SARI, LAMPUNG SELATAN, LAMPUNG",4,152,72,224
https://kawalpemilu.org#22858,"WONODADI, TANJUNG SARI, LAMPUNG SELATAN, LAMPUNG",5,168,35,203
https://kawalpemilu.org#22858,"WONODADI, TANJUNG SARI, LAMPUNG SELATAN, LAMPUNG",6,153,13,166
https://kawalpemilu.org#22858,"WONODADI, TANJUNG SARI, LAMPUNG SELATAN, LAMPUNG",7,164,23,187
https://kawalpemilu.org#22858,"WONODADI, TANJUNG SARI, LAMPUNG SELATAN, LAMPUNG",8,104,46,150
https://kawalpemilu.org#22858,"WONODADI, TANJUNG SARI, LAMPUNG SELATAN, LAMPUNG",9,95,56,151
https://kawalpemilu.org#22858,"WONODADI, TANJUNG SARI, LAMPUNG SELATAN, LAMPUNG",10,155,49,204
https://kawalpemilu.org#22858,"WONODADI, TANJUNG SARI, LAMPUNG SELATAN, LAMPUNG",11,127,55,182
https://kawalpemilu.org#22858,"WONODADI, TANJUNG SARI, LAMPUNG SELATAN, LAMPUNG",12,167,43,210
https://kawalpemilu.org#22858,"WONODADI, TANJUNG SARI, LAMPUNG SELATAN, LAMPUNG",13,166,41,207
https://kawalpemilu.org#22858,"WONODADI, TANJUNG SARI, LAMPUNG SELATAN, LAMPUNG",14,166,22,188
https://kawalpemilu.org#22859,"KERTOSARI, TANJUNG SARI, LAMPUNG SELATAN, LAMPUNG",1,77,103,180
https://kawalpemilu.org#22859,"KERTOSARI, TANJUNG SARI, LAMPUNG SELATAN, LAMPUNG",2,151,65,216
https://kawalpemilu.org#22859,"KERTOSARI, TANJUNG SARI, LAMPUNG SELATAN, LAMPUNG",3,165,59,221
https://kawalpemilu.org#22859,"KERTOSARI, TANJUNG SARI, LAMPUNG SELATAN, LAMPUNG",4,148,26,174
https://kawalpemilu.org#22859,"KERTOSARI, TANJUNG SARI, LAMPUNG SELATAN, LAMPUNG",5,148,55,203
https://kawalpemilu.org#22859,"KERTOSARI, TANJUNG SARI, LAMPUNG SELATAN, LAMPUNG",6,161,49,210
https://kawalpemilu.org#22859,"KERTOSARI, TANJUNG SARI, LAMPUNG SELATAN, LAMPUNG",7,121,45,166
https://kawalpemilu.org#22859,"KERTOSARI, TANJUNG SARI, LAMPUNG SELATAN, LAMPUNG",8,189,48,237
https://kawalpemilu.org#22859,"KERTOSARI, TANJUNG SARI, LAMPUNG SELATAN, LAMPUNG",9,141,38,179
https://kawalpemilu.org#22859,"KERTOSARI, TANJUNG SARI, LAMPUNG SELATAN, LAMPUNG",10,120,36,156
https://kawalpemilu.org#22859,"KERTOSARI, TANJUNG SARI, LAMPUNG SELATAN, LAMPUNG",11,157,26,183
https://kawalpemilu.org#22859,"KERTOSARI, TANJUNG SARI, LAMPUNG SELATAN, LAMPUNG",12,154,18,168
https://kawalpemilu.org#22859,"KERTOSARI, TANJUNG SARI, LAMPUNG SELATAN, LAMPUNG",13,109,25,134
https://kawalpemilu.org#22859,"KERTOSARI, TANJUNG SARI, LAMPUNG SELATAN, LAMPUNG",14,148,19,167
https://kawalpemilu.org#22859,"KERTOSARI, TANJUNG SARI, LAMPUNG SELATAN, LAMPUNG",15,65,92,157
https://kawalpemilu.org#22859,"KERTOSARI, TANJUNG SARI, LAMPUNG SELATAN, LAMPUNG",16,150,59,209
https://kawalpemilu.org#22859,"KERTOSARI, TANJUNG SARI, LAMPUNG SELATAN, LAMPUNG",17,127,33,160
https://kawalpemilu.org#22859,"KERTOSARI, TANJUNG SARI, LAMPUNG SELATAN, LAMPUNG",18,137,35,172
https://kawalpemilu.org#22859,"KERTOSARI, TANJUNG SARI, LAMPUNG SELATAN, LAMPUNG",19,144,62,206
https://kawalpemilu.org#22859,"KERTOSARI, TANJUNG SARI, LAMPUNG SELATAN, LAMPUNG",20,131,22,153
https://kawalpemilu.org#22859,"KERTOSARI, TANJUNG SARI, LAMPUNG SELATAN, LAMPUNG",21,135,45,180
https://kawalpemilu.org#22859,"KERTOSARI, TANJUNG SARI, LAMPUNG SELATAN, LAMPUNG",22,114,43,157
https://kawalpemilu.org#22859,"KERTOSARI, TANJUNG SARI, LAMPUNG SELATAN, LAMPUNG",23,149,51,200
https://kawalpemilu.org#22859,"KERTOSARI, TANJUNG SARI, LAMPUNG SELATAN, LAMPUNG",24,149,49,198
https://kawalpemilu.org#22859,"KERTOSARI, TANJUNG SARI, LAMPUNG SELATAN, LAMPUNG",25,144,16,160
https://kawalpemilu.org#22859,"KERTOSARI, TANJUNG SARI, LAMPUNG SELATAN, LAMPUNG",26,144,8,152
https://kawalpemilu.org#22859,"KERTOSARI, TANJUNG SARI, LAMPUNG SELATAN, LAMPUNG",27,158,18,176
https://kawalpemilu.org#22859,"KERTOSARI, TANJUNG SARI, LAMPUNG SELATAN, LAMPUNG",28,151,18,169
https://kawalpemilu.org#22860,"MALANG SARI, TANJUNG SARI, LAMPUNG SELATAN, LAMPUNG",1,149,35,184
https://kawalpemilu.org#22860,"MALANG SARI, TANJUNG SARI, LAMPUNG SELATAN, LAMPUNG",2,130,39,169
https://kawalpemilu.org#22860,"MALANG SARI, TANJUNG SARI, LAMPUNG SELATAN, LAMPUNG",3,155,46,201
https://kawalpemilu.org#22860,"MALANG SARI, TANJUNG SARI, LAMPUNG SELATAN, LAMPUNG",4,142,26,168
https://kawalpemilu.org#22860,"MALANG SARI, TANJUNG SARI, LAMPUNG SELATAN, LAMPUNG",5,131,29,160
https://kawalpemilu.org#22860,"MALANG SARI, TANJUNG SARI, LAMPUNG SELATAN, LAMPUNG",6,152,21,173
https://kawalpemilu.org#22860,"MALANG SARI, TANJUNG SARI, LAMPUNG SELATAN, LAMPUNG",7,134,32,166
https://kawalpemilu.org#22860,"MALANG SARI, TANJUNG SARI, LAMPUNG SELATAN, LAMPUNG",8,120,15,135
https://kawalpemilu.org#22860,"MALANG SARI, TANJUNG SARI, LAMPUNG SELATAN, LAMPUNG",9,118,33,151
https://kawalpemilu.org#22862,"MEKAR SARI, WAY SULAN, LAMPUNG SELATAN, LAMPUNG",1,88,93,181
https://kawalpemilu.org#22862,"MEKAR SARI, WAY SULAN, LAMPUNG SELATAN, LAMPUNG",2,46,78,124
https://kawalpemilu.org#22862,"MEKAR SARI, WAY SULAN, LAMPUNG SELATAN, LAMPUNG",3,62,145,207
https://kawalpemilu.org#22862,"MEKAR SARI, WAY SULAN, LAMPUNG SELATAN, LAMPUNG",4,35,134,169
https://kawalpemilu.org#22862,"MEKAR SARI, WAY SULAN, LAMPUNG SELATAN, LAMPUNG",5,70,117,187
https://kawalpemilu.org#22862,"MEKAR SARI, WAY SULAN, LAMPUNG SELATAN, LAMPUNG",6,40,119,159
https://kawalpemilu.org#22862,"MEKAR SARI, WAY SULAN, LAMPUNG SELATAN, LAMPUNG",7,70,91,161
https://kawalpemilu.org#22862,"MEKAR SARI, WAY SULAN, LAMPUNG SELATAN, LAMPUNG",8,95,51,146
https://kawalpemilu.org#22863,"SUMBER AGUNG, WAY SULAN, LAMPUNG SELATAN, LAMPUNG",1,179,49,228
https://kawalpemilu.org#22863,"SUMBER AGUNG, WAY SULAN, LAMPUNG SELATAN, LAMPUNG",2,152,30,182
https://kawalpemilu.org#22863,"SUMBER AGUNG, WAY SULAN, LAMPUNG SELATAN, LAMPUNG",3,165,61,226
https://kawalpemilu.org#22863,"SUMBER AGUNG, WAY SULAN, LAMPUNG SELATAN, LAMPUNG",4,156,34,190
https://kawalpemilu.org#22863,"SUMBER AGUNG, WAY SULAN, LAMPUNG SELATAN, LAMPUNG",5,158,24,182
https://kawalpemilu.org#22863,"SUMBER AGUNG, WAY SULAN, LAMPUNG SELATAN, LAMPUNG",6,128,54,182
https://kawalpemilu.org#22863,"SUMBER AGUNG, WAY SULAN, LAMPUNG SELATAN, LAMPUNG",7,149,62,211
https://kawalpemilu.org#22864,"TALANG WAY SULAN, WAY SULAN, LAMPUNG SELATAN, LAMPUNG",1,73,118,191
https://kawalpemilu.org#22864,"TALANG WAY SULAN, WAY SULAN, LAMPUNG SELATAN, LAMPUNG",2,70,59,129
https://kawalpemilu.org#22864,"TALANG WAY SULAN, WAY SULAN, LAMPUNG SELATAN, LAMPUNG",3,70,125,195
https://kawalpemilu.org#22864,"TALANG WAY SULAN, WAY SULAN, LAMPUNG SELATAN, LAMPUNG",4,117,61,178
https://kawalpemilu.org#22864,"TALANG WAY SULAN, WAY SULAN, LAMPUNG SELATAN, LAMPUNG",5,105,84,189
https://kawalpemilu.org#22864,"TALANG WAY SULAN, WAY SULAN, LAMPUNG SELATAN, LAMPUNG",6,99,46,145
https://kawalpemilu.org#22864,"TALANG WAY SULAN, WAY SULAN, LAMPUNG SELATAN, LAMPUNG",7,130,42,172
https://kawalpemilu.org#22864,"TALANG WAY SULAN, WAY SULAN, LAMPUNG SELATAN, LAMPUNG",8,147,58,205
https://kawalpemilu.org#22865,"PAMULIHAN, WAY SULAN, LAMPUNG SELATAN, LAMPUNG",1,142,55,197
https://kawalpemilu.org#22865,"PAMULIHAN, WAY SULAN, LAMPUNG SELATAN, LAMPUNG",2,82,45,127
https://kawalpemilu.org#22865,"PAMULIHAN, WAY SULAN, LAMPUNG SELATAN, LAMPUNG",3,112,46,158
https://kawalpemilu.org#22865,"PAMULIHAN, WAY SULAN, LAMPUNG SELATAN, LAMPUNG",4,150,40,190
https://kawalpemilu.org#22865,"PAMULIHAN, WAY SULAN, LAMPUNG SELATAN, LAMPUNG",5,144,37,181
https://kawalpemilu.org#22866,"PURWODADI, WAY SULAN, LAMPUNG SELATAN, LAMPUNG",1,108,89,197
https://kawalpemilu.org#22866,"PURWODADI, WAY SULAN, LAMPUNG SELATAN, LAMPUNG",2,121,46,167
https://kawalpemilu.org#22866,"PURWODADI, WAY SULAN, LAMPUNG SELATAN, LAMPUNG",3,134,37,171
https://kawalpemilu.org#22866,"PURWODADI, WAY SULAN, LAMPUNG SELATAN, LAMPUNG",4,129,55,184
https://kawalpemilu.org#22866,"PURWODADI, WAY SULAN, LAMPUNG SELATAN, LAMPUNG",5,111,90,201
https://kawalpemilu.org#22866,"PURWODADI, WAY SULAN, LAMPUNG SELATAN, LAMPUNG",6,127,41,168
https://kawalpemilu.org#22866,"PURWODADI, WAY SULAN, LAMPUNG SELATAN, LAMPUNG",7,118,54,172
https://kawalpemilu.org#22867,"SUKA MAJU, WAY SULAN, LAMPUNG SELATAN, LAMPUNG",1,89,94,183
https://kawalpemilu.org#22867,"SUKA MAJU, WAY SULAN, LAMPUNG SELATAN, LAMPUNG",2,64,136,200
https://kawalpemilu.org#22867,"SUKA MAJU, WAY SULAN, LAMPUNG SELATAN, LAMPUNG",3,65,143,208
https://kawalpemilu.org#22867,"SUKA MAJU, WAY SULAN, LAMPUNG SELATAN, LAMPUNG",4,102,88,190
https://kawalpemilu.org#22867,"SUKA MAJU, WAY SULAN, LAMPUNG SELATAN, LAMPUNG",5,102,93,195
https://kawalpemilu.org#22867,"SUKA MAJU, WAY SULAN, LAMPUNG SELATAN, LAMPUNG",6,148,49,197
https://kawalpemilu.org#22868,"BANJAR SARI, WAY SULAN, LAMPUNG SELATAN, LAMPUNG",1,85,92,177
https://kawalpemilu.org#22868,"BANJAR SARI, WAY SULAN, LAMPUNG SELATAN, LAMPUNG",2,87,115,202
https://kawalpemilu.org#22868,"BANJAR SARI, WAY SULAN, LAMPUNG SELATAN, LAMPUNG",3,72,156,228
https://kawalpemilu.org#22868,"BANJAR SARI, WAY SULAN, LAMPUNG SELATAN, LAMPUNG",4,110,84,194
https://kawalpemilu.org#22868,"BANJAR SARI, WAY SULAN, LAMPUNG SELATAN, LAMPUNG",5,61,131,192
https://kawalpemilu.org#22868,"BANJAR SARI, WAY SULAN, LAMPUNG SELATAN, LAMPUNG",6,65,98,163
https://kawalpemilu.org#22868,"BANJAR SARI, WAY SULAN, LAMPUNG SELATAN, LAMPUNG",7,125,54,179
https://kawalpemilu.org#22868,"BANJAR SARI, WAY SULAN, LAMPUNG SELATAN, LAMPUNG",8,59,124,183
https://kawalpemilu.org#22868,"BANJAR SARI, WAY SULAN, LAMPUNG SELATAN, LAMPUNG",9,104,94,198
https://kawalpemilu.org#22868,"BANJAR SARI, WAY SULAN, LAMPUNG SELATAN, LAMPUNG",10,84,123,207
https://kawalpemilu.org#22868,"BANJAR SARI, WAY SULAN, LAMPUNG SELATAN, LAMPUNG",11,61,107,168
https://kawalpemilu.org#22868,"BANJAR SARI, WAY SULAN, LAMPUNG SELATAN, LAMPUNG",12,39,30,69
https://kawalpemilu.org#22869,"KARANG PUCUNG, WAY SULAN, LAMPUNG SELATAN, LAMPUNG",1,109,117,226
https://kawalpemilu.org#22869,"KARANG PUCUNG, WAY SULAN, LAMPUNG SELATAN, LAMPUNG",2,47,163,210
https://kawalpemilu.org#22869,"KARANG PUCUNG, WAY SULAN, LAMPUNG SELATAN, LAMPUNG",3,103,104,207
https://kawalpemilu.org#22869,"KARANG PUCUNG, WAY SULAN, LAMPUNG SELATAN, LAMPUNG",4,119,66,185
https://kawalpemilu.org#22869,"KARANG PUCUNG, WAY SULAN, LAMPUNG SELATAN, LAMPUNG",5,165,50,215
https://kawalpemilu.org#22869,"KARANG PUCUNG, WAY SULAN, LAMPUNG SELATAN, LAMPUNG",6,133,55,188
https://kawalpemilu.org#22869,"KARANG PUCUNG, WAY SULAN, LAMPUNG SELATAN, LAMPUNG",7,111,68,179
https://kawalpemilu.org#22869,"KARANG PUCUNG, WAY SULAN, LAMPUNG SELATAN, LAMPUNG",8,94,98,192
https://kawalpemilu.org#22869,"KARANG PUCUNG, WAY SULAN, LAMPUNG SELATAN, LAMPUNG",9,86,113,199
https://kawalpemilu.org#22869,"KARANG PUCUNG, WAY SULAN, LAMPUNG SELATAN, LAMPUNG",10,59,133,192
https://kawalpemilu.org#22869,"KARANG PUCUNG, WAY SULAN, LAMPUNG SELATAN, LAMPUNG",11,90,114,204
https://kawalpemilu.org#22869,"KARANG PUCUNG, WAY SULAN, LAMPUNG SELATAN, LAMPUNG",12,126,62,188
https://kawalpemilu.org#22869,"KARANG PUCUNG, WAY SULAN, LAMPUNG SELATAN, LAMPUNG",13,108,73,181
https://kawalpemilu.org#22869,"KARANG PUCUNG, WAY SULAN, LAMPUNG SELATAN, LAMPUNG",14,139,71,210
https://kawalpemilu.org#22869,"KARANG PUCUNG, WAY SULAN, LAMPUNG SELATAN, LAMPUNG",15,76,110,186
https://kawalpemilu.org#22869,"KARANG PUCUNG, WAY SULAN, LAMPUNG SELATAN, LAMPUNG",16,90,88,178
https://kawalpemilu.org#22871,"SIDO HARJO, WAY PANJI, LAMPUNG SELATAN, LAMPUNG",1,169,14,183
https://kawalpemilu.org#22871,"SIDO HARJO, WAY PANJI, LAMPUNG SELATAN, LAMPUNG",2,153,38,191
https://kawalpemilu.org#22871,"SIDO HARJO, WAY PANJI, LAMPUNG SELATAN, LAMPUNG",3,151,55,206
https://kawalpemilu.org#22871,"SIDO HARJO, WAY PANJI, LAMPUNG SELATAN, LAMPUNG",4,135,66,201
https://kawalpemilu.org#22871,"SIDO HARJO, WAY PANJI, LAMPUNG SELATAN, LAMPUNG",5,183,46,229
https://kawalpemilu.org#22871,"SIDO HARJO, WAY PANJI, LAMPUNG SELATAN, LAMPUNG",6,129,50,179
https://kawalpemilu.org#22871,"SIDO HARJO, WAY PANJI, LAMPUNG SELATAN, LAMPUNG",7,142,33,175
https://kawalpemilu.org#22871,"SIDO HARJO, WAY PANJI, LAMPUNG SELATAN, LAMPUNG",8,135,25,160
https://kawalpemilu.org#22871,"SIDO HARJO, WAY PANJI, LAMPUNG SELATAN, LAMPUNG",9,145,69,214
https://kawalpemilu.org#22871,"SIDO HARJO, WAY PANJI, LAMPUNG SELATAN, LAMPUNG",10,150,40,190
https://kawalpemilu.org#22871,"SIDO HARJO, WAY PANJI, LAMPUNG SELATAN, LAMPUNG",11,155,22,177
https://kawalpemilu.org#22871,"SIDO HARJO, WAY PANJI, LAMPUNG SELATAN, LAMPUNG",12,155,32,187
https://kawalpemilu.org#22871,"SIDO HARJO, WAY PANJI, LAMPUNG SELATAN, LAMPUNG",13,206,3,209
https://kawalpemilu.org#22871,"SIDO HARJO, WAY PANJI, LAMPUNG SELATAN, LAMPUNG",14,214,3,217
https://kawalpemilu.org#22871,"SIDO HARJO, WAY PANJI, LAMPUNG SELATAN, LAMPUNG",15,177,32,209
https://kawalpemilu.org#22871,"SIDO HARJO, WAY PANJI, LAMPUNG SELATAN, LAMPUNG",16,182,17,199
https://kawalpemilu.org#22871,"SIDO HARJO, WAY PANJI, LAMPUNG SELATAN, LAMPUNG",17,156,22,178
https://kawalpemilu.org#22871,"SIDO HARJO, WAY PANJI, LAMPUNG SELATAN, LAMPUNG",18,129,50,179
https://kawalpemilu.org#22871,"SIDO HARJO, WAY PANJI, LAMPUNG SELATAN, LAMPUNG",19,153,14,167
https://kawalpemilu.org#22871,"SIDO HARJO, WAY PANJI, LAMPUNG SELATAN, LAMPUNG",20,171,9,180
https://kawalpemilu.org#22871,"SIDO HARJO, WAY PANJI, LAMPUNG SELATAN, LAMPUNG",21,161,6,167
https://kawalpemilu.org#22871,"SIDO HARJO, WAY PANJI, LAMPUNG SELATAN, LAMPUNG",22,110,33,143
https://kawalpemilu.org#22871,"SIDO HARJO, WAY PANJI, LAMPUNG SELATAN, LAMPUNG",23,174,37,211
https://kawalpemilu.org#22871,"SIDO HARJO, WAY PANJI, LAMPUNG SELATAN, LAMPUNG",24,143,49,192
https://kawalpemilu.org#22871,"SIDO HARJO, WAY PANJI, LAMPUNG SELATAN, LAMPUNG",25,132,58,190
https://kawalpemilu.org#22871,"SIDO HARJO, WAY PANJI, LAMPUNG SELATAN, LAMPUNG",26,131,59,190
https://kawalpemilu.org#22871,"SIDO HARJO, WAY PANJI, LAMPUNG SELATAN, LAMPUNG",27,164,28,192
https://kawalpemilu.org#22871,"SIDO HARJO, WAY PANJI, LAMPUNG SELATAN, LAMPUNG",28,186,29,215
https://kawalpemilu.org#22871,"SIDO HARJO, WAY PANJI, LAMPUNG SELATAN, LAMPUNG",29,172,28,200
https://kawalpemilu.org#22871,"SIDO HARJO, WAY PANJI, LAMPUNG SELATAN, LAMPUNG",30,143,29,172
https://kawalpemilu.org#22871,"SIDO HARJO, WAY PANJI, LAMPUNG SELATAN, LAMPUNG",31,166,10,176
https://kawalpemilu.org#22872,"SIDO MAKMUR, WAY PANJI, LAMPUNG SELATAN, LAMPUNG",1,224,18,242
https://kawalpemilu.org#22872,"SIDO MAKMUR, WAY PANJI, LAMPUNG SELATAN, LAMPUNG",2,169,28,197
https://kawalpemilu.org#22872,"SIDO MAKMUR, WAY PANJI, LAMPUNG SELATAN, LAMPUNG",3,158,40,198
https://kawalpemilu.org#22872,"SIDO MAKMUR, WAY PANJI, LAMPUNG SELATAN, LAMPUNG",4,147,30,177
https://kawalpemilu.org#22872,"SIDO MAKMUR, WAY PANJI, LAMPUNG SELATAN, LAMPUNG",5,158,16,174
https://kawalpemilu.org#22872,"SIDO MAKMUR, WAY PANJI, LAMPUNG SELATAN, LAMPUNG",6,189,16,205
https://kawalpemilu.org#22872,"SIDO MAKMUR, WAY PANJI, LAMPUNG SELATAN, LAMPUNG",7,169,31,200
https://kawalpemilu.org#22872,"SIDO MAKMUR, WAY PANJI, LAMPUNG SELATAN, LAMPUNG",8,108,12,120
https://kawalpemilu.org#22873,"SIDO RENO, WAY PANJI, LAMPUNG SELATAN, LAMPUNG",1,184,19,203
https://kawalpemilu.org#22873,"SIDO RENO, WAY PANJI, LAMPUNG SELATAN, LAMPUNG",2,161,38,199
https://kawalpemilu.org#22873,"SIDO RENO, WAY PANJI, LAMPUNG SELATAN, LAMPUNG",3,133,5,138
https://kawalpemilu.org#22873,"SIDO RENO, WAY PANJI, LAMPUNG SELATAN, LAMPUNG",5,159,21,180
https://kawalpemilu.org#22873,"SIDO RENO, WAY PANJI, LAMPUNG SELATAN, LAMPUNG",6,155,33,188
https://kawalpemilu.org#22873,"SIDO RENO, WAY PANJI, LAMPUNG SELATAN, LAMPUNG",7,157,12,169
https://kawalpemilu.org#22874,"BALI NURAGA, WAY PANJI, LAMPUNG SELATAN, LAMPUNG",1,182,1,183
https://kawalpemilu.org#22874,"BALI NURAGA, WAY PANJI, LAMPUNG SELATAN, LAMPUNG",2,194,2,196
https://kawalpemilu.org#22874,"BALI NURAGA, WAY PANJI, LAMPUNG SELATAN, LAMPUNG",3,147,5,152
https://kawalpemilu.org#22874,"BALI NURAGA, WAY PANJI, LAMPUNG SELATAN, LAMPUNG",4,168,5,173
https://kawalpemilu.org#22874,"BALI NURAGA, WAY PANJI, LAMPUNG SELATAN, LAMPUNG",5,171,13,184
https://kawalpemilu.org#22874,"BALI NURAGA, WAY PANJI, LAMPUNG SELATAN, LAMPUNG",6,155,8,163
https://kawalpemilu.org#22874,"BALI NURAGA, WAY PANJI, LAMPUNG SELATAN, LAMPUNG",7,180,10,190
https://kawalpemilu.org#22874,"BALI NURAGA, WAY PANJI, LAMPUNG SELATAN, LAMPUNG",8,167,11,178
https://kawalpemilu.org#22874,"BALI NURAGA, WAY PANJI, LAMPUNG SELATAN, LAMPUNG",9,132,10,142
https://kawalpemilu.org#22874,"BALI NURAGA, WAY PANJI, LAMPUNG SELATAN, LAMPUNG",10,158,7,165
https://kawalpemilu.org#22874,"BALI NURAGA, WAY PANJI, LAMPUNG SELATAN, LAMPUNG",11,92,20,112
https://kawalpemilu.org#22874,"BALI NURAGA, WAY PANJI, LAMPUNG SELATAN, LAMPUNG",12,84,1,85
https://kawalpemilu.org#22877,"SRI WAY LANGSEP, KALIREJO, LAMPUNG TENGAH, LAMPUNG",1,130,72,202
https://kawalpemilu.org#22877,"SRI WAY LANGSEP, KALIREJO, LAMPUNG TENGAH, LAMPUNG",2,128,45,173
https://kawalpemilu.org#22877,"SRI WAY LANGSEP, KALIREJO, LAMPUNG TENGAH, LAMPUNG",3,153,47,200
https://kawalpemilu.org#22877,"SRI WAY LANGSEP, KALIREJO, LAMPUNG TENGAH, LAMPUNG",4,154,61,215
https://kawalpemilu.org#22877,"SRI WAY LANGSEP, KALIREJO, LAMPUNG TENGAH, LAMPUNG",5,144,52,196
https://kawalpemilu.org#22877,"SRI WAY LANGSEP, KALIREJO, LAMPUNG TENGAH, LAMPUNG",6,167,38,205
https://kawalpemilu.org#22877,"SRI WAY LANGSEP, KALIREJO, LAMPUNG TENGAH, LAMPUNG",7,153,48,201
https://kawalpemilu.org#22878,"WAYA KRUI, KALIREJO, LAMPUNG TENGAH, LAMPUNG",1,38,97,135
https://kawalpemilu.org#22878,"WAYA KRUI, KALIREJO, LAMPUNG TENGAH, LAMPUNG",2,24,125,149
https://kawalpemilu.org#22878,"WAYA KRUI, KALIREJO, LAMPUNG TENGAH, LAMPUNG",3,40,128,168
https://kawalpemilu.org#22879,"KALIREJO, KALIREJO, LAMPUNG TENGAH, LAMPUNG",1,96,165,261
https://kawalpemilu.org#22879,"KALIREJO, KALIREJO, LAMPUNG TENGAH, LAMPUNG",2,109,106,215
https://kawalpemilu.org#22879,"KALIREJO, KALIREJO, LAMPUNG TENGAH, LAMPUNG",3,150,93,243
https://kawalpemilu.org#22879,"KALIREJO, KALIREJO, LAMPUNG TENGAH, LAMPUNG",4,122,89,211
https://kawalpemilu.org#22879,"KALIREJO, KALIREJO, LAMPUNG TENGAH, LAMPUNG",5,119,105,224
https://kawalpemilu.org#22879,"KALIREJO, KALIREJO, LAMPUNG TENGAH, LAMPUNG",6,124,89,213
https://kawalpemilu.org#22879,"KALIREJO, KALIREJO, LAMPUNG TENGAH, LAMPUNG",7,105,120,225
https://kawalpemilu.org#22879,"KALIREJO, KALIREJO, LAMPUNG TENGAH, LAMPUNG",8,40,172,212
https://kawalpemilu.org#22879,"KALIREJO, KALIREJO, LAMPUNG TENGAH, LAMPUNG",9,41,126,167
https://kawalpemilu.org#22879,"KALIREJO, KALIREJO, LAMPUNG TENGAH, LAMPUNG",10,40,157,197
https://kawalpemilu.org#22879,"KALIREJO, KALIREJO, LAMPUNG TENGAH, LAMPUNG",11,121,66,187
https://kawalpemilu.org#22879,"KALIREJO, KALIREJO, LAMPUNG TENGAH, LAMPUNG",12,94,64,158
https://kawalpemilu.org#22879,"KALIREJO, KALIREJO, LAMPUNG TENGAH, LAMPUNG",13,100,83,183
https://kawalpemilu.org#22879,"KALIREJO, KALIREJO, LAMPUNG TENGAH, LAMPUNG",14,87,73,160
https://kawalpemilu.org#22879,"KALIREJO, KALIREJO, LAMPUNG TENGAH, LAMPUNG",15,129,65,194
https://kawalpemilu.org#22879,"KALIREJO, KALIREJO, LAMPUNG TENGAH, LAMPUNG",16,156,83,239
https://kawalpemilu.org#22879,"KALIREJO, KALIREJO, LAMPUNG TENGAH, LAMPUNG",17,95,92,187
https://kawalpemilu.org#22879,"KALIREJO, KALIREJO, LAMPUNG TENGAH, LAMPUNG",18,122,92,214
https://kawalpemilu.org#22879,"KALIREJO, KALIREJO, LAMPUNG TENGAH, LAMPUNG",19,118,77,195
https://kawalpemilu.org#22879,"KALIREJO, KALIREJO, LAMPUNG TENGAH, LAMPUNG",20,129,75,204
https://kawalpemilu.org#22879,"KALIREJO, KALIREJO, LAMPUNG TENGAH, LAMPUNG",21,122,64,186
https://kawalpemilu.org#22879,"KALIREJO, KALIREJO, LAMPUNG TENGAH, LAMPUNG",22,130,93,223
https://kawalpemilu.org#22879,"KALIREJO, KALIREJO, LAMPUNG TENGAH, LAMPUNG",23,134,98,232
https://kawalpemilu.org#22879,"KALIREJO, KALIREJO, LAMPUNG TENGAH, LAMPUNG",24,98,108,206
https://kawalpemilu.org#22879,"KALIREJO, KALIREJO, LAMPUNG TENGAH, LAMPUNG",26,124,109,233
https://kawalpemilu.org#22879,"KALIREJO, KALIREJO, LAMPUNG TENGAH, LAMPUNG",27,114,114,228
https://kawalpemilu.org#22879,"KALIREJO, KALIREJO, LAMPUNG TENGAH, LAMPUNG",28,136,56,192
https://kawalpemilu.org#22880,"BALAI REJO, KALIREJO, LAMPUNG TENGAH, LAMPUNG",1,78,98,176
https://kawalpemilu.org#22880,"BALAI REJO, KALIREJO, LAMPUNG TENGAH, LAMPUNG",2,123,37,161
https://kawalpemilu.org#22880,"BALAI REJO, KALIREJO, LAMPUNG TENGAH, LAMPUNG",3,119,35,154
https://kawalpemilu.org#22880,"BALAI REJO, KALIREJO, LAMPUNG TENGAH, LAMPUNG",4,150,98,248
https://kawalpemilu.org#22880,"BALAI REJO, KALIREJO, LAMPUNG TENGAH, LAMPUNG",5,95,76,171
https://kawalpemilu.org#22880,"BALAI REJO, KALIREJO, LAMPUNG TENGAH, LAMPUNG",6,108,77,185
https://kawalpemilu.org#22880,"BALAI REJO, KALIREJO, LAMPUNG TENGAH, LAMPUNG",7,110,71,181
https://kawalpemilu.org#22880,"BALAI REJO, KALIREJO, LAMPUNG TENGAH, LAMPUNG",9,134,37,171
https://kawalpemilu.org#22880,"BALAI REJO, KALIREJO, LAMPUNG TENGAH, LAMPUNG",10,110,59,169
https://kawalpemilu.org#22880,"BALAI REJO, KALIREJO, LAMPUNG TENGAH, LAMPUNG",11,146,28,174
https://kawalpemilu.org#22880,"BALAI REJO, KALIREJO, LAMPUNG TENGAH, LAMPUNG",12,110,96,206
https://kawalpemilu.org#22880,"BALAI REJO, KALIREJO, LAMPUNG TENGAH, LAMPUNG",13,148,44,192
https://kawalpemilu.org#22880,"BALAI REJO, KALIREJO, LAMPUNG TENGAH, LAMPUNG",14,118,40,158
https://kawalpemilu.org#22881,"WATU AGUNG, KALIREJO, LAMPUNG TENGAH, LAMPUNG",1,114,98,212
https://kawalpemilu.org#22881,"WATU AGUNG, KALIREJO, LAMPUNG TENGAH, LAMPUNG",2,185,29,214
https://kawalpemilu.org#22881,"WATU AGUNG, KALIREJO, LAMPUNG TENGAH, LAMPUNG",3,161,55,216
https://kawalpemilu.org#22881,"WATU AGUNG, KALIREJO, LAMPUNG TENGAH, LAMPUNG",4,89,93,182
https://kawalpemilu.org#22881,"WATU AGUNG, KALIREJO, LAMPUNG TENGAH, LAMPUNG",5,89,49,138
https://kawalpemilu.org#22881,"WATU AGUNG, KALIREJO, LAMPUNG TENGAH, LAMPUNG",6,158,50,208
https://kawalpemilu.org#22881,"WATU AGUNG, KALIREJO, LAMPUNG TENGAH, LAMPUNG",7,143,63,206
https://kawalpemilu.org#22881,"WATU AGUNG, KALIREJO, LAMPUNG TENGAH, LAMPUNG",8,128,45,173
https://kawalpemilu.org#22881,"WATU AGUNG, KALIREJO, LAMPUNG TENGAH, LAMPUNG",9,119,107,226
https://kawalpemilu.org#22881,"WATU AGUNG, KALIREJO, LAMPUNG TENGAH, LAMPUNG",10,110,45,155
https://kawalpemilu.org#22881,"WATU AGUNG, KALIREJO, LAMPUNG TENGAH, LAMPUNG",11,90,22,112
https://kawalpemilu.org#22881,"WATU AGUNG, KALIREJO, LAMPUNG TENGAH, LAMPUNG",12,144,63,207
https://kawalpemilu.org#22882,"SRI BASUKI, KALIREJO, LAMPUNG TENGAH, LAMPUNG",1,109,116,225
https://kawalpemilu.org#22882,"SRI BASUKI, KALIREJO, LAMPUNG TENGAH, LAMPUNG",2,92,114,206
https://kawalpemilu.org#22882,"SRI BASUKI, KALIREJO, LAMPUNG TENGAH, LAMPUNG",3,97,77,174
https://kawalpemilu.org#22882,"SRI BASUKI, KALIREJO, LAMPUNG TENGAH, LAMPUNG",4,106,75,181
https://kawalpemilu.org#22882,"SRI BASUKI, KALIREJO, LAMPUNG TENGAH, LAMPUNG",5,122,51,173
https://kawalpemilu.org#22882,"SRI BASUKI, KALIREJO, LAMPUNG TENGAH, LAMPUNG",6,108,87,195
https://kawalpemilu.org#22882,"SRI BASUKI, KALIREJO, LAMPUNG TENGAH, LAMPUNG",7,93,65,158
https://kawalpemilu.org#22882,"SRI BASUKI, KALIREJO, LAMPUNG TENGAH, LAMPUNG",8,115,49,164
https://kawalpemilu.org#22883,"KALI WUNGU, KALIREJO, LAMPUNG TENGAH, LAMPUNG",1,116,84,200
https://kawalpemilu.org#22883,"KALI WUNGU, KALIREJO, LAMPUNG TENGAH, LAMPUNG",2,130,98,228
https://kawalpemilu.org#22883,"KALI WUNGU, KALIREJO, LAMPUNG TENGAH, LAMPUNG",3,84,108,192
https://kawalpemilu.org#22883,"KALI WUNGU, KALIREJO, LAMPUNG TENGAH, LAMPUNG",4,119,44,163
https://kawalpemilu.org#22883,"KALI WUNGU, KALIREJO, LAMPUNG TENGAH, LAMPUNG",5,119,77,196
https://kawalpemilu.org#22883,"KALI WUNGU, KALIREJO, LAMPUNG TENGAH, LAMPUNG",6,127,87,214
https://kawalpemilu.org#22883,"KALI WUNGU, KALIREJO, LAMPUNG TENGAH, LAMPUNG",7,91,87,178
https://kawalpemilu.org#22883,"KALI WUNGU, KALIREJO, LAMPUNG TENGAH, LAMPUNG",8,126,81,207
https://kawalpemilu.org#22883,"KALI WUNGU, KALIREJO, LAMPUNG TENGAH, LAMPUNG",9,125,104,229
https://kawalpemilu.org#22883,"KALI WUNGU, KALIREJO, LAMPUNG TENGAH, LAMPUNG",10,106,69,175
https://kawalpemilu.org#22883,"KALI WUNGU, KALIREJO, LAMPUNG TENGAH, LAMPUNG",11,112,45,157
https://kawalpemilu.org#22883,"KALI WUNGU, KALIREJO, LAMPUNG TENGAH, LAMPUNG",12,102,38,140
https://kawalpemilu.org#22883,"KALI WUNGU, KALIREJO, LAMPUNG TENGAH, LAMPUNG",13,94,46,140
https://kawalpemilu.org#22883,"KALI WUNGU, KALIREJO, LAMPUNG TENGAH, LAMPUNG",14,92,75,167
https://kawalpemilu.org#22883,"KALI WUNGU, KALIREJO, LAMPUNG TENGAH, LAMPUNG",15,90,56,146
https://kawalpemilu.org#22884,"KALIDADI, KALIREJO, LAMPUNG TENGAH, LAMPUNG",1,93,120,213
https://kawalpemilu.org#22884,"KALIDADI, KALIREJO, LAMPUNG TENGAH, LAMPUNG",2,145,31,176
https://kawalpemilu.org#22884,"KALIDADI, KALIREJO, LAMPUNG TENGAH, LAMPUNG",3,82,87,169
https://kawalpemilu.org#22884,"KALIDADI, KALIREJO, LAMPUNG TENGAH, LAMPUNG",4,114,82,196
https://kawalpemilu.org#22884,"KALIDADI, KALIREJO, LAMPUNG TENGAH, LAMPUNG",5,111,75,186
https://kawalpemilu.org#22884,"KALIDADI, KALIREJO, LAMPUNG TENGAH, LAMPUNG",6,77,64,141
https://kawalpemilu.org#22884,"KALIDADI, KALIREJO, LAMPUNG TENGAH, LAMPUNG",7,134,45,179
https://kawalpemilu.org#22884,"KALIDADI, KALIREJO, LAMPUNG TENGAH, LAMPUNG",8,135,52,187
https://kawalpemilu.org#22884,"KALIDADI, KALIREJO, LAMPUNG TENGAH, LAMPUNG",9,121,80,201
https://kawalpemilu.org#22884,"KALIDADI, KALIREJO, LAMPUNG TENGAH, LAMPUNG",10,100,89,189
https://kawalpemilu.org#22884,"KALIDADI, KALIREJO, LAMPUNG TENGAH, LAMPUNG",11,75,79,154
https://kawalpemilu.org#22884,"KALIDADI, KALIREJO, LAMPUNG TENGAH, LAMPUNG",12,49,106,155
https://kawalpemilu.org#22884,"KALIDADI, KALIREJO, LAMPUNG TENGAH, LAMPUNG",13,76,131,207
https://kawalpemilu.org#22884,"KALIDADI, KALIREJO, LAMPUNG TENGAH, LAMPUNG",14,109,63,172
https://kawalpemilu.org#22884,"KALIDADI, KALIREJO, LAMPUNG TENGAH, LAMPUNG",15,78,72,150
https://kawalpemilu.org#22884,"KALIDADI, KALIREJO, LAMPUNG TENGAH, LAMPUNG",16,118,49,167
https://kawalpemilu.org#22884,"KALIDADI, KALIREJO, LAMPUNG TENGAH, LAMPUNG",17,87,48,135
https://kawalpemilu.org#22885,"SRI MULYO, KALIREJO, LAMPUNG TENGAH, LAMPUNG",2,127,33,160
https://kawalpemilu.org#22885,"SRI MULYO, KALIREJO, LAMPUNG TENGAH, LAMPUNG",3,116,75,191
https://kawalpemilu.org#22885,"SRI MULYO, KALIREJO, LAMPUNG TENGAH, LAMPUNG",4,108,66,174
https://kawalpemilu.org#22885,"SRI MULYO, KALIREJO, LAMPUNG TENGAH, LAMPUNG",5,122,29,151
https://kawalpemilu.org#22885,"SRI MULYO, KALIREJO, LAMPUNG TENGAH, LAMPUNG",6,125,43,168
https://kawalpemilu.org#22885,"SRI MULYO, KALIREJO, LAMPUNG TENGAH, LAMPUNG",7,106,40,146
https://kawalpemilu.org#22885,"SRI MULYO, KALIREJO, LAMPUNG TENGAH, LAMPUNG",8,130,99,229
https://kawalpemilu.org#22885,"SRI MULYO, KALIREJO, LAMPUNG TENGAH, LAMPUNG",9,121,57,178
https://kawalpemilu.org#22885,"SRI MULYO, KALIREJO, LAMPUNG TENGAH, LAMPUNG",10,134,35,169
https://kawalpemilu.org#22886,"SRIDADI, KALIREJO, LAMPUNG TENGAH, LAMPUNG",1,133,99,232
https://kawalpemilu.org#22886,"SRIDADI, KALIREJO, LAMPUNG TENGAH, LAMPUNG",2,112,98,210
https://kawalpemilu.org#22886,"SRIDADI, KALIREJO, LAMPUNG TENGAH, LAMPUNG",3,134,81,215
https://kawalpemilu.org#22886,"SRIDADI, KALIREJO, LAMPUNG TENGAH, LAMPUNG",4,142,61,203
https://kawalpemilu.org#22886,"SRIDADI, KALIREJO, LAMPUNG TENGAH, LAMPUNG",5,133,97,210
https://kawalpemilu.org#22886,"SRIDADI, KALIREJO, LAMPUNG TENGAH, LAMPUNG",6,121,63,0
https://kawalpemilu.org#22886,"SRIDADI, KALIREJO, LAMPUNG TENGAH, LAMPUNG",7,129,38,167
https://kawalpemilu.org#22886,"SRIDADI, KALIREJO, LAMPUNG TENGAH, LAMPUNG",8,120,65,185
https://kawalpemilu.org#22886,"SRIDADI, KALIREJO, LAMPUNG TENGAH, LAMPUNG",9,126,82,208
https://kawalpemilu.org#22886,"SRIDADI, KALIREJO, LAMPUNG TENGAH, LAMPUNG",10,111,99,210
https://kawalpemilu.org#22886,"SRIDADI, KALIREJO, LAMPUNG TENGAH, LAMPUNG",11,125,47,172
https://kawalpemilu.org#22886,"SRIDADI, KALIREJO, LAMPUNG TENGAH, LAMPUNG",12,114,48,162
https://kawalpemilu.org#22886,"SRIDADI, KALIREJO, LAMPUNG TENGAH, LAMPUNG",13,131,76,207
https://kawalpemilu.org#22886,"SRIDADI, KALIREJO, LAMPUNG TENGAH, LAMPUNG",14,100,81,181
https://kawalpemilu.org#22887,"SUKO SARI, KALIREJO, LAMPUNG TENGAH, LAMPUNG",1,140,84,224
https://kawalpemilu.org#22887,"SUKO SARI, KALIREJO, LAMPUNG TENGAH, LAMPUNG",2,130,76,206
https://kawalpemilu.org#22887,"SUKO SARI, KALIREJO, LAMPUNG TENGAH, LAMPUNG",3,110,85,195
https://kawalpemilu.org#22887,"SUKO SARI, KALIREJO, LAMPUNG TENGAH, LAMPUNG",4,100,60,160
https://kawalpemilu.org#22887,"SUKO SARI, KALIREJO, LAMPUNG TENGAH, LAMPUNG",6,82,99,181
https://kawalpemilu.org#22887,"SUKO SARI, KALIREJO, LAMPUNG TENGAH, LAMPUNG",7,82,115,197
https://kawalpemilu.org#22887,"SUKO SARI, KALIREJO, LAMPUNG TENGAH, LAMPUNG",8,102,66,168
https://kawalpemilu.org#22887,"SUKO SARI, KALIREJO, LAMPUNG TENGAH, LAMPUNG",9,156,78,234
https://kawalpemilu.org#22887,"SUKO SARI, KALIREJO, LAMPUNG TENGAH, LAMPUNG",10,66,121,187
https://kawalpemilu.org#22887,"SUKO SARI, KALIREJO, LAMPUNG TENGAH, LAMPUNG",11,97,62,159
https://kawalpemilu.org#22888,"SINAR SARI, KALIREJO, LAMPUNG TENGAH, LAMPUNG",1,130,40,170
https://kawalpemilu.org#22888,"SINAR SARI, KALIREJO, LAMPUNG TENGAH, LAMPUNG",2,154,42,196
https://kawalpemilu.org#22888,"SINAR SARI, KALIREJO, LAMPUNG TENGAH, LAMPUNG",3,112,96,208
https://kawalpemilu.org#22888,"SINAR SARI, KALIREJO, LAMPUNG TENGAH, LAMPUNG",4,126,54,180
https://kawalpemilu.org#22888,"SINAR SARI, KALIREJO, LAMPUNG TENGAH, LAMPUNG",5,124,56,180
https://kawalpemilu.org#22888,"SINAR SARI, KALIREJO, LAMPUNG TENGAH, LAMPUNG",6,138,61,199
https://kawalpemilu.org#22888,"SINAR SARI, KALIREJO, LAMPUNG TENGAH, LAMPUNG",7,124,36,160
https://kawalpemilu.org#22888,"SINAR SARI, KALIREJO, LAMPUNG TENGAH, LAMPUNG",8,126,38,164
https://kawalpemilu.org#22888,"SINAR SARI, KALIREJO, LAMPUNG TENGAH, LAMPUNG",9,125,39,164
https://kawalpemilu.org#22889,"PONCO WARNO, KALIREJO, LAMPUNG TENGAH, LAMPUNG",1,159,66,225
https://kawalpemilu.org#22889,"PONCO WARNO, KALIREJO, LAMPUNG TENGAH, LAMPUNG",2,127,63,190
https://kawalpemilu.org#22889,"PONCO WARNO, KALIREJO, LAMPUNG TENGAH, LAMPUNG",3,143,78,221
https://kawalpemilu.org#22889,"PONCO WARNO, KALIREJO, LAMPUNG TENGAH, LAMPUNG",4,86,65,151
https://kawalpemilu.org#22889,"PONCO WARNO, KALIREJO, LAMPUNG TENGAH, LAMPUNG",5,102,82,184
https://kawalpemilu.org#22889,"PONCO WARNO, KALIREJO, LAMPUNG TENGAH, LAMPUNG",6,114,43,157
https://kawalpemilu.org#22889,"PONCO WARNO, KALIREJO, LAMPUNG TENGAH, LAMPUNG",7,109,51,160
https://kawalpemilu.org#22889,"PONCO WARNO, KALIREJO, LAMPUNG TENGAH, LAMPUNG",8,86,65,151
https://kawalpemilu.org#22889,"PONCO WARNO, KALIREJO, LAMPUNG TENGAH, LAMPUNG",9,112,61,173
https://kawalpemilu.org#22889,"PONCO WARNO, KALIREJO, LAMPUNG TENGAH, LAMPUNG",10,145,78,223
https://kawalpemilu.org#22889,"PONCO WARNO, KALIREJO, LAMPUNG TENGAH, LAMPUNG",11,139,45,184
https://kawalpemilu.org#22889,"PONCO WARNO, KALIREJO, LAMPUNG TENGAH, LAMPUNG",12,99,71,170
https://kawalpemilu.org#22889,"PONCO WARNO, KALIREJO, LAMPUNG TENGAH, LAMPUNG",13,122,68,190
https://kawalpemilu.org#22889,"PONCO WARNO, KALIREJO, LAMPUNG TENGAH, LAMPUNG",14,95,65,160
https://kawalpemilu.org#22889,"PONCO WARNO, KALIREJO, LAMPUNG TENGAH, LAMPUNG",15,131,73,204
https://kawalpemilu.org#22889,"PONCO WARNO, KALIREJO, LAMPUNG TENGAH, LAMPUNG",16,108,45,153
https://kawalpemilu.org#22889,"PONCO WARNO, KALIREJO, LAMPUNG TENGAH, LAMPUNG",17,129,53,182
https://kawalpemilu.org#22889,"PONCO WARNO, KALIREJO, LAMPUNG TENGAH, LAMPUNG",18,117,36,153
https://kawalpemilu.org#22889,"PONCO WARNO, KALIREJO, LAMPUNG TENGAH, LAMPUNG",19,139,41,170
https://kawalpemilu.org#22889,"PONCO WARNO, KALIREJO, LAMPUNG TENGAH, LAMPUNG",20,89,47,136
https://kawalpemilu.org#22889,"PONCO WARNO, KALIREJO, LAMPUNG TENGAH, LAMPUNG",21,136,48,184
https://kawalpemilu.org#22889,"PONCO WARNO, KALIREJO, LAMPUNG TENGAH, LAMPUNG",22,176,36,212
https://kawalpemilu.org#22889,"PONCO WARNO, KALIREJO, LAMPUNG TENGAH, LAMPUNG",23,103,70,173
https://kawalpemilu.org#22889,"PONCO WARNO, KALIREJO, LAMPUNG TENGAH, LAMPUNG",24,138,67,205
https://kawalpemilu.org#22889,"PONCO WARNO, KALIREJO, LAMPUNG TENGAH, LAMPUNG",25,125,54,179
https://kawalpemilu.org#22889,"PONCO WARNO, KALIREJO, LAMPUNG TENGAH, LAMPUNG",26,122,35,157
https://kawalpemilu.org#84789,"SINARREJO, KALIREJO, LAMPUNG TENGAH, LAMPUNG",1,53,138,191
https://kawalpemilu.org#84789,"SINARREJO, KALIREJO, LAMPUNG TENGAH, LAMPUNG",2,112,75,187
https://kawalpemilu.org#84789,"SINARREJO, KALIREJO, LAMPUNG TENGAH, LAMPUNG",3,108,54,162
https://kawalpemilu.org#84789,"SINARREJO, KALIREJO, LAMPUNG TENGAH, LAMPUNG",4,151,42,193
https://kawalpemilu.org#84790,"AGUNG TIMUR, KALIREJO, LAMPUNG TENGAH, LAMPUNG",1,101,100,201
https://kawalpemilu.org#84790,"AGUNG TIMUR, KALIREJO, LAMPUNG TENGAH, LAMPUNG",2,113,71,184
https://kawalpemilu.org#84790,"AGUNG TIMUR, KALIREJO, LAMPUNG TENGAH, LAMPUNG",3,99,84,183
https://kawalpemilu.org#84790,"AGUNG TIMUR, KALIREJO, LAMPUNG TENGAH, LAMPUNG",4,94,75,169
https://kawalpemilu.org#84790,"AGUNG TIMUR, KALIREJO, LAMPUNG TENGAH, LAMPUNG",5,148,39,187
https://kawalpemilu.org#84790,"AGUNG TIMUR, KALIREJO, LAMPUNG TENGAH, LAMPUNG",6,130,74,204
https://kawalpemilu.org#84790,"AGUNG TIMUR, KALIREJO, LAMPUNG TENGAH, LAMPUNG",7,135,35,170
https://kawalpemilu.org#84790,"AGUNG TIMUR, KALIREJO, LAMPUNG TENGAH, LAMPUNG",8,98,33,131
https://kawalpemilu.org#84790,"AGUNG TIMUR, KALIREJO, LAMPUNG TENGAH, LAMPUNG",9,131,29,160
https://kawalpemilu.org#84790,"AGUNG TIMUR, KALIREJO, LAMPUNG TENGAH, LAMPUNG",10,105,73,178
https://kawalpemilu.org#91288,"SRI PURNOMO, KALIREJO, LAMPUNG TENGAH, LAMPUNG",1,139,48,187
https://kawalpemilu.org#91288,"SRI PURNOMO, KALIREJO, LAMPUNG TENGAH, LAMPUNG",2,132,67,199
https://kawalpemilu.org#91288,"SRI PURNOMO, KALIREJO, LAMPUNG TENGAH, LAMPUNG",3,170,43,213
https://kawalpemilu.org#91288,"SRI PURNOMO, KALIREJO, LAMPUNG TENGAH, LAMPUNG",4,181,27,208
https://kawalpemilu.org#91288,"SRI PURNOMO, KALIREJO, LAMPUNG TENGAH, LAMPUNG",5,129,77,206
https://kawalpemilu.org#91288,"SRI PURNOMO, KALIREJO, LAMPUNG TENGAH, LAMPUNG",6,137,56,193
https://kawalpemilu.org#91288,"SRI PURNOMO, KALIREJO, LAMPUNG TENGAH, LAMPUNG",7,161,29,190
https://kawalpemilu.org#91288,"SRI PURNOMO, KALIREJO, LAMPUNG TENGAH, LAMPUNG",8,156,37,193
https://kawalpemilu.org#91288,"SRI PURNOMO, KALIREJO, LAMPUNG TENGAH, LAMPUNG",9,140,37,177
https://kawalpemilu.org#91288,"SRI PURNOMO, KALIREJO, LAMPUNG TENGAH, LAMPUNG",10,138,70,208
https://kawalpemilu.org#91288,"SRI PURNOMO, KALIREJO, LAMPUNG TENGAH, LAMPUNG",11,150,43,193
https://kawalpemilu.org#91288,"SRI PURNOMO, KALIREJO, LAMPUNG TENGAH, LAMPUNG",12,163,40,203
https://kawalpemilu.org#928198,"KALI SARI, KALIREJO, LAMPUNG TENGAH, LAMPUNG",1,138,58,196
https://kawalpemilu.org#928198,"KALI SARI, KALIREJO, LAMPUNG TENGAH, LAMPUNG",2,177,44,221
https://kawalpemilu.org#928198,"KALI SARI, KALIREJO, LAMPUNG TENGAH, LAMPUNG",3,153,41,194
https://kawalpemilu.org#928198,"KALI SARI, KALIREJO, LAMPUNG TENGAH, LAMPUNG",4,165,33,198
https://kawalpemilu.org#22891,"PURWODADI, BANGUN REJO, LAMPUNG TENGAH, LAMPUNG",1,96,82,178
https://kawalpemilu.org#22891,"PURWODADI, BANGUN REJO, LAMPUNG TENGAH, LAMPUNG",2,155,38,193
https://kawalpemilu.org#22891,"PURWODADI, BANGUN REJO, LAMPUNG TENGAH, LAMPUNG",3,115,53,168
https://kawalpemilu.org#22891,"PURWODADI, BANGUN REJO, LAMPUNG TENGAH, LAMPUNG",4,143,33,176
https://kawalpemilu.org#22891,"PURWODADI, BANGUN REJO, LAMPUNG TENGAH, LAMPUNG",5,124,79,203
https://kawalpemilu.org#22891,"PURWODADI, BANGUN REJO, LAMPUNG TENGAH, LAMPUNG",6,129,73,202
https://kawalpemilu.org#22891,"PURWODADI, BANGUN REJO, LAMPUNG TENGAH, LAMPUNG",7,90,56,146
https://kawalpemilu.org#22891,"PURWODADI, BANGUN REJO, LAMPUNG TENGAH, LAMPUNG",8,109,63,172
https://kawalpemilu.org#22891,"PURWODADI, BANGUN REJO, LAMPUNG TENGAH, LAMPUNG",9,128,42,170
https://kawalpemilu.org#22891,"PURWODADI, BANGUN REJO, LAMPUNG TENGAH, LAMPUNG",10,95,53,148
https://kawalpemilu.org#22891,"PURWODADI, BANGUN REJO, LAMPUNG TENGAH, LAMPUNG",11,124,61,185
https://kawalpemilu.org#22891,"PURWODADI, BANGUN REJO, LAMPUNG TENGAH, LAMPUNG",12,107,50,157
https://kawalpemilu.org#22891,"PURWODADI, BANGUN REJO, LAMPUNG TENGAH, LAMPUNG",13,133,48,181
https://kawalpemilu.org#22891,"PURWODADI, BANGUN REJO, LAMPUNG TENGAH, LAMPUNG",14,64,55,119
https://kawalpemilu.org#22891,"PURWODADI, BANGUN REJO, LAMPUNG TENGAH, LAMPUNG",15,115,38,153
https://kawalpemilu.org#22892,"SIDO DADI, BANGUN REJO, LAMPUNG TENGAH, LAMPUNG",1,80,67,147
https://kawalpemilu.org#22892,"SIDO DADI, BANGUN REJO, LAMPUNG TENGAH, LAMPUNG",2,79,96,175
https://kawalpemilu.org#22892,"SIDO DADI, BANGUN REJO, LAMPUNG TENGAH, LAMPUNG",3,102,85,187
https://kawalpemilu.org#22892,"SIDO DADI, BANGUN REJO, LAMPUNG TENGAH, LAMPUNG",4,59,153,212
https://kawalpemilu.org#22892,"SIDO DADI, BANGUN REJO, LAMPUNG TENGAH, LAMPUNG",5,73,95,168
https://kawalpemilu.org#22892,"SIDO DADI, BANGUN REJO, LAMPUNG TENGAH, LAMPUNG",6,44,120,164
https://kawalpemilu.org#22892,"SIDO DADI, BANGUN REJO, LAMPUNG TENGAH, LAMPUNG",7,76,89,165
https://kawalpemilu.org#22892,"SIDO DADI, BANGUN REJO, LAMPUNG TENGAH, LAMPUNG",8,48,123,171
https://kawalpemilu.org#22892,"SIDO DADI, BANGUN REJO, LAMPUNG TENGAH, LAMPUNG",9,83,78,161
https://kawalpemilu.org#22892,"SIDO DADI, BANGUN REJO, LAMPUNG TENGAH, LAMPUNG",10,76,45,121
https://kawalpemilu.org#22892,"SIDO DADI, BANGUN REJO, LAMPUNG TENGAH, LAMPUNG",11,98,47,145
https://kawalpemilu.org#22892,"SIDO DADI, BANGUN REJO, LAMPUNG TENGAH, LAMPUNG",12,92,49,141
https://kawalpemilu.org#22892,"SIDO DADI, BANGUN REJO, LAMPUNG TENGAH, LAMPUNG",13,129,61,190
https://kawalpemilu.org#22892,"SIDO DADI, BANGUN REJO, LAMPUNG TENGAH, LAMPUNG",14,79,123,202
https://kawalpemilu.org#22892,"SIDO DADI, BANGUN REJO, LAMPUNG TENGAH, LAMPUNG",15,73,88,161
https://kawalpemilu.org#22892,"SIDO DADI, BANGUN REJO, LAMPUNG TENGAH, LAMPUNG",16,57,115,172
https://kawalpemilu.org#22893,"SIDO REJO, BANGUN REJO, LAMPUNG TENGAH, LAMPUNG",1,94,46,140
https://kawalpemilu.org#22893,"SIDO REJO, BANGUN REJO, LAMPUNG TENGAH, LAMPUNG",2,110,51,161
https://kawalpemilu.org#22893,"SIDO REJO, BANGUN REJO, LAMPUNG TENGAH, LAMPUNG",3,119,67,186
https://kawalpemilu.org#22893,"SIDO REJO, BANGUN REJO, LAMPUNG TENGAH, LAMPUNG",4,128,59,187
https://kawalpemilu.org#22893,"SIDO REJO, BANGUN REJO, LAMPUNG TENGAH, LAMPUNG",5,96,40,136
https://kawalpemilu.org#22893,"SIDO REJO, BANGUN REJO, LAMPUNG TENGAH, LAMPUNG",6,81,29,110
https://kawalpemilu.org#22893,"SIDO REJO, BANGUN REJO, LAMPUNG TENGAH, LAMPUNG",7,86,50,136
https://kawalpemilu.org#22893,"SIDO REJO, BANGUN REJO, LAMPUNG TENGAH, LAMPUNG",8,76,47,123
https://kawalpemilu.org#22893,"SIDO REJO, BANGUN REJO, LAMPUNG TENGAH, LAMPUNG",9,157,60,217
https://kawalpemilu.org#22893,"SIDO REJO, BANGUN REJO, LAMPUNG TENGAH, LAMPUNG",10,102,29,131
https://kawalpemilu.org#22893,"SIDO REJO, BANGUN REJO, LAMPUNG TENGAH, LAMPUNG",11,117,22,139
https://kawalpemilu.org#22893,"SIDO REJO, BANGUN REJO, LAMPUNG TENGAH, LAMPUNG",12,98,22,120
https://kawalpemilu.org#22893,"SIDO REJO, BANGUN REJO, LAMPUNG TENGAH, LAMPUNG",13,89,14,103
https://kawalpemilu.org#22893,"SIDO REJO, BANGUN REJO, LAMPUNG TENGAH, LAMPUNG",14,148,63,211
https://kawalpemilu.org#22894,"CIMARIAS, BANGUN REJO, LAMPUNG TENGAH, LAMPUNG",1,82,53,135
https://kawalpemilu.org#22894,"CIMARIAS, BANGUN REJO, LAMPUNG TENGAH, LAMPUNG",2,27,90,117
https://kawalpemilu.org#22894,"CIMARIAS, BANGUN REJO, LAMPUNG TENGAH, LAMPUNG",3,79,60,139
https://kawalpemilu.org#22894,"CIMARIAS, BANGUN REJO, LAMPUNG TENGAH, LAMPUNG",4,87,73,160
https://kawalpemilu.org#22894,"CIMARIAS, BANGUN REJO, LAMPUNG TENGAH, LAMPUNG",5,121,35,156
https://kawalpemilu.org#22894,"CIMARIAS, BANGUN REJO, LAMPUNG TENGAH, LAMPUNG",6,79,51,130
https://kawalpemilu.org#22894,"CIMARIAS, BANGUN REJO, LAMPUNG TENGAH, LAMPUNG",7,133,23,156
https://kawalpemilu.org#22894,"CIMARIAS, BANGUN REJO, LAMPUNG TENGAH, LAMPUNG",8,144,32,176
https://kawalpemilu.org#22894,"CIMARIAS, BANGUN REJO, LAMPUNG TENGAH, LAMPUNG",9,92,57,149
https://kawalpemilu.org#22894,"CIMARIAS, BANGUN REJO, LAMPUNG TENGAH, LAMPUNG",10,91,27,118
https://kawalpemilu.org#22894,"CIMARIAS, BANGUN REJO, LAMPUNG TENGAH, LAMPUNG",11,113,53,166
https://kawalpemilu.org#22894,"CIMARIAS, BANGUN REJO, LAMPUNG TENGAH, LAMPUNG",12,114,40,154
https://kawalpemilu.org#22895,"BANGUN REJO, BANGUN REJO, LAMPUNG TENGAH, LAMPUNG",1,146,27,173
https://kawalpemilu.org#22895,"BANGUN REJO, BANGUN REJO, LAMPUNG TENGAH, LAMPUNG",2,142,47,189
https://kawalpemilu.org#22895,"BANGUN REJO, BANGUN REJO, LAMPUNG TENGAH, LAMPUNG",3,135,34,169
https://kawalpemilu.org#22895,"BANGUN REJO, BANGUN REJO, LAMPUNG TENGAH, LAMPUNG",4,124,22,146
https://kawalpemilu.org#22895,"BANGUN REJO, BANGUN REJO, LAMPUNG TENGAH, LAMPUNG",5,93,38,131
https://kawalpemilu.org#22895,"BANGUN REJO, BANGUN REJO, LAMPUNG TENGAH, LAMPUNG",6,105,80,185
https://kawalpemilu.org#22895,"BANGUN REJO, BANGUN REJO, LAMPUNG TENGAH, LAMPUNG",7,90,26,116
https://kawalpemilu.org#22895,"BANGUN REJO, BANGUN REJO, LAMPUNG TENGAH, LAMPUNG",8,152,54,206
https://kawalpemilu.org#22895,"BANGUN REJO, BANGUN REJO, LAMPUNG TENGAH, LAMPUNG",9,108,80,188
https://kawalpemilu.org#22895,"BANGUN REJO, BANGUN REJO, LAMPUNG TENGAH, LAMPUNG",10,65,67,132
https://kawalpemilu.org#22895,"BANGUN REJO, BANGUN REJO, LAMPUNG TENGAH, LAMPUNG",11,87,72,159
https://kawalpemilu.org#22895,"BANGUN REJO, BANGUN REJO, LAMPUNG TENGAH, LAMPUNG",12,136,26,162
https://kawalpemilu.org#22895,"BANGUN REJO, BANGUN REJO, LAMPUNG TENGAH, LAMPUNG",13,149,44,193
https://kawalpemilu.org#22895,"BANGUN REJO, BANGUN REJO, LAMPUNG TENGAH, LAMPUNG",14,146,58,204
https://kawalpemilu.org#22895,"BANGUN REJO, BANGUN REJO, LAMPUNG TENGAH, LAMPUNG",15,118,25,143
https://kawalpemilu.org#22895,"BANGUN REJO, BANGUN REJO, LAMPUNG TENGAH, LAMPUNG",16,175,27,202
https://kawalpemilu.org#22895,"BANGUN REJO, BANGUN REJO, LAMPUNG TENGAH, LAMPUNG",17,134,36,170
https://kawalpemilu.org#22895,"BANGUN REJO, BANGUN REJO, LAMPUNG TENGAH, LAMPUNG",18,94,60,154
https://kawalpemilu.org#22895,"BANGUN REJO, BANGUN REJO, LAMPUNG TENGAH, LAMPUNG",19,129,58,187
https://kawalpemilu.org#22896,"SIDO LUHUR, BANGUN REJO, LAMPUNG TENGAH, LAMPUNG",1,129,33,162
https://kawalpemilu.org#22896,"SIDO LUHUR, BANGUN REJO, LAMPUNG TENGAH, LAMPUNG",2,125,34,159
https://kawalpemilu.org#22896,"SIDO LUHUR, BANGUN REJO, LAMPUNG TENGAH, LAMPUNG",3,158,28,186
https://kawalpemilu.org#22896,"SIDO LUHUR, BANGUN REJO, LAMPUNG TENGAH, LAMPUNG",4,35,116,151
https://kawalpemilu.org#22896,"SIDO LUHUR, BANGUN REJO, LAMPUNG TENGAH, LAMPUNG",5,85,92,177
https://kawalpemilu.org#22896,"SIDO LUHUR, BANGUN REJO, LAMPUNG TENGAH, LAMPUNG",6,105,64,169
https://kawalpemilu.org#22896,"SIDO LUHUR, BANGUN REJO, LAMPUNG TENGAH, LAMPUNG",7,109,86,195
https://kawalpemilu.org#22896,"SIDO LUHUR, BANGUN REJO, LAMPUNG TENGAH, LAMPUNG",8,169,39,208
https://kawalpemilu.org#22896,"SIDO LUHUR, BANGUN REJO, LAMPUNG TENGAH, LAMPUNG",9,116,32,148
https://kawalpemilu.org#22896,"SIDO LUHUR, BANGUN REJO, LAMPUNG TENGAH, LAMPUNG",10,160,57,217
https://kawalpemilu.org#22896,"SIDO LUHUR, BANGUN REJO, LAMPUNG TENGAH, LAMPUNG",11,157,18,175
https://kawalpemilu.org#22896,"SIDO LUHUR, BANGUN REJO, LAMPUNG TENGAH, LAMPUNG",12,130,17,147
https://kawalpemilu.org#22896,"SIDO LUHUR, BANGUN REJO, LAMPUNG TENGAH, LAMPUNG",13,132,23,155
https://kawalpemilu.org#22896,"SIDO LUHUR, BANGUN REJO, LAMPUNG TENGAH, LAMPUNG",14,108,45,153
https://kawalpemilu.org#22896,"SIDO LUHUR, BANGUN REJO, LAMPUNG TENGAH, LAMPUNG",15,164,35,199
https://kawalpemilu.org#22896,"SIDO LUHUR, BANGUN REJO, LAMPUNG TENGAH, LAMPUNG",16,140,25,165
https://kawalpemilu.org#22897,"SIDO MULYO, BANGUN REJO, LAMPUNG TENGAH, LAMPUNG",1,55,33,88
https://kawalpemilu.org#22897,"SIDO MULYO, BANGUN REJO, LAMPUNG TENGAH, LAMPUNG",2,85,61,146
https://kawalpemilu.org#22897,"SIDO MULYO, BANGUN REJO, LAMPUNG TENGAH, LAMPUNG",3,89,47,136
https://kawalpemilu.org#22897,"SIDO MULYO, BANGUN REJO, LAMPUNG TENGAH, LAMPUNG",4,98,64,162
https://kawalpemilu.org#22897,"SIDO MULYO, BANGUN REJO, LAMPUNG TENGAH, LAMPUNG",5,112,83,195
https://kawalpemilu.org#22897,"SIDO MULYO, BANGUN REJO, LAMPUNG TENGAH, LAMPUNG",6,127,46,173
https://kawalpemilu.org#22897,"SIDO MULYO, BANGUN REJO, LAMPUNG TENGAH, LAMPUNG",7,114,26,140
https://kawalpemilu.org#22897,"SIDO MULYO, BANGUN REJO, LAMPUNG TENGAH, LAMPUNG",8,76,34,110
https://kawalpemilu.org#22897,"SIDO MULYO, BANGUN REJO, LAMPUNG TENGAH, LAMPUNG",9,97,23,120
https://kawalpemilu.org#22897,"SIDO MULYO, BANGUN REJO, LAMPUNG TENGAH, LAMPUNG",10,118,50,168
https://kawalpemilu.org#22897,"SIDO MULYO, BANGUN REJO, LAMPUNG TENGAH, LAMPUNG",11,81,22,103
https://kawalpemilu.org#22897,"SIDO MULYO, BANGUN REJO, LAMPUNG TENGAH, LAMPUNG",12,166,25,191
https://kawalpemilu.org#22897,"SIDO MULYO, BANGUN REJO, LAMPUNG TENGAH, LAMPUNG",13,134,74,208
https://kawalpemilu.org#22897,"SIDO MULYO, BANGUN REJO, LAMPUNG TENGAH, LAMPUNG",14,139,58,197
https://kawalpemilu.org#22897,"SIDO MULYO, BANGUN REJO, LAMPUNG TENGAH, LAMPUNG",15,104,29,133
https://kawalpemilu.org#22898,"TIMBUL REJO, BANGUN REJO, LAMPUNG TENGAH, LAMPUNG",1,123,14,137
https://kawalpemilu.org#22898,"TIMBUL REJO, BANGUN REJO, LAMPUNG TENGAH, LAMPUNG",2,122,53,175
https://kawalpemilu.org#22898,"TIMBUL REJO, BANGUN REJO, LAMPUNG TENGAH, LAMPUNG",3,131,36,167
https://kawalpemilu.org#22898,"TIMBUL REJO, BANGUN REJO, LAMPUNG TENGAH, LAMPUNG",4,115,29,144
https://kawalpemilu.org#22898,"TIMBUL REJO, BANGUN REJO, LAMPUNG TENGAH, LAMPUNG",5,122,31,153
https://kawalpemilu.org#22899,"SUKA NEGARA, BANGUN REJO, LAMPUNG TENGAH, LAMPUNG",1,113,5,118
https://kawalpemilu.org#22899,"SUKA NEGARA, BANGUN REJO, LAMPUNG TENGAH, LAMPUNG",2,172,31,203
https://kawalpemilu.org#22899,"SUKA NEGARA, BANGUN REJO, LAMPUNG TENGAH, LAMPUNG",3,102,7,109
https://kawalpemilu.org#22899,"SUKA NEGARA, BANGUN REJO, LAMPUNG TENGAH, LAMPUNG",4,105,27,132
https://kawalpemilu.org#22899,"SUKA NEGARA, BANGUN REJO, LAMPUNG TENGAH, LAMPUNG",5,88,54,142
https://kawalpemilu.org#22899,"SUKA NEGARA, BANGUN REJO, LAMPUNG TENGAH, LAMPUNG",6,107,52,159
https://kawalpemilu.org#22899,"SUKA NEGARA, BANGUN REJO, LAMPUNG TENGAH, LAMPUNG",7,104,57,161
https://kawalpemilu.org#22899,"SUKA NEGARA, BANGUN REJO, LAMPUNG TENGAH, LAMPUNG",8,102,71,173
https://kawalpemilu.org#22899,"SUKA NEGARA, BANGUN REJO, LAMPUNG TENGAH, LAMPUNG",9,127,91,218
https://kawalpemilu.org#22899,"SUKA NEGARA, BANGUN REJO, LAMPUNG TENGAH, LAMPUNG",10,77,62,139
https://kawalpemilu.org#22899,"SUKA NEGARA, BANGUN REJO, LAMPUNG TENGAH, LAMPUNG",11,198,30,228
https://kawalpemilu.org#22899,"SUKA NEGARA, BANGUN REJO, LAMPUNG TENGAH, LAMPUNG",12,61,148,209
https://kawalpemilu.org#22899,"SUKA NEGARA, BANGUN REJO, LAMPUNG TENGAH, LAMPUNG",13,82,95,177
https://kawalpemilu.org#22899,"SUKA NEGARA, BANGUN REJO, LAMPUNG TENGAH, LAMPUNG",14,77,48,125
https://kawalpemilu.org#22899,"SUKA NEGARA, BANGUN REJO, LAMPUNG TENGAH, LAMPUNG",15,185,36,221
https://kawalpemilu.org#22899,"SUKA NEGARA, BANGUN REJO, LAMPUNG TENGAH, LAMPUNG",16,204,44,248
https://kawalpemilu.org#22900,"SINAR SEPUTIH, BANGUN REJO, LAMPUNG TENGAH, LAMPUNG",1,91,55,146
https://kawalpemilu.org#22900,"SINAR SEPUTIH, BANGUN REJO, LAMPUNG TENGAH, LAMPUNG",2,106,46,152
https://kawalpemilu.org#22900,"SINAR SEPUTIH, BANGUN REJO, LAMPUNG TENGAH, LAMPUNG",3,94,48,142
https://kawalpemilu.org#22900,"SINAR SEPUTIH, BANGUN REJO, LAMPUNG TENGAH, LAMPUNG",4,72,77,149
https://kawalpemilu.org#22900,"SINAR SEPUTIH, BANGUN REJO, LAMPUNG TENGAH, LAMPUNG",5,75,75,150
https://kawalpemilu.org#22900,"SINAR SEPUTIH, BANGUN REJO, LAMPUNG TENGAH, LAMPUNG",6,81,92,173
https://kawalpemilu.org#22901,"SINAR LUAS, BANGUN REJO, LAMPUNG TENGAH, LAMPUNG",1,83,58,141
https://kawalpemilu.org#22901,"SINAR LUAS, BANGUN REJO, LAMPUNG TENGAH, LAMPUNG",2,61,91,152
https://kawalpemilu.org#22901,"SINAR LUAS, BANGUN REJO, LAMPUNG TENGAH, LAMPUNG",3,140,48,188
https://kawalpemilu.org#22901,"SINAR LUAS, BANGUN REJO, LAMPUNG TENGAH, LAMPUNG",4,140,43,183
https://kawalpemilu.org#22901,"SINAR LUAS, BANGUN REJO, LAMPUNG TENGAH, LAMPUNG",5,153,37,190
https://kawalpemilu.org#22901,"SINAR LUAS, BANGUN REJO, LAMPUNG TENGAH, LAMPUNG",6,132,48,180
https://kawalpemilu.org#22901,"SINAR LUAS, BANGUN REJO, LAMPUNG TENGAH, LAMPUNG",7,181,24,205
https://kawalpemilu.org#22902,"TANJUNG PANDAN, BANGUN REJO, LAMPUNG TENGAH, LAMPUNG",1,128,48,176
https://kawalpemilu.org#22902,"TANJUNG PANDAN, BANGUN REJO, LAMPUNG TENGAH, LAMPUNG",2,168,33,201
https://kawalpemilu.org#22902,"TANJUNG PANDAN, BANGUN REJO, LAMPUNG TENGAH, LAMPUNG",3,157,35,192
https://kawalpemilu.org#22902,"TANJUNG PANDAN, BANGUN REJO, LAMPUNG TENGAH, LAMPUNG",4,120,33,153
https://kawalpemilu.org#22902,"TANJUNG PANDAN, BANGUN REJO, LAMPUNG TENGAH, LAMPUNG",5,197,60,257
https://kawalpemilu.org#22902,"TANJUNG PANDAN, BANGUN REJO, LAMPUNG TENGAH, LAMPUNG",6,98,42,140
https://kawalpemilu.org#22902,"TANJUNG PANDAN, BANGUN REJO, LAMPUNG TENGAH, LAMPUNG",7,107,31,138
https://kawalpemilu.org#22903,"TANJUNG JAYA, BANGUN REJO, LAMPUNG TENGAH, LAMPUNG",1,152,98,250
https://kawalpemilu.org#22903,"TANJUNG JAYA, BANGUN REJO, LAMPUNG TENGAH, LAMPUNG",2,164,34,198
https://kawalpemilu.org#22903,"TANJUNG JAYA, BANGUN REJO, LAMPUNG TENGAH, LAMPUNG",3,172,46,218
https://kawalpemilu.org#22903,"TANJUNG JAYA, BANGUN REJO, LAMPUNG TENGAH, LAMPUNG",4,125,51,176
https://kawalpemilu.org#22903,"TANJUNG JAYA, BANGUN REJO, LAMPUNG TENGAH, LAMPUNG",5,158,66,224
https://kawalpemilu.org#22903,"TANJUNG JAYA, BANGUN REJO, LAMPUNG TENGAH, LAMPUNG",6,105,68,173
https://kawalpemilu.org#22903,"TANJUNG JAYA, BANGUN REJO, LAMPUNG TENGAH, LAMPUNG",7,121,61,182
https://kawalpemilu.org#22903,"TANJUNG JAYA, BANGUN REJO, LAMPUNG TENGAH, LAMPUNG",8,167,47,214
https://kawalpemilu.org#22903,"TANJUNG JAYA, BANGUN REJO, LAMPUNG TENGAH, LAMPUNG",9,135,36,171
https://kawalpemilu.org#22903,"TANJUNG JAYA, BANGUN REJO, LAMPUNG TENGAH, LAMPUNG",10,80,65,145
https://kawalpemilu.org#22903,"TANJUNG JAYA, BANGUN REJO, LAMPUNG TENGAH, LAMPUNG",11,125,64,189
https://kawalpemilu.org#22903,"TANJUNG JAYA, BANGUN REJO, LAMPUNG TENGAH, LAMPUNG",12,83,85,168
https://kawalpemilu.org#22903,"TANJUNG JAYA, BANGUN REJO, LAMPUNG TENGAH, LAMPUNG",13,86,83,169
https://kawalpemilu.org#22903,"TANJUNG JAYA, BANGUN REJO, LAMPUNG TENGAH, LAMPUNG",14,164,48,212
https://kawalpemilu.org#22903,"TANJUNG JAYA, BANGUN REJO, LAMPUNG TENGAH, LAMPUNG",15,180,37,217
https://kawalpemilu.org#22903,"TANJUNG JAYA, BANGUN REJO, LAMPUNG TENGAH, LAMPUNG",16,146,38,184
https://kawalpemilu.org#22903,"TANJUNG JAYA, BANGUN REJO, LAMPUNG TENGAH, LAMPUNG",17,161,58,219
https://kawalpemilu.org#22903,"TANJUNG JAYA, BANGUN REJO, LAMPUNG TENGAH, LAMPUNG",18,87,64,151
https://kawalpemilu.org#22903,"TANJUNG JAYA, BANGUN REJO, LAMPUNG TENGAH, LAMPUNG",19,41,89,130
https://kawalpemilu.org#22904,"SRI PENDOWO, BANGUN REJO, LAMPUNG TENGAH, LAMPUNG",1,132,17,149
https://kawalpemilu.org#22904,"SRI PENDOWO, BANGUN REJO, LAMPUNG TENGAH, LAMPUNG",2,112,43,155
https://kawalpemilu.org#22904,"SRI PENDOWO, BANGUN REJO, LAMPUNG TENGAH, LAMPUNG",3,135,22,157
https://kawalpemilu.org#22904,"SRI PENDOWO, BANGUN REJO, LAMPUNG TENGAH, LAMPUNG",4,105,12,117
https://kawalpemilu.org#22904,"SRI PENDOWO, BANGUN REJO, LAMPUNG TENGAH, LAMPUNG",5,151,23,174
https://kawalpemilu.org#22904,"SRI PENDOWO, BANGUN REJO, LAMPUNG TENGAH, LAMPUNG",6,77,13,90
https://kawalpemilu.org#22904,"SRI PENDOWO, BANGUN REJO, LAMPUNG TENGAH, LAMPUNG",7,130,27,157
https://kawalpemilu.org#22904,"SRI PENDOWO, BANGUN REJO, LAMPUNG TENGAH, LAMPUNG",8,169,39,208
https://kawalpemilu.org#22904,"SRI PENDOWO, BANGUN REJO, LAMPUNG TENGAH, LAMPUNG",9,72,9,81
https://kawalpemilu.org#22904,"SRI PENDOWO, BANGUN REJO, LAMPUNG TENGAH, LAMPUNG",10,96,27,123
https://kawalpemilu.org#22904,"SRI PENDOWO, BANGUN REJO, LAMPUNG TENGAH, LAMPUNG",11,115,25,140
https://kawalpemilu.org#22904,"SRI PENDOWO, BANGUN REJO, LAMPUNG TENGAH, LAMPUNG",12,93,19,112
https://kawalpemilu.org#22905,"SUKA WARINGIN, BANGUN REJO, LAMPUNG TENGAH, LAMPUNG",1,156,50,206
https://kawalpemilu.org#22905,"SUKA WARINGIN, BANGUN REJO, LAMPUNG TENGAH, LAMPUNG",2,49,18,67
https://kawalpemilu.org#22905,"SUKA WARINGIN, BANGUN REJO, LAMPUNG TENGAH, LAMPUNG",3,79,87,166
https://kawalpemilu.org#22905,"SUKA WARINGIN, BANGUN REJO, LAMPUNG TENGAH, LAMPUNG",4,92,59,151
https://kawalpemilu.org#22905,"SUKA WARINGIN, BANGUN REJO, LAMPUNG TENGAH, LAMPUNG",5,132,62,194
https://kawalpemilu.org#22905,"SUKA WARINGIN, BANGUN REJO, LAMPUNG TENGAH, LAMPUNG",6,171,34,205
https://kawalpemilu.org#22905,"SUKA WARINGIN, BANGUN REJO, LAMPUNG TENGAH, LAMPUNG",7,176,48,224
https://kawalpemilu.org#22905,"SUKA WARINGIN, BANGUN REJO, LAMPUNG TENGAH, LAMPUNG",8,132,38,170
https://kawalpemilu.org#22905,"SUKA WARINGIN, BANGUN REJO, LAMPUNG TENGAH, LAMPUNG",9,157,38,195
https://kawalpemilu.org#91289,"MEKAR JAYA, BANGUN REJO, LAMPUNG TENGAH, LAMPUNG",1,142,69,211
https://kawalpemilu.org#91289,"MEKAR JAYA, BANGUN REJO, LAMPUNG TENGAH, LAMPUNG",2,167,36,203
https://kawalpemilu.org#91289,"MEKAR JAYA, BANGUN REJO, LAMPUNG TENGAH, LAMPUNG",3,112,43,155
https://kawalpemilu.org#91289,"MEKAR JAYA, BANGUN REJO, LAMPUNG TENGAH, LAMPUNG",4,91,38,129
https://kawalpemilu.org#91289,"MEKAR JAYA, BANGUN REJO, LAMPUNG TENGAH, LAMPUNG",5,140,43,183
https://kawalpemilu.org#91289,"MEKAR JAYA, BANGUN REJO, LAMPUNG TENGAH, LAMPUNG",6,116,58,174
https://kawalpemilu.org#91289,"MEKAR JAYA, BANGUN REJO, LAMPUNG TENGAH, LAMPUNG",7,93,50,143
https://kawalpemilu.org#91289,"MEKAR JAYA, BANGUN REJO, LAMPUNG TENGAH, LAMPUNG",8,125,73,198
https://kawalpemilu.org#91289,"MEKAR JAYA, BANGUN REJO, LAMPUNG TENGAH, LAMPUNG",9,136,63,199
https://kawalpemilu.org#91289,"MEKAR JAYA, BANGUN REJO, LAMPUNG TENGAH, LAMPUNG",10,90,63,153
https://kawalpemilu.org#91289,"MEKAR JAYA, BANGUN REJO, LAMPUNG TENGAH, LAMPUNG",11,74,91,165
https://kawalpemilu.org#928203,"SUKA NEGERI, BANGUN REJO, LAMPUNG TENGAH, LAMPUNG",1,183,23,206
https://kawalpemilu.org#928203,"SUKA NEGERI, BANGUN REJO, LAMPUNG TENGAH, LAMPUNG",2,139,74,213
https://kawalpemilu.org#928203,"SUKA NEGERI, BANGUN REJO, LAMPUNG TENGAH, LAMPUNG",3,87,41,128
https://kawalpemilu.org#928203,"SUKA NEGERI, BANGUN REJO, LAMPUNG TENGAH, LAMPUNG",4,89,10,99
https://kawalpemilu.org#928203,"SUKA NEGERI, BANGUN REJO, LAMPUNG TENGAH, LAMPUNG",5,160,29,189
https://kawalpemilu.org#22907,"PURWO SARI, PADANG RATU, LAMPUNG TENGAH, LAMPUNG",1,170,53,223
https://kawalpemilu.org#22907,"PURWO SARI, PADANG RATU, LAMPUNG TENGAH, LAMPUNG",2,182,38,220
https://kawalpemilu.org#22907,"PURWO SARI, PADANG RATU, LAMPUNG TENGAH, LAMPUNG",3,156,66,222
https://kawalpemilu.org#22907,"PURWO SARI, PADANG RATU, LAMPUNG TENGAH, LAMPUNG",4,125,107,232
https://kawalpemilu.org#22907,"PURWO SARI, PADANG RATU, LAMPUNG TENGAH, LAMPUNG",5,171,28,199
https://kawalpemilu.org#22907,"PURWO SARI, PADANG RATU, LAMPUNG TENGAH, LAMPUNG",6,167,22,189
https://kawalpemilu.org#22907,"PURWO SARI, PADANG RATU, LAMPUNG TENGAH, LAMPUNG",7,103,44,147
https://kawalpemilu.org#22907,"PURWO SARI, PADANG RATU, LAMPUNG TENGAH, LAMPUNG",8,107,69,176
https://kawalpemilu.org#22907,"PURWO SARI, PADANG RATU, LAMPUNG TENGAH, LAMPUNG",9,156,39,195
https://kawalpemilu.org#22907,"PURWO SARI, PADANG RATU, LAMPUNG TENGAH, LAMPUNG",10,135,40,175
https://kawalpemilu.org#22908,"SENDANG AYU, PADANG RATU, LAMPUNG TENGAH, LAMPUNG",1,157,70,227
https://kawalpemilu.org#22908,"SENDANG AYU, PADANG RATU, LAMPUNG TENGAH, LAMPUNG",2,126,65,191
https://kawalpemilu.org#22908,"SENDANG AYU, PADANG RATU, LAMPUNG TENGAH, LAMPUNG",3,131,54,185
https://kawalpemilu.org#22908,"SENDANG AYU, PADANG RATU, LAMPUNG TENGAH, LAMPUNG",4,181,46,227
https://kawalpemilu.org#22908,"SENDANG AYU, PADANG RATU, LAMPUNG TENGAH, LAMPUNG",6,140,45,185
https://kawalpemilu.org#22908,"SENDANG AYU, PADANG RATU, LAMPUNG TENGAH, LAMPUNG",7,153,49,202
https://kawalpemilu.org#22908,"SENDANG AYU, PADANG RATU, LAMPUNG TENGAH, LAMPUNG",8,29,113,142
https://kawalpemilu.org#22908,"SENDANG AYU, PADANG RATU, LAMPUNG TENGAH, LAMPUNG",9,36,146,182
https://kawalpemilu.org#22908,"SENDANG AYU, PADANG RATU, LAMPUNG TENGAH, LAMPUNG",10,157,75,232
https://kawalpemilu.org#22908,"SENDANG AYU, PADANG RATU, LAMPUNG TENGAH, LAMPUNG",11,137,51,188
https://kawalpemilu.org#22908,"SENDANG AYU, PADANG RATU, LAMPUNG TENGAH, LAMPUNG",12,176,27,203
https://kawalpemilu.org#22908,"SENDANG AYU, PADANG RATU, LAMPUNG TENGAH, LAMPUNG",13,170,59,229
https://kawalpemilu.org#22908,"SENDANG AYU, PADANG RATU, LAMPUNG TENGAH, LAMPUNG",14,166,67,233
https://kawalpemilu.org#22909,"BANDAR SARI, PADANG RATU, LAMPUNG TENGAH, LAMPUNG",1,98,109,207
https://kawalpemilu.org#22909,"BANDAR SARI, PADANG RATU, LAMPUNG TENGAH, LAMPUNG",2,107,86,193
https://kawalpemilu.org#22909,"BANDAR SARI, PADANG RATU, LAMPUNG TENGAH, LAMPUNG",3,158,94,252
https://kawalpemilu.org#22909,"BANDAR SARI, PADANG RATU, LAMPUNG TENGAH, LAMPUNG",4,133,135,268
https://kawalpemilu.org#22909,"BANDAR SARI, PADANG RATU, LAMPUNG TENGAH, LAMPUNG",5,120,104,224
https://kawalpemilu.org#22909,"BANDAR SARI, PADANG RATU, LAMPUNG TENGAH, LAMPUNG",6,96,96,192
https://kawalpemilu.org#22909,"BANDAR SARI, PADANG RATU, LAMPUNG TENGAH, LAMPUNG",7,153,53,206
https://kawalpemilu.org#22909,"BANDAR SARI, PADANG RATU, LAMPUNG TENGAH, LAMPUNG",8,137,84,221
https://kawalpemilu.org#22909,"BANDAR SARI, PADANG RATU, LAMPUNG TENGAH, LAMPUNG",9,98,80,178
https://kawalpemilu.org#22909,"BANDAR SARI, PADANG RATU, LAMPUNG TENGAH, LAMPUNG",10,92,59,151
https://kawalpemilu.org#22909,"BANDAR SARI, PADANG RATU, LAMPUNG TENGAH, LAMPUNG",11,150,77,227
https://kawalpemilu.org#22909,"BANDAR SARI, PADANG RATU, LAMPUNG TENGAH, LAMPUNG",12,104,67,171
https://kawalpemilu.org#22909,"BANDAR SARI, PADANG RATU, LAMPUNG TENGAH, LAMPUNG",13,123,39,162
https://kawalpemilu.org#22909,"BANDAR SARI, PADANG RATU, LAMPUNG TENGAH, LAMPUNG",14,106,74,180
https://kawalpemilu.org#22910,"SURABAYA, PADANG RATU, LAMPUNG TENGAH, LAMPUNG",1,180,27,207
https://kawalpemilu.org#22910,"SURABAYA, PADANG RATU, LAMPUNG TENGAH, LAMPUNG",2,161,46,207
https://kawalpemilu.org#22910,"SURABAYA, PADANG RATU, LAMPUNG TENGAH, LAMPUNG",3,128,49,177
https://kawalpemilu.org#22910,"SURABAYA, PADANG RATU, LAMPUNG TENGAH, LAMPUNG",4,125,30,155
https://kawalpemilu.org#22910,"SURABAYA, PADANG RATU, LAMPUNG TENGAH, LAMPUNG",5,131,63,194
https://kawalpemilu.org#22910,"SURABAYA, PADANG RATU, LAMPUNG TENGAH, LAMPUNG",6,156,53,209
https://kawalpemilu.org#22910,"SURABAYA, PADANG RATU, LAMPUNG TENGAH, LAMPUNG",7,125,46,171
https://kawalpemilu.org#22910,"SURABAYA, PADANG RATU, LAMPUNG TENGAH, LAMPUNG",8,105,53,158
https://kawalpemilu.org#22910,"SURABAYA, PADANG RATU, LAMPUNG TENGAH, LAMPUNG",9,128,69,197
https://kawalpemilu.org#22910,"SURABAYA, PADANG RATU, LAMPUNG TENGAH, LAMPUNG",10,153,44,197
https://kawalpemilu.org#22911,"MARGO REJO, PADANG RATU, LAMPUNG TENGAH, LAMPUNG",1,143,49,192
https://kawalpemilu.org#22911,"MARGO REJO, PADANG RATU, LAMPUNG TENGAH, LAMPUNG",2,133,65,198
https://kawalpemilu.org#22911,"MARGO REJO, PADANG RATU, LAMPUNG TENGAH, LAMPUNG",3,148,46,194
https://kawalpemilu.org#22911,"MARGO REJO, PADANG RATU, LAMPUNG TENGAH, LAMPUNG",4,122,51,173
https://kawalpemilu.org#22911,"MARGO REJO, PADANG RATU, LAMPUNG TENGAH, LAMPUNG",5,90,79,169
https://kawalpemilu.org#22911,"MARGO REJO, PADANG RATU, LAMPUNG TENGAH, LAMPUNG",6,139,82,221
https://kawalpemilu.org#22911,"MARGO REJO, PADANG RATU, LAMPUNG TENGAH, LAMPUNG",7,168,52,220
https://kawalpemilu.org#22911,"MARGO REJO, PADANG RATU, LAMPUNG TENGAH, LAMPUNG",8,145,47,192
https://kawalpemilu.org#22911,"MARGO REJO, PADANG RATU, LAMPUNG TENGAH, LAMPUNG",9,117,45,162
https://kawalpemilu.org#22911,"MARGO REJO, PADANG RATU, LAMPUNG TENGAH, LAMPUNG",10,125,56,181
https://kawalpemilu.org#22911,"MARGO REJO, PADANG RATU, LAMPUNG TENGAH, LAMPUNG",11,96,34,130
https://kawalpemilu.org#22911,"MARGO REJO, PADANG RATU, LAMPUNG TENGAH, LAMPUNG",12,121,73,194
https://kawalpemilu.org#22912,"KOTA BARU, PADANG RATU, LAMPUNG TENGAH, LAMPUNG",1,107,82,189
https://kawalpemilu.org#22912,"KOTA BARU, PADANG RATU, LAMPUNG TENGAH, LAMPUNG",2,136,43,179
https://kawalpemilu.org#22912,"KOTA BARU, PADANG RATU, LAMPUNG TENGAH, LAMPUNG",3,126,59,185
https://kawalpemilu.org#22912,"KOTA BARU, PADANG RATU, LAMPUNG TENGAH, LAMPUNG",4,133,68,201
https://kawalpemilu.org#22912,"KOTA BARU, PADANG RATU, LAMPUNG TENGAH, LAMPUNG",5,101,68,169
https://kawalpemilu.org#22912,"KOTA BARU, PADANG RATU, LAMPUNG TENGAH, LAMPUNG",6,71,80,151
https://kawalpemilu.org#22912,"KOTA BARU, PADANG RATU, LAMPUNG TENGAH, LAMPUNG",7,131,51,182
https://kawalpemilu.org#22912,"KOTA BARU, PADANG RATU, LAMPUNG TENGAH, LAMPUNG",8,121,37,158
https://kawalpemilu.org#22912,"KOTA BARU, PADANG RATU, LAMPUNG TENGAH, LAMPUNG",9,120,57,177
https://kawalpemilu.org#22912,"KOTA BARU, PADANG RATU, LAMPUNG TENGAH, LAMPUNG",10,128,46,174
https://kawalpemilu.org#22912,"KOTA BARU, PADANG RATU, LAMPUNG TENGAH, LAMPUNG",11,123,51,174
https://kawalpemilu.org#22912,"KOTA BARU, PADANG RATU, LAMPUNG TENGAH, LAMPUNG",12,96,56,152
https://kawalpemilu.org#22913,"KARANG TANJUNG, PADANG RATU, LAMPUNG TENGAH, LAMPUNG",1,105,93,198
https://kawalpemilu.org#22913,"KARANG TANJUNG, PADANG RATU, LAMPUNG TENGAH, LAMPUNG",2,105,47,152
https://kawalpemilu.org#22913,"KARANG TANJUNG, PADANG RATU, LAMPUNG TENGAH, LAMPUNG",3,132,57,189
https://kawalpemilu.org#22913,"KARANG TANJUNG, PADANG RATU, LAMPUNG TENGAH, LAMPUNG",4,124,43,167
https://kawalpemilu.org#22913,"KARANG TANJUNG, PADANG RATU, LAMPUNG TENGAH, LAMPUNG",5,104,37,141
https://kawalpemilu.org#22913,"KARANG TANJUNG, PADANG RATU, LAMPUNG TENGAH, LAMPUNG",6,126,55,181
https://kawalpemilu.org#22913,"KARANG TANJUNG, PADANG RATU, LAMPUNG TENGAH, LAMPUNG",7,98,42,140
https://kawalpemilu.org#22913,"KARANG TANJUNG, PADANG RATU, LAMPUNG TENGAH, LAMPUNG",8,111,65,176
https://kawalpemilu.org#22913,"KARANG TANJUNG, PADANG RATU, LAMPUNG TENGAH, LAMPUNG",9,132,52,185
https://kawalpemilu.org#22913,"KARANG TANJUNG, PADANG RATU, LAMPUNG TENGAH, LAMPUNG",10,114,18,132
https://kawalpemilu.org#22914,"KURIPAN, PADANG RATU, LAMPUNG TENGAH, LAMPUNG",1,48,111,6
https://kawalpemilu.org#22914,"KURIPAN, PADANG RATU, LAMPUNG TENGAH, LAMPUNG",2,120,69,189
https://kawalpemilu.org#22914,"KURIPAN, PADANG RATU, LAMPUNG TENGAH, LAMPUNG",3,149,49,198
https://kawalpemilu.org#22914,"KURIPAN, PADANG RATU, LAMPUNG TENGAH, LAMPUNG",4,94,67,161
https://kawalpemilu.org#22914,"KURIPAN, PADANG RATU, LAMPUNG TENGAH, LAMPUNG",5,110,49,159
https://kawalpemilu.org#22914,"KURIPAN, PADANG RATU, LAMPUNG TENGAH, LAMPUNG",6,134,19,153
https://kawalpemilu.org#22914,"KURIPAN, PADANG RATU, LAMPUNG TENGAH, LAMPUNG",7,118,50,168
https://kawalpemilu.org#22914,"KURIPAN, PADANG RATU, LAMPUNG TENGAH, LAMPUNG",8,147,23,170
https://kawalpemilu.org#22914,"KURIPAN, PADANG RATU, LAMPUNG TENGAH, LAMPUNG",9,179,48,227
https://kawalpemilu.org#22914,"KURIPAN, PADANG RATU, LAMPUNG TENGAH, LAMPUNG",10,0,0,0
https://kawalpemilu.org#22914,"KURIPAN, PADANG RATU, LAMPUNG TENGAH, LAMPUNG",11,91,11,102
https://kawalpemilu.org#22914,"KURIPAN, PADANG RATU, LAMPUNG TENGAH, LAMPUNG",12,48,117,165
https://kawalpemilu.org#22914,"KURIPAN, PADANG RATU, LAMPUNG TENGAH, LAMPUNG",13,102,103,205
https://kawalpemilu.org#22914,"KURIPAN, PADANG RATU, LAMPUNG TENGAH, LAMPUNG",14,127,25,152
https://kawalpemilu.org#22914,"KURIPAN, PADANG RATU, LAMPUNG TENGAH, LAMPUNG",15,116,43,159
https://kawalpemilu.org#22914,"KURIPAN, PADANG RATU, LAMPUNG TENGAH, LAMPUNG",16,96,5,101
https://kawalpemilu.org#22915,"SRI AGUNG, PADANG RATU, LAMPUNG TENGAH, LAMPUNG",1,102,85,187
https://kawalpemilu.org#22915,"SRI AGUNG, PADANG RATU, LAMPUNG TENGAH, LAMPUNG",2,120,69,189
https://kawalpemilu.org#22915,"SRI AGUNG, PADANG RATU, LAMPUNG TENGAH, LAMPUNG",3,93,49,142
https://kawalpemilu.org#22915,"SRI AGUNG, PADANG RATU, LAMPUNG TENGAH, LAMPUNG",4,89,35,124
https://kawalpemilu.org#22915,"SRI AGUNG, PADANG RATU, LAMPUNG TENGAH, LAMPUNG",5,105,41,146
https://kawalpemilu.org#22915,"SRI AGUNG, PADANG RATU, LAMPUNG TENGAH, LAMPUNG",6,69,62,131
https://kawalpemilu.org#22915,"SRI AGUNG, PADANG RATU, LAMPUNG TENGAH, LAMPUNG",7,109,52,161
https://kawalpemilu.org#22915,"SRI AGUNG, PADANG RATU, LAMPUNG TENGAH, LAMPUNG",8,99,28,127
https://kawalpemilu.org#22915,"SRI AGUNG, PADANG RATU, LAMPUNG TENGAH, LAMPUNG",9,97,27,124
https://kawalpemilu.org#22916,"HADUYANG RATU, PADANG RATU, LAMPUNG TENGAH, LAMPUNG",1,41,87,128
https://kawalpemilu.org#22916,"HADUYANG RATU, PADANG RATU, LAMPUNG TENGAH, LAMPUNG",2,44,127,171
https://kawalpemilu.org#22916,"HADUYANG RATU, PADANG RATU, LAMPUNG TENGAH, LAMPUNG",3,108,37,145
https://kawalpemilu.org#22916,"HADUYANG RATU, PADANG RATU, LAMPUNG TENGAH, LAMPUNG",4,103,33,136
https://kawalpemilu.org#22916,"HADUYANG RATU, PADANG RATU, LAMPUNG TENGAH, LAMPUNG",5,112,21,133
https://kawalpemilu.org#22916,"HADUYANG RATU, PADANG RATU, LAMPUNG TENGAH, LAMPUNG",6,166,25,191
https://kawalpemilu.org#22916,"HADUYANG RATU, PADANG RATU, LAMPUNG TENGAH, LAMPUNG",7,176,25,201
https://kawalpemilu.org#22916,"HADUYANG RATU, PADANG RATU, LAMPUNG TENGAH, LAMPUNG",8,38,105,143
https://kawalpemilu.org#22916,"HADUYANG RATU, PADANG RATU, LAMPUNG TENGAH, LAMPUNG",9,72,106,178
https://kawalpemilu.org#22916,"HADUYANG RATU, PADANG RATU, LAMPUNG TENGAH, LAMPUNG",10,98,30,128
https://kawalpemilu.org#22916,"HADUYANG RATU, PADANG RATU, LAMPUNG TENGAH, LAMPUNG",11,81,30,111
https://kawalpemilu.org#22916,"HADUYANG RATU, PADANG RATU, LAMPUNG TENGAH, LAMPUNG",12,145,7,152
https://kawalpemilu.org#22917,"PADANG RATU, PADANG RATU, LAMPUNG TENGAH, LAMPUNG",1,183,43,226
https://kawalpemilu.org#22917,"PADANG RATU, PADANG RATU, LAMPUNG TENGAH, LAMPUNG",2,22,123,143
https://kawalpemilu.org#22917,"PADANG RATU, PADANG RATU, LAMPUNG TENGAH, LAMPUNG",3,27,90,117
https://kawalpemilu.org#22917,"PADANG RATU, PADANG RATU, LAMPUNG TENGAH, LAMPUNG",4,55,143,198
https://kawalpemilu.org#22917,"PADANG RATU, PADANG RATU, LAMPUNG TENGAH, LAMPUNG",6,150,48,198
https://kawalpemilu.org#22917,"PADANG RATU, PADANG RATU, LAMPUNG TENGAH, LAMPUNG",7,153,7,160
https://kawalpemilu.org#22917,"PADANG RATU, PADANG RATU, LAMPUNG TENGAH, LAMPUNG",8,52,89,141
https://kawalpemilu.org#22917,"PADANG RATU, PADANG RATU, LAMPUNG TENGAH, LAMPUNG",9,41,57,98
https://kawalpemilu.org#22918,"KARANG SARI, PADANG RATU, LAMPUNG TENGAH, LAMPUNG",1,107,58,165
https://kawalpemilu.org#22918,"KARANG SARI, PADANG RATU, LAMPUNG TENGAH, LAMPUNG",2,102,54,156
https://kawalpemilu.org#22918,"KARANG SARI, PADANG RATU, LAMPUNG TENGAH, LAMPUNG",3,97,61,158
https://kawalpemilu.org#22918,"KARANG SARI, PADANG RATU, LAMPUNG TENGAH, LAMPUNG",4,71,141,212
https://kawalpemilu.org#22918,"KARANG SARI, PADANG RATU, LAMPUNG TENGAH, LAMPUNG",5,112,63,175
https://kawalpemilu.org#22918,"KARANG SARI, PADANG RATU, LAMPUNG TENGAH, LAMPUNG",6,126,40,166
https://kawalpemilu.org#22918,"KARANG SARI, PADANG RATU, LAMPUNG TENGAH, LAMPUNG",7,51,79,130
https://kawalpemilu.org#22919,"MOJO KERTO, PADANG RATU, LAMPUNG TENGAH, LAMPUNG",1,165,57,222
https://kawalpemilu.org#22919,"MOJO KERTO, PADANG RATU, LAMPUNG TENGAH, LAMPUNG",2,150,59,209
https://kawalpemilu.org#22919,"MOJO KERTO, PADANG RATU, LAMPUNG TENGAH, LAMPUNG",3,184,21,205
https://kawalpemilu.org#22919,"MOJO KERTO, PADANG RATU, LAMPUNG TENGAH, LAMPUNG",4,187,20,207
https://kawalpemilu.org#22919,"MOJO KERTO, PADANG RATU, LAMPUNG TENGAH, LAMPUNG",5,101,95,196
https://kawalpemilu.org#22919,"MOJO KERTO, PADANG RATU, LAMPUNG TENGAH, LAMPUNG",6,167,35,202
https://kawalpemilu.org#22919,"MOJO KERTO, PADANG RATU, LAMPUNG TENGAH, LAMPUNG",7,216,13,229
https://kawalpemilu.org#22919,"MOJO KERTO, PADANG RATU, LAMPUNG TENGAH, LAMPUNG",8,165,58,223
https://kawalpemilu.org#22919,"MOJO KERTO, PADANG RATU, LAMPUNG TENGAH, LAMPUNG",9,170,28,198
https://kawalpemilu.org#22920,"SUMBER SARI, PADANG RATU, LAMPUNG TENGAH, LAMPUNG",1,155,68,223
https://kawalpemilu.org#22920,"SUMBER SARI, PADANG RATU, LAMPUNG TENGAH, LAMPUNG",2,121,111,232
https://kawalpemilu.org#22920,"SUMBER SARI, PADANG RATU, LAMPUNG TENGAH, LAMPUNG",3,127,87,214
https://kawalpemilu.org#91290,"PURWOREJO, PADANG RATU, LAMPUNG TENGAH, LAMPUNG",1,116,119,235
https://kawalpemilu.org#91290,"PURWOREJO, PADANG RATU, LAMPUNG TENGAH, LAMPUNG",2,85,86,171
https://kawalpemilu.org#91290,"PURWOREJO, PADANG RATU, LAMPUNG TENGAH, LAMPUNG",3,196,43,239
https://kawalpemilu.org#91290,"PURWOREJO, PADANG RATU, LAMPUNG TENGAH, LAMPUNG",4,100,118,218
https://kawalpemilu.org#91290,"PURWOREJO, PADANG RATU, LAMPUNG TENGAH, LAMPUNG",5,70,74,144
https://kawalpemilu.org#91290,"PURWOREJO, PADANG RATU, LAMPUNG TENGAH, LAMPUNG",6,90,35,125
https://kawalpemilu.org#91290,"PURWOREJO, PADANG RATU, LAMPUNG TENGAH, LAMPUNG",7,154,46,200
https://kawalpemilu.org#91290,"PURWOREJO, PADANG RATU, LAMPUNG TENGAH, LAMPUNG",8,80,58,138
https://kawalpemilu.org#91290,"PURWOREJO, PADANG RATU, LAMPUNG TENGAH, LAMPUNG",9,54,119,173
https://kawalpemilu.org#22922,"GUNUNG SUGIH, GUNUNG SUGIH, LAMPUNG TENGAH, LAMPUNG",1,22,83,105
https://kawalpemilu.org#22922,"GUNUNG SUGIH, GUNUNG SUGIH, LAMPUNG TENGAH, LAMPUNG",2,28,161,189
https://kawalpemilu.org#22922,"GUNUNG SUGIH, GUNUNG SUGIH, LAMPUNG TENGAH, LAMPUNG",3,42,195,237
https://kawalpemilu.org#22922,"GUNUNG SUGIH, GUNUNG SUGIH, LAMPUNG TENGAH, LAMPUNG",4,54,150,204
https://kawalpemilu.org#22922,"GUNUNG SUGIH, GUNUNG SUGIH, LAMPUNG TENGAH, LAMPUNG",5,94,119,213
https://kawalpemilu.org#22922,"GUNUNG SUGIH, GUNUNG SUGIH, LAMPUNG TENGAH, LAMPUNG",6,131,76,207
https://kawalpemilu.org#22922,"GUNUNG SUGIH, GUNUNG SUGIH, LAMPUNG TENGAH, LAMPUNG",7,129,57,186
https://kawalpemilu.org#22922,"GUNUNG SUGIH, GUNUNG SUGIH, LAMPUNG TENGAH, LAMPUNG",8,134,38,172
https://kawalpemilu.org#22922,"GUNUNG SUGIH, GUNUNG SUGIH, LAMPUNG TENGAH, LAMPUNG",9,127,49,176
https://kawalpemilu.org#22922,"GUNUNG SUGIH, GUNUNG SUGIH, LAMPUNG TENGAH, LAMPUNG",10,36,134,170
https://kawalpemilu.org#22922,"GUNUNG SUGIH, GUNUNG SUGIH, LAMPUNG TENGAH, LAMPUNG",11,98,174,272
https://kawalpemilu.org#22922,"GUNUNG SUGIH, GUNUNG SUGIH, LAMPUNG TENGAH, LAMPUNG",12,132,72,204
https://kawalpemilu.org#22922,"GUNUNG SUGIH, GUNUNG SUGIH, LAMPUNG TENGAH, LAMPUNG",13,80,72,152
https://kawalpemilu.org#22922,"GUNUNG SUGIH, GUNUNG SUGIH, LAMPUNG TENGAH, LAMPUNG",14,92,20,112
https://kawalpemilu.org#22922,"GUNUNG SUGIH, GUNUNG SUGIH, LAMPUNG TENGAH, LAMPUNG",15,93,34,127
https://kawalpemilu.org#22923,"GUNUNG S. RAYA, GUNUNG SUGIH, LAMPUNG TENGAH, LAMPUNG",1,41,167,208
https://kawalpemilu.org#22923,"GUNUNG S. RAYA, GUNUNG SUGIH, LAMPUNG TENGAH, LAMPUNG",2,77,151,228
https://kawalpemilu.org#22923,"GUNUNG S. RAYA, GUNUNG SUGIH, LAMPUNG TENGAH, LAMPUNG",3,120,94,214
https://kawalpemilu.org#22923,"GUNUNG S. RAYA, GUNUNG SUGIH, LAMPUNG TENGAH, LAMPUNG",4,78,102,180
https://kawalpemilu.org#22923,"GUNUNG S. RAYA, GUNUNG SUGIH, LAMPUNG TENGAH, LAMPUNG",5,105,156,261
https://kawalpemilu.org#22923,"GUNUNG S. RAYA, GUNUNG SUGIH, LAMPUNG TENGAH, LAMPUNG",6,137,106,243
https://kawalpemilu.org#22923,"GUNUNG S. RAYA, GUNUNG SUGIH, LAMPUNG TENGAH, LAMPUNG",7,113,83,196
https://kawalpemilu.org#22923,"GUNUNG S. RAYA, GUNUNG SUGIH, LAMPUNG TENGAH, LAMPUNG",8,128,53,181
https://kawalpemilu.org#22923,"GUNUNG S. RAYA, GUNUNG SUGIH, LAMPUNG TENGAH, LAMPUNG",9,168,41,209
https://kawalpemilu.org#22923,"GUNUNG S. RAYA, GUNUNG SUGIH, LAMPUNG TENGAH, LAMPUNG",10,148,73,221
https://kawalpemilu.org#22923,"GUNUNG S. RAYA, GUNUNG SUGIH, LAMPUNG TENGAH, LAMPUNG",11,69,113,182
https://kawalpemilu.org#22923,"GUNUNG S. RAYA, GUNUNG SUGIH, LAMPUNG TENGAH, LAMPUNG",12,56,131,187
https://kawalpemilu.org#22923,"GUNUNG S. RAYA, GUNUNG SUGIH, LAMPUNG TENGAH, LAMPUNG",13,137,95,232
https://kawalpemilu.org#22923,"GUNUNG S. RAYA, GUNUNG SUGIH, LAMPUNG TENGAH, LAMPUNG",14,161,50,211
https://kawalpemilu.org#22923,"GUNUNG S. RAYA, GUNUNG SUGIH, LAMPUNG TENGAH, LAMPUNG",15,90,48,138
https://kawalpemilu.org#22924,"KOMERING AGUNG, GUNUNG SUGIH, LAMPUNG TENGAH, LAMPUNG",1,46,124,170
https://kawalpemilu.org#22924,"KOMERING AGUNG, GUNUNG SUGIH, LAMPUNG TENGAH, LAMPUNG",2,38,160,198
https://kawalpemilu.org#22924,"KOMERING AGUNG, GUNUNG SUGIH, LAMPUNG TENGAH, LAMPUNG",3,55,185,240
https://kawalpemilu.org#22924,"KOMERING AGUNG, GUNUNG SUGIH, LAMPUNG TENGAH, LAMPUNG",4,137,102,239
https://kawalpemilu.org#22924,"KOMERING AGUNG, GUNUNG SUGIH, LAMPUNG TENGAH, LAMPUNG",5,144,62,206
https://kawalpemilu.org#22924,"KOMERING AGUNG, GUNUNG SUGIH, LAMPUNG TENGAH, LAMPUNG",6,129,73,202
https://kawalpemilu.org#22924,"KOMERING AGUNG, GUNUNG SUGIH, LAMPUNG TENGAH, LAMPUNG",7,116,42,158
https://kawalpemilu.org#22924,"KOMERING AGUNG, GUNUNG SUGIH, LAMPUNG TENGAH, LAMPUNG",8,49,95,143
https://kawalpemilu.org#22924,"KOMERING AGUNG, GUNUNG SUGIH, LAMPUNG TENGAH, LAMPUNG",9,28,148,176
https://kawalpemilu.org#22924,"KOMERING AGUNG, GUNUNG SUGIH, LAMPUNG TENGAH, LAMPUNG",10,51,162,213
https://kawalpemilu.org#22924,"KOMERING AGUNG, GUNUNG SUGIH, LAMPUNG TENGAH, LAMPUNG",11,70,48,118
https://kawalpemilu.org#22924,"KOMERING AGUNG, GUNUNG SUGIH, LAMPUNG TENGAH, LAMPUNG",12,78,65,143
https://kawalpemilu.org#22925,"SEPUTIH JAYA, GUNUNG SUGIH, LAMPUNG TENGAH, LAMPUNG",1,105,102,207
https://kawalpemilu.org#22925,"SEPUTIH JAYA, GUNUNG SUGIH, LAMPUNG TENGAH, LAMPUNG",3,137,88,225
https://kawalpemilu.org#22925,"SEPUTIH JAYA, GUNUNG SUGIH, LAMPUNG TENGAH, LAMPUNG",4,74,65,139
https://kawalpemilu.org#22925,"SEPUTIH JAYA, GUNUNG SUGIH, LAMPUNG TENGAH, LAMPUNG",5,91,117,208
https://kawalpemilu.org#22925,"SEPUTIH JAYA, GUNUNG SUGIH, LAMPUNG TENGAH, LAMPUNG",6,82,176,258
https://kawalpemilu.org#22925,"SEPUTIH JAYA, GUNUNG SUGIH, LAMPUNG TENGAH, LAMPUNG",7,25,132,157
https://kawalpemilu.org#22925,"SEPUTIH JAYA, GUNUNG SUGIH, LAMPUNG TENGAH, LAMPUNG",8,33,130,163
https://kawalpemilu.org#22925,"SEPUTIH JAYA, GUNUNG SUGIH, LAMPUNG TENGAH, LAMPUNG",9,82,113,195
https://kawalpemilu.org#22925,"SEPUTIH JAYA, GUNUNG SUGIH, LAMPUNG TENGAH, LAMPUNG",10,183,23,206
https://kawalpemilu.org#22925,"SEPUTIH JAYA, GUNUNG SUGIH, LAMPUNG TENGAH, LAMPUNG",11,166,45,211
https://kawalpemilu.org#22925,"SEPUTIH JAYA, GUNUNG SUGIH, LAMPUNG TENGAH, LAMPUNG",12,179,36,215
https://kawalpemilu.org#22925,"SEPUTIH JAYA, GUNUNG SUGIH, LAMPUNG TENGAH, LAMPUNG",13,65,123,188
https://kawalpemilu.org#22925,"SEPUTIH JAYA, GUNUNG SUGIH, LAMPUNG TENGAH, LAMPUNG",14,42,112,154
https://kawalpemilu.org#22925,"SEPUTIH JAYA, GUNUNG SUGIH, LAMPUNG TENGAH, LAMPUNG",15,25,33,58
https://kawalpemilu.org#22926,"TERBANGGI SUBING, GUNUNG SUGIH, LAMPUNG TENGAH, LAMPUNG",1,73,170,243
https://kawalpemilu.org#22926,"TERBANGGI SUBING, GUNUNG SUGIH, LAMPUNG TENGAH, LAMPUNG",2,152,65,217
https://kawalpemilu.org#22926,"TERBANGGI SUBING, GUNUNG SUGIH, LAMPUNG TENGAH, LAMPUNG",3,117,61,178
https://kawalpemilu.org#22926,"TERBANGGI SUBING, GUNUNG SUGIH, LAMPUNG TENGAH, LAMPUNG",4,197,42,239
https://kawalpemilu.org#22926,"TERBANGGI SUBING, GUNUNG SUGIH, LAMPUNG TENGAH, LAMPUNG",5,150,77,227
https://kawalpemilu.org#22926,"TERBANGGI SUBING, GUNUNG SUGIH, LAMPUNG TENGAH, LAMPUNG",6,157,80,237
https://kawalpemilu.org#22926,"TERBANGGI SUBING, GUNUNG SUGIH, LAMPUNG TENGAH, LAMPUNG",7,165,60,225
https://kawalpemilu.org#22926,"TERBANGGI SUBING, GUNUNG SUGIH, LAMPUNG TENGAH, LAMPUNG",8,127,88,215
https://kawalpemilu.org#22926,"TERBANGGI SUBING, GUNUNG SUGIH, LAMPUNG TENGAH, LAMPUNG",9,132,61,193
https://kawalpemilu.org#22926,"TERBANGGI SUBING, GUNUNG SUGIH, LAMPUNG TENGAH, LAMPUNG",10,146,66,212
https://kawalpemilu.org#22926,"TERBANGGI SUBING, GUNUNG SUGIH, LAMPUNG TENGAH, LAMPUNG",11,108,88,196
https://kawalpemilu.org#22926,"TERBANGGI SUBING, GUNUNG SUGIH, LAMPUNG TENGAH, LAMPUNG",12,124,76,200
https://kawalpemilu.org#22926,"TERBANGGI SUBING, GUNUNG SUGIH, LAMPUNG TENGAH, LAMPUNG",13,164,41,205
https://kawalpemilu.org#22926,"TERBANGGI SUBING, GUNUNG SUGIH, LAMPUNG TENGAH, LAMPUNG",14,177,46,223
https://kawalpemilu.org#22926,"TERBANGGI SUBING, GUNUNG SUGIH, LAMPUNG TENGAH, LAMPUNG",15,143,32,175
https://kawalpemilu.org#22926,"TERBANGGI SUBING, GUNUNG SUGIH, LAMPUNG TENGAH, LAMPUNG",16,131,74,205
https://kawalpemilu.org#22926,"TERBANGGI SUBING, GUNUNG SUGIH, LAMPUNG TENGAH, LAMPUNG",17,128,64,192
https://kawalpemilu.org#22926,"TERBANGGI SUBING, GUNUNG SUGIH, LAMPUNG TENGAH, LAMPUNG",18,134,72,206
https://kawalpemilu.org#22927,"TERBANGGI AGUNG, GUNUNG SUGIH, LAMPUNG TENGAH, LAMPUNG",1,19,199,218
https://kawalpemilu.org#22927,"TERBANGGI AGUNG, GUNUNG SUGIH, LAMPUNG TENGAH, LAMPUNG",2,25,187,212
https://kawalpemilu.org#22927,"TERBANGGI AGUNG, GUNUNG SUGIH, LAMPUNG TENGAH, LAMPUNG",3,18,191,209
https://kawalpemilu.org#22927,"TERBANGGI AGUNG, GUNUNG SUGIH, LAMPUNG TENGAH, LAMPUNG",4,77,63,140
https://kawalpemilu.org#22927,"TERBANGGI AGUNG, GUNUNG SUGIH, LAMPUNG TENGAH, LAMPUNG",5,196,47,243
https://kawalpemilu.org#22927,"TERBANGGI AGUNG, GUNUNG SUGIH, LAMPUNG TENGAH, LAMPUNG",6,91,117,208
https://kawalpemilu.org#22927,"TERBANGGI AGUNG, GUNUNG SUGIH, LAMPUNG TENGAH, LAMPUNG",7,176,48,224
https://kawalpemilu.org#22927,"TERBANGGI AGUNG, GUNUNG SUGIH, LAMPUNG TENGAH, LAMPUNG",8,83,75,158
https://kawalpemilu.org#22927,"TERBANGGI AGUNG, GUNUNG SUGIH, LAMPUNG TENGAH, LAMPUNG",9,89,68,157
https://kawalpemilu.org#22927,"TERBANGGI AGUNG, GUNUNG SUGIH, LAMPUNG TENGAH, LAMPUNG",10,82,77,159
https://kawalpemilu.org#22927,"TERBANGGI AGUNG, GUNUNG SUGIH, LAMPUNG TENGAH, LAMPUNG",11,86,85,171
https://kawalpemilu.org#22927,"TERBANGGI AGUNG, GUNUNG SUGIH, LAMPUNG TENGAH, LAMPUNG",12,146,86,232
https://kawalpemilu.org#22927,"TERBANGGI AGUNG, GUNUNG SUGIH, LAMPUNG TENGAH, LAMPUNG",13,54,66,120
https://kawalpemilu.org#22928,"FAJAR BULAN, GUNUNG SUGIH, LAMPUNG TENGAH, LAMPUNG",1,76,117,193
https://kawalpemilu.org#22928,"FAJAR BULAN, GUNUNG SUGIH, LAMPUNG TENGAH, LAMPUNG",2,54,107,161
https://kawalpemilu.org#22928,"FAJAR BULAN, GUNUNG SUGIH, LAMPUNG TENGAH, LAMPUNG",3,56,141,197
https://kawalpemilu.org#22928,"FAJAR BULAN, GUNUNG SUGIH, LAMPUNG TENGAH, LAMPUNG",4,28,112,140
https://kawalpemilu.org#22928,"FAJAR BULAN, GUNUNG SUGIH, LAMPUNG TENGAH, LAMPUNG",5,42,138,180
https://kawalpemilu.org#22928,"FAJAR BULAN, GUNUNG SUGIH, LAMPUNG TENGAH, LAMPUNG",6,77,96,173
https://kawalpemilu.org#22928,"FAJAR BULAN, GUNUNG SUGIH, LAMPUNG TENGAH, LAMPUNG",7,100,68,168
https://kawalpemilu.org#22928,"FAJAR BULAN, GUNUNG SUGIH, LAMPUNG TENGAH, LAMPUNG",8,119,76,195
https://kawalpemilu.org#22928,"FAJAR BULAN, GUNUNG SUGIH, LAMPUNG TENGAH, LAMPUNG",9,118,107,225
https://kawalpemilu.org#22928,"FAJAR BULAN, GUNUNG SUGIH, LAMPUNG TENGAH, LAMPUNG",10,123,66,189
https://kawalpemilu.org#22928,"FAJAR BULAN, GUNUNG SUGIH, LAMPUNG TENGAH, LAMPUNG",11,149,98,247
https://kawalpemilu.org#22928,"FAJAR BULAN, GUNUNG SUGIH, LAMPUNG TENGAH, LAMPUNG",12,144,79,223
https://kawalpemilu.org#22928,"FAJAR BULAN, GUNUNG SUGIH, LAMPUNG TENGAH, LAMPUNG",13,142,55,197
https://kawalpemilu.org#22928,"FAJAR BULAN, GUNUNG SUGIH, LAMPUNG TENGAH, LAMPUNG",14,198,27,225
https://kawalpemilu.org#22928,"FAJAR BULAN, GUNUNG SUGIH, LAMPUNG TENGAH, LAMPUNG",15,125,28,153
https://kawalpemilu.org#22928,"FAJAR BULAN, GUNUNG SUGIH, LAMPUNG TENGAH, LAMPUNG",16,165,51,216
https://kawalpemilu.org#22928,"FAJAR BULAN, GUNUNG SUGIH, LAMPUNG TENGAH, LAMPUNG",17,160,52,212
https://kawalpemilu.org#22929,"KOMERING PUTIH, GUNUNG SUGIH, LAMPUNG TENGAH, LAMPUNG",1,14,115,129
https://kawalpemilu.org#22929,"KOMERING PUTIH, GUNUNG SUGIH, LAMPUNG TENGAH, LAMPUNG",2,31,198,229
https://kawalpemilu.org#22929,"KOMERING PUTIH, GUNUNG SUGIH, LAMPUNG TENGAH, LAMPUNG",3,44,149,193
https://kawalpemilu.org#22929,"KOMERING PUTIH, GUNUNG SUGIH, LAMPUNG TENGAH, LAMPUNG",4,41,160,201
https://kawalpemilu.org#22929,"KOMERING PUTIH, GUNUNG SUGIH, LAMPUNG TENGAH, LAMPUNG",5,182,75,257
https://kawalpemilu.org#22929,"KOMERING PUTIH, GUNUNG SUGIH, LAMPUNG TENGAH, LAMPUNG",6,202,58,260
https://kawalpemilu.org#22929,"KOMERING PUTIH, GUNUNG SUGIH, LAMPUNG TENGAH, LAMPUNG",7,90,132,222
https://kawalpemilu.org#22929,"KOMERING PUTIH, GUNUNG SUGIH, LAMPUNG TENGAH, LAMPUNG",8,54,152,206
https://kawalpemilu.org#22929,"KOMERING PUTIH, GUNUNG SUGIH, LAMPUNG TENGAH, LAMPUNG",9,131,106,237
https://kawalpemilu.org#22929,"KOMERING PUTIH, GUNUNG SUGIH, LAMPUNG TENGAH, LAMPUNG",10,140,59,199
https://kawalpemilu.org#22929,"KOMERING PUTIH, GUNUNG SUGIH, LAMPUNG TENGAH, LAMPUNG",11,63,170,233
https://kawalpemilu.org#22929,"KOMERING PUTIH, GUNUNG SUGIH, LAMPUNG TENGAH, LAMPUNG",12,121,108,229
https://kawalpemilu.org#22929,"KOMERING PUTIH, GUNUNG SUGIH, LAMPUNG TENGAH, LAMPUNG",13,115,122,237
https://kawalpemilu.org#22929,"KOMERING PUTIH, GUNUNG SUGIH, LAMPUNG TENGAH, LAMPUNG",14,71,65,136
https://kawalpemilu.org#22930,"BUYUT UDIK, GUNUNG SUGIH, LAMPUNG TENGAH, LAMPUNG",1,79,156,235
https://kawalpemilu.org#22930,"BUYUT UDIK, GUNUNG SUGIH, LAMPUNG TENGAH, LAMPUNG",2,35,154,189
https://kawalpemilu.org#22930,"BUYUT UDIK, GUNUNG SUGIH, LAMPUNG TENGAH, LAMPUNG",3,91,147,238
https://kawalpemilu.org#22930,"BUYUT UDIK, GUNUNG SUGIH, LAMPUNG TENGAH, LAMPUNG",4,113,123,236
https://kawalpemilu.org#22930,"BUYUT UDIK, GUNUNG SUGIH, LAMPUNG TENGAH, LAMPUNG",5,9,40,49
https://kawalpemilu.org#22930,"BUYUT UDIK, GUNUNG SUGIH, LAMPUNG TENGAH, LAMPUNG",6,13,49,62
https://kawalpemilu.org#22930,"BUYUT UDIK, GUNUNG SUGIH, LAMPUNG TENGAH, LAMPUNG",7,165,45,210
https://kawalpemilu.org#22930,"BUYUT UDIK, GUNUNG SUGIH, LAMPUNG TENGAH, LAMPUNG",8,117,47,164
https://kawalpemilu.org#22930,"BUYUT UDIK, GUNUNG SUGIH, LAMPUNG TENGAH, LAMPUNG",9,157,71,228
https://kawalpemilu.org#22930,"BUYUT UDIK, GUNUNG SUGIH, LAMPUNG TENGAH, LAMPUNG",10,182,56,238
https://kawalpemilu.org#22930,"BUYUT UDIK, GUNUNG SUGIH, LAMPUNG TENGAH, LAMPUNG",11,64,124,188
https://kawalpemilu.org#22930,"BUYUT UDIK, GUNUNG SUGIH, LAMPUNG TENGAH, LAMPUNG",12,176,44,220
https://kawalpemilu.org#22930,"BUYUT UDIK, GUNUNG SUGIH, LAMPUNG TENGAH, LAMPUNG",13,155,53,208
https://kawalpemilu.org#22930,"BUYUT UDIK, GUNUNG SUGIH, LAMPUNG TENGAH, LAMPUNG",14,187,55,242
https://kawalpemilu.org#22931,"BUYUT ILIR, GUNUNG SUGIH, LAMPUNG TENGAH, LAMPUNG",1,41,217,258
https://kawalpemilu.org#22931,"BUYUT ILIR, GUNUNG SUGIH, LAMPUNG TENGAH, LAMPUNG",2,76,169,245
https://kawalpemilu.org#22931,"BUYUT ILIR, GUNUNG SUGIH, LAMPUNG TENGAH, LAMPUNG",3,140,60,200
https://kawalpemilu.org#22931,"BUYUT ILIR, GUNUNG SUGIH, LAMPUNG TENGAH, LAMPUNG",4,130,71,201
https://kawalpemilu.org#22931,"BUYUT ILIR, GUNUNG SUGIH, LAMPUNG TENGAH, LAMPUNG",5,229,26,255
https://kawalpemilu.org#22931,"BUYUT ILIR, GUNUNG SUGIH, LAMPUNG TENGAH, LAMPUNG",6,187,26,213
https://kawalpemilu.org#22931,"BUYUT ILIR, GUNUNG SUGIH, LAMPUNG TENGAH, LAMPUNG",7,116,71,187
https://kawalpemilu.org#22931,"BUYUT ILIR, GUNUNG SUGIH, LAMPUNG TENGAH, LAMPUNG",8,117,84,201
https://kawalpemilu.org#22931,"BUYUT ILIR, GUNUNG SUGIH, LAMPUNG TENGAH, LAMPUNG",9,149,66,215
https://kawalpemilu.org#22931,"BUYUT ILIR, GUNUNG SUGIH, LAMPUNG TENGAH, LAMPUNG",10,120,84,204
https://kawalpemilu.org#22931,"BUYUT ILIR, GUNUNG SUGIH, LAMPUNG TENGAH, LAMPUNG",11,103,90,193
https://kawalpemilu.org#22931,"BUYUT ILIR, GUNUNG SUGIH, LAMPUNG TENGAH, LAMPUNG",12,48,205,253
https://kawalpemilu.org#22931,"BUYUT ILIR, GUNUNG SUGIH, LAMPUNG TENGAH, LAMPUNG",13,142,33,175
https://kawalpemilu.org#22931,"BUYUT ILIR, GUNUNG SUGIH, LAMPUNG TENGAH, LAMPUNG",14,145,67,212
https://kawalpemilu.org#22931,"BUYUT ILIR, GUNUNG SUGIH, LAMPUNG TENGAH, LAMPUNG",15,127,80,207
https://kawalpemilu.org#22931,"BUYUT ILIR, GUNUNG SUGIH, LAMPUNG TENGAH, LAMPUNG",16,139,70,209
https://kawalpemilu.org#22931,"BUYUT ILIR, GUNUNG SUGIH, LAMPUNG TENGAH, LAMPUNG",17,106,90,196
https://kawalpemilu.org#22932,"BANGUN REJO, GUNUNG SUGIH, LAMPUNG TENGAH, LAMPUNG",1,137,62,199
https://kawalpemilu.org#22932,"BANGUN REJO, GUNUNG SUGIH, LAMPUNG TENGAH, LAMPUNG",2,166,60,226
https://kawalpemilu.org#22932,"BANGUN REJO, GUNUNG SUGIH, LAMPUNG TENGAH, LAMPUNG",3,122,68,190
https://kawalpemilu.org#22932,"BANGUN REJO, GUNUNG SUGIH, LAMPUNG TENGAH, LAMPUNG",4,161,74,235
https://kawalpemilu.org#22932,"BANGUN REJO, GUNUNG SUGIH, LAMPUNG TENGAH, LAMPUNG",5,153,63,216
https://kawalpemilu.org#22932,"BANGUN REJO, GUNUNG SUGIH, LAMPUNG TENGAH, LAMPUNG",6,143,62,205
https://kawalpemilu.org#22932,"BANGUN REJO, GUNUNG SUGIH, LAMPUNG TENGAH, LAMPUNG",7,128,59,187
https://kawalpemilu.org#22932,"BANGUN REJO, GUNUNG SUGIH, LAMPUNG TENGAH, LAMPUNG",8,128,57,185
https://kawalpemilu.org#22932,"BANGUN REJO, GUNUNG SUGIH, LAMPUNG TENGAH, LAMPUNG",9,120,90,210
https://kawalpemilu.org#22932,"BANGUN REJO, GUNUNG SUGIH, LAMPUNG TENGAH, LAMPUNG",10,129,101,230
https://kawalpemilu.org#22932,"BANGUN REJO, GUNUNG SUGIH, LAMPUNG TENGAH, LAMPUNG",11,144,71,215
https://kawalpemilu.org#22932,"BANGUN REJO, GUNUNG SUGIH, LAMPUNG TENGAH, LAMPUNG",12,160,83,243
https://kawalpemilu.org#22933,"WONOSARI, GUNUNG SUGIH, LAMPUNG TENGAH, LAMPUNG",1,157,41,198
https://kawalpemilu.org#22933,"WONOSARI, GUNUNG SUGIH, LAMPUNG TENGAH, LAMPUNG",2,168,52,220
https://kawalpemilu.org#22933,"WONOSARI, GUNUNG SUGIH, LAMPUNG TENGAH, LAMPUNG",3,139,66,205
https://kawalpemilu.org#22933,"WONOSARI, GUNUNG SUGIH, LAMPUNG TENGAH, LAMPUNG",4,161,56,217
https://kawalpemilu.org#22933,"WONOSARI, GUNUNG SUGIH, LAMPUNG TENGAH, LAMPUNG",5,117,44,161
https://kawalpemilu.org#22934,"PUTRA BUYUT, GUNUNG SUGIH, LAMPUNG TENGAH, LAMPUNG",1,148,62,210
https://kawalpemilu.org#22934,"PUTRA BUYUT, GUNUNG SUGIH, LAMPUNG TENGAH, LAMPUNG",2,150,62,212
https://kawalpemilu.org#22934,"PUTRA BUYUT, GUNUNG SUGIH, LAMPUNG TENGAH, LAMPUNG",3,117,98,215
https://kawalpemilu.org#22934,"PUTRA BUYUT, GUNUNG SUGIH, LAMPUNG TENGAH, LAMPUNG",4,88,67,155
https://kawalpemilu.org#22934,"PUTRA BUYUT, GUNUNG SUGIH, LAMPUNG TENGAH, LAMPUNG",5,161,22,183
https://kawalpemilu.org#22934,"PUTRA BUYUT, GUNUNG SUGIH, LAMPUNG TENGAH, LAMPUNG",6,190,25,215
https://kawalpemilu.org#22934,"PUTRA BUYUT, GUNUNG SUGIH, LAMPUNG TENGAH, LAMPUNG",7,188,30,218
https://kawalpemilu.org#22934,"PUTRA BUYUT, GUNUNG SUGIH, LAMPUNG TENGAH, LAMPUNG",8,98,94,192
https://kawalpemilu.org#22934,"PUTRA BUYUT, GUNUNG SUGIH, LAMPUNG TENGAH, LAMPUNG",9,188,33,221
https://kawalpemilu.org#22934,"PUTRA BUYUT, GUNUNG SUGIH, LAMPUNG TENGAH, LAMPUNG",10,181,28,209
https://kawalpemilu.org#22935,"GUNUNG SARI, GUNUNG SUGIH, LAMPUNG TENGAH, LAMPUNG",1,202,51,253
https://kawalpemilu.org#22935,"GUNUNG SARI, GUNUNG SUGIH, LAMPUNG TENGAH, LAMPUNG",2,176,36,212
https://kawalpemilu.org#22935,"GUNUNG SARI, GUNUNG SUGIH, LAMPUNG TENGAH, LAMPUNG",3,165,34,199
https://kawalpemilu.org#22935,"GUNUNG SARI, GUNUNG SUGIH, LAMPUNG TENGAH, LAMPUNG",4,126,88,214
https://kawalpemilu.org#22935,"GUNUNG SARI, GUNUNG SUGIH, LAMPUNG TENGAH, LAMPUNG",5,217,35,252
https://kawalpemilu.org#22935,"GUNUNG SARI, GUNUNG SUGIH, LAMPUNG TENGAH, LAMPUNG",6,149,26,175
https://kawalpemilu.org#22935,"GUNUNG SARI, GUNUNG SUGIH, LAMPUNG TENGAH, LAMPUNG",7,114,24,138
https://kawalpemilu.org#22935,"GUNUNG SARI, GUNUNG SUGIH, LAMPUNG TENGAH, LAMPUNG",8,170,36,206
https://kawalpemilu.org#22935,"GUNUNG SARI, GUNUNG SUGIH, LAMPUNG TENGAH, LAMPUNG",9,127,44,171
https://kawalpemilu.org#22935,"GUNUNG SARI, GUNUNG SUGIH, LAMPUNG TENGAH, LAMPUNG",10,175,21,196
https://kawalpemilu.org#22935,"GUNUNG SARI, GUNUNG SUGIH, LAMPUNG TENGAH, LAMPUNG",11,0,0,0
https://kawalpemilu.org#22935,"GUNUNG SARI, GUNUNG SUGIH, LAMPUNG TENGAH, LAMPUNG",12,162,55,217
https://kawalpemilu.org#22936,"BUYUT UTARA, GUNUNG SUGIH, LAMPUNG TENGAH, LAMPUNG",1,144,53,197
https://kawalpemilu.org#22936,"BUYUT UTARA, GUNUNG SUGIH, LAMPUNG TENGAH, LAMPUNG",2,123,84,207
https://kawalpemilu.org#22936,"BUYUT UTARA, GUNUNG SUGIH, LAMPUNG TENGAH, LAMPUNG",3,139,66,205
https://kawalpemilu.org#22936,"BUYUT UTARA, GUNUNG SUGIH, LAMPUNG TENGAH, LAMPUNG",4,151,86,237
https://kawalpemilu.org#22936,"BUYUT UTARA, GUNUNG SUGIH, LAMPUNG TENGAH, LAMPUNG",5,165,57,222
https://kawalpemilu.org#22936,"BUYUT UTARA, GUNUNG SUGIH, LAMPUNG TENGAH, LAMPUNG",6,166,45,211
https://kawalpemilu.org#22936,"BUYUT UTARA, GUNUNG SUGIH, LAMPUNG TENGAH, LAMPUNG",7,136,57,193
https://kawalpemilu.org#22936,"BUYUT UTARA, GUNUNG SUGIH, LAMPUNG TENGAH, LAMPUNG",8,170,15,185
https://kawalpemilu.org#22936,"BUYUT UTARA, GUNUNG SUGIH, LAMPUNG TENGAH, LAMPUNG",9,93,6,99
https://kawalpemilu.org#22936,"BUYUT UTARA, GUNUNG SUGIH, LAMPUNG TENGAH, LAMPUNG",10,114,17,131
https://kawalpemilu.org#22938,"ADI PURO, TRIMURJO, LAMPUNG TENGAH, LAMPUNG",1,152,46,198
https://kawalpemilu.org#22938,"ADI PURO, TRIMURJO, LAMPUNG TENGAH, LAMPUNG",2,109,73,182
https://kawalpemilu.org#22938,"ADI PURO, TRIMURJO, LAMPUNG TENGAH, LAMPUNG",3,91,134,225
https://kawalpemilu.org#22938,"ADI PURO, TRIMURJO, LAMPUNG TENGAH, LAMPUNG",4,124,110,234
https://kawalpemilu.org#22938,"ADI PURO, TRIMURJO, LAMPUNG TENGAH, LAMPUNG",5,190,27,217
https://kawalpemilu.org#22938,"ADI PURO, TRIMURJO, LAMPUNG TENGAH, LAMPUNG",6,92,117,209
https://kawalpemilu.org#22938,"ADI PURO, TRIMURJO, LAMPUNG TENGAH, LAMPUNG",7,138,59,197
https://kawalpemilu.org#22938,"ADI PURO, TRIMURJO, LAMPUNG TENGAH, LAMPUNG",8,142,46,188
https://kawalpemilu.org#22938,"ADI PURO, TRIMURJO, LAMPUNG TENGAH, LAMPUNG",9,143,42,185
https://kawalpemilu.org#22938,"ADI PURO, TRIMURJO, LAMPUNG TENGAH, LAMPUNG",10,112,67,179
https://kawalpemilu.org#22938,"ADI PURO, TRIMURJO, LAMPUNG TENGAH, LAMPUNG",11,66,155,221
https://kawalpemilu.org#22938,"ADI PURO, TRIMURJO, LAMPUNG TENGAH, LAMPUNG",12,117,87,204
https://kawalpemilu.org#22938,"ADI PURO, TRIMURJO, LAMPUNG TENGAH, LAMPUNG",13,80,39,119
https://kawalpemilu.org#22938,"ADI PURO, TRIMURJO, LAMPUNG TENGAH, LAMPUNG",14,70,67,137
https://kawalpemilu.org#22938,"ADI PURO, TRIMURJO, LAMPUNG TENGAH, LAMPUNG",15,151,79,230
https://kawalpemilu.org#22938,"ADI PURO, TRIMURJO, LAMPUNG TENGAH, LAMPUNG",16,79,102,181
https://kawalpemilu.org#22938,"ADI PURO, TRIMURJO, LAMPUNG TENGAH, LAMPUNG",17,122,52,174
https://kawalpemilu.org#22938,"ADI PURO, TRIMURJO, LAMPUNG TENGAH, LAMPUNG",18,129,29,158
https://kawalpemilu.org#22938,"ADI PURO, TRIMURJO, LAMPUNG TENGAH, LAMPUNG",19,75,42,117
https://kawalpemilu.org#22938,"ADI PURO, TRIMURJO, LAMPUNG TENGAH, LAMPUNG",20,123,51,174
https://kawalpemilu.org#22938,"ADI PURO, TRIMURJO, LAMPUNG TENGAH, LAMPUNG",21,94,41,135
https://kawalpemilu.org#22939,"TRIMURJO, TRIMURJO, LAMPUNG TENGAH, LAMPUNG",1,149,66,215
https://kawalpemilu.org#22939,"TRIMURJO, TRIMURJO, LAMPUNG TENGAH, LAMPUNG",2,127,42,169
https://kawalpemilu.org#22939,"TRIMURJO, TRIMURJO, LAMPUNG TENGAH, LAMPUNG",3,163,58,221
https://kawalpemilu.org#22939,"TRIMURJO, TRIMURJO, LAMPUNG TENGAH, LAMPUNG",4,156,66,222
https://kawalpemilu.org#22939,"TRIMURJO, TRIMURJO, LAMPUNG TENGAH, LAMPUNG",5,156,25,181
https://kawalpemilu.org#22939,"TRIMURJO, TRIMURJO, LAMPUNG TENGAH, LAMPUNG",6,130,70,200
https://kawalpemilu.org#22939,"TRIMURJO, TRIMURJO, LAMPUNG TENGAH, LAMPUNG",7,126,37,163
https://kawalpemilu.org#22939,"TRIMURJO, TRIMURJO, LAMPUNG TENGAH, LAMPUNG",8,88,64,152
https://kawalpemilu.org#22939,"TRIMURJO, TRIMURJO, LAMPUNG TENGAH, LAMPUNG",9,123,50,173
https://kawalpemilu.org#22939,"TRIMURJO, TRIMURJO, LAMPUNG TENGAH, LAMPUNG",10,104,39,143
https://kawalpemilu.org#22939,"TRIMURJO, TRIMURJO, LAMPUNG TENGAH, LAMPUNG",11,158,57,215
https://kawalpemilu.org#22939,"TRIMURJO, TRIMURJO, LAMPUNG TENGAH, LAMPUNG",12,136,26,162
https://kawalpemilu.org#22939,"TRIMURJO, TRIMURJO, LAMPUNG TENGAH, LAMPUNG",13,122,37,159
https://kawalpemilu.org#22939,"TRIMURJO, TRIMURJO, LAMPUNG TENGAH, LAMPUNG",14,75,57,132
https://kawalpemilu.org#22939,"TRIMURJO, TRIMURJO, LAMPUNG TENGAH, LAMPUNG",15,93,56,149
https://kawalpemilu.org#22939,"TRIMURJO, TRIMURJO, LAMPUNG TENGAH, LAMPUNG",16,110,38,148
https://kawalpemilu.org#22939,"TRIMURJO, TRIMURJO, LAMPUNG TENGAH, LAMPUNG",17,106,37,143
https://kawalpemilu.org#22940,"SIMBAR WARINGIN, TRIMURJO, LAMPUNG TENGAH, LAMPUNG",1,83,85,168
https://kawalpemilu.org#22940,"SIMBAR WARINGIN, TRIMURJO, LAMPUNG TENGAH, LAMPUNG",2,105,74,179
https://kawalpemilu.org#22940,"SIMBAR WARINGIN, TRIMURJO, LAMPUNG TENGAH, LAMPUNG",3,97,70,167
https://kawalpemilu.org#22940,"SIMBAR WARINGIN, TRIMURJO, LAMPUNG TENGAH, LAMPUNG",4,71,71,142
https://kawalpemilu.org#22940,"SIMBAR WARINGIN, TRIMURJO, LAMPUNG TENGAH, LAMPUNG",5,91,67,158
https://kawalpemilu.org#22940,"SIMBAR WARINGIN, TRIMURJO, LAMPUNG TENGAH, LAMPUNG",6,120,65,185
https://kawalpemilu.org#22940,"SIMBAR WARINGIN, TRIMURJO, LAMPUNG TENGAH, LAMPUNG",7,152,52,204
https://kawalpemilu.org#22940,"SIMBAR WARINGIN, TRIMURJO, LAMPUNG TENGAH, LAMPUNG",8,113,40,153
https://kawalpemilu.org#22940,"SIMBAR WARINGIN, TRIMURJO, LAMPUNG TENGAH, LAMPUNG",9,103,36,139
https://kawalpemilu.org#22940,"SIMBAR WARINGIN, TRIMURJO, LAMPUNG TENGAH, LAMPUNG",10,83,64,147
https://kawalpemilu.org#22940,"SIMBAR WARINGIN, TRIMURJO, LAMPUNG TENGAH, LAMPUNG",11,89,71,160
https://kawalpemilu.org#22940,"SIMBAR WARINGIN, TRIMURJO, LAMPUNG TENGAH, LAMPUNG",12,81,54,135
https://kawalpemilu.org#22940,"SIMBAR WARINGIN, TRIMURJO, LAMPUNG TENGAH, LAMPUNG",13,73,72,145
https://kawalpemilu.org#22940,"SIMBAR WARINGIN, TRIMURJO, LAMPUNG TENGAH, LAMPUNG",14,94,48,142
https://kawalpemilu.org#22940,"SIMBAR WARINGIN, TRIMURJO, LAMPUNG TENGAH, LAMPUNG",15,68,51,119
https://kawalpemilu.org#22940,"SIMBAR WARINGIN, TRIMURJO, LAMPUNG TENGAH, LAMPUNG",16,61,39,100
https://kawalpemilu.org#22940,"SIMBAR WARINGIN, TRIMURJO, LAMPUNG TENGAH, LAMPUNG",17,108,30,138
https://kawalpemilu.org#22940,"SIMBAR WARINGIN, TRIMURJO, LAMPUNG TENGAH, LAMPUNG",18,77,34,111
https://kawalpemilu.org#22940,"SIMBAR WARINGIN, TRIMURJO, LAMPUNG TENGAH, LAMPUNG",19,101,82,183
https://kawalpemilu.org#22940,"SIMBAR WARINGIN, TRIMURJO, LAMPUNG TENGAH, LAMPUNG",20,128,58,186
https://kawalpemilu.org#22940,"SIMBAR WARINGIN, TRIMURJO, LAMPUNG TENGAH, LAMPUNG",21,139,60,199
https://kawalpemilu.org#22940,"SIMBAR WARINGIN, TRIMURJO, LAMPUNG TENGAH, LAMPUNG",22,115,33,148
https://kawalpemilu.org#22940,"SIMBAR WARINGIN, TRIMURJO, LAMPUNG TENGAH, LAMPUNG",23,122,24,146
https://kawalpemilu.org#22941,"DEPOK REJO, TRIMURJO, LAMPUNG TENGAH, LAMPUNG",1,103,65,168
https://kawalpemilu.org#22941,"DEPOK REJO, TRIMURJO, LAMPUNG TENGAH, LAMPUNG",2,139,61,200
https://kawalpemilu.org#22941,"DEPOK REJO, TRIMURJO, LAMPUNG TENGAH, LAMPUNG",3,90,87,177
https://kawalpemilu.org#22941,"DEPOK REJO, TRIMURJO, LAMPUNG TENGAH, LAMPUNG",4,148,48,196
https://kawalpemilu.org#22941,"DEPOK REJO, TRIMURJO, LAMPUNG TENGAH, LAMPUNG",5,150,64,214
https://kawalpemilu.org#22941,"DEPOK REJO, TRIMURJO, LAMPUNG TENGAH, LAMPUNG",6,153,36,189
https://kawalpemilu.org#22941,"DEPOK REJO, TRIMURJO, LAMPUNG TENGAH, LAMPUNG",7,99,59,158
https://kawalpemilu.org#22941,"DEPOK REJO, TRIMURJO, LAMPUNG TENGAH, LAMPUNG",8,79,88,167
https://kawalpemilu.org#22941,"DEPOK REJO, TRIMURJO, LAMPUNG TENGAH, LAMPUNG",9,121,63,184
https://kawalpemilu.org#22941,"DEPOK REJO, TRIMURJO, LAMPUNG TENGAH, LAMPUNG",10,102,51,153
https://kawalpemilu.org#22941,"DEPOK REJO, TRIMURJO, LAMPUNG TENGAH, LAMPUNG",11,160,60,220
https://kawalpemilu.org#22941,"DEPOK REJO, TRIMURJO, LAMPUNG TENGAH, LAMPUNG",12,156,31,187
https://kawalpemilu.org#22942,"LIMAN BENAWI, TRIMURJO, LAMPUNG TENGAH, LAMPUNG",1,141,44,185
https://kawalpemilu.org#22942,"LIMAN BENAWI, TRIMURJO, LAMPUNG TENGAH, LAMPUNG",2,130,68,198
https://kawalpemilu.org#22942,"LIMAN BENAWI, TRIMURJO, LAMPUNG TENGAH, LAMPUNG",3,174,19,193
https://kawalpemilu.org#22942,"LIMAN BENAWI, TRIMURJO, LAMPUNG TENGAH, LAMPUNG",4,172,33,205
https://kawalpemilu.org#22942,"LIMAN BENAWI, TRIMURJO, LAMPUNG TENGAH, LAMPUNG",5,149,44,193
https://kawalpemilu.org#22942,"LIMAN BENAWI, TRIMURJO, LAMPUNG TENGAH, LAMPUNG",6,112,64,176
https://kawalpemilu.org#22942,"LIMAN BENAWI, TRIMURJO, LAMPUNG TENGAH, LAMPUNG",7,107,93,200
https://kawalpemilu.org#22942,"LIMAN BENAWI, TRIMURJO, LAMPUNG TENGAH, LAMPUNG",8,109,94,203
https://kawalpemilu.org#22942,"LIMAN BENAWI, TRIMURJO, LAMPUNG TENGAH, LAMPUNG",9,154,60,214
https://kawalpemilu.org#22942,"LIMAN BENAWI, TRIMURJO, LAMPUNG TENGAH, LAMPUNG",10,140,65,205
https://kawalpemilu.org#22942,"LIMAN BENAWI, TRIMURJO, LAMPUNG TENGAH, LAMPUNG",11,127,71,198
https://kawalpemilu.org#22942,"LIMAN BENAWI, TRIMURJO, LAMPUNG TENGAH, LAMPUNG",12,107,50,157
https://kawalpemilu.org#22942,"LIMAN BENAWI, TRIMURJO, LAMPUNG TENGAH, LAMPUNG",13,111,66,177
https://kawalpemilu.org#22943,"NOTO HARJO, TRIMURJO, LAMPUNG TENGAH, LAMPUNG",1,135,82,217
https://kawalpemilu.org#22943,"NOTO HARJO, TRIMURJO, LAMPUNG TENGAH, LAMPUNG",2,110,75,185
https://kawalpemilu.org#22943,"NOTO HARJO, TRIMURJO, LAMPUNG TENGAH, LAMPUNG",3,154,41,195
https://kawalpemilu.org#22943,"NOTO HARJO, TRIMURJO, LAMPUNG TENGAH, LAMPUNG",4,131,93,224
https://kawalpemilu.org#22943,"NOTO HARJO, TRIMURJO, LAMPUNG TENGAH, LAMPUNG",5,107,93,200
https://kawalpemilu.org#22943,"NOTO HARJO, TRIMURJO, LAMPUNG TENGAH, LAMPUNG",6,84,47,131
https://kawalpemilu.org#22943,"NOTO HARJO, TRIMURJO, LAMPUNG TENGAH, LAMPUNG",7,99,31,130
https://kawalpemilu.org#22943,"NOTO HARJO, TRIMURJO, LAMPUNG TENGAH, LAMPUNG",8,125,32,157
https://kawalpemilu.org#22943,"NOTO HARJO, TRIMURJO, LAMPUNG TENGAH, LAMPUNG",9,131,34,165
https://kawalpemilu.org#22943,"NOTO HARJO, TRIMURJO, LAMPUNG TENGAH, LAMPUNG",10,141,52,193
https://kawalpemilu.org#22943,"NOTO HARJO, TRIMURJO, LAMPUNG TENGAH, LAMPUNG",11,149,55,204
https://kawalpemilu.org#22944,"PURWODADI, TRIMURJO, LAMPUNG TENGAH, LAMPUNG",1,96,117,213
https://kawalpemilu.org#22944,"PURWODADI, TRIMURJO, LAMPUNG TENGAH, LAMPUNG",2,79,137,216
https://kawalpemilu.org#22944,"PURWODADI, TRIMURJO, LAMPUNG TENGAH, LAMPUNG",3,134,124,258
https://kawalpemilu.org#22944,"PURWODADI, TRIMURJO, LAMPUNG TENGAH, LAMPUNG",4,132,129,261
https://kawalpemilu.org#22944,"PURWODADI, TRIMURJO, LAMPUNG TENGAH, LAMPUNG",5,137,69,206
https://kawalpemilu.org#22944,"PURWODADI, TRIMURJO, LAMPUNG TENGAH, LAMPUNG",6,101,69,170
https://kawalpemilu.org#22944,"PURWODADI, TRIMURJO, LAMPUNG TENGAH, LAMPUNG",8,90,149,239
https://kawalpemilu.org#22944,"PURWODADI, TRIMURJO, LAMPUNG TENGAH, LAMPUNG",9,138,111,249
https://kawalpemilu.org#22944,"PURWODADI, TRIMURJO, LAMPUNG TENGAH, LAMPUNG",10,131,104,235
https://kawalpemilu.org#22944,"PURWODADI, TRIMURJO, LAMPUNG TENGAH, LAMPUNG",11,66,119,185
https://kawalpemilu.org#22944,"PURWODADI, TRIMURJO, LAMPUNG TENGAH, LAMPUNG",12,101,92,193
https://kawalpemilu.org#22944,"PURWODADI, TRIMURJO, LAMPUNG TENGAH, LAMPUNG",13,142,115,257
https://kawalpemilu.org#22944,"PURWODADI, TRIMURJO, LAMPUNG TENGAH, LAMPUNG",14,110,99,209
https://kawalpemilu.org#22944,"PURWODADI, TRIMURJO, LAMPUNG TENGAH, LAMPUNG",15,133,73,206
https://kawalpemilu.org#22945,"TEMPURAN, TRIMURJO, LAMPUNG TENGAH, LAMPUNG",1,80,89,169
https://kawalpemilu.org#22945,"TEMPURAN, TRIMURJO, LAMPUNG TENGAH, LAMPUNG",2,143,78,221
https://kawalpemilu.org#22945,"TEMPURAN, TRIMURJO, LAMPUNG TENGAH, LAMPUNG",3,121,123,244
https://kawalpemilu.org#22945,"TEMPURAN, TRIMURJO, LAMPUNG TENGAH, LAMPUNG",4,102,102,204
https://kawalpemilu.org#22945,"TEMPURAN, TRIMURJO, LAMPUNG TENGAH, LAMPUNG",5,99,107,206
https://kawalpemilu.org#22945,"TEMPURAN, TRIMURJO, LAMPUNG TENGAH, LAMPUNG",6,136,85,221
https://kawalpemilu.org#22945,"TEMPURAN, TRIMURJO, LAMPUNG TENGAH, LAMPUNG",7,117,110,227
https://kawalpemilu.org#22945,"TEMPURAN, TRIMURJO, LAMPUNG TENGAH, LAMPUNG",8,129,132,261
https://kawalpemilu.org#22945,"TEMPURAN, TRIMURJO, LAMPUNG TENGAH, LAMPUNG",9,118,133,251
https://kawalpemilu.org#22945,"TEMPURAN, TRIMURJO, LAMPUNG TENGAH, LAMPUNG",10,147,81,228
https://kawalpemilu.org#22945,"TEMPURAN, TRIMURJO, LAMPUNG TENGAH, LAMPUNG",11,106,109,215
https://kawalpemilu.org#22945,"TEMPURAN, TRIMURJO, LAMPUNG TENGAH, LAMPUNG",12,72,147,219
https://kawalpemilu.org#22945,"TEMPURAN, TRIMURJO, LAMPUNG TENGAH, LAMPUNG",13,72,120,192
https://kawalpemilu.org#22945,"TEMPURAN, TRIMURJO, LAMPUNG TENGAH, LAMPUNG",14,83,92,175
https://kawalpemilu.org#22945,"TEMPURAN, TRIMURJO, LAMPUNG TENGAH, LAMPUNG",15,137,54,191
https://kawalpemilu.org#22945,"TEMPURAN, TRIMURJO, LAMPUNG TENGAH, LAMPUNG",16,64,109,173
https://kawalpemilu.org#22946,"PURWO ADI, TRIMURJO, LAMPUNG TENGAH, LAMPUNG",1,132,76,208
https://kawalpemilu.org#22946,"PURWO ADI, TRIMURJO, LAMPUNG TENGAH, LAMPUNG",2,106,91,197
https://kawalpemilu.org#22946,"PURWO ADI, TRIMURJO, LAMPUNG TENGAH, LAMPUNG",3,100,87,187
https://kawalpemilu.org#22946,"PURWO ADI, TRIMURJO, LAMPUNG TENGAH, LAMPUNG",4,128,59,187
https://kawalpemilu.org#22946,"PURWO ADI, TRIMURJO, LAMPUNG TENGAH, LAMPUNG",5,115,87,202
https://kawalpemilu.org#22946,"PURWO ADI, TRIMURJO, LAMPUNG TENGAH, LAMPUNG",6,75,99,174
https://kawalpemilu.org#22946,"PURWO ADI, TRIMURJO, LAMPUNG TENGAH, LAMPUNG",7,107,47,154
https://kawalpemilu.org#22946,"PURWO ADI, TRIMURJO, LAMPUNG TENGAH, LAMPUNG",8,145,72,217
https://kawalpemilu.org#22947,"PUJO DADI, TRIMURJO, LAMPUNG TENGAH, LAMPUNG",1,121,109,230
https://kawalpemilu.org#22947,"PUJO DADI, TRIMURJO, LAMPUNG TENGAH, LAMPUNG",2,142,97,239
https://kawalpemilu.org#22947,"PUJO DADI, TRIMURJO, LAMPUNG TENGAH, LAMPUNG",3,126,67,193
https://kawalpemilu.org#22947,"PUJO DADI, TRIMURJO, LAMPUNG TENGAH, LAMPUNG",4,155,58,213
https://kawalpemilu.org#22947,"PUJO DADI, TRIMURJO, LAMPUNG TENGAH, LAMPUNG",5,129,96,225
https://kawalpemilu.org#22947,"PUJO DADI, TRIMURJO, LAMPUNG TENGAH, LAMPUNG",6,157,67,224
https://kawalpemilu.org#22948,"PUJO KERTO, TRIMURJO, LAMPUNG TENGAH, LAMPUNG",1,156,53,209
https://kawalpemilu.org#22948,"PUJO KERTO, TRIMURJO, LAMPUNG TENGAH, LAMPUNG",2,91,136,227
https://kawalpemilu.org#22948,"PUJO KERTO, TRIMURJO, LAMPUNG TENGAH, LAMPUNG",3,128,61,189
https://kawalpemilu.org#22948,"PUJO KERTO, TRIMURJO, LAMPUNG TENGAH, LAMPUNG",4,137,56,193
https://kawalpemilu.org#22948,"PUJO KERTO, TRIMURJO, LAMPUNG TENGAH, LAMPUNG",5,125,85,210
https://kawalpemilu.org#22948,"PUJO KERTO, TRIMURJO, LAMPUNG TENGAH, LAMPUNG",6,102,102,204
https://kawalpemilu.org#22948,"PUJO KERTO, TRIMURJO, LAMPUNG TENGAH, LAMPUNG",7,126,42,168
https://kawalpemilu.org#22948,"PUJO KERTO, TRIMURJO, LAMPUNG TENGAH, LAMPUNG",8,122,50,172
https://kawalpemilu.org#22949,"UNTORO, TRIMURJO, LAMPUNG TENGAH, LAMPUNG",1,118,62,180
https://kawalpemilu.org#22949,"UNTORO, TRIMURJO, LAMPUNG TENGAH, LAMPUNG",2,70,67,137
https://kawalpemilu.org#22949,"UNTORO, TRIMURJO, LAMPUNG TENGAH, LAMPUNG",3,115,73,188
https://kawalpemilu.org#22949,"UNTORO, TRIMURJO, LAMPUNG TENGAH, LAMPUNG",4,145,47,192
https://kawalpemilu.org#22949,"UNTORO, TRIMURJO, LAMPUNG TENGAH, LAMPUNG",5,90,77,167
https://kawalpemilu.org#22949,"UNTORO, TRIMURJO, LAMPUNG TENGAH, LAMPUNG",6,132,45,177
https://kawalpemilu.org#22949,"UNTORO, TRIMURJO, LAMPUNG TENGAH, LAMPUNG",7,81,73,154
https://kawalpemilu.org#22949,"UNTORO, TRIMURJO, LAMPUNG TENGAH, LAMPUNG",8,131,51,182
https://kawalpemilu.org#22949,"UNTORO, TRIMURJO, LAMPUNG TENGAH, LAMPUNG",9,135,48,183
https://kawalpemilu.org#22949,"UNTORO, TRIMURJO, LAMPUNG TENGAH, LAMPUNG",10,105,65,170
https://kawalpemilu.org#22950,"PUJO ASRI, TRIMURJO, LAMPUNG TENGAH, LAMPUNG",1,68,95,163
https://kawalpemilu.org#22950,"PUJO ASRI, TRIMURJO, LAMPUNG TENGAH, LAMPUNG",2,130,89,219
https://kawalpemilu.org#22950,"PUJO ASRI, TRIMURJO, LAMPUNG TENGAH, LAMPUNG",3,148,93,241
https://kawalpemilu.org#22950,"PUJO ASRI, TRIMURJO, LAMPUNG TENGAH, LAMPUNG",4,68,90,158
https://kawalpemilu.org#22950,"PUJO ASRI, TRIMURJO, LAMPUNG TENGAH, LAMPUNG",5,124,85,209
https://kawalpemilu.org#22951,"PUJO BASUKI, TRIMURJO, LAMPUNG TENGAH, LAMPUNG",1,94,56,150
https://kawalpemilu.org#22951,"PUJO BASUKI, TRIMURJO, LAMPUNG TENGAH, LAMPUNG",2,63,98,161
https://kawalpemilu.org#22951,"PUJO BASUKI, TRIMURJO, LAMPUNG TENGAH, LAMPUNG",3,79,54,133
https://kawalpemilu.org#22951,"PUJO BASUKI, TRIMURJO, LAMPUNG TENGAH, LAMPUNG",4,92,44,136
https://kawalpemilu.org#22951,"PUJO BASUKI, TRIMURJO, LAMPUNG TENGAH, LAMPUNG",5,68,80,148
https://kawalpemilu.org#22951,"PUJO BASUKI, TRIMURJO, LAMPUNG TENGAH, LAMPUNG",6,84,51,135
https://kawalpemilu.org#22953,"NUNGGAL REJO, PUNGGUR, LAMPUNG TENGAH, LAMPUNG",1,195,67,262
https://kawalpemilu.org#22953,"NUNGGAL REJO, PUNGGUR, LAMPUNG TENGAH, LAMPUNG",2,199,37,236
https://kawalpemilu.org#22953,"NUNGGAL REJO, PUNGGUR, LAMPUNG TENGAH, LAMPUNG",3,166,72,238
https://kawalpemilu.org#22953,"NUNGGAL REJO, PUNGGUR, LAMPUNG TENGAH, LAMPUNG",4,158,76,234
https://kawalpemilu.org#22953,"NUNGGAL REJO, PUNGGUR, LAMPUNG TENGAH, LAMPUNG",5,145,90,235
https://kawalpemilu.org#22953,"NUNGGAL REJO, PUNGGUR, LAMPUNG TENGAH, LAMPUNG",6,116,114,230
https://kawalpemilu.org#22953,"NUNGGAL REJO, PUNGGUR, LAMPUNG TENGAH, LAMPUNG",7,77,160,237
https://kawalpemilu.org#22953,"NUNGGAL REJO, PUNGGUR, LAMPUNG TENGAH, LAMPUNG",8,98,118,216
https://kawalpemilu.org#22953,"NUNGGAL REJO, PUNGGUR, LAMPUNG TENGAH, LAMPUNG",9,136,110,246
https://kawalpemilu.org#22953,"NUNGGAL REJO, PUNGGUR, LAMPUNG TENGAH, LAMPUNG",10,126,112,238
https://kawalpemilu.org#22953,"NUNGGAL REJO, PUNGGUR, LAMPUNG TENGAH, LAMPUNG",11,87,106,193
https://kawalpemilu.org#22953,"NUNGGAL REJO, PUNGGUR, LAMPUNG TENGAH, LAMPUNG",12,106,40,146
https://kawalpemilu.org#22954,"BADRAN SARI, PUNGGUR, LAMPUNG TENGAH, LAMPUNG",1,90,73,163
https://kawalpemilu.org#22954,"BADRAN SARI, PUNGGUR, LAMPUNG TENGAH, LAMPUNG",2,97,55,152
https://kawalpemilu.org#22954,"BADRAN SARI, PUNGGUR, LAMPUNG TENGAH, LAMPUNG",3,143,27,170
https://kawalpemilu.org#22954,"BADRAN SARI, PUNGGUR, LAMPUNG TENGAH, LAMPUNG",4,121,31,152
https://kawalpemilu.org#22954,"BADRAN SARI, PUNGGUR, LAMPUNG TENGAH, LAMPUNG",5,158,50,208
https://kawalpemilu.org#22954,"BADRAN SARI, PUNGGUR, LAMPUNG TENGAH, LAMPUNG",6,139,76,215
https://kawalpemilu.org#22955,"SRI SAWAHAN, PUNGGUR, LAMPUNG TENGAH, LAMPUNG",1,88,106,194
https://kawalpemilu.org#22955,"SRI SAWAHAN, PUNGGUR, LAMPUNG TENGAH, LAMPUNG",2,134,115,249
https://kawalpemilu.org#22955,"SRI SAWAHAN, PUNGGUR, LAMPUNG TENGAH, LAMPUNG",3,87,92,179
https://kawalpemilu.org#22955,"SRI SAWAHAN, PUNGGUR, LAMPUNG TENGAH, LAMPUNG",4,145,73,218
https://kawalpemilu.org#22955,"SRI SAWAHAN, PUNGGUR, LAMPUNG TENGAH, LAMPUNG",5,102,137,239
https://kawalpemilu.org#22955,"SRI SAWAHAN, PUNGGUR, LAMPUNG TENGAH, LAMPUNG",6,93,140,233
https://kawalpemilu.org#22955,"SRI SAWAHAN, PUNGGUR, LAMPUNG TENGAH, LAMPUNG",7,65,140,205
https://kawalpemilu.org#22956,"TOTO KATON, PUNGGUR, LAMPUNG TENGAH, LAMPUNG",1,77,54,131
https://kawalpemilu.org#22956,"TOTO KATON, PUNGGUR, LAMPUNG TENGAH, LAMPUNG",2,123,49,172
https://kawalpemilu.org#22956,"TOTO KATON, PUNGGUR, LAMPUNG TENGAH, LAMPUNG",3,135,47,182
https://kawalpemilu.org#22956,"TOTO KATON, PUNGGUR, LAMPUNG TENGAH, LAMPUNG",4,152,42,194
https://kawalpemilu.org#22956,"TOTO KATON, PUNGGUR, LAMPUNG TENGAH, LAMPUNG",5,98,80,178
https://kawalpemilu.org#22956,"TOTO KATON, PUNGGUR, LAMPUNG TENGAH, LAMPUNG",6,91,100,191
https://kawalpemilu.org#22956,"TOTO KATON, PUNGGUR, LAMPUNG TENGAH, LAMPUNG",7,117,55,172
https://kawalpemilu.org#22956,"TOTO KATON, PUNGGUR, LAMPUNG TENGAH, LAMPUNG",8,53,61,114
https://kawalpemilu.org#22956,"TOTO KATON, PUNGGUR, LAMPUNG TENGAH, LAMPUNG",9,69,95,164
https://kawalpemilu.org#22956,"TOTO KATON, PUNGGUR, LAMPUNG TENGAH, LAMPUNG",10,101,62,163
https://kawalpemilu.org#22956,"TOTO KATON, PUNGGUR, LAMPUNG TENGAH, LAMPUNG",11,63,58,121
https://kawalpemilu.org#22956,"TOTO KATON, PUNGGUR, LAMPUNG TENGAH, LAMPUNG",12,106,38,144
https://kawalpemilu.org#22956,"TOTO KATON, PUNGGUR, LAMPUNG TENGAH, LAMPUNG",13,97,90,187
https://kawalpemilu.org#22956,"TOTO KATON, PUNGGUR, LAMPUNG TENGAH, LAMPUNG",14,139,80,219
https://kawalpemilu.org#22956,"TOTO KATON, PUNGGUR, LAMPUNG TENGAH, LAMPUNG",15,121,61,182
https://kawalpemilu.org#22956,"TOTO KATON, PUNGGUR, LAMPUNG TENGAH, LAMPUNG",16,94,81,175
https://kawalpemilu.org#22956,"TOTO KATON, PUNGGUR, LAMPUNG TENGAH, LAMPUNG",17,133,71,204
https://kawalpemilu.org#22956,"TOTO KATON, PUNGGUR, LAMPUNG TENGAH, LAMPUNG",18,81,75,156
https://kawalpemilu.org#22956,"TOTO KATON, PUNGGUR, LAMPUNG TENGAH, LAMPUNG",19,81,94,175
https://kawalpemilu.org#22956,"TOTO KATON, PUNGGUR, LAMPUNG TENGAH, LAMPUNG",20,146,92,238
https://kawalpemilu.org#22956,"TOTO KATON, PUNGGUR, LAMPUNG TENGAH, LAMPUNG",21,75,82,157
https://kawalpemilu.org#22957,"TANGGUL ANGIN, PUNGGUR, LAMPUNG TENGAH, LAMPUNG",1,116,60,176
https://kawalpemilu.org#22957,"TANGGUL ANGIN, PUNGGUR, LAMPUNG TENGAH, LAMPUNG",2,132,62,194
https://kawalpemilu.org#22957,"TANGGUL ANGIN, PUNGGUR, LAMPUNG TENGAH, LAMPUNG",3,139,69,208
https://kawalpemilu.org#22957,"TANGGUL ANGIN, PUNGGUR, LAMPUNG TENGAH, LAMPUNG",4,116,85,201
https://kawalpemilu.org#22957,"TANGGUL ANGIN, PUNGGUR, LAMPUNG TENGAH, LAMPUNG",5,117,95,212
https://kawalpemilu.org#22957,"TANGGUL ANGIN, PUNGGUR, LAMPUNG TENGAH, LAMPUNG",6,124,70,194
https://kawalpemilu.org#22957,"TANGGUL ANGIN, PUNGGUR, LAMPUNG TENGAH, LAMPUNG",7,127,54,181
https://kawalpemilu.org#22957,"TANGGUL ANGIN, PUNGGUR, LAMPUNG TENGAH, LAMPUNG",8,124,66,190
https://kawalpemilu.org#22957,"TANGGUL ANGIN, PUNGGUR, LAMPUNG TENGAH, LAMPUNG",9,101,92,193
https://kawalpemilu.org#22957,"TANGGUL ANGIN, PUNGGUR, LAMPUNG TENGAH, LAMPUNG",10,153,38,191
https://kawalpemilu.org#22957,"TANGGUL ANGIN, PUNGGUR, LAMPUNG TENGAH, LAMPUNG",11,124,60,184
https://kawalpemilu.org#22957,"TANGGUL ANGIN, PUNGGUR, LAMPUNG TENGAH, LAMPUNG",12,124,59,183
https://kawalpemilu.org#22957,"TANGGUL ANGIN, PUNGGUR, LAMPUNG TENGAH, LAMPUNG",13,163,41,204
https://kawalpemilu.org#22957,"TANGGUL ANGIN, PUNGGUR, LAMPUNG TENGAH, LAMPUNG",14,128,67,195
https://kawalpemilu.org#22957,"TANGGUL ANGIN, PUNGGUR, LAMPUNG TENGAH, LAMPUNG",15,135,64,199
https://kawalpemilu.org#22957,"TANGGUL ANGIN, PUNGGUR, LAMPUNG TENGAH, LAMPUNG",16,145,39,184
https://kawalpemilu.org#22957,"TANGGUL ANGIN, PUNGGUR, LAMPUNG TENGAH, LAMPUNG",17,125,61,186
https://kawalpemilu.org#22957,"TANGGUL ANGIN, PUNGGUR, LAMPUNG TENGAH, LAMPUNG",18,145,43,188
https://kawalpemilu.org#22958,"NGESTI RAHAYU, PUNGGUR, LAMPUNG TENGAH, LAMPUNG",1,147,35,182
https://kawalpemilu.org#22958,"NGESTI RAHAYU, PUNGGUR, LAMPUNG TENGAH, LAMPUNG",2,198,48,246
https://kawalpemilu.org#22958,"NGESTI RAHAYU, PUNGGUR, LAMPUNG TENGAH, LAMPUNG",3,195,36,231
https://kawalpemilu.org#22958,"NGESTI RAHAYU, PUNGGUR, LAMPUNG TENGAH, LAMPUNG",4,182,27,209
https://kawalpemilu.org#22958,"NGESTI RAHAYU, PUNGGUR, LAMPUNG TENGAH, LAMPUNG",5,156,32,188
https://kawalpemilu.org#22958,"NGESTI RAHAYU, PUNGGUR, LAMPUNG TENGAH, LAMPUNG",6,155,51,206
https://kawalpemilu.org#22958,"NGESTI RAHAYU, PUNGGUR, LAMPUNG TENGAH, LAMPUNG",7,124,66,190
https://kawalpemilu.org#22958,"NGESTI RAHAYU, PUNGGUR, LAMPUNG TENGAH, LAMPUNG",8,157,48,205
https://kawalpemilu.org#22958,"NGESTI RAHAYU, PUNGGUR, LAMPUNG TENGAH, LAMPUNG",9,168,47,215
https://kawalpemilu.org#22959,"MOJOPAHIT, PUNGGUR, LAMPUNG TENGAH, LAMPUNG",1,108,117,225
https://kawalpemilu.org#22959,"MOJOPAHIT, PUNGGUR, LAMPUNG TENGAH, LAMPUNG",2,109,114,223
https://kawalpemilu.org#22959,"MOJOPAHIT, PUNGGUR, LAMPUNG TENGAH, LAMPUNG",3,158,91,249
https://kawalpemilu.org#22959,"MOJOPAHIT, PUNGGUR, LAMPUNG TENGAH, LAMPUNG",4,166,64,230
https://kawalpemilu.org#22959,"MOJOPAHIT, PUNGGUR, LAMPUNG TENGAH, LAMPUNG",5,155,66,221
https://kawalpemilu.org#22959,"MOJOPAHIT, PUNGGUR, LAMPUNG TENGAH, LAMPUNG",6,132,86,218
https://kawalpemilu.org#22959,"MOJOPAHIT, PUNGGUR, LAMPUNG TENGAH, LAMPUNG",7,128,100,228
https://kawalpemilu.org#22959,"MOJOPAHIT, PUNGGUR, LAMPUNG TENGAH, LAMPUNG",8,133,52,185
https://kawalpemilu.org#22959,"MOJOPAHIT, PUNGGUR, LAMPUNG TENGAH, LAMPUNG",9,156,61,214
https://kawalpemilu.org#22959,"MOJOPAHIT, PUNGGUR, LAMPUNG TENGAH, LAMPUNG",10,145,66,211
https://kawalpemilu.org#22960,"ASTO MULYO, PUNGGUR, LAMPUNG TENGAH, LAMPUNG",1,168,57,225
https://kawalpemilu.org#22960,"ASTO MULYO, PUNGGUR, LAMPUNG TENGAH, LAMPUNG",2,151,54,205
https://kawalpemilu.org#22960,"ASTO MULYO, PUNGGUR, LAMPUNG TENGAH, LAMPUNG",3,149,70,219
https://kawalpemilu.org#22960,"ASTO MULYO, PUNGGUR, LAMPUNG TENGAH, LAMPUNG",4,154,78,232
https://kawalpemilu.org#22960,"ASTO MULYO, PUNGGUR, LAMPUNG TENGAH, LAMPUNG",5,149,51,200
https://kawalpemilu.org#22960,"ASTO MULYO, PUNGGUR, LAMPUNG TENGAH, LAMPUNG",6,150,56,206
https://kawalpemilu.org#22960,"ASTO MULYO, PUNGGUR, LAMPUNG TENGAH, LAMPUNG",7,151,40,191
https://kawalpemilu.org#22960,"ASTO MULYO, PUNGGUR, LAMPUNG TENGAH, LAMPUNG",8,146,46,192
https://kawalpemilu.org#22960,"ASTO MULYO, PUNGGUR, LAMPUNG TENGAH, LAMPUNG",9,141,55,196
https://kawalpemilu.org#22960,"ASTO MULYO, PUNGGUR, LAMPUNG TENGAH, LAMPUNG",10,149,57,206
https://kawalpemilu.org#22960,"ASTO MULYO, PUNGGUR, LAMPUNG TENGAH, LAMPUNG",11,168,61,229
https://kawalpemilu.org#22960,"ASTO MULYO, PUNGGUR, LAMPUNG TENGAH, LAMPUNG",12,160,57,217
https://kawalpemilu.org#22960,"ASTO MULYO, PUNGGUR, LAMPUNG TENGAH, LAMPUNG",13,178,48,226
https://kawalpemilu.org#22960,"ASTO MULYO, PUNGGUR, LAMPUNG TENGAH, LAMPUNG",14,186,39,225
https://kawalpemilu.org#22960,"ASTO MULYO, PUNGGUR, LAMPUNG TENGAH, LAMPUNG",15,146,49,195
https://kawalpemilu.org#22960,"ASTO MULYO, PUNGGUR, LAMPUNG TENGAH, LAMPUNG",16,167,61,228
https://kawalpemilu.org#22960,"ASTO MULYO, PUNGGUR, LAMPUNG TENGAH, LAMPUNG",17,175,66,241
https://kawalpemilu.org#22960,"ASTO MULYO, PUNGGUR, LAMPUNG TENGAH, LAMPUNG",18,178,47,225
https://kawalpemilu.org#22960,"ASTO MULYO, PUNGGUR, LAMPUNG TENGAH, LAMPUNG",19,122,63,185
https://kawalpemilu.org#22960,"ASTO MULYO, PUNGGUR, LAMPUNG TENGAH, LAMPUNG",20,124,52,176
https://kawalpemilu.org#22961,"SIDO MULYO, PUNGGUR, LAMPUNG TENGAH, LAMPUNG",1,161,70,231
https://kawalpemilu.org#22961,"SIDO MULYO, PUNGGUR, LAMPUNG TENGAH, LAMPUNG",2,122,83,205
https://kawalpemilu.org#22961,"SIDO MULYO, PUNGGUR, LAMPUNG TENGAH, LAMPUNG",3,143,80,223
https://kawalpemilu.org#22961,"SIDO MULYO, PUNGGUR, LAMPUNG TENGAH, LAMPUNG",4,146,57,203
https://kawalpemilu.org#22961,"SIDO MULYO, PUNGGUR, LAMPUNG TENGAH, LAMPUNG",5,145,87,232
https://kawalpemilu.org#22961,"SIDO MULYO, PUNGGUR, LAMPUNG TENGAH, LAMPUNG",6,125,86,211
https://kawalpemilu.org#22961,"SIDO MULYO, PUNGGUR, LAMPUNG TENGAH, LAMPUNG",7,140,59,199
https://kawalpemilu.org#22961,"SIDO MULYO, PUNGGUR, LAMPUNG TENGAH, LAMPUNG",8,120,88,208
https://kawalpemilu.org#22961,"SIDO MULYO, PUNGGUR, LAMPUNG TENGAH, LAMPUNG",9,154,68,222
https://kawalpemilu.org#22961,"SIDO MULYO, PUNGGUR, LAMPUNG TENGAH, LAMPUNG",10,122,66,188
https://kawalpemilu.org#22961,"SIDO MULYO, PUNGGUR, LAMPUNG TENGAH, LAMPUNG",11,129,59,188
https://kawalpemilu.org#22961,"SIDO MULYO, PUNGGUR, LAMPUNG TENGAH, LAMPUNG",12,135,79,214
https://kawalpemilu.org#22963,"BANDAR JAYA TIMUR, TERBANGGI BESAR, LAMPUNG TENGAH, LAMPUNG",1,53,104,157
https://kawalpemilu.org#22963,"BANDAR JAYA TIMUR, TERBANGGI BESAR, LAMPUNG TENGAH, LAMPUNG",2,101,111,212
https://kawalpemilu.org#22963,"BANDAR JAYA TIMUR, TERBANGGI BESAR, LAMPUNG TENGAH, LAMPUNG",3,119,100,219
https://kawalpemilu.org#22963,"BANDAR JAYA TIMUR, TERBANGGI BESAR, LAMPUNG TENGAH, LAMPUNG",4,176,71,247
https://kawalpemilu.org#22963,"BANDAR JAYA TIMUR, TERBANGGI BESAR, LAMPUNG TENGAH, LAMPUNG",5,174,76,250
https://kawalpemilu.org#22963,"BANDAR JAYA TIMUR, TERBANGGI BESAR, LAMPUNG TENGAH, LAMPUNG",6,124,100,224
https://kawalpemilu.org#22963,"BANDAR JAYA TIMUR, TERBANGGI BESAR, LAMPUNG TENGAH, LAMPUNG",7,97,73,170
https://kawalpemilu.org#22963,"BANDAR JAYA TIMUR, TERBANGGI BESAR, LAMPUNG TENGAH, LAMPUNG",8,79,31,110
https://kawalpemilu.org#22963,"BANDAR JAYA TIMUR, TERBANGGI BESAR, LAMPUNG TENGAH, LAMPUNG",9,187,53,240
https://kawalpemilu.org#22963,"BANDAR JAYA TIMUR, TERBANGGI BESAR, LAMPUNG TENGAH, LAMPUNG",10,92,92,184
https://kawalpemilu.org#22963,"BANDAR JAYA TIMUR, TERBANGGI BESAR, LAMPUNG TENGAH, LAMPUNG",11,113,90,203
https://kawalpemilu.org#22963,"BANDAR JAYA TIMUR, TERBANGGI BESAR, LAMPUNG TENGAH, LAMPUNG",12,137,43,180
https://kawalpemilu.org#22963,"BANDAR JAYA TIMUR, TERBANGGI BESAR, LAMPUNG TENGAH, LAMPUNG",13,97,104,201
https://kawalpemilu.org#22963,"BANDAR JAYA TIMUR, TERBANGGI BESAR, LAMPUNG TENGAH, LAMPUNG",14,103,71,174
https://kawalpemilu.org#22963,"BANDAR JAYA TIMUR, TERBANGGI BESAR, LAMPUNG TENGAH, LAMPUNG",15,120,122,242
https://kawalpemilu.org#22963,"BANDAR JAYA TIMUR, TERBANGGI BESAR, LAMPUNG TENGAH, LAMPUNG",16,163,40,203
https://kawalpemilu.org#22963,"BANDAR JAYA TIMUR, TERBANGGI BESAR, LAMPUNG TENGAH, LAMPUNG",17,130,31,161
https://kawalpemilu.org#22963,"BANDAR JAYA TIMUR, TERBANGGI BESAR, LAMPUNG TENGAH, LAMPUNG",18,149,78,227
https://kawalpemilu.org#22963,"BANDAR JAYA TIMUR, TERBANGGI BESAR, LAMPUNG TENGAH, LAMPUNG",19,173,57,230
https://kawalpemilu.org#22963,"BANDAR JAYA TIMUR, TERBANGGI BESAR, LAMPUNG TENGAH, LAMPUNG",20,131,87,218
https://kawalpemilu.org#22963,"BANDAR JAYA TIMUR, TERBANGGI BESAR, LAMPUNG TENGAH, LAMPUNG",21,141,54,195
https://kawalpemilu.org#22963,"BANDAR JAYA TIMUR, TERBANGGI BESAR, LAMPUNG TENGAH, LAMPUNG",22,150,87,237
https://kawalpemilu.org#22963,"BANDAR JAYA TIMUR, TERBANGGI BESAR, LAMPUNG TENGAH, LAMPUNG",23,93,62,155
https://kawalpemilu.org#22963,"BANDAR JAYA TIMUR, TERBANGGI BESAR, LAMPUNG TENGAH, LAMPUNG",24,189,91,280
https://kawalpemilu.org#22963,"BANDAR JAYA TIMUR, TERBANGGI BESAR, LAMPUNG TENGAH, LAMPUNG",25,168,99,267
https://kawalpemilu.org#22963,"BANDAR JAYA TIMUR, TERBANGGI BESAR, LAMPUNG TENGAH, LAMPUNG",26,92,167,259
https://kawalpemilu.org#22963,"BANDAR JAYA TIMUR, TERBANGGI BESAR, LAMPUNG TENGAH, LAMPUNG",27,103,46,149
https://kawalpemilu.org#22963,"BANDAR JAYA TIMUR, TERBANGGI BESAR, LAMPUNG TENGAH, LAMPUNG",28,159,64,223
https://kawalpemilu.org#22963,"BANDAR JAYA TIMUR, TERBANGGI BESAR, LAMPUNG TENGAH, LAMPUNG",29,184,14,198
https://kawalpemilu.org#22963,"BANDAR JAYA TIMUR, TERBANGGI BESAR, LAMPUNG TENGAH, LAMPUNG",30,53,84,137
https://kawalpemilu.org#22963,"BANDAR JAYA TIMUR, TERBANGGI BESAR, LAMPUNG TENGAH, LAMPUNG",31,114,59,173
https://kawalpemilu.org#22963,"BANDAR JAYA TIMUR, TERBANGGI BESAR, LAMPUNG TENGAH, LAMPUNG",32,150,40,190
https://kawalpemilu.org#22963,"BANDAR JAYA TIMUR, TERBANGGI BESAR, LAMPUNG TENGAH, LAMPUNG",33,130,43,173
https://kawalpemilu.org#22963,"BANDAR JAYA TIMUR, TERBANGGI BESAR, LAMPUNG TENGAH, LAMPUNG",34,131,33,164
https://kawalpemilu.org#22963,"BANDAR JAYA TIMUR, TERBANGGI BESAR, LAMPUNG TENGAH, LAMPUNG",35,116,29,145
https://kawalpemilu.org#22963,"BANDAR JAYA TIMUR, TERBANGGI BESAR, LAMPUNG TENGAH, LAMPUNG",36,81,35,116
https://kawalpemilu.org#22963,"BANDAR JAYA TIMUR, TERBANGGI BESAR, LAMPUNG TENGAH, LAMPUNG",37,86,38,124
https://kawalpemilu.org#22964,"BANDAR JAYA BARAT, TERBANGGI BESAR, LAMPUNG TENGAH, LAMPUNG",1,138,119,257
https://kawalpemilu.org#22964,"BANDAR JAYA BARAT, TERBANGGI BESAR, LAMPUNG TENGAH, LAMPUNG",2,159,108,267
https://kawalpemilu.org#22964,"BANDAR JAYA BARAT, TERBANGGI BESAR, LAMPUNG TENGAH, LAMPUNG",3,92,152,244
https://kawalpemilu.org#22964,"BANDAR JAYA BARAT, TERBANGGI BESAR, LAMPUNG TENGAH, LAMPUNG",4,86,112,198
https://kawalpemilu.org#22964,"BANDAR JAYA BARAT, TERBANGGI BESAR, LAMPUNG TENGAH, LAMPUNG",5,96,115,211
https://kawalpemilu.org#22964,"BANDAR JAYA BARAT, TERBANGGI BESAR, LAMPUNG TENGAH, LAMPUNG",6,129,129,258
https://kawalpemilu.org#22964,"BANDAR JAYA BARAT, TERBANGGI BESAR, LAMPUNG TENGAH, LAMPUNG",7,119,155,274
https://kawalpemilu.org#22964,"BANDAR JAYA BARAT, TERBANGGI BESAR, LAMPUNG TENGAH, LAMPUNG",8,99,96,195
https://kawalpemilu.org#22964,"BANDAR JAYA BARAT, TERBANGGI BESAR, LAMPUNG TENGAH, LAMPUNG",9,130,119,249
https://kawalpemilu.org#22964,"BANDAR JAYA BARAT, TERBANGGI BESAR, LAMPUNG TENGAH, LAMPUNG",10,93,145,238
https://kawalpemilu.org#22964,"BANDAR JAYA BARAT, TERBANGGI BESAR, LAMPUNG TENGAH, LAMPUNG",11,112,164,276
https://kawalpemilu.org#22964,"BANDAR JAYA BARAT, TERBANGGI BESAR, LAMPUNG TENGAH, LAMPUNG",12,45,219,264
https://kawalpemilu.org#22964,"BANDAR JAYA BARAT, TERBANGGI BESAR, LAMPUNG TENGAH, LAMPUNG",13,125,100,225
https://kawalpemilu.org#22964,"BANDAR JAYA BARAT, TERBANGGI BESAR, LAMPUNG TENGAH, LAMPUNG",14,197,55,252
https://kawalpemilu.org#22964,"BANDAR JAYA BARAT, TERBANGGI BESAR, LAMPUNG TENGAH, LAMPUNG",15,109,154,263
https://kawalpemilu.org#22964,"BANDAR JAYA BARAT, TERBANGGI BESAR, LAMPUNG TENGAH, LAMPUNG",16,134,106,240
https://kawalpemilu.org#22964,"BANDAR JAYA BARAT, TERBANGGI BESAR, LAMPUNG TENGAH, LAMPUNG",17,92,161,253
https://kawalpemilu.org#22964,"BANDAR JAYA BARAT, TERBANGGI BESAR, LAMPUNG TENGAH, LAMPUNG",18,108,133,241
https://kawalpemilu.org#22964,"BANDAR JAYA BARAT, TERBANGGI BESAR, LAMPUNG TENGAH, LAMPUNG",19,178,91,269
https://kawalpemilu.org#22964,"BANDAR JAYA BARAT, TERBANGGI BESAR, LAMPUNG TENGAH, LAMPUNG",20,133,107,240
https://kawalpemilu.org#22964,"BANDAR JAYA BARAT, TERBANGGI BESAR, LAMPUNG TENGAH, LAMPUNG",21,142,68,210
https://kawalpemilu.org#22964,"BANDAR JAYA BARAT, TERBANGGI BESAR, LAMPUNG TENGAH, LAMPUNG",22,109,112,221
https://kawalpemilu.org#22964,"BANDAR JAYA BARAT, TERBANGGI BESAR, LAMPUNG TENGAH, LAMPUNG",23,148,80,228
https://kawalpemilu.org#22964,"BANDAR JAYA BARAT, TERBANGGI BESAR, LAMPUNG TENGAH, LAMPUNG",24,118,136,254
https://kawalpemilu.org#22964,"BANDAR JAYA BARAT, TERBANGGI BESAR, LAMPUNG TENGAH, LAMPUNG",25,141,110,251
https://kawalpemilu.org#22964,"BANDAR JAYA BARAT, TERBANGGI BESAR, LAMPUNG TENGAH, LAMPUNG",26,125,143,268
https://kawalpemilu.org#22964,"BANDAR JAYA BARAT, TERBANGGI BESAR, LAMPUNG TENGAH, LAMPUNG",27,155,126,281
https://kawalpemilu.org#22964,"BANDAR JAYA BARAT, TERBANGGI BESAR, LAMPUNG TENGAH, LAMPUNG",28,139,129,268
https://kawalpemilu.org#22964,"BANDAR JAYA BARAT, TERBANGGI BESAR, LAMPUNG TENGAH, LAMPUNG",29,69,98,167
https://kawalpemilu.org#22964,"BANDAR JAYA BARAT, TERBANGGI BESAR, LAMPUNG TENGAH, LAMPUNG",30,82,87,169
https://kawalpemilu.org#22964,"BANDAR JAYA BARAT, TERBANGGI BESAR, LAMPUNG TENGAH, LAMPUNG",31,174,73,247
https://kawalpemilu.org#22964,"BANDAR JAYA BARAT, TERBANGGI BESAR, LAMPUNG TENGAH, LAMPUNG",32,119,87,206
https://kawalpemilu.org#22964,"BANDAR JAYA BARAT, TERBANGGI BESAR, LAMPUNG TENGAH, LAMPUNG",33,79,72,151
https://kawalpemilu.org#22965,"YUKUM JAYA, TERBANGGI BESAR, LAMPUNG TENGAH, LAMPUNG",1,89,55,144
https://kawalpemilu.org#22965,"YUKUM JAYA, TERBANGGI BESAR, LAMPUNG TENGAH, LAMPUNG",2,57,79,136
https://kawalpemilu.org#22965,"YUKUM JAYA, TERBANGGI BESAR, LAMPUNG TENGAH, LAMPUNG",3,116,55,171
https://kawalpemilu.org#22965,"YUKUM JAYA, TERBANGGI BESAR, LAMPUNG TENGAH, LAMPUNG",4,87,111,198
https://kawalpemilu.org#22965,"YUKUM JAYA, TERBANGGI BESAR, LAMPUNG TENGAH, LAMPUNG",6,142,46,188
https://kawalpemilu.org#22965,"YUKUM JAYA, TERBANGGI BESAR, LAMPUNG TENGAH, LAMPUNG",7,48,162,210
https://kawalpemilu.org#22965,"YUKUM JAYA, TERBANGGI BESAR, LAMPUNG TENGAH, LAMPUNG",8,61,62,123
https://kawalpemilu.org#22965,"YUKUM JAYA, TERBANGGI BESAR, LAMPUNG TENGAH, LAMPUNG",10,102,110,212
https://kawalpemilu.org#22965,"YUKUM JAYA, TERBANGGI BESAR, LAMPUNG TENGAH, LAMPUNG",11,76,45,121
https://kawalpemilu.org#22965,"YUKUM JAYA, TERBANGGI BESAR, LAMPUNG TENGAH, LAMPUNG",12,99,65,164
https://kawalpemilu.org#22965,"YUKUM JAYA, TERBANGGI BESAR, LAMPUNG TENGAH, LAMPUNG",13,45,34,79
https://kawalpemilu.org#22965,"YUKUM JAYA, TERBANGGI BESAR, LAMPUNG TENGAH, LAMPUNG",14,37,148,185
https://kawalpemilu.org#22965,"YUKUM JAYA, TERBANGGI BESAR, LAMPUNG TENGAH, LAMPUNG",15,102,94,196
https://kawalpemilu.org#22965,"YUKUM JAYA, TERBANGGI BESAR, LAMPUNG TENGAH, LAMPUNG",16,54,72,126
https://kawalpemilu.org#22965,"YUKUM JAYA, TERBANGGI BESAR, LAMPUNG TENGAH, LAMPUNG",17,110,132,242
https://kawalpemilu.org#22965,"YUKUM JAYA, TERBANGGI BESAR, LAMPUNG TENGAH, LAMPUNG",18,82,124,206
https://kawalpemilu.org#22965,"YUKUM JAYA, TERBANGGI BESAR, LAMPUNG TENGAH, LAMPUNG",19,86,138,224
https://kawalpemilu.org#22965,"YUKUM JAYA, TERBANGGI BESAR, LAMPUNG TENGAH, LAMPUNG",20,82,45,127
https://kawalpemilu.org#22965,"YUKUM JAYA, TERBANGGI BESAR, LAMPUNG TENGAH, LAMPUNG",21,101,87,188
https://kawalpemilu.org#22965,"YUKUM JAYA, TERBANGGI BESAR, LAMPUNG TENGAH, LAMPUNG",22,121,69,190
https://kawalpemilu.org#22965,"YUKUM JAYA, TERBANGGI BESAR, LAMPUNG TENGAH, LAMPUNG",23,102,74,176
https://kawalpemilu.org#22965,"YUKUM JAYA, TERBANGGI BESAR, LAMPUNG TENGAH, LAMPUNG",24,74,86,160
https://kawalpemilu.org#22965,"YUKUM JAYA, TERBANGGI BESAR, LAMPUNG TENGAH, LAMPUNG",25,43,94,137
https://kawalpemilu.org#22965,"YUKUM JAYA, TERBANGGI BESAR, LAMPUNG TENGAH, LAMPUNG",26,30,86,116
https://kawalpemilu.org#22965,"YUKUM JAYA, TERBANGGI BESAR, LAMPUNG TENGAH, LAMPUNG",27,154,58,212
https://kawalpemilu.org#22965,"YUKUM JAYA, TERBANGGI BESAR, LAMPUNG TENGAH, LAMPUNG",28,133,50,183
https://kawalpemilu.org#22965,"YUKUM JAYA, TERBANGGI BESAR, LAMPUNG TENGAH, LAMPUNG",29,116,71,187
https://kawalpemilu.org#22965,"YUKUM JAYA, TERBANGGI BESAR, LAMPUNG TENGAH, LAMPUNG",30,122,46,168
https://kawalpemilu.org#22965,"YUKUM JAYA, TERBANGGI BESAR, LAMPUNG TENGAH, LAMPUNG",31,56,91,147
https://kawalpemilu.org#22965,"YUKUM JAYA, TERBANGGI BESAR, LAMPUNG TENGAH, LAMPUNG",32,142,101,243
https://kawalpemilu.org#22965,"YUKUM JAYA, TERBANGGI BESAR, LAMPUNG TENGAH, LAMPUNG",33,78,94,172
https://kawalpemilu.org#22965,"YUKUM JAYA, TERBANGGI BESAR, LAMPUNG TENGAH, LAMPUNG",34,88,54,142
https://kawalpemilu.org#22965,"YUKUM JAYA, TERBANGGI BESAR, LAMPUNG TENGAH, LAMPUNG",35,79,56,135
https://kawalpemilu.org#22965,"YUKUM JAYA, TERBANGGI BESAR, LAMPUNG TENGAH, LAMPUNG",36,90,37,127
https://kawalpemilu.org#22965,"YUKUM JAYA, TERBANGGI BESAR, LAMPUNG TENGAH, LAMPUNG",37,108,75,183
https://kawalpemilu.org#22965,"YUKUM JAYA, TERBANGGI BESAR, LAMPUNG TENGAH, LAMPUNG",38,111,33,144
https://kawalpemilu.org#22965,"YUKUM JAYA, TERBANGGI BESAR, LAMPUNG TENGAH, LAMPUNG",39,132,43,175
https://kawalpemilu.org#22965,"YUKUM JAYA, TERBANGGI BESAR, LAMPUNG TENGAH, LAMPUNG",40,106,47,153
https://kawalpemilu.org#22965,"YUKUM JAYA, TERBANGGI BESAR, LAMPUNG TENGAH, LAMPUNG",41,56,39,95
https://kawalpemilu.org#22965,"YUKUM JAYA, TERBANGGI BESAR, LAMPUNG TENGAH, LAMPUNG",42,36,62,98
https://kawalpemilu.org#22965,"YUKUM JAYA, TERBANGGI BESAR, LAMPUNG TENGAH, LAMPUNG",43,82,115,197
https://kawalpemilu.org#22965,"YUKUM JAYA, TERBANGGI BESAR, LAMPUNG TENGAH, LAMPUNG",44,46,67,113
https://kawalpemilu.org#22965,"YUKUM JAYA, TERBANGGI BESAR, LAMPUNG TENGAH, LAMPUNG",45,55,36,91
https://kawalpemilu.org#22965,"YUKUM JAYA, TERBANGGI BESAR, LAMPUNG TENGAH, LAMPUNG",46,81,88,169
https://kawalpemilu.org#22965,"YUKUM JAYA, TERBANGGI BESAR, LAMPUNG TENGAH, LAMPUNG",48,51,60,111
https://kawalpemilu.org#22965,"YUKUM JAYA, TERBANGGI BESAR, LAMPUNG TENGAH, LAMPUNG",49,62,63,125
https://kawalpemilu.org#22965,"YUKUM JAYA, TERBANGGI BESAR, LAMPUNG TENGAH, LAMPUNG",50,68,98,166
https://kawalpemilu.org#22965,"YUKUM JAYA, TERBANGGI BESAR, LAMPUNG TENGAH, LAMPUNG",51,40,121,161
https://kawalpemilu.org#22965,"YUKUM JAYA, TERBANGGI BESAR, LAMPUNG TENGAH, LAMPUNG",52,63,42,105
https://kawalpemilu.org#22965,"YUKUM JAYA, TERBANGGI BESAR, LAMPUNG TENGAH, LAMPUNG",53,82,104,186
https://kawalpemilu.org#22965,"YUKUM JAYA, TERBANGGI BESAR, LAMPUNG TENGAH, LAMPUNG",54,90,118,208
https://kawalpemilu.org#22965,"YUKUM JAYA, TERBANGGI BESAR, LAMPUNG TENGAH, LAMPUNG",55,124,82,206
https://kawalpemilu.org#22965,"YUKUM JAYA, TERBANGGI BESAR, LAMPUNG TENGAH, LAMPUNG",56,84,90,174
https://kawalpemilu.org#22965,"YUKUM JAYA, TERBANGGI BESAR, LAMPUNG TENGAH, LAMPUNG",57,97,130,227
https://kawalpemilu.org#22965,"YUKUM JAYA, TERBANGGI BESAR, LAMPUNG TENGAH, LAMPUNG",58,30,86,116
https://kawalpemilu.org#22965,"YUKUM JAYA, TERBANGGI BESAR, LAMPUNG TENGAH, LAMPUNG",59,146,60,206
https://kawalpemilu.org#22965,"YUKUM JAYA, TERBANGGI BESAR, LAMPUNG TENGAH, LAMPUNG",60,136,47,183
https://kawalpemilu.org#22965,"YUKUM JAYA, TERBANGGI BESAR, LAMPUNG TENGAH, LAMPUNG",61,83,40,123
https://kawalpemilu.org#22965,"YUKUM JAYA, TERBANGGI BESAR, LAMPUNG TENGAH, LAMPUNG",62,123,62,185
https://kawalpemilu.org#22965,"YUKUM JAYA, TERBANGGI BESAR, LAMPUNG TENGAH, LAMPUNG",63,70,35,105
https://kawalpemilu.org#22965,"YUKUM JAYA, TERBANGGI BESAR, LAMPUNG TENGAH, LAMPUNG",64,30,66,96
https://kawalpemilu.org#22966,"ADI JAYA, TERBANGGI BESAR, LAMPUNG TENGAH, LAMPUNG",1,135,88,223
https://kawalpemilu.org#22966,"ADI JAYA, TERBANGGI BESAR, LAMPUNG TENGAH, LAMPUNG",2,167,57,224
https://kawalpemilu.org#22966,"ADI JAYA, TERBANGGI BESAR, LAMPUNG TENGAH, LAMPUNG",3,183,71,254
https://kawalpemilu.org#22966,"ADI JAYA, TERBANGGI BESAR, LAMPUNG TENGAH, LAMPUNG",4,107,85,192
https://kawalpemilu.org#22966,"ADI JAYA, TERBANGGI BESAR, LAMPUNG TENGAH, LAMPUNG",5,98,84,182
https://kawalpemilu.org#22966,"ADI JAYA, TERBANGGI BESAR, LAMPUNG TENGAH, LAMPUNG",6,208,45,253
https://kawalpemilu.org#22966,"ADI JAYA, TERBANGGI BESAR, LAMPUNG TENGAH, LAMPUNG",7,130,46,176
https://kawalpemilu.org#22966,"ADI JAYA, TERBANGGI BESAR, LAMPUNG TENGAH, LAMPUNG",8,155,72,227
https://kawalpemilu.org#22966,"ADI JAYA, TERBANGGI BESAR, LAMPUNG TENGAH, LAMPUNG",9,171,50,221
https://kawalpemilu.org#22966,"ADI JAYA, TERBANGGI BESAR, LAMPUNG TENGAH, LAMPUNG",10,177,82,259
https://kawalpemilu.org#22966,"ADI JAYA, TERBANGGI BESAR, LAMPUNG TENGAH, LAMPUNG",11,172,75,247
https://kawalpemilu.org#22966,"ADI JAYA, TERBANGGI BESAR, LAMPUNG TENGAH, LAMPUNG",12,121,112,233
https://kawalpemilu.org#22966,"ADI JAYA, TERBANGGI BESAR, LAMPUNG TENGAH, LAMPUNG",13,172,94,266
https://kawalpemilu.org#22966,"ADI JAYA, TERBANGGI BESAR, LAMPUNG TENGAH, LAMPUNG",14,198,52,250
https://kawalpemilu.org#22966,"ADI JAYA, TERBANGGI BESAR, LAMPUNG TENGAH, LAMPUNG",15,142,68,210
https://kawalpemilu.org#22966,"ADI JAYA, TERBANGGI BESAR, LAMPUNG TENGAH, LAMPUNG",16,164,67,231
https://kawalpemilu.org#22966,"ADI JAYA, TERBANGGI BESAR, LAMPUNG TENGAH, LAMPUNG",17,202,60,262
https://kawalpemilu.org#22966,"ADI JAYA, TERBANGGI BESAR, LAMPUNG TENGAH, LAMPUNG",18,233,30,263
https://kawalpemilu.org#22967,"INDRA PUTRA SUBING, TERBANGGI BESAR, LAMPUNG TENGAH, LAMPUNG",1,158,107,265
https://kawalpemilu.org#22967,"INDRA PUTRA SUBING, TERBANGGI BESAR, LAMPUNG TENGAH, LAMPUNG",2,155,127,282
https://kawalpemilu.org#22967,"INDRA PUTRA SUBING, TERBANGGI BESAR, LAMPUNG TENGAH, LAMPUNG",3,149,121,270
https://kawalpemilu.org#22967,"INDRA PUTRA SUBING, TERBANGGI BESAR, LAMPUNG TENGAH, LAMPUNG",4,135,121,256
https://kawalpemilu.org#22967,"INDRA PUTRA SUBING, TERBANGGI BESAR, LAMPUNG TENGAH, LAMPUNG",5,104,126,230
https://kawalpemilu.org#22967,"INDRA PUTRA SUBING, TERBANGGI BESAR, LAMPUNG TENGAH, LAMPUNG",6,41,146,187
https://kawalpemilu.org#22967,"INDRA PUTRA SUBING, TERBANGGI BESAR, LAMPUNG TENGAH, LAMPUNG",7,119,79,192
https://kawalpemilu.org#22967,"INDRA PUTRA SUBING, TERBANGGI BESAR, LAMPUNG TENGAH, LAMPUNG",8,188,39,227
https://kawalpemilu.org#22967,"INDRA PUTRA SUBING, TERBANGGI BESAR, LAMPUNG TENGAH, LAMPUNG",9,205,35,240
https://kawalpemilu.org#22967,"INDRA PUTRA SUBING, TERBANGGI BESAR, LAMPUNG TENGAH, LAMPUNG",10,187,58,245
https://kawalpemilu.org#22967,"INDRA PUTRA SUBING, TERBANGGI BESAR, LAMPUNG TENGAH, LAMPUNG",11,151,113,264
https://kawalpemilu.org#22967,"INDRA PUTRA SUBING, TERBANGGI BESAR, LAMPUNG TENGAH, LAMPUNG",12,138,96,234
https://kawalpemilu.org#22967,"INDRA PUTRA SUBING, TERBANGGI BESAR, LAMPUNG TENGAH, LAMPUNG",13,109,83,192
https://kawalpemilu.org#22967,"INDRA PUTRA SUBING, TERBANGGI BESAR, LAMPUNG TENGAH, LAMPUNG",14,178,27,205
https://kawalpemilu.org#22967,"INDRA PUTRA SUBING, TERBANGGI BESAR, LAMPUNG TENGAH, LAMPUNG",15,55,62,117
https://kawalpemilu.org#22968,"KARANG ENDAH, TERBANGGI BESAR, LAMPUNG TENGAH, LAMPUNG",1,149,72,221
https://kawalpemilu.org#22968,"KARANG ENDAH, TERBANGGI BESAR, LAMPUNG TENGAH, LAMPUNG",2,84,75,159
https://kawalpemilu.org#22968,"KARANG ENDAH, TERBANGGI BESAR, LAMPUNG TENGAH, LAMPUNG",3,165,121,286
https://kawalpemilu.org#22968,"KARANG ENDAH, TERBANGGI BESAR, LAMPUNG TENGAH, LAMPUNG",4,121,141,262
https://kawalpemilu.org#22968,"KARANG ENDAH, TERBANGGI BESAR, LAMPUNG TENGAH, LAMPUNG",5,139,209,248
https://kawalpemilu.org#22968,"KARANG ENDAH, TERBANGGI BESAR, LAMPUNG TENGAH, LAMPUNG",6,161,81,242
https://kawalpemilu.org#22968,"KARANG ENDAH, TERBANGGI BESAR, LAMPUNG TENGAH, LAMPUNG",7,148,69,217
https://kawalpemilu.org#22968,"KARANG ENDAH, TERBANGGI BESAR, LAMPUNG TENGAH, LAMPUNG",8,175,38,213
https://kawalpemilu.org#22968,"KARANG ENDAH, TERBANGGI BESAR, LAMPUNG TENGAH, LAMPUNG",9,150,68,218
https://kawalpemilu.org#22968,"KARANG ENDAH, TERBANGGI BESAR, LAMPUNG TENGAH, LAMPUNG",10,144,114,258
https://kawalpemilu.org#22968,"KARANG ENDAH, TERBANGGI BESAR, LAMPUNG TENGAH, LAMPUNG",11,97,59,156
https://kawalpemilu.org#22968,"KARANG ENDAH, TERBANGGI BESAR, LAMPUNG TENGAH, LAMPUNG",12,94,85,179
https://kawalpemilu.org#22968,"KARANG ENDAH, TERBANGGI BESAR, LAMPUNG TENGAH, LAMPUNG",13,73,114,187
https://kawalpemilu.org#22968,"KARANG ENDAH, TERBANGGI BESAR, LAMPUNG TENGAH, LAMPUNG",14,127,112,239
https://kawalpemilu.org#22968,"KARANG ENDAH, TERBANGGI BESAR, LAMPUNG TENGAH, LAMPUNG",15,173,77,250
https://kawalpemilu.org#22968,"KARANG ENDAH, TERBANGGI BESAR, LAMPUNG TENGAH, LAMPUNG",16,104,60,164
https://kawalpemilu.org#22968,"KARANG ENDAH, TERBANGGI BESAR, LAMPUNG TENGAH, LAMPUNG",17,142,86,228
https://kawalpemilu.org#22968,"KARANG ENDAH, TERBANGGI BESAR, LAMPUNG TENGAH, LAMPUNG",18,102,184,286
https://kawalpemilu.org#22968,"KARANG ENDAH, TERBANGGI BESAR, LAMPUNG TENGAH, LAMPUNG",19,141,85,226
https://kawalpemilu.org#22968,"KARANG ENDAH, TERBANGGI BESAR, LAMPUNG TENGAH, LAMPUNG",20,110,42,152
https://kawalpemilu.org#22968,"KARANG ENDAH, TERBANGGI BESAR, LAMPUNG TENGAH, LAMPUNG",21,134,51,185
https://kawalpemilu.org#22968,"KARANG ENDAH, TERBANGGI BESAR, LAMPUNG TENGAH, LAMPUNG",22,88,58,146
https://kawalpemilu.org#22968,"KARANG ENDAH, TERBANGGI BESAR, LAMPUNG TENGAH, LAMPUNG",23,149,108,257
https://kawalpemilu.org#22968,"KARANG ENDAH, TERBANGGI BESAR, LAMPUNG TENGAH, LAMPUNG",24,175,91,266
https://kawalpemilu.org#22968,"KARANG ENDAH, TERBANGGI BESAR, LAMPUNG TENGAH, LAMPUNG",25,111,95,206
https://kawalpemilu.org#22968,"KARANG ENDAH, TERBANGGI BESAR, LAMPUNG TENGAH, LAMPUNG",26,113,77,190
https://kawalpemilu.org#22968,"KARANG ENDAH, TERBANGGI BESAR, LAMPUNG TENGAH, LAMPUNG",27,61,83,144
https://kawalpemilu.org#22969,"NAMBAH DADI, TERBANGGI BESAR, LAMPUNG TENGAH, LAMPUNG",1,197,66,263
https://kawalpemilu.org#22969,"NAMBAH DADI, TERBANGGI BESAR, LAMPUNG TENGAH, LAMPUNG",2,150,67,227
https://kawalpemilu.org#22969,"NAMBAH DADI, TERBANGGI BESAR, LAMPUNG TENGAH, LAMPUNG",3,144,56,200
https://kawalpemilu.org#22969,"NAMBAH DADI, TERBANGGI BESAR, LAMPUNG TENGAH, LAMPUNG",4,105,41,146
https://kawalpemilu.org#22969,"NAMBAH DADI, TERBANGGI BESAR, LAMPUNG TENGAH, LAMPUNG",5,82,64,146
https://kawalpemilu.org#22969,"NAMBAH DADI, TERBANGGI BESAR, LAMPUNG TENGAH, LAMPUNG",6,128,32,160
https://kawalpemilu.org#22969,"NAMBAH DADI, TERBANGGI BESAR, LAMPUNG TENGAH, LAMPUNG",7,133,101,234
https://kawalpemilu.org#22969,"NAMBAH DADI, TERBANGGI BESAR, LAMPUNG TENGAH, LAMPUNG",8,93,56,149
https://kawalpemilu.org#22969,"NAMBAH DADI, TERBANGGI BESAR, LAMPUNG TENGAH, LAMPUNG",9,144,76,220
https://kawalpemilu.org#22969,"NAMBAH DADI, TERBANGGI BESAR, LAMPUNG TENGAH, LAMPUNG",10,117,125,242
https://kawalpemilu.org#22969,"NAMBAH DADI, TERBANGGI BESAR, LAMPUNG TENGAH, LAMPUNG",11,120,95,215
https://kawalpemilu.org#22969,"NAMBAH DADI, TERBANGGI BESAR, LAMPUNG TENGAH, LAMPUNG",12,116,80,196
https://kawalpemilu.org#22969,"NAMBAH DADI, TERBANGGI BESAR, LAMPUNG TENGAH, LAMPUNG",13,119,73,192
https://kawalpemilu.org#22969,"NAMBAH DADI, TERBANGGI BESAR, LAMPUNG TENGAH, LAMPUNG",14,190,62,252
https://kawalpemilu.org#22969,"NAMBAH DADI, TERBANGGI BESAR, LAMPUNG TENGAH, LAMPUNG",15,112,39,151
https://kawalpemilu.org#22969,"NAMBAH DADI, TERBANGGI BESAR, LAMPUNG TENGAH, LAMPUNG",16,152,47,199
https://kawalpemilu.org#22969,"NAMBAH DADI, TERBANGGI BESAR, LAMPUNG TENGAH, LAMPUNG",17,163,25,188
https://kawalpemilu.org#22969,"NAMBAH DADI, TERBANGGI BESAR, LAMPUNG TENGAH, LAMPUNG",18,86,20,106
https://kawalpemilu.org#22969,"NAMBAH DADI, TERBANGGI BESAR, LAMPUNG TENGAH, LAMPUNG",19,134,51,185
https://kawalpemilu.org#22969,"NAMBAH DADI, TERBANGGI BESAR, LAMPUNG TENGAH, LAMPUNG",20,137,32,169
https://kawalpemilu.org#22969,"NAMBAH DADI, TERBANGGI BESAR, LAMPUNG TENGAH, LAMPUNG",21,148,60,208
https://kawalpemilu.org#22969,"NAMBAH DADI, TERBANGGI BESAR, LAMPUNG TENGAH, LAMPUNG",22,130,51,181
https://kawalpemilu.org#22969,"NAMBAH DADI, TERBANGGI BESAR, LAMPUNG TENGAH, LAMPUNG",23,196,30,226
https://kawalpemilu.org#22969,"NAMBAH DADI, TERBANGGI BESAR, LAMPUNG TENGAH, LAMPUNG",24,114,13,127
https://kawalpemilu.org#22969,"NAMBAH DADI, TERBANGGI BESAR, LAMPUNG TENGAH, LAMPUNG",25,136,78,214
https://kawalpemilu.org#22969,"NAMBAH DADI, TERBANGGI BESAR, LAMPUNG TENGAH, LAMPUNG",26,90,40,130
https://kawalpemilu.org#22970,"ONO HARJO, TERBANGGI BESAR, LAMPUNG TENGAH, LAMPUNG",1,157,55,212
https://kawalpemilu.org#22970,"ONO HARJO, TERBANGGI BESAR, LAMPUNG TENGAH, LAMPUNG",2,145,48,193
https://kawalpemilu.org#22970,"ONO HARJO, TERBANGGI BESAR, LAMPUNG TENGAH, LAMPUNG",4,128,55,183
https://kawalpemilu.org#22970,"ONO HARJO, TERBANGGI BESAR, LAMPUNG TENGAH, LAMPUNG",5,183,43,226
https://kawalpemilu.org#22970,"ONO HARJO, TERBANGGI BESAR, LAMPUNG TENGAH, LAMPUNG",6,145,33,178
https://kawalpemilu.org#22970,"ONO HARJO, TERBANGGI BESAR, LAMPUNG TENGAH, LAMPUNG",7,184,37,221
https://kawalpemilu.org#22970,"ONO HARJO, TERBANGGI BESAR, LAMPUNG TENGAH, LAMPUNG",8,156,70,226
https://kawalpemilu.org#22970,"ONO HARJO, TERBANGGI BESAR, LAMPUNG TENGAH, LAMPUNG",9,139,87,226
https://kawalpemilu.org#22970,"ONO HARJO, TERBANGGI BESAR, LAMPUNG TENGAH, LAMPUNG",10,169,41,210
https://kawalpemilu.org#22970,"ONO HARJO, TERBANGGI BESAR, LAMPUNG TENGAH, LAMPUNG",11,136,45,181
https://kawalpemilu.org#22971,"TERBANGGI BESAR, TERBANGGI BESAR, LAMPUNG TENGAH, LAMPUNG",1,29,160,189
https://kawalpemilu.org#22971,"TERBANGGI BESAR, TERBANGGI BESAR, LAMPUNG TENGAH, LAMPUNG",2,34,152,186
https://kawalpemilu.org#22971,"TERBANGGI BESAR, TERBANGGI BESAR, LAMPUNG TENGAH, LAMPUNG",3,25,208,233
https://kawalpemilu.org#22971,"TERBANGGI BESAR, TERBANGGI BESAR, LAMPUNG TENGAH, LAMPUNG",4,21,129,150
https://kawalpemilu.org#22971,"TERBANGGI BESAR, TERBANGGI BESAR, LAMPUNG TENGAH, LAMPUNG",5,33,150,183
https://kawalpemilu.org#22971,"TERBANGGI BESAR, TERBANGGI BESAR, LAMPUNG TENGAH, LAMPUNG",6,112,148,260
https://kawalpemilu.org#22971,"TERBANGGI BESAR, TERBANGGI BESAR, LAMPUNG TENGAH, LAMPUNG",7,67,135,202
https://kawalpemilu.org#22971,"TERBANGGI BESAR, TERBANGGI BESAR, LAMPUNG TENGAH, LAMPUNG",8,55,137,192
https://kawalpemilu.org#22971,"TERBANGGI BESAR, TERBANGGI BESAR, LAMPUNG TENGAH, LAMPUNG",9,19,119,148
https://kawalpemilu.org#22971,"TERBANGGI BESAR, TERBANGGI BESAR, LAMPUNG TENGAH, LAMPUNG",10,94,157,241
https://kawalpemilu.org#22971,"TERBANGGI BESAR, TERBANGGI BESAR, LAMPUNG TENGAH, LAMPUNG",11,72,141,213
https://kawalpemilu.org#22971,"TERBANGGI BESAR, TERBANGGI BESAR, LAMPUNG TENGAH, LAMPUNG",12,75,85,160
https://kawalpemilu.org#22971,"TERBANGGI BESAR, TERBANGGI BESAR, LAMPUNG TENGAH, LAMPUNG",13,29,78,107
https://kawalpemilu.org#22971,"TERBANGGI BESAR, TERBANGGI BESAR, LAMPUNG TENGAH, LAMPUNG",14,69,102,171
https://kawalpemilu.org#22971,"TERBANGGI BESAR, TERBANGGI BESAR, LAMPUNG TENGAH, LAMPUNG",15,130,135,265
https://kawalpemilu.org#22971,"TERBANGGI BESAR, TERBANGGI BESAR, LAMPUNG TENGAH, LAMPUNG",16,135,73,208
https://kawalpemilu.org#22971,"TERBANGGI BESAR, TERBANGGI BESAR, LAMPUNG TENGAH, LAMPUNG",17,129,49,178
https://kawalpemilu.org#22971,"TERBANGGI BESAR, TERBANGGI BESAR, LAMPUNG TENGAH, LAMPUNG",18,96,53,149
https://kawalpemilu.org#22971,"TERBANGGI BESAR, TERBANGGI BESAR, LAMPUNG TENGAH, LAMPUNG",19,112,43,155
https://kawalpemilu.org#22971,"TERBANGGI BESAR, TERBANGGI BESAR, LAMPUNG TENGAH, LAMPUNG",20,138,86,224
https://kawalpemilu.org#22971,"TERBANGGI BESAR, TERBANGGI BESAR, LAMPUNG TENGAH, LAMPUNG",21,194,46,240
https://kawalpemilu.org#22971,"TERBANGGI BESAR, TERBANGGI BESAR, LAMPUNG TENGAH, LAMPUNG",22,155,46,201
https://kawalpemilu.org#22971,"TERBANGGI BESAR, TERBANGGI BESAR, LAMPUNG TENGAH, LAMPUNG",23,133,35,168
https://kawalpemilu.org#22971,"TERBANGGI BESAR, TERBANGGI BESAR, LAMPUNG TENGAH, LAMPUNG",25,168,64,232
https://kawalpemilu.org#22971,"TERBANGGI BESAR, TERBANGGI BESAR, LAMPUNG TENGAH, LAMPUNG",26,157,65,222
https://kawalpemilu.org#22971,"TERBANGGI BESAR, TERBANGGI BESAR, LAMPUNG TENGAH, LAMPUNG",27,80,60,140
https://kawalpemilu.org#22971,"TERBANGGI BESAR, TERBANGGI BESAR, LAMPUNG TENGAH, LAMPUNG",28,223,53,276
https://kawalpemilu.org#22971,"TERBANGGI BESAR, TERBANGGI BESAR, LAMPUNG TENGAH, LAMPUNG",29,110,50,160
https://kawalpemilu.org#22971,"TERBANGGI BESAR, TERBANGGI BESAR, LAMPUNG TENGAH, LAMPUNG",30,126,34,160
https://kawalpemilu.org#22971,"TERBANGGI BESAR, TERBANGGI BESAR, LAMPUNG TENGAH, LAMPUNG",31,182,59,241
https://kawalpemilu.org#22971,"TERBANGGI BESAR, TERBANGGI BESAR, LAMPUNG TENGAH, LAMPUNG",32,116,69,185
https://kawalpemilu.org#22971,"TERBANGGI BESAR, TERBANGGI BESAR, LAMPUNG TENGAH, LAMPUNG",33,151,72,223
https://kawalpemilu.org#22971,"TERBANGGI BESAR, TERBANGGI BESAR, LAMPUNG TENGAH, LAMPUNG",34,119,40,159
https://kawalpemilu.org#22971,"TERBANGGI BESAR, TERBANGGI BESAR, LAMPUNG TENGAH, LAMPUNG",35,155,59,214
https://kawalpemilu.org#22971,"TERBANGGI BESAR, TERBANGGI BESAR, LAMPUNG TENGAH, LAMPUNG",36,97,56,153
https://kawalpemilu.org#22971,"TERBANGGI BESAR, TERBANGGI BESAR, LAMPUNG TENGAH, LAMPUNG",37,169,63,232
https://kawalpemilu.org#22971,"TERBANGGI BESAR, TERBANGGI BESAR, LAMPUNG TENGAH, LAMPUNG",38,125,50,175
https://kawalpemilu.org#22971,"TERBANGGI BESAR, TERBANGGI BESAR, LAMPUNG TENGAH, LAMPUNG",39,74,93,167
https://kawalpemilu.org#22971,"TERBANGGI BESAR, TERBANGGI BESAR, LAMPUNG TENGAH, LAMPUNG",40,84,79,163
https://kawalpemilu.org#22971,"TERBANGGI BESAR, TERBANGGI BESAR, LAMPUNG TENGAH, LAMPUNG",41,94,47,141
https://kawalpemilu.org#22971,"TERBANGGI BESAR, TERBANGGI BESAR, LAMPUNG TENGAH, LAMPUNG",44,141,76,217
https://kawalpemilu.org#22971,"TERBANGGI BESAR, TERBANGGI BESAR, LAMPUNG TENGAH, LAMPUNG",45,71,157,228
https://kawalpemilu.org#22971,"TERBANGGI BESAR, TERBANGGI BESAR, LAMPUNG TENGAH, LAMPUNG",46,63,86,149
https://kawalpemilu.org#22971,"TERBANGGI BESAR, TERBANGGI BESAR, LAMPUNG TENGAH, LAMPUNG",47,42,71,113
https://kawalpemilu.org#22971,"TERBANGGI BESAR, TERBANGGI BESAR, LAMPUNG TENGAH, LAMPUNG",49,154,53,207
https://kawalpemilu.org#22971,"TERBANGGI BESAR, TERBANGGI BESAR, LAMPUNG TENGAH, LAMPUNG",50,103,56,159
https://kawalpemilu.org#22971,"TERBANGGI BESAR, TERBANGGI BESAR, LAMPUNG TENGAH, LAMPUNG",51,149,59,244
https://kawalpemilu.org#22971,"TERBANGGI BESAR, TERBANGGI BESAR, LAMPUNG TENGAH, LAMPUNG",52,80,80,160
https://kawalpemilu.org#22971,"TERBANGGI BESAR, TERBANGGI BESAR, LAMPUNG TENGAH, LAMPUNG",53,85,49,134
https://kawalpemilu.org#22971,"TERBANGGI BESAR, TERBANGGI BESAR, LAMPUNG TENGAH, LAMPUNG",54,156,100,256
https://kawalpemilu.org#22971,"TERBANGGI BESAR, TERBANGGI BESAR, LAMPUNG TENGAH, LAMPUNG",55,135,56,191
https://kawalpemilu.org#22971,"TERBANGGI BESAR, TERBANGGI BESAR, LAMPUNG TENGAH, LAMPUNG",56,95,67,162
https://kawalpemilu.org#22971,"TERBANGGI BESAR, TERBANGGI BESAR, LAMPUNG TENGAH, LAMPUNG",57,97,146,243
https://kawalpemilu.org#22971,"TERBANGGI BESAR, TERBANGGI BESAR, LAMPUNG TENGAH, LAMPUNG",58,108,74,182
https://kawalpemilu.org#22971,"TERBANGGI BESAR, TERBANGGI BESAR, LAMPUNG TENGAH, LAMPUNG",59,94,104,198
https://kawalpemilu.org#22971,"TERBANGGI BESAR, TERBANGGI BESAR, LAMPUNG TENGAH, LAMPUNG",60,116,93,209
https://kawalpemilu.org#22971,"TERBANGGI BESAR, TERBANGGI BESAR, LAMPUNG TENGAH, LAMPUNG",61,109,121,230
https://kawalpemilu.org#22971,"TERBANGGI BESAR, TERBANGGI BESAR, LAMPUNG TENGAH, LAMPUNG",62,103,119,222
https://kawalpemilu.org#22971,"TERBANGGI BESAR, TERBANGGI BESAR, LAMPUNG TENGAH, LAMPUNG",63,108,50,158
https://kawalpemilu.org#22971,"TERBANGGI BESAR, TERBANGGI BESAR, LAMPUNG TENGAH, LAMPUNG",64,38,141,179
https://kawalpemilu.org#22971,"TERBANGGI BESAR, TERBANGGI BESAR, LAMPUNG TENGAH, LAMPUNG",65,0,0,156
https://kawalpemilu.org#22971,"TERBANGGI BESAR, TERBANGGI BESAR, LAMPUNG TENGAH, LAMPUNG",66,24,112,136
https://kawalpemilu.org#22971,"TERBANGGI BESAR, TERBANGGI BESAR, LAMPUNG TENGAH, LAMPUNG",67,59,128,187
https://kawalpemilu.org#22971,"TERBANGGI BESAR, TERBANGGI BESAR, LAMPUNG TENGAH, LAMPUNG",68,92,54,146
https://kawalpemilu.org#22971,"TERBANGGI BESAR, TERBANGGI BESAR, LAMPUNG TENGAH, LAMPUNG",69,30,131,161
https://kawalpemilu.org#22971,"TERBANGGI BESAR, TERBANGGI BESAR, LAMPUNG TENGAH, LAMPUNG",70,36,132,168
https://kawalpemilu.org#22971,"TERBANGGI BESAR, TERBANGGI BESAR, LAMPUNG TENGAH, LAMPUNG",71,113,37,150
https://kawalpemilu.org#22971,"TERBANGGI BESAR, TERBANGGI BESAR, LAMPUNG TENGAH, LAMPUNG",72,97,36,133
https://kawalpemilu.org#22971,"TERBANGGI BESAR, TERBANGGI BESAR, LAMPUNG TENGAH, LAMPUNG",73,86,53,139
https://kawalpemilu.org#22971,"TERBANGGI BESAR, TERBANGGI BESAR, LAMPUNG TENGAH, LAMPUNG",74,125,56,181
https://kawalpemilu.org#22971,"TERBANGGI BESAR, TERBANGGI BESAR, LAMPUNG TENGAH, LAMPUNG",75,94,40,134
https://kawalpemilu.org#22971,"TERBANGGI BESAR, TERBANGGI BESAR, LAMPUNG TENGAH, LAMPUNG",76,90,69,159
https://kawalpemilu.org#22971,"TERBANGGI BESAR, TERBANGGI BESAR, LAMPUNG TENGAH, LAMPUNG",77,90,75,165
https://kawalpemilu.org#22971,"TERBANGGI BESAR, TERBANGGI BESAR, LAMPUNG TENGAH, LAMPUNG",78,123,49,179
https://kawalpemilu.org#22972,"PONCO WATI, TERBANGGI BESAR, LAMPUNG TENGAH, LAMPUNG",1,164,48,212
https://kawalpemilu.org#22972,"PONCO WATI, TERBANGGI BESAR, LAMPUNG TENGAH, LAMPUNG",2,96,109,205
https://kawalpemilu.org#22972,"PONCO WATI, TERBANGGI BESAR, LAMPUNG TENGAH, LAMPUNG",3,116,91,207
https://kawalpemilu.org#22972,"PONCO WATI, TERBANGGI BESAR, LAMPUNG TENGAH, LAMPUNG",4,48,81,129
https://kawalpemilu.org#22972,"PONCO WATI, TERBANGGI BESAR, LAMPUNG TENGAH, LAMPUNG",5,62,80,142
https://kawalpemilu.org#22972,"PONCO WATI, TERBANGGI BESAR, LAMPUNG TENGAH, LAMPUNG",6,95,123,218
https://kawalpemilu.org#22972,"PONCO WATI, TERBANGGI BESAR, LAMPUNG TENGAH, LAMPUNG",7,118,85,203
https://kawalpemilu.org#22972,"PONCO WATI, TERBANGGI BESAR, LAMPUNG TENGAH, LAMPUNG",8,111,111,222
https://kawalpemilu.org#22972,"PONCO WATI, TERBANGGI BESAR, LAMPUNG TENGAH, LAMPUNG",9,84,97,163
https://kawalpemilu.org#22972,"PONCO WATI, TERBANGGI BESAR, LAMPUNG TENGAH, LAMPUNG",10,51,80,131
https://kawalpemilu.org#22972,"PONCO WATI, TERBANGGI BESAR, LAMPUNG TENGAH, LAMPUNG",11,131,92,223
https://kawalpemilu.org#22972,"PONCO WATI, TERBANGGI BESAR, LAMPUNG TENGAH, LAMPUNG",12,57,81,138
https://kawalpemilu.org#22972,"PONCO WATI, TERBANGGI BESAR, LAMPUNG TENGAH, LAMPUNG",13,161,42,203
https://kawalpemilu.org#22972,"PONCO WATI, TERBANGGI BESAR, LAMPUNG TENGAH, LAMPUNG",14,118,34,152
https://kawalpemilu.org#22972,"PONCO WATI, TERBANGGI BESAR, LAMPUNG TENGAH, LAMPUNG",15,88,156,244
https://kawalpemilu.org#22972,"PONCO WATI, TERBANGGI BESAR, LAMPUNG TENGAH, LAMPUNG",16,87,96,183
https://kawalpemilu.org#22972,"PONCO WATI, TERBANGGI BESAR, LAMPUNG TENGAH, LAMPUNG",17,79,85,164
https://kawalpemilu.org#22972,"PONCO WATI, TERBANGGI BESAR, LAMPUNG TENGAH, LAMPUNG",18,74,103,177
https://kawalpemilu.org#22972,"PONCO WATI, TERBANGGI BESAR, LAMPUNG TENGAH, LAMPUNG",19,118,96,214
https://kawalpemilu.org#22972,"PONCO WATI, TERBANGGI BESAR, LAMPUNG TENGAH, LAMPUNG",20,76,63,139
https://kawalpemilu.org#22972,"PONCO WATI, TERBANGGI BESAR, LAMPUNG TENGAH, LAMPUNG",21,66,103,169
https://kawalpemilu.org#22972,"PONCO WATI, TERBANGGI BESAR, LAMPUNG TENGAH, LAMPUNG",22,71,108,179
https://kawalpemilu.org#22972,"PONCO WATI, TERBANGGI BESAR, LAMPUNG TENGAH, LAMPUNG",23,57,69,126
https://kawalpemilu.org#22972,"PONCO WATI, TERBANGGI BESAR, LAMPUNG TENGAH, LAMPUNG",24,53,55,108
https://kawalpemilu.org#22972,"PONCO WATI, TERBANGGI BESAR, LAMPUNG TENGAH, LAMPUNG",25,54,75,129
https://kawalpemilu.org#22974,"REJO BASUKI, SEPUTIH RAMAN, LAMPUNG TENGAH, LAMPUNG",1,96,95,191
https://kawalpemilu.org#22974,"REJO BASUKI, SEPUTIH RAMAN, LAMPUNG TENGAH, LAMPUNG",2,108,86,194
https://kawalpemilu.org#22974,"REJO BASUKI, SEPUTIH RAMAN, LAMPUNG TENGAH, LAMPUNG",3,165,45,210
https://kawalpemilu.org#22974,"REJO BASUKI, SEPUTIH RAMAN, LAMPUNG TENGAH, LAMPUNG",4,139,98,237
https://kawalpemilu.org#22974,"REJO BASUKI, SEPUTIH RAMAN, LAMPUNG TENGAH, LAMPUNG",5,156,52,208
https://kawalpemilu.org#22974,"REJO BASUKI, SEPUTIH RAMAN, LAMPUNG TENGAH, LAMPUNG",6,168,68,236
https://kawalpemilu.org#22974,"REJO BASUKI, SEPUTIH RAMAN, LAMPUNG TENGAH, LAMPUNG",7,187,61,248
https://kawalpemilu.org#22974,"REJO BASUKI, SEPUTIH RAMAN, LAMPUNG TENGAH, LAMPUNG",8,135,73,208
https://kawalpemilu.org#22974,"REJO BASUKI, SEPUTIH RAMAN, LAMPUNG TENGAH, LAMPUNG",9,145,35,180
https://kawalpemilu.org#22974,"REJO BASUKI, SEPUTIH RAMAN, LAMPUNG TENGAH, LAMPUNG",10,205,33,238
https://kawalpemilu.org#22974,"REJO BASUKI, SEPUTIH RAMAN, LAMPUNG TENGAH, LAMPUNG",11,127,59,186
https://kawalpemilu.org#22975,"REJO ASRI, SEPUTIH RAMAN, LAMPUNG TENGAH, LAMPUNG",1,110,30,140
https://kawalpemilu.org#22975,"REJO ASRI, SEPUTIH RAMAN, LAMPUNG TENGAH, LAMPUNG",2,140,31,171
https://kawalpemilu.org#22975,"REJO ASRI, SEPUTIH RAMAN, LAMPUNG TENGAH, LAMPUNG",3,111,40,151
https://kawalpemilu.org#22975,"REJO ASRI, SEPUTIH RAMAN, LAMPUNG TENGAH, LAMPUNG",4,71,27,98
https://kawalpemilu.org#22975,"REJO ASRI, SEPUTIH RAMAN, LAMPUNG TENGAH, LAMPUNG",5,79,49,128
https://kawalpemilu.org#22975,"REJO ASRI, SEPUTIH RAMAN, LAMPUNG TENGAH, LAMPUNG",6,83,62,145
https://kawalpemilu.org#22975,"REJO ASRI, SEPUTIH RAMAN, LAMPUNG TENGAH, LAMPUNG",7,93,34,127
https://kawalpemilu.org#22975,"REJO ASRI, SEPUTIH RAMAN, LAMPUNG TENGAH, LAMPUNG",8,137,24,161
https://kawalpemilu.org#22975,"REJO ASRI, SEPUTIH RAMAN, LAMPUNG TENGAH, LAMPUNG",9,141,39,180
https://kawalpemilu.org#22975,"REJO ASRI, SEPUTIH RAMAN, LAMPUNG TENGAH, LAMPUNG",10,86,125,211
https://kawalpemilu.org#22975,"REJO ASRI, SEPUTIH RAMAN, LAMPUNG TENGAH, LAMPUNG",11,90,83,173
https://kawalpemilu.org#22975,"REJO ASRI, SEPUTIH RAMAN, LAMPUNG TENGAH, LAMPUNG",12,156,24,180
https://kawalpemilu.org#22975,"REJO ASRI, SEPUTIH RAMAN, LAMPUNG TENGAH, LAMPUNG",13,152,17,169
https://kawalpemilu.org#22975,"REJO ASRI, SEPUTIH RAMAN, LAMPUNG TENGAH, LAMPUNG",14,148,24,172
https://kawalpemilu.org#22975,"REJO ASRI, SEPUTIH RAMAN, LAMPUNG TENGAH, LAMPUNG",15,113,53,166
https://kawalpemilu.org#22975,"REJO ASRI, SEPUTIH RAMAN, LAMPUNG TENGAH, LAMPUNG",16,147,59,206
https://kawalpemilu.org#22975,"REJO ASRI, SEPUTIH RAMAN, LAMPUNG TENGAH, LAMPUNG",17,141,74,215
https://kawalpemilu.org#22976,"RUKTI ENDAH, SEPUTIH RAMAN, LAMPUNG TENGAH, LAMPUNG",1,135,42,177
https://kawalpemilu.org#22976,"RUKTI ENDAH, SEPUTIH RAMAN, LAMPUNG TENGAH, LAMPUNG",2,106,75,181
https://kawalpemilu.org#22976,"RUKTI ENDAH, SEPUTIH RAMAN, LAMPUNG TENGAH, LAMPUNG",3,108,14,122
https://kawalpemilu.org#22976,"RUKTI ENDAH, SEPUTIH RAMAN, LAMPUNG TENGAH, LAMPUNG",4,108,15,123
https://kawalpemilu.org#22976,"RUKTI ENDAH, SEPUTIH RAMAN, LAMPUNG TENGAH, LAMPUNG",6,189,21,210
https://kawalpemilu.org#22976,"RUKTI ENDAH, SEPUTIH RAMAN, LAMPUNG TENGAH, LAMPUNG",7,149,16,165
https://kawalpemilu.org#22976,"RUKTI ENDAH, SEPUTIH RAMAN, LAMPUNG TENGAH, LAMPUNG",8,132,17,149
https://kawalpemilu.org#22976,"RUKTI ENDAH, SEPUTIH RAMAN, LAMPUNG TENGAH, LAMPUNG",9,185,9,194
https://kawalpemilu.org#22976,"RUKTI ENDAH, SEPUTIH RAMAN, LAMPUNG TENGAH, LAMPUNG",10,119,23,142
https://kawalpemilu.org#22976,"RUKTI ENDAH, SEPUTIH RAMAN, LAMPUNG TENGAH, LAMPUNG",11,110,31,141
https://kawalpemilu.org#22976,"RUKTI ENDAH, SEPUTIH RAMAN, LAMPUNG TENGAH, LAMPUNG",12,164,27,191
https://kawalpemilu.org#22976,"RUKTI ENDAH, SEPUTIH RAMAN, LAMPUNG TENGAH, LAMPUNG",14,124,42,166
https://kawalpemilu.org#22976,"RUKTI ENDAH, SEPUTIH RAMAN, LAMPUNG TENGAH, LAMPUNG",15,137,35,172
https://kawalpemilu.org#22976,"RUKTI ENDAH, SEPUTIH RAMAN, LAMPUNG TENGAH, LAMPUNG",16,154,19,173
https://kawalpemilu.org#22977,"RAMA DEWA, SEPUTIH RAMAN, LAMPUNG TENGAH, LAMPUNG",1,123,24,147
https://kawalpemilu.org#22977,"RAMA DEWA, SEPUTIH RAMAN, LAMPUNG TENGAH, LAMPUNG",2,112,59,171
https://kawalpemilu.org#22977,"RAMA DEWA, SEPUTIH RAMAN, LAMPUNG TENGAH, LAMPUNG",3,169,6,175
https://kawalpemilu.org#22977,"RAMA DEWA, SEPUTIH RAMAN, LAMPUNG TENGAH, LAMPUNG",4,131,2,133
https://kawalpemilu.org#22977,"RAMA DEWA, SEPUTIH RAMAN, LAMPUNG TENGAH, LAMPUNG",5,148,11,159
https://kawalpemilu.org#22977,"RAMA DEWA, SEPUTIH RAMAN, LAMPUNG TENGAH, LAMPUNG",6,165,3,168
https://kawalpemilu.org#22977,"RAMA DEWA, SEPUTIH RAMAN, LAMPUNG TENGAH, LAMPUNG",7,147,18,165
https://kawalpemilu.org#22977,"RAMA DEWA, SEPUTIH RAMAN, LAMPUNG TENGAH, LAMPUNG",8,159,10,169
https://kawalpemilu.org#22977,"RAMA DEWA, SEPUTIH RAMAN, LAMPUNG TENGAH, LAMPUNG",9,136,16,152
https://kawalpemilu.org#22977,"RAMA DEWA, SEPUTIH RAMAN, LAMPUNG TENGAH, LAMPUNG",10,130,26,156
https://kawalpemilu.org#22978,"RATNA CHATON, SEPUTIH RAMAN, LAMPUNG TENGAH, LAMPUNG",1,93,86,179
https://kawalpemilu.org#22978,"RATNA CHATON, SEPUTIH RAMAN, LAMPUNG TENGAH, LAMPUNG",2,92,93,185
https://kawalpemilu.org#22978,"RATNA CHATON, SEPUTIH RAMAN, LAMPUNG TENGAH, LAMPUNG",3,117,74,191
https://kawalpemilu.org#22978,"RATNA CHATON, SEPUTIH RAMAN, LAMPUNG TENGAH, LAMPUNG",4,181,64,245
https://kawalpemilu.org#22978,"RATNA CHATON, SEPUTIH RAMAN, LAMPUNG TENGAH, LAMPUNG",5,167,61,228
https://kawalpemilu.org#22978,"RATNA CHATON, SEPUTIH RAMAN, LAMPUNG TENGAH, LAMPUNG",6,172,68,240
https://kawalpemilu.org#22978,"RATNA CHATON, SEPUTIH RAMAN, LAMPUNG TENGAH, LAMPUNG",7,183,49,232
https://kawalpemilu.org#22978,"RATNA CHATON, SEPUTIH RAMAN, LAMPUNG TENGAH, LAMPUNG",8,187,46,233
https://kawalpemilu.org#22978,"RATNA CHATON, SEPUTIH RAMAN, LAMPUNG TENGAH, LAMPUNG",9,193,32,225
https://kawalpemilu.org#22979,"RAMAYANA, SEPUTIH RAMAN, LAMPUNG TENGAH, LAMPUNG",1,181,62,243
https://kawalpemilu.org#22979,"RAMAYANA, SEPUTIH RAMAN, LAMPUNG TENGAH, LAMPUNG",2,160,72,232
https://kawalpemilu.org#22979,"RAMAYANA, SEPUTIH RAMAN, LAMPUNG TENGAH, LAMPUNG",3,193,41,234
https://kawalpemilu.org#22979,"RAMAYANA, SEPUTIH RAMAN, LAMPUNG TENGAH, LAMPUNG",4,145,74,219
https://kawalpemilu.org#22979,"RAMAYANA, SEPUTIH RAMAN, LAMPUNG TENGAH, LAMPUNG",5,151,31,182
https://kawalpemilu.org#22979,"RAMAYANA, SEPUTIH RAMAN, LAMPUNG TENGAH, LAMPUNG",6,196,35,231
https://kawalpemilu.org#22979,"RAMAYANA, SEPUTIH RAMAN, LAMPUNG TENGAH, LAMPUNG",7,149,76,225
https://kawalpemilu.org#22979,"RAMAYANA, SEPUTIH RAMAN, LAMPUNG TENGAH, LAMPUNG",8,166,59,225
https://kawalpemilu.org#22979,"RAMAYANA, SEPUTIH RAMAN, LAMPUNG TENGAH, LAMPUNG",9,173,37,210
https://kawalpemilu.org#22980,"RAMA INDRA, SEPUTIH RAMAN, LAMPUNG TENGAH, LAMPUNG",1,185,52,237
https://kawalpemilu.org#22980,"RAMA INDRA, SEPUTIH RAMAN, LAMPUNG TENGAH, LAMPUNG",2,184,43,227
https://kawalpemilu.org#22980,"RAMA INDRA, SEPUTIH RAMAN, LAMPUNG TENGAH, LAMPUNG",3,209,54,263
https://kawalpemilu.org#22980,"RAMA INDRA, SEPUTIH RAMAN, LAMPUNG TENGAH, LAMPUNG",4,203,29,232
https://kawalpemilu.org#22980,"RAMA INDRA, SEPUTIH RAMAN, LAMPUNG TENGAH, LAMPUNG",5,152,84,236
https://kawalpemilu.org#22980,"RAMA INDRA, SEPUTIH RAMAN, LAMPUNG TENGAH, LAMPUNG",6,142,53,195
https://kawalpemilu.org#22980,"RAMA INDRA, SEPUTIH RAMAN, LAMPUNG TENGAH, LAMPUNG",7,159,30,189
https://kawalpemilu.org#22980,"RAMA INDRA, SEPUTIH RAMAN, LAMPUNG TENGAH, LAMPUNG",8,145,31,176
https://kawalpemilu.org#22981,"RUKTI HARJO, SEPUTIH RAMAN, LAMPUNG TENGAH, LAMPUNG",1,139,66,205
https://kawalpemilu.org#22981,"RUKTI HARJO, SEPUTIH RAMAN, LAMPUNG TENGAH, LAMPUNG",2,162,64,226
https://kawalpemilu.org#22981,"RUKTI HARJO, SEPUTIH RAMAN, LAMPUNG TENGAH, LAMPUNG",3,126,101,227
https://kawalpemilu.org#22981,"RUKTI HARJO, SEPUTIH RAMAN, LAMPUNG TENGAH, LAMPUNG",4,143,43,186
https://kawalpemilu.org#22981,"RUKTI HARJO, SEPUTIH RAMAN, LAMPUNG TENGAH, LAMPUNG",5,150,54,204
https://kawalpemilu.org#22981,"RUKTI HARJO, SEPUTIH RAMAN, LAMPUNG TENGAH, LAMPUNG",6,148,94,242
https://kawalpemilu.org#22981,"RUKTI HARJO, SEPUTIH RAMAN, LAMPUNG TENGAH, LAMPUNG",7,107,113,220
https://kawalpemilu.org#22981,"RUKTI HARJO, SEPUTIH RAMAN, LAMPUNG TENGAH, LAMPUNG",8,137,61,198
https://kawalpemilu.org#22981,"RUKTI HARJO, SEPUTIH RAMAN, LAMPUNG TENGAH, LAMPUNG",9,166,16,182
https://kawalpemilu.org#22981,"RUKTI HARJO, SEPUTIH RAMAN, LAMPUNG TENGAH, LAMPUNG",10,159,60,219
https://kawalpemilu.org#22981,"RUKTI HARJO, SEPUTIH RAMAN, LAMPUNG TENGAH, LAMPUNG",11,134,70,204
https://kawalpemilu.org#22981,"RUKTI HARJO, SEPUTIH RAMAN, LAMPUNG TENGAH, LAMPUNG",12,176,39,215
https://kawalpemilu.org#22981,"RUKTI HARJO, SEPUTIH RAMAN, LAMPUNG TENGAH, LAMPUNG",13,155,23,178
https://kawalpemilu.org#22981,"RUKTI HARJO, SEPUTIH RAMAN, LAMPUNG TENGAH, LAMPUNG",14,182,18,200
https://kawalpemilu.org#22981,"RUKTI HARJO, SEPUTIH RAMAN, LAMPUNG TENGAH, LAMPUNG",15,163,64,227
https://kawalpemilu.org#22981,"RUKTI HARJO, SEPUTIH RAMAN, LAMPUNG TENGAH, LAMPUNG",16,130,36,166
https://kawalpemilu.org#22981,"RUKTI HARJO, SEPUTIH RAMAN, LAMPUNG TENGAH, LAMPUNG",17,114,31,145
https://kawalpemilu.org#22981,"RUKTI HARJO, SEPUTIH RAMAN, LAMPUNG TENGAH, LAMPUNG",18,156,56,212
https://kawalpemilu.org#22982,"RAMA GUNAWAN, SEPUTIH RAMAN, LAMPUNG TENGAH, LAMPUNG",1,176,58,234
https://kawalpemilu.org#22982,"RAMA GUNAWAN, SEPUTIH RAMAN, LAMPUNG TENGAH, LAMPUNG",2,155,68,223
https://kawalpemilu.org#22982,"RAMA GUNAWAN, SEPUTIH RAMAN, LAMPUNG TENGAH, LAMPUNG",3,231,23,254
https://kawalpemilu.org#22982,"RAMA GUNAWAN, SEPUTIH RAMAN, LAMPUNG TENGAH, LAMPUNG",4,211,16,227
https://kawalpemilu.org#22982,"RAMA GUNAWAN, SEPUTIH RAMAN, LAMPUNG TENGAH, LAMPUNG",5,180,1,181
https://kawalpemilu.org#22982,"RAMA GUNAWAN, SEPUTIH RAMAN, LAMPUNG TENGAH, LAMPUNG",6,181,38,219
https://kawalpemilu.org#22982,"RAMA GUNAWAN, SEPUTIH RAMAN, LAMPUNG TENGAH, LAMPUNG",7,177,13,190
https://kawalpemilu.org#22982,"RAMA GUNAWAN, SEPUTIH RAMAN, LAMPUNG TENGAH, LAMPUNG",8,195,20,215
https://kawalpemilu.org#22982,"RAMA GUNAWAN, SEPUTIH RAMAN, LAMPUNG TENGAH, LAMPUNG",9,191,26,217
https://kawalpemilu.org#22983,"RAMA OETAMA, SEPUTIH RAMAN, LAMPUNG TENGAH, LAMPUNG",1,225,10,235
https://kawalpemilu.org#22983,"RAMA OETAMA, SEPUTIH RAMAN, LAMPUNG TENGAH, LAMPUNG",2,184,49,233
https://kawalpemilu.org#22983,"RAMA OETAMA, SEPUTIH RAMAN, LAMPUNG TENGAH, LAMPUNG",3,177,31,208
https://kawalpemilu.org#22983,"RAMA OETAMA, SEPUTIH RAMAN, LAMPUNG TENGAH, LAMPUNG",4,199,27,226
https://kawalpemilu.org#22983,"RAMA OETAMA, SEPUTIH RAMAN, LAMPUNG TENGAH, LAMPUNG",5,45,69,114
https://kawalpemilu.org#22983,"RAMA OETAMA, SEPUTIH RAMAN, LAMPUNG TENGAH, LAMPUNG",6,102,146,248
https://kawalpemilu.org#22983,"RAMA OETAMA, SEPUTIH RAMAN, LAMPUNG TENGAH, LAMPUNG",7,145,95,240
https://kawalpemilu.org#22983,"RAMA OETAMA, SEPUTIH RAMAN, LAMPUNG TENGAH, LAMPUNG",8,108,151,259
https://kawalpemilu.org#22983,"RAMA OETAMA, SEPUTIH RAMAN, LAMPUNG TENGAH, LAMPUNG",9,101,112,213
https://kawalpemilu.org#22983,"RAMA OETAMA, SEPUTIH RAMAN, LAMPUNG TENGAH, LAMPUNG",10,118,90,208
https://kawalpemilu.org#22983,"RAMA OETAMA, SEPUTIH RAMAN, LAMPUNG TENGAH, LAMPUNG",11,52,59,111
https://kawalpemilu.org#22984,"RAMA NIRWANA, SEPUTIH RAMAN, LAMPUNG TENGAH, LAMPUNG",1,157,54,211
https://kawalpemilu.org#22984,"RAMA NIRWANA, SEPUTIH RAMAN, LAMPUNG TENGAH, LAMPUNG",2,141,64,205
https://kawalpemilu.org#22984,"RAMA NIRWANA, SEPUTIH RAMAN, LAMPUNG TENGAH, LAMPUNG",3,138,96,234
https://kawalpemilu.org#22984,"RAMA NIRWANA, SEPUTIH RAMAN, LAMPUNG TENGAH, LAMPUNG",4,129,76,205
https://kawalpemilu.org#22984,"RAMA NIRWANA, SEPUTIH RAMAN, LAMPUNG TENGAH, LAMPUNG",5,172,18,190
https://kawalpemilu.org#22984,"RAMA NIRWANA, SEPUTIH RAMAN, LAMPUNG TENGAH, LAMPUNG",6,258,9,267
https://kawalpemilu.org#22984,"RAMA NIRWANA, SEPUTIH RAMAN, LAMPUNG TENGAH, LAMPUNG",7,228,13,241
https://kawalpemilu.org#22984,"RAMA NIRWANA, SEPUTIH RAMAN, LAMPUNG TENGAH, LAMPUNG",8,233,8,241
https://kawalpemilu.org#22985,"RAMA MURTI, SEPUTIH RAMAN, LAMPUNG TENGAH, LAMPUNG",1,180,39,219
https://kawalpemilu.org#22985,"RAMA MURTI, SEPUTIH RAMAN, LAMPUNG TENGAH, LAMPUNG",2,189,7,196
https://kawalpemilu.org#22985,"RAMA MURTI, SEPUTIH RAMAN, LAMPUNG TENGAH, LAMPUNG",3,162,17,179
https://kawalpemilu.org#22985,"RAMA MURTI, SEPUTIH RAMAN, LAMPUNG TENGAH, LAMPUNG",4,151,28,179
https://kawalpemilu.org#22985,"RAMA MURTI, SEPUTIH RAMAN, LAMPUNG TENGAH, LAMPUNG",5,159,23,182
https://kawalpemilu.org#22985,"RAMA MURTI, SEPUTIH RAMAN, LAMPUNG TENGAH, LAMPUNG",6,176,24,200
https://kawalpemilu.org#22985,"RAMA MURTI, SEPUTIH RAMAN, LAMPUNG TENGAH, LAMPUNG",7,196,12,208
https://kawalpemilu.org#22986,"RAMA KLANDUNGAN, SEPUTIH RAMAN, LAMPUNG TENGAH, LAMPUNG",1,162,60,222
https://kawalpemilu.org#22986,"RAMA KLANDUNGAN, SEPUTIH RAMAN, LAMPUNG TENGAH, LAMPUNG",2,156,78,234
https://kawalpemilu.org#22986,"RAMA KLANDUNGAN, SEPUTIH RAMAN, LAMPUNG TENGAH, LAMPUNG",3,110,79,189
https://kawalpemilu.org#22986,"RAMA KLANDUNGAN, SEPUTIH RAMAN, LAMPUNG TENGAH, LAMPUNG",4,112,84,196
https://kawalpemilu.org#22986,"RAMA KLANDUNGAN, SEPUTIH RAMAN, LAMPUNG TENGAH, LAMPUNG",5,131,31,162
https://kawalpemilu.org#22986,"RAMA KLANDUNGAN, SEPUTIH RAMAN, LAMPUNG TENGAH, LAMPUNG",6,138,25,163
https://kawalpemilu.org#22986,"RAMA KLANDUNGAN, SEPUTIH RAMAN, LAMPUNG TENGAH, LAMPUNG",7,112,44,156
https://kawalpemilu.org#22986,"RAMA KLANDUNGAN, SEPUTIH RAMAN, LAMPUNG TENGAH, LAMPUNG",8,139,33,172
https://kawalpemilu.org#22986,"RAMA KLANDUNGAN, SEPUTIH RAMAN, LAMPUNG TENGAH, LAMPUNG",9,164,46,210
https://kawalpemilu.org#22987,"BUYUT BARU, SEPUTIH RAMAN, LAMPUNG TENGAH, LAMPUNG",1,155,24,179
https://kawalpemilu.org#22987,"BUYUT BARU, SEPUTIH RAMAN, LAMPUNG TENGAH, LAMPUNG",2,139,5,144
https://kawalpemilu.org#22987,"BUYUT BARU, SEPUTIH RAMAN, LAMPUNG TENGAH, LAMPUNG",3,134,57,191
https://kawalpemilu.org#22987,"BUYUT BARU, SEPUTIH RAMAN, LAMPUNG TENGAH, LAMPUNG",4,192,36,228
https://kawalpemilu.org#22987,"BUYUT BARU, SEPUTIH RAMAN, LAMPUNG TENGAH, LAMPUNG",5,151,34,185
https://kawalpemilu.org#22987,"BUYUT BARU, SEPUTIH RAMAN, LAMPUNG TENGAH, LAMPUNG",6,147,50,197
https://kawalpemilu.org#22989,"TELUK DALEM ILIR, RUMBIA, LAMPUNG TENGAH, LAMPUNG",1,121,101,222
https://kawalpemilu.org#22989,"TELUK DALEM ILIR, RUMBIA, LAMPUNG TENGAH, LAMPUNG",2,120,61,181
https://kawalpemilu.org#22989,"TELUK DALEM ILIR, RUMBIA, LAMPUNG TENGAH, LAMPUNG",3,110,100,210
https://kawalpemilu.org#22989,"TELUK DALEM ILIR, RUMBIA, LAMPUNG TENGAH, LAMPUNG",4,111,85,196
https://kawalpemilu.org#22989,"TELUK DALEM ILIR, RUMBIA, LAMPUNG TENGAH, LAMPUNG",5,132,48,180
https://kawalpemilu.org#22989,"TELUK DALEM ILIR, RUMBIA, LAMPUNG TENGAH, LAMPUNG",6,103,87,190
https://kawalpemilu.org#22989,"TELUK DALEM ILIR, RUMBIA, LAMPUNG TENGAH, LAMPUNG",7,102,80,182
https://kawalpemilu.org#22989,"TELUK DALEM ILIR, RUMBIA, LAMPUNG TENGAH, LAMPUNG",8,130,53,183
https://kawalpemilu.org#22989,"TELUK DALEM ILIR, RUMBIA, LAMPUNG TENGAH, LAMPUNG",9,146,65,211
https://kawalpemilu.org#22990,"REKSO BINANGUN, RUMBIA, LAMPUNG TENGAH, LAMPUNG",1,123,51,174
https://kawalpemilu.org#22990,"REKSO BINANGUN, RUMBIA, LAMPUNG TENGAH, LAMPUNG",2,162,46,208
https://kawalpemilu.org#22990,"REKSO BINANGUN, RUMBIA, LAMPUNG TENGAH, LAMPUNG",3,134,89,232
https://kawalpemilu.org#22990,"REKSO BINANGUN, RUMBIA, LAMPUNG TENGAH, LAMPUNG",4,182,26,208
https://kawalpemilu.org#22990,"REKSO BINANGUN, RUMBIA, LAMPUNG TENGAH, LAMPUNG",5,171,22,193
https://kawalpemilu.org#22990,"REKSO BINANGUN, RUMBIA, LAMPUNG TENGAH, LAMPUNG",6,162,28,190
https://kawalpemilu.org#22990,"REKSO BINANGUN, RUMBIA, LAMPUNG TENGAH, LAMPUNG",7,208,23,231
https://kawalpemilu.org#22990,"REKSO BINANGUN, RUMBIA, LAMPUNG TENGAH, LAMPUNG",8,177,58,235
https://kawalpemilu.org#22990,"REKSO BINANGUN, RUMBIA, LAMPUNG TENGAH, LAMPUNG",9,141,47,188
https://kawalpemilu.org#22990,"REKSO BINANGUN, RUMBIA, LAMPUNG TENGAH, LAMPUNG",10,104,48,152
https://kawalpemilu.org#22990,"REKSO BINANGUN, RUMBIA, LAMPUNG TENGAH, LAMPUNG",11,139,60,199
https://kawalpemilu.org#22990,"REKSO BINANGUN, RUMBIA, LAMPUNG TENGAH, LAMPUNG",12,169,74,243
https://kawalpemilu.org#22990,"REKSO BINANGUN, RUMBIA, LAMPUNG TENGAH, LAMPUNG",13,163,40,203
https://kawalpemilu.org#22990,"REKSO BINANGUN, RUMBIA, LAMPUNG TENGAH, LAMPUNG",14,182,32,214
https://kawalpemilu.org#22991,"RUKTI BASUKI, RUMBIA, LAMPUNG TENGAH, LAMPUNG",1,138,78,216
https://kawalpemilu.org#22991,"RUKTI BASUKI, RUMBIA, LAMPUNG TENGAH, LAMPUNG",2,160,79,239
https://kawalpemilu.org#22991,"RUKTI BASUKI, RUMBIA, LAMPUNG TENGAH, LAMPUNG",3,170,60,230
https://kawalpemilu.org#22991,"RUKTI BASUKI, RUMBIA, LAMPUNG TENGAH, LAMPUNG",4,144,85,229
https://kawalpemilu.org#22991,"RUKTI BASUKI, RUMBIA, LAMPUNG TENGAH, LAMPUNG",5,179,20,199
https://kawalpemilu.org#22991,"RUKTI BASUKI, RUMBIA, LAMPUNG TENGAH, LAMPUNG",6,165,47,212
https://kawalpemilu.org#22991,"RUKTI BASUKI, RUMBIA, LAMPUNG TENGAH, LAMPUNG",7,147,52,199
https://kawalpemilu.org#22991,"RUKTI BASUKI, RUMBIA, LAMPUNG TENGAH, LAMPUNG",8,190,54,244
https://kawalpemilu.org#22991,"RUKTI BASUKI, RUMBIA, LAMPUNG TENGAH, LAMPUNG",9,133,48,181
https://kawalpemilu.org#22991,"RUKTI BASUKI, RUMBIA, LAMPUNG TENGAH, LAMPUNG",10,129,54,183
https://kawalpemilu.org#22991,"RUKTI BASUKI, RUMBIA, LAMPUNG TENGAH, LAMPUNG",11,123,54,177
https://kawalpemilu.org#22991,"RUKTI BASUKI, RUMBIA, LAMPUNG TENGAH, LAMPUNG",12,123,99,222
https://kawalpemilu.org#22991,"RUKTI BASUKI, RUMBIA, LAMPUNG TENGAH, LAMPUNG",13,165,59,224
https://kawalpemilu.org#22991,"RUKTI BASUKI, RUMBIA, LAMPUNG TENGAH, LAMPUNG",14,170,47,217
https://kawalpemilu.org#22991,"RUKTI BASUKI, RUMBIA, LAMPUNG TENGAH, LAMPUNG",15,138,98,236
https://kawalpemilu.org#22991,"RUKTI BASUKI, RUMBIA, LAMPUNG TENGAH, LAMPUNG",16,161,59,220
https://kawalpemilu.org#22991,"RUKTI BASUKI, RUMBIA, LAMPUNG TENGAH, LAMPUNG",17,143,69,212
https://kawalpemilu.org#22991,"RUKTI BASUKI, RUMBIA, LAMPUNG TENGAH, LAMPUNG",18,148,49,197
https://kawalpemilu.org#22991,"RUKTI BASUKI, RUMBIA, LAMPUNG TENGAH, LAMPUNG",19,120,71,191
https://kawalpemilu.org#22991,"RUKTI BASUKI, RUMBIA, LAMPUNG TENGAH, LAMPUNG",20,135,39,174
https://kawalpemilu.org#22992,"RESTU BARU, RUMBIA, LAMPUNG TENGAH, LAMPUNG",1,153,50,203
https://kawalpemilu.org#22992,"RESTU BARU, RUMBIA, LAMPUNG TENGAH, LAMPUNG",2,158,84,242
https://kawalpemilu.org#22992,"RESTU BARU, RUMBIA, LAMPUNG TENGAH, LAMPUNG",3,129,70,199
https://kawalpemilu.org#22992,"RESTU BARU, RUMBIA, LAMPUNG TENGAH, LAMPUNG",4,148,64,212
https://kawalpemilu.org#22992,"RESTU BARU, RUMBIA, LAMPUNG TENGAH, LAMPUNG",5,187,27,214
https://kawalpemilu.org#22992,"RESTU BARU, RUMBIA, LAMPUNG TENGAH, LAMPUNG",6,196,12,208
https://kawalpemilu.org#22992,"RESTU BARU, RUMBIA, LAMPUNG TENGAH, LAMPUNG",7,234,8,242
https://kawalpemilu.org#22992,"RESTU BARU, RUMBIA, LAMPUNG TENGAH, LAMPUNG",8,139,46,185
https://kawalpemilu.org#22992,"RESTU BARU, RUMBIA, LAMPUNG TENGAH, LAMPUNG",9,180,27,207
https://kawalpemilu.org#22992,"RESTU BARU, RUMBIA, LAMPUNG TENGAH, LAMPUNG",10,201,9,210
https://kawalpemilu.org#22993,"RESTU BUANA, RUMBIA, LAMPUNG TENGAH, LAMPUNG",1,263,4,267
https://kawalpemilu.org#22993,"RESTU BUANA, RUMBIA, LAMPUNG TENGAH, LAMPUNG",2,213,16,229
https://kawalpemilu.org#22993,"RESTU BUANA, RUMBIA, LAMPUNG TENGAH, LAMPUNG",4,235,10,245
https://kawalpemilu.org#22993,"RESTU BUANA, RUMBIA, LAMPUNG TENGAH, LAMPUNG",5,215,9,224
https://kawalpemilu.org#22993,"RESTU BUANA, RUMBIA, LAMPUNG TENGAH, LAMPUNG",6,226,20,246
https://kawalpemilu.org#22993,"RESTU BUANA, RUMBIA, LAMPUNG TENGAH, LAMPUNG",7,179,25,204
https://kawalpemilu.org#22993,"RESTU BUANA, RUMBIA, LAMPUNG TENGAH, LAMPUNG",8,218,12,230
https://kawalpemilu.org#22994,"RENO BASUKI, RUMBIA, LAMPUNG TENGAH, LAMPUNG",1,85,99,184
https://kawalpemilu.org#22994,"RENO BASUKI, RUMBIA, LAMPUNG TENGAH, LAMPUNG",2,118,61,179
https://kawalpemilu.org#22994,"RENO BASUKI, RUMBIA, LAMPUNG TENGAH, LAMPUNG",3,91,118,209
https://kawalpemilu.org#22994,"RENO BASUKI, RUMBIA, LAMPUNG TENGAH, LAMPUNG",4,88,60,148
https://kawalpemilu.org#22994,"RENO BASUKI, RUMBIA, LAMPUNG TENGAH, LAMPUNG",5,169,52,221
https://kawalpemilu.org#22994,"RENO BASUKI, RUMBIA, LAMPUNG TENGAH, LAMPUNG",6,187,37,224
https://kawalpemilu.org#22994,"RENO BASUKI, RUMBIA, LAMPUNG TENGAH, LAMPUNG",7,170,22,192
https://kawalpemilu.org#22994,"RENO BASUKI, RUMBIA, LAMPUNG TENGAH, LAMPUNG",8,157,14,171
https://kawalpemilu.org#22994,"RENO BASUKI, RUMBIA, LAMPUNG TENGAH, LAMPUNG",9,153,27,180
https://kawalpemilu.org#22994,"RENO BASUKI, RUMBIA, LAMPUNG TENGAH, LAMPUNG",10,192,14,206
https://kawalpemilu.org#22994,"RENO BASUKI, RUMBIA, LAMPUNG TENGAH, LAMPUNG",11,107,61,168
https://kawalpemilu.org#22994,"RENO BASUKI, RUMBIA, LAMPUNG TENGAH, LAMPUNG",12,133,44,177
https://kawalpemilu.org#22994,"RENO BASUKI, RUMBIA, LAMPUNG TENGAH, LAMPUNG",13,99,73,172
https://kawalpemilu.org#22994,"RENO BASUKI, RUMBIA, LAMPUNG TENGAH, LAMPUNG",14,96,48,144
https://kawalpemilu.org#22994,"RENO BASUKI, RUMBIA, LAMPUNG TENGAH, LAMPUNG",15,168,24,192
https://kawalpemilu.org#22994,"RENO BASUKI, RUMBIA, LAMPUNG TENGAH, LAMPUNG",16,139,34,173
https://kawalpemilu.org#22994,"RENO BASUKI, RUMBIA, LAMPUNG TENGAH, LAMPUNG",17,177,19,196
https://kawalpemilu.org#22995,"BINA KARYA PUTRA, RUMBIA, LAMPUNG TENGAH, LAMPUNG",1,183,45,228
https://kawalpemilu.org#22995,"BINA KARYA PUTRA, RUMBIA, LAMPUNG TENGAH, LAMPUNG",2,201,50,251
https://kawalpemilu.org#22995,"BINA KARYA PUTRA, RUMBIA, LAMPUNG TENGAH, LAMPUNG",3,205,42,247
https://kawalpemilu.org#22995,"BINA KARYA PUTRA, RUMBIA, LAMPUNG TENGAH, LAMPUNG",4,182,30,212
https://kawalpemilu.org#22995,"BINA KARYA PUTRA, RUMBIA, LAMPUNG TENGAH, LAMPUNG",5,139,40,179
https://kawalpemilu.org#22995,"BINA KARYA PUTRA, RUMBIA, LAMPUNG TENGAH, LAMPUNG",6,192,29,221
https://kawalpemilu.org#22995,"BINA KARYA PUTRA, RUMBIA, LAMPUNG TENGAH, LAMPUNG",7,186,15,201
https://kawalpemilu.org#22995,"BINA KARYA PUTRA, RUMBIA, LAMPUNG TENGAH, LAMPUNG",8,193,30,223
https://kawalpemilu.org#22995,"BINA KARYA PUTRA, RUMBIA, LAMPUNG TENGAH, LAMPUNG",9,145,41,186
https://kawalpemilu.org#22995,"BINA KARYA PUTRA, RUMBIA, LAMPUNG TENGAH, LAMPUNG",10,145,38,183
https://kawalpemilu.org#22995,"BINA KARYA PUTRA, RUMBIA, LAMPUNG TENGAH, LAMPUNG",11,160,25,185
https://kawalpemilu.org#22996,"BINA KARYA BUANA, RUMBIA, LAMPUNG TENGAH, LAMPUNG",2,192,10,202
https://kawalpemilu.org#22996,"BINA KARYA BUANA, RUMBIA, LAMPUNG TENGAH, LAMPUNG",3,207,22,229
https://kawalpemilu.org#22996,"BINA KARYA BUANA, RUMBIA, LAMPUNG TENGAH, LAMPUNG",4,217,18,235
https://kawalpemilu.org#22996,"BINA KARYA BUANA, RUMBIA, LAMPUNG TENGAH, LAMPUNG",5,205,30,235
https://kawalpemilu.org#22996,"BINA KARYA BUANA, RUMBIA, LAMPUNG TENGAH, LAMPUNG",6,243,6,249
https://kawalpemilu.org#22996,"BINA KARYA BUANA, RUMBIA, LAMPUNG TENGAH, LAMPUNG",7,193,18,211
https://kawalpemilu.org#22996,"BINA KARYA BUANA, RUMBIA, LAMPUNG TENGAH, LAMPUNG",8,243,22,265
https://kawalpemilu.org#928202,"BINA KARYA MANDIRI, RUMBIA, LAMPUNG TENGAH, LAMPUNG",1,200,5,205
https://kawalpemilu.org#928202,"BINA KARYA MANDIRI, RUMBIA, LAMPUNG TENGAH, LAMPUNG",2,212,9,221
https://kawalpemilu.org#928202,"BINA KARYA MANDIRI, RUMBIA, LAMPUNG TENGAH, LAMPUNG",3,197,7,204
https://kawalpemilu.org#928202,"BINA KARYA MANDIRI, RUMBIA, LAMPUNG TENGAH, LAMPUNG",4,184,14,198
https://kawalpemilu.org#22998,"SUMBER BAHAGIA, SEPUTIH BANYAK, LAMPUNG TENGAH, LAMPUNG",1,135,59,194
https://kawalpemilu.org#22998,"SUMBER BAHAGIA, SEPUTIH BANYAK, LAMPUNG TENGAH, LAMPUNG",2,91,56,147
https://kawalpemilu.org#22998,"SUMBER BAHAGIA, SEPUTIH BANYAK, LAMPUNG TENGAH, LAMPUNG",3,81,140,221
https://kawalpemilu.org#22998,"SUMBER BAHAGIA, SEPUTIH BANYAK, LAMPUNG TENGAH, LAMPUNG",4,134,74,208
https://kawalpemilu.org#22998,"SUMBER BAHAGIA, SEPUTIH BANYAK, LAMPUNG TENGAH, LAMPUNG",5,82,143,225
https://kawalpemilu.org#22998,"SUMBER BAHAGIA, SEPUTIH BANYAK, LAMPUNG TENGAH, LAMPUNG",6,129,58,187
https://kawalpemilu.org#22998,"SUMBER BAHAGIA, SEPUTIH BANYAK, LAMPUNG TENGAH, LAMPUNG",7,68,75,143
https://kawalpemilu.org#22998,"SUMBER BAHAGIA, SEPUTIH BANYAK, LAMPUNG TENGAH, LAMPUNG",8,103,73,176
https://kawalpemilu.org#22998,"SUMBER BAHAGIA, SEPUTIH BANYAK, LAMPUNG TENGAH, LAMPUNG",9,101,70,171
https://kawalpemilu.org#22998,"SUMBER BAHAGIA, SEPUTIH BANYAK, LAMPUNG TENGAH, LAMPUNG",10,101,89,190
https://kawalpemilu.org#22999,"TANJUNGHARAPAN, SEPUTIH BANYAK, LAMPUNG TENGAH, LAMPUNG",1,105,83,188
https://kawalpemilu.org#22999,"TANJUNGHARAPAN, SEPUTIH BANYAK, LAMPUNG TENGAH, LAMPUNG",2,83,121,204
https://kawalpemilu.org#22999,"TANJUNGHARAPAN, SEPUTIH BANYAK, LAMPUNG TENGAH, LAMPUNG",3,139,53,192
https://kawalpemilu.org#22999,"TANJUNGHARAPAN, SEPUTIH BANYAK, LAMPUNG TENGAH, LAMPUNG",4,105,75,180
https://kawalpemilu.org#22999,"TANJUNGHARAPAN, SEPUTIH BANYAK, LAMPUNG TENGAH, LAMPUNG",5,139,46,185
https://kawalpemilu.org#22999,"TANJUNGHARAPAN, SEPUTIH BANYAK, LAMPUNG TENGAH, LAMPUNG",6,107,102,209
https://kawalpemilu.org#22999,"TANJUNGHARAPAN, SEPUTIH BANYAK, LAMPUNG TENGAH, LAMPUNG",7,156,46,200
https://kawalpemilu.org#22999,"TANJUNGHARAPAN, SEPUTIH BANYAK, LAMPUNG TENGAH, LAMPUNG",8,149,70,219
https://kawalpemilu.org#22999,"TANJUNGHARAPAN, SEPUTIH BANYAK, LAMPUNG TENGAH, LAMPUNG",9,173,52,225
https://kawalpemilu.org#22999,"TANJUNGHARAPAN, SEPUTIH BANYAK, LAMPUNG TENGAH, LAMPUNG",10,129,75,204
https://kawalpemilu.org#22999,"TANJUNGHARAPAN, SEPUTIH BANYAK, LAMPUNG TENGAH, LAMPUNG",11,141,94,235
https://kawalpemilu.org#22999,"TANJUNGHARAPAN, SEPUTIH BANYAK, LAMPUNG TENGAH, LAMPUNG",12,126,91,217
https://kawalpemilu.org#22999,"TANJUNGHARAPAN, SEPUTIH BANYAK, LAMPUNG TENGAH, LAMPUNG",13,176,66,242
https://kawalpemilu.org#22999,"TANJUNGHARAPAN, SEPUTIH BANYAK, LAMPUNG TENGAH, LAMPUNG",14,102,38,140
https://kawalpemilu.org#22999,"TANJUNGHARAPAN, SEPUTIH BANYAK, LAMPUNG TENGAH, LAMPUNG",15,95,74,169
https://kawalpemilu.org#23000,"SETIA BUMI, SEPUTIH BANYAK, LAMPUNG TENGAH, LAMPUNG",1,122,77,199
https://kawalpemilu.org#23000,"SETIA BUMI, SEPUTIH BANYAK, LAMPUNG TENGAH, LAMPUNG",2,86,23,109
https://kawalpemilu.org#23000,"SETIA BUMI, SEPUTIH BANYAK, LAMPUNG TENGAH, LAMPUNG",3,132,61,193
https://kawalpemilu.org#23000,"SETIA BUMI, SEPUTIH BANYAK, LAMPUNG TENGAH, LAMPUNG",4,140,42,182
https://kawalpemilu.org#23000,"SETIA BUMI, SEPUTIH BANYAK, LAMPUNG TENGAH, LAMPUNG",5,103,85,188
https://kawalpemilu.org#23000,"SETIA BUMI, SEPUTIH BANYAK, LAMPUNG TENGAH, LAMPUNG",6,145,68,213
https://kawalpemilu.org#23000,"SETIA BUMI, SEPUTIH BANYAK, LAMPUNG TENGAH, LAMPUNG",7,115,108,223
https://kawalpemilu.org#23000,"SETIA BUMI, SEPUTIH BANYAK, LAMPUNG TENGAH, LAMPUNG",8,98,128,226
https://kawalpemilu.org#23000,"SETIA BUMI, SEPUTIH BANYAK, LAMPUNG TENGAH, LAMPUNG",9,101,79,180
https://kawalpemilu.org#23000,"SETIA BUMI, SEPUTIH BANYAK, LAMPUNG TENGAH, LAMPUNG",10,102,105,207
https://kawalpemilu.org#23000,"SETIA BUMI, SEPUTIH BANYAK, LAMPUNG TENGAH, LAMPUNG",11,148,41,189
https://kawalpemilu.org#23000,"SETIA BUMI, SEPUTIH BANYAK, LAMPUNG TENGAH, LAMPUNG",12,98,109,207
https://kawalpemilu.org#23001,"SUMBER BARU, SEPUTIH BANYAK, LAMPUNG TENGAH, LAMPUNG",1,134,73,207
https://kawalpemilu.org#23001,"SUMBER BARU, SEPUTIH BANYAK, LAMPUNG TENGAH, LAMPUNG",2,94,139,233
https://kawalpemilu.org#23001,"SUMBER BARU, SEPUTIH BANYAK, LAMPUNG TENGAH, LAMPUNG",3,132,86,218
https://kawalpemilu.org#23001,"SUMBER BARU, SEPUTIH BANYAK, LAMPUNG TENGAH, LAMPUNG",4,112,96,208
https://kawalpemilu.org#23001,"SUMBER BARU, SEPUTIH BANYAK, LAMPUNG TENGAH, LAMPUNG",5,106,82,188
https://kawalpemilu.org#23001,"SUMBER BARU, SEPUTIH BANYAK, LAMPUNG TENGAH, LAMPUNG",6,113,110,223
https://kawalpemilu.org#23001,"SUMBER BARU, SEPUTIH BANYAK, LAMPUNG TENGAH, LAMPUNG",7,120,64,184
https://kawalpemilu.org#23001,"SUMBER BARU, SEPUTIH BANYAK, LAMPUNG TENGAH, LAMPUNG",8,149,46,195
https://kawalpemilu.org#23001,"SUMBER BARU, SEPUTIH BANYAK, LAMPUNG TENGAH, LAMPUNG",9,162,43,205
https://kawalpemilu.org#23001,"SUMBER BARU, SEPUTIH BANYAK, LAMPUNG TENGAH, LAMPUNG",10,126,72,198
https://kawalpemilu.org#23001,"SUMBER BARU, SEPUTIH BANYAK, LAMPUNG TENGAH, LAMPUNG",11,0,0,0
https://kawalpemilu.org#23001,"SUMBER BARU, SEPUTIH BANYAK, LAMPUNG TENGAH, LAMPUNG",12,147,81,228
https://kawalpemilu.org#23002,"SISWO BINANGUN, SEPUTIH BANYAK, LAMPUNG TENGAH, LAMPUNG",1,156,36,192
https://kawalpemilu.org#23002,"SISWO BINANGUN, SEPUTIH BANYAK, LAMPUNG TENGAH, LAMPUNG",2,98,89,187
https://kawalpemilu.org#23002,"SISWO BINANGUN, SEPUTIH BANYAK, LAMPUNG TENGAH, LAMPUNG",3,100,95,195
https://kawalpemilu.org#23002,"SISWO BINANGUN, SEPUTIH BANYAK, LAMPUNG TENGAH, LAMPUNG",4,93,143,236
https://kawalpemilu.org#23002,"SISWO BINANGUN, SEPUTIH BANYAK, LAMPUNG TENGAH, LAMPUNG",5,82,86,168
https://kawalpemilu.org#23002,"SISWO BINANGUN, SEPUTIH BANYAK, LAMPUNG TENGAH, LAMPUNG",6,102,136,238
https://kawalpemilu.org#23002,"SISWO BINANGUN, SEPUTIH BANYAK, LAMPUNG TENGAH, LAMPUNG",7,68,125,193
https://kawalpemilu.org#23002,"SISWO BINANGUN, SEPUTIH BANYAK, LAMPUNG TENGAH, LAMPUNG",8,126,78,204
https://kawalpemilu.org#23002,"SISWO BINANGUN, SEPUTIH BANYAK, LAMPUNG TENGAH, LAMPUNG",9,93,77,170
https://kawalpemilu.org#23002,"SISWO BINANGUN, SEPUTIH BANYAK, LAMPUNG TENGAH, LAMPUNG",10,137,56,193
https://kawalpemilu.org#23002,"SISWO BINANGUN, SEPUTIH BANYAK, LAMPUNG TENGAH, LAMPUNG",11,14,229,243
https://kawalpemilu.org#23002,"SISWO BINANGUN, SEPUTIH BANYAK, LAMPUNG TENGAH, LAMPUNG",12,99,81,180
https://kawalpemilu.org#23002,"SISWO BINANGUN, SEPUTIH BANYAK, LAMPUNG TENGAH, LAMPUNG",13,208,6,214
https://kawalpemilu.org#23003,"SANGGAR BUANA, SEPUTIH BANYAK, LAMPUNG TENGAH, LAMPUNG",1,114,79,193
https://kawalpemilu.org#23003,"SANGGAR BUANA, SEPUTIH BANYAK, LAMPUNG TENGAH, LAMPUNG",2,67,151,218
https://kawalpemilu.org#23003,"SANGGAR BUANA, SEPUTIH BANYAK, LAMPUNG TENGAH, LAMPUNG",3,71,162,233
https://kawalpemilu.org#23003,"SANGGAR BUANA, SEPUTIH BANYAK, LAMPUNG TENGAH, LAMPUNG",4,215,20,235
https://kawalpemilu.org#23003,"SANGGAR BUANA, SEPUTIH BANYAK, LAMPUNG TENGAH, LAMPUNG",5,221,11,232
https://kawalpemilu.org#23003,"SANGGAR BUANA, SEPUTIH BANYAK, LAMPUNG TENGAH, LAMPUNG",6,98,82,180
https://kawalpemilu.org#23003,"SANGGAR BUANA, SEPUTIH BANYAK, LAMPUNG TENGAH, LAMPUNG",7,241,3,244
https://kawalpemilu.org#23003,"SANGGAR BUANA, SEPUTIH BANYAK, LAMPUNG TENGAH, LAMPUNG",8,238,5,243
https://kawalpemilu.org#23003,"SANGGAR BUANA, SEPUTIH BANYAK, LAMPUNG TENGAH, LAMPUNG",9,243,7,250
https://kawalpemilu.org#23003,"SANGGAR BUANA, SEPUTIH BANYAK, LAMPUNG TENGAH, LAMPUNG",10,143,49,192
https://kawalpemilu.org#23003,"SANGGAR BUANA, SEPUTIH BANYAK, LAMPUNG TENGAH, LAMPUNG",11,207,8,215
https://kawalpemilu.org#23004,"SAKTI BUANA, SEPUTIH BANYAK, LAMPUNG TENGAH, LAMPUNG",1,280,2,282
https://kawalpemilu.org#23004,"SAKTI BUANA, SEPUTIH BANYAK, LAMPUNG TENGAH, LAMPUNG",2,248,14,262
https://kawalpemilu.org#23004,"SAKTI BUANA, SEPUTIH BANYAK, LAMPUNG TENGAH, LAMPUNG",3,231,17,248
https://kawalpemilu.org#23004,"SAKTI BUANA, SEPUTIH BANYAK, LAMPUNG TENGAH, LAMPUNG",4,219,17,236
https://kawalpemilu.org#23004,"SAKTI BUANA, SEPUTIH BANYAK, LAMPUNG TENGAH, LAMPUNG",5,212,5,217
https://kawalpemilu.org#23004,"SAKTI BUANA, SEPUTIH BANYAK, LAMPUNG TENGAH, LAMPUNG",6,220,7,227
https://kawalpemilu.org#23004,"SAKTI BUANA, SEPUTIH BANYAK, LAMPUNG TENGAH, LAMPUNG",7,176,36,212
https://kawalpemilu.org#23004,"SAKTI BUANA, SEPUTIH BANYAK, LAMPUNG TENGAH, LAMPUNG",8,113,95,208
https://kawalpemilu.org#23005,"SETIA BAKTI, SEPUTIH BANYAK, LAMPUNG TENGAH, LAMPUNG",1,141,71,212
https://kawalpemilu.org#23005,"SETIA BAKTI, SEPUTIH BANYAK, LAMPUNG TENGAH, LAMPUNG",2,133,62,195
https://kawalpemilu.org#23005,"SETIA BAKTI, SEPUTIH BANYAK, LAMPUNG TENGAH, LAMPUNG",3,201,15,216
https://kawalpemilu.org#23005,"SETIA BAKTI, SEPUTIH BANYAK, LAMPUNG TENGAH, LAMPUNG",4,197,40,237
https://kawalpemilu.org#23005,"SETIA BAKTI, SEPUTIH BANYAK, LAMPUNG TENGAH, LAMPUNG",5,169,52,221
https://kawalpemilu.org#23005,"SETIA BAKTI, SEPUTIH BANYAK, LAMPUNG TENGAH, LAMPUNG",6,161,38,199
https://kawalpemilu.org#23005,"SETIA BAKTI, SEPUTIH BANYAK, LAMPUNG TENGAH, LAMPUNG",7,178,40,218
https://kawalpemilu.org#23005,"SETIA BAKTI, SEPUTIH BANYAK, LAMPUNG TENGAH, LAMPUNG",8,153,71,224
https://kawalpemilu.org#23005,"SETIA BAKTI, SEPUTIH BANYAK, LAMPUNG TENGAH, LAMPUNG",9,130,74,204
https://kawalpemilu.org#23005,"SETIA BAKTI, SEPUTIH BANYAK, LAMPUNG TENGAH, LAMPUNG",10,139,70,209
https://kawalpemilu.org#23005,"SETIA BAKTI, SEPUTIH BANYAK, LAMPUNG TENGAH, LAMPUNG",11,128,71,199
https://kawalpemilu.org#23005,"SETIA BAKTI, SEPUTIH BANYAK, LAMPUNG TENGAH, LAMPUNG",12,143,76,219
https://kawalpemilu.org#23005,"SETIA BAKTI, SEPUTIH BANYAK, LAMPUNG TENGAH, LAMPUNG",13,176,57,233
https://kawalpemilu.org#23005,"SETIA BAKTI, SEPUTIH BANYAK, LAMPUNG TENGAH, LAMPUNG",14,179,49,228
https://kawalpemilu.org#23006,"SRI BASUKI, SEPUTIH BANYAK, LAMPUNG TENGAH, LAMPUNG",1,154,74,228
https://kawalpemilu.org#23006,"SRI BASUKI, SEPUTIH BANYAK, LAMPUNG TENGAH, LAMPUNG",2,126,70,196
https://kawalpemilu.org#23006,"SRI BASUKI, SEPUTIH BANYAK, LAMPUNG TENGAH, LAMPUNG",3,126,61,187
https://kawalpemilu.org#23006,"SRI BASUKI, SEPUTIH BANYAK, LAMPUNG TENGAH, LAMPUNG",4,105,110,215
https://kawalpemilu.org#23006,"SRI BASUKI, SEPUTIH BANYAK, LAMPUNG TENGAH, LAMPUNG",5,197,36,233
https://kawalpemilu.org#23006,"SRI BASUKI, SEPUTIH BANYAK, LAMPUNG TENGAH, LAMPUNG",6,154,58,212
https://kawalpemilu.org#23006,"SRI BASUKI, SEPUTIH BANYAK, LAMPUNG TENGAH, LAMPUNG",7,125,51,176
https://kawalpemilu.org#23006,"SRI BASUKI, SEPUTIH BANYAK, LAMPUNG TENGAH, LAMPUNG",8,82,94,176
https://kawalpemilu.org#23006,"SRI BASUKI, SEPUTIH BANYAK, LAMPUNG TENGAH, LAMPUNG",9,108,82,190
https://kawalpemilu.org#23006,"SRI BASUKI, SEPUTIH BANYAK, LAMPUNG TENGAH, LAMPUNG",10,102,77,179
https://kawalpemilu.org#23006,"SRI BASUKI, SEPUTIH BANYAK, LAMPUNG TENGAH, LAMPUNG",11,65,109,174
https://kawalpemilu.org#23006,"SRI BASUKI, SEPUTIH BANYAK, LAMPUNG TENGAH, LAMPUNG",12,158,50,208
https://kawalpemilu.org#23006,"SRI BASUKI, SEPUTIH BANYAK, LAMPUNG TENGAH, LAMPUNG",13,143,56,199
https://kawalpemilu.org#23006,"SRI BASUKI, SEPUTIH BANYAK, LAMPUNG TENGAH, LAMPUNG",14,134,53,187
https://kawalpemilu.org#23007,"SRI BHAKTI, SEPUTIH BANYAK, LAMPUNG TENGAH, LAMPUNG",1,142,49,191
https://kawalpemilu.org#23007,"SRI BHAKTI, SEPUTIH BANYAK, LAMPUNG TENGAH, LAMPUNG",2,115,117,232
https://kawalpemilu.org#23007,"SRI BHAKTI, SEPUTIH BANYAK, LAMPUNG TENGAH, LAMPUNG",3,118,98,216
https://kawalpemilu.org#23007,"SRI BHAKTI, SEPUTIH BANYAK, LAMPUNG TENGAH, LAMPUNG",4,99,109,208
https://kawalpemilu.org#23007,"SRI BHAKTI, SEPUTIH BANYAK, LAMPUNG TENGAH, LAMPUNG",5,118,110,228
https://kawalpemilu.org#23007,"SRI BHAKTI, SEPUTIH BANYAK, LAMPUNG TENGAH, LAMPUNG",6,165,74,239
https://kawalpemilu.org#23007,"SRI BHAKTI, SEPUTIH BANYAK, LAMPUNG TENGAH, LAMPUNG",7,158,54,212
https://kawalpemilu.org#23007,"SRI BHAKTI, SEPUTIH BANYAK, LAMPUNG TENGAH, LAMPUNG",8,143,88,231
https://kawalpemilu.org#23008,"SWASTIKA BUANA, SEPUTIH BANYAK, LAMPUNG TENGAH, LAMPUNG",1,179,3,182
https://kawalpemilu.org#23008,"SWASTIKA BUANA, SEPUTIH BANYAK, LAMPUNG TENGAH, LAMPUNG",2,155,7,162
https://kawalpemilu.org#23008,"SWASTIKA BUANA, SEPUTIH BANYAK, LAMPUNG TENGAH, LAMPUNG",3,138,3,141
https://kawalpemilu.org#23008,"SWASTIKA BUANA, SEPUTIH BANYAK, LAMPUNG TENGAH, LAMPUNG",4,112,7,119
https://kawalpemilu.org#23008,"SWASTIKA BUANA, SEPUTIH BANYAK, LAMPUNG TENGAH, LAMPUNG",5,213,7,220
https://kawalpemilu.org#23008,"SWASTIKA BUANA, SEPUTIH BANYAK, LAMPUNG TENGAH, LAMPUNG",6,226,5,231
https://kawalpemilu.org#23008,"SWASTIKA BUANA, SEPUTIH BANYAK, LAMPUNG TENGAH, LAMPUNG",7,140,4,144
https://kawalpemilu.org#23008,"SWASTIKA BUANA, SEPUTIH BANYAK, LAMPUNG TENGAH, LAMPUNG",8,220,7,227
https://kawalpemilu.org#84791,"SUMBER FAJAR, SEPUTIH BANYAK, LAMPUNG TENGAH, LAMPUNG",1,157,73,230
https://kawalpemilu.org#84791,"SUMBER FAJAR, SEPUTIH BANYAK, LAMPUNG TENGAH, LAMPUNG",2,134,82,216
https://kawalpemilu.org#84791,"SUMBER FAJAR, SEPUTIH BANYAK, LAMPUNG TENGAH, LAMPUNG",3,144,89,233
https://kawalpemilu.org#84791,"SUMBER FAJAR, SEPUTIH BANYAK, LAMPUNG TENGAH, LAMPUNG",4,161,68,229
https://kawalpemilu.org#84791,"SUMBER FAJAR, SEPUTIH BANYAK, LAMPUNG TENGAH, LAMPUNG",5,155,67,222
https://kawalpemilu.org#84792,"TANJUNGKERAJAN, SEPUTIH BANYAK, LAMPUNG TENGAH, LAMPUNG",1,150,74,224
https://kawalpemilu.org#84792,"TANJUNGKERAJAN, SEPUTIH BANYAK, LAMPUNG TENGAH, LAMPUNG",2,129,48,177
https://kawalpemilu.org#84792,"TANJUNGKERAJAN, SEPUTIH BANYAK, LAMPUNG TENGAH, LAMPUNG",3,111,54,165
https://kawalpemilu.org#84792,"TANJUNGKERAJAN, SEPUTIH BANYAK, LAMPUNG TENGAH, LAMPUNG",4,126,55,181
https://kawalpemilu.org#84792,"TANJUNGKERAJAN, SEPUTIH BANYAK, LAMPUNG TENGAH, LAMPUNG",5,196,32,228
https://kawalpemilu.org#84792,"TANJUNGKERAJAN, SEPUTIH BANYAK, LAMPUNG TENGAH, LAMPUNG",6,134,60,194
https://kawalpemilu.org#23010,"PAJAR MATARAM, SEPUTIH MATARAM, LAMPUNG TENGAH, LAMPUNG",1,146,59,205
https://kawalpemilu.org#23010,"PAJAR MATARAM, SEPUTIH MATARAM, LAMPUNG TENGAH, LAMPUNG",2,162,45,207
https://kawalpemilu.org#23010,"PAJAR MATARAM, SEPUTIH MATARAM, LAMPUNG TENGAH, LAMPUNG",3,192,9,201
https://kawalpemilu.org#23010,"PAJAR MATARAM, SEPUTIH MATARAM, LAMPUNG TENGAH, LAMPUNG",4,159,29,188
https://kawalpemilu.org#23010,"PAJAR MATARAM, SEPUTIH MATARAM, LAMPUNG TENGAH, LAMPUNG",5,128,65,193
https://kawalpemilu.org#23010,"PAJAR MATARAM, SEPUTIH MATARAM, LAMPUNG TENGAH, LAMPUNG",6,133,86,219
https://kawalpemilu.org#23010,"PAJAR MATARAM, SEPUTIH MATARAM, LAMPUNG TENGAH, LAMPUNG",7,122,89,211
https://kawalpemilu.org#23010,"PAJAR MATARAM, SEPUTIH MATARAM, LAMPUNG TENGAH, LAMPUNG",8,132,67,199
https://kawalpemilu.org#23010,"PAJAR MATARAM, SEPUTIH MATARAM, LAMPUNG TENGAH, LAMPUNG",9,133,53,186
https://kawalpemilu.org#23010,"PAJAR MATARAM, SEPUTIH MATARAM, LAMPUNG TENGAH, LAMPUNG",10,137,60,197
https://kawalpemilu.org#23010,"PAJAR MATARAM, SEPUTIH MATARAM, LAMPUNG TENGAH, LAMPUNG",11,152,64,216
https://kawalpemilu.org#23010,"PAJAR MATARAM, SEPUTIH MATARAM, LAMPUNG TENGAH, LAMPUNG",12,202,8,210
https://kawalpemilu.org#23010,"PAJAR MATARAM, SEPUTIH MATARAM, LAMPUNG TENGAH, LAMPUNG",13,180,22,202
https://kawalpemilu.org#23010,"PAJAR MATARAM, SEPUTIH MATARAM, LAMPUNG TENGAH, LAMPUNG",14,168,47,215
https://kawalpemilu.org#23010,"PAJAR MATARAM, SEPUTIH MATARAM, LAMPUNG TENGAH, LAMPUNG",15,134,83,217
https://kawalpemilu.org#23011,"REJO SARI MATARAM, SEPUTIH MATARAM, LAMPUNG TENGAH, LAMPUNG",1,101,79,180
https://kawalpemilu.org#23011,"REJO SARI MATARAM, SEPUTIH MATARAM, LAMPUNG TENGAH, LAMPUNG",2,111,94,205
https://kawalpemilu.org#23011,"REJO SARI MATARAM, SEPUTIH MATARAM, LAMPUNG TENGAH, LAMPUNG",3,85,77,162
https://kawalpemilu.org#23011,"REJO SARI MATARAM, SEPUTIH MATARAM, LAMPUNG TENGAH, LAMPUNG",4,140,65,205
https://kawalpemilu.org#23011,"REJO SARI MATARAM, SEPUTIH MATARAM, LAMPUNG TENGAH, LAMPUNG",5,123,48,171
https://kawalpemilu.org#23011,"REJO SARI MATARAM, SEPUTIH MATARAM, LAMPUNG TENGAH, LAMPUNG",6,113,30,143
https://kawalpemilu.org#23011,"REJO SARI MATARAM, SEPUTIH MATARAM, LAMPUNG TENGAH, LAMPUNG",7,149,21,170
https://kawalpemilu.org#23011,"REJO SARI MATARAM, SEPUTIH MATARAM, LAMPUNG TENGAH, LAMPUNG",8,124,52,176
https://kawalpemilu.org#23011,"REJO SARI MATARAM, SEPUTIH MATARAM, LAMPUNG TENGAH, LAMPUNG",9,134,70,204
https://kawalpemilu.org#23011,"REJO SARI MATARAM, SEPUTIH MATARAM, LAMPUNG TENGAH, LAMPUNG",10,127,62,189
https://kawalpemilu.org#23011,"REJO SARI MATARAM, SEPUTIH MATARAM, LAMPUNG TENGAH, LAMPUNG",11,143,43,186
https://kawalpemilu.org#23011,"REJO SARI MATARAM, SEPUTIH MATARAM, LAMPUNG TENGAH, LAMPUNG",12,144,59,203
https://kawalpemilu.org#23011,"REJO SARI MATARAM, SEPUTIH MATARAM, LAMPUNG TENGAH, LAMPUNG",13,151,54,205
https://kawalpemilu.org#23011,"REJO SARI MATARAM, SEPUTIH MATARAM, LAMPUNG TENGAH, LAMPUNG",14,118,77,195
https://kawalpemilu.org#23012,"QURNIA MATARAM, SEPUTIH MATARAM, LAMPUNG TENGAH, LAMPUNG",1,111,112,223
https://kawalpemilu.org#23012,"QURNIA MATARAM, SEPUTIH MATARAM, LAMPUNG TENGAH, LAMPUNG",2,153,94,247
https://kawalpemilu.org#23012,"QURNIA MATARAM, SEPUTIH MATARAM, LAMPUNG TENGAH, LAMPUNG",3,136,116,252
https://kawalpemilu.org#23012,"QURNIA MATARAM, SEPUTIH MATARAM, LAMPUNG TENGAH, LAMPUNG",4,122,111,233
https://kawalpemilu.org#23012,"QURNIA MATARAM, SEPUTIH MATARAM, LAMPUNG TENGAH, LAMPUNG",5,141,109,250
https://kawalpemilu.org#23012,"QURNIA MATARAM, SEPUTIH MATARAM, LAMPUNG TENGAH, LAMPUNG",6,132,80,212
https://kawalpemilu.org#23012,"QURNIA MATARAM, SEPUTIH MATARAM, LAMPUNG TENGAH, LAMPUNG",7,146,118,264
https://kawalpemilu.org#23012,"QURNIA MATARAM, SEPUTIH MATARAM, LAMPUNG TENGAH, LAMPUNG",8,150,85,235
https://kawalpemilu.org#23012,"QURNIA MATARAM, SEPUTIH MATARAM, LAMPUNG TENGAH, LAMPUNG",9,149,95,244
https://kawalpemilu.org#23012,"QURNIA MATARAM, SEPUTIH MATARAM, LAMPUNG TENGAH, LAMPUNG",10,113,98,211
https://kawalpemilu.org#23012,"QURNIA MATARAM, SEPUTIH MATARAM, LAMPUNG TENGAH, LAMPUNG",11,123,110,233
https://kawalpemilu.org#23012,"QURNIA MATARAM, SEPUTIH MATARAM, LAMPUNG TENGAH, LAMPUNG",12,117,117,234
https://kawalpemilu.org#23012,"QURNIA MATARAM, SEPUTIH MATARAM, LAMPUNG TENGAH, LAMPUNG",13,143,61,204
https://kawalpemilu.org#23013,"TRIMULYA MATARAM, SEPUTIH MATARAM, LAMPUNG TENGAH, LAMPUNG",1,143,50,193
https://kawalpemilu.org#23013,"TRIMULYA MATARAM, SEPUTIH MATARAM, LAMPUNG TENGAH, LAMPUNG",2,140,50,190
https://kawalpemilu.org#23013,"TRIMULYA MATARAM, SEPUTIH MATARAM, LAMPUNG TENGAH, LAMPUNG",3,144,63,207
https://kawalpemilu.org#23013,"TRIMULYA MATARAM, SEPUTIH MATARAM, LAMPUNG TENGAH, LAMPUNG",4,146,61,207
https://kawalpemilu.org#23013,"TRIMULYA MATARAM, SEPUTIH MATARAM, LAMPUNG TENGAH, LAMPUNG",5,253,2,255
https://kawalpemilu.org#23013,"TRIMULYA MATARAM, SEPUTIH MATARAM, LAMPUNG TENGAH, LAMPUNG",6,214,5,219
https://kawalpemilu.org#23013,"TRIMULYA MATARAM, SEPUTIH MATARAM, LAMPUNG TENGAH, LAMPUNG",7,130,68,198
https://kawalpemilu.org#23013,"TRIMULYA MATARAM, SEPUTIH MATARAM, LAMPUNG TENGAH, LAMPUNG",8,147,53,200
https://kawalpemilu.org#23013,"TRIMULYA MATARAM, SEPUTIH MATARAM, LAMPUNG TENGAH, LAMPUNG",9,171,54,225
https://kawalpemilu.org#23013,"TRIMULYA MATARAM, SEPUTIH MATARAM, LAMPUNG TENGAH, LAMPUNG",10,123,81,204
https://kawalpemilu.org#23013,"TRIMULYA MATARAM, SEPUTIH MATARAM, LAMPUNG TENGAH, LAMPUNG",11,188,14,202
https://kawalpemilu.org#23013,"TRIMULYA MATARAM, SEPUTIH MATARAM, LAMPUNG TENGAH, LAMPUNG",12,190,18,208
https://kawalpemilu.org#23014,"UTAMA JAYA, SEPUTIH MATARAM, LAMPUNG TENGAH, LAMPUNG",1,126,87,213
https://kawalpemilu.org#23014,"UTAMA JAYA, SEPUTIH MATARAM, LAMPUNG TENGAH, LAMPUNG",2,145,95,240
https://kawalpemilu.org#23014,"UTAMA JAYA, SEPUTIH MATARAM, LAMPUNG TENGAH, LAMPUNG",3,167,60,227
https://kawalpemilu.org#23014,"UTAMA JAYA, SEPUTIH MATARAM, LAMPUNG TENGAH, LAMPUNG",4,182,60,242
https://kawalpemilu.org#23014,"UTAMA JAYA, SEPUTIH MATARAM, LAMPUNG TENGAH, LAMPUNG",5,129,83,212
https://kawalpemilu.org#23014,"UTAMA JAYA, SEPUTIH MATARAM, LAMPUNG TENGAH, LAMPUNG",6,142,45,187
https://kawalpemilu.org#23014,"UTAMA JAYA, SEPUTIH MATARAM, LAMPUNG TENGAH, LAMPUNG",7,143,35,178
https://kawalpemilu.org#23014,"UTAMA JAYA, SEPUTIH MATARAM, LAMPUNG TENGAH, LAMPUNG",8,135,52,187
https://kawalpemilu.org#23014,"UTAMA JAYA, SEPUTIH MATARAM, LAMPUNG TENGAH, LAMPUNG",9,155,59,214
https://kawalpemilu.org#23015,"SUMBER AGUNG, SEPUTIH MATARAM, LAMPUNG TENGAH, LAMPUNG",1,168,57,225
https://kawalpemilu.org#23015,"SUMBER AGUNG, SEPUTIH MATARAM, LAMPUNG TENGAH, LAMPUNG",2,133,74,207
https://kawalpemilu.org#23015,"SUMBER AGUNG, SEPUTIH MATARAM, LAMPUNG TENGAH, LAMPUNG",3,158,43,201
https://kawalpemilu.org#23015,"SUMBER AGUNG, SEPUTIH MATARAM, LAMPUNG TENGAH, LAMPUNG",4,192,26,218
https://kawalpemilu.org#23015,"SUMBER AGUNG, SEPUTIH MATARAM, LAMPUNG TENGAH, LAMPUNG",5,172,39,211
https://kawalpemilu.org#23015,"SUMBER AGUNG, SEPUTIH MATARAM, LAMPUNG TENGAH, LAMPUNG",6,182,19,201
https://kawalpemilu.org#23015,"SUMBER AGUNG, SEPUTIH MATARAM, LAMPUNG TENGAH, LAMPUNG",7,149,48,197
https://kawalpemilu.org#23015,"SUMBER AGUNG, SEPUTIH MATARAM, LAMPUNG TENGAH, LAMPUNG",8,166,31,197
https://kawalpemilu.org#23015,"SUMBER AGUNG, SEPUTIH MATARAM, LAMPUNG TENGAH, LAMPUNG",9,130,92,222
https://kawalpemilu.org#23015,"SUMBER AGUNG, SEPUTIH MATARAM, LAMPUNG TENGAH, LAMPUNG",10,179,26,205
https://kawalpemilu.org#23015,"SUMBER AGUNG, SEPUTIH MATARAM, LAMPUNG TENGAH, LAMPUNG",11,215,27,242
https://kawalpemilu.org#23015,"SUMBER AGUNG, SEPUTIH MATARAM, LAMPUNG TENGAH, LAMPUNG",12,184,28,212
https://kawalpemilu.org#23015,"SUMBER AGUNG, SEPUTIH MATARAM, LAMPUNG TENGAH, LAMPUNG",13,180,27,207
https://kawalpemilu.org#23015,"SUMBER AGUNG, SEPUTIH MATARAM, LAMPUNG TENGAH, LAMPUNG",14,152,17,169
https://kawalpemilu.org#23015,"SUMBER AGUNG, SEPUTIH MATARAM, LAMPUNG TENGAH, LAMPUNG",15,157,38,195
https://kawalpemilu.org#23015,"SUMBER AGUNG, SEPUTIH MATARAM, LAMPUNG TENGAH, LAMPUNG",16,147,57,204
https://kawalpemilu.org#23016,"VARIA AGUNG, SEPUTIH MATARAM, LAMPUNG TENGAH, LAMPUNG",1,157,51,208
https://kawalpemilu.org#23016,"VARIA AGUNG, SEPUTIH MATARAM, LAMPUNG TENGAH, LAMPUNG",2,161,38,199
https://kawalpemilu.org#23016,"VARIA AGUNG, SEPUTIH MATARAM, LAMPUNG TENGAH, LAMPUNG",3,200,24,224
https://kawalpemilu.org#23016,"VARIA AGUNG, SEPUTIH MATARAM, LAMPUNG TENGAH, LAMPUNG",4,185,29,214
https://kawalpemilu.org#23016,"VARIA AGUNG, SEPUTIH MATARAM, LAMPUNG TENGAH, LAMPUNG",5,160,49,209
https://kawalpemilu.org#23016,"VARIA AGUNG, SEPUTIH MATARAM, LAMPUNG TENGAH, LAMPUNG",6,231,28,259
https://kawalpemilu.org#23016,"VARIA AGUNG, SEPUTIH MATARAM, LAMPUNG TENGAH, LAMPUNG",7,204,13,217
https://kawalpemilu.org#23016,"VARIA AGUNG, SEPUTIH MATARAM, LAMPUNG TENGAH, LAMPUNG",8,178,44,222
https://kawalpemilu.org#23016,"VARIA AGUNG, SEPUTIH MATARAM, LAMPUNG TENGAH, LAMPUNG",9,191,29,220
https://kawalpemilu.org#23016,"VARIA AGUNG, SEPUTIH MATARAM, LAMPUNG TENGAH, LAMPUNG",10,184,33,217
https://kawalpemilu.org#23016,"VARIA AGUNG, SEPUTIH MATARAM, LAMPUNG TENGAH, LAMPUNG",11,182,27,209
https://kawalpemilu.org#23016,"VARIA AGUNG, SEPUTIH MATARAM, LAMPUNG TENGAH, LAMPUNG",12,185,28,213
https://kawalpemilu.org#23016,"VARIA AGUNG, SEPUTIH MATARAM, LAMPUNG TENGAH, LAMPUNG",13,169,53,222
https://kawalpemilu.org#23017,"WIRATA AGUNG, SEPUTIH MATARAM, LAMPUNG TENGAH, LAMPUNG",1,195,9,204
https://kawalpemilu.org#23017,"WIRATA AGUNG, SEPUTIH MATARAM, LAMPUNG TENGAH, LAMPUNG",2,179,18,197
https://kawalpemilu.org#23017,"WIRATA AGUNG, SEPUTIH MATARAM, LAMPUNG TENGAH, LAMPUNG",3,185,22,207
https://kawalpemilu.org#23017,"WIRATA AGUNG, SEPUTIH MATARAM, LAMPUNG TENGAH, LAMPUNG",4,214,13,227
https://kawalpemilu.org#23017,"WIRATA AGUNG, SEPUTIH MATARAM, LAMPUNG TENGAH, LAMPUNG",5,232,5,237
https://kawalpemilu.org#23017,"WIRATA AGUNG, SEPUTIH MATARAM, LAMPUNG TENGAH, LAMPUNG",6,190,22,212
https://kawalpemilu.org#23017,"WIRATA AGUNG, SEPUTIH MATARAM, LAMPUNG TENGAH, LAMPUNG",7,169,8,177
https://kawalpemilu.org#23017,"WIRATA AGUNG, SEPUTIH MATARAM, LAMPUNG TENGAH, LAMPUNG",8,186,17,203
https://kawalpemilu.org#23017,"WIRATA AGUNG, SEPUTIH MATARAM, LAMPUNG TENGAH, LAMPUNG",9,184,9,193
https://kawalpemilu.org#23017,"WIRATA AGUNG, SEPUTIH MATARAM, LAMPUNG TENGAH, LAMPUNG",10,179,6,185
https://kawalpemilu.org#23018,"DHARMA AGUNG, SEPUTIH MATARAM, LAMPUNG TENGAH, LAMPUNG",1,215,13,228
https://kawalpemilu.org#23018,"DHARMA AGUNG, SEPUTIH MATARAM, LAMPUNG TENGAH, LAMPUNG",2,186,17,203
https://kawalpemilu.org#23018,"DHARMA AGUNG, SEPUTIH MATARAM, LAMPUNG TENGAH, LAMPUNG",3,167,15,182
https://kawalpemilu.org#23018,"DHARMA AGUNG, SEPUTIH MATARAM, LAMPUNG TENGAH, LAMPUNG",4,164,16,180
https://kawalpemilu.org#23018,"DHARMA AGUNG, SEPUTIH MATARAM, LAMPUNG TENGAH, LAMPUNG",5,219,3,222
https://kawalpemilu.org#23018,"DHARMA AGUNG, SEPUTIH MATARAM, LAMPUNG TENGAH, LAMPUNG",6,213,6,219
https://kawalpemilu.org#23018,"DHARMA AGUNG, SEPUTIH MATARAM, LAMPUNG TENGAH, LAMPUNG",7,165,8,173
https://kawalpemilu.org#23018,"DHARMA AGUNG, SEPUTIH MATARAM, LAMPUNG TENGAH, LAMPUNG",8,170,13,183
https://kawalpemilu.org#23018,"DHARMA AGUNG, SEPUTIH MATARAM, LAMPUNG TENGAH, LAMPUNG",9,186,14,200
https://kawalpemilu.org#23018,"DHARMA AGUNG, SEPUTIH MATARAM, LAMPUNG TENGAH, LAMPUNG",10,228,3,231
https://kawalpemilu.org#23019,"BUMI SETIA, SEPUTIH MATARAM, LAMPUNG TENGAH, LAMPUNG",1,182,37,219
https://kawalpemilu.org#23019,"BUMI SETIA, SEPUTIH MATARAM, LAMPUNG TENGAH, LAMPUNG",2,185,38,223
https://kawalpemilu.org#23019,"BUMI SETIA, SEPUTIH MATARAM, LAMPUNG TENGAH, LAMPUNG",3,183,37,220
https://kawalpemilu.org#23019,"BUMI SETIA, SEPUTIH MATARAM, LAMPUNG TENGAH, LAMPUNG",4,216,25,241
https://kawalpemilu.org#23019,"BUMI SETIA, SEPUTIH MATARAM, LAMPUNG TENGAH, LAMPUNG",5,197,46,243
https://kawalpemilu.org#23019,"BUMI SETIA, SEPUTIH MATARAM, LAMPUNG TENGAH, LAMPUNG",6,196,35,231
https://kawalpemilu.org#23019,"BUMI SETIA, SEPUTIH MATARAM, LAMPUNG TENGAH, LAMPUNG",7,213,39,252
https://kawalpemilu.org#23019,"BUMI SETIA, SEPUTIH MATARAM, LAMPUNG TENGAH, LAMPUNG",8,193,33,226
https://kawalpemilu.org#23019,"BUMI SETIA, SEPUTIH MATARAM, LAMPUNG TENGAH, LAMPUNG",9,194,33,227
https://kawalpemilu.org#23019,"BUMI SETIA, SEPUTIH MATARAM, LAMPUNG TENGAH, LAMPUNG",10,198,25,223
https://kawalpemilu.org#23019,"BUMI SETIA, SEPUTIH MATARAM, LAMPUNG TENGAH, LAMPUNG",11,190,30,220
https://kawalpemilu.org#23019,"BUMI SETIA, SEPUTIH MATARAM, LAMPUNG TENGAH, LAMPUNG",12,179,47,226
https://kawalpemilu.org#23020,"SUBING KARYA, SEPUTIH MATARAM, LAMPUNG TENGAH, LAMPUNG",1,138,41,179
https://kawalpemilu.org#23020,"SUBING KARYA, SEPUTIH MATARAM, LAMPUNG TENGAH, LAMPUNG",2,155,33,188
https://kawalpemilu.org#23020,"SUBING KARYA, SEPUTIH MATARAM, LAMPUNG TENGAH, LAMPUNG",3,153,31,184
https://kawalpemilu.org#23020,"SUBING KARYA, SEPUTIH MATARAM, LAMPUNG TENGAH, LAMPUNG",4,140,43,183
https://kawalpemilu.org#23020,"SUBING KARYA, SEPUTIH MATARAM, LAMPUNG TENGAH, LAMPUNG",5,149,33,182
https://kawalpemilu.org#23020,"SUBING KARYA, SEPUTIH MATARAM, LAMPUNG TENGAH, LAMPUNG",6,93,61,154
https://kawalpemilu.org#23020,"SUBING KARYA, SEPUTIH MATARAM, LAMPUNG TENGAH, LAMPUNG",7,83,51,134
https://kawalpemilu.org#23020,"SUBING KARYA, SEPUTIH MATARAM, LAMPUNG TENGAH, LAMPUNG",8,96,66,162
https://kawalpemilu.org#23020,"SUBING KARYA, SEPUTIH MATARAM, LAMPUNG TENGAH, LAMPUNG",9,116,57,173
https://kawalpemilu.org#23020,"SUBING KARYA, SEPUTIH MATARAM, LAMPUNG TENGAH, LAMPUNG",10,108,62,170
https://kawalpemilu.org#23021,"BANJAR AGUNG, SEPUTIH MATARAM, LAMPUNG TENGAH, LAMPUNG",1,180,41,221
https://kawalpemilu.org#23021,"BANJAR AGUNG, SEPUTIH MATARAM, LAMPUNG TENGAH, LAMPUNG",2,190,27,217
https://kawalpemilu.org#23021,"BANJAR AGUNG, SEPUTIH MATARAM, LAMPUNG TENGAH, LAMPUNG",3,178,38,216
https://kawalpemilu.org#23021,"BANJAR AGUNG, SEPUTIH MATARAM, LAMPUNG TENGAH, LAMPUNG",4,147,57,204
https://kawalpemilu.org#23021,"BANJAR AGUNG, SEPUTIH MATARAM, LAMPUNG TENGAH, LAMPUNG",5,149,57,206
https://kawalpemilu.org#23021,"BANJAR AGUNG, SEPUTIH MATARAM, LAMPUNG TENGAH, LAMPUNG",6,149,71,220
https://kawalpemilu.org#23021,"BANJAR AGUNG, SEPUTIH MATARAM, LAMPUNG TENGAH, LAMPUNG",7,138,45,183
https://kawalpemilu.org#23021,"BANJAR AGUNG, SEPUTIH MATARAM, LAMPUNG TENGAH, LAMPUNG",8,181,24,205
https://kawalpemilu.org#23021,"BANJAR AGUNG, SEPUTIH MATARAM, LAMPUNG TENGAH, LAMPUNG",9,151,29,180
https://kawalpemilu.org#23021,"BANJAR AGUNG, SEPUTIH MATARAM, LAMPUNG TENGAH, LAMPUNG",10,195,31,226
https://kawalpemilu.org#23021,"BANJAR AGUNG, SEPUTIH MATARAM, LAMPUNG TENGAH, LAMPUNG",11,173,55,228
https://kawalpemilu.org#23021,"BANJAR AGUNG, SEPUTIH MATARAM, LAMPUNG TENGAH, LAMPUNG",12,189,37,226
https://kawalpemilu.org#23021,"BANJAR AGUNG, SEPUTIH MATARAM, LAMPUNG TENGAH, LAMPUNG",13,199,28,227
https://kawalpemilu.org#23023,"GAYA BARU VI, SEPUTIH SURABAYA, LAMPUNG TENGAH, LAMPUNG",1,198,28,226
https://kawalpemilu.org#23023,"GAYA BARU VI, SEPUTIH SURABAYA, LAMPUNG TENGAH, LAMPUNG",2,144,52,196
https://kawalpemilu.org#23023,"GAYA BARU VI, SEPUTIH SURABAYA, LAMPUNG TENGAH, LAMPUNG",3,178,36,214
https://kawalpemilu.org#23023,"GAYA BARU VI, SEPUTIH SURABAYA, LAMPUNG TENGAH, LAMPUNG",4,114,54,168
https://kawalpemilu.org#23023,"GAYA BARU VI, SEPUTIH SURABAYA, LAMPUNG TENGAH, LAMPUNG",5,163,23,186
https://kawalpemilu.org#23023,"GAYA BARU VI, SEPUTIH SURABAYA, LAMPUNG TENGAH, LAMPUNG",6,131,51,182
https://kawalpemilu.org#23023,"GAYA BARU VI, SEPUTIH SURABAYA, LAMPUNG TENGAH, LAMPUNG",7,157,52,209
https://kawalpemilu.org#23023,"GAYA BARU VI, SEPUTIH SURABAYA, LAMPUNG TENGAH, LAMPUNG",8,181,41,222
https://kawalpemilu.org#23023,"GAYA BARU VI, SEPUTIH SURABAYA, LAMPUNG TENGAH, LAMPUNG",9,112,53,165
https://kawalpemilu.org#23023,"GAYA BARU VI, SEPUTIH SURABAYA, LAMPUNG TENGAH, LAMPUNG",10,139,65,204
https://kawalpemilu.org#23024,"SUMBER KATON, SEPUTIH SURABAYA, LAMPUNG TENGAH, LAMPUNG",1,117,23,140
https://kawalpemilu.org#23024,"SUMBER KATON, SEPUTIH SURABAYA, LAMPUNG TENGAH, LAMPUNG",2,161,43,204
https://kawalpemilu.org#23024,"SUMBER KATON, SEPUTIH SURABAYA, LAMPUNG TENGAH, LAMPUNG",3,179,21,200
https://kawalpemilu.org#23024,"SUMBER KATON, SEPUTIH SURABAYA, LAMPUNG TENGAH, LAMPUNG",6,148,26,174
https://kawalpemilu.org#23024,"SUMBER KATON, SEPUTIH SURABAYA, LAMPUNG TENGAH, LAMPUNG",7,88,78,166
https://kawalpemilu.org#23024,"SUMBER KATON, SEPUTIH SURABAYA, LAMPUNG TENGAH, LAMPUNG",8,84,55,139
https://kawalpemilu.org#23024,"SUMBER KATON, SEPUTIH SURABAYA, LAMPUNG TENGAH, LAMPUNG",9,121,32,153
https://kawalpemilu.org#23024,"SUMBER KATON, SEPUTIH SURABAYA, LAMPUNG TENGAH, LAMPUNG",10,131,78,209
https://kawalpemilu.org#23024,"SUMBER KATON, SEPUTIH SURABAYA, LAMPUNG TENGAH, LAMPUNG",11,157,28,185
https://kawalpemilu.org#23024,"SUMBER KATON, SEPUTIH SURABAYA, LAMPUNG TENGAH, LAMPUNG",12,155,35,190
https://kawalpemilu.org#23024,"SUMBER KATON, SEPUTIH SURABAYA, LAMPUNG TENGAH, LAMPUNG",13,112,83,195
https://kawalpemilu.org#23024,"SUMBER KATON, SEPUTIH SURABAYA, LAMPUNG TENGAH, LAMPUNG",14,91,29,120
https://kawalpemilu.org#23025,"SRI KATON, SEPUTIH SURABAYA, LAMPUNG TENGAH, LAMPUNG",1,123,85,208
https://kawalpemilu.org#23025,"SRI KATON, SEPUTIH SURABAYA, LAMPUNG TENGAH, LAMPUNG",2,120,49,169
https://kawalpemilu.org#23025,"SRI KATON, SEPUTIH SURABAYA, LAMPUNG TENGAH, LAMPUNG",3,156,42,198
https://kawalpemilu.org#23025,"SRI KATON, SEPUTIH SURABAYA, LAMPUNG TENGAH, LAMPUNG",4,112,45,157
https://kawalpemilu.org#23025,"SRI KATON, SEPUTIH SURABAYA, LAMPUNG TENGAH, LAMPUNG",5,123,43,166
https://kawalpemilu.org#23025,"SRI KATON, SEPUTIH SURABAYA, LAMPUNG TENGAH, LAMPUNG",6,125,76,201
https://kawalpemilu.org#23025,"SRI KATON, SEPUTIH SURABAYA, LAMPUNG TENGAH, LAMPUNG",7,111,76,187
https://kawalpemilu.org#23025,"SRI KATON, SEPUTIH SURABAYA, LAMPUNG TENGAH, LAMPUNG",8,148,51,199
https://kawalpemilu.org#23025,"SRI KATON, SEPUTIH SURABAYA, LAMPUNG TENGAH, LAMPUNG",9,146,35,181
https://kawalpemilu.org#23025,"SRI KATON, SEPUTIH SURABAYA, LAMPUNG TENGAH, LAMPUNG",10,151,34,185
https://kawalpemilu.org#23025,"SRI KATON, SEPUTIH SURABAYA, LAMPUNG TENGAH, LAMPUNG",11,103,44,147
https://kawalpemilu.org#23025,"SRI KATON, SEPUTIH SURABAYA, LAMPUNG TENGAH, LAMPUNG",12,120,92,212
https://kawalpemilu.org#23025,"SRI KATON, SEPUTIH SURABAYA, LAMPUNG TENGAH, LAMPUNG",13,75,87,162
https://kawalpemilu.org#23026,"GAYA BARU VII, SEPUTIH SURABAYA, LAMPUNG TENGAH, LAMPUNG",1,117,34,151
https://kawalpemilu.org#23026,"GAYA BARU VII, SEPUTIH SURABAYA, LAMPUNG TENGAH, LAMPUNG",2,170,30,200
https://kawalpemilu.org#23026,"GAYA BARU VII, SEPUTIH SURABAYA, LAMPUNG TENGAH, LAMPUNG",3,122,60,182
https://kawalpemilu.org#23027,"GAYA BARU IV, SEPUTIH SURABAYA, LAMPUNG TENGAH, LAMPUNG",1,162,44,206
https://kawalpemilu.org#23027,"GAYA BARU IV, SEPUTIH SURABAYA, LAMPUNG TENGAH, LAMPUNG",2,143,70,213
https://kawalpemilu.org#23027,"GAYA BARU IV, SEPUTIH SURABAYA, LAMPUNG TENGAH, LAMPUNG",3,142,35,177
https://kawalpemilu.org#23027,"GAYA BARU IV, SEPUTIH SURABAYA, LAMPUNG TENGAH, LAMPUNG",4,178,41,219
https://kawalpemilu.org#23027,"GAYA BARU IV, SEPUTIH SURABAYA, LAMPUNG TENGAH, LAMPUNG",5,150,63,213
https://kawalpemilu.org#23027,"GAYA BARU IV, SEPUTIH SURABAYA, LAMPUNG TENGAH, LAMPUNG",6,152,25,177
https://kawalpemilu.org#23027,"GAYA BARU IV, SEPUTIH SURABAYA, LAMPUNG TENGAH, LAMPUNG",7,162,24,186
https://kawalpemilu.org#23027,"GAYA BARU IV, SEPUTIH SURABAYA, LAMPUNG TENGAH, LAMPUNG",8,209,8,217
https://kawalpemilu.org#23027,"GAYA BARU IV, SEPUTIH SURABAYA, LAMPUNG TENGAH, LAMPUNG",9,147,44,191
https://kawalpemilu.org#23027,"GAYA BARU IV, SEPUTIH SURABAYA, LAMPUNG TENGAH, LAMPUNG",10,151,68,219
https://kawalpemilu.org#23027,"GAYA BARU IV, SEPUTIH SURABAYA, LAMPUNG TENGAH, LAMPUNG",11,192,20,212
https://kawalpemilu.org#23027,"GAYA BARU IV, SEPUTIH SURABAYA, LAMPUNG TENGAH, LAMPUNG",12,140,28,168
https://kawalpemilu.org#23028,"GAYA BARU III, SEPUTIH SURABAYA, LAMPUNG TENGAH, LAMPUNG",1,163,45,208
https://kawalpemilu.org#23028,"GAYA BARU III, SEPUTIH SURABAYA, LAMPUNG TENGAH, LAMPUNG",2,158,38,196
https://kawalpemilu.org#23028,"GAYA BARU III, SEPUTIH SURABAYA, LAMPUNG TENGAH, LAMPUNG",3,130,58,188
https://kawalpemilu.org#23028,"GAYA BARU III, SEPUTIH SURABAYA, LAMPUNG TENGAH, LAMPUNG",4,179,47,226
https://kawalpemilu.org#23028,"GAYA BARU III, SEPUTIH SURABAYA, LAMPUNG TENGAH, LAMPUNG",5,194,32,226
https://kawalpemilu.org#23028,"GAYA BARU III, SEPUTIH SURABAYA, LAMPUNG TENGAH, LAMPUNG",6,174,31,205
https://kawalpemilu.org#23028,"GAYA BARU III, SEPUTIH SURABAYA, LAMPUNG TENGAH, LAMPUNG",7,188,36,224
https://kawalpemilu.org#23028,"GAYA BARU III, SEPUTIH SURABAYA, LAMPUNG TENGAH, LAMPUNG",8,168,50,218
https://kawalpemilu.org#23028,"GAYA BARU III, SEPUTIH SURABAYA, LAMPUNG TENGAH, LAMPUNG",9,197,51,248
https://kawalpemilu.org#23028,"GAYA BARU III, SEPUTIH SURABAYA, LAMPUNG TENGAH, LAMPUNG",10,161,67,228
https://kawalpemilu.org#23028,"GAYA BARU III, SEPUTIH SURABAYA, LAMPUNG TENGAH, LAMPUNG",11,158,36,194
https://kawalpemilu.org#23028,"GAYA BARU III, SEPUTIH SURABAYA, LAMPUNG TENGAH, LAMPUNG",12,137,46,183
https://kawalpemilu.org#23028,"GAYA BARU III, SEPUTIH SURABAYA, LAMPUNG TENGAH, LAMPUNG",13,162,32,194
https://kawalpemilu.org#23028,"GAYA BARU III, SEPUTIH SURABAYA, LAMPUNG TENGAH, LAMPUNG",14,143,67,210
https://kawalpemilu.org#23028,"GAYA BARU III, SEPUTIH SURABAYA, LAMPUNG TENGAH, LAMPUNG",15,71,29,100
https://kawalpemilu.org#23029,"GAYA BARU II, SEPUTIH SURABAYA, LAMPUNG TENGAH, LAMPUNG",1,125,54,179
https://kawalpemilu.org#23029,"GAYA BARU II, SEPUTIH SURABAYA, LAMPUNG TENGAH, LAMPUNG",2,101,60,161
https://kawalpemilu.org#23029,"GAYA BARU II, SEPUTIH SURABAYA, LAMPUNG TENGAH, LAMPUNG",3,132,29,161
https://kawalpemilu.org#23029,"GAYA BARU II, SEPUTIH SURABAYA, LAMPUNG TENGAH, LAMPUNG",4,126,24,150
https://kawalpemilu.org#23029,"GAYA BARU II, SEPUTIH SURABAYA, LAMPUNG TENGAH, LAMPUNG",5,70,130,200
https://kawalpemilu.org#23029,"GAYA BARU II, SEPUTIH SURABAYA, LAMPUNG TENGAH, LAMPUNG",6,134,57,191
https://kawalpemilu.org#23029,"GAYA BARU II, SEPUTIH SURABAYA, LAMPUNG TENGAH, LAMPUNG",7,147,65,212
https://kawalpemilu.org#23029,"GAYA BARU II, SEPUTIH SURABAYA, LAMPUNG TENGAH, LAMPUNG",8,142,42,184
https://kawalpemilu.org#23029,"GAYA BARU II, SEPUTIH SURABAYA, LAMPUNG TENGAH, LAMPUNG",9,119,33,152
https://kawalpemilu.org#23029,"GAYA BARU II, SEPUTIH SURABAYA, LAMPUNG TENGAH, LAMPUNG",10,116,24,140
https://kawalpemilu.org#23029,"GAYA BARU II, SEPUTIH SURABAYA, LAMPUNG TENGAH, LAMPUNG",11,67,32,99
https://kawalpemilu.org#23029,"GAYA BARU II, SEPUTIH SURABAYA, LAMPUNG TENGAH, LAMPUNG",12,151,38,189
https://kawalpemilu.org#23029,"GAYA BARU II, SEPUTIH SURABAYA, LAMPUNG TENGAH, LAMPUNG",13,132,36,168
https://kawalpemilu.org#23029,"GAYA BARU II, SEPUTIH SURABAYA, LAMPUNG TENGAH, LAMPUNG",14,134,33,167
https://kawalpemilu.org#23029,"GAYA BARU II, SEPUTIH SURABAYA, LAMPUNG TENGAH, LAMPUNG",15,133,73,206
https://kawalpemilu.org#23029,"GAYA BARU II, SEPUTIH SURABAYA, LAMPUNG TENGAH, LAMPUNG",16,108,30,138
https://kawalpemilu.org#23029,"GAYA BARU II, SEPUTIH SURABAYA, LAMPUNG TENGAH, LAMPUNG",17,78,26,104
https://kawalpemilu.org#23030,"GAYA BARU VIII, SEPUTIH SURABAYA, LAMPUNG TENGAH, LAMPUNG",1,121,77,198
https://kawalpemilu.org#23030,"GAYA BARU VIII, SEPUTIH SURABAYA, LAMPUNG TENGAH, LAMPUNG",2,109,45,154
https://kawalpemilu.org#23030,"GAYA BARU VIII, SEPUTIH SURABAYA, LAMPUNG TENGAH, LAMPUNG",3,148,41,189
https://kawalpemilu.org#23030,"GAYA BARU VIII, SEPUTIH SURABAYA, LAMPUNG TENGAH, LAMPUNG",4,99,32,131
https://kawalpemilu.org#23031,"GAYA BARU I, SEPUTIH SURABAYA, LAMPUNG TENGAH, LAMPUNG",1,78,105,183
https://kawalpemilu.org#23031,"GAYA BARU I, SEPUTIH SURABAYA, LAMPUNG TENGAH, LAMPUNG",2,94,113,207
https://kawalpemilu.org#23031,"GAYA BARU I, SEPUTIH SURABAYA, LAMPUNG TENGAH, LAMPUNG",3,144,52,196
https://kawalpemilu.org#23031,"GAYA BARU I, SEPUTIH SURABAYA, LAMPUNG TENGAH, LAMPUNG",4,150,38,188
https://kawalpemilu.org#23031,"GAYA BARU I, SEPUTIH SURABAYA, LAMPUNG TENGAH, LAMPUNG",5,138,72,210
https://kawalpemilu.org#23031,"GAYA BARU I, SEPUTIH SURABAYA, LAMPUNG TENGAH, LAMPUNG",6,152,84,236
https://kawalpemilu.org#23031,"GAYA BARU I, SEPUTIH SURABAYA, LAMPUNG TENGAH, LAMPUNG",7,143,43,186
https://kawalpemilu.org#23031,"GAYA BARU I, SEPUTIH SURABAYA, LAMPUNG TENGAH, LAMPUNG",8,131,62,193
https://kawalpemilu.org#23031,"GAYA BARU I, SEPUTIH SURABAYA, LAMPUNG TENGAH, LAMPUNG",9,196,29,225
https://kawalpemilu.org#23031,"GAYA BARU I, SEPUTIH SURABAYA, LAMPUNG TENGAH, LAMPUNG",10,104,21,125
https://kawalpemilu.org#23031,"GAYA BARU I, SEPUTIH SURABAYA, LAMPUNG TENGAH, LAMPUNG",11,106,13,119
https://kawalpemilu.org#23031,"GAYA BARU I, SEPUTIH SURABAYA, LAMPUNG TENGAH, LAMPUNG",12,107,50,157
https://kawalpemilu.org#23031,"GAYA BARU I, SEPUTIH SURABAYA, LAMPUNG TENGAH, LAMPUNG",13,77,29,106
https://kawalpemilu.org#23032,"MATARAM ILIR, SEPUTIH SURABAYA, LAMPUNG TENGAH, LAMPUNG",1,51,168,219
https://kawalpemilu.org#23032,"MATARAM ILIR, SEPUTIH SURABAYA, LAMPUNG TENGAH, LAMPUNG",2,35,133,168
https://kawalpemilu.org#23032,"MATARAM ILIR, SEPUTIH SURABAYA, LAMPUNG TENGAH, LAMPUNG",3,146,40,186
https://kawalpemilu.org#23032,"MATARAM ILIR, SEPUTIH SURABAYA, LAMPUNG TENGAH, LAMPUNG",4,152,58,210
https://kawalpemilu.org#23032,"MATARAM ILIR, SEPUTIH SURABAYA, LAMPUNG TENGAH, LAMPUNG",5,170,51,221
https://kawalpemilu.org#23032,"MATARAM ILIR, SEPUTIH SURABAYA, LAMPUNG TENGAH, LAMPUNG",6,157,29,186
https://kawalpemilu.org#23032,"MATARAM ILIR, SEPUTIH SURABAYA, LAMPUNG TENGAH, LAMPUNG",7,162,22,184
https://kawalpemilu.org#23032,"MATARAM ILIR, SEPUTIH SURABAYA, LAMPUNG TENGAH, LAMPUNG",8,158,35,195
https://kawalpemilu.org#23032,"MATARAM ILIR, SEPUTIH SURABAYA, LAMPUNG TENGAH, LAMPUNG",9,155,33,188
https://kawalpemilu.org#23032,"MATARAM ILIR, SEPUTIH SURABAYA, LAMPUNG TENGAH, LAMPUNG",10,114,16,130
https://kawalpemilu.org#23032,"MATARAM ILIR, SEPUTIH SURABAYA, LAMPUNG TENGAH, LAMPUNG",11,125,9,134
https://kawalpemilu.org#23032,"MATARAM ILIR, SEPUTIH SURABAYA, LAMPUNG TENGAH, LAMPUNG",12,126,64,190
https://kawalpemilu.org#23032,"MATARAM ILIR, SEPUTIH SURABAYA, LAMPUNG TENGAH, LAMPUNG",13,163,32,195
https://kawalpemilu.org#23032,"MATARAM ILIR, SEPUTIH SURABAYA, LAMPUNG TENGAH, LAMPUNG",14,145,29,174
https://kawalpemilu.org#23032,"MATARAM ILIR, SEPUTIH SURABAYA, LAMPUNG TENGAH, LAMPUNG",15,149,64,213
https://kawalpemilu.org#23032,"MATARAM ILIR, SEPUTIH SURABAYA, LAMPUNG TENGAH, LAMPUNG",16,167,61,228
https://kawalpemilu.org#23032,"MATARAM ILIR, SEPUTIH SURABAYA, LAMPUNG TENGAH, LAMPUNG",17,180,18,198
https://kawalpemilu.org#23032,"MATARAM ILIR, SEPUTIH SURABAYA, LAMPUNG TENGAH, LAMPUNG",18,159,25,184
https://kawalpemilu.org#23032,"MATARAM ILIR, SEPUTIH SURABAYA, LAMPUNG TENGAH, LAMPUNG",19,115,22,137
https://kawalpemilu.org#23032,"MATARAM ILIR, SEPUTIH SURABAYA, LAMPUNG TENGAH, LAMPUNG",20,172,42,214
https://kawalpemilu.org#23032,"MATARAM ILIR, SEPUTIH SURABAYA, LAMPUNG TENGAH, LAMPUNG",21,121,35,156
https://kawalpemilu.org#23032,"MATARAM ILIR, SEPUTIH SURABAYA, LAMPUNG TENGAH, LAMPUNG",22,34,68,102
https://kawalpemilu.org#23032,"MATARAM ILIR, SEPUTIH SURABAYA, LAMPUNG TENGAH, LAMPUNG",23,148,31,179
https://kawalpemilu.org#23032,"MATARAM ILIR, SEPUTIH SURABAYA, LAMPUNG TENGAH, LAMPUNG",24,134,52,186
https://kawalpemilu.org#23032,"MATARAM ILIR, SEPUTIH SURABAYA, LAMPUNG TENGAH, LAMPUNG",25,142,36,178
https://kawalpemilu.org#23032,"MATARAM ILIR, SEPUTIH SURABAYA, LAMPUNG TENGAH, LAMPUNG",26,139,35,174
https://kawalpemilu.org#23032,"MATARAM ILIR, SEPUTIH SURABAYA, LAMPUNG TENGAH, LAMPUNG",27,136,20,156
https://kawalpemilu.org#23032,"MATARAM ILIR, SEPUTIH SURABAYA, LAMPUNG TENGAH, LAMPUNG",28,113,14,127
https://kawalpemilu.org#23033,"RAWA BETIK, SEPUTIH SURABAYA, LAMPUNG TENGAH, LAMPUNG",1,147,60,207
https://kawalpemilu.org#23033,"RAWA BETIK, SEPUTIH SURABAYA, LAMPUNG TENGAH, LAMPUNG",2,144,38,182
https://kawalpemilu.org#23033,"RAWA BETIK, SEPUTIH SURABAYA, LAMPUNG TENGAH, LAMPUNG",3,173,10,183
https://kawalpemilu.org#23033,"RAWA BETIK, SEPUTIH SURABAYA, LAMPUNG TENGAH, LAMPUNG",4,167,12,179
https://kawalpemilu.org#23033,"RAWA BETIK, SEPUTIH SURABAYA, LAMPUNG TENGAH, LAMPUNG",5,172,18,190
https://kawalpemilu.org#23033,"RAWA BETIK, SEPUTIH SURABAYA, LAMPUNG TENGAH, LAMPUNG",6,136,44,180
https://kawalpemilu.org#23034,"SRI MULYA JAYA, SEPUTIH SURABAYA, LAMPUNG TENGAH, LAMPUNG",1,102,67,169
https://kawalpemilu.org#23034,"SRI MULYA JAYA, SEPUTIH SURABAYA, LAMPUNG TENGAH, LAMPUNG",2,110,26,136
https://kawalpemilu.org#23034,"SRI MULYA JAYA, SEPUTIH SURABAYA, LAMPUNG TENGAH, LAMPUNG",3,90,41,131
https://kawalpemilu.org#23034,"SRI MULYA JAYA, SEPUTIH SURABAYA, LAMPUNG TENGAH, LAMPUNG",4,130,36,166
https://kawalpemilu.org#23034,"SRI MULYA JAYA, SEPUTIH SURABAYA, LAMPUNG TENGAH, LAMPUNG",5,105,65,170
https://kawalpemilu.org#23034,"SRI MULYA JAYA, SEPUTIH SURABAYA, LAMPUNG TENGAH, LAMPUNG",6,159,30,189
https://kawalpemilu.org#23034,"SRI MULYA JAYA, SEPUTIH SURABAYA, LAMPUNG TENGAH, LAMPUNG",7,113,65,178
https://kawalpemilu.org#23035,"KENANGA SARI, SEPUTIH SURABAYA, LAMPUNG TENGAH, LAMPUNG",1,98,27,125
https://kawalpemilu.org#23035,"KENANGA SARI, SEPUTIH SURABAYA, LAMPUNG TENGAH, LAMPUNG",2,135,30,165
https://kawalpemilu.org#23035,"KENANGA SARI, SEPUTIH SURABAYA, LAMPUNG TENGAH, LAMPUNG",3,139,16,155
https://kawalpemilu.org#23035,"KENANGA SARI, SEPUTIH SURABAYA, LAMPUNG TENGAH, LAMPUNG",5,125,12,137
https://kawalpemilu.org#23035,"KENANGA SARI, SEPUTIH SURABAYA, LAMPUNG TENGAH, LAMPUNG",6,146,32,178
https://kawalpemilu.org#23035,"KENANGA SARI, SEPUTIH SURABAYA, LAMPUNG TENGAH, LAMPUNG",7,73,12,85
https://kawalpemilu.org#23037,"GUNUNG BATIN UDIK, TERUSAN NUNYAI, LAMPUNG TENGAH, LAMPUNG",1,41,205,246
https://kawalpemilu.org#23037,"GUNUNG BATIN UDIK, TERUSAN NUNYAI, LAMPUNG TENGAH, LAMPUNG",2,40,185,225
https://kawalpemilu.org#23037,"GUNUNG BATIN UDIK, TERUSAN NUNYAI, LAMPUNG TENGAH, LAMPUNG",3,47,201,248
https://kawalpemilu.org#23037,"GUNUNG BATIN UDIK, TERUSAN NUNYAI, LAMPUNG TENGAH, LAMPUNG",4,35,196,231
https://kawalpemilu.org#23037,"GUNUNG BATIN UDIK, TERUSAN NUNYAI, LAMPUNG TENGAH, LAMPUNG",5,53,188,241
https://kawalpemilu.org#23037,"GUNUNG BATIN UDIK, TERUSAN NUNYAI, LAMPUNG TENGAH, LAMPUNG",6,57,147,204
https://kawalpemilu.org#23037,"GUNUNG BATIN UDIK, TERUSAN NUNYAI, LAMPUNG TENGAH, LAMPUNG",7,75,167,242
https://kawalpemilu.org#23037,"GUNUNG BATIN UDIK, TERUSAN NUNYAI, LAMPUNG TENGAH, LAMPUNG",8,75,132,207
https://kawalpemilu.org#23037,"GUNUNG BATIN UDIK, TERUSAN NUNYAI, LAMPUNG TENGAH, LAMPUNG",9,91,110,201
https://kawalpemilu.org#23037,"GUNUNG BATIN UDIK, TERUSAN NUNYAI, LAMPUNG TENGAH, LAMPUNG",10,41,50,91
https://kawalpemilu.org#23037,"GUNUNG BATIN UDIK, TERUSAN NUNYAI, LAMPUNG TENGAH, LAMPUNG",11,55,197,252
https://kawalpemilu.org#23037,"GUNUNG BATIN UDIK, TERUSAN NUNYAI, LAMPUNG TENGAH, LAMPUNG",12,51,202,253
https://kawalpemilu.org#23037,"GUNUNG BATIN UDIK, TERUSAN NUNYAI, LAMPUNG TENGAH, LAMPUNG",13,75,160,235
https://kawalpemilu.org#23037,"GUNUNG BATIN UDIK, TERUSAN NUNYAI, LAMPUNG TENGAH, LAMPUNG",14,124,100,224
https://kawalpemilu.org#23037,"GUNUNG BATIN UDIK, TERUSAN NUNYAI, LAMPUNG TENGAH, LAMPUNG",15,150,89,239
https://kawalpemilu.org#23037,"GUNUNG BATIN UDIK, TERUSAN NUNYAI, LAMPUNG TENGAH, LAMPUNG",16,145,103,248
https://kawalpemilu.org#23037,"GUNUNG BATIN UDIK, TERUSAN NUNYAI, LAMPUNG TENGAH, LAMPUNG",17,145,96,241
https://kawalpemilu.org#23037,"GUNUNG BATIN UDIK, TERUSAN NUNYAI, LAMPUNG TENGAH, LAMPUNG",18,101,60,161
https://kawalpemilu.org#23037,"GUNUNG BATIN UDIK, TERUSAN NUNYAI, LAMPUNG TENGAH, LAMPUNG",19,70,98,168
https://kawalpemilu.org#23037,"GUNUNG BATIN UDIK, TERUSAN NUNYAI, LAMPUNG TENGAH, LAMPUNG",20,98,44,142
https://kawalpemilu.org#23037,"GUNUNG BATIN UDIK, TERUSAN NUNYAI, LAMPUNG TENGAH, LAMPUNG",21,92,79,171
https://kawalpemilu.org#23037,"GUNUNG BATIN UDIK, TERUSAN NUNYAI, LAMPUNG TENGAH, LAMPUNG",22,31,149,180
https://kawalpemilu.org#23037,"GUNUNG BATIN UDIK, TERUSAN NUNYAI, LAMPUNG TENGAH, LAMPUNG",23,67,98,165
https://kawalpemilu.org#23038,"GUNUNG BATIN ILIR, TERUSAN NUNYAI, LAMPUNG TENGAH, LAMPUNG",1,55,170,225
https://kawalpemilu.org#23038,"GUNUNG BATIN ILIR, TERUSAN NUNYAI, LAMPUNG TENGAH, LAMPUNG",2,61,158,219
https://kawalpemilu.org#23038,"GUNUNG BATIN ILIR, TERUSAN NUNYAI, LAMPUNG TENGAH, LAMPUNG",3,37,153,190
https://kawalpemilu.org#23038,"GUNUNG BATIN ILIR, TERUSAN NUNYAI, LAMPUNG TENGAH, LAMPUNG",4,97,136,233
https://kawalpemilu.org#23039,"GUNUNG BATIN BARU, TERUSAN NUNYAI, LAMPUNG TENGAH, LAMPUNG",1,63,191,254
https://kawalpemilu.org#23039,"GUNUNG BATIN BARU, TERUSAN NUNYAI, LAMPUNG TENGAH, LAMPUNG",2,56,168,224
https://kawalpemilu.org#23039,"GUNUNG BATIN BARU, TERUSAN NUNYAI, LAMPUNG TENGAH, LAMPUNG",3,48,163,211
https://kawalpemilu.org#23039,"GUNUNG BATIN BARU, TERUSAN NUNYAI, LAMPUNG TENGAH, LAMPUNG",4,50,206,256
https://kawalpemilu.org#23039,"GUNUNG BATIN BARU, TERUSAN NUNYAI, LAMPUNG TENGAH, LAMPUNG",5,46,227,273
https://kawalpemilu.org#23039,"GUNUNG BATIN BARU, TERUSAN NUNYAI, LAMPUNG TENGAH, LAMPUNG",6,35,131,166
https://kawalpemilu.org#23039,"GUNUNG BATIN BARU, TERUSAN NUNYAI, LAMPUNG TENGAH, LAMPUNG",7,140,89,229
https://kawalpemilu.org#23039,"GUNUNG BATIN BARU, TERUSAN NUNYAI, LAMPUNG TENGAH, LAMPUNG",8,126,84,210
https://kawalpemilu.org#23039,"GUNUNG BATIN BARU, TERUSAN NUNYAI, LAMPUNG TENGAH, LAMPUNG",9,146,80,226
https://kawalpemilu.org#23039,"GUNUNG BATIN BARU, TERUSAN NUNYAI, LAMPUNG TENGAH, LAMPUNG",10,156,75,231
https://kawalpemilu.org#23039,"GUNUNG BATIN BARU, TERUSAN NUNYAI, LAMPUNG TENGAH, LAMPUNG",11,120,144,264
https://kawalpemilu.org#23039,"GUNUNG BATIN BARU, TERUSAN NUNYAI, LAMPUNG TENGAH, LAMPUNG",12,102,130,232
https://kawalpemilu.org#23039,"GUNUNG BATIN BARU, TERUSAN NUNYAI, LAMPUNG TENGAH, LAMPUNG",13,71,68,139
https://kawalpemilu.org#23039,"GUNUNG BATIN BARU, TERUSAN NUNYAI, LAMPUNG TENGAH, LAMPUNG",14,34,65,99
https://kawalpemilu.org#23039,"GUNUNG BATIN BARU, TERUSAN NUNYAI, LAMPUNG TENGAH, LAMPUNG",15,87,123,210
https://kawalpemilu.org#23039,"GUNUNG BATIN BARU, TERUSAN NUNYAI, LAMPUNG TENGAH, LAMPUNG",16,96,114,210
https://kawalpemilu.org#23039,"GUNUNG BATIN BARU, TERUSAN NUNYAI, LAMPUNG TENGAH, LAMPUNG",17,108,118,226
https://kawalpemilu.org#23039,"GUNUNG BATIN BARU, TERUSAN NUNYAI, LAMPUNG TENGAH, LAMPUNG",18,126,84,210
https://kawalpemilu.org#23039,"GUNUNG BATIN BARU, TERUSAN NUNYAI, LAMPUNG TENGAH, LAMPUNG",19,42,84,126
https://kawalpemilu.org#23039,"GUNUNG BATIN BARU, TERUSAN NUNYAI, LAMPUNG TENGAH, LAMPUNG",20,63,129,192
https://kawalpemilu.org#23039,"GUNUNG BATIN BARU, TERUSAN NUNYAI, LAMPUNG TENGAH, LAMPUNG",21,44,57,101
https://kawalpemilu.org#23039,"GUNUNG BATIN BARU, TERUSAN NUNYAI, LAMPUNG TENGAH, LAMPUNG",22,80,78,158
https://kawalpemilu.org#23039,"GUNUNG BATIN BARU, TERUSAN NUNYAI, LAMPUNG TENGAH, LAMPUNG",23,89,97,186
https://kawalpemilu.org#23039,"GUNUNG BATIN BARU, TERUSAN NUNYAI, LAMPUNG TENGAH, LAMPUNG",24,94,160,254
https://kawalpemilu.org#23039,"GUNUNG BATIN BARU, TERUSAN NUNYAI, LAMPUNG TENGAH, LAMPUNG",25,74,121,195
https://kawalpemilu.org#23039,"GUNUNG BATIN BARU, TERUSAN NUNYAI, LAMPUNG TENGAH, LAMPUNG",26,88,148,236
https://kawalpemilu.org#23039,"GUNUNG BATIN BARU, TERUSAN NUNYAI, LAMPUNG TENGAH, LAMPUNG",27,81,150,231
https://kawalpemilu.org#23039,"GUNUNG BATIN BARU, TERUSAN NUNYAI, LAMPUNG TENGAH, LAMPUNG",28,88,177,265
https://kawalpemilu.org#23039,"GUNUNG BATIN BARU, TERUSAN NUNYAI, LAMPUNG TENGAH, LAMPUNG",29,63,140,203
https://kawalpemilu.org#23039,"GUNUNG BATIN BARU, TERUSAN NUNYAI, LAMPUNG TENGAH, LAMPUNG",30,48,165,213
https://kawalpemilu.org#23039,"GUNUNG BATIN BARU, TERUSAN NUNYAI, LAMPUNG TENGAH, LAMPUNG",31,57,117,174
https://kawalpemilu.org#23039,"GUNUNG BATIN BARU, TERUSAN NUNYAI, LAMPUNG TENGAH, LAMPUNG",32,113,86,199
https://kawalpemilu.org#23040,"GUNUNG AGUNG, TERUSAN NUNYAI, LAMPUNG TENGAH, LAMPUNG",1,96,101,197
https://kawalpemilu.org#23040,"GUNUNG AGUNG, TERUSAN NUNYAI, LAMPUNG TENGAH, LAMPUNG",2,87,122,209
https://kawalpemilu.org#23040,"GUNUNG AGUNG, TERUSAN NUNYAI, LAMPUNG TENGAH, LAMPUNG",3,95,98,193
https://kawalpemilu.org#23040,"GUNUNG AGUNG, TERUSAN NUNYAI, LAMPUNG TENGAH, LAMPUNG",4,46,147,193
https://kawalpemilu.org#23040,"GUNUNG AGUNG, TERUSAN NUNYAI, LAMPUNG TENGAH, LAMPUNG",5,44,142,186
https://kawalpemilu.org#23040,"GUNUNG AGUNG, TERUSAN NUNYAI, LAMPUNG TENGAH, LAMPUNG",6,95,117,212
https://kawalpemilu.org#23040,"GUNUNG AGUNG, TERUSAN NUNYAI, LAMPUNG TENGAH, LAMPUNG",7,92,129,221
https://kawalpemilu.org#23040,"GUNUNG AGUNG, TERUSAN NUNYAI, LAMPUNG TENGAH, LAMPUNG",8,167,52,219
https://kawalpemilu.org#23040,"GUNUNG AGUNG, TERUSAN NUNYAI, LAMPUNG TENGAH, LAMPUNG",9,148,75,223
https://kawalpemilu.org#23040,"GUNUNG AGUNG, TERUSAN NUNYAI, LAMPUNG TENGAH, LAMPUNG",10,155,53,208
https://kawalpemilu.org#23040,"GUNUNG AGUNG, TERUSAN NUNYAI, LAMPUNG TENGAH, LAMPUNG",11,173,71,244
https://kawalpemilu.org#23040,"GUNUNG AGUNG, TERUSAN NUNYAI, LAMPUNG TENGAH, LAMPUNG",12,166,88,254
https://kawalpemilu.org#23040,"GUNUNG AGUNG, TERUSAN NUNYAI, LAMPUNG TENGAH, LAMPUNG",13,126,69,185
https://kawalpemilu.org#23040,"GUNUNG AGUNG, TERUSAN NUNYAI, LAMPUNG TENGAH, LAMPUNG",14,115,65,180
https://kawalpemilu.org#23040,"GUNUNG AGUNG, TERUSAN NUNYAI, LAMPUNG TENGAH, LAMPUNG",15,119,68,187
https://kawalpemilu.org#23040,"GUNUNG AGUNG, TERUSAN NUNYAI, LAMPUNG TENGAH, LAMPUNG",16,184,14,198
https://kawalpemilu.org#23040,"GUNUNG AGUNG, TERUSAN NUNYAI, LAMPUNG TENGAH, LAMPUNG",17,171,24,195
https://kawalpemilu.org#23040,"GUNUNG AGUNG, TERUSAN NUNYAI, LAMPUNG TENGAH, LAMPUNG",18,95,150,245
https://kawalpemilu.org#23040,"GUNUNG AGUNG, TERUSAN NUNYAI, LAMPUNG TENGAH, LAMPUNG",19,116,55,171
https://kawalpemilu.org#23040,"GUNUNG AGUNG, TERUSAN NUNYAI, LAMPUNG TENGAH, LAMPUNG",20,77,123,200
https://kawalpemilu.org#23040,"GUNUNG AGUNG, TERUSAN NUNYAI, LAMPUNG TENGAH, LAMPUNG",21,82,114,196
https://kawalpemilu.org#23040,"GUNUNG AGUNG, TERUSAN NUNYAI, LAMPUNG TENGAH, LAMPUNG",22,53,111,164
https://kawalpemilu.org#23040,"GUNUNG AGUNG, TERUSAN NUNYAI, LAMPUNG TENGAH, LAMPUNG",23,125,78,203
https://kawalpemilu.org#23040,"GUNUNG AGUNG, TERUSAN NUNYAI, LAMPUNG TENGAH, LAMPUNG",24,147,57,204
https://kawalpemilu.org#23040,"GUNUNG AGUNG, TERUSAN NUNYAI, LAMPUNG TENGAH, LAMPUNG",25,174,80,254
https://kawalpemilu.org#23040,"GUNUNG AGUNG, TERUSAN NUNYAI, LAMPUNG TENGAH, LAMPUNG",26,79,94,173
https://kawalpemilu.org#23041,"BANDAR AGUNG, TERUSAN NUNYAI, LAMPUNG TENGAH, LAMPUNG",1,97,152,249
https://kawalpemilu.org#23041,"BANDAR AGUNG, TERUSAN NUNYAI, LAMPUNG TENGAH, LAMPUNG",2,102,137,239
https://kawalpemilu.org#23041,"BANDAR AGUNG, TERUSAN NUNYAI, LAMPUNG TENGAH, LAMPUNG",3,150,110,260
https://kawalpemilu.org#23041,"BANDAR AGUNG, TERUSAN NUNYAI, LAMPUNG TENGAH, LAMPUNG",4,96,174,270
https://kawalpemilu.org#23041,"BANDAR AGUNG, TERUSAN NUNYAI, LAMPUNG TENGAH, LAMPUNG",5,122,153,275
https://kawalpemilu.org#23041,"BANDAR AGUNG, TERUSAN NUNYAI, LAMPUNG TENGAH, LAMPUNG",6,76,133,209
https://kawalpemilu.org#23041,"BANDAR AGUNG, TERUSAN NUNYAI, LAMPUNG TENGAH, LAMPUNG",7,123,134,257
https://kawalpemilu.org#23041,"BANDAR AGUNG, TERUSAN NUNYAI, LAMPUNG TENGAH, LAMPUNG",8,132,140,272
https://kawalpemilu.org#23041,"BANDAR AGUNG, TERUSAN NUNYAI, LAMPUNG TENGAH, LAMPUNG",9,120,77,197
https://kawalpemilu.org#23041,"BANDAR AGUNG, TERUSAN NUNYAI, LAMPUNG TENGAH, LAMPUNG",10,147,40,187
https://kawalpemilu.org#23041,"BANDAR AGUNG, TERUSAN NUNYAI, LAMPUNG TENGAH, LAMPUNG",11,102,133,235
https://kawalpemilu.org#23041,"BANDAR AGUNG, TERUSAN NUNYAI, LAMPUNG TENGAH, LAMPUNG",12,156,111,267
https://kawalpemilu.org#23041,"BANDAR AGUNG, TERUSAN NUNYAI, LAMPUNG TENGAH, LAMPUNG",13,172,57,229
https://kawalpemilu.org#23041,"BANDAR AGUNG, TERUSAN NUNYAI, LAMPUNG TENGAH, LAMPUNG",14,101,107,208
https://kawalpemilu.org#23041,"BANDAR AGUNG, TERUSAN NUNYAI, LAMPUNG TENGAH, LAMPUNG",15,122,80,202
https://kawalpemilu.org#23041,"BANDAR AGUNG, TERUSAN NUNYAI, LAMPUNG TENGAH, LAMPUNG",16,108,20,128
https://kawalpemilu.org#23042,"BANDAR SAKTI, TERUSAN NUNYAI, LAMPUNG TENGAH, LAMPUNG",1,83,190,273
https://kawalpemilu.org#23042,"BANDAR SAKTI, TERUSAN NUNYAI, LAMPUNG TENGAH, LAMPUNG",2,90,135,225
https://kawalpemilu.org#23042,"BANDAR SAKTI, TERUSAN NUNYAI, LAMPUNG TENGAH, LAMPUNG",3,94,140,234
https://kawalpemilu.org#23042,"BANDAR SAKTI, TERUSAN NUNYAI, LAMPUNG TENGAH, LAMPUNG",4,86,158,244
https://kawalpemilu.org#23042,"BANDAR SAKTI, TERUSAN NUNYAI, LAMPUNG TENGAH, LAMPUNG",5,88,137,225
https://kawalpemilu.org#23042,"BANDAR SAKTI, TERUSAN NUNYAI, LAMPUNG TENGAH, LAMPUNG",6,133,116,249
https://kawalpemilu.org#23042,"BANDAR SAKTI, TERUSAN NUNYAI, LAMPUNG TENGAH, LAMPUNG",7,108,121,229
https://kawalpemilu.org#23042,"BANDAR SAKTI, TERUSAN NUNYAI, LAMPUNG TENGAH, LAMPUNG",8,70,183,253
https://kawalpemilu.org#23042,"BANDAR SAKTI, TERUSAN NUNYAI, LAMPUNG TENGAH, LAMPUNG",9,111,122,233
https://kawalpemilu.org#23042,"BANDAR SAKTI, TERUSAN NUNYAI, LAMPUNG TENGAH, LAMPUNG",10,125,77,202
https://kawalpemilu.org#23042,"BANDAR SAKTI, TERUSAN NUNYAI, LAMPUNG TENGAH, LAMPUNG",11,220,60,280
https://kawalpemilu.org#23043,"TANJUNG ANOM, TERUSAN NUNYAI, LAMPUNG TENGAH, LAMPUNG",1,79,176,255
https://kawalpemilu.org#23043,"TANJUNG ANOM, TERUSAN NUNYAI, LAMPUNG TENGAH, LAMPUNG",2,116,130,246
https://kawalpemilu.org#23043,"TANJUNG ANOM, TERUSAN NUNYAI, LAMPUNG TENGAH, LAMPUNG",3,99,137,236
https://kawalpemilu.org#23043,"TANJUNG ANOM, TERUSAN NUNYAI, LAMPUNG TENGAH, LAMPUNG",4,82,156,238
https://kawalpemilu.org#23043,"TANJUNG ANOM, TERUSAN NUNYAI, LAMPUNG TENGAH, LAMPUNG",5,99,181,280
https://kawalpemilu.org#23043,"TANJUNG ANOM, TERUSAN NUNYAI, LAMPUNG TENGAH, LAMPUNG",6,80,175,255
https://kawalpemilu.org#23043,"TANJUNG ANOM, TERUSAN NUNYAI, LAMPUNG TENGAH, LAMPUNG",7,77,173,250
https://kawalpemilu.org#23043,"TANJUNG ANOM, TERUSAN NUNYAI, LAMPUNG TENGAH, LAMPUNG",8,102,130,232
https://kawalpemilu.org#23043,"TANJUNG ANOM, TERUSAN NUNYAI, LAMPUNG TENGAH, LAMPUNG",9,113,128,241
https://kawalpemilu.org#23045,"SUKA JAWA, BUMI RATU NUBAN, LAMPUNG TENGAH, LAMPUNG",1,82,104,186
https://kawalpemilu.org#23045,"SUKA JAWA, BUMI RATU NUBAN, LAMPUNG TENGAH, LAMPUNG",2,84,117,201
https://kawalpemilu.org#23045,"SUKA JAWA, BUMI RATU NUBAN, LAMPUNG TENGAH, LAMPUNG",3,191,59,250
https://kawalpemilu.org#23045,"SUKA JAWA, BUMI RATU NUBAN, LAMPUNG TENGAH, LAMPUNG",4,174,35,209
https://kawalpemilu.org#23045,"SUKA JAWA, BUMI RATU NUBAN, LAMPUNG TENGAH, LAMPUNG",5,105,83,188
https://kawalpemilu.org#23045,"SUKA JAWA, BUMI RATU NUBAN, LAMPUNG TENGAH, LAMPUNG",6,90,110,200
https://kawalpemilu.org#23045,"SUKA JAWA, BUMI RATU NUBAN, LAMPUNG TENGAH, LAMPUNG",7,98,77,175
https://kawalpemilu.org#23045,"SUKA JAWA, BUMI RATU NUBAN, LAMPUNG TENGAH, LAMPUNG",8,88,71,159
https://kawalpemilu.org#23045,"SUKA JAWA, BUMI RATU NUBAN, LAMPUNG TENGAH, LAMPUNG",9,64,64,128
https://kawalpemilu.org#23045,"SUKA JAWA, BUMI RATU NUBAN, LAMPUNG TENGAH, LAMPUNG",10,51,75,126
https://kawalpemilu.org#23045,"SUKA JAWA, BUMI RATU NUBAN, LAMPUNG TENGAH, LAMPUNG",11,120,49,177
https://kawalpemilu.org#23045,"SUKA JAWA, BUMI RATU NUBAN, LAMPUNG TENGAH, LAMPUNG",12,120,78,198
https://kawalpemilu.org#23045,"SUKA JAWA, BUMI RATU NUBAN, LAMPUNG TENGAH, LAMPUNG",13,87,83,170
https://kawalpemilu.org#23045,"SUKA JAWA, BUMI RATU NUBAN, LAMPUNG TENGAH, LAMPUNG",14,63,64,127
https://kawalpemilu.org#23046,"SIDOKERTO, BUMI RATU NUBAN, LAMPUNG TENGAH, LAMPUNG",1,112,25,137
https://kawalpemilu.org#23046,"SIDOKERTO, BUMI RATU NUBAN, LAMPUNG TENGAH, LAMPUNG",2,107,60,167
https://kawalpemilu.org#23046,"SIDOKERTO, BUMI RATU NUBAN, LAMPUNG TENGAH, LAMPUNG",3,125,80,205
https://kawalpemilu.org#23046,"SIDOKERTO, BUMI RATU NUBAN, LAMPUNG TENGAH, LAMPUNG",4,156,61,217
https://kawalpemilu.org#23046,"SIDOKERTO, BUMI RATU NUBAN, LAMPUNG TENGAH, LAMPUNG",5,173,46,219
https://kawalpemilu.org#23046,"SIDOKERTO, BUMI RATU NUBAN, LAMPUNG TENGAH, LAMPUNG",6,156,20,176
https://kawalpemilu.org#23046,"SIDOKERTO, BUMI RATU NUBAN, LAMPUNG TENGAH, LAMPUNG",7,122,42,164
https://kawalpemilu.org#23046,"SIDOKERTO, BUMI RATU NUBAN, LAMPUNG TENGAH, LAMPUNG",8,147,58,205
https://kawalpemilu.org#23046,"SIDOKERTO, BUMI RATU NUBAN, LAMPUNG TENGAH, LAMPUNG",9,86,26,112
https://kawalpemilu.org#23046,"SIDOKERTO, BUMI RATU NUBAN, LAMPUNG TENGAH, LAMPUNG",10,47,48,95
https://kawalpemilu.org#23046,"SIDOKERTO, BUMI RATU NUBAN, LAMPUNG TENGAH, LAMPUNG",11,86,44,130
https://kawalpemilu.org#23046,"SIDOKERTO, BUMI RATU NUBAN, LAMPUNG TENGAH, LAMPUNG",12,63,17,80
https://kawalpemilu.org#23046,"SIDOKERTO, BUMI RATU NUBAN, LAMPUNG TENGAH, LAMPUNG",13,69,20,89
https://kawalpemilu.org#23046,"SIDOKERTO, BUMI RATU NUBAN, LAMPUNG TENGAH, LAMPUNG",14,103,42,145
https://kawalpemilu.org#23046,"SIDOKERTO, BUMI RATU NUBAN, LAMPUNG TENGAH, LAMPUNG",15,122,26,148
https://kawalpemilu.org#23047,"SUKAJADI, BUMI RATU NUBAN, LAMPUNG TENGAH, LAMPUNG",1,155,28,183
https://kawalpemilu.org#23047,"SUKAJADI, BUMI RATU NUBAN, LAMPUNG TENGAH, LAMPUNG",2,143,24,167
https://kawalpemilu.org#23047,"SUKAJADI, BUMI RATU NUBAN, LAMPUNG TENGAH, LAMPUNG",3,151,21,172
https://kawalpemilu.org#23047,"SUKAJADI, BUMI RATU NUBAN, LAMPUNG TENGAH, LAMPUNG",4,93,48,141
https://kawalpemilu.org#23047,"SUKAJADI, BUMI RATU NUBAN, LAMPUNG TENGAH, LAMPUNG",5,156,28,184
https://kawalpemilu.org#23047,"SUKAJADI, BUMI RATU NUBAN, LAMPUNG TENGAH, LAMPUNG",6,136,36,172
https://kawalpemilu.org#23047,"SUKAJADI, BUMI RATU NUBAN, LAMPUNG TENGAH, LAMPUNG",7,149,15,164
https://kawalpemilu.org#23047,"SUKAJADI, BUMI RATU NUBAN, LAMPUNG TENGAH, LAMPUNG",8,106,25,131
https://kawalpemilu.org#23048,"BUMI RAHARJO, BUMI RATU NUBAN, LAMPUNG TENGAH, LAMPUNG",1,109,46,155
https://kawalpemilu.org#23048,"BUMI RAHARJO, BUMI RATU NUBAN, LAMPUNG TENGAH, LAMPUNG",2,118,50,168
https://kawalpemilu.org#23048,"BUMI RAHARJO, BUMI RATU NUBAN, LAMPUNG TENGAH, LAMPUNG",3,124,37,161
https://kawalpemilu.org#23048,"BUMI RAHARJO, BUMI RATU NUBAN, LAMPUNG TENGAH, LAMPUNG",4,112,80,192
https://kawalpemilu.org#23048,"BUMI RAHARJO, BUMI RATU NUBAN, LAMPUNG TENGAH, LAMPUNG",5,176,45,221
https://kawalpemilu.org#23048,"BUMI RAHARJO, BUMI RATU NUBAN, LAMPUNG TENGAH, LAMPUNG",6,129,31,160
https://kawalpemilu.org#23048,"BUMI RAHARJO, BUMI RATU NUBAN, LAMPUNG TENGAH, LAMPUNG",7,178,26,204
https://kawalpemilu.org#23048,"BUMI RAHARJO, BUMI RATU NUBAN, LAMPUNG TENGAH, LAMPUNG",8,88,70,158
https://kawalpemilu.org#23048,"BUMI RAHARJO, BUMI RATU NUBAN, LAMPUNG TENGAH, LAMPUNG",9,103,67,170
https://kawalpemilu.org#23048,"BUMI RAHARJO, BUMI RATU NUBAN, LAMPUNG TENGAH, LAMPUNG",10,105,49,154
https://kawalpemilu.org#23048,"BUMI RAHARJO, BUMI RATU NUBAN, LAMPUNG TENGAH, LAMPUNG",11,130,57,187
https://kawalpemilu.org#23048,"BUMI RAHARJO, BUMI RATU NUBAN, LAMPUNG TENGAH, LAMPUNG",12,154,17,171
https://kawalpemilu.org#23049,"WATES, BUMI RATU NUBAN, LAMPUNG TENGAH, LAMPUNG",1,143,23,166
https://kawalpemilu.org#23049,"WATES, BUMI RATU NUBAN, LAMPUNG TENGAH, LAMPUNG",2,82,57,139
https://kawalpemilu.org#23049,"WATES, BUMI RATU NUBAN, LAMPUNG TENGAH, LAMPUNG",3,79,52,131
https://kawalpemilu.org#23049,"WATES, BUMI RATU NUBAN, LAMPUNG TENGAH, LAMPUNG",4,101,51,152
https://kawalpemilu.org#23049,"WATES, BUMI RATU NUBAN, LAMPUNG TENGAH, LAMPUNG",5,108,59,167
https://kawalpemilu.org#23049,"WATES, BUMI RATU NUBAN, LAMPUNG TENGAH, LAMPUNG",6,135,60,195
https://kawalpemilu.org#23049,"WATES, BUMI RATU NUBAN, LAMPUNG TENGAH, LAMPUNG",7,139,57,196
https://kawalpemilu.org#23049,"WATES, BUMI RATU NUBAN, LAMPUNG TENGAH, LAMPUNG",8,138,28,166
https://kawalpemilu.org#23049,"WATES, BUMI RATU NUBAN, LAMPUNG TENGAH, LAMPUNG",9,101,50,151
https://kawalpemilu.org#23049,"WATES, BUMI RATU NUBAN, LAMPUNG TENGAH, LAMPUNG",10,93,36,129
https://kawalpemilu.org#23049,"WATES, BUMI RATU NUBAN, LAMPUNG TENGAH, LAMPUNG",11,93,50,143
https://kawalpemilu.org#23049,"WATES, BUMI RATU NUBAN, LAMPUNG TENGAH, LAMPUNG",12,132,53,185
https://kawalpemilu.org#23049,"WATES, BUMI RATU NUBAN, LAMPUNG TENGAH, LAMPUNG",13,132,50,182
https://kawalpemilu.org#23049,"WATES, BUMI RATU NUBAN, LAMPUNG TENGAH, LAMPUNG",14,121,50,171
https://kawalpemilu.org#23050,"BUMI RATU, BUMI RATU NUBAN, LAMPUNG TENGAH, LAMPUNG",1,31,168,199
https://kawalpemilu.org#23050,"BUMI RATU, BUMI RATU NUBAN, LAMPUNG TENGAH, LAMPUNG",2,16,119,135
https://kawalpemilu.org#23050,"BUMI RATU, BUMI RATU NUBAN, LAMPUNG TENGAH, LAMPUNG",3,122,29,151
https://kawalpemilu.org#23050,"BUMI RATU, BUMI RATU NUBAN, LAMPUNG TENGAH, LAMPUNG",4,117,39,156
https://kawalpemilu.org#23050,"BUMI RATU, BUMI RATU NUBAN, LAMPUNG TENGAH, LAMPUNG",5,155,76,231
https://kawalpemilu.org#23050,"BUMI RATU, BUMI RATU NUBAN, LAMPUNG TENGAH, LAMPUNG",6,95,28,123
https://kawalpemilu.org#23050,"BUMI RATU, BUMI RATU NUBAN, LAMPUNG TENGAH, LAMPUNG",7,114,46,160
https://kawalpemilu.org#23050,"BUMI RATU, BUMI RATU NUBAN, LAMPUNG TENGAH, LAMPUNG",8,129,51,180
https://kawalpemilu.org#23050,"BUMI RATU, BUMI RATU NUBAN, LAMPUNG TENGAH, LAMPUNG",9,179,11,190
https://kawalpemilu.org#23050,"BUMI RATU, BUMI RATU NUBAN, LAMPUNG TENGAH, LAMPUNG",10,16,120,136
https://kawalpemilu.org#23050,"BUMI RATU, BUMI RATU NUBAN, LAMPUNG TENGAH, LAMPUNG",11,113,36,149
https://kawalpemilu.org#23050,"BUMI RATU, BUMI RATU NUBAN, LAMPUNG TENGAH, LAMPUNG",12,81,27,108
https://kawalpemilu.org#23050,"BUMI RATU, BUMI RATU NUBAN, LAMPUNG TENGAH, LAMPUNG",13,106,18,124
https://kawalpemilu.org#23050,"BUMI RATU, BUMI RATU NUBAN, LAMPUNG TENGAH, LAMPUNG",14,89,32,121
https://kawalpemilu.org#23050,"BUMI RATU, BUMI RATU NUBAN, LAMPUNG TENGAH, LAMPUNG",15,153,24,177
https://kawalpemilu.org#23050,"BUMI RATU, BUMI RATU NUBAN, LAMPUNG TENGAH, LAMPUNG",16,123,22,145
https://kawalpemilu.org#23050,"BUMI RATU, BUMI RATU NUBAN, LAMPUNG TENGAH, LAMPUNG",17,140,41,181
https://kawalpemilu.org#23051,"BULU SARI, BUMI RATU NUBAN, LAMPUNG TENGAH, LAMPUNG",1,100,71,171
https://kawalpemilu.org#23051,"BULU SARI, BUMI RATU NUBAN, LAMPUNG TENGAH, LAMPUNG",2,114,64,178
https://kawalpemilu.org#23051,"BULU SARI, BUMI RATU NUBAN, LAMPUNG TENGAH, LAMPUNG",3,109,48,157
https://kawalpemilu.org#23051,"BULU SARI, BUMI RATU NUBAN, LAMPUNG TENGAH, LAMPUNG",4,140,55,195
https://kawalpemilu.org#23051,"BULU SARI, BUMI RATU NUBAN, LAMPUNG TENGAH, LAMPUNG",5,109,80,189
https://kawalpemilu.org#23051,"BULU SARI, BUMI RATU NUBAN, LAMPUNG TENGAH, LAMPUNG",6,94,26,120
https://kawalpemilu.org#23051,"BULU SARI, BUMI RATU NUBAN, LAMPUNG TENGAH, LAMPUNG",7,173,20,193
https://kawalpemilu.org#23051,"BULU SARI, BUMI RATU NUBAN, LAMPUNG TENGAH, LAMPUNG",8,90,65,155
https://kawalpemilu.org#23051,"BULU SARI, BUMI RATU NUBAN, LAMPUNG TENGAH, LAMPUNG",9,108,77,185
https://kawalpemilu.org#23051,"BULU SARI, BUMI RATU NUBAN, LAMPUNG TENGAH, LAMPUNG",10,88,24,112
https://kawalpemilu.org#23051,"BULU SARI, BUMI RATU NUBAN, LAMPUNG TENGAH, LAMPUNG",11,75,43,118
https://kawalpemilu.org#23051,"BULU SARI, BUMI RATU NUBAN, LAMPUNG TENGAH, LAMPUNG",12,161,23,184
https://kawalpemilu.org#23052,"BUMI RAHAYU, BUMI RATU NUBAN, LAMPUNG TENGAH, LAMPUNG",1,95,91,186
https://kawalpemilu.org#23052,"BUMI RAHAYU, BUMI RATU NUBAN, LAMPUNG TENGAH, LAMPUNG",2,150,21,171
https://kawalpemilu.org#23052,"BUMI RAHAYU, BUMI RATU NUBAN, LAMPUNG TENGAH, LAMPUNG",3,158,29,187
https://kawalpemilu.org#23052,"BUMI RAHAYU, BUMI RATU NUBAN, LAMPUNG TENGAH, LAMPUNG",4,191,32,223
https://kawalpemilu.org#23052,"BUMI RAHAYU, BUMI RATU NUBAN, LAMPUNG TENGAH, LAMPUNG",5,120,74,194
https://kawalpemilu.org#23052,"BUMI RAHAYU, BUMI RATU NUBAN, LAMPUNG TENGAH, LAMPUNG",6,72,18,90
https://kawalpemilu.org#23052,"BUMI RAHAYU, BUMI RATU NUBAN, LAMPUNG TENGAH, LAMPUNG",7,76,24,100
https://kawalpemilu.org#23053,"SIDO WARAS, BUMI RATU NUBAN, LAMPUNG TENGAH, LAMPUNG",1,139,63,202
https://kawalpemilu.org#23053,"SIDO WARAS, BUMI RATU NUBAN, LAMPUNG TENGAH, LAMPUNG",2,88,58,146
https://kawalpemilu.org#23053,"SIDO WARAS, BUMI RATU NUBAN, LAMPUNG TENGAH, LAMPUNG",3,115,58,173
https://kawalpemilu.org#23053,"SIDO WARAS, BUMI RATU NUBAN, LAMPUNG TENGAH, LAMPUNG",4,105,83,188
https://kawalpemilu.org#23053,"SIDO WARAS, BUMI RATU NUBAN, LAMPUNG TENGAH, LAMPUNG",5,82,61,143
https://kawalpemilu.org#23053,"SIDO WARAS, BUMI RATU NUBAN, LAMPUNG TENGAH, LAMPUNG",6,122,54,176
https://kawalpemilu.org#84793,"TULUNG KAKAN, BUMI RATU NUBAN, LAMPUNG TENGAH, LAMPUNG",1,192,23,215
https://kawalpemilu.org#84793,"TULUNG KAKAN, BUMI RATU NUBAN, LAMPUNG TENGAH, LAMPUNG",2,188,34,222
https://kawalpemilu.org#84793,"TULUNG KAKAN, BUMI RATU NUBAN, LAMPUNG TENGAH, LAMPUNG",3,141,14,155
https://kawalpemilu.org#84793,"TULUNG KAKAN, BUMI RATU NUBAN, LAMPUNG TENGAH, LAMPUNG",4,184,33,217
https://kawalpemilu.org#84793,"TULUNG KAKAN, BUMI RATU NUBAN, LAMPUNG TENGAH, LAMPUNG",5,202,38,240
https://kawalpemilu.org#84793,"TULUNG KAKAN, BUMI RATU NUBAN, LAMPUNG TENGAH, LAMPUNG",6,133,14,147
https://kawalpemilu.org#23055,"RENGAS, BEKRI, LAMPUNG TENGAH, LAMPUNG",1,138,83,221
https://kawalpemilu.org#23055,"RENGAS, BEKRI, LAMPUNG TENGAH, LAMPUNG",2,73,100,173
https://kawalpemilu.org#23055,"RENGAS, BEKRI, LAMPUNG TENGAH, LAMPUNG",3,98,87,185
https://kawalpemilu.org#23055,"RENGAS, BEKRI, LAMPUNG TENGAH, LAMPUNG",4,178,35,213
https://kawalpemilu.org#23055,"RENGAS, BEKRI, LAMPUNG TENGAH, LAMPUNG",5,128,41,169
https://kawalpemilu.org#23055,"RENGAS, BEKRI, LAMPUNG TENGAH, LAMPUNG",6,53,124,177
https://kawalpemilu.org#23055,"RENGAS, BEKRI, LAMPUNG TENGAH, LAMPUNG",7,161,52,213
https://kawalpemilu.org#23055,"RENGAS, BEKRI, LAMPUNG TENGAH, LAMPUNG",8,116,70,186
https://kawalpemilu.org#23055,"RENGAS, BEKRI, LAMPUNG TENGAH, LAMPUNG",9,119,78,197
https://kawalpemilu.org#23055,"RENGAS, BEKRI, LAMPUNG TENGAH, LAMPUNG",10,78,51,129
https://kawalpemilu.org#23055,"RENGAS, BEKRI, LAMPUNG TENGAH, LAMPUNG",11,126,41,167
https://kawalpemilu.org#23056,"KESUMADADI, BEKRI, LAMPUNG TENGAH, LAMPUNG",1,120,79,199
https://kawalpemilu.org#23056,"KESUMADADI, BEKRI, LAMPUNG TENGAH, LAMPUNG",2,176,34,210
https://kawalpemilu.org#23056,"KESUMADADI, BEKRI, LAMPUNG TENGAH, LAMPUNG",3,62,112,174
https://kawalpemilu.org#23056,"KESUMADADI, BEKRI, LAMPUNG TENGAH, LAMPUNG",4,81,94,175
https://kawalpemilu.org#23056,"KESUMADADI, BEKRI, LAMPUNG TENGAH, LAMPUNG",5,74,58,132
https://kawalpemilu.org#23056,"KESUMADADI, BEKRI, LAMPUNG TENGAH, LAMPUNG",6,93,98,191
https://kawalpemilu.org#23056,"KESUMADADI, BEKRI, LAMPUNG TENGAH, LAMPUNG",7,94,51,145
https://kawalpemilu.org#23056,"KESUMADADI, BEKRI, LAMPUNG TENGAH, LAMPUNG",8,112,33,145
https://kawalpemilu.org#23056,"KESUMADADI, BEKRI, LAMPUNG TENGAH, LAMPUNG",9,82,94,176
https://kawalpemilu.org#23056,"KESUMADADI, BEKRI, LAMPUNG TENGAH, LAMPUNG",10,73,90,163
https://kawalpemilu.org#23056,"KESUMADADI, BEKRI, LAMPUNG TENGAH, LAMPUNG",11,136,22,158
https://kawalpemilu.org#23056,"KESUMADADI, BEKRI, LAMPUNG TENGAH, LAMPUNG",12,87,47,134
https://kawalpemilu.org#23056,"KESUMADADI, BEKRI, LAMPUNG TENGAH, LAMPUNG",13,120,45,165
https://kawalpemilu.org#23057,"SINAR BANTEN, BEKRI, LAMPUNG TENGAH, LAMPUNG",1,128,33,161
https://kawalpemilu.org#23057,"SINAR BANTEN, BEKRI, LAMPUNG TENGAH, LAMPUNG",2,90,60,150
https://kawalpemilu.org#23057,"SINAR BANTEN, BEKRI, LAMPUNG TENGAH, LAMPUNG",3,98,51,149
https://kawalpemilu.org#23057,"SINAR BANTEN, BEKRI, LAMPUNG TENGAH, LAMPUNG",4,83,34,117
https://kawalpemilu.org#23057,"SINAR BANTEN, BEKRI, LAMPUNG TENGAH, LAMPUNG",5,26,79,105
https://kawalpemilu.org#23057,"SINAR BANTEN, BEKRI, LAMPUNG TENGAH, LAMPUNG",6,161,27,188
https://kawalpemilu.org#23057,"SINAR BANTEN, BEKRI, LAMPUNG TENGAH, LAMPUNG",7,110,30,140
https://kawalpemilu.org#23057,"SINAR BANTEN, BEKRI, LAMPUNG TENGAH, LAMPUNG",8,98,51,149
https://kawalpemilu.org#23057,"SINAR BANTEN, BEKRI, LAMPUNG TENGAH, LAMPUNG",9,131,52,183
https://kawalpemilu.org#23057,"SINAR BANTEN, BEKRI, LAMPUNG TENGAH, LAMPUNG",10,127,71,198
https://kawalpemilu.org#23057,"SINAR BANTEN, BEKRI, LAMPUNG TENGAH, LAMPUNG",11,104,48,152
https://kawalpemilu.org#23057,"SINAR BANTEN, BEKRI, LAMPUNG TENGAH, LAMPUNG",12,87,32,119
https://kawalpemilu.org#23057,"SINAR BANTEN, BEKRI, LAMPUNG TENGAH, LAMPUNG",13,98,33,131
https://kawalpemilu.org#23057,"SINAR BANTEN, BEKRI, LAMPUNG TENGAH, LAMPUNG",14,37,91,128
https://kawalpemilu.org#23057,"SINAR BANTEN, BEKRI, LAMPUNG TENGAH, LAMPUNG",15,183,27,210
https://kawalpemilu.org#23057,"SINAR BANTEN, BEKRI, LAMPUNG TENGAH, LAMPUNG",16,88,47,135
https://kawalpemilu.org#23057,"SINAR BANTEN, BEKRI, LAMPUNG TENGAH, LAMPUNG",17,112,56,168
https://kawalpemilu.org#23058,"KESUMA JAYA, BEKRI, LAMPUNG TENGAH, LAMPUNG",1,130,77,207
https://kawalpemilu.org#23058,"KESUMA JAYA, BEKRI, LAMPUNG TENGAH, LAMPUNG",2,108,51,159
https://kawalpemilu.org#23058,"KESUMA JAYA, BEKRI, LAMPUNG TENGAH, LAMPUNG",3,127,70,197
https://kawalpemilu.org#23058,"KESUMA JAYA, BEKRI, LAMPUNG TENGAH, LAMPUNG",4,156,50,206
https://kawalpemilu.org#23058,"KESUMA JAYA, BEKRI, LAMPUNG TENGAH, LAMPUNG",5,113,78,191
https://kawalpemilu.org#23058,"KESUMA JAYA, BEKRI, LAMPUNG TENGAH, LAMPUNG",6,153,55,208
https://kawalpemilu.org#23058,"KESUMA JAYA, BEKRI, LAMPUNG TENGAH, LAMPUNG",7,143,21,164
https://kawalpemilu.org#23058,"KESUMA JAYA, BEKRI, LAMPUNG TENGAH, LAMPUNG",8,140,72,212
https://kawalpemilu.org#23058,"KESUMA JAYA, BEKRI, LAMPUNG TENGAH, LAMPUNG",9,87,69,156
https://kawalpemilu.org#23058,"KESUMA JAYA, BEKRI, LAMPUNG TENGAH, LAMPUNG",10,147,55,202
https://kawalpemilu.org#23058,"KESUMA JAYA, BEKRI, LAMPUNG TENGAH, LAMPUNG",11,123,64,187
https://kawalpemilu.org#23058,"KESUMA JAYA, BEKRI, LAMPUNG TENGAH, LAMPUNG",12,156,40,196
https://kawalpemilu.org#23058,"KESUMA JAYA, BEKRI, LAMPUNG TENGAH, LAMPUNG",13,115,69,184
https://kawalpemilu.org#23058,"KESUMA JAYA, BEKRI, LAMPUNG TENGAH, LAMPUNG",14,160,52,212
https://kawalpemilu.org#23058,"KESUMA JAYA, BEKRI, LAMPUNG TENGAH, LAMPUNG",15,129,38,167
https://kawalpemilu.org#23058,"KESUMA JAYA, BEKRI, LAMPUNG TENGAH, LAMPUNG",16,113,64,177
https://kawalpemilu.org#23059,"BINJAI NGAGUNG, BEKRI, LAMPUNG TENGAH, LAMPUNG",1,108,55,163
https://kawalpemilu.org#23059,"BINJAI NGAGUNG, BEKRI, LAMPUNG TENGAH, LAMPUNG",2,171,26,197
https://kawalpemilu.org#23059,"BINJAI NGAGUNG, BEKRI, LAMPUNG TENGAH, LAMPUNG",3,169,38,207
https://kawalpemilu.org#23059,"BINJAI NGAGUNG, BEKRI, LAMPUNG TENGAH, LAMPUNG",4,125,19,144
https://kawalpemilu.org#23059,"BINJAI NGAGUNG, BEKRI, LAMPUNG TENGAH, LAMPUNG",5,102,70,172
https://kawalpemilu.org#23059,"BINJAI NGAGUNG, BEKRI, LAMPUNG TENGAH, LAMPUNG",6,139,36,175
https://kawalpemilu.org#23059,"BINJAI NGAGUNG, BEKRI, LAMPUNG TENGAH, LAMPUNG",7,157,46,203
https://kawalpemilu.org#23059,"BINJAI NGAGUNG, BEKRI, LAMPUNG TENGAH, LAMPUNG",8,169,30,199
https://kawalpemilu.org#23059,"BINJAI NGAGUNG, BEKRI, LAMPUNG TENGAH, LAMPUNG",9,106,38,144
https://kawalpemilu.org#23060,"KEDATUAN, BEKRI, LAMPUNG TENGAH, LAMPUNG",1,124,54,178
https://kawalpemilu.org#23060,"KEDATUAN, BEKRI, LAMPUNG TENGAH, LAMPUNG",2,171,42,213
https://kawalpemilu.org#23060,"KEDATUAN, BEKRI, LAMPUNG TENGAH, LAMPUNG",3,82,69,151
https://kawalpemilu.org#23060,"KEDATUAN, BEKRI, LAMPUNG TENGAH, LAMPUNG",4,118,45,163
https://kawalpemilu.org#23060,"KEDATUAN, BEKRI, LAMPUNG TENGAH, LAMPUNG",5,109,56,165
https://kawalpemilu.org#23061,"GORAS JAYA, BEKRI, LAMPUNG TENGAH, LAMPUNG",1,143,98,241
https://kawalpemilu.org#23061,"GORAS JAYA, BEKRI, LAMPUNG TENGAH, LAMPUNG",2,142,91,233
https://kawalpemilu.org#23061,"GORAS JAYA, BEKRI, LAMPUNG TENGAH, LAMPUNG",3,98,67,165
https://kawalpemilu.org#23061,"GORAS JAYA, BEKRI, LAMPUNG TENGAH, LAMPUNG",4,114,65,179
https://kawalpemilu.org#23061,"GORAS JAYA, BEKRI, LAMPUNG TENGAH, LAMPUNG",5,151,90,241
https://kawalpemilu.org#23061,"GORAS JAYA, BEKRI, LAMPUNG TENGAH, LAMPUNG",6,118,37,155
https://kawalpemilu.org#23061,"GORAS JAYA, BEKRI, LAMPUNG TENGAH, LAMPUNG",7,149,38,187
https://kawalpemilu.org#23061,"GORAS JAYA, BEKRI, LAMPUNG TENGAH, LAMPUNG",8,137,38,175
https://kawalpemilu.org#23061,"GORAS JAYA, BEKRI, LAMPUNG TENGAH, LAMPUNG",9,141,60,201
https://kawalpemilu.org#23061,"GORAS JAYA, BEKRI, LAMPUNG TENGAH, LAMPUNG",10,127,47,174
https://kawalpemilu.org#23061,"GORAS JAYA, BEKRI, LAMPUNG TENGAH, LAMPUNG",11,76,79,155
https://kawalpemilu.org#23062,"BANGUN SARI, BEKRI, LAMPUNG TENGAH, LAMPUNG",1,171,31,202
https://kawalpemilu.org#23062,"BANGUN SARI, BEKRI, LAMPUNG TENGAH, LAMPUNG",2,153,26,179
https://kawalpemilu.org#23062,"BANGUN SARI, BEKRI, LAMPUNG TENGAH, LAMPUNG",3,172,25,197
https://kawalpemilu.org#23062,"BANGUN SARI, BEKRI, LAMPUNG TENGAH, LAMPUNG",4,162,33,195
https://kawalpemilu.org#23062,"BANGUN SARI, BEKRI, LAMPUNG TENGAH, LAMPUNG",5,172,18,190
https://kawalpemilu.org#23064,"HARAPAN REJO, SEPUTIH AGUNG, LAMPUNG TENGAH, LAMPUNG",1,84,55,139
https://kawalpemilu.org#23064,"HARAPAN REJO, SEPUTIH AGUNG, LAMPUNG TENGAH, LAMPUNG",2,102,78,180
https://kawalpemilu.org#23064,"HARAPAN REJO, SEPUTIH AGUNG, LAMPUNG TENGAH, LAMPUNG",3,76,59,135
https://kawalpemilu.org#23064,"HARAPAN REJO, SEPUTIH AGUNG, LAMPUNG TENGAH, LAMPUNG",4,84,78,162
https://kawalpemilu.org#23064,"HARAPAN REJO, SEPUTIH AGUNG, LAMPUNG TENGAH, LAMPUNG",5,68,66,134
https://kawalpemilu.org#23064,"HARAPAN REJO, SEPUTIH AGUNG, LAMPUNG TENGAH, LAMPUNG",6,96,58,154
https://kawalpemilu.org#23064,"HARAPAN REJO, SEPUTIH AGUNG, LAMPUNG TENGAH, LAMPUNG",7,94,65,159
https://kawalpemilu.org#23064,"HARAPAN REJO, SEPUTIH AGUNG, LAMPUNG TENGAH, LAMPUNG",8,84,48,132
https://kawalpemilu.org#23064,"HARAPAN REJO, SEPUTIH AGUNG, LAMPUNG TENGAH, LAMPUNG",9,93,46,139
https://kawalpemilu.org#23064,"HARAPAN REJO, SEPUTIH AGUNG, LAMPUNG TENGAH, LAMPUNG",10,91,76,167
https://kawalpemilu.org#23064,"HARAPAN REJO, SEPUTIH AGUNG, LAMPUNG TENGAH, LAMPUNG",11,115,88,203
https://kawalpemilu.org#23064,"HARAPAN REJO, SEPUTIH AGUNG, LAMPUNG TENGAH, LAMPUNG",12,69,93,162
https://kawalpemilu.org#23064,"HARAPAN REJO, SEPUTIH AGUNG, LAMPUNG TENGAH, LAMPUNG",13,105,79,184
https://kawalpemilu.org#23064,"HARAPAN REJO, SEPUTIH AGUNG, LAMPUNG TENGAH, LAMPUNG",14,46,50,96
https://kawalpemilu.org#23064,"HARAPAN REJO, SEPUTIH AGUNG, LAMPUNG TENGAH, LAMPUNG",15,95,64,159
https://kawalpemilu.org#23064,"HARAPAN REJO, SEPUTIH AGUNG, LAMPUNG TENGAH, LAMPUNG",16,101,38,139
https://kawalpemilu.org#23064,"HARAPAN REJO, SEPUTIH AGUNG, LAMPUNG TENGAH, LAMPUNG",17,71,57,128
https://kawalpemilu.org#23064,"HARAPAN REJO, SEPUTIH AGUNG, LAMPUNG TENGAH, LAMPUNG",18,109,73,182
https://kawalpemilu.org#23065,"ENDANG REJO, SEPUTIH AGUNG, LAMPUNG TENGAH, LAMPUNG",1,138,49,187
https://kawalpemilu.org#23065,"ENDANG REJO, SEPUTIH AGUNG, LAMPUNG TENGAH, LAMPUNG",2,113,67,180
https://kawalpemilu.org#23065,"ENDANG REJO, SEPUTIH AGUNG, LAMPUNG TENGAH, LAMPUNG",3,123,71,194
https://kawalpemilu.org#23065,"ENDANG REJO, SEPUTIH AGUNG, LAMPUNG TENGAH, LAMPUNG",4,100,84,184
https://kawalpemilu.org#23065,"ENDANG REJO, SEPUTIH AGUNG, LAMPUNG TENGAH, LAMPUNG",5,103,100,203
https://kawalpemilu.org#23065,"ENDANG REJO, SEPUTIH AGUNG, LAMPUNG TENGAH, LAMPUNG",6,122,72,194
https://kawalpemilu.org#23065,"ENDANG REJO, SEPUTIH AGUNG, LAMPUNG TENGAH, LAMPUNG",7,129,57,186
https://kawalpemilu.org#23065,"ENDANG REJO, SEPUTIH AGUNG, LAMPUNG TENGAH, LAMPUNG",8,125,106,231
https://kawalpemilu.org#23065,"ENDANG REJO, SEPUTIH AGUNG, LAMPUNG TENGAH, LAMPUNG",9,56,85,141
https://kawalpemilu.org#23065,"ENDANG REJO, SEPUTIH AGUNG, LAMPUNG TENGAH, LAMPUNG",10,114,50,164
https://kawalpemilu.org#23065,"ENDANG REJO, SEPUTIH AGUNG, LAMPUNG TENGAH, LAMPUNG",11,81,94,175
https://kawalpemilu.org#23065,"ENDANG REJO, SEPUTIH AGUNG, LAMPUNG TENGAH, LAMPUNG",12,112,67,179
https://kawalpemilu.org#23065,"ENDANG REJO, SEPUTIH AGUNG, LAMPUNG TENGAH, LAMPUNG",13,116,75,191
https://kawalpemilu.org#23065,"ENDANG REJO, SEPUTIH AGUNG, LAMPUNG TENGAH, LAMPUNG",14,88,82,170
https://kawalpemilu.org#23065,"ENDANG REJO, SEPUTIH AGUNG, LAMPUNG TENGAH, LAMPUNG",15,130,62,192
https://kawalpemilu.org#23065,"ENDANG REJO, SEPUTIH AGUNG, LAMPUNG TENGAH, LAMPUNG",16,154,51,205
https://kawalpemilu.org#23065,"ENDANG REJO, SEPUTIH AGUNG, LAMPUNG TENGAH, LAMPUNG",17,128,87,215
https://kawalpemilu.org#23065,"ENDANG REJO, SEPUTIH AGUNG, LAMPUNG TENGAH, LAMPUNG",18,62,111,173
https://kawalpemilu.org#23066,"DONO ARUM, SEPUTIH AGUNG, LAMPUNG TENGAH, LAMPUNG",1,117,50,167
https://kawalpemilu.org#23066,"DONO ARUM, SEPUTIH AGUNG, LAMPUNG TENGAH, LAMPUNG",2,153,43,196
https://kawalpemilu.org#23066,"DONO ARUM, SEPUTIH AGUNG, LAMPUNG TENGAH, LAMPUNG",3,135,62,197
https://kawalpemilu.org#23066,"DONO ARUM, SEPUTIH AGUNG, LAMPUNG TENGAH, LAMPUNG",4,144,63,207
https://kawalpemilu.org#23066,"DONO ARUM, SEPUTIH AGUNG, LAMPUNG TENGAH, LAMPUNG",5,168,38,206
https://kawalpemilu.org#23066,"DONO ARUM, SEPUTIH AGUNG, LAMPUNG TENGAH, LAMPUNG",6,91,46,137
https://kawalpemilu.org#23066,"DONO ARUM, SEPUTIH AGUNG, LAMPUNG TENGAH, LAMPUNG",7,114,74,188
https://kawalpemilu.org#23066,"DONO ARUM, SEPUTIH AGUNG, LAMPUNG TENGAH, LAMPUNG",8,126,61,187
https://kawalpemilu.org#23066,"DONO ARUM, SEPUTIH AGUNG, LAMPUNG TENGAH, LAMPUNG",9,134,50,1
https://kawalpemilu.org#23066,"DONO ARUM, SEPUTIH AGUNG, LAMPUNG TENGAH, LAMPUNG",10,83,54,137
https://kawalpemilu.org#23066,"DONO ARUM, SEPUTIH AGUNG, LAMPUNG TENGAH, LAMPUNG",11,155,31,186
https://kawalpemilu.org#23066,"DONO ARUM, SEPUTIH AGUNG, LAMPUNG TENGAH, LAMPUNG",12,118,89,207
https://kawalpemilu.org#23066,"DONO ARUM, SEPUTIH AGUNG, LAMPUNG TENGAH, LAMPUNG",13,125,56,181
https://kawalpemilu.org#23066,"DONO ARUM, SEPUTIH AGUNG, LAMPUNG TENGAH, LAMPUNG",14,89,43,132
https://kawalpemilu.org#23066,"DONO ARUM, SEPUTIH AGUNG, LAMPUNG TENGAH, LAMPUNG",15,122,57,179
https://kawalpemilu.org#23066,"DONO ARUM, SEPUTIH AGUNG, LAMPUNG TENGAH, LAMPUNG",16,135,31,166
https://kawalpemilu.org#23067,"SIMPANG AGUNG, SEPUTIH AGUNG, LAMPUNG TENGAH, LAMPUNG",1,140,56,196
https://kawalpemilu.org#23067,"SIMPANG AGUNG, SEPUTIH AGUNG, LAMPUNG TENGAH, LAMPUNG",2,112,54,166
https://kawalpemilu.org#23067,"SIMPANG AGUNG, SEPUTIH AGUNG, LAMPUNG TENGAH, LAMPUNG",3,160,35,195
https://kawalpemilu.org#23067,"SIMPANG AGUNG, SEPUTIH AGUNG, LAMPUNG TENGAH, LAMPUNG",4,121,17,138
https://kawalpemilu.org#23067,"SIMPANG AGUNG, SEPUTIH AGUNG, LAMPUNG TENGAH, LAMPUNG",5,94,67,161
https://kawalpemilu.org#23067,"SIMPANG AGUNG, SEPUTIH AGUNG, LAMPUNG TENGAH, LAMPUNG",6,125,29,154
https://kawalpemilu.org#23067,"SIMPANG AGUNG, SEPUTIH AGUNG, LAMPUNG TENGAH, LAMPUNG",7,112,46,158
https://kawalpemilu.org#23067,"SIMPANG AGUNG, SEPUTIH AGUNG, LAMPUNG TENGAH, LAMPUNG",8,130,26,156
https://kawalpemilu.org#23067,"SIMPANG AGUNG, SEPUTIH AGUNG, LAMPUNG TENGAH, LAMPUNG",9,120,27,147
https://kawalpemilu.org#23067,"SIMPANG AGUNG, SEPUTIH AGUNG, LAMPUNG TENGAH, LAMPUNG",10,102,27,129
https://kawalpemilu.org#23067,"SIMPANG AGUNG, SEPUTIH AGUNG, LAMPUNG TENGAH, LAMPUNG",11,89,37,126
https://kawalpemilu.org#23067,"SIMPANG AGUNG, SEPUTIH AGUNG, LAMPUNG TENGAH, LAMPUNG",12,153,52,205
https://kawalpemilu.org#23067,"SIMPANG AGUNG, SEPUTIH AGUNG, LAMPUNG TENGAH, LAMPUNG",13,125,41,166
https://kawalpemilu.org#23067,"SIMPANG AGUNG, SEPUTIH AGUNG, LAMPUNG TENGAH, LAMPUNG",14,125,35,160
https://kawalpemilu.org#23067,"SIMPANG AGUNG, SEPUTIH AGUNG, LAMPUNG TENGAH, LAMPUNG",15,120,39,159
https://kawalpemilu.org#23067,"SIMPANG AGUNG, SEPUTIH AGUNG, LAMPUNG TENGAH, LAMPUNG",16,112,39,151
https://kawalpemilu.org#23067,"SIMPANG AGUNG, SEPUTIH AGUNG, LAMPUNG TENGAH, LAMPUNG",17,96,44,140
https://kawalpemilu.org#23067,"SIMPANG AGUNG, SEPUTIH AGUNG, LAMPUNG TENGAH, LAMPUNG",18,117,42,159
https://kawalpemilu.org#23067,"SIMPANG AGUNG, SEPUTIH AGUNG, LAMPUNG TENGAH, LAMPUNG",19,107,50,157
https://kawalpemilu.org#23067,"SIMPANG AGUNG, SEPUTIH AGUNG, LAMPUNG TENGAH, LAMPUNG",20,100,42,142
https://kawalpemilu.org#23067,"SIMPANG AGUNG, SEPUTIH AGUNG, LAMPUNG TENGAH, LAMPUNG",21,102,20,122
https://kawalpemilu.org#23067,"SIMPANG AGUNG, SEPUTIH AGUNG, LAMPUNG TENGAH, LAMPUNG",22,122,29,151
https://kawalpemilu.org#23067,"SIMPANG AGUNG, SEPUTIH AGUNG, LAMPUNG TENGAH, LAMPUNG",23,115,49,164
https://kawalpemilu.org#23067,"SIMPANG AGUNG, SEPUTIH AGUNG, LAMPUNG TENGAH, LAMPUNG",24,135,19,154
https://kawalpemilu.org#23067,"SIMPANG AGUNG, SEPUTIH AGUNG, LAMPUNG TENGAH, LAMPUNG",25,103,44,147
https://kawalpemilu.org#23067,"SIMPANG AGUNG, SEPUTIH AGUNG, LAMPUNG TENGAH, LAMPUNG",26,91,55,146
https://kawalpemilu.org#23068,"BUMI KENCANA, SEPUTIH AGUNG, LAMPUNG TENGAH, LAMPUNG",1,128,116,244
https://kawalpemilu.org#23068,"BUMI KENCANA, SEPUTIH AGUNG, LAMPUNG TENGAH, LAMPUNG",2,131,57,188
https://kawalpemilu.org#23068,"BUMI KENCANA, SEPUTIH AGUNG, LAMPUNG TENGAH, LAMPUNG",3,213,36,249
https://kawalpemilu.org#23068,"BUMI KENCANA, SEPUTIH AGUNG, LAMPUNG TENGAH, LAMPUNG",4,176,44,220
https://kawalpemilu.org#23068,"BUMI KENCANA, SEPUTIH AGUNG, LAMPUNG TENGAH, LAMPUNG",5,182,62,244
https://kawalpemilu.org#23068,"BUMI KENCANA, SEPUTIH AGUNG, LAMPUNG TENGAH, LAMPUNG",6,106,109,215
https://kawalpemilu.org#23068,"BUMI KENCANA, SEPUTIH AGUNG, LAMPUNG TENGAH, LAMPUNG",7,150,43,193
https://kawalpemilu.org#23068,"BUMI KENCANA, SEPUTIH AGUNG, LAMPUNG TENGAH, LAMPUNG",8,133,58,191
https://kawalpemilu.org#23068,"BUMI KENCANA, SEPUTIH AGUNG, LAMPUNG TENGAH, LAMPUNG",9,149,52,201
https://kawalpemilu.org#23068,"BUMI KENCANA, SEPUTIH AGUNG, LAMPUNG TENGAH, LAMPUNG",10,111,75,186
https://kawalpemilu.org#23068,"BUMI KENCANA, SEPUTIH AGUNG, LAMPUNG TENGAH, LAMPUNG",11,170,99,269
https://kawalpemilu.org#23068,"BUMI KENCANA, SEPUTIH AGUNG, LAMPUNG TENGAH, LAMPUNG",12,140,74,214
https://kawalpemilu.org#23068,"BUMI KENCANA, SEPUTIH AGUNG, LAMPUNG TENGAH, LAMPUNG",13,128,75,203
https://kawalpemilu.org#23068,"BUMI KENCANA, SEPUTIH AGUNG, LAMPUNG TENGAH, LAMPUNG",14,196,56,252
https://kawalpemilu.org#23069,"GAYAU SAKTI, SEPUTIH AGUNG, LAMPUNG TENGAH, LAMPUNG",1,103,84,187
https://kawalpemilu.org#23069,"GAYAU SAKTI, SEPUTIH AGUNG, LAMPUNG TENGAH, LAMPUNG",2,162,56,218
https://kawalpemilu.org#23069,"GAYAU SAKTI, SEPUTIH AGUNG, LAMPUNG TENGAH, LAMPUNG",3,179,24,203
https://kawalpemilu.org#23069,"GAYAU SAKTI, SEPUTIH AGUNG, LAMPUNG TENGAH, LAMPUNG",4,103,55,158
https://kawalpemilu.org#23069,"GAYAU SAKTI, SEPUTIH AGUNG, LAMPUNG TENGAH, LAMPUNG",5,82,54,136
https://kawalpemilu.org#23069,"GAYAU SAKTI, SEPUTIH AGUNG, LAMPUNG TENGAH, LAMPUNG",6,126,65,191
https://kawalpemilu.org#23069,"GAYAU SAKTI, SEPUTIH AGUNG, LAMPUNG TENGAH, LAMPUNG",7,104,72,176
https://kawalpemilu.org#23069,"GAYAU SAKTI, SEPUTIH AGUNG, LAMPUNG TENGAH, LAMPUNG",8,89,69,158
https://kawalpemilu.org#23069,"GAYAU SAKTI, SEPUTIH AGUNG, LAMPUNG TENGAH, LAMPUNG",9,107,52,159
https://kawalpemilu.org#23069,"GAYAU SAKTI, SEPUTIH AGUNG, LAMPUNG TENGAH, LAMPUNG",10,94,51,145
https://kawalpemilu.org#23069,"GAYAU SAKTI, SEPUTIH AGUNG, LAMPUNG TENGAH, LAMPUNG",11,163,56,119
https://kawalpemilu.org#23069,"GAYAU SAKTI, SEPUTIH AGUNG, LAMPUNG TENGAH, LAMPUNG",12,103,47,150
https://kawalpemilu.org#23069,"GAYAU SAKTI, SEPUTIH AGUNG, LAMPUNG TENGAH, LAMPUNG",13,111,49,160
https://kawalpemilu.org#23069,"GAYAU SAKTI, SEPUTIH AGUNG, LAMPUNG TENGAH, LAMPUNG",14,156,46,202
https://kawalpemilu.org#23069,"GAYAU SAKTI, SEPUTIH AGUNG, LAMPUNG TENGAH, LAMPUNG",15,145,64,209
https://kawalpemilu.org#23069,"GAYAU SAKTI, SEPUTIH AGUNG, LAMPUNG TENGAH, LAMPUNG",16,147,91,238
https://kawalpemilu.org#23069,"GAYAU SAKTI, SEPUTIH AGUNG, LAMPUNG TENGAH, LAMPUNG",17,118,87,205
https://kawalpemilu.org#23070,"FAJAR ASRI, SEPUTIH AGUNG, LAMPUNG TENGAH, LAMPUNG",1,134,20,154
https://kawalpemilu.org#23070,"FAJAR ASRI, SEPUTIH AGUNG, LAMPUNG TENGAH, LAMPUNG",2,118,13,131
https://kawalpemilu.org#23070,"FAJAR ASRI, SEPUTIH AGUNG, LAMPUNG TENGAH, LAMPUNG",3,106,21,127
https://kawalpemilu.org#23070,"FAJAR ASRI, SEPUTIH AGUNG, LAMPUNG TENGAH, LAMPUNG",4,120,54,174
https://kawalpemilu.org#23070,"FAJAR ASRI, SEPUTIH AGUNG, LAMPUNG TENGAH, LAMPUNG",5,107,68,175
https://kawalpemilu.org#23070,"FAJAR ASRI, SEPUTIH AGUNG, LAMPUNG TENGAH, LAMPUNG",6,123,59,182
https://kawalpemilu.org#23070,"FAJAR ASRI, SEPUTIH AGUNG, LAMPUNG TENGAH, LAMPUNG",7,73,48,121
https://kawalpemilu.org#23070,"FAJAR ASRI, SEPUTIH AGUNG, LAMPUNG TENGAH, LAMPUNG",8,114,25,139
https://kawalpemilu.org#23070,"FAJAR ASRI, SEPUTIH AGUNG, LAMPUNG TENGAH, LAMPUNG",9,102,18,120
https://kawalpemilu.org#23070,"FAJAR ASRI, SEPUTIH AGUNG, LAMPUNG TENGAH, LAMPUNG",10,95,32,127
https://kawalpemilu.org#23070,"FAJAR ASRI, SEPUTIH AGUNG, LAMPUNG TENGAH, LAMPUNG",11,134,33,167
https://kawalpemilu.org#23070,"FAJAR ASRI, SEPUTIH AGUNG, LAMPUNG TENGAH, LAMPUNG",12,163,41,204
https://kawalpemilu.org#23070,"FAJAR ASRI, SEPUTIH AGUNG, LAMPUNG TENGAH, LAMPUNG",13,123,47,170
https://kawalpemilu.org#23070,"FAJAR ASRI, SEPUTIH AGUNG, LAMPUNG TENGAH, LAMPUNG",14,114,33,147
https://kawalpemilu.org#23071,"MUJI RAHAYU, SEPUTIH AGUNG, LAMPUNG TENGAH, LAMPUNG",1,146,55,201
https://kawalpemilu.org#23071,"MUJI RAHAYU, SEPUTIH AGUNG, LAMPUNG TENGAH, LAMPUNG",2,178,28,206
https://kawalpemilu.org#23071,"MUJI RAHAYU, SEPUTIH AGUNG, LAMPUNG TENGAH, LAMPUNG",3,113,28,141
https://kawalpemilu.org#23071,"MUJI RAHAYU, SEPUTIH AGUNG, LAMPUNG TENGAH, LAMPUNG",4,115,29,144
https://kawalpemilu.org#23071,"MUJI RAHAYU, SEPUTIH AGUNG, LAMPUNG TENGAH, LAMPUNG",5,91,30,121
https://kawalpemilu.org#23071,"MUJI RAHAYU, SEPUTIH AGUNG, LAMPUNG TENGAH, LAMPUNG",6,130,44,174
https://kawalpemilu.org#23071,"MUJI RAHAYU, SEPUTIH AGUNG, LAMPUNG TENGAH, LAMPUNG",7,128,32,160
https://kawalpemilu.org#23071,"MUJI RAHAYU, SEPUTIH AGUNG, LAMPUNG TENGAH, LAMPUNG",8,120,30,150
https://kawalpemilu.org#23071,"MUJI RAHAYU, SEPUTIH AGUNG, LAMPUNG TENGAH, LAMPUNG",9,123,54,177
https://kawalpemilu.org#23071,"MUJI RAHAYU, SEPUTIH AGUNG, LAMPUNG TENGAH, LAMPUNG",10,150,73,223
https://kawalpemilu.org#23071,"MUJI RAHAYU, SEPUTIH AGUNG, LAMPUNG TENGAH, LAMPUNG",11,175,52,227
https://kawalpemilu.org#23071,"MUJI RAHAYU, SEPUTIH AGUNG, LAMPUNG TENGAH, LAMPUNG",12,145,27,172
https://kawalpemilu.org#23071,"MUJI RAHAYU, SEPUTIH AGUNG, LAMPUNG TENGAH, LAMPUNG",13,119,14,133
https://kawalpemilu.org#23071,"MUJI RAHAYU, SEPUTIH AGUNG, LAMPUNG TENGAH, LAMPUNG",14,79,63,143
https://kawalpemilu.org#23071,"MUJI RAHAYU, SEPUTIH AGUNG, LAMPUNG TENGAH, LAMPUNG",15,90,30,120
https://kawalpemilu.org#23071,"MUJI RAHAYU, SEPUTIH AGUNG, LAMPUNG TENGAH, LAMPUNG",16,100,29,129
https://kawalpemilu.org#23071,"MUJI RAHAYU, SEPUTIH AGUNG, LAMPUNG TENGAH, LAMPUNG",17,105,70,175
https://kawalpemilu.org#23071,"MUJI RAHAYU, SEPUTIH AGUNG, LAMPUNG TENGAH, LAMPUNG",18,112,21,133
https://kawalpemilu.org#23071,"MUJI RAHAYU, SEPUTIH AGUNG, LAMPUNG TENGAH, LAMPUNG",19,144,44,188
https://kawalpemilu.org#23071,"MUJI RAHAYU, SEPUTIH AGUNG, LAMPUNG TENGAH, LAMPUNG",20,119,63,182
https://kawalpemilu.org#23071,"MUJI RAHAYU, SEPUTIH AGUNG, LAMPUNG TENGAH, LAMPUNG",21,157,37,194
https://kawalpemilu.org#23071,"MUJI RAHAYU, SEPUTIH AGUNG, LAMPUNG TENGAH, LAMPUNG",22,157,45,202
https://kawalpemilu.org#23072,"SULUSUBAN, SEPUTIH AGUNG, LAMPUNG TENGAH, LAMPUNG",1,125,48,173
https://kawalpemilu.org#23072,"SULUSUBAN, SEPUTIH AGUNG, LAMPUNG TENGAH, LAMPUNG",2,73,59,132
https://kawalpemilu.org#23072,"SULUSUBAN, SEPUTIH AGUNG, LAMPUNG TENGAH, LAMPUNG",3,162,88,250
https://kawalpemilu.org#23072,"SULUSUBAN, SEPUTIH AGUNG, LAMPUNG TENGAH, LAMPUNG",4,166,49,215
https://kawalpemilu.org#23072,"SULUSUBAN, SEPUTIH AGUNG, LAMPUNG TENGAH, LAMPUNG",5,89,109,198
https://kawalpemilu.org#23072,"SULUSUBAN, SEPUTIH AGUNG, LAMPUNG TENGAH, LAMPUNG",6,105,56,161
https://kawalpemilu.org#23072,"SULUSUBAN, SEPUTIH AGUNG, LAMPUNG TENGAH, LAMPUNG",7,122,56,178
https://kawalpemilu.org#23072,"SULUSUBAN, SEPUTIH AGUNG, LAMPUNG TENGAH, LAMPUNG",8,148,80,228
https://kawalpemilu.org#23072,"SULUSUBAN, SEPUTIH AGUNG, LAMPUNG TENGAH, LAMPUNG",9,139,74,1
https://kawalpemilu.org#23072,"SULUSUBAN, SEPUTIH AGUNG, LAMPUNG TENGAH, LAMPUNG",10,105,76,181
https://kawalpemilu.org#23072,"SULUSUBAN, SEPUTIH AGUNG, LAMPUNG TENGAH, LAMPUNG",11,91,61,152
https://kawalpemilu.org#23072,"SULUSUBAN, SEPUTIH AGUNG, LAMPUNG TENGAH, LAMPUNG",12,153,33,186
https://kawalpemilu.org#23072,"SULUSUBAN, SEPUTIH AGUNG, LAMPUNG TENGAH, LAMPUNG",13,121,53,174
https://kawalpemilu.org#23072,"SULUSUBAN, SEPUTIH AGUNG, LAMPUNG TENGAH, LAMPUNG",14,188,18,206
https://kawalpemilu.org#23072,"SULUSUBAN, SEPUTIH AGUNG, LAMPUNG TENGAH, LAMPUNG",15,115,51,166
https://kawalpemilu.org#23072,"SULUSUBAN, SEPUTIH AGUNG, LAMPUNG TENGAH, LAMPUNG",16,77,47,124
https://kawalpemilu.org#23072,"SULUSUBAN, SEPUTIH AGUNG, LAMPUNG TENGAH, LAMPUNG",17,164,53,217
https://kawalpemilu.org#23072,"SULUSUBAN, SEPUTIH AGUNG, LAMPUNG TENGAH, LAMPUNG",18,85,63,148
https://kawalpemilu.org#23072,"SULUSUBAN, SEPUTIH AGUNG, LAMPUNG TENGAH, LAMPUNG",19,109,63,172
https://kawalpemilu.org#23072,"SULUSUBAN, SEPUTIH AGUNG, LAMPUNG TENGAH, LAMPUNG",20,131,49,180
https://kawalpemilu.org#23072,"SULUSUBAN, SEPUTIH AGUNG, LAMPUNG TENGAH, LAMPUNG",21,143,14,157
https://kawalpemilu.org#23072,"SULUSUBAN, SEPUTIH AGUNG, LAMPUNG TENGAH, LAMPUNG",22,87,55,142
https://kawalpemilu.org#23072,"SULUSUBAN, SEPUTIH AGUNG, LAMPUNG TENGAH, LAMPUNG",23,127,23,150
https://kawalpemilu.org#23072,"SULUSUBAN, SEPUTIH AGUNG, LAMPUNG TENGAH, LAMPUNG",24,100,22,122
https://kawalpemilu.org#23072,"SULUSUBAN, SEPUTIH AGUNG, LAMPUNG TENGAH, LAMPUNG",25,138,15,153
https://kawalpemilu.org#23072,"SULUSUBAN, SEPUTIH AGUNG, LAMPUNG TENGAH, LAMPUNG",26,124,20,144
https://kawalpemilu.org#928199,"BUMI MAS, SEPUTIH AGUNG, LAMPUNG TENGAH, LAMPUNG",1,116,62,178
https://kawalpemilu.org#928199,"BUMI MAS, SEPUTIH AGUNG, LAMPUNG TENGAH, LAMPUNG",2,119,66,185
https://kawalpemilu.org#928199,"BUMI MAS, SEPUTIH AGUNG, LAMPUNG TENGAH, LAMPUNG",3,128,63,191
https://kawalpemilu.org#928199,"BUMI MAS, SEPUTIH AGUNG, LAMPUNG TENGAH, LAMPUNG",4,143,76,219
https://kawalpemilu.org#928199,"BUMI MAS, SEPUTIH AGUNG, LAMPUNG TENGAH, LAMPUNG",5,124,43,167
https://kawalpemilu.org#928199,"BUMI MAS, SEPUTIH AGUNG, LAMPUNG TENGAH, LAMPUNG",6,111,47,158
https://kawalpemilu.org#928199,"BUMI MAS, SEPUTIH AGUNG, LAMPUNG TENGAH, LAMPUNG",7,188,39,227
https://kawalpemilu.org#23074,"TANJUNG RATU ILIR, WAY PENGUBUAN, LAMPUNG TENGAH, LAMPUNG",1,61,131,192
https://kawalpemilu.org#23074,"TANJUNG RATU ILIR, WAY PENGUBUAN, LAMPUNG TENGAH, LAMPUNG",2,68,153,221
https://kawalpemilu.org#23074,"TANJUNG RATU ILIR, WAY PENGUBUAN, LAMPUNG TENGAH, LAMPUNG",3,69,117,186
https://kawalpemilu.org#23074,"TANJUNG RATU ILIR, WAY PENGUBUAN, LAMPUNG TENGAH, LAMPUNG",4,40,146,186
https://kawalpemilu.org#23074,"TANJUNG RATU ILIR, WAY PENGUBUAN, LAMPUNG TENGAH, LAMPUNG",5,135,59,194
https://kawalpemilu.org#23074,"TANJUNG RATU ILIR, WAY PENGUBUAN, LAMPUNG TENGAH, LAMPUNG",6,155,41,196
https://kawalpemilu.org#23074,"TANJUNG RATU ILIR, WAY PENGUBUAN, LAMPUNG TENGAH, LAMPUNG",7,139,26,165
https://kawalpemilu.org#23074,"TANJUNG RATU ILIR, WAY PENGUBUAN, LAMPUNG TENGAH, LAMPUNG",8,112,76,188
https://kawalpemilu.org#23074,"TANJUNG RATU ILIR, WAY PENGUBUAN, LAMPUNG TENGAH, LAMPUNG",9,159,103,262
https://kawalpemilu.org#23074,"TANJUNG RATU ILIR, WAY PENGUBUAN, LAMPUNG TENGAH, LAMPUNG",10,190,40,230
https://kawalpemilu.org#23074,"TANJUNG RATU ILIR, WAY PENGUBUAN, LAMPUNG TENGAH, LAMPUNG",11,25,164,189
https://kawalpemilu.org#23074,"TANJUNG RATU ILIR, WAY PENGUBUAN, LAMPUNG TENGAH, LAMPUNG",12,79,35,114
https://kawalpemilu.org#23074,"TANJUNG RATU ILIR, WAY PENGUBUAN, LAMPUNG TENGAH, LAMPUNG",13,136,58,194
https://kawalpemilu.org#23074,"TANJUNG RATU ILIR, WAY PENGUBUAN, LAMPUNG TENGAH, LAMPUNG",14,125,35,160
https://kawalpemilu.org#23074,"TANJUNG RATU ILIR, WAY PENGUBUAN, LAMPUNG TENGAH, LAMPUNG",15,103,70,173
https://kawalpemilu.org#23075,"CANDI REJO, WAY PENGUBUAN, LAMPUNG TENGAH, LAMPUNG",1,110,95,205
https://kawalpemilu.org#23075,"CANDI REJO, WAY PENGUBUAN, LAMPUNG TENGAH, LAMPUNG",2,83,104,187
https://kawalpemilu.org#23075,"CANDI REJO, WAY PENGUBUAN, LAMPUNG TENGAH, LAMPUNG",3,90,137,227
https://kawalpemilu.org#23075,"CANDI REJO, WAY PENGUBUAN, LAMPUNG TENGAH, LAMPUNG",4,72,127,199
https://kawalpemilu.org#23075,"CANDI REJO, WAY PENGUBUAN, LAMPUNG TENGAH, LAMPUNG",5,73,183,256
https://kawalpemilu.org#23075,"CANDI REJO, WAY PENGUBUAN, LAMPUNG TENGAH, LAMPUNG",6,76,161,237
https://kawalpemilu.org#23075,"CANDI REJO, WAY PENGUBUAN, LAMPUNG TENGAH, LAMPUNG",7,97,71,168
https://kawalpemilu.org#23075,"CANDI REJO, WAY PENGUBUAN, LAMPUNG TENGAH, LAMPUNG",8,133,100,233
https://kawalpemilu.org#23075,"CANDI REJO, WAY PENGUBUAN, LAMPUNG TENGAH, LAMPUNG",9,150,105,255
https://kawalpemilu.org#23075,"CANDI REJO, WAY PENGUBUAN, LAMPUNG TENGAH, LAMPUNG",10,140,98,238
https://kawalpemilu.org#23075,"CANDI REJO, WAY PENGUBUAN, LAMPUNG TENGAH, LAMPUNG",11,97,134,231
https://kawalpemilu.org#23075,"CANDI REJO, WAY PENGUBUAN, LAMPUNG TENGAH, LAMPUNG",12,116,124,240
https://kawalpemilu.org#23075,"CANDI REJO, WAY PENGUBUAN, LAMPUNG TENGAH, LAMPUNG",13,118,110,228
https://kawalpemilu.org#23076,"BANJAR RATU, WAY PENGUBUAN, LAMPUNG TENGAH, LAMPUNG",1,45,131,176
https://kawalpemilu.org#23076,"BANJAR RATU, WAY PENGUBUAN, LAMPUNG TENGAH, LAMPUNG",2,110,102,212
https://kawalpemilu.org#23076,"BANJAR RATU, WAY PENGUBUAN, LAMPUNG TENGAH, LAMPUNG",3,154,43,197
https://kawalpemilu.org#23076,"BANJAR RATU, WAY PENGUBUAN, LAMPUNG TENGAH, LAMPUNG",4,101,91,192
https://kawalpemilu.org#23076,"BANJAR RATU, WAY PENGUBUAN, LAMPUNG TENGAH, LAMPUNG",5,155,58,213
https://kawalpemilu.org#23076,"BANJAR RATU, WAY PENGUBUAN, LAMPUNG TENGAH, LAMPUNG",6,152,55,207
https://kawalpemilu.org#23076,"BANJAR RATU, WAY PENGUBUAN, LAMPUNG TENGAH, LAMPUNG",7,129,55,184
https://kawalpemilu.org#23076,"BANJAR RATU, WAY PENGUBUAN, LAMPUNG TENGAH, LAMPUNG",8,105,32,137
https://kawalpemilu.org#23076,"BANJAR RATU, WAY PENGUBUAN, LAMPUNG TENGAH, LAMPUNG",9,127,106,233
https://kawalpemilu.org#23076,"BANJAR RATU, WAY PENGUBUAN, LAMPUNG TENGAH, LAMPUNG",10,180,25,205
https://kawalpemilu.org#23076,"BANJAR RATU, WAY PENGUBUAN, LAMPUNG TENGAH, LAMPUNG",11,81,27,108
https://kawalpemilu.org#23077,"BANJAR KERTAHAYU, WAY PENGUBUAN, LAMPUNG TENGAH, LAMPUNG",1,122,67,187
https://kawalpemilu.org#23077,"BANJAR KERTAHAYU, WAY PENGUBUAN, LAMPUNG TENGAH, LAMPUNG",2,83,118,201
https://kawalpemilu.org#23077,"BANJAR KERTAHAYU, WAY PENGUBUAN, LAMPUNG TENGAH, LAMPUNG",3,109,120,229
https://kawalpemilu.org#23077,"BANJAR KERTAHAYU, WAY PENGUBUAN, LAMPUNG TENGAH, LAMPUNG",4,105,108,213
https://kawalpemilu.org#23077,"BANJAR KERTAHAYU, WAY PENGUBUAN, LAMPUNG TENGAH, LAMPUNG",5,104,96,200
https://kawalpemilu.org#23077,"BANJAR KERTAHAYU, WAY PENGUBUAN, LAMPUNG TENGAH, LAMPUNG",6,92,73,165
https://kawalpemilu.org#23077,"BANJAR KERTAHAYU, WAY PENGUBUAN, LAMPUNG TENGAH, LAMPUNG",7,153,69,222
https://kawalpemilu.org#23077,"BANJAR KERTAHAYU, WAY PENGUBUAN, LAMPUNG TENGAH, LAMPUNG",8,90,86,176
https://kawalpemilu.org#23077,"BANJAR KERTAHAYU, WAY PENGUBUAN, LAMPUNG TENGAH, LAMPUNG",9,85,111,196
https://kawalpemilu.org#23077,"BANJAR KERTAHAYU, WAY PENGUBUAN, LAMPUNG TENGAH, LAMPUNG",10,75,131,206
https://kawalpemilu.org#23077,"BANJAR KERTAHAYU, WAY PENGUBUAN, LAMPUNG TENGAH, LAMPUNG",11,103,125,228
https://kawalpemilu.org#23077,"BANJAR KERTAHAYU, WAY PENGUBUAN, LAMPUNG TENGAH, LAMPUNG",12,107,116,223
https://kawalpemilu.org#23077,"BANJAR KERTAHAYU, WAY PENGUBUAN, LAMPUNG TENGAH, LAMPUNG",13,83,74,157
https://kawalpemilu.org#23077,"BANJAR KERTAHAYU, WAY PENGUBUAN, LAMPUNG TENGAH, LAMPUNG",14,95,76,171
https://kawalpemilu.org#23077,"BANJAR KERTAHAYU, WAY PENGUBUAN, LAMPUNG TENGAH, LAMPUNG",15,116,83,199
https://kawalpemilu.org#23077,"BANJAR KERTAHAYU, WAY PENGUBUAN, LAMPUNG TENGAH, LAMPUNG",16,107,81,188
https://kawalpemilu.org#23078,"LEMPUYANG BANDAR, WAY PENGUBUAN, LAMPUNG TENGAH, LAMPUNG",1,75,82,157
https://kawalpemilu.org#23078,"LEMPUYANG BANDAR, WAY PENGUBUAN, LAMPUNG TENGAH, LAMPUNG",2,51,110,161
https://kawalpemilu.org#23078,"LEMPUYANG BANDAR, WAY PENGUBUAN, LAMPUNG TENGAH, LAMPUNG",3,93,137,230
https://kawalpemilu.org#23078,"LEMPUYANG BANDAR, WAY PENGUBUAN, LAMPUNG TENGAH, LAMPUNG",4,106,140,246
https://kawalpemilu.org#23078,"LEMPUYANG BANDAR, WAY PENGUBUAN, LAMPUNG TENGAH, LAMPUNG",5,87,140,227
https://kawalpemilu.org#23078,"LEMPUYANG BANDAR, WAY PENGUBUAN, LAMPUNG TENGAH, LAMPUNG",6,91,109,200
https://kawalpemilu.org#23078,"LEMPUYANG BANDAR, WAY PENGUBUAN, LAMPUNG TENGAH, LAMPUNG",7,111,107,218
https://kawalpemilu.org#23078,"LEMPUYANG BANDAR, WAY PENGUBUAN, LAMPUNG TENGAH, LAMPUNG",8,130,89,219
https://kawalpemilu.org#23078,"LEMPUYANG BANDAR, WAY PENGUBUAN, LAMPUNG TENGAH, LAMPUNG",9,152,55,207
https://kawalpemilu.org#23078,"LEMPUYANG BANDAR, WAY PENGUBUAN, LAMPUNG TENGAH, LAMPUNG",10,125,103,228
https://kawalpemilu.org#23078,"LEMPUYANG BANDAR, WAY PENGUBUAN, LAMPUNG TENGAH, LAMPUNG",11,158,38,196
https://kawalpemilu.org#23078,"LEMPUYANG BANDAR, WAY PENGUBUAN, LAMPUNG TENGAH, LAMPUNG",12,111,76,187
https://kawalpemilu.org#23078,"LEMPUYANG BANDAR, WAY PENGUBUAN, LAMPUNG TENGAH, LAMPUNG",13,83,128,211
https://kawalpemilu.org#23078,"LEMPUYANG BANDAR, WAY PENGUBUAN, LAMPUNG TENGAH, LAMPUNG",14,93,116,209
https://kawalpemilu.org#23078,"LEMPUYANG BANDAR, WAY PENGUBUAN, LAMPUNG TENGAH, LAMPUNG",16,118,146,264
https://kawalpemilu.org#23078,"LEMPUYANG BANDAR, WAY PENGUBUAN, LAMPUNG TENGAH, LAMPUNG",17,89,135,224
https://kawalpemilu.org#23078,"LEMPUYANG BANDAR, WAY PENGUBUAN, LAMPUNG TENGAH, LAMPUNG",18,85,158,243
https://kawalpemilu.org#23078,"LEMPUYANG BANDAR, WAY PENGUBUAN, LAMPUNG TENGAH, LAMPUNG",19,55,144,199
https://kawalpemilu.org#23078,"LEMPUYANG BANDAR, WAY PENGUBUAN, LAMPUNG TENGAH, LAMPUNG",20,80,125,205
https://kawalpemilu.org#23078,"LEMPUYANG BANDAR, WAY PENGUBUAN, LAMPUNG TENGAH, LAMPUNG",21,108,81,189
https://kawalpemilu.org#23078,"LEMPUYANG BANDAR, WAY PENGUBUAN, LAMPUNG TENGAH, LAMPUNG",22,117,105,222
https://kawalpemilu.org#23078,"LEMPUYANG BANDAR, WAY PENGUBUAN, LAMPUNG TENGAH, LAMPUNG",23,119,77,196
https://kawalpemilu.org#23078,"LEMPUYANG BANDAR, WAY PENGUBUAN, LAMPUNG TENGAH, LAMPUNG",24,132,91,223
https://kawalpemilu.org#23078,"LEMPUYANG BANDAR, WAY PENGUBUAN, LAMPUNG TENGAH, LAMPUNG",25,95,127,222
https://kawalpemilu.org#23078,"LEMPUYANG BANDAR, WAY PENGUBUAN, LAMPUNG TENGAH, LAMPUNG",26,110,103,213
https://kawalpemilu.org#23078,"LEMPUYANG BANDAR, WAY PENGUBUAN, LAMPUNG TENGAH, LAMPUNG",27,78,67,145
https://kawalpemilu.org#23078,"LEMPUYANG BANDAR, WAY PENGUBUAN, LAMPUNG TENGAH, LAMPUNG",28,80,129,209
https://kawalpemilu.org#23078,"LEMPUYANG BANDAR, WAY PENGUBUAN, LAMPUNG TENGAH, LAMPUNG",29,104,115,219
https://kawalpemilu.org#23078,"LEMPUYANG BANDAR, WAY PENGUBUAN, LAMPUNG TENGAH, LAMPUNG",30,102,143,245
https://kawalpemilu.org#23078,"LEMPUYANG BANDAR, WAY PENGUBUAN, LAMPUNG TENGAH, LAMPUNG",31,91,72,163
https://kawalpemilu.org#23078,"LEMPUYANG BANDAR, WAY PENGUBUAN, LAMPUNG TENGAH, LAMPUNG",32,106,73,179
https://kawalpemilu.org#23078,"LEMPUYANG BANDAR, WAY PENGUBUAN, LAMPUNG TENGAH, LAMPUNG",33,86,123,209
https://kawalpemilu.org#23078,"LEMPUYANG BANDAR, WAY PENGUBUAN, LAMPUNG TENGAH, LAMPUNG",34,100,112,212
https://kawalpemilu.org#23078,"LEMPUYANG BANDAR, WAY PENGUBUAN, LAMPUNG TENGAH, LAMPUNG",35,108,92,200
https://kawalpemilu.org#23078,"LEMPUYANG BANDAR, WAY PENGUBUAN, LAMPUNG TENGAH, LAMPUNG",36,148,34,182
https://kawalpemilu.org#23078,"LEMPUYANG BANDAR, WAY PENGUBUAN, LAMPUNG TENGAH, LAMPUNG",37,53,56,109
https://kawalpemilu.org#23078,"LEMPUYANG BANDAR, WAY PENGUBUAN, LAMPUNG TENGAH, LAMPUNG",38,82,124,206
https://kawalpemilu.org#23078,"LEMPUYANG BANDAR, WAY PENGUBUAN, LAMPUNG TENGAH, LAMPUNG",39,74,99,173
https://kawalpemilu.org#23078,"LEMPUYANG BANDAR, WAY PENGUBUAN, LAMPUNG TENGAH, LAMPUNG",40,92,103,195
https://kawalpemilu.org#23078,"LEMPUYANG BANDAR, WAY PENGUBUAN, LAMPUNG TENGAH, LAMPUNG",41,50,137,187
https://kawalpemilu.org#23078,"LEMPUYANG BANDAR, WAY PENGUBUAN, LAMPUNG TENGAH, LAMPUNG",42,90,95,185
https://kawalpemilu.org#23079,"PURNAMA TUNGGAL, WAY PENGUBUAN, LAMPUNG TENGAH, LAMPUNG",1,108,69,177
https://kawalpemilu.org#23079,"PURNAMA TUNGGAL, WAY PENGUBUAN, LAMPUNG TENGAH, LAMPUNG",2,122,81,203
https://kawalpemilu.org#23079,"PURNAMA TUNGGAL, WAY PENGUBUAN, LAMPUNG TENGAH, LAMPUNG",3,124,65,189
https://kawalpemilu.org#23079,"PURNAMA TUNGGAL, WAY PENGUBUAN, LAMPUNG TENGAH, LAMPUNG",4,133,40,173
https://kawalpemilu.org#23079,"PURNAMA TUNGGAL, WAY PENGUBUAN, LAMPUNG TENGAH, LAMPUNG",5,130,73,203
https://kawalpemilu.org#91298,"BANJAR REJO, WAY PENGUBUAN, LAMPUNG TENGAH, LAMPUNG",1,123,33,156
https://kawalpemilu.org#91298,"BANJAR REJO, WAY PENGUBUAN, LAMPUNG TENGAH, LAMPUNG",2,126,62,188
https://kawalpemilu.org#91298,"BANJAR REJO, WAY PENGUBUAN, LAMPUNG TENGAH, LAMPUNG",3,117,80,197
https://kawalpemilu.org#91298,"BANJAR REJO, WAY PENGUBUAN, LAMPUNG TENGAH, LAMPUNG",4,124,52,176
https://kawalpemilu.org#91298,"BANJAR REJO, WAY PENGUBUAN, LAMPUNG TENGAH, LAMPUNG",5,131,58,189
https://kawalpemilu.org#91298,"BANJAR REJO, WAY PENGUBUAN, LAMPUNG TENGAH, LAMPUNG",6,126,64,190
https://kawalpemilu.org#91298,"BANJAR REJO, WAY PENGUBUAN, LAMPUNG TENGAH, LAMPUNG",7,104,62,166
https://kawalpemilu.org#91298,"BANJAR REJO, WAY PENGUBUAN, LAMPUNG TENGAH, LAMPUNG",8,85,62,147
https://kawalpemilu.org#91298,"BANJAR REJO, WAY PENGUBUAN, LAMPUNG TENGAH, LAMPUNG",9,87,52,139
https://kawalpemilu.org#91298,"BANJAR REJO, WAY PENGUBUAN, LAMPUNG TENGAH, LAMPUNG",10,106,74,180
https://kawalpemilu.org#91298,"BANJAR REJO, WAY PENGUBUAN, LAMPUNG TENGAH, LAMPUNG",11,81,72,153
https://kawalpemilu.org#928200,"PUTRA LEMPUYANG, WAY PENGUBUAN, LAMPUNG TENGAH, LAMPUNG",1,139,68,207
https://kawalpemilu.org#928200,"PUTRA LEMPUYANG, WAY PENGUBUAN, LAMPUNG TENGAH, LAMPUNG",2,149,67,216
https://kawalpemilu.org#928200,"PUTRA LEMPUYANG, WAY PENGUBUAN, LAMPUNG TENGAH, LAMPUNG",3,122,45,167
https://kawalpemilu.org#928200,"PUTRA LEMPUYANG, WAY PENGUBUAN, LAMPUNG TENGAH, LAMPUNG",4,108,59,167
https://kawalpemilu.org#928200,"PUTRA LEMPUYANG, WAY PENGUBUAN, LAMPUNG TENGAH, LAMPUNG",5,124,38,162
https://kawalpemilu.org#928200,"PUTRA LEMPUYANG, WAY PENGUBUAN, LAMPUNG TENGAH, LAMPUNG",6,139,54,193
https://kawalpemilu.org#928200,"PUTRA LEMPUYANG, WAY PENGUBUAN, LAMPUNG TENGAH, LAMPUNG",7,125,65,190
https://kawalpemilu.org#928200,"PUTRA LEMPUYANG, WAY PENGUBUAN, LAMPUNG TENGAH, LAMPUNG",8,133,45,178
https://kawalpemilu.org#928200,"PUTRA LEMPUYANG, WAY PENGUBUAN, LAMPUNG TENGAH, LAMPUNG",9,78,53,131
https://kawalpemilu.org#928200,"PUTRA LEMPUYANG, WAY PENGUBUAN, LAMPUNG TENGAH, LAMPUNG",10,122,45,167
https://kawalpemilu.org#23081,"SRIWIJAYA MATARAM, BANDAR MATARAM, LAMPUNG TENGAH, LAMPUNG",1,119,3,122
https://kawalpemilu.org#23081,"SRIWIJAYA MATARAM, BANDAR MATARAM, LAMPUNG TENGAH, LAMPUNG",2,109,11,120
https://kawalpemilu.org#23081,"SRIWIJAYA MATARAM, BANDAR MATARAM, LAMPUNG TENGAH, LAMPUNG",3,120,39,159
https://kawalpemilu.org#23081,"SRIWIJAYA MATARAM, BANDAR MATARAM, LAMPUNG TENGAH, LAMPUNG",4,146,22,168
https://kawalpemilu.org#23081,"SRIWIJAYA MATARAM, BANDAR MATARAM, LAMPUNG TENGAH, LAMPUNG",5,134,32,166
https://kawalpemilu.org#23081,"SRIWIJAYA MATARAM, BANDAR MATARAM, LAMPUNG TENGAH, LAMPUNG",6,173,14,187
https://kawalpemilu.org#23081,"SRIWIJAYA MATARAM, BANDAR MATARAM, LAMPUNG TENGAH, LAMPUNG",7,150,37,187
https://kawalpemilu.org#23081,"SRIWIJAYA MATARAM, BANDAR MATARAM, LAMPUNG TENGAH, LAMPUNG",8,99,6,105
https://kawalpemilu.org#23081,"SRIWIJAYA MATARAM, BANDAR MATARAM, LAMPUNG TENGAH, LAMPUNG",9,111,34,145
https://kawalpemilu.org#23081,"SRIWIJAYA MATARAM, BANDAR MATARAM, LAMPUNG TENGAH, LAMPUNG",10,137,51,188
https://kawalpemilu.org#23081,"SRIWIJAYA MATARAM, BANDAR MATARAM, LAMPUNG TENGAH, LAMPUNG",11,186,22,208
https://kawalpemilu.org#23081,"SRIWIJAYA MATARAM, BANDAR MATARAM, LAMPUNG TENGAH, LAMPUNG",12,125,12,137
https://kawalpemilu.org#23081,"SRIWIJAYA MATARAM, BANDAR MATARAM, LAMPUNG TENGAH, LAMPUNG",13,124,12,136
https://kawalpemilu.org#23081,"SRIWIJAYA MATARAM, BANDAR MATARAM, LAMPUNG TENGAH, LAMPUNG",14,133,22,155
https://kawalpemilu.org#23081,"SRIWIJAYA MATARAM, BANDAR MATARAM, LAMPUNG TENGAH, LAMPUNG",15,172,13,185
https://kawalpemilu.org#23081,"SRIWIJAYA MATARAM, BANDAR MATARAM, LAMPUNG TENGAH, LAMPUNG",16,180,36,216
https://kawalpemilu.org#23081,"SRIWIJAYA MATARAM, BANDAR MATARAM, LAMPUNG TENGAH, LAMPUNG",17,108,31,139
https://kawalpemilu.org#23081,"SRIWIJAYA MATARAM, BANDAR MATARAM, LAMPUNG TENGAH, LAMPUNG",18,148,27,175
https://kawalpemilu.org#23081,"SRIWIJAYA MATARAM, BANDAR MATARAM, LAMPUNG TENGAH, LAMPUNG",19,152,36,188
https://kawalpemilu.org#23081,"SRIWIJAYA MATARAM, BANDAR MATARAM, LAMPUNG TENGAH, LAMPUNG",20,100,20,120
https://kawalpemilu.org#23081,"SRIWIJAYA MATARAM, BANDAR MATARAM, LAMPUNG TENGAH, LAMPUNG",21,144,14,158
https://kawalpemilu.org#23081,"SRIWIJAYA MATARAM, BANDAR MATARAM, LAMPUNG TENGAH, LAMPUNG",22,154,38,192
https://kawalpemilu.org#23081,"SRIWIJAYA MATARAM, BANDAR MATARAM, LAMPUNG TENGAH, LAMPUNG",23,170,28,198
https://kawalpemilu.org#23081,"SRIWIJAYA MATARAM, BANDAR MATARAM, LAMPUNG TENGAH, LAMPUNG",24,115,11,126
https://kawalpemilu.org#23082,"UMAN AGUNG MATARAM, BANDAR MATARAM, LAMPUNG TENGAH, LAMPUNG",1,235,12,247
https://kawalpemilu.org#23082,"UMAN AGUNG MATARAM, BANDAR MATARAM, LAMPUNG TENGAH, LAMPUNG",2,117,40,157
https://kawalpemilu.org#23082,"UMAN AGUNG MATARAM, BANDAR MATARAM, LAMPUNG TENGAH, LAMPUNG",3,103,43,146
https://kawalpemilu.org#23082,"UMAN AGUNG MATARAM, BANDAR MATARAM, LAMPUNG TENGAH, LAMPUNG",4,114,41,155
https://kawalpemilu.org#23082,"UMAN AGUNG MATARAM, BANDAR MATARAM, LAMPUNG TENGAH, LAMPUNG",5,108,16,124
https://kawalpemilu.org#23082,"UMAN AGUNG MATARAM, BANDAR MATARAM, LAMPUNG TENGAH, LAMPUNG",6,219,24,243
https://kawalpemilu.org#23082,"UMAN AGUNG MATARAM, BANDAR MATARAM, LAMPUNG TENGAH, LAMPUNG",7,116,23,139
https://kawalpemilu.org#23082,"UMAN AGUNG MATARAM, BANDAR MATARAM, LAMPUNG TENGAH, LAMPUNG",8,110,28,138
https://kawalpemilu.org#23082,"UMAN AGUNG MATARAM, BANDAR MATARAM, LAMPUNG TENGAH, LAMPUNG",9,114,25,139
https://kawalpemilu.org#23082,"UMAN AGUNG MATARAM, BANDAR MATARAM, LAMPUNG TENGAH, LAMPUNG",10,122,13,135
https://kawalpemilu.org#23083,"TERBANGGI ILIR, BANDAR MATARAM, LAMPUNG TENGAH, LAMPUNG",1,173,40,213
https://kawalpemilu.org#23083,"TERBANGGI ILIR, BANDAR MATARAM, LAMPUNG TENGAH, LAMPUNG",2,86,56,142
https://kawalpemilu.org#23083,"TERBANGGI ILIR, BANDAR MATARAM, LAMPUNG TENGAH, LAMPUNG",3,68,34,102
https://kawalpemilu.org#23083,"TERBANGGI ILIR, BANDAR MATARAM, LAMPUNG TENGAH, LAMPUNG",4,103,46,149
https://kawalpemilu.org#23083,"TERBANGGI ILIR, BANDAR MATARAM, LAMPUNG TENGAH, LAMPUNG",5,69,57,126
https://kawalpemilu.org#23083,"TERBANGGI ILIR, BANDAR MATARAM, LAMPUNG TENGAH, LAMPUNG",6,52,78,130
https://kawalpemilu.org#23083,"TERBANGGI ILIR, BANDAR MATARAM, LAMPUNG TENGAH, LAMPUNG",7,25,96,121
https://kawalpemilu.org#23083,"TERBANGGI ILIR, BANDAR MATARAM, LAMPUNG TENGAH, LAMPUNG",8,119,54,173
https://kawalpemilu.org#23083,"TERBANGGI ILIR, BANDAR MATARAM, LAMPUNG TENGAH, LAMPUNG",9,136,51,187
https://kawalpemilu.org#23083,"TERBANGGI ILIR, BANDAR MATARAM, LAMPUNG TENGAH, LAMPUNG",10,165,35,200
https://kawalpemilu.org#23083,"TERBANGGI ILIR, BANDAR MATARAM, LAMPUNG TENGAH, LAMPUNG",11,51,66,117
https://kawalpemilu.org#23083,"TERBANGGI ILIR, BANDAR MATARAM, LAMPUNG TENGAH, LAMPUNG",12,79,120,199
https://kawalpemilu.org#23083,"TERBANGGI ILIR, BANDAR MATARAM, LAMPUNG TENGAH, LAMPUNG",13,138,37,175
https://kawalpemilu.org#23083,"TERBANGGI ILIR, BANDAR MATARAM, LAMPUNG TENGAH, LAMPUNG",14,138,38,176
https://kawalpemilu.org#23083,"TERBANGGI ILIR, BANDAR MATARAM, LAMPUNG TENGAH, LAMPUNG",15,49,39,88
https://kawalpemilu.org#23083,"TERBANGGI ILIR, BANDAR MATARAM, LAMPUNG TENGAH, LAMPUNG",16,75,69,144
https://kawalpemilu.org#23083,"TERBANGGI ILIR, BANDAR MATARAM, LAMPUNG TENGAH, LAMPUNG",17,67,53,120
https://kawalpemilu.org#23083,"TERBANGGI ILIR, BANDAR MATARAM, LAMPUNG TENGAH, LAMPUNG",18,96,89,185
https://kawalpemilu.org#23083,"TERBANGGI ILIR, BANDAR MATARAM, LAMPUNG TENGAH, LAMPUNG",19,22,106,128
https://kawalpemilu.org#23083,"TERBANGGI ILIR, BANDAR MATARAM, LAMPUNG TENGAH, LAMPUNG",20,123,54,177
https://kawalpemilu.org#23083,"TERBANGGI ILIR, BANDAR MATARAM, LAMPUNG TENGAH, LAMPUNG",21,44,76,120
https://kawalpemilu.org#23084,"JATI DATAR MATARAM, BANDAR MATARAM, LAMPUNG TENGAH, LAMPUNG",1,169,53,222
https://kawalpemilu.org#23084,"JATI DATAR MATARAM, BANDAR MATARAM, LAMPUNG TENGAH, LAMPUNG",2,132,75,207
https://kawalpemilu.org#23084,"JATI DATAR MATARAM, BANDAR MATARAM, LAMPUNG TENGAH, LAMPUNG",3,70,43,113
https://kawalpemilu.org#23084,"JATI DATAR MATARAM, BANDAR MATARAM, LAMPUNG TENGAH, LAMPUNG",4,104,33,137
https://kawalpemilu.org#23084,"JATI DATAR MATARAM, BANDAR MATARAM, LAMPUNG TENGAH, LAMPUNG",5,167,56,223
https://kawalpemilu.org#23084,"JATI DATAR MATARAM, BANDAR MATARAM, LAMPUNG TENGAH, LAMPUNG",6,98,27,125
https://kawalpemilu.org#23084,"JATI DATAR MATARAM, BANDAR MATARAM, LAMPUNG TENGAH, LAMPUNG",7,127,46,173
https://kawalpemilu.org#23084,"JATI DATAR MATARAM, BANDAR MATARAM, LAMPUNG TENGAH, LAMPUNG",8,97,87,184
https://kawalpemilu.org#23084,"JATI DATAR MATARAM, BANDAR MATARAM, LAMPUNG TENGAH, LAMPUNG",9,183,52,235
https://kawalpemilu.org#23084,"JATI DATAR MATARAM, BANDAR MATARAM, LAMPUNG TENGAH, LAMPUNG",10,203,46,249
https://kawalpemilu.org#23084,"JATI DATAR MATARAM, BANDAR MATARAM, LAMPUNG TENGAH, LAMPUNG",11,78,47,125
https://kawalpemilu.org#23084,"JATI DATAR MATARAM, BANDAR MATARAM, LAMPUNG TENGAH, LAMPUNG",12,140,66,206
https://kawalpemilu.org#23084,"JATI DATAR MATARAM, BANDAR MATARAM, LAMPUNG TENGAH, LAMPUNG",13,155,52,207
https://kawalpemilu.org#23084,"JATI DATAR MATARAM, BANDAR MATARAM, LAMPUNG TENGAH, LAMPUNG",14,123,55,178
https://kawalpemilu.org#23084,"JATI DATAR MATARAM, BANDAR MATARAM, LAMPUNG TENGAH, LAMPUNG",15,110,24,134
https://kawalpemilu.org#23084,"JATI DATAR MATARAM, BANDAR MATARAM, LAMPUNG TENGAH, LAMPUNG",16,160,75,235
https://kawalpemilu.org#23084,"JATI DATAR MATARAM, BANDAR MATARAM, LAMPUNG TENGAH, LAMPUNG",17,153,46,199
https://kawalpemilu.org#23084,"JATI DATAR MATARAM, BANDAR MATARAM, LAMPUNG TENGAH, LAMPUNG",18,128,50,178
https://kawalpemilu.org#23084,"JATI DATAR MATARAM, BANDAR MATARAM, LAMPUNG TENGAH, LAMPUNG",19,60,38,98
https://kawalpemilu.org#23084,"JATI DATAR MATARAM, BANDAR MATARAM, LAMPUNG TENGAH, LAMPUNG",20,120,49,169
https://kawalpemilu.org#23085,"SENDANG AGUNG MATARAM, BANDAR MATARAM, LAMPUNG TENGAH, LAMPUNG",1,142,28,170
https://kawalpemilu.org#23085,"SENDANG AGUNG MATARAM, BANDAR MATARAM, LAMPUNG TENGAH, LAMPUNG",2,113,25,138
https://kawalpemilu.org#23085,"SENDANG AGUNG MATARAM, BANDAR MATARAM, LAMPUNG TENGAH, LAMPUNG",3,120,55,175
https://kawalpemilu.org#23085,"SENDANG AGUNG MATARAM, BANDAR MATARAM, LAMPUNG TENGAH, LAMPUNG",4,173,36,209
https://kawalpemilu.org#23085,"SENDANG AGUNG MATARAM, BANDAR MATARAM, LAMPUNG TENGAH, LAMPUNG",5,96,16,112
https://kawalpemilu.org#23085,"SENDANG AGUNG MATARAM, BANDAR MATARAM, LAMPUNG TENGAH, LAMPUNG",6,103,10,113
https://kawalpemilu.org#23085,"SENDANG AGUNG MATARAM, BANDAR MATARAM, LAMPUNG TENGAH, LAMPUNG",7,162,19,181
https://kawalpemilu.org#23085,"SENDANG AGUNG MATARAM, BANDAR MATARAM, LAMPUNG TENGAH, LAMPUNG",8,132,28,160
https://kawalpemilu.org#23085,"SENDANG AGUNG MATARAM, BANDAR MATARAM, LAMPUNG TENGAH, LAMPUNG",9,129,18,147
https://kawalpemilu.org#23085,"SENDANG AGUNG MATARAM, BANDAR MATARAM, LAMPUNG TENGAH, LAMPUNG",10,95,31,126
https://kawalpemilu.org#23085,"SENDANG AGUNG MATARAM, BANDAR MATARAM, LAMPUNG TENGAH, LAMPUNG",11,124,81,205
https://kawalpemilu.org#23085,"SENDANG AGUNG MATARAM, BANDAR MATARAM, LAMPUNG TENGAH, LAMPUNG",12,116,52,168
https://kawalpemilu.org#23085,"SENDANG AGUNG MATARAM, BANDAR MATARAM, LAMPUNG TENGAH, LAMPUNG",14,146,39,185
https://kawalpemilu.org#23085,"SENDANG AGUNG MATARAM, BANDAR MATARAM, LAMPUNG TENGAH, LAMPUNG",15,147,17,164
https://kawalpemilu.org#23085,"SENDANG AGUNG MATARAM, BANDAR MATARAM, LAMPUNG TENGAH, LAMPUNG",16,88,16,104
https://kawalpemilu.org#23086,"MATARAM UDIK, BANDAR MATARAM, LAMPUNG TENGAH, LAMPUNG",1,28,156,184
https://kawalpemilu.org#23086,"MATARAM UDIK, BANDAR MATARAM, LAMPUNG TENGAH, LAMPUNG",2,31,99,130
https://kawalpemilu.org#23086,"MATARAM UDIK, BANDAR MATARAM, LAMPUNG TENGAH, LAMPUNG",3,106,37,143
https://kawalpemilu.org#23086,"MATARAM UDIK, BANDAR MATARAM, LAMPUNG TENGAH, LAMPUNG",4,115,27,142
https://kawalpemilu.org#23086,"MATARAM UDIK, BANDAR MATARAM, LAMPUNG TENGAH, LAMPUNG",5,148,39,187
https://kawalpemilu.org#23086,"MATARAM UDIK, BANDAR MATARAM, LAMPUNG TENGAH, LAMPUNG",6,189,62,251
https://kawalpemilu.org#23086,"MATARAM UDIK, BANDAR MATARAM, LAMPUNG TENGAH, LAMPUNG",7,193,45,238
https://kawalpemilu.org#23086,"MATARAM UDIK, BANDAR MATARAM, LAMPUNG TENGAH, LAMPUNG",8,112,23,135
https://kawalpemilu.org#23086,"MATARAM UDIK, BANDAR MATARAM, LAMPUNG TENGAH, LAMPUNG",9,133,28,161
https://kawalpemilu.org#23086,"MATARAM UDIK, BANDAR MATARAM, LAMPUNG TENGAH, LAMPUNG",10,83,48,131
https://kawalpemilu.org#23086,"MATARAM UDIK, BANDAR MATARAM, LAMPUNG TENGAH, LAMPUNG",11,147,46,193
https://kawalpemilu.org#23086,"MATARAM UDIK, BANDAR MATARAM, LAMPUNG TENGAH, LAMPUNG",12,157,51,208
https://kawalpemilu.org#23086,"MATARAM UDIK, BANDAR MATARAM, LAMPUNG TENGAH, LAMPUNG",13,108,84,192
https://kawalpemilu.org#23086,"MATARAM UDIK, BANDAR MATARAM, LAMPUNG TENGAH, LAMPUNG",14,0,0,0
https://kawalpemilu.org#23086,"MATARAM UDIK, BANDAR MATARAM, LAMPUNG TENGAH, LAMPUNG",15,92,66,158
https://kawalpemilu.org#23086,"MATARAM UDIK, BANDAR MATARAM, LAMPUNG TENGAH, LAMPUNG",16,171,23,194
https://kawalpemilu.org#23086,"MATARAM UDIK, BANDAR MATARAM, LAMPUNG TENGAH, LAMPUNG",17,170,53,223
https://kawalpemilu.org#23086,"MATARAM UDIK, BANDAR MATARAM, LAMPUNG TENGAH, LAMPUNG",18,112,35,147
https://kawalpemilu.org#23086,"MATARAM UDIK, BANDAR MATARAM, LAMPUNG TENGAH, LAMPUNG",19,171,27,198
https://kawalpemilu.org#23086,"MATARAM UDIK, BANDAR MATARAM, LAMPUNG TENGAH, LAMPUNG",21,159,36,195
https://kawalpemilu.org#23086,"MATARAM UDIK, BANDAR MATARAM, LAMPUNG TENGAH, LAMPUNG",22,149,49,198
https://kawalpemilu.org#23086,"MATARAM UDIK, BANDAR MATARAM, LAMPUNG TENGAH, LAMPUNG",23,194,20,214
https://kawalpemilu.org#23086,"MATARAM UDIK, BANDAR MATARAM, LAMPUNG TENGAH, LAMPUNG",24,114,17,131
https://kawalpemilu.org#23086,"MATARAM UDIK, BANDAR MATARAM, LAMPUNG TENGAH, LAMPUNG",25,127,27,154
https://kawalpemilu.org#23086,"MATARAM UDIK, BANDAR MATARAM, LAMPUNG TENGAH, LAMPUNG",26,148,40,188
https://kawalpemilu.org#23086,"MATARAM UDIK, BANDAR MATARAM, LAMPUNG TENGAH, LAMPUNG",27,77,39,116
https://kawalpemilu.org#23086,"MATARAM UDIK, BANDAR MATARAM, LAMPUNG TENGAH, LAMPUNG",28,163,67,230
https://kawalpemilu.org#23086,"MATARAM UDIK, BANDAR MATARAM, LAMPUNG TENGAH, LAMPUNG",30,187,30,217
https://kawalpemilu.org#23086,"MATARAM UDIK, BANDAR MATARAM, LAMPUNG TENGAH, LAMPUNG",31,164,47,211
https://kawalpemilu.org#23086,"MATARAM UDIK, BANDAR MATARAM, LAMPUNG TENGAH, LAMPUNG",32,115,55,170
https://kawalpemilu.org#23086,"MATARAM UDIK, BANDAR MATARAM, LAMPUNG TENGAH, LAMPUNG",33,134,29,163
https://kawalpemilu.org#23086,"MATARAM UDIK, BANDAR MATARAM, LAMPUNG TENGAH, LAMPUNG",34,107,41,148
https://kawalpemilu.org#23086,"MATARAM UDIK, BANDAR MATARAM, LAMPUNG TENGAH, LAMPUNG",35,132,53,185
https://kawalpemilu.org#23086,"MATARAM UDIK, BANDAR MATARAM, LAMPUNG TENGAH, LAMPUNG",36,93,24,117
https://kawalpemilu.org#23086,"MATARAM UDIK, BANDAR MATARAM, LAMPUNG TENGAH, LAMPUNG",37,101,18,119
https://kawalpemilu.org#23086,"MATARAM UDIK, BANDAR MATARAM, LAMPUNG TENGAH, LAMPUNG",38,96,28,124
https://kawalpemilu.org#23086,"MATARAM UDIK, BANDAR MATARAM, LAMPUNG TENGAH, LAMPUNG",39,111,14,125
https://kawalpemilu.org#23086,"MATARAM UDIK, BANDAR MATARAM, LAMPUNG TENGAH, LAMPUNG",40,75,15,90
https://kawalpemilu.org#23086,"MATARAM UDIK, BANDAR MATARAM, LAMPUNG TENGAH, LAMPUNG",41,135,8,143
https://kawalpemilu.org#23086,"MATARAM UDIK, BANDAR MATARAM, LAMPUNG TENGAH, LAMPUNG",42,176,15,191
https://kawalpemilu.org#23086,"MATARAM UDIK, BANDAR MATARAM, LAMPUNG TENGAH, LAMPUNG",43,167,17,184
https://kawalpemilu.org#23086,"MATARAM UDIK, BANDAR MATARAM, LAMPUNG TENGAH, LAMPUNG",44,174,11,185
https://kawalpemilu.org#23086,"MATARAM UDIK, BANDAR MATARAM, LAMPUNG TENGAH, LAMPUNG",45,197,19,216
https://kawalpemilu.org#23086,"MATARAM UDIK, BANDAR MATARAM, LAMPUNG TENGAH, LAMPUNG",46,177,4,181
https://kawalpemilu.org#23086,"MATARAM UDIK, BANDAR MATARAM, LAMPUNG TENGAH, LAMPUNG",47,108,40,148
https://kawalpemilu.org#23086,"MATARAM UDIK, BANDAR MATARAM, LAMPUNG TENGAH, LAMPUNG",48,101,6,107
https://kawalpemilu.org#23086,"MATARAM UDIK, BANDAR MATARAM, LAMPUNG TENGAH, LAMPUNG",49,213,3,216
https://kawalpemilu.org#23086,"MATARAM UDIK, BANDAR MATARAM, LAMPUNG TENGAH, LAMPUNG",50,235,11,247
https://kawalpemilu.org#23086,"MATARAM UDIK, BANDAR MATARAM, LAMPUNG TENGAH, LAMPUNG",51,163,9,172
https://kawalpemilu.org#23086,"MATARAM UDIK, BANDAR MATARAM, LAMPUNG TENGAH, LAMPUNG",52,208,30,238
https://kawalpemilu.org#23086,"MATARAM UDIK, BANDAR MATARAM, LAMPUNG TENGAH, LAMPUNG",53,140,14,154
https://kawalpemilu.org#23086,"MATARAM UDIK, BANDAR MATARAM, LAMPUNG TENGAH, LAMPUNG",54,142,7,149
https://kawalpemilu.org#23086,"MATARAM UDIK, BANDAR MATARAM, LAMPUNG TENGAH, LAMPUNG",55,128,7,135
https://kawalpemilu.org#23086,"MATARAM UDIK, BANDAR MATARAM, LAMPUNG TENGAH, LAMPUNG",56,145,9,154
https://kawalpemilu.org#23086,"MATARAM UDIK, BANDAR MATARAM, LAMPUNG TENGAH, LAMPUNG",57,158,18,176
https://kawalpemilu.org#23086,"MATARAM UDIK, BANDAR MATARAM, LAMPUNG TENGAH, LAMPUNG",58,118,10,128
https://kawalpemilu.org#23086,"MATARAM UDIK, BANDAR MATARAM, LAMPUNG TENGAH, LAMPUNG",59,137,1,138
https://kawalpemilu.org#23086,"MATARAM UDIK, BANDAR MATARAM, LAMPUNG TENGAH, LAMPUNG",60,193,6,199
https://kawalpemilu.org#23086,"MATARAM UDIK, BANDAR MATARAM, LAMPUNG TENGAH, LAMPUNG",61,130,17,147
https://kawalpemilu.org#23086,"MATARAM UDIK, BANDAR MATARAM, LAMPUNG TENGAH, LAMPUNG",62,165,16,181
https://kawalpemilu.org#23086,"MATARAM UDIK, BANDAR MATARAM, LAMPUNG TENGAH, LAMPUNG",63,114,0,114
https://kawalpemilu.org#23086,"MATARAM UDIK, BANDAR MATARAM, LAMPUNG TENGAH, LAMPUNG",64,178,11,189
https://kawalpemilu.org#23086,"MATARAM UDIK, BANDAR MATARAM, LAMPUNG TENGAH, LAMPUNG",65,155,2,157
https://kawalpemilu.org#23086,"MATARAM UDIK, BANDAR MATARAM, LAMPUNG TENGAH, LAMPUNG",66,157,9,166
https://kawalpemilu.org#23086,"MATARAM UDIK, BANDAR MATARAM, LAMPUNG TENGAH, LAMPUNG",67,135,11,146
https://kawalpemilu.org#23086,"MATARAM UDIK, BANDAR MATARAM, LAMPUNG TENGAH, LAMPUNG",68,199,2,201
https://kawalpemilu.org#23086,"MATARAM UDIK, BANDAR MATARAM, LAMPUNG TENGAH, LAMPUNG",69,217,9,226
https://kawalpemilu.org#23086,"MATARAM UDIK, BANDAR MATARAM, LAMPUNG TENGAH, LAMPUNG",70,130,1,131
https://kawalpemilu.org#23086,"MATARAM UDIK, BANDAR MATARAM, LAMPUNG TENGAH, LAMPUNG",71,209,8,217
https://kawalpemilu.org#23086,"MATARAM UDIK, BANDAR MATARAM, LAMPUNG TENGAH, LAMPUNG",72,96,2,98
https://kawalpemilu.org#23086,"MATARAM UDIK, BANDAR MATARAM, LAMPUNG TENGAH, LAMPUNG",73,197,31,228
https://kawalpemilu.org#23086,"MATARAM UDIK, BANDAR MATARAM, LAMPUNG TENGAH, LAMPUNG",74,179,13,192
https://kawalpemilu.org#23086,"MATARAM UDIK, BANDAR MATARAM, LAMPUNG TENGAH, LAMPUNG",75,135,59,159
https://kawalpemilu.org#23086,"MATARAM UDIK, BANDAR MATARAM, LAMPUNG TENGAH, LAMPUNG",76,226,10,236
https://kawalpemilu.org#23086,"MATARAM UDIK, BANDAR MATARAM, LAMPUNG TENGAH, LAMPUNG",77,206,21,227
https://kawalpemilu.org#23086,"MATARAM UDIK, BANDAR MATARAM, LAMPUNG TENGAH, LAMPUNG",78,202,36,238
https://kawalpemilu.org#23086,"MATARAM UDIK, BANDAR MATARAM, LAMPUNG TENGAH, LAMPUNG",79,201,9,210
https://kawalpemilu.org#23086,"MATARAM UDIK, BANDAR MATARAM, LAMPUNG TENGAH, LAMPUNG",80,72,52,124
https://kawalpemilu.org#23086,"MATARAM UDIK, BANDAR MATARAM, LAMPUNG TENGAH, LAMPUNG",81,158,69,227
https://kawalpemilu.org#23086,"MATARAM UDIK, BANDAR MATARAM, LAMPUNG TENGAH, LAMPUNG",82,150,65,215
https://kawalpemilu.org#23086,"MATARAM UDIK, BANDAR MATARAM, LAMPUNG TENGAH, LAMPUNG",83,102,44,146
https://kawalpemilu.org#23086,"MATARAM UDIK, BANDAR MATARAM, LAMPUNG TENGAH, LAMPUNG",84,105,30,135
https://kawalpemilu.org#23086,"MATARAM UDIK, BANDAR MATARAM, LAMPUNG TENGAH, LAMPUNG",85,96,42,138
https://kawalpemilu.org#23086,"MATARAM UDIK, BANDAR MATARAM, LAMPUNG TENGAH, LAMPUNG",86,112,57,169
https://kawalpemilu.org#23086,"MATARAM UDIK, BANDAR MATARAM, LAMPUNG TENGAH, LAMPUNG",87,73,52,125
https://kawalpemilu.org#23086,"MATARAM UDIK, BANDAR MATARAM, LAMPUNG TENGAH, LAMPUNG",88,93,18,111
https://kawalpemilu.org#23086,"MATARAM UDIK, BANDAR MATARAM, LAMPUNG TENGAH, LAMPUNG",89,89,49,138
https://kawalpemilu.org#23086,"MATARAM UDIK, BANDAR MATARAM, LAMPUNG TENGAH, LAMPUNG",90,110,58,168
https://kawalpemilu.org#23086,"MATARAM UDIK, BANDAR MATARAM, LAMPUNG TENGAH, LAMPUNG",91,171,59,230
https://kawalpemilu.org#23086,"MATARAM UDIK, BANDAR MATARAM, LAMPUNG TENGAH, LAMPUNG",92,110,41,151
https://kawalpemilu.org#23086,"MATARAM UDIK, BANDAR MATARAM, LAMPUNG TENGAH, LAMPUNG",93,175,25,200
https://kawalpemilu.org#23086,"MATARAM UDIK, BANDAR MATARAM, LAMPUNG TENGAH, LAMPUNG",94,114,77,191
https://kawalpemilu.org#23086,"MATARAM UDIK, BANDAR MATARAM, LAMPUNG TENGAH, LAMPUNG",95,61,8,69
https://kawalpemilu.org#23086,"MATARAM UDIK, BANDAR MATARAM, LAMPUNG TENGAH, LAMPUNG",96,78,37,115
https://kawalpemilu.org#23086,"MATARAM UDIK, BANDAR MATARAM, LAMPUNG TENGAH, LAMPUNG",97,134,77,211
https://kawalpemilu.org#23086,"MATARAM UDIK, BANDAR MATARAM, LAMPUNG TENGAH, LAMPUNG",98,124,42,166
https://kawalpemilu.org#23086,"MATARAM UDIK, BANDAR MATARAM, LAMPUNG TENGAH, LAMPUNG",99,151,94,245
https://kawalpemilu.org#23086,"MATARAM UDIK, BANDAR MATARAM, LAMPUNG TENGAH, LAMPUNG",100,46,161,207
https://kawalpemilu.org#23086,"MATARAM UDIK, BANDAR MATARAM, LAMPUNG TENGAH, LAMPUNG",101,88,139,227
https://kawalpemilu.org#23086,"MATARAM UDIK, BANDAR MATARAM, LAMPUNG TENGAH, LAMPUNG",102,60,127,187
https://kawalpemilu.org#23086,"MATARAM UDIK, BANDAR MATARAM, LAMPUNG TENGAH, LAMPUNG",103,88,138,226
https://kawalpemilu.org#23086,"MATARAM UDIK, BANDAR MATARAM, LAMPUNG TENGAH, LAMPUNG",104,89,51,140
https://kawalpemilu.org#23086,"MATARAM UDIK, BANDAR MATARAM, LAMPUNG TENGAH, LAMPUNG",105,117,46,163
https://kawalpemilu.org#23086,"MATARAM UDIK, BANDAR MATARAM, LAMPUNG TENGAH, LAMPUNG",106,111,43,154
https://kawalpemilu.org#23086,"MATARAM UDIK, BANDAR MATARAM, LAMPUNG TENGAH, LAMPUNG",107,137,54,191
https://kawalpemilu.org#23086,"MATARAM UDIK, BANDAR MATARAM, LAMPUNG TENGAH, LAMPUNG",109,130,46,176
https://kawalpemilu.org#23086,"MATARAM UDIK, BANDAR MATARAM, LAMPUNG TENGAH, LAMPUNG",110,98,25,123
https://kawalpemilu.org#23086,"MATARAM UDIK, BANDAR MATARAM, LAMPUNG TENGAH, LAMPUNG",111,145,18,163
https://kawalpemilu.org#23086,"MATARAM UDIK, BANDAR MATARAM, LAMPUNG TENGAH, LAMPUNG",112,125,13,138
https://kawalpemilu.org#23086,"MATARAM UDIK, BANDAR MATARAM, LAMPUNG TENGAH, LAMPUNG",113,69,39,108
https://kawalpemilu.org#23086,"MATARAM UDIK, BANDAR MATARAM, LAMPUNG TENGAH, LAMPUNG",114,76,30,106
https://kawalpemilu.org#23086,"MATARAM UDIK, BANDAR MATARAM, LAMPUNG TENGAH, LAMPUNG",115,84,15,99
https://kawalpemilu.org#23086,"MATARAM UDIK, BANDAR MATARAM, LAMPUNG TENGAH, LAMPUNG",116,86,18,104
https://kawalpemilu.org#23086,"MATARAM UDIK, BANDAR MATARAM, LAMPUNG TENGAH, LAMPUNG",117,103,1,104
https://kawalpemilu.org#23086,"MATARAM UDIK, BANDAR MATARAM, LAMPUNG TENGAH, LAMPUNG",118,180,6,186
https://kawalpemilu.org#23086,"MATARAM UDIK, BANDAR MATARAM, LAMPUNG TENGAH, LAMPUNG",119,145,2,147
https://kawalpemilu.org#23086,"MATARAM UDIK, BANDAR MATARAM, LAMPUNG TENGAH, LAMPUNG",120,191,14,205
https://kawalpemilu.org#23086,"MATARAM UDIK, BANDAR MATARAM, LAMPUNG TENGAH, LAMPUNG",121,134,13,147
https://kawalpemilu.org#23086,"MATARAM UDIK, BANDAR MATARAM, LAMPUNG TENGAH, LAMPUNG",122,75,45,120
https://kawalpemilu.org#23086,"MATARAM UDIK, BANDAR MATARAM, LAMPUNG TENGAH, LAMPUNG",123,87,51,138
https://kawalpemilu.org#23086,"MATARAM UDIK, BANDAR MATARAM, LAMPUNG TENGAH, LAMPUNG",124,87,42,129
https://kawalpemilu.org#23086,"MATARAM UDIK, BANDAR MATARAM, LAMPUNG TENGAH, LAMPUNG",125,95,42,137
https://kawalpemilu.org#23086,"MATARAM UDIK, BANDAR MATARAM, LAMPUNG TENGAH, LAMPUNG",126,130,46,176
https://kawalpemilu.org#23086,"MATARAM UDIK, BANDAR MATARAM, LAMPUNG TENGAH, LAMPUNG",127,91,31,122
https://kawalpemilu.org#23086,"MATARAM UDIK, BANDAR MATARAM, LAMPUNG TENGAH, LAMPUNG",128,89,35,124
https://kawalpemilu.org#23086,"MATARAM UDIK, BANDAR MATARAM, LAMPUNG TENGAH, LAMPUNG",129,86,54,140
https://kawalpemilu.org#23087,"TERBANGGI MULYA, BANDAR MATARAM, LAMPUNG TENGAH, LAMPUNG",1,124,23,147
https://kawalpemilu.org#23087,"TERBANGGI MULYA, BANDAR MATARAM, LAMPUNG TENGAH, LAMPUNG",2,168,59,227
https://kawalpemilu.org#23087,"TERBANGGI MULYA, BANDAR MATARAM, LAMPUNG TENGAH, LAMPUNG",3,123,69,192
https://kawalpemilu.org#23087,"TERBANGGI MULYA, BANDAR MATARAM, LAMPUNG TENGAH, LAMPUNG",4,76,77,153
https://kawalpemilu.org#23087,"TERBANGGI MULYA, BANDAR MATARAM, LAMPUNG TENGAH, LAMPUNG",5,150,50,200
https://kawalpemilu.org#23087,"TERBANGGI MULYA, BANDAR MATARAM, LAMPUNG TENGAH, LAMPUNG",6,174,29,203
https://kawalpemilu.org#23087,"TERBANGGI MULYA, BANDAR MATARAM, LAMPUNG TENGAH, LAMPUNG",7,133,66,199
https://kawalpemilu.org#23087,"TERBANGGI MULYA, BANDAR MATARAM, LAMPUNG TENGAH, LAMPUNG",9,132,24,156
https://kawalpemilu.org#23087,"TERBANGGI MULYA, BANDAR MATARAM, LAMPUNG TENGAH, LAMPUNG",10,107,25,132
https://kawalpemilu.org#23087,"TERBANGGI MULYA, BANDAR MATARAM, LAMPUNG TENGAH, LAMPUNG",11,149,70,219
https://kawalpemilu.org#23087,"TERBANGGI MULYA, BANDAR MATARAM, LAMPUNG TENGAH, LAMPUNG",12,157,36,193
https://kawalpemilu.org#23087,"TERBANGGI MULYA, BANDAR MATARAM, LAMPUNG TENGAH, LAMPUNG",13,150,58,208
https://kawalpemilu.org#23087,"TERBANGGI MULYA, BANDAR MATARAM, LAMPUNG TENGAH, LAMPUNG",14,119,51,170
https://kawalpemilu.org#23088,"MATARAM JAYA, BANDAR MATARAM, LAMPUNG TENGAH, LAMPUNG",1,166,21,187
https://kawalpemilu.org#23088,"MATARAM JAYA, BANDAR MATARAM, LAMPUNG TENGAH, LAMPUNG",2,157,22,179
https://kawalpemilu.org#23088,"MATARAM JAYA, BANDAR MATARAM, LAMPUNG TENGAH, LAMPUNG",3,117,36,153
https://kawalpemilu.org#23088,"MATARAM JAYA, BANDAR MATARAM, LAMPUNG TENGAH, LAMPUNG",4,190,29,219
https://kawalpemilu.org#23088,"MATARAM JAYA, BANDAR MATARAM, LAMPUNG TENGAH, LAMPUNG",5,119,9,128
https://kawalpemilu.org#23088,"MATARAM JAYA, BANDAR MATARAM, LAMPUNG TENGAH, LAMPUNG",6,112,9,121
https://kawalpemilu.org#23088,"MATARAM JAYA, BANDAR MATARAM, LAMPUNG TENGAH, LAMPUNG",7,106,10,116
https://kawalpemilu.org#23088,"MATARAM JAYA, BANDAR MATARAM, LAMPUNG TENGAH, LAMPUNG",8,146,22,168
https://kawalpemilu.org#23088,"MATARAM JAYA, BANDAR MATARAM, LAMPUNG TENGAH, LAMPUNG",9,184,22,206
https://kawalpemilu.org#23088,"MATARAM JAYA, BANDAR MATARAM, LAMPUNG TENGAH, LAMPUNG",10,119,16,135
https://kawalpemilu.org#23088,"MATARAM JAYA, BANDAR MATARAM, LAMPUNG TENGAH, LAMPUNG",11,92,15,107
https://kawalpemilu.org#23088,"MATARAM JAYA, BANDAR MATARAM, LAMPUNG TENGAH, LAMPUNG",12,187,12,199
https://kawalpemilu.org#23088,"MATARAM JAYA, BANDAR MATARAM, LAMPUNG TENGAH, LAMPUNG",13,119,19,138
https://kawalpemilu.org#23088,"MATARAM JAYA, BANDAR MATARAM, LAMPUNG TENGAH, LAMPUNG",14,97,8,105
https://kawalpemilu.org#23088,"MATARAM JAYA, BANDAR MATARAM, LAMPUNG TENGAH, LAMPUNG",15,136,3,139
https://kawalpemilu.org#23088,"MATARAM JAYA, BANDAR MATARAM, LAMPUNG TENGAH, LAMPUNG",16,106,19,125
https://kawalpemilu.org#23088,"MATARAM JAYA, BANDAR MATARAM, LAMPUNG TENGAH, LAMPUNG",17,113,7,120
https://kawalpemilu.org#23088,"MATARAM JAYA, BANDAR MATARAM, LAMPUNG TENGAH, LAMPUNG",18,66,22,88
https://kawalpemilu.org#23088,"MATARAM JAYA, BANDAR MATARAM, LAMPUNG TENGAH, LAMPUNG",19,104,15,119
https://kawalpemilu.org#23088,"MATARAM JAYA, BANDAR MATARAM, LAMPUNG TENGAH, LAMPUNG",20,99,20,119
https://kawalpemilu.org#84794,"SUMBER REJEKI MATARAM, BANDAR MATARAM, LAMPUNG TENGAH, LAMPUNG",1,161,16,177
https://kawalpemilu.org#84794,"SUMBER REJEKI MATARAM, BANDAR MATARAM, LAMPUNG TENGAH, LAMPUNG",2,150,5,155
https://kawalpemilu.org#84794,"SUMBER REJEKI MATARAM, BANDAR MATARAM, LAMPUNG TENGAH, LAMPUNG",3,119,13,132
https://kawalpemilu.org#84794,"SUMBER REJEKI MATARAM, BANDAR MATARAM, LAMPUNG TENGAH, LAMPUNG",4,219,18,237
https://kawalpemilu.org#84794,"SUMBER REJEKI MATARAM, BANDAR MATARAM, LAMPUNG TENGAH, LAMPUNG",5,177,22,199
https://kawalpemilu.org#84794,"SUMBER REJEKI MATARAM, BANDAR MATARAM, LAMPUNG TENGAH, LAMPUNG",6,206,11,217
https://kawalpemilu.org#84794,"SUMBER REJEKI MATARAM, BANDAR MATARAM, LAMPUNG TENGAH, LAMPUNG",7,158,15,173
https://kawalpemilu.org#84794,"SUMBER REJEKI MATARAM, BANDAR MATARAM, LAMPUNG TENGAH, LAMPUNG",8,215,18,233
https://kawalpemilu.org#84794,"SUMBER REJEKI MATARAM, BANDAR MATARAM, LAMPUNG TENGAH, LAMPUNG",9,193,39,232
https://kawalpemilu.org#84794,"SUMBER REJEKI MATARAM, BANDAR MATARAM, LAMPUNG TENGAH, LAMPUNG",10,146,15,161
https://kawalpemilu.org#84794,"SUMBER REJEKI MATARAM, BANDAR MATARAM, LAMPUNG TENGAH, LAMPUNG",11,142,19,161
https://kawalpemilu.org#84794,"SUMBER REJEKI MATARAM, BANDAR MATARAM, LAMPUNG TENGAH, LAMPUNG",12,153,17,170
https://kawalpemilu.org#23090,"KOTA BATU, PUBIAN, LAMPUNG TENGAH, LAMPUNG",1,164,49,213
https://kawalpemilu.org#23090,"KOTA BATU, PUBIAN, LAMPUNG TENGAH, LAMPUNG",2,144,44,188
https://kawalpemilu.org#23090,"KOTA BATU, PUBIAN, LAMPUNG TENGAH, LAMPUNG",3,151,59,210
https://kawalpemilu.org#23090,"KOTA BATU, PUBIAN, LAMPUNG TENGAH, LAMPUNG",4,171,20,191
https://kawalpemilu.org#23090,"KOTA BATU, PUBIAN, LAMPUNG TENGAH, LAMPUNG",5,153,30,183
https://kawalpemilu.org#23090,"KOTA BATU, PUBIAN, LAMPUNG TENGAH, LAMPUNG",6,135,50,185
https://kawalpemilu.org#23090,"KOTA BATU, PUBIAN, LAMPUNG TENGAH, LAMPUNG",7,122,38,160
https://kawalpemilu.org#23090,"KOTA BATU, PUBIAN, LAMPUNG TENGAH, LAMPUNG",8,109,72,181
https://kawalpemilu.org#23091,"SANGUN RATU, PUBIAN, LAMPUNG TENGAH, LAMPUNG",1,128,28,156
https://kawalpemilu.org#23091,"SANGUN RATU, PUBIAN, LAMPUNG TENGAH, LAMPUNG",2,128,30,158
https://kawalpemilu.org#23091,"SANGUN RATU, PUBIAN, LAMPUNG TENGAH, LAMPUNG",3,139,36,175
https://kawalpemilu.org#23091,"SANGUN RATU, PUBIAN, LAMPUNG TENGAH, LAMPUNG",4,131,25,156
https://kawalpemilu.org#23091,"SANGUN RATU, PUBIAN, LAMPUNG TENGAH, LAMPUNG",5,125,30,155
https://kawalpemilu.org#23091,"SANGUN RATU, PUBIAN, LAMPUNG TENGAH, LAMPUNG",6,96,47,143
https://kawalpemilu.org#23091,"SANGUN RATU, PUBIAN, LAMPUNG TENGAH, LAMPUNG",7,133,33,166
https://kawalpemilu.org#23091,"SANGUN RATU, PUBIAN, LAMPUNG TENGAH, LAMPUNG",8,128,25,153
https://kawalpemilu.org#23092,"GUNUNGRAYA, PUBIAN, LAMPUNG TENGAH, LAMPUNG",1,24,98,122
https://kawalpemilu.org#23092,"GUNUNGRAYA, PUBIAN, LAMPUNG TENGAH, LAMPUNG",2,75,40,115
https://kawalpemilu.org#23092,"GUNUNGRAYA, PUBIAN, LAMPUNG TENGAH, LAMPUNG",3,182,31,213
https://kawalpemilu.org#23092,"GUNUNGRAYA, PUBIAN, LAMPUNG TENGAH, LAMPUNG",4,104,22,126
https://kawalpemilu.org#23092,"GUNUNGRAYA, PUBIAN, LAMPUNG TENGAH, LAMPUNG",5,147,42,189
https://kawalpemilu.org#23092,"GUNUNGRAYA, PUBIAN, LAMPUNG TENGAH, LAMPUNG",6,53,161,214
https://kawalpemilu.org#23092,"GUNUNGRAYA, PUBIAN, LAMPUNG TENGAH, LAMPUNG",7,110,13,123
https://kawalpemilu.org#23092,"GUNUNGRAYA, PUBIAN, LAMPUNG TENGAH, LAMPUNG",8,114,17,131
https://kawalpemilu.org#23093,"GUNUNGHAJI, PUBIAN, LAMPUNG TENGAH, LAMPUNG",1,11,123,134
https://kawalpemilu.org#23093,"GUNUNGHAJI, PUBIAN, LAMPUNG TENGAH, LAMPUNG",2,26,83,109
https://kawalpemilu.org#23093,"GUNUNGHAJI, PUBIAN, LAMPUNG TENGAH, LAMPUNG",3,110,49,159
https://kawalpemilu.org#23093,"GUNUNGHAJI, PUBIAN, LAMPUNG TENGAH, LAMPUNG",4,97,59,156
https://kawalpemilu.org#23093,"GUNUNGHAJI, PUBIAN, LAMPUNG TENGAH, LAMPUNG",5,70,46,116
https://kawalpemilu.org#23093,"GUNUNGHAJI, PUBIAN, LAMPUNG TENGAH, LAMPUNG",6,137,24,161
https://kawalpemilu.org#23093,"GUNUNGHAJI, PUBIAN, LAMPUNG TENGAH, LAMPUNG",7,14,98,112
https://kawalpemilu.org#23093,"GUNUNGHAJI, PUBIAN, LAMPUNG TENGAH, LAMPUNG",8,52,28,80
https://kawalpemilu.org#23093,"GUNUNGHAJI, PUBIAN, LAMPUNG TENGAH, LAMPUNG",9,94,32,126
https://kawalpemilu.org#23094,"NEGERI RATU, PUBIAN, LAMPUNG TENGAH, LAMPUNG",1,61,97,158
https://kawalpemilu.org#23094,"NEGERI RATU, PUBIAN, LAMPUNG TENGAH, LAMPUNG",2,21,151,172
https://kawalpemilu.org#23094,"NEGERI RATU, PUBIAN, LAMPUNG TENGAH, LAMPUNG",3,99,24,123
https://kawalpemilu.org#23094,"NEGERI RATU, PUBIAN, LAMPUNG TENGAH, LAMPUNG",4,125,31,156
https://kawalpemilu.org#23094,"NEGERI RATU, PUBIAN, LAMPUNG TENGAH, LAMPUNG",5,142,21,163
https://kawalpemilu.org#23095,"TANJUNGKEMALA, PUBIAN, LAMPUNG TENGAH, LAMPUNG",1,17,133,150
https://kawalpemilu.org#23095,"TANJUNGKEMALA, PUBIAN, LAMPUNG TENGAH, LAMPUNG",2,81,42,123
https://kawalpemilu.org#23095,"TANJUNGKEMALA, PUBIAN, LAMPUNG TENGAH, LAMPUNG",3,135,102,237
https://kawalpemilu.org#23095,"TANJUNGKEMALA, PUBIAN, LAMPUNG TENGAH, LAMPUNG",4,64,57,121
https://kawalpemilu.org#23095,"TANJUNGKEMALA, PUBIAN, LAMPUNG TENGAH, LAMPUNG",6,131,30,161
https://kawalpemilu.org#23095,"TANJUNGKEMALA, PUBIAN, LAMPUNG TENGAH, LAMPUNG",7,113,44,157
https://kawalpemilu.org#23096,"PAYUNG REJO, PUBIAN, LAMPUNG TENGAH, LAMPUNG",1,142,21,163
https://kawalpemilu.org#23096,"PAYUNG REJO, PUBIAN, LAMPUNG TENGAH, LAMPUNG",2,107,70,177
https://kawalpemilu.org#23096,"PAYUNG REJO, PUBIAN, LAMPUNG TENGAH, LAMPUNG",3,120,31,151
https://kawalpemilu.org#23096,"PAYUNG REJO, PUBIAN, LAMPUNG TENGAH, LAMPUNG",4,93,33,126
https://kawalpemilu.org#23096,"PAYUNG REJO, PUBIAN, LAMPUNG TENGAH, LAMPUNG",6,111,42,153
https://kawalpemilu.org#23096,"PAYUNG REJO, PUBIAN, LAMPUNG TENGAH, LAMPUNG",8,106,50,156
https://kawalpemilu.org#23096,"PAYUNG REJO, PUBIAN, LAMPUNG TENGAH, LAMPUNG",9,83,68,151
https://kawalpemilu.org#23096,"PAYUNG REJO, PUBIAN, LAMPUNG TENGAH, LAMPUNG",10,113,21,134
https://kawalpemilu.org#23096,"PAYUNG REJO, PUBIAN, LAMPUNG TENGAH, LAMPUNG",11,120,34,154
https://kawalpemilu.org#23096,"PAYUNG REJO, PUBIAN, LAMPUNG TENGAH, LAMPUNG",12,117,39,156
https://kawalpemilu.org#23096,"PAYUNG REJO, PUBIAN, LAMPUNG TENGAH, LAMPUNG",13,104,40,144
https://kawalpemilu.org#23096,"PAYUNG REJO, PUBIAN, LAMPUNG TENGAH, LAMPUNG",14,82,57,139
https://kawalpemilu.org#23097,"PAYUNG BATU, PUBIAN, LAMPUNG TENGAH, LAMPUNG",1,123,42,165
https://kawalpemilu.org#23097,"PAYUNG BATU, PUBIAN, LAMPUNG TENGAH, LAMPUNG",2,105,53,158
https://kawalpemilu.org#23097,"PAYUNG BATU, PUBIAN, LAMPUNG TENGAH, LAMPUNG",3,119,33,152
https://kawalpemilu.org#23097,"PAYUNG BATU, PUBIAN, LAMPUNG TENGAH, LAMPUNG",4,134,35,169
https://kawalpemilu.org#23097,"PAYUNG BATU, PUBIAN, LAMPUNG TENGAH, LAMPUNG",5,105,35,140
https://kawalpemilu.org#23097,"PAYUNG BATU, PUBIAN, LAMPUNG TENGAH, LAMPUNG",6,127,29,156
https://kawalpemilu.org#23097,"PAYUNG BATU, PUBIAN, LAMPUNG TENGAH, LAMPUNG",7,101,31,132
https://kawalpemilu.org#23097,"PAYUNG BATU, PUBIAN, LAMPUNG TENGAH, LAMPUNG",8,219,10,229
https://kawalpemilu.org#23097,"PAYUNG BATU, PUBIAN, LAMPUNG TENGAH, LAMPUNG",9,112,17,129
https://kawalpemilu.org#23097,"PAYUNG BATU, PUBIAN, LAMPUNG TENGAH, LAMPUNG",10,119,36,155
https://kawalpemilu.org#23097,"PAYUNG BATU, PUBIAN, LAMPUNG TENGAH, LAMPUNG",11,106,41,147
https://kawalpemilu.org#23097,"PAYUNG BATU, PUBIAN, LAMPUNG TENGAH, LAMPUNG",12,105,28,133
https://kawalpemilu.org#23097,"PAYUNG BATU, PUBIAN, LAMPUNG TENGAH, LAMPUNG",13,96,17,113
https://kawalpemilu.org#23098,"NEGERI KEPAYUNGAN, PUBIAN, LAMPUNG TENGAH, LAMPUNG",1,25,164,189
https://kawalpemilu.org#23098,"NEGERI KEPAYUNGAN, PUBIAN, LAMPUNG TENGAH, LAMPUNG",2,10,126,136
https://kawalpemilu.org#23098,"NEGERI KEPAYUNGAN, PUBIAN, LAMPUNG TENGAH, LAMPUNG",3,21,156,177
https://kawalpemilu.org#23098,"NEGERI KEPAYUNGAN, PUBIAN, LAMPUNG TENGAH, LAMPUNG",4,67,69,136
https://kawalpemilu.org#23099,"SEGALA MIDER, PUBIAN, LAMPUNG TENGAH, LAMPUNG",1,52,106,158
https://kawalpemilu.org#23099,"SEGALA MIDER, PUBIAN, LAMPUNG TENGAH, LAMPUNG",2,71,98,169
https://kawalpemilu.org#23099,"SEGALA MIDER, PUBIAN, LAMPUNG TENGAH, LAMPUNG",3,18,159,177
https://kawalpemilu.org#23099,"SEGALA MIDER, PUBIAN, LAMPUNG TENGAH, LAMPUNG",4,71,99,170
https://kawalpemilu.org#23099,"SEGALA MIDER, PUBIAN, LAMPUNG TENGAH, LAMPUNG",6,117,90,207
https://kawalpemilu.org#23099,"SEGALA MIDER, PUBIAN, LAMPUNG TENGAH, LAMPUNG",7,78,80,158
https://kawalpemilu.org#23099,"SEGALA MIDER, PUBIAN, LAMPUNG TENGAH, LAMPUNG",8,41,111,152
https://kawalpemilu.org#23099,"SEGALA MIDER, PUBIAN, LAMPUNG TENGAH, LAMPUNG",9,125,61,186
https://kawalpemilu.org#23099,"SEGALA MIDER, PUBIAN, LAMPUNG TENGAH, LAMPUNG",10,75,175,250
https://kawalpemilu.org#23099,"SEGALA MIDER, PUBIAN, LAMPUNG TENGAH, LAMPUNG",11,58,71,129
https://kawalpemilu.org#23099,"SEGALA MIDER, PUBIAN, LAMPUNG TENGAH, LAMPUNG",12,101,86,187
https://kawalpemilu.org#23099,"SEGALA MIDER, PUBIAN, LAMPUNG TENGAH, LAMPUNG",13,107,91,198
https://kawalpemilu.org#23099,"SEGALA MIDER, PUBIAN, LAMPUNG TENGAH, LAMPUNG",14,98,61,159
https://kawalpemilu.org#23100,"TIAS BANGUN, PUBIAN, LAMPUNG TENGAH, LAMPUNG",1,104,74,178
https://kawalpemilu.org#23100,"TIAS BANGUN, PUBIAN, LAMPUNG TENGAH, LAMPUNG",2,109,74,183
https://kawalpemilu.org#23100,"TIAS BANGUN, PUBIAN, LAMPUNG TENGAH, LAMPUNG",3,72,73,145
https://kawalpemilu.org#23100,"TIAS BANGUN, PUBIAN, LAMPUNG TENGAH, LAMPUNG",4,87,104,191
https://kawalpemilu.org#23100,"TIAS BANGUN, PUBIAN, LAMPUNG TENGAH, LAMPUNG",5,54,34,88
https://kawalpemilu.org#23100,"TIAS BANGUN, PUBIAN, LAMPUNG TENGAH, LAMPUNG",6,70,60,130
https://kawalpemilu.org#23100,"TIAS BANGUN, PUBIAN, LAMPUNG TENGAH, LAMPUNG",7,90,74,164
https://kawalpemilu.org#23100,"TIAS BANGUN, PUBIAN, LAMPUNG TENGAH, LAMPUNG",8,80,71,151
https://kawalpemilu.org#23100,"TIAS BANGUN, PUBIAN, LAMPUNG TENGAH, LAMPUNG",9,124,64,189
https://kawalpemilu.org#23100,"TIAS BANGUN, PUBIAN, LAMPUNG TENGAH, LAMPUNG",10,73,87,160
https://kawalpemilu.org#23100,"TIAS BANGUN, PUBIAN, LAMPUNG TENGAH, LAMPUNG",11,106,45,151
https://kawalpemilu.org#23100,"TIAS BANGUN, PUBIAN, LAMPUNG TENGAH, LAMPUNG",12,53,62,115
https://kawalpemilu.org#23100,"TIAS BANGUN, PUBIAN, LAMPUNG TENGAH, LAMPUNG",13,94,19,113
https://kawalpemilu.org#23100,"TIAS BANGUN, PUBIAN, LAMPUNG TENGAH, LAMPUNG",14,62,45,107
https://kawalpemilu.org#23101,"RIAU PRIANGAN, PUBIAN, LAMPUNG TENGAH, LAMPUNG",1,108,86,194
https://kawalpemilu.org#23101,"RIAU PRIANGAN, PUBIAN, LAMPUNG TENGAH, LAMPUNG",2,77,47,124
https://kawalpemilu.org#23101,"RIAU PRIANGAN, PUBIAN, LAMPUNG TENGAH, LAMPUNG",3,64,46,110
https://kawalpemilu.org#23101,"RIAU PRIANGAN, PUBIAN, LAMPUNG TENGAH, LAMPUNG",4,54,48,102
https://kawalpemilu.org#23101,"RIAU PRIANGAN, PUBIAN, LAMPUNG TENGAH, LAMPUNG",5,29,100,129
https://kawalpemilu.org#23101,"RIAU PRIANGAN, PUBIAN, LAMPUNG TENGAH, LAMPUNG",6,48,64,112
https://kawalpemilu.org#23101,"RIAU PRIANGAN, PUBIAN, LAMPUNG TENGAH, LAMPUNG",7,56,63,119
https://kawalpemilu.org#23102,"PAYUNG DADI, PUBIAN, LAMPUNG TENGAH, LAMPUNG",1,144,26,170
https://kawalpemilu.org#23102,"PAYUNG DADI, PUBIAN, LAMPUNG TENGAH, LAMPUNG",2,81,61,142
https://kawalpemilu.org#23102,"PAYUNG DADI, PUBIAN, LAMPUNG TENGAH, LAMPUNG",3,77,21,98
https://kawalpemilu.org#23102,"PAYUNG DADI, PUBIAN, LAMPUNG TENGAH, LAMPUNG",4,87,37,124
https://kawalpemilu.org#23102,"PAYUNG DADI, PUBIAN, LAMPUNG TENGAH, LAMPUNG",5,102,103,205
https://kawalpemilu.org#23102,"PAYUNG DADI, PUBIAN, LAMPUNG TENGAH, LAMPUNG",6,104,36,140
https://kawalpemilu.org#23102,"PAYUNG DADI, PUBIAN, LAMPUNG TENGAH, LAMPUNG",7,91,47,138
https://kawalpemilu.org#23102,"PAYUNG DADI, PUBIAN, LAMPUNG TENGAH, LAMPUNG",8,79,31,110
https://kawalpemilu.org#23102,"PAYUNG DADI, PUBIAN, LAMPUNG TENGAH, LAMPUNG",9,139,45,184
https://kawalpemilu.org#23102,"PAYUNG DADI, PUBIAN, LAMPUNG TENGAH, LAMPUNG",10,105,73,178
https://kawalpemilu.org#23103,"PAYUNG MAKMUR, PUBIAN, LAMPUNG TENGAH, LAMPUNG",1,186,26,212
https://kawalpemilu.org#23103,"PAYUNG MAKMUR, PUBIAN, LAMPUNG TENGAH, LAMPUNG",2,120,42,162
https://kawalpemilu.org#23103,"PAYUNG MAKMUR, PUBIAN, LAMPUNG TENGAH, LAMPUNG",3,147,60,207
https://kawalpemilu.org#23103,"PAYUNG MAKMUR, PUBIAN, LAMPUNG TENGAH, LAMPUNG",4,123,42,165
https://kawalpemilu.org#23103,"PAYUNG MAKMUR, PUBIAN, LAMPUNG TENGAH, LAMPUNG",5,114,74,188
https://kawalpemilu.org#23103,"PAYUNG MAKMUR, PUBIAN, LAMPUNG TENGAH, LAMPUNG",6,103,21,124
https://kawalpemilu.org#23103,"PAYUNG MAKMUR, PUBIAN, LAMPUNG TENGAH, LAMPUNG",7,110,21,131
https://kawalpemilu.org#23103,"PAYUNG MAKMUR, PUBIAN, LAMPUNG TENGAH, LAMPUNG",8,155,33,188
https://kawalpemilu.org#23104,"TANJUNGREJO, PUBIAN, LAMPUNG TENGAH, LAMPUNG",1,82,115,197
https://kawalpemilu.org#23104,"TANJUNGREJO, PUBIAN, LAMPUNG TENGAH, LAMPUNG",2,129,60,189
https://kawalpemilu.org#23104,"TANJUNGREJO, PUBIAN, LAMPUNG TENGAH, LAMPUNG",3,132,52,184
https://kawalpemilu.org#23104,"TANJUNGREJO, PUBIAN, LAMPUNG TENGAH, LAMPUNG",4,83,72,155
https://kawalpemilu.org#23104,"TANJUNGREJO, PUBIAN, LAMPUNG TENGAH, LAMPUNG",5,90,96,186
https://kawalpemilu.org#23104,"TANJUNGREJO, PUBIAN, LAMPUNG TENGAH, LAMPUNG",6,66,54,120
https://kawalpemilu.org#23104,"TANJUNGREJO, PUBIAN, LAMPUNG TENGAH, LAMPUNG",7,139,41,180
https://kawalpemilu.org#23104,"TANJUNGREJO, PUBIAN, LAMPUNG TENGAH, LAMPUNG",8,79,63,142
https://kawalpemilu.org#23104,"TANJUNGREJO, PUBIAN, LAMPUNG TENGAH, LAMPUNG",9,127,65,192
https://kawalpemilu.org#23104,"TANJUNGREJO, PUBIAN, LAMPUNG TENGAH, LAMPUNG",10,50,67,117
https://kawalpemilu.org#23105,"TAWANG NEGERI, PUBIAN, LAMPUNG TENGAH, LAMPUNG",1,168,18,186
https://kawalpemilu.org#23105,"TAWANG NEGERI, PUBIAN, LAMPUNG TENGAH, LAMPUNG",2,112,57,169
https://kawalpemilu.org#23106,"SINAR NEGERI, PUBIAN, LAMPUNG TENGAH, LAMPUNG",1,63,107,170
https://kawalpemilu.org#23106,"SINAR NEGERI, PUBIAN, LAMPUNG TENGAH, LAMPUNG",2,175,49,224
https://kawalpemilu.org#23106,"SINAR NEGERI, PUBIAN, LAMPUNG TENGAH, LAMPUNG",3,64,71,135
https://kawalpemilu.org#23107,"PEKANDANGAN, PUBIAN, LAMPUNG TENGAH, LAMPUNG",1,166,87,253
https://kawalpemilu.org#23107,"PEKANDANGAN, PUBIAN, LAMPUNG TENGAH, LAMPUNG",2,169,32,201
https://kawalpemilu.org#84795,"PAYUNG MULYA, PUBIAN, LAMPUNG TENGAH, LAMPUNG",1,116,30,146
https://kawalpemilu.org#84795,"PAYUNG MULYA, PUBIAN, LAMPUNG TENGAH, LAMPUNG",2,134,35,169
https://kawalpemilu.org#84795,"PAYUNG MULYA, PUBIAN, LAMPUNG TENGAH, LAMPUNG",3,126,54,180
https://kawalpemilu.org#84795,"PAYUNG MULYA, PUBIAN, LAMPUNG TENGAH, LAMPUNG",4,75,84,159
https://kawalpemilu.org#91301,"PADANG REJO, PUBIAN, LAMPUNG TENGAH, LAMPUNG",1,112,53,165
https://kawalpemilu.org#91301,"PADANG REJO, PUBIAN, LAMPUNG TENGAH, LAMPUNG",2,101,93,140
https://kawalpemilu.org#91301,"PADANG REJO, PUBIAN, LAMPUNG TENGAH, LAMPUNG",3,131,26,157
https://kawalpemilu.org#91301,"PADANG REJO, PUBIAN, LAMPUNG TENGAH, LAMPUNG",4,127,16,143
https://kawalpemilu.org#91301,"PADANG REJO, PUBIAN, LAMPUNG TENGAH, LAMPUNG",5,125,24,149
https://kawalpemilu.org#91301,"PADANG REJO, PUBIAN, LAMPUNG TENGAH, LAMPUNG",6,149,22,171
https://kawalpemilu.org#23109,"NYUKANG HARJO, SELAGAI LINGGA, LAMPUNG TENGAH, LAMPUNG",1,156,13,169
https://kawalpemilu.org#23109,"NYUKANG HARJO, SELAGAI LINGGA, LAMPUNG TENGAH, LAMPUNG",2,150,34,184
https://kawalpemilu.org#23109,"NYUKANG HARJO, SELAGAI LINGGA, LAMPUNG TENGAH, LAMPUNG",3,92,14,106
https://kawalpemilu.org#23109,"NYUKANG HARJO, SELAGAI LINGGA, LAMPUNG TENGAH, LAMPUNG",4,175,55,230
https://kawalpemilu.org#23109,"NYUKANG HARJO, SELAGAI LINGGA, LAMPUNG TENGAH, LAMPUNG",5,164,26,190
https://kawalpemilu.org#23109,"NYUKANG HARJO, SELAGAI LINGGA, LAMPUNG TENGAH, LAMPUNG",6,198,17,215
https://kawalpemilu.org#23109,"NYUKANG HARJO, SELAGAI LINGGA, LAMPUNG TENGAH, LAMPUNG",7,137,66,203
https://kawalpemilu.org#23109,"NYUKANG HARJO, SELAGAI LINGGA, LAMPUNG TENGAH, LAMPUNG",8,77,21,98
https://kawalpemilu.org#23109,"NYUKANG HARJO, SELAGAI LINGGA, LAMPUNG TENGAH, LAMPUNG",9,145,23,168
https://kawalpemilu.org#23109,"NYUKANG HARJO, SELAGAI LINGGA, LAMPUNG TENGAH, LAMPUNG",10,202,7,209
https://kawalpemilu.org#23109,"NYUKANG HARJO, SELAGAI LINGGA, LAMPUNG TENGAH, LAMPUNG",11,171,33,204
https://kawalpemilu.org#23109,"NYUKANG HARJO, SELAGAI LINGGA, LAMPUNG TENGAH, LAMPUNG",12,73,15,88
https://kawalpemilu.org#23109,"NYUKANG HARJO, SELAGAI LINGGA, LAMPUNG TENGAH, LAMPUNG",13,141,32,173
https://kawalpemilu.org#23109,"NYUKANG HARJO, SELAGAI LINGGA, LAMPUNG TENGAH, LAMPUNG",14,155,36,191
https://kawalpemilu.org#23109,"NYUKANG HARJO, SELAGAI LINGGA, LAMPUNG TENGAH, LAMPUNG",15,130,42,172
https://kawalpemilu.org#23109,"NYUKANG HARJO, SELAGAI LINGGA, LAMPUNG TENGAH, LAMPUNG",16,161,21,182
https://kawalpemilu.org#23109,"NYUKANG HARJO, SELAGAI LINGGA, LAMPUNG TENGAH, LAMPUNG",17,76,120,196
https://kawalpemilu.org#23110,"LINGGA PURA, SELAGAI LINGGA, LAMPUNG TENGAH, LAMPUNG",1,123,36,159
https://kawalpemilu.org#23110,"LINGGA PURA, SELAGAI LINGGA, LAMPUNG TENGAH, LAMPUNG",2,76,38,114
https://kawalpemilu.org#23110,"LINGGA PURA, SELAGAI LINGGA, LAMPUNG TENGAH, LAMPUNG",3,138,41,179
https://kawalpemilu.org#23110,"LINGGA PURA, SELAGAI LINGGA, LAMPUNG TENGAH, LAMPUNG",4,127,37,164
https://kawalpemilu.org#23110,"LINGGA PURA, SELAGAI LINGGA, LAMPUNG TENGAH, LAMPUNG",5,212,29,241
https://kawalpemilu.org#23110,"LINGGA PURA, SELAGAI LINGGA, LAMPUNG TENGAH, LAMPUNG",6,151,64,215
https://kawalpemilu.org#23110,"LINGGA PURA, SELAGAI LINGGA, LAMPUNG TENGAH, LAMPUNG",7,117,54,171
https://kawalpemilu.org#23110,"LINGGA PURA, SELAGAI LINGGA, LAMPUNG TENGAH, LAMPUNG",8,77,62,139
https://kawalpemilu.org#23110,"LINGGA PURA, SELAGAI LINGGA, LAMPUNG TENGAH, LAMPUNG",9,75,58,133
https://kawalpemilu.org#23110,"LINGGA PURA, SELAGAI LINGGA, LAMPUNG TENGAH, LAMPUNG",10,73,64,137
https://kawalpemilu.org#23110,"LINGGA PURA, SELAGAI LINGGA, LAMPUNG TENGAH, LAMPUNG",11,103,50,153
https://kawalpemilu.org#23110,"LINGGA PURA, SELAGAI LINGGA, LAMPUNG TENGAH, LAMPUNG",12,84,57,141
https://kawalpemilu.org#23110,"LINGGA PURA, SELAGAI LINGGA, LAMPUNG TENGAH, LAMPUNG",13,86,60,146
https://kawalpemilu.org#23110,"LINGGA PURA, SELAGAI LINGGA, LAMPUNG TENGAH, LAMPUNG",14,126,38,164
https://kawalpemilu.org#23111,"SIDO HARJO, SELAGAI LINGGA, LAMPUNG TENGAH, LAMPUNG",1,156,41,197
https://kawalpemilu.org#23111,"SIDO HARJO, SELAGAI LINGGA, LAMPUNG TENGAH, LAMPUNG",2,168,41,209
https://kawalpemilu.org#23111,"SIDO HARJO, SELAGAI LINGGA, LAMPUNG TENGAH, LAMPUNG",3,186,48,234
https://kawalpemilu.org#23111,"SIDO HARJO, SELAGAI LINGGA, LAMPUNG TENGAH, LAMPUNG",4,137,62,199
https://kawalpemilu.org#23111,"SIDO HARJO, SELAGAI LINGGA, LAMPUNG TENGAH, LAMPUNG",5,174,31,205
https://kawalpemilu.org#23112,"TAMAN SARI, SELAGAI LINGGA, LAMPUNG TENGAH, LAMPUNG",1,95,69,164
https://kawalpemilu.org#23112,"TAMAN SARI, SELAGAI LINGGA, LAMPUNG TENGAH, LAMPUNG",2,111,92,203
https://kawalpemilu.org#23112,"TAMAN SARI, SELAGAI LINGGA, LAMPUNG TENGAH, LAMPUNG",3,176,34,210
https://kawalpemilu.org#23113,"KARANG ANYAR, SELAGAI LINGGA, LAMPUNG TENGAH, LAMPUNG",1,89,84,173
https://kawalpemilu.org#23113,"KARANG ANYAR, SELAGAI LINGGA, LAMPUNG TENGAH, LAMPUNG",2,133,83,216
https://kawalpemilu.org#23113,"KARANG ANYAR, SELAGAI LINGGA, LAMPUNG TENGAH, LAMPUNG",3,46,67,113
https://kawalpemilu.org#23113,"KARANG ANYAR, SELAGAI LINGGA, LAMPUNG TENGAH, LAMPUNG",4,139,49,188
https://kawalpemilu.org#23113,"KARANG ANYAR, SELAGAI LINGGA, LAMPUNG TENGAH, LAMPUNG",5,144,21,165
https://kawalpemilu.org#23113,"KARANG ANYAR, SELAGAI LINGGA, LAMPUNG TENGAH, LAMPUNG",6,104,65,169
https://kawalpemilu.org#23113,"KARANG ANYAR, SELAGAI LINGGA, LAMPUNG TENGAH, LAMPUNG",7,70,30,100
https://kawalpemilu.org#23113,"KARANG ANYAR, SELAGAI LINGGA, LAMPUNG TENGAH, LAMPUNG",8,47,21,68
https://kawalpemilu.org#23113,"KARANG ANYAR, SELAGAI LINGGA, LAMPUNG TENGAH, LAMPUNG",9,131,43,174
https://kawalpemilu.org#23114,"NEGERI KATON, SELAGAI LINGGA, LAMPUNG TENGAH, LAMPUNG",1,41,139,180
https://kawalpemilu.org#23114,"NEGERI KATON, SELAGAI LINGGA, LAMPUNG TENGAH, LAMPUNG",2,31,116,147
https://kawalpemilu.org#23114,"NEGERI KATON, SELAGAI LINGGA, LAMPUNG TENGAH, LAMPUNG",3,84,45,129
https://kawalpemilu.org#23114,"NEGERI KATON, SELAGAI LINGGA, LAMPUNG TENGAH, LAMPUNG",4,37,53,90
https://kawalpemilu.org#23115,"GEDUNG HARTA, SELAGAI LINGGA, LAMPUNG TENGAH, LAMPUNG",1,33,98,131
https://kawalpemilu.org#23115,"GEDUNG HARTA, SELAGAI LINGGA, LAMPUNG TENGAH, LAMPUNG",2,131,19,150
https://kawalpemilu.org#23115,"GEDUNG HARTA, SELAGAI LINGGA, LAMPUNG TENGAH, LAMPUNG",3,116,38,154
https://kawalpemilu.org#23115,"GEDUNG HARTA, SELAGAI LINGGA, LAMPUNG TENGAH, LAMPUNG",4,73,81,154
https://kawalpemilu.org#23115,"GEDUNG HARTA, SELAGAI LINGGA, LAMPUNG TENGAH, LAMPUNG",5,93,21,114
https://kawalpemilu.org#23115,"GEDUNG HARTA, SELAGAI LINGGA, LAMPUNG TENGAH, LAMPUNG",6,61,42,103
https://kawalpemilu.org#23115,"GEDUNG HARTA, SELAGAI LINGGA, LAMPUNG TENGAH, LAMPUNG",7,133,36,169
https://kawalpemilu.org#23115,"GEDUNG HARTA, SELAGAI LINGGA, LAMPUNG TENGAH, LAMPUNG",8,144,13,157
https://kawalpemilu.org#23116,"TANJUNG RATU, SELAGAI LINGGA, LAMPUNG TENGAH, LAMPUNG",1,71,84,155
https://kawalpemilu.org#23116,"TANJUNG RATU, SELAGAI LINGGA, LAMPUNG TENGAH, LAMPUNG",2,85,112,197
https://kawalpemilu.org#23116,"TANJUNG RATU, SELAGAI LINGGA, LAMPUNG TENGAH, LAMPUNG",3,130,46,176
https://kawalpemilu.org#23116,"TANJUNG RATU, SELAGAI LINGGA, LAMPUNG TENGAH, LAMPUNG",4,76,34,110
https://kawalpemilu.org#23116,"TANJUNG RATU, SELAGAI LINGGA, LAMPUNG TENGAH, LAMPUNG",5,131,16,147
https://kawalpemilu.org#23116,"TANJUNG RATU, SELAGAI LINGGA, LAMPUNG TENGAH, LAMPUNG",6,32,109,141
https://kawalpemilu.org#23116,"TANJUNG RATU, SELAGAI LINGGA, LAMPUNG TENGAH, LAMPUNG",7,172,44,216
https://kawalpemilu.org#23117,"NEGERI AGUNG, SELAGAI LINGGA, LAMPUNG TENGAH, LAMPUNG",1,44,115,159
https://kawalpemilu.org#23117,"NEGERI AGUNG, SELAGAI LINGGA, LAMPUNG TENGAH, LAMPUNG",2,34,153,187
https://kawalpemilu.org#23117,"NEGERI AGUNG, SELAGAI LINGGA, LAMPUNG TENGAH, LAMPUNG",3,142,35,177
https://kawalpemilu.org#23117,"NEGERI AGUNG, SELAGAI LINGGA, LAMPUNG TENGAH, LAMPUNG",4,159,20,179
https://kawalpemilu.org#23117,"NEGERI AGUNG, SELAGAI LINGGA, LAMPUNG TENGAH, LAMPUNG",5,95,94,189
https://kawalpemilu.org#23117,"NEGERI AGUNG, SELAGAI LINGGA, LAMPUNG TENGAH, LAMPUNG",6,92,17,109
https://kawalpemilu.org#23117,"NEGERI AGUNG, SELAGAI LINGGA, LAMPUNG TENGAH, LAMPUNG",7,76,61,137
https://kawalpemilu.org#23117,"NEGERI AGUNG, SELAGAI LINGGA, LAMPUNG TENGAH, LAMPUNG",8,171,24,195
https://kawalpemilu.org#23117,"NEGERI AGUNG, SELAGAI LINGGA, LAMPUNG TENGAH, LAMPUNG",9,89,34,123
https://kawalpemilu.org#23117,"NEGERI AGUNG, SELAGAI LINGGA, LAMPUNG TENGAH, LAMPUNG",10,66,80,146
https://kawalpemilu.org#23118,"GILIH KARANG JATI, SELAGAI LINGGA, LAMPUNG TENGAH, LAMPUNG",1,99,73,172
https://kawalpemilu.org#23118,"GILIH KARANG JATI, SELAGAI LINGGA, LAMPUNG TENGAH, LAMPUNG",2,62,94,156
https://kawalpemilu.org#23118,"GILIH KARANG JATI, SELAGAI LINGGA, LAMPUNG TENGAH, LAMPUNG",3,105,49,154
https://kawalpemilu.org#23118,"GILIH KARANG JATI, SELAGAI LINGGA, LAMPUNG TENGAH, LAMPUNG",4,109,72,181
https://kawalpemilu.org#23118,"GILIH KARANG JATI, SELAGAI LINGGA, LAMPUNG TENGAH, LAMPUNG",5,124,71,195
https://kawalpemilu.org#23119,"MARGA JAYA, SELAGAI LINGGA, LAMPUNG TENGAH, LAMPUNG",1,131,21,152
https://kawalpemilu.org#23119,"MARGA JAYA, SELAGAI LINGGA, LAMPUNG TENGAH, LAMPUNG",2,129,30,159
https://kawalpemilu.org#23119,"MARGA JAYA, SELAGAI LINGGA, LAMPUNG TENGAH, LAMPUNG",3,104,68,172
https://kawalpemilu.org#23119,"MARGA JAYA, SELAGAI LINGGA, LAMPUNG TENGAH, LAMPUNG",4,136,37,173
https://kawalpemilu.org#23119,"MARGA JAYA, SELAGAI LINGGA, LAMPUNG TENGAH, LAMPUNG",5,92,30,122
https://kawalpemilu.org#23119,"MARGA JAYA, SELAGAI LINGGA, LAMPUNG TENGAH, LAMPUNG",6,97,31,128
https://kawalpemilu.org#23119,"MARGA JAYA, SELAGAI LINGGA, LAMPUNG TENGAH, LAMPUNG",7,84,50,134
https://kawalpemilu.org#23119,"MARGA JAYA, SELAGAI LINGGA, LAMPUNG TENGAH, LAMPUNG",8,127,24,151
https://kawalpemilu.org#23119,"MARGA JAYA, SELAGAI LINGGA, LAMPUNG TENGAH, LAMPUNG",9,92,31,123
https://kawalpemilu.org#23119,"MARGA JAYA, SELAGAI LINGGA, LAMPUNG TENGAH, LAMPUNG",10,95,20,115
https://kawalpemilu.org#23120,"GEDUNG AJI, SELAGAI LINGGA, LAMPUNG TENGAH, LAMPUNG",1,135,60,195
https://kawalpemilu.org#23120,"GEDUNG AJI, SELAGAI LINGGA, LAMPUNG TENGAH, LAMPUNG",2,131,23,154
https://kawalpemilu.org#23120,"GEDUNG AJI, SELAGAI LINGGA, LAMPUNG TENGAH, LAMPUNG",3,167,71,238
https://kawalpemilu.org#23120,"GEDUNG AJI, SELAGAI LINGGA, LAMPUNG TENGAH, LAMPUNG",4,149,90,239
https://kawalpemilu.org#23120,"GEDUNG AJI, SELAGAI LINGGA, LAMPUNG TENGAH, LAMPUNG",5,114,104,218
https://kawalpemilu.org#91303,"NEGERI JAYA, SELAGAI LINGGA, LAMPUNG TENGAH, LAMPUNG",1,130,45,175
https://kawalpemilu.org#91303,"NEGERI JAYA, SELAGAI LINGGA, LAMPUNG TENGAH, LAMPUNG",2,136,51,136
https://kawalpemilu.org#91303,"NEGERI JAYA, SELAGAI LINGGA, LAMPUNG TENGAH, LAMPUNG",3,134,48,182
https://kawalpemilu.org#928204,"MEKAR HARJO, SELAGAI LINGGA, LAMPUNG TENGAH, LAMPUNG",1,144,89,233
https://kawalpemilu.org#928204,"MEKAR HARJO, SELAGAI LINGGA, LAMPUNG TENGAH, LAMPUNG",3,158,47,205
https://kawalpemilu.org#928204,"MEKAR HARJO, SELAGAI LINGGA, LAMPUNG TENGAH, LAMPUNG",4,145,45,190
https://kawalpemilu.org#928204,"MEKAR HARJO, SELAGAI LINGGA, LAMPUNG TENGAH, LAMPUNG",5,134,57,190
https://kawalpemilu.org#23122,"SRI KATON, ANAK TUHA, LAMPUNG TENGAH, LAMPUNG",1,206,7,213
https://kawalpemilu.org#23122,"SRI KATON, ANAK TUHA, LAMPUNG TENGAH, LAMPUNG",2,147,61,208
https://kawalpemilu.org#23122,"SRI KATON, ANAK TUHA, LAMPUNG TENGAH, LAMPUNG",3,124,76,200
https://kawalpemilu.org#23122,"SRI KATON, ANAK TUHA, LAMPUNG TENGAH, LAMPUNG",4,163,51,214
https://kawalpemilu.org#23122,"SRI KATON, ANAK TUHA, LAMPUNG TENGAH, LAMPUNG",5,160,32,192
https://kawalpemilu.org#23122,"SRI KATON, ANAK TUHA, LAMPUNG TENGAH, LAMPUNG",6,166,13,179
https://kawalpemilu.org#23122,"SRI KATON, ANAK TUHA, LAMPUNG TENGAH, LAMPUNG",7,148,49,197
https://kawalpemilu.org#23122,"SRI KATON, ANAK TUHA, LAMPUNG TENGAH, LAMPUNG",8,126,63,189
https://kawalpemilu.org#23122,"SRI KATON, ANAK TUHA, LAMPUNG TENGAH, LAMPUNG",9,135,61,196
https://kawalpemilu.org#23122,"SRI KATON, ANAK TUHA, LAMPUNG TENGAH, LAMPUNG",10,186,21,207
https://kawalpemilu.org#23123,"JAYA SAKTI, ANAK TUHA, LAMPUNG TENGAH, LAMPUNG",1,180,51,231
https://kawalpemilu.org#23123,"JAYA SAKTI, ANAK TUHA, LAMPUNG TENGAH, LAMPUNG",2,196,31,227
https://kawalpemilu.org#23123,"JAYA SAKTI, ANAK TUHA, LAMPUNG TENGAH, LAMPUNG",3,166,43,209
https://kawalpemilu.org#23123,"JAYA SAKTI, ANAK TUHA, LAMPUNG TENGAH, LAMPUNG",4,141,63,204
https://kawalpemilu.org#23123,"JAYA SAKTI, ANAK TUHA, LAMPUNG TENGAH, LAMPUNG",5,89,116,205
https://kawalpemilu.org#23123,"JAYA SAKTI, ANAK TUHA, LAMPUNG TENGAH, LAMPUNG",7,177,49,226
https://kawalpemilu.org#23123,"JAYA SAKTI, ANAK TUHA, LAMPUNG TENGAH, LAMPUNG",8,171,44,215
https://kawalpemilu.org#23123,"JAYA SAKTI, ANAK TUHA, LAMPUNG TENGAH, LAMPUNG",9,138,72,210
https://kawalpemilu.org#23123,"JAYA SAKTI, ANAK TUHA, LAMPUNG TENGAH, LAMPUNG",10,173,29,202
https://kawalpemilu.org#23123,"JAYA SAKTI, ANAK TUHA, LAMPUNG TENGAH, LAMPUNG",11,139,50,189
https://kawalpemilu.org#23123,"JAYA SAKTI, ANAK TUHA, LAMPUNG TENGAH, LAMPUNG",12,146,83,229
https://kawalpemilu.org#23123,"JAYA SAKTI, ANAK TUHA, LAMPUNG TENGAH, LAMPUNG",13,177,40,217
https://kawalpemilu.org#23124,"HAJI PEMANGGILAN, ANAK TUHA, LAMPUNG TENGAH, LAMPUNG",1,38,121,159
https://kawalpemilu.org#23124,"HAJI PEMANGGILAN, ANAK TUHA, LAMPUNG TENGAH, LAMPUNG",2,68,134,202
https://kawalpemilu.org#23124,"HAJI PEMANGGILAN, ANAK TUHA, LAMPUNG TENGAH, LAMPUNG",3,136,99,235
https://kawalpemilu.org#23124,"HAJI PEMANGGILAN, ANAK TUHA, LAMPUNG TENGAH, LAMPUNG",4,195,53,248
https://kawalpemilu.org#23124,"HAJI PEMANGGILAN, ANAK TUHA, LAMPUNG TENGAH, LAMPUNG",5,56,172,228
https://kawalpemilu.org#23124,"HAJI PEMANGGILAN, ANAK TUHA, LAMPUNG TENGAH, LAMPUNG",6,154,57,211
https://kawalpemilu.org#23124,"HAJI PEMANGGILAN, ANAK TUHA, LAMPUNG TENGAH, LAMPUNG",7,186,19,205
https://kawalpemilu.org#23124,"HAJI PEMANGGILAN, ANAK TUHA, LAMPUNG TENGAH, LAMPUNG",8,41,141,182
https://kawalpemilu.org#23124,"HAJI PEMANGGILAN, ANAK TUHA, LAMPUNG TENGAH, LAMPUNG",9,58,126,184
https://kawalpemilu.org#23124,"HAJI PEMANGGILAN, ANAK TUHA, LAMPUNG TENGAH, LAMPUNG",10,130,70,200
https://kawalpemilu.org#23124,"HAJI PEMANGGILAN, ANAK TUHA, LAMPUNG TENGAH, LAMPUNG",11,152,22,174
https://kawalpemilu.org#23125,"NEGARA BUMI ILIR, ANAK TUHA, LAMPUNG TENGAH, LAMPUNG",1,49,162,211
https://kawalpemilu.org#23125,"NEGARA BUMI ILIR, ANAK TUHA, LAMPUNG TENGAH, LAMPUNG",2,44,107,1
https://kawalpemilu.org#23125,"NEGARA BUMI ILIR, ANAK TUHA, LAMPUNG TENGAH, LAMPUNG",3,84,11,95
https://kawalpemilu.org#23125,"NEGARA BUMI ILIR, ANAK TUHA, LAMPUNG TENGAH, LAMPUNG",4,178,43,221
https://kawalpemilu.org#23125,"NEGARA BUMI ILIR, ANAK TUHA, LAMPUNG TENGAH, LAMPUNG",5,209,37,246
https://kawalpemilu.org#23125,"NEGARA BUMI ILIR, ANAK TUHA, LAMPUNG TENGAH, LAMPUNG",6,231,30,261
https://kawalpemilu.org#23125,"NEGARA BUMI ILIR, ANAK TUHA, LAMPUNG TENGAH, LAMPUNG",7,160,26,186
https://kawalpemilu.org#23125,"NEGARA BUMI ILIR, ANAK TUHA, LAMPUNG TENGAH, LAMPUNG",8,42,116,158
https://kawalpemilu.org#23125,"NEGARA BUMI ILIR, ANAK TUHA, LAMPUNG TENGAH, LAMPUNG",9,155,41,196
https://kawalpemilu.org#23125,"NEGARA BUMI ILIR, ANAK TUHA, LAMPUNG TENGAH, LAMPUNG",10,180,33,213
https://kawalpemilu.org#23125,"NEGARA BUMI ILIR, ANAK TUHA, LAMPUNG TENGAH, LAMPUNG",11,170,37,207
https://kawalpemilu.org#23126,"BUMI AJI, ANAK TUHA, LAMPUNG TENGAH, LAMPUNG",1,49,167,216
https://kawalpemilu.org#23126,"BUMI AJI, ANAK TUHA, LAMPUNG TENGAH, LAMPUNG",2,92,174,266
https://kawalpemilu.org#23126,"BUMI AJI, ANAK TUHA, LAMPUNG TENGAH, LAMPUNG",3,220,43,263
https://kawalpemilu.org#23126,"BUMI AJI, ANAK TUHA, LAMPUNG TENGAH, LAMPUNG",6,144,127,271
https://kawalpemilu.org#23126,"BUMI AJI, ANAK TUHA, LAMPUNG TENGAH, LAMPUNG",7,144,81,225
https://kawalpemilu.org#23126,"BUMI AJI, ANAK TUHA, LAMPUNG TENGAH, LAMPUNG",8,207,32,239
https://kawalpemilu.org#23126,"BUMI AJI, ANAK TUHA, LAMPUNG TENGAH, LAMPUNG",9,156,28,148
https://kawalpemilu.org#23126,"BUMI AJI, ANAK TUHA, LAMPUNG TENGAH, LAMPUNG",10,57,135,192
https://kawalpemilu.org#23126,"BUMI AJI, ANAK TUHA, LAMPUNG TENGAH, LAMPUNG",11,93,147,240
https://kawalpemilu.org#23126,"BUMI AJI, ANAK TUHA, LAMPUNG TENGAH, LAMPUNG",12,205,81,286
https://kawalpemilu.org#23126,"BUMI AJI, ANAK TUHA, LAMPUNG TENGAH, LAMPUNG",13,148,50,198
https://kawalpemilu.org#23127,"NEGARA AJI TUA, ANAK TUHA, LAMPUNG TENGAH, LAMPUNG",1,47,81,128
https://kawalpemilu.org#23127,"NEGARA AJI TUA, ANAK TUHA, LAMPUNG TENGAH, LAMPUNG",2,126,35,161
https://kawalpemilu.org#23127,"NEGARA AJI TUA, ANAK TUHA, LAMPUNG TENGAH, LAMPUNG",3,119,14,133
https://kawalpemilu.org#23127,"NEGARA AJI TUA, ANAK TUHA, LAMPUNG TENGAH, LAMPUNG",4,158,32,190
https://kawalpemilu.org#23127,"NEGARA AJI TUA, ANAK TUHA, LAMPUNG TENGAH, LAMPUNG",5,185,20,205
https://kawalpemilu.org#23127,"NEGARA AJI TUA, ANAK TUHA, LAMPUNG TENGAH, LAMPUNG",6,189,16,205
https://kawalpemilu.org#23127,"NEGARA AJI TUA, ANAK TUHA, LAMPUNG TENGAH, LAMPUNG",7,119,76,195
https://kawalpemilu.org#23127,"NEGARA AJI TUA, ANAK TUHA, LAMPUNG TENGAH, LAMPUNG",8,178,33,211
https://kawalpemilu.org#23127,"NEGARA AJI TUA, ANAK TUHA, LAMPUNG TENGAH, LAMPUNG",9,99,13,112
https://kawalpemilu.org#23127,"NEGARA AJI TUA, ANAK TUHA, LAMPUNG TENGAH, LAMPUNG",10,131,51,182
https://kawalpemilu.org#23127,"NEGARA AJI TUA, ANAK TUHA, LAMPUNG TENGAH, LAMPUNG",11,123,5,128
https://kawalpemilu.org#23127,"NEGARA AJI TUA, ANAK TUHA, LAMPUNG TENGAH, LAMPUNG",12,191,32,223
https://kawalpemilu.org#23128,"NEGARA BUMI UDIK, ANAK TUHA, LAMPUNG TENGAH, LAMPUNG",1,81,87,168
https://kawalpemilu.org#23128,"NEGARA BUMI UDIK, ANAK TUHA, LAMPUNG TENGAH, LAMPUNG",2,48,54,102
https://kawalpemilu.org#23128,"NEGARA BUMI UDIK, ANAK TUHA, LAMPUNG TENGAH, LAMPUNG",3,125,43,168
https://kawalpemilu.org#23128,"NEGARA BUMI UDIK, ANAK TUHA, LAMPUNG TENGAH, LAMPUNG",4,154,46,200
https://kawalpemilu.org#23128,"NEGARA BUMI UDIK, ANAK TUHA, LAMPUNG TENGAH, LAMPUNG",5,157,46,203
https://kawalpemilu.org#23128,"NEGARA BUMI UDIK, ANAK TUHA, LAMPUNG TENGAH, LAMPUNG",6,149,61,210
https://kawalpemilu.org#23128,"NEGARA BUMI UDIK, ANAK TUHA, LAMPUNG TENGAH, LAMPUNG",7,122,42,164
https://kawalpemilu.org#23128,"NEGARA BUMI UDIK, ANAK TUHA, LAMPUNG TENGAH, LAMPUNG",8,64,82,146
https://kawalpemilu.org#23128,"NEGARA BUMI UDIK, ANAK TUHA, LAMPUNG TENGAH, LAMPUNG",9,123,37,160
https://kawalpemilu.org#23128,"NEGARA BUMI UDIK, ANAK TUHA, LAMPUNG TENGAH, LAMPUNG",10,140,44,184
https://kawalpemilu.org#23128,"NEGARA BUMI UDIK, ANAK TUHA, LAMPUNG TENGAH, LAMPUNG",11,126,51,177
https://kawalpemilu.org#23128,"NEGARA BUMI UDIK, ANAK TUHA, LAMPUNG TENGAH, LAMPUNG",12,87,28,115
https://kawalpemilu.org#23129,"NEGARA AJI BARU, ANAK TUHA, LAMPUNG TENGAH, LAMPUNG",1,87,55,142
https://kawalpemilu.org#23129,"NEGARA AJI BARU, ANAK TUHA, LAMPUNG TENGAH, LAMPUNG",2,69,92,161
https://kawalpemilu.org#23129,"NEGARA AJI BARU, ANAK TUHA, LAMPUNG TENGAH, LAMPUNG",3,89,5,94
https://kawalpemilu.org#23129,"NEGARA AJI BARU, ANAK TUHA, LAMPUNG TENGAH, LAMPUNG",4,193,33,226
https://kawalpemilu.org#23129,"NEGARA AJI BARU, ANAK TUHA, LAMPUNG TENGAH, LAMPUNG",5,199,17,216
https://kawalpemilu.org#23129,"NEGARA AJI BARU, ANAK TUHA, LAMPUNG TENGAH, LAMPUNG",6,138,15,153
https://kawalpemilu.org#23129,"NEGARA AJI BARU, ANAK TUHA, LAMPUNG TENGAH, LAMPUNG",7,70,67,137
https://kawalpemilu.org#23129,"NEGARA AJI BARU, ANAK TUHA, LAMPUNG TENGAH, LAMPUNG",8,179,10,189
https://kawalpemilu.org#23129,"NEGARA AJI BARU, ANAK TUHA, LAMPUNG TENGAH, LAMPUNG",9,144,19,163
https://kawalpemilu.org#23130,"GUNUNG AGUNG, ANAK TUHA, LAMPUNG TENGAH, LAMPUNG",1,49,116,165
https://kawalpemilu.org#23131,"TANJUNG HARAPAN, ANAK TUHA, LAMPUNG TENGAH, LAMPUNG",1,22,170,192
https://kawalpemilu.org#23131,"TANJUNG HARAPAN, ANAK TUHA, LAMPUNG TENGAH, LAMPUNG",2,172,69,241
https://kawalpemilu.org#23131,"TANJUNG HARAPAN, ANAK TUHA, LAMPUNG TENGAH, LAMPUNG",3,138,84,222
https://kawalpemilu.org#23131,"TANJUNG HARAPAN, ANAK TUHA, LAMPUNG TENGAH, LAMPUNG",4,205,50,255
https://kawalpemilu.org#23131,"TANJUNG HARAPAN, ANAK TUHA, LAMPUNG TENGAH, LAMPUNG",5,106,104,210
https://kawalpemilu.org#23132,"BUMI JAYA, ANAK TUHA, LAMPUNG TENGAH, LAMPUNG",1,110,72,182
https://kawalpemilu.org#23132,"BUMI JAYA, ANAK TUHA, LAMPUNG TENGAH, LAMPUNG",2,134,54,188
https://kawalpemilu.org#23132,"BUMI JAYA, ANAK TUHA, LAMPUNG TENGAH, LAMPUNG",3,173,34,207
https://kawalpemilu.org#23132,"BUMI JAYA, ANAK TUHA, LAMPUNG TENGAH, LAMPUNG",4,178,61,239
https://kawalpemilu.org#23132,"BUMI JAYA, ANAK TUHA, LAMPUNG TENGAH, LAMPUNG",5,112,132,244
https://kawalpemilu.org#23132,"BUMI JAYA, ANAK TUHA, LAMPUNG TENGAH, LAMPUNG",6,112,63,175
https://kawalpemilu.org#23132,"BUMI JAYA, ANAK TUHA, LAMPUNG TENGAH, LAMPUNG",7,181,33,214
https://kawalpemilu.org#23133,"MULYO HAJI, ANAK TUHA, LAMPUNG TENGAH, LAMPUNG",1,136,99,235
https://kawalpemilu.org#23133,"MULYO HAJI, ANAK TUHA, LAMPUNG TENGAH, LAMPUNG",2,163,55,218
https://kawalpemilu.org#23133,"MULYO HAJI, ANAK TUHA, LAMPUNG TENGAH, LAMPUNG",3,175,48,223
https://kawalpemilu.org#23133,"MULYO HAJI, ANAK TUHA, LAMPUNG TENGAH, LAMPUNG",4,178,61,239
https://kawalpemilu.org#23133,"MULYO HAJI, ANAK TUHA, LAMPUNG TENGAH, LAMPUNG",5,188,74,262
https://kawalpemilu.org#23133,"MULYO HAJI, ANAK TUHA, LAMPUNG TENGAH, LAMPUNG",6,208,39,247
https://kawalpemilu.org#23133,"MULYO HAJI, ANAK TUHA, LAMPUNG TENGAH, LAMPUNG",7,121,11,132
https://kawalpemilu.org#23135,"SENDANG MULYO, SENDANG AGUNG, LAMPUNG TENGAH, LAMPUNG",1,182,43,225
https://kawalpemilu.org#23135,"SENDANG MULYO, SENDANG AGUNG, LAMPUNG TENGAH, LAMPUNG",2,183,22,205
https://kawalpemilu.org#23135,"SENDANG MULYO, SENDANG AGUNG, LAMPUNG TENGAH, LAMPUNG",3,156,67,223
https://kawalpemilu.org#23135,"SENDANG MULYO, SENDANG AGUNG, LAMPUNG TENGAH, LAMPUNG",4,150,47,197
https://kawalpemilu.org#23135,"SENDANG MULYO, SENDANG AGUNG, LAMPUNG TENGAH, LAMPUNG",5,161,44,205
https://kawalpemilu.org#23135,"SENDANG MULYO, SENDANG AGUNG, LAMPUNG TENGAH, LAMPUNG",6,171,43,214
https://kawalpemilu.org#23135,"SENDANG MULYO, SENDANG AGUNG, LAMPUNG TENGAH, LAMPUNG",7,149,39,192
https://kawalpemilu.org#23135,"SENDANG MULYO, SENDANG AGUNG, LAMPUNG TENGAH, LAMPUNG",8,151,61,212
https://kawalpemilu.org#23135,"SENDANG MULYO, SENDANG AGUNG, LAMPUNG TENGAH, LAMPUNG",9,128,44,172
https://kawalpemilu.org#23135,"SENDANG MULYO, SENDANG AGUNG, LAMPUNG TENGAH, LAMPUNG",10,107,62,169
https://kawalpemilu.org#23135,"SENDANG MULYO, SENDANG AGUNG, LAMPUNG TENGAH, LAMPUNG",11,132,42,174
https://kawalpemilu.org#23135,"SENDANG MULYO, SENDANG AGUNG, LAMPUNG TENGAH, LAMPUNG",12,135,45,180
https://kawalpemilu.org#23135,"SENDANG MULYO, SENDANG AGUNG, LAMPUNG TENGAH, LAMPUNG",13,153,60,213
https://kawalpemilu.org#23135,"SENDANG MULYO, SENDANG AGUNG, LAMPUNG TENGAH, LAMPUNG",14,130,52,182
https://kawalpemilu.org#23135,"SENDANG MULYO, SENDANG AGUNG, LAMPUNG TENGAH, LAMPUNG",15,130,38,168
https://kawalpemilu.org#23135,"SENDANG MULYO, SENDANG AGUNG, LAMPUNG TENGAH, LAMPUNG",16,118,60,178
https://kawalpemilu.org#23135,"SENDANG MULYO, SENDANG AGUNG, LAMPUNG TENGAH, LAMPUNG",17,117,86,203
https://kawalpemilu.org#23135,"SENDANG MULYO, SENDANG AGUNG, LAMPUNG TENGAH, LAMPUNG",18,134,74,208
https://kawalpemilu.org#23136,"SENDANG REJO, SENDANG AGUNG, LAMPUNG TENGAH, LAMPUNG",1,139,66,205
https://kawalpemilu.org#23136,"SENDANG REJO, SENDANG AGUNG, LAMPUNG TENGAH, LAMPUNG",2,186,48,234
https://kawalpemilu.org#23136,"SENDANG REJO, SENDANG AGUNG, LAMPUNG TENGAH, LAMPUNG",3,152,55,207
https://kawalpemilu.org#23136,"SENDANG REJO, SENDANG AGUNG, LAMPUNG TENGAH, LAMPUNG",4,192,52,244
https://kawalpemilu.org#23136,"SENDANG REJO, SENDANG AGUNG, LAMPUNG TENGAH, LAMPUNG",5,159,33,192
https://kawalpemilu.org#23136,"SENDANG REJO, SENDANG AGUNG, LAMPUNG TENGAH, LAMPUNG",6,128,58,186
https://kawalpemilu.org#23136,"SENDANG REJO, SENDANG AGUNG, LAMPUNG TENGAH, LAMPUNG",7,148,75,223
https://kawalpemilu.org#23136,"SENDANG REJO, SENDANG AGUNG, LAMPUNG TENGAH, LAMPUNG",8,161,55,216
https://kawalpemilu.org#23136,"SENDANG REJO, SENDANG AGUNG, LAMPUNG TENGAH, LAMPUNG",9,167,54,221
https://kawalpemilu.org#23136,"SENDANG REJO, SENDANG AGUNG, LAMPUNG TENGAH, LAMPUNG",10,153,79,232
https://kawalpemilu.org#23136,"SENDANG REJO, SENDANG AGUNG, LAMPUNG TENGAH, LAMPUNG",11,164,96,260
https://kawalpemilu.org#23136,"SENDANG REJO, SENDANG AGUNG, LAMPUNG TENGAH, LAMPUNG",12,181,74,255
https://kawalpemilu.org#23137,"SENDANG BARU, SENDANG AGUNG, LAMPUNG TENGAH, LAMPUNG",1,122,59,181
https://kawalpemilu.org#23137,"SENDANG BARU, SENDANG AGUNG, LAMPUNG TENGAH, LAMPUNG",2,131,64,195
https://kawalpemilu.org#23137,"SENDANG BARU, SENDANG AGUNG, LAMPUNG TENGAH, LAMPUNG",3,117,43,160
https://kawalpemilu.org#23137,"SENDANG BARU, SENDANG AGUNG, LAMPUNG TENGAH, LAMPUNG",4,116,58,174
https://kawalpemilu.org#23137,"SENDANG BARU, SENDANG AGUNG, LAMPUNG TENGAH, LAMPUNG",5,121,56,177
https://kawalpemilu.org#23137,"SENDANG BARU, SENDANG AGUNG, LAMPUNG TENGAH, LAMPUNG",6,86,63,149
https://kawalpemilu.org#23137,"SENDANG BARU, SENDANG AGUNG, LAMPUNG TENGAH, LAMPUNG",7,97,53,150
https://kawalpemilu.org#23137,"SENDANG BARU, SENDANG AGUNG, LAMPUNG TENGAH, LAMPUNG",8,122,57,179
https://kawalpemilu.org#23137,"SENDANG BARU, SENDANG AGUNG, LAMPUNG TENGAH, LAMPUNG",9,123,49,172
https://kawalpemilu.org#23137,"SENDANG BARU, SENDANG AGUNG, LAMPUNG TENGAH, LAMPUNG",10,150,56,206
https://kawalpemilu.org#23137,"SENDANG BARU, SENDANG AGUNG, LAMPUNG TENGAH, LAMPUNG",11,113,44,157
https://kawalpemilu.org#23137,"SENDANG BARU, SENDANG AGUNG, LAMPUNG TENGAH, LAMPUNG",12,99,87,186
https://kawalpemilu.org#23138,"SENDANG RETNO, SENDANG AGUNG, LAMPUNG TENGAH, LAMPUNG",1,86,97,183
https://kawalpemilu.org#23138,"SENDANG RETNO, SENDANG AGUNG, LAMPUNG TENGAH, LAMPUNG",2,111,84,195
https://kawalpemilu.org#23138,"SENDANG RETNO, SENDANG AGUNG, LAMPUNG TENGAH, LAMPUNG",3,136,52,188
https://kawalpemilu.org#23138,"SENDANG RETNO, SENDANG AGUNG, LAMPUNG TENGAH, LAMPUNG",4,58,87,145
https://kawalpemilu.org#23138,"SENDANG RETNO, SENDANG AGUNG, LAMPUNG TENGAH, LAMPUNG",5,75,109,184
https://kawalpemilu.org#23138,"SENDANG RETNO, SENDANG AGUNG, LAMPUNG TENGAH, LAMPUNG",6,93,115,208
https://kawalpemilu.org#23138,"SENDANG RETNO, SENDANG AGUNG, LAMPUNG TENGAH, LAMPUNG",7,99,76,175
https://kawalpemilu.org#23138,"SENDANG RETNO, SENDANG AGUNG, LAMPUNG TENGAH, LAMPUNG",8,86,89,175
https://kawalpemilu.org#23138,"SENDANG RETNO, SENDANG AGUNG, LAMPUNG TENGAH, LAMPUNG",9,114,92,206
https://kawalpemilu.org#23139,"SENDANG ASIH, SENDANG AGUNG, LAMPUNG TENGAH, LAMPUNG",1,152,54,206
https://kawalpemilu.org#23139,"SENDANG ASIH, SENDANG AGUNG, LAMPUNG TENGAH, LAMPUNG",2,144,70,214
https://kawalpemilu.org#23139,"SENDANG ASIH, SENDANG AGUNG, LAMPUNG TENGAH, LAMPUNG",3,130,48,176
https://kawalpemilu.org#23139,"SENDANG ASIH, SENDANG AGUNG, LAMPUNG TENGAH, LAMPUNG",4,218,32,250
https://kawalpemilu.org#23139,"SENDANG ASIH, SENDANG AGUNG, LAMPUNG TENGAH, LAMPUNG",6,130,72,202
https://kawalpemilu.org#23139,"SENDANG ASIH, SENDANG AGUNG, LAMPUNG TENGAH, LAMPUNG",7,188,40,228
https://kawalpemilu.org#23139,"SENDANG ASIH, SENDANG AGUNG, LAMPUNG TENGAH, LAMPUNG",8,164,60,224
https://kawalpemilu.org#23139,"SENDANG ASIH, SENDANG AGUNG, LAMPUNG TENGAH, LAMPUNG",9,170,44,214
https://kawalpemilu.org#23139,"SENDANG ASIH, SENDANG AGUNG, LAMPUNG TENGAH, LAMPUNG",10,185,54,239
https://kawalpemilu.org#23139,"SENDANG ASIH, SENDANG AGUNG, LAMPUNG TENGAH, LAMPUNG",11,157,41,198
https://kawalpemilu.org#23139,"SENDANG ASIH, SENDANG AGUNG, LAMPUNG TENGAH, LAMPUNG",12,157,61,218
https://kawalpemilu.org#23139,"SENDANG ASIH, SENDANG AGUNG, LAMPUNG TENGAH, LAMPUNG",13,167,55,222
https://kawalpemilu.org#23139,"SENDANG ASIH, SENDANG AGUNG, LAMPUNG TENGAH, LAMPUNG",14,203,28,231
https://kawalpemilu.org#23139,"SENDANG ASIH, SENDANG AGUNG, LAMPUNG TENGAH, LAMPUNG",15,130,80,210
https://kawalpemilu.org#23140,"SENDANG AGUNG, SENDANG AGUNG, LAMPUNG TENGAH, LAMPUNG",1,136,60,196
https://kawalpemilu.org#23140,"SENDANG AGUNG, SENDANG AGUNG, LAMPUNG TENGAH, LAMPUNG",2,102,55,157
https://kawalpemilu.org#23140,"SENDANG AGUNG, SENDANG AGUNG, LAMPUNG TENGAH, LAMPUNG",3,138,83,221
https://kawalpemilu.org#23140,"SENDANG AGUNG, SENDANG AGUNG, LAMPUNG TENGAH, LAMPUNG",4,107,87,194
https://kawalpemilu.org#23140,"SENDANG AGUNG, SENDANG AGUNG, LAMPUNG TENGAH, LAMPUNG",5,90,82,172
https://kawalpemilu.org#23140,"SENDANG AGUNG, SENDANG AGUNG, LAMPUNG TENGAH, LAMPUNG",6,105,62,167
https://kawalpemilu.org#23140,"SENDANG AGUNG, SENDANG AGUNG, LAMPUNG TENGAH, LAMPUNG",7,85,62,147
https://kawalpemilu.org#23140,"SENDANG AGUNG, SENDANG AGUNG, LAMPUNG TENGAH, LAMPUNG",8,135,55,190
https://kawalpemilu.org#23140,"SENDANG AGUNG, SENDANG AGUNG, LAMPUNG TENGAH, LAMPUNG",9,98,58,156
https://kawalpemilu.org#23140,"SENDANG AGUNG, SENDANG AGUNG, LAMPUNG TENGAH, LAMPUNG",10,118,73,191
https://kawalpemilu.org#23140,"SENDANG AGUNG, SENDANG AGUNG, LAMPUNG TENGAH, LAMPUNG",11,107,57,164
https://kawalpemilu.org#23140,"SENDANG AGUNG, SENDANG AGUNG, LAMPUNG TENGAH, LAMPUNG",12,114,83,197
https://kawalpemilu.org#23140,"SENDANG AGUNG, SENDANG AGUNG, LAMPUNG TENGAH, LAMPUNG",13,85,49,134
https://kawalpemilu.org#23140,"SENDANG AGUNG, SENDANG AGUNG, LAMPUNG TENGAH, LAMPUNG",14,84,70,154
https://kawalpemilu.org#23140,"SENDANG AGUNG, SENDANG AGUNG, LAMPUNG TENGAH, LAMPUNG",15,120,65,185
https://kawalpemilu.org#23140,"SENDANG AGUNG, SENDANG AGUNG, LAMPUNG TENGAH, LAMPUNG",16,119,67,186
https://kawalpemilu.org#23140,"SENDANG AGUNG, SENDANG AGUNG, LAMPUNG TENGAH, LAMPUNG",17,80,85,165
https://kawalpemilu.org#23140,"SENDANG AGUNG, SENDANG AGUNG, LAMPUNG TENGAH, LAMPUNG",18,92,75,167
https://kawalpemilu.org#23140,"SENDANG AGUNG, SENDANG AGUNG, LAMPUNG TENGAH, LAMPUNG",19,96,40,136
https://kawalpemilu.org#23140,"SENDANG AGUNG, SENDANG AGUNG, LAMPUNG TENGAH, LAMPUNG",20,75,60,135
https://kawalpemilu.org#23140,"SENDANG AGUNG, SENDANG AGUNG, LAMPUNG TENGAH, LAMPUNG",21,73,39,112
https://kawalpemilu.org#23140,"SENDANG AGUNG, SENDANG AGUNG, LAMPUNG TENGAH, LAMPUNG",22,107,70,177
https://kawalpemilu.org#23141,"SENDANG ASRI, SENDANG AGUNG, LAMPUNG TENGAH, LAMPUNG",1,82,114,196
https://kawalpemilu.org#23141,"SENDANG ASRI, SENDANG AGUNG, LAMPUNG TENGAH, LAMPUNG",2,113,100,213
https://kawalpemilu.org#23141,"SENDANG ASRI, SENDANG AGUNG, LAMPUNG TENGAH, LAMPUNG",3,126,55,181
https://kawalpemilu.org#23141,"SENDANG ASRI, SENDANG AGUNG, LAMPUNG TENGAH, LAMPUNG",4,149,49,198
https://kawalpemilu.org#23141,"SENDANG ASRI, SENDANG AGUNG, LAMPUNG TENGAH, LAMPUNG",5,110,55,165
https://kawalpemilu.org#23141,"SENDANG ASRI, SENDANG AGUNG, LAMPUNG TENGAH, LAMPUNG",6,104,62,166
https://kawalpemilu.org#23141,"SENDANG ASRI, SENDANG AGUNG, LAMPUNG TENGAH, LAMPUNG",7,107,68,175
https://kawalpemilu.org#23141,"SENDANG ASRI, SENDANG AGUNG, LAMPUNG TENGAH, LAMPUNG",8,134,50,184
https://kawalpemilu.org#23141,"SENDANG ASRI, SENDANG AGUNG, LAMPUNG TENGAH, LAMPUNG",9,108,59,167
https://kawalpemilu.org#23142,"SENDANG MUKTI, SENDANG AGUNG, LAMPUNG TENGAH, LAMPUNG",1,126,92,218
https://kawalpemilu.org#23142,"SENDANG MUKTI, SENDANG AGUNG, LAMPUNG TENGAH, LAMPUNG",2,130,70,200
https://kawalpemilu.org#23142,"SENDANG MUKTI, SENDANG AGUNG, LAMPUNG TENGAH, LAMPUNG",3,133,57,190
https://kawalpemilu.org#23142,"SENDANG MUKTI, SENDANG AGUNG, LAMPUNG TENGAH, LAMPUNG",4,115,88,203
https://kawalpemilu.org#23142,"SENDANG MUKTI, SENDANG AGUNG, LAMPUNG TENGAH, LAMPUNG",5,95,68,163
https://kawalpemilu.org#23142,"SENDANG MUKTI, SENDANG AGUNG, LAMPUNG TENGAH, LAMPUNG",6,120,78,198
https://kawalpemilu.org#23142,"SENDANG MUKTI, SENDANG AGUNG, LAMPUNG TENGAH, LAMPUNG",7,113,69,182
https://kawalpemilu.org#23142,"SENDANG MUKTI, SENDANG AGUNG, LAMPUNG TENGAH, LAMPUNG",8,97,110,207
https://kawalpemilu.org#23142,"SENDANG MUKTI, SENDANG AGUNG, LAMPUNG TENGAH, LAMPUNG",9,79,88,167
https://kawalpemilu.org#23143,"KUTO WINANGUN, SENDANG AGUNG, LAMPUNG TENGAH, LAMPUNG",1,120,90,210
https://kawalpemilu.org#23143,"KUTO WINANGUN, SENDANG AGUNG, LAMPUNG TENGAH, LAMPUNG",2,94,71,165
https://kawalpemilu.org#23143,"KUTO WINANGUN, SENDANG AGUNG, LAMPUNG TENGAH, LAMPUNG",3,50,130,180
https://kawalpemilu.org#23143,"KUTO WINANGUN, SENDANG AGUNG, LAMPUNG TENGAH, LAMPUNG",4,77,88,165
https://kawalpemilu.org#23143,"KUTO WINANGUN, SENDANG AGUNG, LAMPUNG TENGAH, LAMPUNG",5,94,95,189
https://kawalpemilu.org#23143,"KUTO WINANGUN, SENDANG AGUNG, LAMPUNG TENGAH, LAMPUNG",6,124,70,194
https://kawalpemilu.org#23145,"SRI TEJO KENCONO, KOTA GAJAH, LAMPUNG TENGAH, LAMPUNG",1,85,69,154
https://kawalpemilu.org#23145,"SRI TEJO KENCONO, KOTA GAJAH, LAMPUNG TENGAH, LAMPUNG",2,98,77,175
https://kawalpemilu.org#23145,"SRI TEJO KENCONO, KOTA GAJAH, LAMPUNG TENGAH, LAMPUNG",3,116,87,203
https://kawalpemilu.org#23145,"SRI TEJO KENCONO, KOTA GAJAH, LAMPUNG TENGAH, LAMPUNG",4,75,93,168
https://kawalpemilu.org#23145,"SRI TEJO KENCONO, KOTA GAJAH, LAMPUNG TENGAH, LAMPUNG",5,70,112,182
https://kawalpemilu.org#23145,"SRI TEJO KENCONO, KOTA GAJAH, LAMPUNG TENGAH, LAMPUNG",7,64,84,148
https://kawalpemilu.org#23145,"SRI TEJO KENCONO, KOTA GAJAH, LAMPUNG TENGAH, LAMPUNG",8,91,67,158
https://kawalpemilu.org#23145,"SRI TEJO KENCONO, KOTA GAJAH, LAMPUNG TENGAH, LAMPUNG",9,97,61,158
https://kawalpemilu.org#23145,"SRI TEJO KENCONO, KOTA GAJAH, LAMPUNG TENGAH, LAMPUNG",10,115,62,177
https://kawalpemilu.org#23145,"SRI TEJO KENCONO, KOTA GAJAH, LAMPUNG TENGAH, LAMPUNG",11,104,69,173
https://kawalpemilu.org#23145,"SRI TEJO KENCONO, KOTA GAJAH, LAMPUNG TENGAH, LAMPUNG",12,116,52,168
https://kawalpemilu.org#23145,"SRI TEJO KENCONO, KOTA GAJAH, LAMPUNG TENGAH, LAMPUNG",14,109,77,186
https://kawalpemilu.org#23145,"SRI TEJO KENCONO, KOTA GAJAH, LAMPUNG TENGAH, LAMPUNG",15,125,90,215
https://kawalpemilu.org#23145,"SRI TEJO KENCONO, KOTA GAJAH, LAMPUNG TENGAH, LAMPUNG",16,172,63,235
https://kawalpemilu.org#23146,"SAPTO MULYO, KOTA GAJAH, LAMPUNG TENGAH, LAMPUNG",1,140,113,253
https://kawalpemilu.org#23146,"SAPTO MULYO, KOTA GAJAH, LAMPUNG TENGAH, LAMPUNG",2,144,108,252
https://kawalpemilu.org#23146,"SAPTO MULYO, KOTA GAJAH, LAMPUNG TENGAH, LAMPUNG",3,127,119,246
https://kawalpemilu.org#23146,"SAPTO MULYO, KOTA GAJAH, LAMPUNG TENGAH, LAMPUNG",4,81,112,193
https://kawalpemilu.org#23146,"SAPTO MULYO, KOTA GAJAH, LAMPUNG TENGAH, LAMPUNG",5,104,149,253
https://kawalpemilu.org#23146,"SAPTO MULYO, KOTA GAJAH, LAMPUNG TENGAH, LAMPUNG",6,73,149,222
https://kawalpemilu.org#23147,"NAMBAH REJO, KOTA GAJAH, LAMPUNG TENGAH, LAMPUNG",1,117,38,155
https://kawalpemilu.org#23147,"NAMBAH REJO, KOTA GAJAH, LAMPUNG TENGAH, LAMPUNG",2,129,50,179
https://kawalpemilu.org#23147,"NAMBAH REJO, KOTA GAJAH, LAMPUNG TENGAH, LAMPUNG",3,115,40,155
https://kawalpemilu.org#23147,"NAMBAH REJO, KOTA GAJAH, LAMPUNG TENGAH, LAMPUNG",4,125,55,180
https://kawalpemilu.org#23147,"NAMBAH REJO, KOTA GAJAH, LAMPUNG TENGAH, LAMPUNG",5,111,62,173
https://kawalpemilu.org#23147,"NAMBAH REJO, KOTA GAJAH, LAMPUNG TENGAH, LAMPUNG",6,138,38,176
https://kawalpemilu.org#23147,"NAMBAH REJO, KOTA GAJAH, LAMPUNG TENGAH, LAMPUNG",7,149,36,185
https://kawalpemilu.org#23147,"NAMBAH REJO, KOTA GAJAH, LAMPUNG TENGAH, LAMPUNG",8,139,46,185
https://kawalpemilu.org#23147,"NAMBAH REJO, KOTA GAJAH, LAMPUNG TENGAH, LAMPUNG",9,115,40,155
https://kawalpemilu.org#23147,"NAMBAH REJO, KOTA GAJAH, LAMPUNG TENGAH, LAMPUNG",10,126,31,157
https://kawalpemilu.org#23147,"NAMBAH REJO, KOTA GAJAH, LAMPUNG TENGAH, LAMPUNG",11,126,26,152
https://kawalpemilu.org#23147,"NAMBAH REJO, KOTA GAJAH, LAMPUNG TENGAH, LAMPUNG",12,122,34,156
https://kawalpemilu.org#23147,"NAMBAH REJO, KOTA GAJAH, LAMPUNG TENGAH, LAMPUNG",13,153,30,183
https://kawalpemilu.org#23148,"SUMBER REJO, KOTA GAJAH, LAMPUNG TENGAH, LAMPUNG",1,110,85,195
https://kawalpemilu.org#23148,"SUMBER REJO, KOTA GAJAH, LAMPUNG TENGAH, LAMPUNG",2,177,59,236
https://kawalpemilu.org#23148,"SUMBER REJO, KOTA GAJAH, LAMPUNG TENGAH, LAMPUNG",3,119,99,218
https://kawalpemilu.org#23148,"SUMBER REJO, KOTA GAJAH, LAMPUNG TENGAH, LAMPUNG",4,131,53,184
https://kawalpemilu.org#23148,"SUMBER REJO, KOTA GAJAH, LAMPUNG TENGAH, LAMPUNG",5,165,55,220
https://kawalpemilu.org#23148,"SUMBER REJO, KOTA GAJAH, LAMPUNG TENGAH, LAMPUNG",6,96,34,130
https://kawalpemilu.org#23148,"SUMBER REJO, KOTA GAJAH, LAMPUNG TENGAH, LAMPUNG",7,133,70,203
https://kawalpemilu.org#23148,"SUMBER REJO, KOTA GAJAH, LAMPUNG TENGAH, LAMPUNG",8,156,55,211
https://kawalpemilu.org#23148,"SUMBER REJO, KOTA GAJAH, LAMPUNG TENGAH, LAMPUNG",9,202,69,271
https://kawalpemilu.org#23148,"SUMBER REJO, KOTA GAJAH, LAMPUNG TENGAH, LAMPUNG",10,188,69,257
https://kawalpemilu.org#23149,"PURWOREJO, KOTA GAJAH, LAMPUNG TENGAH, LAMPUNG",1,125,41,166
https://kawalpemilu.org#23149,"PURWOREJO, KOTA GAJAH, LAMPUNG TENGAH, LAMPUNG",2,72,59,131
https://kawalpemilu.org#23149,"PURWOREJO, KOTA GAJAH, LAMPUNG TENGAH, LAMPUNG",3,98,60,158
https://kawalpemilu.org#23149,"PURWOREJO, KOTA GAJAH, LAMPUNG TENGAH, LAMPUNG",4,84,72,156
https://kawalpemilu.org#23149,"PURWOREJO, KOTA GAJAH, LAMPUNG TENGAH, LAMPUNG",5,75,62,137
https://kawalpemilu.org#23149,"PURWOREJO, KOTA GAJAH, LAMPUNG TENGAH, LAMPUNG",6,116,51,167
https://kawalpemilu.org#23149,"PURWOREJO, KOTA GAJAH, LAMPUNG TENGAH, LAMPUNG",7,139,72,211
https://kawalpemilu.org#23149,"PURWOREJO, KOTA GAJAH, LAMPUNG TENGAH, LAMPUNG",8,112,54,166
https://kawalpemilu.org#23149,"PURWOREJO, KOTA GAJAH, LAMPUNG TENGAH, LAMPUNG",9,77,63,140
https://kawalpemilu.org#23149,"PURWOREJO, KOTA GAJAH, LAMPUNG TENGAH, LAMPUNG",10,80,70,150
https://kawalpemilu.org#23149,"PURWOREJO, KOTA GAJAH, LAMPUNG TENGAH, LAMPUNG",11,125,72,197
https://kawalpemilu.org#23150,"KOTA GAJAH, KOTA GAJAH, LAMPUNG TENGAH, LAMPUNG",1,130,77,207
https://kawalpemilu.org#23150,"KOTA GAJAH, KOTA GAJAH, LAMPUNG TENGAH, LAMPUNG",2,107,128,235
https://kawalpemilu.org#23150,"KOTA GAJAH, KOTA GAJAH, LAMPUNG TENGAH, LAMPUNG",3,125,77,202
https://kawalpemilu.org#23150,"KOTA GAJAH, KOTA GAJAH, LAMPUNG TENGAH, LAMPUNG",4,129,88,217
https://kawalpemilu.org#23150,"KOTA GAJAH, KOTA GAJAH, LAMPUNG TENGAH, LAMPUNG",5,148,79,227
https://kawalpemilu.org#23150,"KOTA GAJAH, KOTA GAJAH, LAMPUNG TENGAH, LAMPUNG",6,122,92,214
https://kawalpemilu.org#23150,"KOTA GAJAH, KOTA GAJAH, LAMPUNG TENGAH, LAMPUNG",7,137,84,221
https://kawalpemilu.org#23150,"KOTA GAJAH, KOTA GAJAH, LAMPUNG TENGAH, LAMPUNG",8,160,86,246
https://kawalpemilu.org#23150,"KOTA GAJAH, KOTA GAJAH, LAMPUNG TENGAH, LAMPUNG",9,194,55,249
https://kawalpemilu.org#23150,"KOTA GAJAH, KOTA GAJAH, LAMPUNG TENGAH, LAMPUNG",10,203,56,259
https://kawalpemilu.org#23150,"KOTA GAJAH, KOTA GAJAH, LAMPUNG TENGAH, LAMPUNG",11,170,73,243
https://kawalpemilu.org#23150,"KOTA GAJAH, KOTA GAJAH, LAMPUNG TENGAH, LAMPUNG",13,117,111,228
https://kawalpemilu.org#23150,"KOTA GAJAH, KOTA GAJAH, LAMPUNG TENGAH, LAMPUNG",14,73,89,162
https://kawalpemilu.org#23150,"KOTA GAJAH, KOTA GAJAH, LAMPUNG TENGAH, LAMPUNG",15,76,124,200
https://kawalpemilu.org#23150,"KOTA GAJAH, KOTA GAJAH, LAMPUNG TENGAH, LAMPUNG",16,115,66,181
https://kawalpemilu.org#23150,"KOTA GAJAH, KOTA GAJAH, LAMPUNG TENGAH, LAMPUNG",17,110,91,201
https://kawalpemilu.org#23150,"KOTA GAJAH, KOTA GAJAH, LAMPUNG TENGAH, LAMPUNG",18,99,72,171
https://kawalpemilu.org#23150,"KOTA GAJAH, KOTA GAJAH, LAMPUNG TENGAH, LAMPUNG",19,110,50,160
https://kawalpemilu.org#23150,"KOTA GAJAH, KOTA GAJAH, LAMPUNG TENGAH, LAMPUNG",20,94,66,160
https://kawalpemilu.org#23150,"KOTA GAJAH, KOTA GAJAH, LAMPUNG TENGAH, LAMPUNG",21,167,58,225
https://kawalpemilu.org#23150,"KOTA GAJAH, KOTA GAJAH, LAMPUNG TENGAH, LAMPUNG",22,151,51,202
https://kawalpemilu.org#23150,"KOTA GAJAH, KOTA GAJAH, LAMPUNG TENGAH, LAMPUNG",23,76,72,148
https://kawalpemilu.org#23150,"KOTA GAJAH, KOTA GAJAH, LAMPUNG TENGAH, LAMPUNG",24,57,83,140
https://kawalpemilu.org#23150,"KOTA GAJAH, KOTA GAJAH, LAMPUNG TENGAH, LAMPUNG",25,118,80,198
https://kawalpemilu.org#84796,"KOTA GAJAH TIMUR, KOTA GAJAH, LAMPUNG TENGAH, LAMPUNG",1,108,49,157
https://kawalpemilu.org#84796,"KOTA GAJAH TIMUR, KOTA GAJAH, LAMPUNG TENGAH, LAMPUNG",2,128,64,192
https://kawalpemilu.org#84796,"KOTA GAJAH TIMUR, KOTA GAJAH, LAMPUNG TENGAH, LAMPUNG",3,82,64,146
https://kawalpemilu.org#84796,"KOTA GAJAH TIMUR, KOTA GAJAH, LAMPUNG TENGAH, LAMPUNG",4,140,59,199
https://kawalpemilu.org#84796,"KOTA GAJAH TIMUR, KOTA GAJAH, LAMPUNG TENGAH, LAMPUNG",5,125,92,217
https://kawalpemilu.org#84796,"KOTA GAJAH TIMUR, KOTA GAJAH, LAMPUNG TENGAH, LAMPUNG",6,113,82,195
https://kawalpemilu.org#84796,"KOTA GAJAH TIMUR, KOTA GAJAH, LAMPUNG TENGAH, LAMPUNG",7,107,79,186
https://kawalpemilu.org#84796,"KOTA GAJAH TIMUR, KOTA GAJAH, LAMPUNG TENGAH, LAMPUNG",8,140,53,193
https://kawalpemilu.org#84796,"KOTA GAJAH TIMUR, KOTA GAJAH, LAMPUNG TENGAH, LAMPUNG",9,169,40,209
https://kawalpemilu.org#84796,"KOTA GAJAH TIMUR, KOTA GAJAH, LAMPUNG TENGAH, LAMPUNG",10,193,58,251
https://kawalpemilu.org#84796,"KOTA GAJAH TIMUR, KOTA GAJAH, LAMPUNG TENGAH, LAMPUNG",11,112,27,139
https://kawalpemilu.org#84796,"KOTA GAJAH TIMUR, KOTA GAJAH, LAMPUNG TENGAH, LAMPUNG",12,141,57,198
https://kawalpemilu.org#84796,"KOTA GAJAH TIMUR, KOTA GAJAH, LAMPUNG TENGAH, LAMPUNG",13,111,29,140
https://kawalpemilu.org#84796,"KOTA GAJAH TIMUR, KOTA GAJAH, LAMPUNG TENGAH, LAMPUNG",14,114,15,129
https://kawalpemilu.org#84796,"KOTA GAJAH TIMUR, KOTA GAJAH, LAMPUNG TENGAH, LAMPUNG",15,155,65,220
https://kawalpemilu.org#84796,"KOTA GAJAH TIMUR, KOTA GAJAH, LAMPUNG TENGAH, LAMPUNG",16,92,34,126
https://kawalpemilu.org#84796,"KOTA GAJAH TIMUR, KOTA GAJAH, LAMPUNG TENGAH, LAMPUNG",17,118,40,158
https://kawalpemilu.org#84796,"KOTA GAJAH TIMUR, KOTA GAJAH, LAMPUNG TENGAH, LAMPUNG",18,106,33,139
https://kawalpemilu.org#84796,"KOTA GAJAH TIMUR, KOTA GAJAH, LAMPUNG TENGAH, LAMPUNG",19,77,47,124
https://kawalpemilu.org#84796,"KOTA GAJAH TIMUR, KOTA GAJAH, LAMPUNG TENGAH, LAMPUNG",20,106,76,182
https://kawalpemilu.org#84796,"KOTA GAJAH TIMUR, KOTA GAJAH, LAMPUNG TENGAH, LAMPUNG",21,90,42,132
https://kawalpemilu.org#84796,"KOTA GAJAH TIMUR, KOTA GAJAH, LAMPUNG TENGAH, LAMPUNG",22,158,40,198
https://kawalpemilu.org#84796,"KOTA GAJAH TIMUR, KOTA GAJAH, LAMPUNG TENGAH, LAMPUNG",23,97,24,121
https://kawalpemilu.org#84796,"KOTA GAJAH TIMUR, KOTA GAJAH, LAMPUNG TENGAH, LAMPUNG",24,93,72,165
https://kawalpemilu.org#84796,"KOTA GAJAH TIMUR, KOTA GAJAH, LAMPUNG TENGAH, LAMPUNG",25,76,22,98
https://kawalpemilu.org#84796,"KOTA GAJAH TIMUR, KOTA GAJAH, LAMPUNG TENGAH, LAMPUNG",26,105,12,117
https://kawalpemilu.org#84796,"KOTA GAJAH TIMUR, KOTA GAJAH, LAMPUNG TENGAH, LAMPUNG",27,185,51,236
https://kawalpemilu.org#23152,"SRI KENCONO, BUMI NABUNG, LAMPUNG TENGAH, LAMPUNG",1,191,31,222
https://kawalpemilu.org#23152,"SRI KENCONO, BUMI NABUNG, LAMPUNG TENGAH, LAMPUNG",2,141,42,183
https://kawalpemilu.org#23152,"SRI KENCONO, BUMI NABUNG, LAMPUNG TENGAH, LAMPUNG",3,161,41,202
https://kawalpemilu.org#23152,"SRI KENCONO, BUMI NABUNG, LAMPUNG TENGAH, LAMPUNG",4,154,35,189
https://kawalpemilu.org#23152,"SRI KENCONO, BUMI NABUNG, LAMPUNG TENGAH, LAMPUNG",5,135,55,190
https://kawalpemilu.org#23152,"SRI KENCONO, BUMI NABUNG, LAMPUNG TENGAH, LAMPUNG",6,145,47,192
https://kawalpemilu.org#23152,"SRI KENCONO, BUMI NABUNG, LAMPUNG TENGAH, LAMPUNG",7,91,34,125
https://kawalpemilu.org#23152,"SRI KENCONO, BUMI NABUNG, LAMPUNG TENGAH, LAMPUNG",8,122,31,153
https://kawalpemilu.org#23152,"SRI KENCONO, BUMI NABUNG, LAMPUNG TENGAH, LAMPUNG",9,133,29,162
https://kawalpemilu.org#23152,"SRI KENCONO, BUMI NABUNG, LAMPUNG TENGAH, LAMPUNG",10,116,17,133
https://kawalpemilu.org#23152,"SRI KENCONO, BUMI NABUNG, LAMPUNG TENGAH, LAMPUNG",11,148,41,189
https://kawalpemilu.org#23152,"SRI KENCONO, BUMI NABUNG, LAMPUNG TENGAH, LAMPUNG",12,123,49,172
https://kawalpemilu.org#23152,"SRI KENCONO, BUMI NABUNG, LAMPUNG TENGAH, LAMPUNG",14,115,12,127
https://kawalpemilu.org#23152,"SRI KENCONO, BUMI NABUNG, LAMPUNG TENGAH, LAMPUNG",15,155,25,180
https://kawalpemilu.org#23152,"SRI KENCONO, BUMI NABUNG, LAMPUNG TENGAH, LAMPUNG",16,109,22,131
https://kawalpemilu.org#23153,"BUMI NABUNG ILIR, BUMI NABUNG, LAMPUNG TENGAH, LAMPUNG",1,33,219,252
https://kawalpemilu.org#23153,"BUMI NABUNG ILIR, BUMI NABUNG, LAMPUNG TENGAH, LAMPUNG",2,46,154,200
https://kawalpemilu.org#23153,"BUMI NABUNG ILIR, BUMI NABUNG, LAMPUNG TENGAH, LAMPUNG",3,147,7,154
https://kawalpemilu.org#23153,"BUMI NABUNG ILIR, BUMI NABUNG, LAMPUNG TENGAH, LAMPUNG",4,113,87,200
https://kawalpemilu.org#23153,"BUMI NABUNG ILIR, BUMI NABUNG, LAMPUNG TENGAH, LAMPUNG",5,73,103,176
https://kawalpemilu.org#23153,"BUMI NABUNG ILIR, BUMI NABUNG, LAMPUNG TENGAH, LAMPUNG",7,170,55,225
https://kawalpemilu.org#23153,"BUMI NABUNG ILIR, BUMI NABUNG, LAMPUNG TENGAH, LAMPUNG",8,136,57,193
https://kawalpemilu.org#23153,"BUMI NABUNG ILIR, BUMI NABUNG, LAMPUNG TENGAH, LAMPUNG",9,141,59,200
https://kawalpemilu.org#23153,"BUMI NABUNG ILIR, BUMI NABUNG, LAMPUNG TENGAH, LAMPUNG",10,178,30,208
https://kawalpemilu.org#23153,"BUMI NABUNG ILIR, BUMI NABUNG, LAMPUNG TENGAH, LAMPUNG",11,142,52,194
https://kawalpemilu.org#23153,"BUMI NABUNG ILIR, BUMI NABUNG, LAMPUNG TENGAH, LAMPUNG",12,188,33,221
https://kawalpemilu.org#23153,"BUMI NABUNG ILIR, BUMI NABUNG, LAMPUNG TENGAH, LAMPUNG",13,127,32,159
https://kawalpemilu.org#23153,"BUMI NABUNG ILIR, BUMI NABUNG, LAMPUNG TENGAH, LAMPUNG",14,156,33,189
https://kawalpemilu.org#23153,"BUMI NABUNG ILIR, BUMI NABUNG, LAMPUNG TENGAH, LAMPUNG",15,161,66,227
https://kawalpemilu.org#23153,"BUMI NABUNG ILIR, BUMI NABUNG, LAMPUNG TENGAH, LAMPUNG",16,96,50,146
https://kawalpemilu.org#23153,"BUMI NABUNG ILIR, BUMI NABUNG, LAMPUNG TENGAH, LAMPUNG",17,148,45,193
https://kawalpemilu.org#23153,"BUMI NABUNG ILIR, BUMI NABUNG, LAMPUNG TENGAH, LAMPUNG",18,137,54,191
https://kawalpemilu.org#23153,"BUMI NABUNG ILIR, BUMI NABUNG, LAMPUNG TENGAH, LAMPUNG",19,119,44,163
https://kawalpemilu.org#23153,"BUMI NABUNG ILIR, BUMI NABUNG, LAMPUNG TENGAH, LAMPUNG",20,190,32,222
https://kawalpemilu.org#23153,"BUMI NABUNG ILIR, BUMI NABUNG, LAMPUNG TENGAH, LAMPUNG",21,112,30,142
https://kawalpemilu.org#23153,"BUMI NABUNG ILIR, BUMI NABUNG, LAMPUNG TENGAH, LAMPUNG",22,120,26,146
https://kawalpemilu.org#23153,"BUMI NABUNG ILIR, BUMI NABUNG, LAMPUNG TENGAH, LAMPUNG",23,142,18,160
https://kawalpemilu.org#23153,"BUMI NABUNG ILIR, BUMI NABUNG, LAMPUNG TENGAH, LAMPUNG",24,86,71,157
https://kawalpemilu.org#23153,"BUMI NABUNG ILIR, BUMI NABUNG, LAMPUNG TENGAH, LAMPUNG",25,120,46,166
https://kawalpemilu.org#23153,"BUMI NABUNG ILIR, BUMI NABUNG, LAMPUNG TENGAH, LAMPUNG",26,122,26,148
https://kawalpemilu.org#23153,"BUMI NABUNG ILIR, BUMI NABUNG, LAMPUNG TENGAH, LAMPUNG",27,37,180,217
https://kawalpemilu.org#23153,"BUMI NABUNG ILIR, BUMI NABUNG, LAMPUNG TENGAH, LAMPUNG",28,126,15,141
https://kawalpemilu.org#23153,"BUMI NABUNG ILIR, BUMI NABUNG, LAMPUNG TENGAH, LAMPUNG",29,58,98,156
https://kawalpemilu.org#23153,"BUMI NABUNG ILIR, BUMI NABUNG, LAMPUNG TENGAH, LAMPUNG",30,173,43,216
https://kawalpemilu.org#23153,"BUMI NABUNG ILIR, BUMI NABUNG, LAMPUNG TENGAH, LAMPUNG",31,164,26,190
https://kawalpemilu.org#23153,"BUMI NABUNG ILIR, BUMI NABUNG, LAMPUNG TENGAH, LAMPUNG",32,165,41,206
https://kawalpemilu.org#23153,"BUMI NABUNG ILIR, BUMI NABUNG, LAMPUNG TENGAH, LAMPUNG",33,95,30,125
https://kawalpemilu.org#23153,"BUMI NABUNG ILIR, BUMI NABUNG, LAMPUNG TENGAH, LAMPUNG",34,138,53,191
https://kawalpemilu.org#23153,"BUMI NABUNG ILIR, BUMI NABUNG, LAMPUNG TENGAH, LAMPUNG",35,119,35,154
https://kawalpemilu.org#23153,"BUMI NABUNG ILIR, BUMI NABUNG, LAMPUNG TENGAH, LAMPUNG",36,112,42,154
https://kawalpemilu.org#23153,"BUMI NABUNG ILIR, BUMI NABUNG, LAMPUNG TENGAH, LAMPUNG",37,147,30,177
https://kawalpemilu.org#23153,"BUMI NABUNG ILIR, BUMI NABUNG, LAMPUNG TENGAH, LAMPUNG",38,98,53,151
https://kawalpemilu.org#23153,"BUMI NABUNG ILIR, BUMI NABUNG, LAMPUNG TENGAH, LAMPUNG",39,114,17,131
https://kawalpemilu.org#23153,"BUMI NABUNG ILIR, BUMI NABUNG, LAMPUNG TENGAH, LAMPUNG",40,139,23,162
https://kawalpemilu.org#23153,"BUMI NABUNG ILIR, BUMI NABUNG, LAMPUNG TENGAH, LAMPUNG",41,87,51,138
https://kawalpemilu.org#23153,"BUMI NABUNG ILIR, BUMI NABUNG, LAMPUNG TENGAH, LAMPUNG",42,92,28,120
https://kawalpemilu.org#23154,"BUMI NABUNG UTARA, BUMI NABUNG, LAMPUNG TENGAH, LAMPUNG",1,111,42,153
https://kawalpemilu.org#23154,"BUMI NABUNG UTARA, BUMI NABUNG, LAMPUNG TENGAH, LAMPUNG",2,179,49,228
https://kawalpemilu.org#23154,"BUMI NABUNG UTARA, BUMI NABUNG, LAMPUNG TENGAH, LAMPUNG",3,82,41,1
https://kawalpemilu.org#23154,"BUMI NABUNG UTARA, BUMI NABUNG, LAMPUNG TENGAH, LAMPUNG",4,97,72,169
https://kawalpemilu.org#23154,"BUMI NABUNG UTARA, BUMI NABUNG, LAMPUNG TENGAH, LAMPUNG",5,78,29,2
https://kawalpemilu.org#23154,"BUMI NABUNG UTARA, BUMI NABUNG, LAMPUNG TENGAH, LAMPUNG",6,91,38,129
https://kawalpemilu.org#23154,"BUMI NABUNG UTARA, BUMI NABUNG, LAMPUNG TENGAH, LAMPUNG",7,105,81,186
https://kawalpemilu.org#23154,"BUMI NABUNG UTARA, BUMI NABUNG, LAMPUNG TENGAH, LAMPUNG",8,115,47,162
https://kawalpemilu.org#23154,"BUMI NABUNG UTARA, BUMI NABUNG, LAMPUNG TENGAH, LAMPUNG",9,88,43,131
https://kawalpemilu.org#23154,"BUMI NABUNG UTARA, BUMI NABUNG, LAMPUNG TENGAH, LAMPUNG",10,92,42,134
https://kawalpemilu.org#23154,"BUMI NABUNG UTARA, BUMI NABUNG, LAMPUNG TENGAH, LAMPUNG",11,137,18,155
https://kawalpemilu.org#23154,"BUMI NABUNG UTARA, BUMI NABUNG, LAMPUNG TENGAH, LAMPUNG",12,75,46,121
https://kawalpemilu.org#23154,"BUMI NABUNG UTARA, BUMI NABUNG, LAMPUNG TENGAH, LAMPUNG",13,133,30,163
https://kawalpemilu.org#23154,"BUMI NABUNG UTARA, BUMI NABUNG, LAMPUNG TENGAH, LAMPUNG",14,113,27,140
https://kawalpemilu.org#23154,"BUMI NABUNG UTARA, BUMI NABUNG, LAMPUNG TENGAH, LAMPUNG",15,99,20,119
https://kawalpemilu.org#23155,"BUMI NABUNG SELATAN, BUMI NABUNG, LAMPUNG TENGAH, LAMPUNG",1,112,17,129
https://kawalpemilu.org#23155,"BUMI NABUNG SELATAN, BUMI NABUNG, LAMPUNG TENGAH, LAMPUNG",2,95,18,113
https://kawalpemilu.org#23155,"BUMI NABUNG SELATAN, BUMI NABUNG, LAMPUNG TENGAH, LAMPUNG",3,100,12,112
https://kawalpemilu.org#23155,"BUMI NABUNG SELATAN, BUMI NABUNG, LAMPUNG TENGAH, LAMPUNG",4,109,19,128
https://kawalpemilu.org#23155,"BUMI NABUNG SELATAN, BUMI NABUNG, LAMPUNG TENGAH, LAMPUNG",5,101,36,137
https://kawalpemilu.org#23155,"BUMI NABUNG SELATAN, BUMI NABUNG, LAMPUNG TENGAH, LAMPUNG",6,103,12,115
https://kawalpemilu.org#23155,"BUMI NABUNG SELATAN, BUMI NABUNG, LAMPUNG TENGAH, LAMPUNG",7,129,11,140
https://kawalpemilu.org#23155,"BUMI NABUNG SELATAN, BUMI NABUNG, LAMPUNG TENGAH, LAMPUNG",8,98,20,118
https://kawalpemilu.org#23155,"BUMI NABUNG SELATAN, BUMI NABUNG, LAMPUNG TENGAH, LAMPUNG",9,96,26,122
https://kawalpemilu.org#23155,"BUMI NABUNG SELATAN, BUMI NABUNG, LAMPUNG TENGAH, LAMPUNG",10,127,13,140
https://kawalpemilu.org#23155,"BUMI NABUNG SELATAN, BUMI NABUNG, LAMPUNG TENGAH, LAMPUNG",11,109,19,128
https://kawalpemilu.org#23155,"BUMI NABUNG SELATAN, BUMI NABUNG, LAMPUNG TENGAH, LAMPUNG",12,103,51,154
https://kawalpemilu.org#23155,"BUMI NABUNG SELATAN, BUMI NABUNG, LAMPUNG TENGAH, LAMPUNG",13,90,54,144
https://kawalpemilu.org#23155,"BUMI NABUNG SELATAN, BUMI NABUNG, LAMPUNG TENGAH, LAMPUNG",14,127,34,161
https://kawalpemilu.org#23155,"BUMI NABUNG SELATAN, BUMI NABUNG, LAMPUNG TENGAH, LAMPUNG",15,96,29,125
https://kawalpemilu.org#23155,"BUMI NABUNG SELATAN, BUMI NABUNG, LAMPUNG TENGAH, LAMPUNG",16,82,58,140
https://kawalpemilu.org#23156,"BUMI NABUNG TIMUR, BUMI NABUNG, LAMPUNG TENGAH, LAMPUNG",1,93,48,141
https://kawalpemilu.org#23156,"BUMI NABUNG TIMUR, BUMI NABUNG, LAMPUNG TENGAH, LAMPUNG",2,125,45,170
https://kawalpemilu.org#23156,"BUMI NABUNG TIMUR, BUMI NABUNG, LAMPUNG TENGAH, LAMPUNG",3,82,111,193
https://kawalpemilu.org#23156,"BUMI NABUNG TIMUR, BUMI NABUNG, LAMPUNG TENGAH, LAMPUNG",4,101,88,189
https://kawalpemilu.org#23156,"BUMI NABUNG TIMUR, BUMI NABUNG, LAMPUNG TENGAH, LAMPUNG",5,124,91,215
https://kawalpemilu.org#23156,"BUMI NABUNG TIMUR, BUMI NABUNG, LAMPUNG TENGAH, LAMPUNG",6,105,112,217
https://kawalpemilu.org#23156,"BUMI NABUNG TIMUR, BUMI NABUNG, LAMPUNG TENGAH, LAMPUNG",7,220,13,233
https://kawalpemilu.org#23156,"BUMI NABUNG TIMUR, BUMI NABUNG, LAMPUNG TENGAH, LAMPUNG",8,152,56,208
https://kawalpemilu.org#23156,"BUMI NABUNG TIMUR, BUMI NABUNG, LAMPUNG TENGAH, LAMPUNG",9,66,132,198
https://kawalpemilu.org#23156,"BUMI NABUNG TIMUR, BUMI NABUNG, LAMPUNG TENGAH, LAMPUNG",10,225,34,259
https://kawalpemilu.org#23156,"BUMI NABUNG TIMUR, BUMI NABUNG, LAMPUNG TENGAH, LAMPUNG",11,87,47,134
https://kawalpemilu.org#23156,"BUMI NABUNG TIMUR, BUMI NABUNG, LAMPUNG TENGAH, LAMPUNG",12,132,21,153
https://kawalpemilu.org#23156,"BUMI NABUNG TIMUR, BUMI NABUNG, LAMPUNG TENGAH, LAMPUNG",13,78,101,179
https://kawalpemilu.org#23156,"BUMI NABUNG TIMUR, BUMI NABUNG, LAMPUNG TENGAH, LAMPUNG",14,77,94,171
https://kawalpemilu.org#23156,"BUMI NABUNG TIMUR, BUMI NABUNG, LAMPUNG TENGAH, LAMPUNG",15,144,34,148
https://kawalpemilu.org#23156,"BUMI NABUNG TIMUR, BUMI NABUNG, LAMPUNG TENGAH, LAMPUNG",16,87,106,193
https://kawalpemilu.org#23157,"BUMI NABUNG BARU, BUMI NABUNG, LAMPUNG TENGAH, LAMPUNG",1,133,46,179
https://kawalpemilu.org#23157,"BUMI NABUNG BARU, BUMI NABUNG, LAMPUNG TENGAH, LAMPUNG",2,119,49,168
https://kawalpemilu.org#23157,"BUMI NABUNG BARU, BUMI NABUNG, LAMPUNG TENGAH, LAMPUNG",3,73,43,116
https://kawalpemilu.org#23157,"BUMI NABUNG BARU, BUMI NABUNG, LAMPUNG TENGAH, LAMPUNG",4,64,44,108
https://kawalpemilu.org#23157,"BUMI NABUNG BARU, BUMI NABUNG, LAMPUNG TENGAH, LAMPUNG",5,62,67,129
https://kawalpemilu.org#23157,"BUMI NABUNG BARU, BUMI NABUNG, LAMPUNG TENGAH, LAMPUNG",6,121,51,172
https://kawalpemilu.org#23157,"BUMI NABUNG BARU, BUMI NABUNG, LAMPUNG TENGAH, LAMPUNG",7,61,36,97
https://kawalpemilu.org#23157,"BUMI NABUNG BARU, BUMI NABUNG, LAMPUNG TENGAH, LAMPUNG",8,89,28,117
https://kawalpemilu.org#23157,"BUMI NABUNG BARU, BUMI NABUNG, LAMPUNG TENGAH, LAMPUNG",9,84,11,95
https://kawalpemilu.org#23157,"BUMI NABUNG BARU, BUMI NABUNG, LAMPUNG TENGAH, LAMPUNG",10,121,20,141
https://kawalpemilu.org#23157,"BUMI NABUNG BARU, BUMI NABUNG, LAMPUNG TENGAH, LAMPUNG",11,98,56,154
https://kawalpemilu.org#23157,"BUMI NABUNG BARU, BUMI NABUNG, LAMPUNG TENGAH, LAMPUNG",12,176,15,191
https://kawalpemilu.org#23157,"BUMI NABUNG BARU, BUMI NABUNG, LAMPUNG TENGAH, LAMPUNG",13,140,17,157
https://kawalpemilu.org#23157,"BUMI NABUNG BARU, BUMI NABUNG, LAMPUNG TENGAH, LAMPUNG",15,147,40,187
https://kawalpemilu.org#928201,"SRI KENCONO BARU, BUMI NABUNG, LAMPUNG TENGAH, LAMPUNG",1,113,67,180
https://kawalpemilu.org#928201,"SRI KENCONO BARU, BUMI NABUNG, LAMPUNG TENGAH, LAMPUNG",2,139,48,187
https://kawalpemilu.org#928201,"SRI KENCONO BARU, BUMI NABUNG, LAMPUNG TENGAH, LAMPUNG",3,130,39,169
https://kawalpemilu.org#928201,"SRI KENCONO BARU, BUMI NABUNG, LAMPUNG TENGAH, LAMPUNG",4,133,58,191
https://kawalpemilu.org#23159,"SIDO BINANGUN, WAY SEPUTIH, LAMPUNG TENGAH, LAMPUNG",1,101,82,183
https://kawalpemilu.org#23159,"SIDO BINANGUN, WAY SEPUTIH, LAMPUNG TENGAH, LAMPUNG",2,117,83,200
https://kawalpemilu.org#23159,"SIDO BINANGUN, WAY SEPUTIH, LAMPUNG TENGAH, LAMPUNG",3,84,88,172
https://kawalpemilu.org#23159,"SIDO BINANGUN, WAY SEPUTIH, LAMPUNG TENGAH, LAMPUNG",4,81,95,176
https://kawalpemilu.org#23159,"SIDO BINANGUN, WAY SEPUTIH, LAMPUNG TENGAH, LAMPUNG",5,101,53,154
https://kawalpemilu.org#23159,"SIDO BINANGUN, WAY SEPUTIH, LAMPUNG TENGAH, LAMPUNG",6,117,88,205
https://kawalpemilu.org#23159,"SIDO BINANGUN, WAY SEPUTIH, LAMPUNG TENGAH, LAMPUNG",7,125,88,213
https://kawalpemilu.org#23159,"SIDO BINANGUN, WAY SEPUTIH, LAMPUNG TENGAH, LAMPUNG",8,148,40,188
https://kawalpemilu.org#23159,"SIDO BINANGUN, WAY SEPUTIH, LAMPUNG TENGAH, LAMPUNG",9,110,68,178
https://kawalpemilu.org#23159,"SIDO BINANGUN, WAY SEPUTIH, LAMPUNG TENGAH, LAMPUNG",10,105,73,178
https://kawalpemilu.org#23159,"SIDO BINANGUN, WAY SEPUTIH, LAMPUNG TENGAH, LAMPUNG",11,134,61,195
https://kawalpemilu.org#23159,"SIDO BINANGUN, WAY SEPUTIH, LAMPUNG TENGAH, LAMPUNG",12,98,67,165
https://kawalpemilu.org#23159,"SIDO BINANGUN, WAY SEPUTIH, LAMPUNG TENGAH, LAMPUNG",13,94,59,153
https://kawalpemilu.org#23159,"SIDO BINANGUN, WAY SEPUTIH, LAMPUNG TENGAH, LAMPUNG",14,107,85,192
https://kawalpemilu.org#23159,"SIDO BINANGUN, WAY SEPUTIH, LAMPUNG TENGAH, LAMPUNG",15,110,54,164
https://kawalpemilu.org#23160,"SRIBAWONO, WAY SEPUTIH, LAMPUNG TENGAH, LAMPUNG",1,129,41,170
https://kawalpemilu.org#23160,"SRIBAWONO, WAY SEPUTIH, LAMPUNG TENGAH, LAMPUNG",2,116,26,142
https://kawalpemilu.org#23160,"SRIBAWONO, WAY SEPUTIH, LAMPUNG TENGAH, LAMPUNG",3,136,60,196
https://kawalpemilu.org#23160,"SRIBAWONO, WAY SEPUTIH, LAMPUNG TENGAH, LAMPUNG",4,105,63,168
https://kawalpemilu.org#23160,"SRIBAWONO, WAY SEPUTIH, LAMPUNG TENGAH, LAMPUNG",5,141,43,184
https://kawalpemilu.org#23160,"SRIBAWONO, WAY SEPUTIH, LAMPUNG TENGAH, LAMPUNG",6,150,28,178
https://kawalpemilu.org#23160,"SRIBAWONO, WAY SEPUTIH, LAMPUNG TENGAH, LAMPUNG",7,158,31,189
https://kawalpemilu.org#23160,"SRIBAWONO, WAY SEPUTIH, LAMPUNG TENGAH, LAMPUNG",8,92,40,132
https://kawalpemilu.org#23160,"SRIBAWONO, WAY SEPUTIH, LAMPUNG TENGAH, LAMPUNG",9,102,29,131
https://kawalpemilu.org#23160,"SRIBAWONO, WAY SEPUTIH, LAMPUNG TENGAH, LAMPUNG",10,84,19,103
https://kawalpemilu.org#23160,"SRIBAWONO, WAY SEPUTIH, LAMPUNG TENGAH, LAMPUNG",11,87,63,150
https://kawalpemilu.org#23160,"SRIBAWONO, WAY SEPUTIH, LAMPUNG TENGAH, LAMPUNG",12,115,63,178
https://kawalpemilu.org#23161,"SRIBUDAYA, WAY SEPUTIH, LAMPUNG TENGAH, LAMPUNG",1,128,55,183
https://kawalpemilu.org#23161,"SRIBUDAYA, WAY SEPUTIH, LAMPUNG TENGAH, LAMPUNG",2,126,56,182
https://kawalpemilu.org#23161,"SRIBUDAYA, WAY SEPUTIH, LAMPUNG TENGAH, LAMPUNG",3,125,46,171
https://kawalpemilu.org#23161,"SRIBUDAYA, WAY SEPUTIH, LAMPUNG TENGAH, LAMPUNG",4,148,46,194
https://kawalpemilu.org#23161,"SRIBUDAYA, WAY SEPUTIH, LAMPUNG TENGAH, LAMPUNG",5,122,62,184
https://kawalpemilu.org#23161,"SRIBUDAYA, WAY SEPUTIH, LAMPUNG TENGAH, LAMPUNG",6,159,36,195
https://kawalpemilu.org#23161,"SRIBUDAYA, WAY SEPUTIH, LAMPUNG TENGAH, LAMPUNG",7,124,71,195
https://kawalpemilu.org#23161,"SRIBUDAYA, WAY SEPUTIH, LAMPUNG TENGAH, LAMPUNG",8,133,52,185
https://kawalpemilu.org#23161,"SRIBUDAYA, WAY SEPUTIH, LAMPUNG TENGAH, LAMPUNG",9,95,64,159
https://kawalpemilu.org#23161,"SRIBUDAYA, WAY SEPUTIH, LAMPUNG TENGAH, LAMPUNG",10,126,33,159
https://kawalpemilu.org#23161,"SRIBUDAYA, WAY SEPUTIH, LAMPUNG TENGAH, LAMPUNG",11,115,41,156
https://kawalpemilu.org#23162,"SUKO BINANGUN, WAY SEPUTIH, LAMPUNG TENGAH, LAMPUNG",1,150,77,227
https://kawalpemilu.org#23162,"SUKO BINANGUN, WAY SEPUTIH, LAMPUNG TENGAH, LAMPUNG",2,161,57,218
https://kawalpemilu.org#23162,"SUKO BINANGUN, WAY SEPUTIH, LAMPUNG TENGAH, LAMPUNG",3,163,62,225
https://kawalpemilu.org#23162,"SUKO BINANGUN, WAY SEPUTIH, LAMPUNG TENGAH, LAMPUNG",4,125,79,204
https://kawalpemilu.org#23162,"SUKO BINANGUN, WAY SEPUTIH, LAMPUNG TENGAH, LAMPUNG",6,109,86,195
https://kawalpemilu.org#23162,"SUKO BINANGUN, WAY SEPUTIH, LAMPUNG TENGAH, LAMPUNG",7,132,80,212
https://kawalpemilu.org#23162,"SUKO BINANGUN, WAY SEPUTIH, LAMPUNG TENGAH, LAMPUNG",8,137,79,216
https://kawalpemilu.org#23163,"SRI BUSONO, WAY SEPUTIH, LAMPUNG TENGAH, LAMPUNG",1,144,21,165
https://kawalpemilu.org#23163,"SRI BUSONO, WAY SEPUTIH, LAMPUNG TENGAH, LAMPUNG",2,164,33,197
https://kawalpemilu.org#23163,"SRI BUSONO, WAY SEPUTIH, LAMPUNG TENGAH, LAMPUNG",3,145,31,176
https://kawalpemilu.org#23163,"SRI BUSONO, WAY SEPUTIH, LAMPUNG TENGAH, LAMPUNG",4,164,52,166
https://kawalpemilu.org#23163,"SRI BUSONO, WAY SEPUTIH, LAMPUNG TENGAH, LAMPUNG",5,151,35,186
https://kawalpemilu.org#23163,"SRI BUSONO, WAY SEPUTIH, LAMPUNG TENGAH, LAMPUNG",6,125,51,176
https://kawalpemilu.org#23163,"SRI BUSONO, WAY SEPUTIH, LAMPUNG TENGAH, LAMPUNG",7,119,88,207
https://kawalpemilu.org#23163,"SRI BUSONO, WAY SEPUTIH, LAMPUNG TENGAH, LAMPUNG",8,147,54,201
https://kawalpemilu.org#23163,"SRI BUSONO, WAY SEPUTIH, LAMPUNG TENGAH, LAMPUNG",9,163,40,203
https://kawalpemilu.org#23163,"SRI BUSONO, WAY SEPUTIH, LAMPUNG TENGAH, LAMPUNG",10,151,48,199
https://kawalpemilu.org#23164,"SANGGA BUANA, WAY SEPUTIH, LAMPUNG TENGAH, LAMPUNG",1,167,55,222
https://kawalpemilu.org#23164,"SANGGA BUANA, WAY SEPUTIH, LAMPUNG TENGAH, LAMPUNG",2,133,43,176
https://kawalpemilu.org#23164,"SANGGA BUANA, WAY SEPUTIH, LAMPUNG TENGAH, LAMPUNG",3,154,47,201
https://kawalpemilu.org#23164,"SANGGA BUANA, WAY SEPUTIH, LAMPUNG TENGAH, LAMPUNG",4,163,36,199
https://kawalpemilu.org#23164,"SANGGA BUANA, WAY SEPUTIH, LAMPUNG TENGAH, LAMPUNG",5,137,44,181
https://kawalpemilu.org#23164,"SANGGA BUANA, WAY SEPUTIH, LAMPUNG TENGAH, LAMPUNG",6,110,33,143
https://kawalpemilu.org#23164,"SANGGA BUANA, WAY SEPUTIH, LAMPUNG TENGAH, LAMPUNG",7,120,22,142
https://kawalpemilu.org#23166,"GAYA BARU LIMA, BANDAR SURABAYA, LAMPUNG TENGAH, LAMPUNG",1,181,19,200
https://kawalpemilu.org#23166,"GAYA BARU LIMA, BANDAR SURABAYA, LAMPUNG TENGAH, LAMPUNG",2,190,34,224
https://kawalpemilu.org#23166,"GAYA BARU LIMA, BANDAR SURABAYA, LAMPUNG TENGAH, LAMPUNG",3,138,38,176
https://kawalpemilu.org#23166,"GAYA BARU LIMA, BANDAR SURABAYA, LAMPUNG TENGAH, LAMPUNG",4,169,27,196
https://kawalpemilu.org#23166,"GAYA BARU LIMA, BANDAR SURABAYA, LAMPUNG TENGAH, LAMPUNG",5,217,15,232
https://kawalpemilu.org#23166,"GAYA BARU LIMA, BANDAR SURABAYA, LAMPUNG TENGAH, LAMPUNG",6,172,22,194
https://kawalpemilu.org#23166,"GAYA BARU LIMA, BANDAR SURABAYA, LAMPUNG TENGAH, LAMPUNG",7,150,55,205
https://kawalpemilu.org#23166,"GAYA BARU LIMA, BANDAR SURABAYA, LAMPUNG TENGAH, LAMPUNG",8,171,23,194
https://kawalpemilu.org#23166,"GAYA BARU LIMA, BANDAR SURABAYA, LAMPUNG TENGAH, LAMPUNG",9,200,19,219
https://kawalpemilu.org#23166,"GAYA BARU LIMA, BANDAR SURABAYA, LAMPUNG TENGAH, LAMPUNG",10,155,21,176
https://kawalpemilu.org#23166,"GAYA BARU LIMA, BANDAR SURABAYA, LAMPUNG TENGAH, LAMPUNG",11,108,31,139
https://kawalpemilu.org#23166,"GAYA BARU LIMA, BANDAR SURABAYA, LAMPUNG TENGAH, LAMPUNG",12,98,27,125
https://kawalpemilu.org#23166,"GAYA BARU LIMA, BANDAR SURABAYA, LAMPUNG TENGAH, LAMPUNG",13,138,15,153
https://kawalpemilu.org#23166,"GAYA BARU LIMA, BANDAR SURABAYA, LAMPUNG TENGAH, LAMPUNG",14,97,44,141
https://kawalpemilu.org#23166,"GAYA BARU LIMA, BANDAR SURABAYA, LAMPUNG TENGAH, LAMPUNG",15,100,22,122
https://kawalpemilu.org#23166,"GAYA BARU LIMA, BANDAR SURABAYA, LAMPUNG TENGAH, LAMPUNG",16,128,22,150
https://kawalpemilu.org#23167,"SURABAYA ILIR, BANDAR SURABAYA, LAMPUNG TENGAH, LAMPUNG",1,157,63,220
https://kawalpemilu.org#23167,"SURABAYA ILIR, BANDAR SURABAYA, LAMPUNG TENGAH, LAMPUNG",2,140,81,221
https://kawalpemilu.org#23167,"SURABAYA ILIR, BANDAR SURABAYA, LAMPUNG TENGAH, LAMPUNG",3,117,62,179
https://kawalpemilu.org#23167,"SURABAYA ILIR, BANDAR SURABAYA, LAMPUNG TENGAH, LAMPUNG",4,43,118,161
https://kawalpemilu.org#23167,"SURABAYA ILIR, BANDAR SURABAYA, LAMPUNG TENGAH, LAMPUNG",5,27,132,159
https://kawalpemilu.org#23167,"SURABAYA ILIR, BANDAR SURABAYA, LAMPUNG TENGAH, LAMPUNG",6,61,88,149
https://kawalpemilu.org#23167,"SURABAYA ILIR, BANDAR SURABAYA, LAMPUNG TENGAH, LAMPUNG",7,94,70,164
https://kawalpemilu.org#23167,"SURABAYA ILIR, BANDAR SURABAYA, LAMPUNG TENGAH, LAMPUNG",8,116,57,173
https://kawalpemilu.org#23167,"SURABAYA ILIR, BANDAR SURABAYA, LAMPUNG TENGAH, LAMPUNG",9,134,71,205
https://kawalpemilu.org#23167,"SURABAYA ILIR, BANDAR SURABAYA, LAMPUNG TENGAH, LAMPUNG",10,131,51,182
https://kawalpemilu.org#23167,"SURABAYA ILIR, BANDAR SURABAYA, LAMPUNG TENGAH, LAMPUNG",11,96,71,167
https://kawalpemilu.org#23167,"SURABAYA ILIR, BANDAR SURABAYA, LAMPUNG TENGAH, LAMPUNG",12,127,81,208
https://kawalpemilu.org#23167,"SURABAYA ILIR, BANDAR SURABAYA, LAMPUNG TENGAH, LAMPUNG",13,137,27,164
https://kawalpemilu.org#23167,"SURABAYA ILIR, BANDAR SURABAYA, LAMPUNG TENGAH, LAMPUNG",14,160,28,188
https://kawalpemilu.org#23167,"SURABAYA ILIR, BANDAR SURABAYA, LAMPUNG TENGAH, LAMPUNG",15,142,75,217
https://kawalpemilu.org#23167,"SURABAYA ILIR, BANDAR SURABAYA, LAMPUNG TENGAH, LAMPUNG",16,126,65,191
https://kawalpemilu.org#23167,"SURABAYA ILIR, BANDAR SURABAYA, LAMPUNG TENGAH, LAMPUNG",17,159,29,188
https://kawalpemilu.org#23167,"SURABAYA ILIR, BANDAR SURABAYA, LAMPUNG TENGAH, LAMPUNG",18,71,4,75
https://kawalpemilu.org#23168,"RAJA WALI, BANDAR SURABAYA, LAMPUNG TENGAH, LAMPUNG",1,176,7,183
https://kawalpemilu.org#23168,"RAJA WALI, BANDAR SURABAYA, LAMPUNG TENGAH, LAMPUNG",2,168,11,179
https://kawalpemilu.org#23168,"RAJA WALI, BANDAR SURABAYA, LAMPUNG TENGAH, LAMPUNG",3,159,10,169
https://kawalpemilu.org#23168,"RAJA WALI, BANDAR SURABAYA, LAMPUNG TENGAH, LAMPUNG",4,174,6,180
https://kawalpemilu.org#23168,"RAJA WALI, BANDAR SURABAYA, LAMPUNG TENGAH, LAMPUNG",5,143,47,190
https://kawalpemilu.org#23168,"RAJA WALI, BANDAR SURABAYA, LAMPUNG TENGAH, LAMPUNG",6,132,23,155
https://kawalpemilu.org#23168,"RAJA WALI, BANDAR SURABAYA, LAMPUNG TENGAH, LAMPUNG",7,145,13,158
https://kawalpemilu.org#23168,"RAJA WALI, BANDAR SURABAYA, LAMPUNG TENGAH, LAMPUNG",8,134,15,149
https://kawalpemilu.org#23168,"RAJA WALI, BANDAR SURABAYA, LAMPUNG TENGAH, LAMPUNG",9,140,14,154
https://kawalpemilu.org#23168,"RAJA WALI, BANDAR SURABAYA, LAMPUNG TENGAH, LAMPUNG",10,158,18,176
https://kawalpemilu.org#23168,"RAJA WALI, BANDAR SURABAYA, LAMPUNG TENGAH, LAMPUNG",11,154,19,173
https://kawalpemilu.org#23169,"CEMPAKA PUTIH, BANDAR SURABAYA, LAMPUNG TENGAH, LAMPUNG",1,154,46,200
https://kawalpemilu.org#23169,"CEMPAKA PUTIH, BANDAR SURABAYA, LAMPUNG TENGAH, LAMPUNG",2,137,33,170
https://kawalpemilu.org#23169,"CEMPAKA PUTIH, BANDAR SURABAYA, LAMPUNG TENGAH, LAMPUNG",3,178,16,194
https://kawalpemilu.org#23169,"CEMPAKA PUTIH, BANDAR SURABAYA, LAMPUNG TENGAH, LAMPUNG",4,148,19,167
https://kawalpemilu.org#23169,"CEMPAKA PUTIH, BANDAR SURABAYA, LAMPUNG TENGAH, LAMPUNG",5,191,20,211
https://kawalpemilu.org#23169,"CEMPAKA PUTIH, BANDAR SURABAYA, LAMPUNG TENGAH, LAMPUNG",6,188,30,218
https://kawalpemilu.org#23169,"CEMPAKA PUTIH, BANDAR SURABAYA, LAMPUNG TENGAH, LAMPUNG",7,165,14,179
https://kawalpemilu.org#23169,"CEMPAKA PUTIH, BANDAR SURABAYA, LAMPUNG TENGAH, LAMPUNG",8,185,2,187
https://kawalpemilu.org#23169,"CEMPAKA PUTIH, BANDAR SURABAYA, LAMPUNG TENGAH, LAMPUNG",9,118,3,121
https://kawalpemilu.org#23169,"CEMPAKA PUTIH, BANDAR SURABAYA, LAMPUNG TENGAH, LAMPUNG",10,174,1,175
https://kawalpemilu.org#23170,"SUBANG JAYA, BANDAR SURABAYA, LAMPUNG TENGAH, LAMPUNG",1,120,66,186
https://kawalpemilu.org#23170,"SUBANG JAYA, BANDAR SURABAYA, LAMPUNG TENGAH, LAMPUNG",2,66,122,186
https://kawalpemilu.org#23170,"SUBANG JAYA, BANDAR SURABAYA, LAMPUNG TENGAH, LAMPUNG",3,50,78,128
https://kawalpemilu.org#23170,"SUBANG JAYA, BANDAR SURABAYA, LAMPUNG TENGAH, LAMPUNG",4,80,105,185
https://kawalpemilu.org#23170,"SUBANG JAYA, BANDAR SURABAYA, LAMPUNG TENGAH, LAMPUNG",5,60,118,178
https://kawalpemilu.org#23170,"SUBANG JAYA, BANDAR SURABAYA, LAMPUNG TENGAH, LAMPUNG",6,90,94,184
https://kawalpemilu.org#23170,"SUBANG JAYA, BANDAR SURABAYA, LAMPUNG TENGAH, LAMPUNG",7,63,121,184
https://kawalpemilu.org#23170,"SUBANG JAYA, BANDAR SURABAYA, LAMPUNG TENGAH, LAMPUNG",8,111,70,181
https://kawalpemilu.org#23171,"CABANG, BANDAR SURABAYA, LAMPUNG TENGAH, LAMPUNG",1,92,22,114
https://kawalpemilu.org#23171,"CABANG, BANDAR SURABAYA, LAMPUNG TENGAH, LAMPUNG",2,129,53,182
https://kawalpemilu.org#23171,"CABANG, BANDAR SURABAYA, LAMPUNG TENGAH, LAMPUNG",3,106,12,118
https://kawalpemilu.org#23171,"CABANG, BANDAR SURABAYA, LAMPUNG TENGAH, LAMPUNG",4,153,35,188
https://kawalpemilu.org#23171,"CABANG, BANDAR SURABAYA, LAMPUNG TENGAH, LAMPUNG",5,106,24,130
https://kawalpemilu.org#23172,"BERINGIN JAYA, BANDAR SURABAYA, LAMPUNG TENGAH, LAMPUNG",1,143,39,182
https://kawalpemilu.org#23172,"BERINGIN JAYA, BANDAR SURABAYA, LAMPUNG TENGAH, LAMPUNG",2,173,21,194
https://kawalpemilu.org#23172,"BERINGIN JAYA, BANDAR SURABAYA, LAMPUNG TENGAH, LAMPUNG",3,125,26,151
https://kawalpemilu.org#23172,"BERINGIN JAYA, BANDAR SURABAYA, LAMPUNG TENGAH, LAMPUNG",4,180,27,207
https://kawalpemilu.org#23172,"BERINGIN JAYA, BANDAR SURABAYA, LAMPUNG TENGAH, LAMPUNG",5,158,35,193
https://kawalpemilu.org#23172,"BERINGIN JAYA, BANDAR SURABAYA, LAMPUNG TENGAH, LAMPUNG",6,141,35,176
https://kawalpemilu.org#23173,"SIDO DADI, BANDAR SURABAYA, LAMPUNG TENGAH, LAMPUNG",1,91,38,129
https://kawalpemilu.org#23173,"SIDO DADI, BANDAR SURABAYA, LAMPUNG TENGAH, LAMPUNG",2,171,19,190
https://kawalpemilu.org#23173,"SIDO DADI, BANDAR SURABAYA, LAMPUNG TENGAH, LAMPUNG",3,124,23,147
https://kawalpemilu.org#23173,"SIDO DADI, BANDAR SURABAYA, LAMPUNG TENGAH, LAMPUNG",4,88,81,169
https://kawalpemilu.org#23173,"SIDO DADI, BANDAR SURABAYA, LAMPUNG TENGAH, LAMPUNG",5,140,23,163
https://kawalpemilu.org#23173,"SIDO DADI, BANDAR SURABAYA, LAMPUNG TENGAH, LAMPUNG",6,170,27,197
https://kawalpemilu.org#23173,"SIDO DADI, BANDAR SURABAYA, LAMPUNG TENGAH, LAMPUNG",7,158,24,182
https://kawalpemilu.org#23173,"SIDO DADI, BANDAR SURABAYA, LAMPUNG TENGAH, LAMPUNG",8,139,36,175
https://kawalpemilu.org#23173,"SIDO DADI, BANDAR SURABAYA, LAMPUNG TENGAH, LAMPUNG",9,162,15,177
https://kawalpemilu.org#23173,"SIDO DADI, BANDAR SURABAYA, LAMPUNG TENGAH, LAMPUNG",10,148,15,163
https://kawalpemilu.org#23173,"SIDO DADI, BANDAR SURABAYA, LAMPUNG TENGAH, LAMPUNG",11,138,52,190
https://kawalpemilu.org#23173,"SIDO DADI, BANDAR SURABAYA, LAMPUNG TENGAH, LAMPUNG",12,159,17,176
https://kawalpemilu.org#23173,"SIDO DADI, BANDAR SURABAYA, LAMPUNG TENGAH, LAMPUNG",13,158,58,216
https://kawalpemilu.org#23173,"SIDO DADI, BANDAR SURABAYA, LAMPUNG TENGAH, LAMPUNG",14,156,10,166
https://kawalpemilu.org#23173,"SIDO DADI, BANDAR SURABAYA, LAMPUNG TENGAH, LAMPUNG",15,161,15,176
https://kawalpemilu.org#23173,"SIDO DADI, BANDAR SURABAYA, LAMPUNG TENGAH, LAMPUNG",16,159,19,178
https://kawalpemilu.org#23173,"SIDO DADI, BANDAR SURABAYA, LAMPUNG TENGAH, LAMPUNG",17,132,47,179
https://kawalpemilu.org#23173,"SIDO DADI, BANDAR SURABAYA, LAMPUNG TENGAH, LAMPUNG",18,118,51,169
https://kawalpemilu.org#23173,"SIDO DADI, BANDAR SURABAYA, LAMPUNG TENGAH, LAMPUNG",19,134,23,157
https://kawalpemilu.org#23173,"SIDO DADI, BANDAR SURABAYA, LAMPUNG TENGAH, LAMPUNG",20,136,3,139
https://kawalpemilu.org#23174,"SUMBER AGUNG, BANDAR SURABAYA, LAMPUNG TENGAH, LAMPUNG",1,121,37,158
https://kawalpemilu.org#23174,"SUMBER AGUNG, BANDAR SURABAYA, LAMPUNG TENGAH, LAMPUNG",2,137,15,152
https://kawalpemilu.org#23174,"SUMBER AGUNG, BANDAR SURABAYA, LAMPUNG TENGAH, LAMPUNG",3,108,26,134
https://kawalpemilu.org#23174,"SUMBER AGUNG, BANDAR SURABAYA, LAMPUNG TENGAH, LAMPUNG",4,129,31,160
https://kawalpemilu.org#23174,"SUMBER AGUNG, BANDAR SURABAYA, LAMPUNG TENGAH, LAMPUNG",5,130,18,148
https://kawalpemilu.org#23174,"SUMBER AGUNG, BANDAR SURABAYA, LAMPUNG TENGAH, LAMPUNG",6,143,20,163
https://kawalpemilu.org#23174,"SUMBER AGUNG, BANDAR SURABAYA, LAMPUNG TENGAH, LAMPUNG",7,141,33,174
https://kawalpemilu.org#23174,"SUMBER AGUNG, BANDAR SURABAYA, LAMPUNG TENGAH, LAMPUNG",8,134,28,162
https://kawalpemilu.org#23174,"SUMBER AGUNG, BANDAR SURABAYA, LAMPUNG TENGAH, LAMPUNG",9,127,14,141
https://kawalpemilu.org#23174,"SUMBER AGUNG, BANDAR SURABAYA, LAMPUNG TENGAH, LAMPUNG",10,109,33,142
https://kawalpemilu.org#23174,"SUMBER AGUNG, BANDAR SURABAYA, LAMPUNG TENGAH, LAMPUNG",11,119,37,156
https://kawalpemilu.org#23174,"SUMBER AGUNG, BANDAR SURABAYA, LAMPUNG TENGAH, LAMPUNG",12,135,11,146
https://kawalpemilu.org#23174,"SUMBER AGUNG, BANDAR SURABAYA, LAMPUNG TENGAH, LAMPUNG",13,173,18,191
https://kawalpemilu.org#84797,"SURABAYA BARU, BANDAR SURABAYA, LAMPUNG TENGAH, LAMPUNG",1,161,56,217
https://kawalpemilu.org#84797,"SURABAYA BARU, BANDAR SURABAYA, LAMPUNG TENGAH, LAMPUNG",2,82,38,120
https://kawalpemilu.org#84797,"SURABAYA BARU, BANDAR SURABAYA, LAMPUNG TENGAH, LAMPUNG",3,137,44,181
https://kawalpemilu.org#84797,"SURABAYA BARU, BANDAR SURABAYA, LAMPUNG TENGAH, LAMPUNG",4,135,70,205
https://kawalpemilu.org#84797,"SURABAYA BARU, BANDAR SURABAYA, LAMPUNG TENGAH, LAMPUNG",5,116,41,157
https://kawalpemilu.org#84797,"SURABAYA BARU, BANDAR SURABAYA, LAMPUNG TENGAH, LAMPUNG",6,131,36,167
https://kawalpemilu.org#23176,"GEDUNG SARI, ANAK RATU AJI, LAMPUNG TENGAH, LAMPUNG",1,91,156,247
https://kawalpemilu.org#23176,"GEDUNG SARI, ANAK RATU AJI, LAMPUNG TENGAH, LAMPUNG",2,163,101,264
https://kawalpemilu.org#23176,"GEDUNG SARI, ANAK RATU AJI, LAMPUNG TENGAH, LAMPUNG",3,128,108,236
https://kawalpemilu.org#23176,"GEDUNG SARI, ANAK RATU AJI, LAMPUNG TENGAH, LAMPUNG",4,119,116,235
https://kawalpemilu.org#23176,"GEDUNG SARI, ANAK RATU AJI, LAMPUNG TENGAH, LAMPUNG",5,203,48,251
https://kawalpemilu.org#23176,"GEDUNG SARI, ANAK RATU AJI, LAMPUNG TENGAH, LAMPUNG",6,144,123,267
https://kawalpemilu.org#23176,"GEDUNG SARI, ANAK RATU AJI, LAMPUNG TENGAH, LAMPUNG",7,111,27,138
https://kawalpemilu.org#23176,"GEDUNG SARI, ANAK RATU AJI, LAMPUNG TENGAH, LAMPUNG",8,114,134,248
https://kawalpemilu.org#23177,"SRI MULYO, ANAK RATU AJI, LAMPUNG TENGAH, LAMPUNG",1,128,69,197
https://kawalpemilu.org#23177,"SRI MULYO, ANAK RATU AJI, LAMPUNG TENGAH, LAMPUNG",2,97,93,190
https://kawalpemilu.org#23177,"SRI MULYO, ANAK RATU AJI, LAMPUNG TENGAH, LAMPUNG",3,118,100,218
https://kawalpemilu.org#23177,"SRI MULYO, ANAK RATU AJI, LAMPUNG TENGAH, LAMPUNG",4,122,76,198
https://kawalpemilu.org#23177,"SRI MULYO, ANAK RATU AJI, LAMPUNG TENGAH, LAMPUNG",5,154,43,197
https://kawalpemilu.org#23177,"SRI MULYO, ANAK RATU AJI, LAMPUNG TENGAH, LAMPUNG",6,107,51,158
https://kawalpemilu.org#23177,"SRI MULYO, ANAK RATU AJI, LAMPUNG TENGAH, LAMPUNG",7,82,84,166
https://kawalpemilu.org#23177,"SRI MULYO, ANAK RATU AJI, LAMPUNG TENGAH, LAMPUNG",8,57,107,164
https://kawalpemilu.org#23177,"SRI MULYO, ANAK RATU AJI, LAMPUNG TENGAH, LAMPUNG",9,130,77,207
https://kawalpemilu.org#23177,"SRI MULYO, ANAK RATU AJI, LAMPUNG TENGAH, LAMPUNG",10,110,58,168
https://kawalpemilu.org#23177,"SRI MULYO, ANAK RATU AJI, LAMPUNG TENGAH, LAMPUNG",11,95,74,169
https://kawalpemilu.org#23178,"GEDUNG RATU, ANAK RATU AJI, LAMPUNG TENGAH, LAMPUNG",1,86,71,157
https://kawalpemilu.org#23178,"GEDUNG RATU, ANAK RATU AJI, LAMPUNG TENGAH, LAMPUNG",2,116,88,204
https://kawalpemilu.org#23178,"GEDUNG RATU, ANAK RATU AJI, LAMPUNG TENGAH, LAMPUNG",3,156,48,204
https://kawalpemilu.org#23178,"GEDUNG RATU, ANAK RATU AJI, LAMPUNG TENGAH, LAMPUNG",4,124,83,207
https://kawalpemilu.org#23179,"BANDAR PUTIH TUA, ANAK RATU AJI, LAMPUNG TENGAH, LAMPUNG",1,97,76,173
https://kawalpemilu.org#23179,"BANDAR PUTIH TUA, ANAK RATU AJI, LAMPUNG TENGAH, LAMPUNG",2,118,116,234
https://kawalpemilu.org#23179,"BANDAR PUTIH TUA, ANAK RATU AJI, LAMPUNG TENGAH, LAMPUNG",3,58,70,128
https://kawalpemilu.org#23179,"BANDAR PUTIH TUA, ANAK RATU AJI, LAMPUNG TENGAH, LAMPUNG",4,33,65,98
https://kawalpemilu.org#23179,"BANDAR PUTIH TUA, ANAK RATU AJI, LAMPUNG TENGAH, LAMPUNG",5,146,65,211
https://kawalpemilu.org#23179,"BANDAR PUTIH TUA, ANAK RATU AJI, LAMPUNG TENGAH, LAMPUNG",6,102,43,145
https://kawalpemilu.org#23180,"KARANG JAWA, ANAK RATU AJI, LAMPUNG TENGAH, LAMPUNG",1,109,95,204
https://kawalpemilu.org#23180,"KARANG JAWA, ANAK RATU AJI, LAMPUNG TENGAH, LAMPUNG",2,84,116,200
https://kawalpemilu.org#23180,"KARANG JAWA, ANAK RATU AJI, LAMPUNG TENGAH, LAMPUNG",3,160,127,287
https://kawalpemilu.org#23180,"KARANG JAWA, ANAK RATU AJI, LAMPUNG TENGAH, LAMPUNG",4,133,97,230
https://kawalpemilu.org#23180,"KARANG JAWA, ANAK RATU AJI, LAMPUNG TENGAH, LAMPUNG",5,106,54,160
https://kawalpemilu.org#23180,"KARANG JAWA, ANAK RATU AJI, LAMPUNG TENGAH, LAMPUNG",6,88,93,181
https://kawalpemilu.org#23180,"KARANG JAWA, ANAK RATU AJI, LAMPUNG TENGAH, LAMPUNG",7,103,70,173
https://kawalpemilu.org#23180,"KARANG JAWA, ANAK RATU AJI, LAMPUNG TENGAH, LAMPUNG",8,56,112,168
https://kawalpemilu.org#23180,"KARANG JAWA, ANAK RATU AJI, LAMPUNG TENGAH, LAMPUNG",9,90,73,163
https://kawalpemilu.org#23180,"KARANG JAWA, ANAK RATU AJI, LAMPUNG TENGAH, LAMPUNG",10,63,61,124
https://kawalpemilu.org#23180,"KARANG JAWA, ANAK RATU AJI, LAMPUNG TENGAH, LAMPUNG",11,62,88,150
https://kawalpemilu.org#23181,"SUKAJAYA, ANAK RATU AJI, LAMPUNG TENGAH, LAMPUNG",1,187,41,228
https://kawalpemilu.org#23181,"SUKAJAYA, ANAK RATU AJI, LAMPUNG TENGAH, LAMPUNG",2,142,71,213
https://kawalpemilu.org#23181,"SUKAJAYA, ANAK RATU AJI, LAMPUNG TENGAH, LAMPUNG",3,149,79,228
https://kawalpemilu.org#23181,"SUKAJAYA, ANAK RATU AJI, LAMPUNG TENGAH, LAMPUNG",4,84,115,199
https://kawalpemilu.org#23181,"SUKAJAYA, ANAK RATU AJI, LAMPUNG TENGAH, LAMPUNG",5,92,124,216
https://kawalpemilu.org#23181,"SUKAJAYA, ANAK RATU AJI, LAMPUNG TENGAH, LAMPUNG",6,136,74,210
https://kawalpemilu.org#23181,"SUKAJAYA, ANAK RATU AJI, LAMPUNG TENGAH, LAMPUNG",7,99,84,183
https://kawalpemilu.org#23181,"SUKAJAYA, ANAK RATU AJI, LAMPUNG TENGAH, LAMPUNG",8,78,52,130
https://kawalpemilu.org#23181,"SUKAJAYA, ANAK RATU AJI, LAMPUNG TENGAH, LAMPUNG",9,81,120,201
https://kawalpemilu.org#23183,"RANTAU JAYA ILIR, PUTRA RUMBIA, LAMPUNG TENGAH, LAMPUNG",2,150,38,188
https://kawalpemilu.org#23183,"RANTAU JAYA ILIR, PUTRA RUMBIA, LAMPUNG TENGAH, LAMPUNG",3,155,26,181
https://kawalpemilu.org#23183,"RANTAU JAYA ILIR, PUTRA RUMBIA, LAMPUNG TENGAH, LAMPUNG",4,161,16,177
https://kawalpemilu.org#23183,"RANTAU JAYA ILIR, PUTRA RUMBIA, LAMPUNG TENGAH, LAMPUNG",5,191,13,204
https://kawalpemilu.org#23183,"RANTAU JAYA ILIR, PUTRA RUMBIA, LAMPUNG TENGAH, LAMPUNG",6,183,10,193
https://kawalpemilu.org#23184,"RANTAU JAYA BARU, PUTRA RUMBIA, LAMPUNG TENGAH, LAMPUNG",1,187,13,200
https://kawalpemilu.org#23184,"RANTAU JAYA BARU, PUTRA RUMBIA, LAMPUNG TENGAH, LAMPUNG",2,196,18,214
https://kawalpemilu.org#23184,"RANTAU JAYA BARU, PUTRA RUMBIA, LAMPUNG TENGAH, LAMPUNG",3,182,40,222
https://kawalpemilu.org#23184,"RANTAU JAYA BARU, PUTRA RUMBIA, LAMPUNG TENGAH, LAMPUNG",4,199,16,215
https://kawalpemilu.org#23185,"JOHARAN, PUTRA RUMBIA, LAMPUNG TENGAH, LAMPUNG",1,142,63,205
https://kawalpemilu.org#23185,"JOHARAN, PUTRA RUMBIA, LAMPUNG TENGAH, LAMPUNG",2,169,26,195
https://kawalpemilu.org#23185,"JOHARAN, PUTRA RUMBIA, LAMPUNG TENGAH, LAMPUNG",3,207,27,234
https://kawalpemilu.org#23185,"JOHARAN, PUTRA RUMBIA, LAMPUNG TENGAH, LAMPUNG",4,144,36,180
https://kawalpemilu.org#23185,"JOHARAN, PUTRA RUMBIA, LAMPUNG TENGAH, LAMPUNG",5,147,50,197
https://kawalpemilu.org#23186,"BINA KARYA JAYA, PUTRA RUMBIA, LAMPUNG TENGAH, LAMPUNG",1,136,36,172
https://kawalpemilu.org#23186,"BINA KARYA JAYA, PUTRA RUMBIA, LAMPUNG TENGAH, LAMPUNG",2,121,33,154
https://kawalpemilu.org#23186,"BINA KARYA JAYA, PUTRA RUMBIA, LAMPUNG TENGAH, LAMPUNG",3,163,56,219
https://kawalpemilu.org#23186,"BINA KARYA JAYA, PUTRA RUMBIA, LAMPUNG TENGAH, LAMPUNG",4,166,24,190
https://kawalpemilu.org#23186,"BINA KARYA JAYA, PUTRA RUMBIA, LAMPUNG TENGAH, LAMPUNG",5,240,6,246
https://kawalpemilu.org#23186,"BINA KARYA JAYA, PUTRA RUMBIA, LAMPUNG TENGAH, LAMPUNG",6,137,23,160
https://kawalpemilu.org#23186,"BINA KARYA JAYA, PUTRA RUMBIA, LAMPUNG TENGAH, LAMPUNG",7,144,44,188
https://kawalpemilu.org#23186,"BINA KARYA JAYA, PUTRA RUMBIA, LAMPUNG TENGAH, LAMPUNG",8,132,50,182
https://kawalpemilu.org#23187,"BINA KARYA UTAMA, PUTRA RUMBIA, LAMPUNG TENGAH, LAMPUNG",1,146,73,219
https://kawalpemilu.org#23187,"BINA KARYA UTAMA, PUTRA RUMBIA, LAMPUNG TENGAH, LAMPUNG",2,131,79,210
https://kawalpemilu.org#23187,"BINA KARYA UTAMA, PUTRA RUMBIA, LAMPUNG TENGAH, LAMPUNG",3,161,46,207
https://kawalpemilu.org#23187,"BINA KARYA UTAMA, PUTRA RUMBIA, LAMPUNG TENGAH, LAMPUNG",4,147,47,194
https://kawalpemilu.org#23187,"BINA KARYA UTAMA, PUTRA RUMBIA, LAMPUNG TENGAH, LAMPUNG",5,136,74,210
https://kawalpemilu.org#23187,"BINA KARYA UTAMA, PUTRA RUMBIA, LAMPUNG TENGAH, LAMPUNG",6,182,40,222
https://kawalpemilu.org#23187,"BINA KARYA UTAMA, PUTRA RUMBIA, LAMPUNG TENGAH, LAMPUNG",7,128,63,191
https://kawalpemilu.org#23187,"BINA KARYA UTAMA, PUTRA RUMBIA, LAMPUNG TENGAH, LAMPUNG",8,151,62,213
https://kawalpemilu.org#23187,"BINA KARYA UTAMA, PUTRA RUMBIA, LAMPUNG TENGAH, LAMPUNG",9,169,43,212
https://kawalpemilu.org#23188,"BINA KARYA SAKTI, PUTRA RUMBIA, LAMPUNG TENGAH, LAMPUNG",1,170,20,190
https://kawalpemilu.org#23188,"BINA KARYA SAKTI, PUTRA RUMBIA, LAMPUNG TENGAH, LAMPUNG",2,163,44,207
https://kawalpemilu.org#23188,"BINA KARYA SAKTI, PUTRA RUMBIA, LAMPUNG TENGAH, LAMPUNG",3,168,30,198
https://kawalpemilu.org#23188,"BINA KARYA SAKTI, PUTRA RUMBIA, LAMPUNG TENGAH, LAMPUNG",4,161,35,196
https://kawalpemilu.org#23188,"BINA KARYA SAKTI, PUTRA RUMBIA, LAMPUNG TENGAH, LAMPUNG",5,150,7,157
https://kawalpemilu.org#84798,"BINAKARYA  BARU, PUTRA RUMBIA, LAMPUNG TENGAH, LAMPUNG",1,145,28,173
https://kawalpemilu.org#84798,"BINAKARYA  BARU, PUTRA RUMBIA, LAMPUNG TENGAH, LAMPUNG",2,121,14,135
https://kawalpemilu.org#84798,"BINAKARYA  BARU, PUTRA RUMBIA, LAMPUNG TENGAH, LAMPUNG",3,116,21,137
https://kawalpemilu.org#84798,"BINAKARYA  BARU, PUTRA RUMBIA, LAMPUNG TENGAH, LAMPUNG",4,162,40,202
https://kawalpemilu.org#84798,"BINAKARYA  BARU, PUTRA RUMBIA, LAMPUNG TENGAH, LAMPUNG",5,189,20,209
https://kawalpemilu.org#84799,"MRANGGI JAYA, PUTRA RUMBIA, LAMPUNG TENGAH, LAMPUNG",1,190,37,227
https://kawalpemilu.org#84799,"MRANGGI JAYA, PUTRA RUMBIA, LAMPUNG TENGAH, LAMPUNG",2,160,64,224
https://kawalpemilu.org#84799,"MRANGGI JAYA, PUTRA RUMBIA, LAMPUNG TENGAH, LAMPUNG",3,186,31,217
https://kawalpemilu.org#84799,"MRANGGI JAYA, PUTRA RUMBIA, LAMPUNG TENGAH, LAMPUNG",4,225,1,226
https://kawalpemilu.org#84800,"RANTAU JAYA MAKMUR, PUTRA RUMBIA, LAMPUNG TENGAH, LAMPUNG",1,203,7,210
https://kawalpemilu.org#84800,"RANTAU JAYA MAKMUR, PUTRA RUMBIA, LAMPUNG TENGAH, LAMPUNG",2,144,19,163
https://kawalpemilu.org#84800,"RANTAU JAYA MAKMUR, PUTRA RUMBIA, LAMPUNG TENGAH, LAMPUNG",3,148,14,162
https://kawalpemilu.org#84800,"RANTAU JAYA MAKMUR, PUTRA RUMBIA, LAMPUNG TENGAH, LAMPUNG",4,176,13,189
https://kawalpemilu.org#84800,"RANTAU JAYA MAKMUR, PUTRA RUMBIA, LAMPUNG TENGAH, LAMPUNG",5,164,27,191
https://kawalpemilu.org#91304,"MEKAR JAYA, PUTRA RUMBIA, LAMPUNG TENGAH, LAMPUNG",1,210,16,226
https://kawalpemilu.org#91304,"MEKAR JAYA, PUTRA RUMBIA, LAMPUNG TENGAH, LAMPUNG",2,199,30,229
https://kawalpemilu.org#91304,"MEKAR JAYA, PUTRA RUMBIA, LAMPUNG TENGAH, LAMPUNG",3,152,11,163
https://kawalpemilu.org#91304,"MEKAR JAYA, PUTRA RUMBIA, LAMPUNG TENGAH, LAMPUNG",4,202,5,207
https://kawalpemilu.org#91304,"MEKAR JAYA, PUTRA RUMBIA, LAMPUNG TENGAH, LAMPUNG",5,187,2,189
https://kawalpemilu.org#91304,"MEKAR JAYA, PUTRA RUMBIA, LAMPUNG TENGAH, LAMPUNG",6,182,7,189
https://kawalpemilu.org#91304,"MEKAR JAYA, PUTRA RUMBIA, LAMPUNG TENGAH, LAMPUNG",7,128,1,129
https://kawalpemilu.org#23191,"BUKIT KEMUNING, BUKIT KEMUNING, LAMPUNG UTARA, LAMPUNG",1,53,139,192
https://kawalpemilu.org#23191,"BUKIT KEMUNING, BUKIT KEMUNING, LAMPUNG UTARA, LAMPUNG",2,34,117,151
https://kawalpemilu.org#23191,"BUKIT KEMUNING, BUKIT KEMUNING, LAMPUNG UTARA, LAMPUNG",3,49,147,196
https://kawalpemilu.org#23191,"BUKIT KEMUNING, BUKIT KEMUNING, LAMPUNG UTARA, LAMPUNG",4,31,159,190
https://kawalpemilu.org#23191,"BUKIT KEMUNING, BUKIT KEMUNING, LAMPUNG UTARA, LAMPUNG",5,73,138,211
https://kawalpemilu.org#23191,"BUKIT KEMUNING, BUKIT KEMUNING, LAMPUNG UTARA, LAMPUNG",6,59,142,201
https://kawalpemilu.org#23191,"BUKIT KEMUNING, BUKIT KEMUNING, LAMPUNG UTARA, LAMPUNG",7,67,138,205
https://kawalpemilu.org#23191,"BUKIT KEMUNING, BUKIT KEMUNING, LAMPUNG UTARA, LAMPUNG",8,75,91,166
https://kawalpemilu.org#23191,"BUKIT KEMUNING, BUKIT KEMUNING, LAMPUNG UTARA, LAMPUNG",9,86,143,229
https://kawalpemilu.org#23191,"BUKIT KEMUNING, BUKIT KEMUNING, LAMPUNG UTARA, LAMPUNG",10,84,133,217
https://kawalpemilu.org#23191,"BUKIT KEMUNING, BUKIT KEMUNING, LAMPUNG UTARA, LAMPUNG",11,0,0,0
https://kawalpemilu.org#23191,"BUKIT KEMUNING, BUKIT KEMUNING, LAMPUNG UTARA, LAMPUNG",12,75,130,205
https://kawalpemilu.org#23191,"BUKIT KEMUNING, BUKIT KEMUNING, LAMPUNG UTARA, LAMPUNG",13,50,125,175
https://kawalpemilu.org#23191,"BUKIT KEMUNING, BUKIT KEMUNING, LAMPUNG UTARA, LAMPUNG",14,52,123,175
https://kawalpemilu.org#23191,"BUKIT KEMUNING, BUKIT KEMUNING, LAMPUNG UTARA, LAMPUNG",15,58,103,161
https://kawalpemilu.org#23191,"BUKIT KEMUNING, BUKIT KEMUNING, LAMPUNG UTARA, LAMPUNG",16,72,99,171
https://kawalpemilu.org#23191,"BUKIT KEMUNING, BUKIT KEMUNING, LAMPUNG UTARA, LAMPUNG",17,38,74,112
https://kawalpemilu.org#23191,"BUKIT KEMUNING, BUKIT KEMUNING, LAMPUNG UTARA, LAMPUNG",18,36,73,109
https://kawalpemilu.org#23191,"BUKIT KEMUNING, BUKIT KEMUNING, LAMPUNG UTARA, LAMPUNG",19,41,119,160
https://kawalpemilu.org#23191,"BUKIT KEMUNING, BUKIT KEMUNING, LAMPUNG UTARA, LAMPUNG",20,34,119,153
https://kawalpemilu.org#23191,"BUKIT KEMUNING, BUKIT KEMUNING, LAMPUNG UTARA, LAMPUNG",21,35,157,192
https://kawalpemilu.org#23191,"BUKIT KEMUNING, BUKIT KEMUNING, LAMPUNG UTARA, LAMPUNG",22,102,124,226
https://kawalpemilu.org#23191,"BUKIT KEMUNING, BUKIT KEMUNING, LAMPUNG UTARA, LAMPUNG",23,121,51,172
https://kawalpemilu.org#23191,"BUKIT KEMUNING, BUKIT KEMUNING, LAMPUNG UTARA, LAMPUNG",24,122,55,177
https://kawalpemilu.org#23191,"BUKIT KEMUNING, BUKIT KEMUNING, LAMPUNG UTARA, LAMPUNG",25,88,113,201
https://kawalpemilu.org#23191,"BUKIT KEMUNING, BUKIT KEMUNING, LAMPUNG UTARA, LAMPUNG",26,89,102,191
https://kawalpemilu.org#23191,"BUKIT KEMUNING, BUKIT KEMUNING, LAMPUNG UTARA, LAMPUNG",27,108,140,248
https://kawalpemilu.org#23191,"BUKIT KEMUNING, BUKIT KEMUNING, LAMPUNG UTARA, LAMPUNG",28,115,140,255
https://kawalpemilu.org#23191,"BUKIT KEMUNING, BUKIT KEMUNING, LAMPUNG UTARA, LAMPUNG",29,86,137,223
https://kawalpemilu.org#23191,"BUKIT KEMUNING, BUKIT KEMUNING, LAMPUNG UTARA, LAMPUNG",30,48,127,175
https://kawalpemilu.org#23191,"BUKIT KEMUNING, BUKIT KEMUNING, LAMPUNG UTARA, LAMPUNG",31,82,88,170
https://kawalpemilu.org#23191,"BUKIT KEMUNING, BUKIT KEMUNING, LAMPUNG UTARA, LAMPUNG",32,119,115,234
https://kawalpemilu.org#23191,"BUKIT KEMUNING, BUKIT KEMUNING, LAMPUNG UTARA, LAMPUNG",33,104,152,256
https://kawalpemilu.org#23191,"BUKIT KEMUNING, BUKIT KEMUNING, LAMPUNG UTARA, LAMPUNG",34,66,110,176
https://kawalpemilu.org#23191,"BUKIT KEMUNING, BUKIT KEMUNING, LAMPUNG UTARA, LAMPUNG",35,47,182,229
https://kawalpemilu.org#23191,"BUKIT KEMUNING, BUKIT KEMUNING, LAMPUNG UTARA, LAMPUNG",36,68,143,211
https://kawalpemilu.org#23191,"BUKIT KEMUNING, BUKIT KEMUNING, LAMPUNG UTARA, LAMPUNG",37,69,107,176
https://kawalpemilu.org#23191,"BUKIT KEMUNING, BUKIT KEMUNING, LAMPUNG UTARA, LAMPUNG",38,47,100,147
https://kawalpemilu.org#23191,"BUKIT KEMUNING, BUKIT KEMUNING, LAMPUNG UTARA, LAMPUNG",39,43,123,166
https://kawalpemilu.org#23191,"BUKIT KEMUNING, BUKIT KEMUNING, LAMPUNG UTARA, LAMPUNG",40,45,129,174
https://kawalpemilu.org#23191,"BUKIT KEMUNING, BUKIT KEMUNING, LAMPUNG UTARA, LAMPUNG",41,52,129,181
https://kawalpemilu.org#23191,"BUKIT KEMUNING, BUKIT KEMUNING, LAMPUNG UTARA, LAMPUNG",42,67,117,184
https://kawalpemilu.org#23191,"BUKIT KEMUNING, BUKIT KEMUNING, LAMPUNG UTARA, LAMPUNG",43,59,112,171
https://kawalpemilu.org#23191,"BUKIT KEMUNING, BUKIT KEMUNING, LAMPUNG UTARA, LAMPUNG",44,61,110,171
https://kawalpemilu.org#23191,"BUKIT KEMUNING, BUKIT KEMUNING, LAMPUNG UTARA, LAMPUNG",45,41,111,152
https://kawalpemilu.org#23191,"BUKIT KEMUNING, BUKIT KEMUNING, LAMPUNG UTARA, LAMPUNG",46,48,101,149
https://kawalpemilu.org#23191,"BUKIT KEMUNING, BUKIT KEMUNING, LAMPUNG UTARA, LAMPUNG",47,56,156,212
https://kawalpemilu.org#23191,"BUKIT KEMUNING, BUKIT KEMUNING, LAMPUNG UTARA, LAMPUNG",48,79,130,209
https://kawalpemilu.org#23191,"BUKIT KEMUNING, BUKIT KEMUNING, LAMPUNG UTARA, LAMPUNG",49,78,109,187
https://kawalpemilu.org#23191,"BUKIT KEMUNING, BUKIT KEMUNING, LAMPUNG UTARA, LAMPUNG",50,63,117,180
https://kawalpemilu.org#23191,"BUKIT KEMUNING, BUKIT KEMUNING, LAMPUNG UTARA, LAMPUNG",51,94,132,226
https://kawalpemilu.org#23191,"BUKIT KEMUNING, BUKIT KEMUNING, LAMPUNG UTARA, LAMPUNG",52,106,104,210
https://kawalpemilu.org#23191,"BUKIT KEMUNING, BUKIT KEMUNING, LAMPUNG UTARA, LAMPUNG",53,29,79,108
https://kawalpemilu.org#23192,"TANJUNG BARU, BUKIT KEMUNING, LAMPUNG UTARA, LAMPUNG",1,0,0,0
https://kawalpemilu.org#23192,"TANJUNG BARU, BUKIT KEMUNING, LAMPUNG UTARA, LAMPUNG",6,0,0,0
https://kawalpemilu.org#23192,"TANJUNG BARU, BUKIT KEMUNING, LAMPUNG UTARA, LAMPUNG",7,0,0,0
https://kawalpemilu.org#23192,"TANJUNG BARU, BUKIT KEMUNING, LAMPUNG UTARA, LAMPUNG",8,0,0,0
https://kawalpemilu.org#23192,"TANJUNG BARU, BUKIT KEMUNING, LAMPUNG UTARA, LAMPUNG",9,0,0,0
https://kawalpemilu.org#23192,"TANJUNG BARU, BUKIT KEMUNING, LAMPUNG UTARA, LAMPUNG",10,0,0,0
https://kawalpemilu.org#23192,"TANJUNG BARU, BUKIT KEMUNING, LAMPUNG UTARA, LAMPUNG",13,0,0,0
https://kawalpemilu.org#23192,"TANJUNG BARU, BUKIT KEMUNING, LAMPUNG UTARA, LAMPUNG",101,100,153,253
https://kawalpemilu.org#23192,"TANJUNG BARU, BUKIT KEMUNING, LAMPUNG UTARA, LAMPUNG",102,91,101,192
https://kawalpemilu.org#23192,"TANJUNG BARU, BUKIT KEMUNING, LAMPUNG UTARA, LAMPUNG",103,85,208,293
https://kawalpemilu.org#23192,"TANJUNG BARU, BUKIT KEMUNING, LAMPUNG UTARA, LAMPUNG",104,90,165,255
https://kawalpemilu.org#23192,"TANJUNG BARU, BUKIT KEMUNING, LAMPUNG UTARA, LAMPUNG",105,90,143,233
https://kawalpemilu.org#23192,"TANJUNG BARU, BUKIT KEMUNING, LAMPUNG UTARA, LAMPUNG",106,129,120,249
https://kawalpemilu.org#23192,"TANJUNG BARU, BUKIT KEMUNING, LAMPUNG UTARA, LAMPUNG",107,116,100,216
https://kawalpemilu.org#23192,"TANJUNG BARU, BUKIT KEMUNING, LAMPUNG UTARA, LAMPUNG",108,114,61,175
https://kawalpemilu.org#23192,"TANJUNG BARU, BUKIT KEMUNING, LAMPUNG UTARA, LAMPUNG",109,214,41,255
https://kawalpemilu.org#23192,"TANJUNG BARU, BUKIT KEMUNING, LAMPUNG UTARA, LAMPUNG",110,122,127,249
https://kawalpemilu.org#23192,"TANJUNG BARU, BUKIT KEMUNING, LAMPUNG UTARA, LAMPUNG",111,167,70,237
https://kawalpemilu.org#23192,"TANJUNG BARU, BUKIT KEMUNING, LAMPUNG UTARA, LAMPUNG",112,101,46,147
https://kawalpemilu.org#23192,"TANJUNG BARU, BUKIT KEMUNING, LAMPUNG UTARA, LAMPUNG",113,121,35,136
https://kawalpemilu.org#23193,"SUKA MENANTI, BUKIT KEMUNING, LAMPUNG UTARA, LAMPUNG",15,0,0,0
https://kawalpemilu.org#23193,"SUKA MENANTI, BUKIT KEMUNING, LAMPUNG UTARA, LAMPUNG",69,97,110,207
https://kawalpemilu.org#23193,"SUKA MENANTI, BUKIT KEMUNING, LAMPUNG UTARA, LAMPUNG",70,100,109,209
https://kawalpemilu.org#23193,"SUKA MENANTI, BUKIT KEMUNING, LAMPUNG UTARA, LAMPUNG",71,106,63,169
https://kawalpemilu.org#23193,"SUKA MENANTI, BUKIT KEMUNING, LAMPUNG UTARA, LAMPUNG",72,102,66,168
https://kawalpemilu.org#23193,"SUKA MENANTI, BUKIT KEMUNING, LAMPUNG UTARA, LAMPUNG",73,57,138,195
https://kawalpemilu.org#23193,"SUKA MENANTI, BUKIT KEMUNING, LAMPUNG UTARA, LAMPUNG",74,48,145,193
https://kawalpemilu.org#23193,"SUKA MENANTI, BUKIT KEMUNING, LAMPUNG UTARA, LAMPUNG",76,97,119,216
https://kawalpemilu.org#23193,"SUKA MENANTI, BUKIT KEMUNING, LAMPUNG UTARA, LAMPUNG",77,78,77,155
https://kawalpemilu.org#23193,"SUKA MENANTI, BUKIT KEMUNING, LAMPUNG UTARA, LAMPUNG",78,80,70,150
https://kawalpemilu.org#23193,"SUKA MENANTI, BUKIT KEMUNING, LAMPUNG UTARA, LAMPUNG",79,92,89,181
https://kawalpemilu.org#23193,"SUKA MENANTI, BUKIT KEMUNING, LAMPUNG UTARA, LAMPUNG",80,63,89,152
https://kawalpemilu.org#23193,"SUKA MENANTI, BUKIT KEMUNING, LAMPUNG UTARA, LAMPUNG",81,87,135,222
https://kawalpemilu.org#23193,"SUKA MENANTI, BUKIT KEMUNING, LAMPUNG UTARA, LAMPUNG",82,86,157,243
https://kawalpemilu.org#23193,"SUKA MENANTI, BUKIT KEMUNING, LAMPUNG UTARA, LAMPUNG",83,68,83,151
https://kawalpemilu.org#23193,"SUKA MENANTI, BUKIT KEMUNING, LAMPUNG UTARA, LAMPUNG",84,39,99,138
https://kawalpemilu.org#23194,"MUARA AMAN, BUKIT KEMUNING, LAMPUNG UTARA, LAMPUNG",1,0,0,0
https://kawalpemilu.org#23194,"MUARA AMAN, BUKIT KEMUNING, LAMPUNG UTARA, LAMPUNG",2,0,0,0
https://kawalpemilu.org#23194,"MUARA AMAN, BUKIT KEMUNING, LAMPUNG UTARA, LAMPUNG",3,0,0,0
https://kawalpemilu.org#23194,"MUARA AMAN, BUKIT KEMUNING, LAMPUNG UTARA, LAMPUNG",4,0,0,0
https://kawalpemilu.org#23194,"MUARA AMAN, BUKIT KEMUNING, LAMPUNG UTARA, LAMPUNG",5,0,0,0
https://kawalpemilu.org#23194,"MUARA AMAN, BUKIT KEMUNING, LAMPUNG UTARA, LAMPUNG",6,0,0,0
https://kawalpemilu.org#23194,"MUARA AMAN, BUKIT KEMUNING, LAMPUNG UTARA, LAMPUNG",7,0,0,0
https://kawalpemilu.org#23194,"MUARA AMAN, BUKIT KEMUNING, LAMPUNG UTARA, LAMPUNG",8,0,0,0
https://kawalpemilu.org#23194,"MUARA AMAN, BUKIT KEMUNING, LAMPUNG UTARA, LAMPUNG",9,0,0,0
https://kawalpemilu.org#23194,"MUARA AMAN, BUKIT KEMUNING, LAMPUNG UTARA, LAMPUNG",10,0,0,0
https://kawalpemilu.org#23194,"MUARA AMAN, BUKIT KEMUNING, LAMPUNG UTARA, LAMPUNG",11,0,0,0
https://kawalpemilu.org#23194,"MUARA AMAN, BUKIT KEMUNING, LAMPUNG UTARA, LAMPUNG",12,0,0,0
https://kawalpemilu.org#23194,"MUARA AMAN, BUKIT KEMUNING, LAMPUNG UTARA, LAMPUNG",15,0,0,0
https://kawalpemilu.org#23194,"MUARA AMAN, BUKIT KEMUNING, LAMPUNG UTARA, LAMPUNG",54,60,140,200
https://kawalpemilu.org#23194,"MUARA AMAN, BUKIT KEMUNING, LAMPUNG UTARA, LAMPUNG",55,84,113,197
https://kawalpemilu.org#23194,"MUARA AMAN, BUKIT KEMUNING, LAMPUNG UTARA, LAMPUNG",56,91,112,203
https://kawalpemilu.org#23194,"MUARA AMAN, BUKIT KEMUNING, LAMPUNG UTARA, LAMPUNG",57,55,132,187
https://kawalpemilu.org#23194,"MUARA AMAN, BUKIT KEMUNING, LAMPUNG UTARA, LAMPUNG",58,79,92,171
https://kawalpemilu.org#23194,"MUARA AMAN, BUKIT KEMUNING, LAMPUNG UTARA, LAMPUNG",59,63,104,167
https://kawalpemilu.org#23194,"MUARA AMAN, BUKIT KEMUNING, LAMPUNG UTARA, LAMPUNG",60,91,74,165
https://kawalpemilu.org#23194,"MUARA AMAN, BUKIT KEMUNING, LAMPUNG UTARA, LAMPUNG",61,61,105,166
https://kawalpemilu.org#23194,"MUARA AMAN, BUKIT KEMUNING, LAMPUNG UTARA, LAMPUNG",62,78,95,173
https://kawalpemilu.org#23194,"MUARA AMAN, BUKIT KEMUNING, LAMPUNG UTARA, LAMPUNG",63,65,58,123
https://kawalpemilu.org#23194,"MUARA AMAN, BUKIT KEMUNING, LAMPUNG UTARA, LAMPUNG",64,87,53,140
https://kawalpemilu.org#23194,"MUARA AMAN, BUKIT KEMUNING, LAMPUNG UTARA, LAMPUNG",65,69,54,123
https://kawalpemilu.org#23194,"MUARA AMAN, BUKIT KEMUNING, LAMPUNG UTARA, LAMPUNG",66,40,90,130
https://kawalpemilu.org#23194,"MUARA AMAN, BUKIT KEMUNING, LAMPUNG UTARA, LAMPUNG",68,67,101,168
https://kawalpemilu.org#23195,"TANJUNG BARU TIMUR, BUKIT KEMUNING, LAMPUNG UTARA, LAMPUNG",1,0,0,0
https://kawalpemilu.org#23195,"TANJUNG BARU TIMUR, BUKIT KEMUNING, LAMPUNG UTARA, LAMPUNG",2,0,0,0
https://kawalpemilu.org#23195,"TANJUNG BARU TIMUR, BUKIT KEMUNING, LAMPUNG UTARA, LAMPUNG",3,0,0,0
https://kawalpemilu.org#23195,"TANJUNG BARU TIMUR, BUKIT KEMUNING, LAMPUNG UTARA, LAMPUNG",4,0,0,0
https://kawalpemilu.org#23195,"TANJUNG BARU TIMUR, BUKIT KEMUNING, LAMPUNG UTARA, LAMPUNG",5,0,0,0
https://kawalpemilu.org#23195,"TANJUNG BARU TIMUR, BUKIT KEMUNING, LAMPUNG UTARA, LAMPUNG",6,0,0,0
https://kawalpemilu.org#23195,"TANJUNG BARU TIMUR, BUKIT KEMUNING, LAMPUNG UTARA, LAMPUNG",7,0,0,0
https://kawalpemilu.org#23195,"TANJUNG BARU TIMUR, BUKIT KEMUNING, LAMPUNG UTARA, LAMPUNG",8,0,0,0
https://kawalpemilu.org#23195,"TANJUNG BARU TIMUR, BUKIT KEMUNING, LAMPUNG UTARA, LAMPUNG",93,60,130,190
https://kawalpemilu.org#23195,"TANJUNG BARU TIMUR, BUKIT KEMUNING, LAMPUNG UTARA, LAMPUNG",94,52,147,199
https://kawalpemilu.org#23195,"TANJUNG BARU TIMUR, BUKIT KEMUNING, LAMPUNG UTARA, LAMPUNG",95,78,91,169
https://kawalpemilu.org#23195,"TANJUNG BARU TIMUR, BUKIT KEMUNING, LAMPUNG UTARA, LAMPUNG",96,67,104,171
https://kawalpemilu.org#23195,"TANJUNG BARU TIMUR, BUKIT KEMUNING, LAMPUNG UTARA, LAMPUNG",97,102,59,161
https://kawalpemilu.org#23195,"TANJUNG BARU TIMUR, BUKIT KEMUNING, LAMPUNG UTARA, LAMPUNG",98,112,55,167
https://kawalpemilu.org#23195,"TANJUNG BARU TIMUR, BUKIT KEMUNING, LAMPUNG UTARA, LAMPUNG",99,74,95,169
https://kawalpemilu.org#23195,"TANJUNG BARU TIMUR, BUKIT KEMUNING, LAMPUNG UTARA, LAMPUNG",100,87,84,171
https://kawalpemilu.org#23196,"DWIKORA, BUKIT KEMUNING, LAMPUNG UTARA, LAMPUNG",4,0,0,0
https://kawalpemilu.org#23196,"DWIKORA, BUKIT KEMUNING, LAMPUNG UTARA, LAMPUNG",114,144,49,193
https://kawalpemilu.org#23196,"DWIKORA, BUKIT KEMUNING, LAMPUNG UTARA, LAMPUNG",115,59,15,74
https://kawalpemilu.org#23196,"DWIKORA, BUKIT KEMUNING, LAMPUNG UTARA, LAMPUNG",116,192,67,259
https://kawalpemilu.org#23196,"DWIKORA, BUKIT KEMUNING, LAMPUNG UTARA, LAMPUNG",117,154,99,253
https://kawalpemilu.org#23196,"DWIKORA, BUKIT KEMUNING, LAMPUNG UTARA, LAMPUNG",118,184,64,248
https://kawalpemilu.org#23196,"DWIKORA, BUKIT KEMUNING, LAMPUNG UTARA, LAMPUNG",119,156,44,200
https://kawalpemilu.org#23196,"DWIKORA, BUKIT KEMUNING, LAMPUNG UTARA, LAMPUNG",120,150,62,212
https://kawalpemilu.org#23197,"TANJUNG WARAS, BUKIT KEMUNING, LAMPUNG UTARA, LAMPUNG",2,0,0,0
https://kawalpemilu.org#23197,"TANJUNG WARAS, BUKIT KEMUNING, LAMPUNG UTARA, LAMPUNG",5,0,0,0
https://kawalpemilu.org#23197,"TANJUNG WARAS, BUKIT KEMUNING, LAMPUNG UTARA, LAMPUNG",7,0,0,0
https://kawalpemilu.org#23197,"TANJUNG WARAS, BUKIT KEMUNING, LAMPUNG UTARA, LAMPUNG",8,0,0,0
https://kawalpemilu.org#23197,"TANJUNG WARAS, BUKIT KEMUNING, LAMPUNG UTARA, LAMPUNG",85,76,132,208
https://kawalpemilu.org#23197,"TANJUNG WARAS, BUKIT KEMUNING, LAMPUNG UTARA, LAMPUNG",86,68,112,180
https://kawalpemilu.org#23197,"TANJUNG WARAS, BUKIT KEMUNING, LAMPUNG UTARA, LAMPUNG",87,50,124,174
https://kawalpemilu.org#23197,"TANJUNG WARAS, BUKIT KEMUNING, LAMPUNG UTARA, LAMPUNG",88,36,111,147
https://kawalpemilu.org#23197,"TANJUNG WARAS, BUKIT KEMUNING, LAMPUNG UTARA, LAMPUNG",89,60,65,125
https://kawalpemilu.org#23197,"TANJUNG WARAS, BUKIT KEMUNING, LAMPUNG UTARA, LAMPUNG",90,40,84,124
https://kawalpemilu.org#23197,"TANJUNG WARAS, BUKIT KEMUNING, LAMPUNG UTARA, LAMPUNG",91,55,77,132
https://kawalpemilu.org#23197,"TANJUNG WARAS, BUKIT KEMUNING, LAMPUNG UTARA, LAMPUNG",92,42,95,137
https://kawalpemilu.org#23198,"SIDO MULYO, BUKIT KEMUNING, LAMPUNG UTARA, LAMPUNG",121,111,52,163
https://kawalpemilu.org#23198,"SIDO MULYO, BUKIT KEMUNING, LAMPUNG UTARA, LAMPUNG",122,88,100,188
https://kawalpemilu.org#23198,"SIDO MULYO, BUKIT KEMUNING, LAMPUNG UTARA, LAMPUNG",123,71,77,148
https://kawalpemilu.org#23198,"SIDO MULYO, BUKIT KEMUNING, LAMPUNG UTARA, LAMPUNG",124,27,36,63
https://kawalpemilu.org#23200,"KOTABUMI UDIK, KOTABUMI, LAMPUNG UTARA, LAMPUNG",1,83,131,214
https://kawalpemilu.org#23200,"KOTABUMI UDIK, KOTABUMI, LAMPUNG UTARA, LAMPUNG",2,74,124,198
https://kawalpemilu.org#23200,"KOTABUMI UDIK, KOTABUMI, LAMPUNG UTARA, LAMPUNG",4,58,112,170
https://kawalpemilu.org#23200,"KOTABUMI UDIK, KOTABUMI, LAMPUNG UTARA, LAMPUNG",5,84,61,145
https://kawalpemilu.org#23200,"KOTABUMI UDIK, KOTABUMI, LAMPUNG UTARA, LAMPUNG",6,63,54,117
https://kawalpemilu.org#23200,"KOTABUMI UDIK, KOTABUMI, LAMPUNG UTARA, LAMPUNG",7,81,133,214
https://kawalpemilu.org#23200,"KOTABUMI UDIK, KOTABUMI, LAMPUNG UTARA, LAMPUNG",8,72,133,205
https://kawalpemilu.org#23200,"KOTABUMI UDIK, KOTABUMI, LAMPUNG UTARA, LAMPUNG",9,53,69,122
https://kawalpemilu.org#23200,"KOTABUMI UDIK, KOTABUMI, LAMPUNG UTARA, LAMPUNG",10,58,64,122
https://kawalpemilu.org#23200,"KOTABUMI UDIK, KOTABUMI, LAMPUNG UTARA, LAMPUNG",11,44,162,206
https://kawalpemilu.org#23200,"KOTABUMI UDIK, KOTABUMI, LAMPUNG UTARA, LAMPUNG",12,59,132,191
https://kawalpemilu.org#23200,"KOTABUMI UDIK, KOTABUMI, LAMPUNG UTARA, LAMPUNG",13,73,120,193
https://kawalpemilu.org#23200,"KOTABUMI UDIK, KOTABUMI, LAMPUNG UTARA, LAMPUNG",14,105,130,235
https://kawalpemilu.org#23200,"KOTABUMI UDIK, KOTABUMI, LAMPUNG UTARA, LAMPUNG",15,62,83,145
https://kawalpemilu.org#23200,"KOTABUMI UDIK, KOTABUMI, LAMPUNG UTARA, LAMPUNG",16,62,80,142
https://kawalpemilu.org#23200,"KOTABUMI UDIK, KOTABUMI, LAMPUNG UTARA, LAMPUNG",17,55,83,138
https://kawalpemilu.org#23200,"KOTABUMI UDIK, KOTABUMI, LAMPUNG UTARA, LAMPUNG",18,37,69,106
https://kawalpemilu.org#23200,"KOTABUMI UDIK, KOTABUMI, LAMPUNG UTARA, LAMPUNG",19,41,139,180
https://kawalpemilu.org#23200,"KOTABUMI UDIK, KOTABUMI, LAMPUNG UTARA, LAMPUNG",20,62,85,147
https://kawalpemilu.org#23200,"KOTABUMI UDIK, KOTABUMI, LAMPUNG UTARA, LAMPUNG",21,78,70,148
https://kawalpemilu.org#23200,"KOTABUMI UDIK, KOTABUMI, LAMPUNG UTARA, LAMPUNG",22,26,79,105
https://kawalpemilu.org#23200,"KOTABUMI UDIK, KOTABUMI, LAMPUNG UTARA, LAMPUNG",23,73,50,123
https://kawalpemilu.org#23200,"KOTABUMI UDIK, KOTABUMI, LAMPUNG UTARA, LAMPUNG",24,80,66,146
https://kawalpemilu.org#23200,"KOTABUMI UDIK, KOTABUMI, LAMPUNG UTARA, LAMPUNG",25,65,60,125
https://kawalpemilu.org#23200,"KOTABUMI UDIK, KOTABUMI, LAMPUNG UTARA, LAMPUNG",26,86,61,147
https://kawalpemilu.org#23200,"KOTABUMI UDIK, KOTABUMI, LAMPUNG UTARA, LAMPUNG",27,92,43,135
https://kawalpemilu.org#23200,"KOTABUMI UDIK, KOTABUMI, LAMPUNG UTARA, LAMPUNG",28,40,105,145
https://kawalpemilu.org#23200,"KOTABUMI UDIK, KOTABUMI, LAMPUNG UTARA, LAMPUNG",29,45,143,188
https://kawalpemilu.org#23200,"KOTABUMI UDIK, KOTABUMI, LAMPUNG UTARA, LAMPUNG",30,42,75,117
https://kawalpemilu.org#23200,"KOTABUMI UDIK, KOTABUMI, LAMPUNG UTARA, LAMPUNG",31,42,76,118
https://kawalpemilu.org#23200,"KOTABUMI UDIK, KOTABUMI, LAMPUNG UTARA, LAMPUNG",32,48,37,85
https://kawalpemilu.org#23201,"CEMPEDAK, KOTABUMI, LAMPUNG UTARA, LAMPUNG",1,0,0,0
https://kawalpemilu.org#23201,"CEMPEDAK, KOTABUMI, LAMPUNG UTARA, LAMPUNG",2,0,0,0
https://kawalpemilu.org#23201,"CEMPEDAK, KOTABUMI, LAMPUNG UTARA, LAMPUNG",3,0,0,0
https://kawalpemilu.org#23201,"CEMPEDAK, KOTABUMI, LAMPUNG UTARA, LAMPUNG",4,0,0,0
https://kawalpemilu.org#23201,"CEMPEDAK, KOTABUMI, LAMPUNG UTARA, LAMPUNG",5,0,0,0
https://kawalpemilu.org#23201,"CEMPEDAK, KOTABUMI, LAMPUNG UTARA, LAMPUNG",6,0,0,0
https://kawalpemilu.org#23201,"CEMPEDAK, KOTABUMI, LAMPUNG UTARA, LAMPUNG",9,0,0,0
https://kawalpemilu.org#23201,"CEMPEDAK, KOTABUMI, LAMPUNG UTARA, LAMPUNG",85,52,137,189
https://kawalpemilu.org#23201,"CEMPEDAK, KOTABUMI, LAMPUNG UTARA, LAMPUNG",86,46,116,162
https://kawalpemilu.org#23201,"CEMPEDAK, KOTABUMI, LAMPUNG UTARA, LAMPUNG",87,22,166,188
https://kawalpemilu.org#23201,"CEMPEDAK, KOTABUMI, LAMPUNG UTARA, LAMPUNG",88,39,125,164
https://kawalpemilu.org#23201,"CEMPEDAK, KOTABUMI, LAMPUNG UTARA, LAMPUNG",89,79,126,205
https://kawalpemilu.org#23201,"CEMPEDAK, KOTABUMI, LAMPUNG UTARA, LAMPUNG",90,72,121,193
https://kawalpemilu.org#23201,"CEMPEDAK, KOTABUMI, LAMPUNG UTARA, LAMPUNG",91,63,112,175
https://kawalpemilu.org#23201,"CEMPEDAK, KOTABUMI, LAMPUNG UTARA, LAMPUNG",92,63,91,154
https://kawalpemilu.org#23201,"CEMPEDAK, KOTABUMI, LAMPUNG UTARA, LAMPUNG",93,35,176,211
https://kawalpemilu.org#23201,"CEMPEDAK, KOTABUMI, LAMPUNG UTARA, LAMPUNG",94,34,139,173
https://kawalpemilu.org#23202,"REJO SARI, KOTABUMI, LAMPUNG UTARA, LAMPUNG",2,0,0,0
https://kawalpemilu.org#23202,"REJO SARI, KOTABUMI, LAMPUNG UTARA, LAMPUNG",3,0,0,0
https://kawalpemilu.org#23202,"REJO SARI, KOTABUMI, LAMPUNG UTARA, LAMPUNG",4,0,0,0
https://kawalpemilu.org#23202,"REJO SARI, KOTABUMI, LAMPUNG UTARA, LAMPUNG",6,0,0,0
https://kawalpemilu.org#23202,"REJO SARI, KOTABUMI, LAMPUNG UTARA, LAMPUNG",9,0,0,0
https://kawalpemilu.org#23202,"REJO SARI, KOTABUMI, LAMPUNG UTARA, LAMPUNG",11,0,0,0
https://kawalpemilu.org#23202,"REJO SARI, KOTABUMI, LAMPUNG UTARA, LAMPUNG",12,0,0,0
https://kawalpemilu.org#23202,"REJO SARI, KOTABUMI, LAMPUNG UTARA, LAMPUNG",18,0,0,0
https://kawalpemilu.org#23202,"REJO SARI, KOTABUMI, LAMPUNG UTARA, LAMPUNG",20,0,0,0
https://kawalpemilu.org#23202,"REJO SARI, KOTABUMI, LAMPUNG UTARA, LAMPUNG",24,0,0,0
https://kawalpemilu.org#23202,"REJO SARI, KOTABUMI, LAMPUNG UTARA, LAMPUNG",131,55,110,165
https://kawalpemilu.org#23202,"REJO SARI, KOTABUMI, LAMPUNG UTARA, LAMPUNG",132,42,136,178
https://kawalpemilu.org#23202,"REJO SARI, KOTABUMI, LAMPUNG UTARA, LAMPUNG",133,64,177,241
https://kawalpemilu.org#23202,"REJO SARI, KOTABUMI, LAMPUNG UTARA, LAMPUNG",134,90,158,248
https://kawalpemilu.org#23202,"REJO SARI, KOTABUMI, LAMPUNG UTARA, LAMPUNG",135,69,87,156
https://kawalpemilu.org#23202,"REJO SARI, KOTABUMI, LAMPUNG UTARA, LAMPUNG",136,29,116,145
https://kawalpemilu.org#23202,"REJO SARI, KOTABUMI, LAMPUNG UTARA, LAMPUNG",137,28,120,148
https://kawalpemilu.org#23202,"REJO SARI, KOTABUMI, LAMPUNG UTARA, LAMPUNG",138,57,172,229
https://kawalpemilu.org#23202,"REJO SARI, KOTABUMI, LAMPUNG UTARA, LAMPUNG",139,52,124,176
https://kawalpemilu.org#23202,"REJO SARI, KOTABUMI, LAMPUNG UTARA, LAMPUNG",140,39,111,150
https://kawalpemilu.org#23202,"REJO SARI, KOTABUMI, LAMPUNG UTARA, LAMPUNG",141,56,180,236
https://kawalpemilu.org#23202,"REJO SARI, KOTABUMI, LAMPUNG UTARA, LAMPUNG",142,171,63,234
https://kawalpemilu.org#23202,"REJO SARI, KOTABUMI, LAMPUNG UTARA, LAMPUNG",143,95,99,194
https://kawalpemilu.org#23202,"REJO SARI, KOTABUMI, LAMPUNG UTARA, LAMPUNG",144,100,64,164
https://kawalpemilu.org#23202,"REJO SARI, KOTABUMI, LAMPUNG UTARA, LAMPUNG",145,42,92,134
https://kawalpemilu.org#23202,"REJO SARI, KOTABUMI, LAMPUNG UTARA, LAMPUNG",146,46,115,161
https://kawalpemilu.org#23202,"REJO SARI, KOTABUMI, LAMPUNG UTARA, LAMPUNG",147,79,130,209
https://kawalpemilu.org#23202,"REJO SARI, KOTABUMI, LAMPUNG UTARA, LAMPUNG",148,46,138,184
https://kawalpemilu.org#23202,"REJO SARI, KOTABUMI, LAMPUNG UTARA, LAMPUNG",149,23,96,119
https://kawalpemilu.org#23202,"REJO SARI, KOTABUMI, LAMPUNG UTARA, LAMPUNG",150,68,121,189
https://kawalpemilu.org#23202,"REJO SARI, KOTABUMI, LAMPUNG UTARA, LAMPUNG",151,19,66,85
https://kawalpemilu.org#23202,"REJO SARI, KOTABUMI, LAMPUNG UTARA, LAMPUNG",152,73,125,198
https://kawalpemilu.org#23202,"REJO SARI, KOTABUMI, LAMPUNG UTARA, LAMPUNG",153,34,107,141
https://kawalpemilu.org#23202,"REJO SARI, KOTABUMI, LAMPUNG UTARA, LAMPUNG",154,54,178,232
https://kawalpemilu.org#23203,"KOTABUMI TENGAH, KOTABUMI, LAMPUNG UTARA, LAMPUNG",72,56,105,161
https://kawalpemilu.org#23203,"KOTABUMI TENGAH, KOTABUMI, LAMPUNG UTARA, LAMPUNG",73,52,117,169
https://kawalpemilu.org#23203,"KOTABUMI TENGAH, KOTABUMI, LAMPUNG UTARA, LAMPUNG",74,41,133,174
https://kawalpemilu.org#23203,"KOTABUMI TENGAH, KOTABUMI, LAMPUNG UTARA, LAMPUNG",75,83,108,191
https://kawalpemilu.org#23203,"KOTABUMI TENGAH, KOTABUMI, LAMPUNG UTARA, LAMPUNG",76,34,111,145
https://kawalpemilu.org#23203,"KOTABUMI TENGAH, KOTABUMI, LAMPUNG UTARA, LAMPUNG",77,36,119,155
https://kawalpemilu.org#23203,"KOTABUMI TENGAH, KOTABUMI, LAMPUNG UTARA, LAMPUNG",78,30,130,160
https://kawalpemilu.org#23203,"KOTABUMI TENGAH, KOTABUMI, LAMPUNG UTARA, LAMPUNG",79,71,121,192
https://kawalpemilu.org#23203,"KOTABUMI TENGAH, KOTABUMI, LAMPUNG UTARA, LAMPUNG",80,104,125,229
https://kawalpemilu.org#23203,"KOTABUMI TENGAH, KOTABUMI, LAMPUNG UTARA, LAMPUNG",81,1,71,72
https://kawalpemilu.org#23203,"KOTABUMI TENGAH, KOTABUMI, LAMPUNG UTARA, LAMPUNG",82,63,93,156
https://kawalpemilu.org#23203,"KOTABUMI TENGAH, KOTABUMI, LAMPUNG UTARA, LAMPUNG",83,63,160,223
https://kawalpemilu.org#23203,"KOTABUMI TENGAH, KOTABUMI, LAMPUNG UTARA, LAMPUNG",84,39,93,132
https://kawalpemilu.org#23204,"KOTABUMI PASAR, KOTABUMI, LAMPUNG UTARA, LAMPUNG",1,0,0,0
https://kawalpemilu.org#23204,"KOTABUMI PASAR, KOTABUMI, LAMPUNG UTARA, LAMPUNG",2,0,0,0
https://kawalpemilu.org#23204,"KOTABUMI PASAR, KOTABUMI, LAMPUNG UTARA, LAMPUNG",3,0,0,0
https://kawalpemilu.org#23204,"KOTABUMI PASAR, KOTABUMI, LAMPUNG UTARA, LAMPUNG",4,0,0,0
https://kawalpemilu.org#23204,"KOTABUMI PASAR, KOTABUMI, LAMPUNG UTARA, LAMPUNG",68,51,117,168
https://kawalpemilu.org#23204,"KOTABUMI PASAR, KOTABUMI, LAMPUNG UTARA, LAMPUNG",69,25,119,144
https://kawalpemilu.org#23204,"KOTABUMI PASAR, KOTABUMI, LAMPUNG UTARA, LAMPUNG",70,27,122,149
https://kawalpemilu.org#23204,"KOTABUMI PASAR, KOTABUMI, LAMPUNG UTARA, LAMPUNG",71,42,107,149
https://kawalpemilu.org#23205,"KOTABUMI ILIR, KOTABUMI, LAMPUNG UTARA, LAMPUNG",1,0,0,0
https://kawalpemilu.org#23205,"KOTABUMI ILIR, KOTABUMI, LAMPUNG UTARA, LAMPUNG",6,0,0,0
https://kawalpemilu.org#23205,"KOTABUMI ILIR, KOTABUMI, LAMPUNG UTARA, LAMPUNG",9,0,0,0
https://kawalpemilu.org#23205,"KOTABUMI ILIR, KOTABUMI, LAMPUNG UTARA, LAMPUNG",10,0,0,0
https://kawalpemilu.org#23205,"KOTABUMI ILIR, KOTABUMI, LAMPUNG UTARA, LAMPUNG",12,0,0,0
https://kawalpemilu.org#23205,"KOTABUMI ILIR, KOTABUMI, LAMPUNG UTARA, LAMPUNG",15,0,0,0
https://kawalpemilu.org#23205,"KOTABUMI ILIR, KOTABUMI, LAMPUNG UTARA, LAMPUNG",16,0,0,0
https://kawalpemilu.org#23205,"KOTABUMI ILIR, KOTABUMI, LAMPUNG UTARA, LAMPUNG",95,27,127,154
https://kawalpemilu.org#23205,"KOTABUMI ILIR, KOTABUMI, LAMPUNG UTARA, LAMPUNG",96,41,118,159
https://kawalpemilu.org#23205,"KOTABUMI ILIR, KOTABUMI, LAMPUNG UTARA, LAMPUNG",97,37,160,197
https://kawalpemilu.org#23205,"KOTABUMI ILIR, KOTABUMI, LAMPUNG UTARA, LAMPUNG",98,35,147,182
https://kawalpemilu.org#23205,"KOTABUMI ILIR, KOTABUMI, LAMPUNG UTARA, LAMPUNG",99,90,106,196
https://kawalpemilu.org#23205,"KOTABUMI ILIR, KOTABUMI, LAMPUNG UTARA, LAMPUNG",100,68,116,184
https://kawalpemilu.org#23205,"KOTABUMI ILIR, KOTABUMI, LAMPUNG UTARA, LAMPUNG",101,85,136,221
https://kawalpemilu.org#23205,"KOTABUMI ILIR, KOTABUMI, LAMPUNG UTARA, LAMPUNG",102,94,130,224
https://kawalpemilu.org#23205,"KOTABUMI ILIR, KOTABUMI, LAMPUNG UTARA, LAMPUNG",103,41,133,174
https://kawalpemilu.org#23205,"KOTABUMI ILIR, KOTABUMI, LAMPUNG UTARA, LAMPUNG",104,61,143,204
https://kawalpemilu.org#23205,"KOTABUMI ILIR, KOTABUMI, LAMPUNG UTARA, LAMPUNG",105,44,164,208
https://kawalpemilu.org#23205,"KOTABUMI ILIR, KOTABUMI, LAMPUNG UTARA, LAMPUNG",106,58,141,199
https://kawalpemilu.org#23205,"KOTABUMI ILIR, KOTABUMI, LAMPUNG UTARA, LAMPUNG",107,38,146,184
https://kawalpemilu.org#23205,"KOTABUMI ILIR, KOTABUMI, LAMPUNG UTARA, LAMPUNG",108,44,136,180
https://kawalpemilu.org#23205,"KOTABUMI ILIR, KOTABUMI, LAMPUNG UTARA, LAMPUNG",109,42,116,158
https://kawalpemilu.org#23205,"KOTABUMI ILIR, KOTABUMI, LAMPUNG UTARA, LAMPUNG",110,8,27,35
https://kawalpemilu.org#23206,"SINDANG SARI, KOTABUMI, LAMPUNG UTARA, LAMPUNG",14,0,0,0
https://kawalpemilu.org#23206,"SINDANG SARI, KOTABUMI, LAMPUNG UTARA, LAMPUNG",50,52,132,184
https://kawalpemilu.org#23206,"SINDANG SARI, KOTABUMI, LAMPUNG UTARA, LAMPUNG",51,29,106,135
https://kawalpemilu.org#23206,"SINDANG SARI, KOTABUMI, LAMPUNG UTARA, LAMPUNG",52,40,109,149
https://kawalpemilu.org#23206,"SINDANG SARI, KOTABUMI, LAMPUNG UTARA, LAMPUNG",53,52,131,183
https://kawalpemilu.org#23206,"SINDANG SARI, KOTABUMI, LAMPUNG UTARA, LAMPUNG",54,53,105,158
https://kawalpemilu.org#23206,"SINDANG SARI, KOTABUMI, LAMPUNG UTARA, LAMPUNG",55,44,197,241
https://kawalpemilu.org#23206,"SINDANG SARI, KOTABUMI, LAMPUNG UTARA, LAMPUNG",56,30,182,212
https://kawalpemilu.org#23206,"SINDANG SARI, KOTABUMI, LAMPUNG UTARA, LAMPUNG",57,33,181,214
https://kawalpemilu.org#23206,"SINDANG SARI, KOTABUMI, LAMPUNG UTARA, LAMPUNG",58,55,70,125
https://kawalpemilu.org#23206,"SINDANG SARI, KOTABUMI, LAMPUNG UTARA, LAMPUNG",59,69,154,223
https://kawalpemilu.org#23206,"SINDANG SARI, KOTABUMI, LAMPUNG UTARA, LAMPUNG",60,93,60,153
https://kawalpemilu.org#23206,"SINDANG SARI, KOTABUMI, LAMPUNG UTARA, LAMPUNG",61,78,58,136
https://kawalpemilu.org#23206,"SINDANG SARI, KOTABUMI, LAMPUNG UTARA, LAMPUNG",62,105,70,175
https://kawalpemilu.org#23206,"SINDANG SARI, KOTABUMI, LAMPUNG UTARA, LAMPUNG",63,110,68,178
https://kawalpemilu.org#23206,"SINDANG SARI, KOTABUMI, LAMPUNG UTARA, LAMPUNG",64,113,56,169
https://kawalpemilu.org#23206,"SINDANG SARI, KOTABUMI, LAMPUNG UTARA, LAMPUNG",65,123,51,174
https://kawalpemilu.org#23206,"SINDANG SARI, KOTABUMI, LAMPUNG UTARA, LAMPUNG",66,88,45,133
https://kawalpemilu.org#23206,"SINDANG SARI, KOTABUMI, LAMPUNG UTARA, LAMPUNG",67,48,226,274
https://kawalpemilu.org#23207,"SRI BASUKI, KOTABUMI, LAMPUNG UTARA, LAMPUNG",1,0,0,0
https://kawalpemilu.org#23207,"SRI BASUKI, KOTABUMI, LAMPUNG UTARA, LAMPUNG",2,0,0,0
https://kawalpemilu.org#23207,"SRI BASUKI, KOTABUMI, LAMPUNG UTARA, LAMPUNG",4,0,0,0
https://kawalpemilu.org#23207,"SRI BASUKI, KOTABUMI, LAMPUNG UTARA, LAMPUNG",5,0,0,0
https://kawalpemilu.org#23207,"SRI BASUKI, KOTABUMI, LAMPUNG UTARA, LAMPUNG",6,0,0,0
https://kawalpemilu.org#23207,"SRI BASUKI, KOTABUMI, LAMPUNG UTARA, LAMPUNG",8,0,0,0
https://kawalpemilu.org#23207,"SRI BASUKI, KOTABUMI, LAMPUNG UTARA, LAMPUNG",9,0,0,0
https://kawalpemilu.org#23207,"SRI BASUKI, KOTABUMI, LAMPUNG UTARA, LAMPUNG",10,0,0,0
https://kawalpemilu.org#23207,"SRI BASUKI, KOTABUMI, LAMPUNG UTARA, LAMPUNG",11,0,0,0
https://kawalpemilu.org#23207,"SRI BASUKI, KOTABUMI, LAMPUNG UTARA, LAMPUNG",12,0,0,0
https://kawalpemilu.org#23207,"SRI BASUKI, KOTABUMI, LAMPUNG UTARA, LAMPUNG",13,0,0,0
https://kawalpemilu.org#23207,"SRI BASUKI, KOTABUMI, LAMPUNG UTARA, LAMPUNG",14,0,0,0
https://kawalpemilu.org#23207,"SRI BASUKI, KOTABUMI, LAMPUNG UTARA, LAMPUNG",15,0,0,0
https://kawalpemilu.org#23207,"SRI BASUKI, KOTABUMI, LAMPUNG UTARA, LAMPUNG",16,0,0,0
https://kawalpemilu.org#23207,"SRI BASUKI, KOTABUMI, LAMPUNG UTARA, LAMPUNG",17,0,0,0
https://kawalpemilu.org#23207,"SRI BASUKI, KOTABUMI, LAMPUNG UTARA, LAMPUNG",18,0,0,0
https://kawalpemilu.org#23207,"SRI BASUKI, KOTABUMI, LAMPUNG UTARA, LAMPUNG",20,0,0,0
https://kawalpemilu.org#23207,"SRI BASUKI, KOTABUMI, LAMPUNG UTARA, LAMPUNG",21,0,0,0
https://kawalpemilu.org#23207,"SRI BASUKI, KOTABUMI, LAMPUNG UTARA, LAMPUNG",23,0,0,0
https://kawalpemilu.org#23207,"SRI BASUKI, KOTABUMI, LAMPUNG UTARA, LAMPUNG",24,0,0,0
https://kawalpemilu.org#23207,"SRI BASUKI, KOTABUMI, LAMPUNG UTARA, LAMPUNG",25,0,0,0
https://kawalpemilu.org#23207,"SRI BASUKI, KOTABUMI, LAMPUNG UTARA, LAMPUNG",26,0,0,0
https://kawalpemilu.org#23207,"SRI BASUKI, KOTABUMI, LAMPUNG UTARA, LAMPUNG",27,0,0,0
https://kawalpemilu.org#23207,"SRI BASUKI, KOTABUMI, LAMPUNG UTARA, LAMPUNG",155,30,145,175
https://kawalpemilu.org#23207,"SRI BASUKI, KOTABUMI, LAMPUNG UTARA, LAMPUNG",156,22,172,194
https://kawalpemilu.org#23207,"SRI BASUKI, KOTABUMI, LAMPUNG UTARA, LAMPUNG",157,40,86,126
https://kawalpemilu.org#23207,"SRI BASUKI, KOTABUMI, LAMPUNG UTARA, LAMPUNG",158,61,110,171
https://kawalpemilu.org#23207,"SRI BASUKI, KOTABUMI, LAMPUNG UTARA, LAMPUNG",159,45,111,156
https://kawalpemilu.org#23207,"SRI BASUKI, KOTABUMI, LAMPUNG UTARA, LAMPUNG",160,12,55,67
https://kawalpemilu.org#23207,"SRI BASUKI, KOTABUMI, LAMPUNG UTARA, LAMPUNG",161,44,139,183
https://kawalpemilu.org#23207,"SRI BASUKI, KOTABUMI, LAMPUNG UTARA, LAMPUNG",162,43,160,203
https://kawalpemilu.org#23207,"SRI BASUKI, KOTABUMI, LAMPUNG UTARA, LAMPUNG",163,62,169,231
https://kawalpemilu.org#23207,"SRI BASUKI, KOTABUMI, LAMPUNG UTARA, LAMPUNG",164,71,98,169
https://kawalpemilu.org#23207,"SRI BASUKI, KOTABUMI, LAMPUNG UTARA, LAMPUNG",165,38,126,164
https://kawalpemilu.org#23207,"SRI BASUKI, KOTABUMI, LAMPUNG UTARA, LAMPUNG",166,50,143,193
https://kawalpemilu.org#23207,"SRI BASUKI, KOTABUMI, LAMPUNG UTARA, LAMPUNG",167,27,122,149
https://kawalpemilu.org#23207,"SRI BASUKI, KOTABUMI, LAMPUNG UTARA, LAMPUNG",168,72,138,210
https://kawalpemilu.org#23207,"SRI BASUKI, KOTABUMI, LAMPUNG UTARA, LAMPUNG",169,50,127,177
https://kawalpemilu.org#23207,"SRI BASUKI, KOTABUMI, LAMPUNG UTARA, LAMPUNG",170,32,133,145
https://kawalpemilu.org#23207,"SRI BASUKI, KOTABUMI, LAMPUNG UTARA, LAMPUNG",171,74,105,179
https://kawalpemilu.org#23207,"SRI BASUKI, KOTABUMI, LAMPUNG UTARA, LAMPUNG",172,64,146,210
https://kawalpemilu.org#23207,"SRI BASUKI, KOTABUMI, LAMPUNG UTARA, LAMPUNG",173,36,162,198
https://kawalpemilu.org#23207,"SRI BASUKI, KOTABUMI, LAMPUNG UTARA, LAMPUNG",174,37,112,149
https://kawalpemilu.org#23207,"SRI BASUKI, KOTABUMI, LAMPUNG UTARA, LAMPUNG",175,48,98,146
https://kawalpemilu.org#23207,"SRI BASUKI, KOTABUMI, LAMPUNG UTARA, LAMPUNG",176,20,84,104
https://kawalpemilu.org#23207,"SRI BASUKI, KOTABUMI, LAMPUNG UTARA, LAMPUNG",177,41,111,152
https://kawalpemilu.org#23207,"SRI BASUKI, KOTABUMI, LAMPUNG UTARA, LAMPUNG",178,62,135,197
https://kawalpemilu.org#23207,"SRI BASUKI, KOTABUMI, LAMPUNG UTARA, LAMPUNG",179,33,107,140
https://kawalpemilu.org#23207,"SRI BASUKI, KOTABUMI, LAMPUNG UTARA, LAMPUNG",180,78,154,232
https://kawalpemilu.org#23207,"SRI BASUKI, KOTABUMI, LAMPUNG UTARA, LAMPUNG",181,56,141,197
https://kawalpemilu.org#23207,"SRI BASUKI, KOTABUMI, LAMPUNG UTARA, LAMPUNG",182,96,135,231
https://kawalpemilu.org#23208,"KOTA GAPURA, KOTABUMI, LAMPUNG UTARA, LAMPUNG",1,0,0,0
https://kawalpemilu.org#23208,"KOTA GAPURA, KOTABUMI, LAMPUNG UTARA, LAMPUNG",2,0,0,0
https://kawalpemilu.org#23208,"KOTA GAPURA, KOTABUMI, LAMPUNG UTARA, LAMPUNG",119,26,100,126
https://kawalpemilu.org#23208,"KOTA GAPURA, KOTABUMI, LAMPUNG UTARA, LAMPUNG",120,29,154,183
https://kawalpemilu.org#23208,"KOTA GAPURA, KOTABUMI, LAMPUNG UTARA, LAMPUNG",121,29,140,169
https://kawalpemilu.org#23208,"KOTA GAPURA, KOTABUMI, LAMPUNG UTARA, LAMPUNG",122,17,122,139
https://kawalpemilu.org#23208,"KOTA GAPURA, KOTABUMI, LAMPUNG UTARA, LAMPUNG",123,76,108,184
https://kawalpemilu.org#23208,"KOTA GAPURA, KOTABUMI, LAMPUNG UTARA, LAMPUNG",124,41,131,172
https://kawalpemilu.org#23208,"KOTA GAPURA, KOTABUMI, LAMPUNG UTARA, LAMPUNG",125,62,144,206
https://kawalpemilu.org#23208,"KOTA GAPURA, KOTABUMI, LAMPUNG UTARA, LAMPUNG",126,52,137,189
https://kawalpemilu.org#23208,"KOTA GAPURA, KOTABUMI, LAMPUNG UTARA, LAMPUNG",127,22,97,119
https://kawalpemilu.org#23208,"KOTA GAPURA, KOTABUMI, LAMPUNG UTARA, LAMPUNG",128,48,104,152
https://kawalpemilu.org#23208,"KOTA GAPURA, KOTABUMI, LAMPUNG UTARA, LAMPUNG",129,36,118,154
https://kawalpemilu.org#23208,"KOTA GAPURA, KOTABUMI, LAMPUNG UTARA, LAMPUNG",130,39,120,159
https://kawalpemilu.org#23209,"TALANG BOJONG, KOTABUMI, LAMPUNG UTARA, LAMPUNG",33,42,137,179
https://kawalpemilu.org#23209,"TALANG BOJONG, KOTABUMI, LAMPUNG UTARA, LAMPUNG",35,31,134,165
https://kawalpemilu.org#23209,"TALANG BOJONG, KOTABUMI, LAMPUNG UTARA, LAMPUNG",36,30,119,149
https://kawalpemilu.org#23209,"TALANG BOJONG, KOTABUMI, LAMPUNG UTARA, LAMPUNG",37,29,153,182
https://kawalpemilu.org#23209,"TALANG BOJONG, KOTABUMI, LAMPUNG UTARA, LAMPUNG",38,20,87,107
https://kawalpemilu.org#23209,"TALANG BOJONG, KOTABUMI, LAMPUNG UTARA, LAMPUNG",39,33,67,100
https://kawalpemilu.org#23209,"TALANG BOJONG, KOTABUMI, LAMPUNG UTARA, LAMPUNG",41,30,49,79
https://kawalpemilu.org#23210,"BOJONG BARAT, KOTABUMI, LAMPUNG UTARA, LAMPUNG",46,39,164,203
https://kawalpemilu.org#23210,"BOJONG BARAT, KOTABUMI, LAMPUNG UTARA, LAMPUNG",47,29,128,157
https://kawalpemilu.org#23210,"BOJONG BARAT, KOTABUMI, LAMPUNG UTARA, LAMPUNG",48,38,84,122
https://kawalpemilu.org#23210,"BOJONG BARAT, KOTABUMI, LAMPUNG UTARA, LAMPUNG",49,50,125,175
https://kawalpemilu.org#23211,"KOTABUMI TENGAH BARAT, KOTABUMI, LAMPUNG UTARA, LAMPUNG",1,0,0,0
https://kawalpemilu.org#23211,"KOTABUMI TENGAH BARAT, KOTABUMI, LAMPUNG UTARA, LAMPUNG",2,0,0,0
https://kawalpemilu.org#23211,"KOTABUMI TENGAH BARAT, KOTABUMI, LAMPUNG UTARA, LAMPUNG",3,0,0,0
https://kawalpemilu.org#23211,"KOTABUMI TENGAH BARAT, KOTABUMI, LAMPUNG UTARA, LAMPUNG",42,40,146,186
https://kawalpemilu.org#23211,"KOTABUMI TENGAH BARAT, KOTABUMI, LAMPUNG UTARA, LAMPUNG",43,20,137,157
https://kawalpemilu.org#23211,"KOTABUMI TENGAH BARAT, KOTABUMI, LAMPUNG UTARA, LAMPUNG",44,29,171,200
https://kawalpemilu.org#23211,"KOTABUMI TENGAH BARAT, KOTABUMI, LAMPUNG UTARA, LAMPUNG",45,45,110,155
https://kawalpemilu.org#23212,"SUMBER ARUM, KOTABUMI, LAMPUNG UTARA, LAMPUNG",1,0,0,0
https://kawalpemilu.org#23212,"SUMBER ARUM, KOTABUMI, LAMPUNG UTARA, LAMPUNG",6,0,0,0
https://kawalpemilu.org#23212,"SUMBER ARUM, KOTABUMI, LAMPUNG UTARA, LAMPUNG",8,0,0,0
https://kawalpemilu.org#23212,"SUMBER ARUM, KOTABUMI, LAMPUNG UTARA, LAMPUNG",111,125,36,161
https://kawalpemilu.org#23212,"SUMBER ARUM, KOTABUMI, LAMPUNG UTARA, LAMPUNG",112,124,15,139
https://kawalpemilu.org#23212,"SUMBER ARUM, KOTABUMI, LAMPUNG UTARA, LAMPUNG",113,170,26,196
https://kawalpemilu.org#23212,"SUMBER ARUM, KOTABUMI, LAMPUNG UTARA, LAMPUNG",114,149,10,159
https://kawalpemilu.org#23212,"SUMBER ARUM, KOTABUMI, LAMPUNG UTARA, LAMPUNG",115,130,51,181
https://kawalpemilu.org#23212,"SUMBER ARUM, KOTABUMI, LAMPUNG UTARA, LAMPUNG",116,124,55,179
https://kawalpemilu.org#23212,"SUMBER ARUM, KOTABUMI, LAMPUNG UTARA, LAMPUNG",117,143,26,169
https://kawalpemilu.org#23212,"SUMBER ARUM, KOTABUMI, LAMPUNG UTARA, LAMPUNG",118,90,76,166
https://kawalpemilu.org#23214,"KETAPANG, SUNGKAI SELATAN, LAMPUNG UTARA, LAMPUNG",1,36,130,166
https://kawalpemilu.org#23214,"KETAPANG, SUNGKAI SELATAN, LAMPUNG UTARA, LAMPUNG",2,32,132,164
https://kawalpemilu.org#23214,"KETAPANG, SUNGKAI SELATAN, LAMPUNG UTARA, LAMPUNG",3,31,147,178
https://kawalpemilu.org#23214,"KETAPANG, SUNGKAI SELATAN, LAMPUNG UTARA, LAMPUNG",4,61,97,158
https://kawalpemilu.org#23214,"KETAPANG, SUNGKAI SELATAN, LAMPUNG UTARA, LAMPUNG",5,38,111,149
https://kawalpemilu.org#23214,"KETAPANG, SUNGKAI SELATAN, LAMPUNG UTARA, LAMPUNG",6,58,95,153
https://kawalpemilu.org#23214,"KETAPANG, SUNGKAI SELATAN, LAMPUNG UTARA, LAMPUNG",7,24,96,120
https://kawalpemilu.org#23214,"KETAPANG, SUNGKAI SELATAN, LAMPUNG UTARA, LAMPUNG",8,28,107,135
https://kawalpemilu.org#23214,"KETAPANG, SUNGKAI SELATAN, LAMPUNG UTARA, LAMPUNG",9,45,121,166
https://kawalpemilu.org#23214,"KETAPANG, SUNGKAI SELATAN, LAMPUNG UTARA, LAMPUNG",10,25,90,115
https://kawalpemilu.org#23214,"KETAPANG, SUNGKAI SELATAN, LAMPUNG UTARA, LAMPUNG",11,71,126,197
https://kawalpemilu.org#23214,"KETAPANG, SUNGKAI SELATAN, LAMPUNG UTARA, LAMPUNG",12,68,101,169
https://kawalpemilu.org#23214,"KETAPANG, SUNGKAI SELATAN, LAMPUNG UTARA, LAMPUNG",13,42,114,156
https://kawalpemilu.org#23214,"KETAPANG, SUNGKAI SELATAN, LAMPUNG UTARA, LAMPUNG",14,63,50,113
https://kawalpemilu.org#23214,"KETAPANG, SUNGKAI SELATAN, LAMPUNG UTARA, LAMPUNG",15,66,35,101
https://kawalpemilu.org#23214,"KETAPANG, SUNGKAI SELATAN, LAMPUNG UTARA, LAMPUNG",16,87,80,167
https://kawalpemilu.org#23214,"KETAPANG, SUNGKAI SELATAN, LAMPUNG UTARA, LAMPUNG",17,74,70,144
https://kawalpemilu.org#23214,"KETAPANG, SUNGKAI SELATAN, LAMPUNG UTARA, LAMPUNG",18,85,68,153
https://kawalpemilu.org#23214,"KETAPANG, SUNGKAI SELATAN, LAMPUNG UTARA, LAMPUNG",19,77,86,163
https://kawalpemilu.org#23214,"KETAPANG, SUNGKAI SELATAN, LAMPUNG UTARA, LAMPUNG",20,55,84,139
https://kawalpemilu.org#23214,"KETAPANG, SUNGKAI SELATAN, LAMPUNG UTARA, LAMPUNG",21,71,60,131
https://kawalpemilu.org#23214,"KETAPANG, SUNGKAI SELATAN, LAMPUNG UTARA, LAMPUNG",22,42,113,155
https://kawalpemilu.org#23214,"KETAPANG, SUNGKAI SELATAN, LAMPUNG UTARA, LAMPUNG",23,29,135,164
https://kawalpemilu.org#23214,"KETAPANG, SUNGKAI SELATAN, LAMPUNG UTARA, LAMPUNG",24,31,68,99
https://kawalpemilu.org#23215,"BUMI RATU, SUNGKAI SELATAN, LAMPUNG UTARA, LAMPUNG",1,0,0,0
https://kawalpemilu.org#23215,"BUMI RATU, SUNGKAI SELATAN, LAMPUNG UTARA, LAMPUNG",2,0,0,0
https://kawalpemilu.org#23215,"BUMI RATU, SUNGKAI SELATAN, LAMPUNG UTARA, LAMPUNG",3,0,0,0
https://kawalpemilu.org#23215,"BUMI RATU, SUNGKAI SELATAN, LAMPUNG UTARA, LAMPUNG",4,0,0,0
https://kawalpemilu.org#23215,"BUMI RATU, SUNGKAI SELATAN, LAMPUNG UTARA, LAMPUNG",5,0,0,0
https://kawalpemilu.org#23215,"BUMI RATU, SUNGKAI SELATAN, LAMPUNG UTARA, LAMPUNG",6,0,0,0
https://kawalpemilu.org#23215,"BUMI RATU, SUNGKAI SELATAN, LAMPUNG UTARA, LAMPUNG",7,0,0,0
https://kawalpemilu.org#23215,"BUMI RATU, SUNGKAI SELATAN, LAMPUNG UTARA, LAMPUNG",8,0,0,0
https://kawalpemilu.org#23215,"BUMI RATU, SUNGKAI SELATAN, LAMPUNG UTARA, LAMPUNG",66,7,121,128
https://kawalpemilu.org#23215,"BUMI RATU, SUNGKAI SELATAN, LAMPUNG UTARA, LAMPUNG",67,14,133,147
https://kawalpemilu.org#23215,"BUMI RATU, SUNGKAI SELATAN, LAMPUNG UTARA, LAMPUNG",68,27,134,161
https://kawalpemilu.org#23215,"BUMI RATU, SUNGKAI SELATAN, LAMPUNG UTARA, LAMPUNG",69,103,72,175
https://kawalpemilu.org#23215,"BUMI RATU, SUNGKAI SELATAN, LAMPUNG UTARA, LAMPUNG",70,69,90,159
https://kawalpemilu.org#23215,"BUMI RATU, SUNGKAI SELATAN, LAMPUNG UTARA, LAMPUNG",71,76,143,219
https://kawalpemilu.org#23215,"BUMI RATU, SUNGKAI SELATAN, LAMPUNG UTARA, LAMPUNG",72,88,148,236
https://kawalpemilu.org#23215,"BUMI RATU, SUNGKAI SELATAN, LAMPUNG UTARA, LAMPUNG",73,90,140,230
https://kawalpemilu.org#23216,"LABUHAN RATU PASAR, SUNGKAI SELATAN, LAMPUNG UTARA, LAMPUNG",3,0,0,0
https://kawalpemilu.org#23216,"LABUHAN RATU PASAR, SUNGKAI SELATAN, LAMPUNG UTARA, LAMPUNG",4,0,0,0
https://kawalpemilu.org#23216,"LABUHAN RATU PASAR, SUNGKAI SELATAN, LAMPUNG UTARA, LAMPUNG",55,38,112,150
https://kawalpemilu.org#23216,"LABUHAN RATU PASAR, SUNGKAI SELATAN, LAMPUNG UTARA, LAMPUNG",56,60,78,138
https://kawalpemilu.org#23216,"LABUHAN RATU PASAR, SUNGKAI SELATAN, LAMPUNG UTARA, LAMPUNG",57,80,43,123
https://kawalpemilu.org#23216,"LABUHAN RATU PASAR, SUNGKAI SELATAN, LAMPUNG UTARA, LAMPUNG",58,120,67,187
https://kawalpemilu.org#23216,"LABUHAN RATU PASAR, SUNGKAI SELATAN, LAMPUNG UTARA, LAMPUNG",59,108,55,163
https://kawalpemilu.org#23216,"LABUHAN RATU PASAR, SUNGKAI SELATAN, LAMPUNG UTARA, LAMPUNG",60,121,45,166
https://kawalpemilu.org#23217,"SINAR GALIH, SUNGKAI SELATAN, LAMPUNG UTARA, LAMPUNG",1,0,0,0
https://kawalpemilu.org#23217,"SINAR GALIH, SUNGKAI SELATAN, LAMPUNG UTARA, LAMPUNG",2,0,0,0
https://kawalpemilu.org#23217,"SINAR GALIH, SUNGKAI SELATAN, LAMPUNG UTARA, LAMPUNG",3,0,0,0
https://kawalpemilu.org#23217,"SINAR GALIH, SUNGKAI SELATAN, LAMPUNG UTARA, LAMPUNG",4,0,0,0
https://kawalpemilu.org#23217,"SINAR GALIH, SUNGKAI SELATAN, LAMPUNG UTARA, LAMPUNG",5,0,0,0
https://kawalpemilu.org#23217,"SINAR GALIH, SUNGKAI SELATAN, LAMPUNG UTARA, LAMPUNG",61,149,71,220
https://kawalpemilu.org#23217,"SINAR GALIH, SUNGKAI SELATAN, LAMPUNG UTARA, LAMPUNG",62,32,120,152
https://kawalpemilu.org#23217,"SINAR GALIH, SUNGKAI SELATAN, LAMPUNG UTARA, LAMPUNG",63,22,64,86
https://kawalpemilu.org#23217,"SINAR GALIH, SUNGKAI SELATAN, LAMPUNG UTARA, LAMPUNG",64,11,76,87
https://kawalpemilu.org#23217,"SINAR GALIH, SUNGKAI SELATAN, LAMPUNG UTARA, LAMPUNG",65,27,107,134
https://kawalpemilu.org#23218,"LABUHAN RATU KAMPUNG, SUNGKAI SELATAN, LAMPUNG UTARA, LAMPUNG",1,0,0,0
https://kawalpemilu.org#23218,"LABUHAN RATU KAMPUNG, SUNGKAI SELATAN, LAMPUNG UTARA, LAMPUNG",3,0,0,0
https://kawalpemilu.org#23218,"LABUHAN RATU KAMPUNG, SUNGKAI SELATAN, LAMPUNG UTARA, LAMPUNG",52,25,156,181
https://kawalpemilu.org#23218,"LABUHAN RATU KAMPUNG, SUNGKAI SELATAN, LAMPUNG UTARA, LAMPUNG",53,92,114,206
https://kawalpemilu.org#23218,"LABUHAN RATU KAMPUNG, SUNGKAI SELATAN, LAMPUNG UTARA, LAMPUNG",54,92,59,151
https://kawalpemilu.org#23219,"GEDUNG KETAPANG, SUNGKAI SELATAN, LAMPUNG UTARA, LAMPUNG",1,0,0,0
https://kawalpemilu.org#23219,"GEDUNG KETAPANG, SUNGKAI SELATAN, LAMPUNG UTARA, LAMPUNG",2,0,0,0
https://kawalpemilu.org#23219,"GEDUNG KETAPANG, SUNGKAI SELATAN, LAMPUNG UTARA, LAMPUNG",3,0,0,0
https://kawalpemilu.org#23219,"GEDUNG KETAPANG, SUNGKAI SELATAN, LAMPUNG UTARA, LAMPUNG",4,0,0,0
https://kawalpemilu.org#23219,"GEDUNG KETAPANG, SUNGKAI SELATAN, LAMPUNG UTARA, LAMPUNG",5,0,0,0
https://kawalpemilu.org#23219,"GEDUNG KETAPANG, SUNGKAI SELATAN, LAMPUNG UTARA, LAMPUNG",8,0,0,0
https://kawalpemilu.org#23219,"GEDUNG KETAPANG, SUNGKAI SELATAN, LAMPUNG UTARA, LAMPUNG",9,0,0,0
https://kawalpemilu.org#23219,"GEDUNG KETAPANG, SUNGKAI SELATAN, LAMPUNG UTARA, LAMPUNG",31,24,150,174
https://kawalpemilu.org#23219,"GEDUNG KETAPANG, SUNGKAI SELATAN, LAMPUNG UTARA, LAMPUNG",32,10,122,132
https://kawalpemilu.org#23219,"GEDUNG KETAPANG, SUNGKAI SELATAN, LAMPUNG UTARA, LAMPUNG",33,35,135,170
https://kawalpemilu.org#23219,"GEDUNG KETAPANG, SUNGKAI SELATAN, LAMPUNG UTARA, LAMPUNG",34,15,165,180
https://kawalpemilu.org#23219,"GEDUNG KETAPANG, SUNGKAI SELATAN, LAMPUNG UTARA, LAMPUNG",35,81,140,221
https://kawalpemilu.org#23219,"GEDUNG KETAPANG, SUNGKAI SELATAN, LAMPUNG UTARA, LAMPUNG",36,119,124,243
https://kawalpemilu.org#23219,"GEDUNG KETAPANG, SUNGKAI SELATAN, LAMPUNG UTARA, LAMPUNG",37,84,71,155
https://kawalpemilu.org#23219,"GEDUNG KETAPANG, SUNGKAI SELATAN, LAMPUNG UTARA, LAMPUNG",38,83,110,193
https://kawalpemilu.org#23219,"GEDUNG KETAPANG, SUNGKAI SELATAN, LAMPUNG UTARA, LAMPUNG",39,62,110,172
https://kawalpemilu.org#23220,"KOTA AGUNG, SUNGKAI SELATAN, LAMPUNG UTARA, LAMPUNG",1,0,0,0
https://kawalpemilu.org#23220,"KOTA AGUNG, SUNGKAI SELATAN, LAMPUNG UTARA, LAMPUNG",2,0,0,0
https://kawalpemilu.org#23220,"KOTA AGUNG, SUNGKAI SELATAN, LAMPUNG UTARA, LAMPUNG",3,0,0,0
https://kawalpemilu.org#23220,"KOTA AGUNG, SUNGKAI SELATAN, LAMPUNG UTARA, LAMPUNG",4,0,0,0
https://kawalpemilu.org#23220,"KOTA AGUNG, SUNGKAI SELATAN, LAMPUNG UTARA, LAMPUNG",5,0,0,0
https://kawalpemilu.org#23220,"KOTA AGUNG, SUNGKAI SELATAN, LAMPUNG UTARA, LAMPUNG",6,0,0,0
https://kawalpemilu.org#23220,"KOTA AGUNG, SUNGKAI SELATAN, LAMPUNG UTARA, LAMPUNG",25,5,142,147
https://kawalpemilu.org#23220,"KOTA AGUNG, SUNGKAI SELATAN, LAMPUNG UTARA, LAMPUNG",26,20,181,201
https://kawalpemilu.org#23220,"KOTA AGUNG, SUNGKAI SELATAN, LAMPUNG UTARA, LAMPUNG",27,38,87,125
https://kawalpemilu.org#23220,"KOTA AGUNG, SUNGKAI SELATAN, LAMPUNG UTARA, LAMPUNG",28,26,87,113
https://kawalpemilu.org#23220,"KOTA AGUNG, SUNGKAI SELATAN, LAMPUNG UTARA, LAMPUNG",29,170,64,234
https://kawalpemilu.org#23220,"KOTA AGUNG, SUNGKAI SELATAN, LAMPUNG UTARA, LAMPUNG",30,181,63,244
https://kawalpemilu.org#23221,"KARANG REJO I, SUNGKAI SELATAN, LAMPUNG UTARA, LAMPUNG",1,0,0,0
https://kawalpemilu.org#23221,"KARANG REJO I, SUNGKAI SELATAN, LAMPUNG UTARA, LAMPUNG",5,0,0,0
https://kawalpemilu.org#23221,"KARANG REJO I, SUNGKAI SELATAN, LAMPUNG UTARA, LAMPUNG",43,83,99,182
https://kawalpemilu.org#23221,"KARANG REJO I, SUNGKAI SELATAN, LAMPUNG UTARA, LAMPUNG",44,56,123,179
https://kawalpemilu.org#23221,"KARANG REJO I, SUNGKAI SELATAN, LAMPUNG UTARA, LAMPUNG",45,84,101,185
https://kawalpemilu.org#23221,"KARANG REJO I, SUNGKAI SELATAN, LAMPUNG UTARA, LAMPUNG",46,76,119,195
https://kawalpemilu.org#23221,"KARANG REJO I, SUNGKAI SELATAN, LAMPUNG UTARA, LAMPUNG",47,55,117,172
https://kawalpemilu.org#23222,"BANJAR KETAPANG, SUNGKAI SELATAN, LAMPUNG UTARA, LAMPUNG",1,0,0,0
https://kawalpemilu.org#23222,"BANJAR KETAPANG, SUNGKAI SELATAN, LAMPUNG UTARA, LAMPUNG",2,0,0,0
https://kawalpemilu.org#23222,"BANJAR KETAPANG, SUNGKAI SELATAN, LAMPUNG UTARA, LAMPUNG",3,0,0,0
https://kawalpemilu.org#23222,"BANJAR KETAPANG, SUNGKAI SELATAN, LAMPUNG UTARA, LAMPUNG",41,51,139,190
https://kawalpemilu.org#23222,"BANJAR KETAPANG, SUNGKAI SELATAN, LAMPUNG UTARA, LAMPUNG",42,55,72,127
https://kawalpemilu.org#23223,"SIDODADI, SUNGKAI SELATAN, LAMPUNG UTARA, LAMPUNG",1,0,0,0
https://kawalpemilu.org#23223,"SIDODADI, SUNGKAI SELATAN, LAMPUNG UTARA, LAMPUNG",2,0,0,0
https://kawalpemilu.org#23223,"SIDODADI, SUNGKAI SELATAN, LAMPUNG UTARA, LAMPUNG",3,0,0,0
https://kawalpemilu.org#23223,"SIDODADI, SUNGKAI SELATAN, LAMPUNG UTARA, LAMPUNG",4,0,0,0
https://kawalpemilu.org#23223,"SIDODADI, SUNGKAI SELATAN, LAMPUNG UTARA, LAMPUNG",48,79,100,179
https://kawalpemilu.org#23223,"SIDODADI, SUNGKAI SELATAN, LAMPUNG UTARA, LAMPUNG",49,74,139,213
https://kawalpemilu.org#23223,"SIDODADI, SUNGKAI SELATAN, LAMPUNG UTARA, LAMPUNG",50,71,120,191
https://kawalpemilu.org#23223,"SIDODADI, SUNGKAI SELATAN, LAMPUNG UTARA, LAMPUNG",51,97,103,200
https://kawalpemilu.org#23224,"GUNUNG LABUHAN, SUNGKAI SELATAN, LAMPUNG UTARA, LAMPUNG",1,0,0,0
https://kawalpemilu.org#23224,"GUNUNG LABUHAN, SUNGKAI SELATAN, LAMPUNG UTARA, LAMPUNG",2,0,0,0
https://kawalpemilu.org#23224,"GUNUNG LABUHAN, SUNGKAI SELATAN, LAMPUNG UTARA, LAMPUNG",3,0,0,0
https://kawalpemilu.org#23224,"GUNUNG LABUHAN, SUNGKAI SELATAN, LAMPUNG UTARA, LAMPUNG",4,0,0,0
https://kawalpemilu.org#23224,"GUNUNG LABUHAN, SUNGKAI SELATAN, LAMPUNG UTARA, LAMPUNG",5,0,0,0
https://kawalpemilu.org#23224,"GUNUNG LABUHAN, SUNGKAI SELATAN, LAMPUNG UTARA, LAMPUNG",74,64,105,169
https://kawalpemilu.org#23224,"GUNUNG LABUHAN, SUNGKAI SELATAN, LAMPUNG UTARA, LAMPUNG",75,29,126,155
https://kawalpemilu.org#23224,"GUNUNG LABUHAN, SUNGKAI SELATAN, LAMPUNG UTARA, LAMPUNG",76,26,120,146
https://kawalpemilu.org#23224,"GUNUNG LABUHAN, SUNGKAI SELATAN, LAMPUNG UTARA, LAMPUNG",77,13,152,165
https://kawalpemilu.org#23224,"GUNUNG LABUHAN, SUNGKAI SELATAN, LAMPUNG UTARA, LAMPUNG",78,22,157,179
https://kawalpemilu.org#23227,"SUKA SARI, TANJUNG RAJA, LAMPUNG UTARA, LAMPUNG",2,0,0,0
https://kawalpemilu.org#23227,"SUKA SARI, TANJUNG RAJA, LAMPUNG UTARA, LAMPUNG",3,0,0,0
https://kawalpemilu.org#23227,"SUKA SARI, TANJUNG RAJA, LAMPUNG UTARA, LAMPUNG",4,0,0,0
https://kawalpemilu.org#23227,"SUKA SARI, TANJUNG RAJA, LAMPUNG UTARA, LAMPUNG",5,0,0,0
https://kawalpemilu.org#23227,"SUKA SARI, TANJUNG RAJA, LAMPUNG UTARA, LAMPUNG",6,0,0,0
https://kawalpemilu.org#23227,"SUKA SARI, TANJUNG RAJA, LAMPUNG UTARA, LAMPUNG",7,0,0,0
https://kawalpemilu.org#23227,"SUKA SARI, TANJUNG RAJA, LAMPUNG UTARA, LAMPUNG",90,52,113,165
https://kawalpemilu.org#23227,"SUKA SARI, TANJUNG RAJA, LAMPUNG UTARA, LAMPUNG",91,113,125,238
https://kawalpemilu.org#23227,"SUKA SARI, TANJUNG RAJA, LAMPUNG UTARA, LAMPUNG",92,101,95,196
https://kawalpemilu.org#23227,"SUKA SARI, TANJUNG RAJA, LAMPUNG UTARA, LAMPUNG",93,57,81,138
https://kawalpemilu.org#23227,"SUKA SARI, TANJUNG RAJA, LAMPUNG UTARA, LAMPUNG",94,94,86,180
https://kawalpemilu.org#23227,"SUKA SARI, TANJUNG RAJA, LAMPUNG UTARA, LAMPUNG",95,98,69,167
https://kawalpemilu.org#23227,"SUKA SARI, TANJUNG RAJA, LAMPUNG UTARA, LAMPUNG",96,59,25,84
https://kawalpemilu.org#23228,"MERAMBUNG, TANJUNG RAJA, LAMPUNG UTARA, LAMPUNG",71,52,157,209
https://kawalpemilu.org#23228,"MERAMBUNG, TANJUNG RAJA, LAMPUNG UTARA, LAMPUNG",72,29,184,213
https://kawalpemilu.org#23228,"MERAMBUNG, TANJUNG RAJA, LAMPUNG UTARA, LAMPUNG",74,61,101,162
https://kawalpemilu.org#23228,"MERAMBUNG, TANJUNG RAJA, LAMPUNG UTARA, LAMPUNG",75,29,86,115
https://kawalpemilu.org#23228,"MERAMBUNG, TANJUNG RAJA, LAMPUNG UTARA, LAMPUNG",76,14,61,75
https://kawalpemilu.org#23228,"MERAMBUNG, TANJUNG RAJA, LAMPUNG UTARA, LAMPUNG",77,22,93,115
https://kawalpemilu.org#23228,"MERAMBUNG, TANJUNG RAJA, LAMPUNG UTARA, LAMPUNG",78,89,67,156
https://kawalpemilu.org#23228,"MERAMBUNG, TANJUNG RAJA, LAMPUNG UTARA, LAMPUNG",79,97,35,132
https://kawalpemilu.org#23229,"SINAR JAYA, TANJUNG RAJA, LAMPUNG UTARA, LAMPUNG",1,0,0,0
https://kawalpemilu.org#23229,"SINAR JAYA, TANJUNG RAJA, LAMPUNG UTARA, LAMPUNG",2,0,0,0
https://kawalpemilu.org#23229,"SINAR JAYA, TANJUNG RAJA, LAMPUNG UTARA, LAMPUNG",3,0,0,0
https://kawalpemilu.org#23229,"SINAR JAYA, TANJUNG RAJA, LAMPUNG UTARA, LAMPUNG",4,0,0,0
https://kawalpemilu.org#23229,"SINAR JAYA, TANJUNG RAJA, LAMPUNG UTARA, LAMPUNG",5,0,0,0
https://kawalpemilu.org#23229,"SINAR JAYA, TANJUNG RAJA, LAMPUNG UTARA, LAMPUNG",80,50,170,220
https://kawalpemilu.org#23229,"SINAR JAYA, TANJUNG RAJA, LAMPUNG UTARA, LAMPUNG",81,37,172,209
https://kawalpemilu.org#23229,"SINAR JAYA, TANJUNG RAJA, LAMPUNG UTARA, LAMPUNG",82,57,95,152
https://kawalpemilu.org#23229,"SINAR JAYA, TANJUNG RAJA, LAMPUNG UTARA, LAMPUNG",83,101,134,235
https://kawalpemilu.org#23229,"SINAR JAYA, TANJUNG RAJA, LAMPUNG UTARA, LAMPUNG",84,79,80,159
https://kawalpemilu.org#23230,"SINDANG AGUNG, TANJUNG RAJA, LAMPUNG UTARA, LAMPUNG",6,0,0,0
https://kawalpemilu.org#23230,"SINDANG AGUNG, TANJUNG RAJA, LAMPUNG UTARA, LAMPUNG",11,0,0,0
https://kawalpemilu.org#23230,"SINDANG AGUNG, TANJUNG RAJA, LAMPUNG UTARA, LAMPUNG",12,0,0,0
https://kawalpemilu.org#23230,"SINDANG AGUNG, TANJUNG RAJA, LAMPUNG UTARA, LAMPUNG",28,122,67,189
https://kawalpemilu.org#23230,"SINDANG AGUNG, TANJUNG RAJA, LAMPUNG UTARA, LAMPUNG",29,71,120,191
https://kawalpemilu.org#23230,"SINDANG AGUNG, TANJUNG RAJA, LAMPUNG UTARA, LAMPUNG",30,46,113,159
https://kawalpemilu.org#23230,"SINDANG AGUNG, TANJUNG RAJA, LAMPUNG UTARA, LAMPUNG",31,39,161,200
https://kawalpemilu.org#23230,"SINDANG AGUNG, TANJUNG RAJA, LAMPUNG UTARA, LAMPUNG",32,29,113,142
https://kawalpemilu.org#23230,"SINDANG AGUNG, TANJUNG RAJA, LAMPUNG UTARA, LAMPUNG",33,17,166,183
https://kawalpemilu.org#23230,"SINDANG AGUNG, TANJUNG RAJA, LAMPUNG UTARA, LAMPUNG",34,141,64,205
https://kawalpemilu.org#23230,"SINDANG AGUNG, TANJUNG RAJA, LAMPUNG UTARA, LAMPUNG",35,115,43,158
https://kawalpemilu.org#23230,"SINDANG AGUNG, TANJUNG RAJA, LAMPUNG UTARA, LAMPUNG",36,35,110,145
https://kawalpemilu.org#23230,"SINDANG AGUNG, TANJUNG RAJA, LAMPUNG UTARA, LAMPUNG",37,50,91,141
https://kawalpemilu.org#23230,"SINDANG AGUNG, TANJUNG RAJA, LAMPUNG UTARA, LAMPUNG",38,30,84,114
https://kawalpemilu.org#23230,"SINDANG AGUNG, TANJUNG RAJA, LAMPUNG UTARA, LAMPUNG",39,15,97,112
https://kawalpemilu.org#23231,"MEKAR JAYA, TANJUNG RAJA, LAMPUNG UTARA, LAMPUNG",1,0,0,0
https://kawalpemilu.org#23231,"MEKAR JAYA, TANJUNG RAJA, LAMPUNG UTARA, LAMPUNG",2,0,0,0
https://kawalpemilu.org#23231,"MEKAR JAYA, TANJUNG RAJA, LAMPUNG UTARA, LAMPUNG",3,0,0,0
https://kawalpemilu.org#23231,"MEKAR JAYA, TANJUNG RAJA, LAMPUNG UTARA, LAMPUNG",20,114,109,223
https://kawalpemilu.org#23231,"MEKAR JAYA, TANJUNG RAJA, LAMPUNG UTARA, LAMPUNG",21,44,204,248
https://kawalpemilu.org#23231,"MEKAR JAYA, TANJUNG RAJA, LAMPUNG UTARA, LAMPUNG",22,38,113,151
https://kawalpemilu.org#23231,"MEKAR JAYA, TANJUNG RAJA, LAMPUNG UTARA, LAMPUNG",23,28,112,140
https://kawalpemilu.org#23231,"MEKAR JAYA, TANJUNG RAJA, LAMPUNG UTARA, LAMPUNG",24,25,121,146
https://kawalpemilu.org#23231,"MEKAR JAYA, TANJUNG RAJA, LAMPUNG UTARA, LAMPUNG",25,90,162,252
https://kawalpemilu.org#23231,"MEKAR JAYA, TANJUNG RAJA, LAMPUNG UTARA, LAMPUNG",26,41,112,153
https://kawalpemilu.org#23232,"SRI MENANTI, TANJUNG RAJA, LAMPUNG UTARA, LAMPUNG",2,0,0,0
https://kawalpemilu.org#23232,"SRI MENANTI, TANJUNG RAJA, LAMPUNG UTARA, LAMPUNG",3,0,0,0
https://kawalpemilu.org#23232,"SRI MENANTI, TANJUNG RAJA, LAMPUNG UTARA, LAMPUNG",5,0,0,0
https://kawalpemilu.org#23232,"SRI MENANTI, TANJUNG RAJA, LAMPUNG UTARA, LAMPUNG",12,90,87,177
https://kawalpemilu.org#23232,"SRI MENANTI, TANJUNG RAJA, LAMPUNG UTARA, LAMPUNG",13,68,104,172
https://kawalpemilu.org#23232,"SRI MENANTI, TANJUNG RAJA, LAMPUNG UTARA, LAMPUNG",14,41,117,158
https://kawalpemilu.org#23232,"SRI MENANTI, TANJUNG RAJA, LAMPUNG UTARA, LAMPUNG",15,55,141,196
https://kawalpemilu.org#23232,"SRI MENANTI, TANJUNG RAJA, LAMPUNG UTARA, LAMPUNG",16,56,121,177
https://kawalpemilu.org#23232,"SRI MENANTI, TANJUNG RAJA, LAMPUNG UTARA, LAMPUNG",17,55,180,235
https://kawalpemilu.org#23232,"SRI MENANTI, TANJUNG RAJA, LAMPUNG UTARA, LAMPUNG",18,71,135,206
https://kawalpemilu.org#23232,"SRI MENANTI, TANJUNG RAJA, LAMPUNG UTARA, LAMPUNG",19,54,127,181
https://kawalpemilu.org#23233,"TULUNG BALAK, TANJUNG RAJA, LAMPUNG UTARA, LAMPUNG",40,29,142,171
https://kawalpemilu.org#23233,"TULUNG BALAK, TANJUNG RAJA, LAMPUNG UTARA, LAMPUNG",41,31,135,166
https://kawalpemilu.org#23233,"TULUNG BALAK, TANJUNG RAJA, LAMPUNG UTARA, LAMPUNG",42,106,144,250
https://kawalpemilu.org#23234,"KARANG WARINGIN, TANJUNG RAJA, LAMPUNG UTARA, LAMPUNG",1,0,0,0
https://kawalpemilu.org#23234,"KARANG WARINGIN, TANJUNG RAJA, LAMPUNG UTARA, LAMPUNG",97,94,83,177
https://kawalpemilu.org#23234,"KARANG WARINGIN, TANJUNG RAJA, LAMPUNG UTARA, LAMPUNG",98,95,137,232
https://kawalpemilu.org#23234,"KARANG WARINGIN, TANJUNG RAJA, LAMPUNG UTARA, LAMPUNG",99,107,114,221
https://kawalpemilu.org#23234,"KARANG WARINGIN, TANJUNG RAJA, LAMPUNG UTARA, LAMPUNG",100,88,133,221
https://kawalpemilu.org#23235,"TANJUNG RIANG, TANJUNG RAJA, LAMPUNG UTARA, LAMPUNG",1,0,0,0
https://kawalpemilu.org#23235,"TANJUNG RIANG, TANJUNG RAJA, LAMPUNG UTARA, LAMPUNG",2,0,0,0
https://kawalpemilu.org#23235,"TANJUNG RIANG, TANJUNG RAJA, LAMPUNG UTARA, LAMPUNG",3,0,0,0
https://kawalpemilu.org#23235,"TANJUNG RIANG, TANJUNG RAJA, LAMPUNG UTARA, LAMPUNG",52,24,38,62
https://kawalpemilu.org#23235,"TANJUNG RIANG, TANJUNG RAJA, LAMPUNG UTARA, LAMPUNG",53,18,179,197
https://kawalpemilu.org#23235,"TANJUNG RIANG, TANJUNG RAJA, LAMPUNG UTARA, LAMPUNG",54,84,120,204
https://kawalpemilu.org#23236,"KEMALA RAJA, TANJUNG RAJA, LAMPUNG UTARA, LAMPUNG",2,0,0,0
https://kawalpemilu.org#23236,"KEMALA RAJA, TANJUNG RAJA, LAMPUNG UTARA, LAMPUNG",62,31,59,90
https://kawalpemilu.org#23236,"KEMALA RAJA, TANJUNG RAJA, LAMPUNG UTARA, LAMPUNG",63,28,117,145
https://kawalpemilu.org#23236,"KEMALA RAJA, TANJUNG RAJA, LAMPUNG UTARA, LAMPUNG",64,36,122,158
https://kawalpemilu.org#23236,"KEMALA RAJA, TANJUNG RAJA, LAMPUNG UTARA, LAMPUNG",65,29,124,153
https://kawalpemilu.org#23236,"KEMALA RAJA, TANJUNG RAJA, LAMPUNG UTARA, LAMPUNG",66,18,147,165
https://kawalpemilu.org#23237,"SINDANG MARGA, TANJUNG RAJA, LAMPUNG UTARA, LAMPUNG",49,54,147,201
https://kawalpemilu.org#23237,"SINDANG MARGA, TANJUNG RAJA, LAMPUNG UTARA, LAMPUNG",50,33,108,141
https://kawalpemilu.org#23237,"SINDANG MARGA, TANJUNG RAJA, LAMPUNG UTARA, LAMPUNG",51,17,95,112
https://kawalpemilu.org#23238,"ULAK ATA, TANJUNG RAJA, LAMPUNG UTARA, LAMPUNG",2,0,0,0
https://kawalpemilu.org#23238,"ULAK ATA, TANJUNG RAJA, LAMPUNG UTARA, LAMPUNG",3,0,0,0
https://kawalpemilu.org#23238,"ULAK ATA, TANJUNG RAJA, LAMPUNG UTARA, LAMPUNG",4,0,0,0
https://kawalpemilu.org#23238,"ULAK ATA, TANJUNG RAJA, LAMPUNG UTARA, LAMPUNG",5,0,0,0
https://kawalpemilu.org#23238,"ULAK ATA, TANJUNG RAJA, LAMPUNG UTARA, LAMPUNG",6,0,0,0
https://kawalpemilu.org#23238,"ULAK ATA, TANJUNG RAJA, LAMPUNG UTARA, LAMPUNG",44,32,101,133
https://kawalpemilu.org#23238,"ULAK ATA, TANJUNG RAJA, LAMPUNG UTARA, LAMPUNG",45,43,104,147
https://kawalpemilu.org#23238,"ULAK ATA, TANJUNG RAJA, LAMPUNG UTARA, LAMPUNG",46,53,101,154
https://kawalpemilu.org#23238,"ULAK ATA, TANJUNG RAJA, LAMPUNG UTARA, LAMPUNG",47,95,123,218
https://kawalpemilu.org#23238,"ULAK ATA, TANJUNG RAJA, LAMPUNG UTARA, LAMPUNG",48,66,134,200
https://kawalpemilu.org#23239,"GUNUNG KATON, TANJUNG RAJA, LAMPUNG UTARA, LAMPUNG",1,0,0,0
https://kawalpemilu.org#23239,"GUNUNG KATON, TANJUNG RAJA, LAMPUNG UTARA, LAMPUNG",2,0,0,0
https://kawalpemilu.org#23239,"GUNUNG KATON, TANJUNG RAJA, LAMPUNG UTARA, LAMPUNG",3,0,0,0
https://kawalpemilu.org#23239,"GUNUNG KATON, TANJUNG RAJA, LAMPUNG UTARA, LAMPUNG",107,136,72,208
https://kawalpemilu.org#23239,"GUNUNG KATON, TANJUNG RAJA, LAMPUNG UTARA, LAMPUNG",108,159,54,213
https://kawalpemilu.org#23239,"GUNUNG KATON, TANJUNG RAJA, LAMPUNG UTARA, LAMPUNG",109,98,130,228
https://kawalpemilu.org#23240,"SUKA MULYA, TANJUNG RAJA, LAMPUNG UTARA, LAMPUNG",1,0,0,0
https://kawalpemilu.org#23240,"SUKA MULYA, TANJUNG RAJA, LAMPUNG UTARA, LAMPUNG",2,0,0,0
https://kawalpemilu.org#23240,"SUKA MULYA, TANJUNG RAJA, LAMPUNG UTARA, LAMPUNG",3,0,0,0
https://kawalpemilu.org#23240,"SUKA MULYA, TANJUNG RAJA, LAMPUNG UTARA, LAMPUNG",5,0,0,0
https://kawalpemilu.org#23240,"SUKA MULYA, TANJUNG RAJA, LAMPUNG UTARA, LAMPUNG",6,0,0,0
https://kawalpemilu.org#23240,"SUKA MULYA, TANJUNG RAJA, LAMPUNG UTARA, LAMPUNG",101,118,55,173
https://kawalpemilu.org#23240,"SUKA MULYA, TANJUNG RAJA, LAMPUNG UTARA, LAMPUNG",102,144,61,205
https://kawalpemilu.org#23240,"SUKA MULYA, TANJUNG RAJA, LAMPUNG UTARA, LAMPUNG",103,89,62,151
https://kawalpemilu.org#23240,"SUKA MULYA, TANJUNG RAJA, LAMPUNG UTARA, LAMPUNG",104,120,83,203
https://kawalpemilu.org#23240,"SUKA MULYA, TANJUNG RAJA, LAMPUNG UTARA, LAMPUNG",105,200,19,219
https://kawalpemilu.org#23240,"SUKA MULYA, TANJUNG RAJA, LAMPUNG UTARA, LAMPUNG",106,33,8,41
https://kawalpemilu.org#23241,"TANJUNG BERINGIN, TANJUNG RAJA, LAMPUNG UTARA, LAMPUNG",1,0,0,0
https://kawalpemilu.org#23241,"TANJUNG BERINGIN, TANJUNG RAJA, LAMPUNG UTARA, LAMPUNG",2,0,0,0
https://kawalpemilu.org#23241,"TANJUNG BERINGIN, TANJUNG RAJA, LAMPUNG UTARA, LAMPUNG",3,0,0,0
https://kawalpemilu.org#23241,"TANJUNG BERINGIN, TANJUNG RAJA, LAMPUNG UTARA, LAMPUNG",4,0,0,0
https://kawalpemilu.org#23241,"TANJUNG BERINGIN, TANJUNG RAJA, LAMPUNG UTARA, LAMPUNG",5,0,0,0
https://kawalpemilu.org#23241,"TANJUNG BERINGIN, TANJUNG RAJA, LAMPUNG UTARA, LAMPUNG",85,66,140,206
https://kawalpemilu.org#23241,"TANJUNG BERINGIN, TANJUNG RAJA, LAMPUNG UTARA, LAMPUNG",86,39,101,140
https://kawalpemilu.org#23241,"TANJUNG BERINGIN, TANJUNG RAJA, LAMPUNG UTARA, LAMPUNG",87,67,89,156
https://kawalpemilu.org#23241,"TANJUNG BERINGIN, TANJUNG RAJA, LAMPUNG UTARA, LAMPUNG",88,46,161,207
https://kawalpemilu.org#23241,"TANJUNG BERINGIN, TANJUNG RAJA, LAMPUNG UTARA, LAMPUNG",89,98,49,147
https://kawalpemilu.org#23242,"SIDO MULYO, TANJUNG RAJA, LAMPUNG UTARA, LAMPUNG",1,0,0,0
https://kawalpemilu.org#23242,"SIDO MULYO, TANJUNG RAJA, LAMPUNG UTARA, LAMPUNG",2,0,0,0
https://kawalpemilu.org#23242,"SIDO MULYO, TANJUNG RAJA, LAMPUNG UTARA, LAMPUNG",3,0,0,0
https://kawalpemilu.org#23242,"SIDO MULYO, TANJUNG RAJA, LAMPUNG UTARA, LAMPUNG",59,104,51,155
https://kawalpemilu.org#23242,"SIDO MULYO, TANJUNG RAJA, LAMPUNG UTARA, LAMPUNG",60,95,65,160
https://kawalpemilu.org#23242,"SIDO MULYO, TANJUNG RAJA, LAMPUNG UTARA, LAMPUNG",61,87,63,150
https://kawalpemilu.org#23243,"SINAR MULYA, TANJUNG RAJA, LAMPUNG UTARA, LAMPUNG",2,0,0,0
https://kawalpemilu.org#23243,"SINAR MULYA, TANJUNG RAJA, LAMPUNG UTARA, LAMPUNG",4,0,0,0
https://kawalpemilu.org#23243,"SINAR MULYA, TANJUNG RAJA, LAMPUNG UTARA, LAMPUNG",55,31,90,121
https://kawalpemilu.org#23243,"SINAR MULYA, TANJUNG RAJA, LAMPUNG UTARA, LAMPUNG",56,26,93,119
https://kawalpemilu.org#23243,"SINAR MULYA, TANJUNG RAJA, LAMPUNG UTARA, LAMPUNG",57,23,93,116
https://kawalpemilu.org#23243,"SINAR MULYA, TANJUNG RAJA, LAMPUNG UTARA, LAMPUNG",58,23,105,128
https://kawalpemilu.org#23244,"PRIANGAN BARU, TANJUNG RAJA, LAMPUNG UTARA, LAMPUNG",2,0,0,0
https://kawalpemilu.org#23244,"PRIANGAN BARU, TANJUNG RAJA, LAMPUNG UTARA, LAMPUNG",3,0,0,0
https://kawalpemilu.org#23244,"PRIANGAN BARU, TANJUNG RAJA, LAMPUNG UTARA, LAMPUNG",4,0,0,0
https://kawalpemilu.org#23244,"PRIANGAN BARU, TANJUNG RAJA, LAMPUNG UTARA, LAMPUNG",67,37,120,157
https://kawalpemilu.org#23244,"PRIANGAN BARU, TANJUNG RAJA, LAMPUNG UTARA, LAMPUNG",68,31,131,162
https://kawalpemilu.org#23244,"PRIANGAN BARU, TANJUNG RAJA, LAMPUNG UTARA, LAMPUNG",69,28,78,106
https://kawalpemilu.org#23244,"PRIANGAN BARU, TANJUNG RAJA, LAMPUNG UTARA, LAMPUNG",70,39,100,139
https://kawalpemilu.org#84801,"TANJUNG RAJA, TANJUNG RAJA, LAMPUNG UTARA, LAMPUNG",1,48,148,196
https://kawalpemilu.org#84801,"TANJUNG RAJA, TANJUNG RAJA, LAMPUNG UTARA, LAMPUNG",2,75,123,198
https://kawalpemilu.org#84801,"TANJUNG RAJA, TANJUNG RAJA, LAMPUNG UTARA, LAMPUNG",3,43,168,211
https://kawalpemilu.org#84801,"TANJUNG RAJA, TANJUNG RAJA, LAMPUNG UTARA, LAMPUNG",4,36,126,162
https://kawalpemilu.org#84801,"TANJUNG RAJA, TANJUNG RAJA, LAMPUNG UTARA, LAMPUNG",5,21,137,158
https://kawalpemilu.org#84801,"TANJUNG RAJA, TANJUNG RAJA, LAMPUNG UTARA, LAMPUNG",6,61,146,207
https://kawalpemilu.org#84801,"TANJUNG RAJA, TANJUNG RAJA, LAMPUNG UTARA, LAMPUNG",7,52,104,156
https://kawalpemilu.org#84801,"TANJUNG RAJA, TANJUNG RAJA, LAMPUNG UTARA, LAMPUNG",8,52,196,248
https://kawalpemilu.org#84801,"TANJUNG RAJA, TANJUNG RAJA, LAMPUNG UTARA, LAMPUNG",9,49,190,239
https://kawalpemilu.org#84801,"TANJUNG RAJA, TANJUNG RAJA, LAMPUNG UTARA, LAMPUNG",10,53,157,210
https://kawalpemilu.org#84801,"TANJUNG RAJA, TANJUNG RAJA, LAMPUNG UTARA, LAMPUNG",11,128,85,213
https://kawalpemilu.org#23246,"BUMI AGUNG MARGA, ABUNG TIMUR, LAMPUNG UTARA, LAMPUNG",1,11,111,122
https://kawalpemilu.org#23246,"BUMI AGUNG MARGA, ABUNG TIMUR, LAMPUNG UTARA, LAMPUNG",2,18,94,112
https://kawalpemilu.org#23246,"BUMI AGUNG MARGA, ABUNG TIMUR, LAMPUNG UTARA, LAMPUNG",3,9,155,164
https://kawalpemilu.org#23246,"BUMI AGUNG MARGA, ABUNG TIMUR, LAMPUNG UTARA, LAMPUNG",4,18,138,156
https://kawalpemilu.org#23246,"BUMI AGUNG MARGA, ABUNG TIMUR, LAMPUNG UTARA, LAMPUNG",5,170,71,241
https://kawalpemilu.org#23246,"BUMI AGUNG MARGA, ABUNG TIMUR, LAMPUNG UTARA, LAMPUNG",6,121,78,199
https://kawalpemilu.org#23246,"BUMI AGUNG MARGA, ABUNG TIMUR, LAMPUNG UTARA, LAMPUNG",7,150,57,207
https://kawalpemilu.org#23246,"BUMI AGUNG MARGA, ABUNG TIMUR, LAMPUNG UTARA, LAMPUNG",8,51,119,170
https://kawalpemilu.org#23246,"BUMI AGUNG MARGA, ABUNG TIMUR, LAMPUNG UTARA, LAMPUNG",9,71,91,162
https://kawalpemilu.org#23246,"BUMI AGUNG MARGA, ABUNG TIMUR, LAMPUNG UTARA, LAMPUNG",10,153,30,183
https://kawalpemilu.org#23246,"BUMI AGUNG MARGA, ABUNG TIMUR, LAMPUNG UTARA, LAMPUNG",11,104,24,128
https://kawalpemilu.org#23247,"BANJAR AGUNG, ABUNG TIMUR, LAMPUNG UTARA, LAMPUNG",1,0,0,0
https://kawalpemilu.org#23247,"BANJAR AGUNG, ABUNG TIMUR, LAMPUNG UTARA, LAMPUNG",2,0,0,0
https://kawalpemilu.org#23247,"BANJAR AGUNG, ABUNG TIMUR, LAMPUNG UTARA, LAMPUNG",118,29,144,173
https://kawalpemilu.org#23247,"BANJAR AGUNG, ABUNG TIMUR, LAMPUNG UTARA, LAMPUNG",119,38,93,131
https://kawalpemilu.org#23248,"PUNGGUK LAMA, ABUNG TIMUR, LAMPUNG UTARA, LAMPUNG",2,0,0,0
https://kawalpemilu.org#23248,"PUNGGUK LAMA, ABUNG TIMUR, LAMPUNG UTARA, LAMPUNG",12,27,180,207
https://kawalpemilu.org#23248,"PUNGGUK LAMA, ABUNG TIMUR, LAMPUNG UTARA, LAMPUNG",13,28,163,191
https://kawalpemilu.org#23248,"PUNGGUK LAMA, ABUNG TIMUR, LAMPUNG UTARA, LAMPUNG",14,159,39,198
https://kawalpemilu.org#23248,"PUNGGUK LAMA, ABUNG TIMUR, LAMPUNG UTARA, LAMPUNG",16,150,34,184
https://kawalpemilu.org#23249,"GEDUNG NYAPAH, ABUNG TIMUR, LAMPUNG UTARA, LAMPUNG",5,0,0,0
https://kawalpemilu.org#23249,"GEDUNG NYAPAH, ABUNG TIMUR, LAMPUNG UTARA, LAMPUNG",6,0,0,0
https://kawalpemilu.org#23249,"GEDUNG NYAPAH, ABUNG TIMUR, LAMPUNG UTARA, LAMPUNG",17,7,180,187
https://kawalpemilu.org#23249,"GEDUNG NYAPAH, ABUNG TIMUR, LAMPUNG UTARA, LAMPUNG",18,13,160,173
https://kawalpemilu.org#23249,"GEDUNG NYAPAH, ABUNG TIMUR, LAMPUNG UTARA, LAMPUNG",19,197,64,261
https://kawalpemilu.org#23249,"GEDUNG NYAPAH, ABUNG TIMUR, LAMPUNG UTARA, LAMPUNG",20,113,63,176
https://kawalpemilu.org#23249,"GEDUNG NYAPAH, ABUNG TIMUR, LAMPUNG UTARA, LAMPUNG",21,116,62,178
https://kawalpemilu.org#23249,"GEDUNG NYAPAH, ABUNG TIMUR, LAMPUNG UTARA, LAMPUNG",22,107,66,173
https://kawalpemilu.org#23249,"GEDUNG NYAPAH, ABUNG TIMUR, LAMPUNG UTARA, LAMPUNG",23,111,48,159
https://kawalpemilu.org#23250,"PENAGAN RATU, ABUNG TIMUR, LAMPUNG UTARA, LAMPUNG",1,0,0,0
https://kawalpemilu.org#23250,"PENAGAN RATU, ABUNG TIMUR, LAMPUNG UTARA, LAMPUNG",13,0,0,0
https://kawalpemilu.org#23250,"PENAGAN RATU, ABUNG TIMUR, LAMPUNG UTARA, LAMPUNG",18,0,0,0
https://kawalpemilu.org#23250,"PENAGAN RATU, ABUNG TIMUR, LAMPUNG UTARA, LAMPUNG",19,0,0,0
https://kawalpemilu.org#23250,"PENAGAN RATU, ABUNG TIMUR, LAMPUNG UTARA, LAMPUNG",20,0,0,0
https://kawalpemilu.org#23250,"PENAGAN RATU, ABUNG TIMUR, LAMPUNG UTARA, LAMPUNG",21,0,0,0
https://kawalpemilu.org#23250,"PENAGAN RATU, ABUNG TIMUR, LAMPUNG UTARA, LAMPUNG",22,0,0,0
https://kawalpemilu.org#23250,"PENAGAN RATU, ABUNG TIMUR, LAMPUNG UTARA, LAMPUNG",23,0,0,0
https://kawalpemilu.org#23250,"PENAGAN RATU, ABUNG TIMUR, LAMPUNG UTARA, LAMPUNG",24,18,124,142
https://kawalpemilu.org#23250,"PENAGAN RATU, ABUNG TIMUR, LAMPUNG UTARA, LAMPUNG",25,11,111,122
https://kawalpemilu.org#23250,"PENAGAN RATU, ABUNG TIMUR, LAMPUNG UTARA, LAMPUNG",26,26,160,186
https://kawalpemilu.org#23250,"PENAGAN RATU, ABUNG TIMUR, LAMPUNG UTARA, LAMPUNG",27,146,126,272
https://kawalpemilu.org#23250,"PENAGAN RATU, ABUNG TIMUR, LAMPUNG UTARA, LAMPUNG",28,67,83,150
https://kawalpemilu.org#23250,"PENAGAN RATU, ABUNG TIMUR, LAMPUNG UTARA, LAMPUNG",29,85,51,136
https://kawalpemilu.org#23250,"PENAGAN RATU, ABUNG TIMUR, LAMPUNG UTARA, LAMPUNG",30,126,104,230
https://kawalpemilu.org#23250,"PENAGAN RATU, ABUNG TIMUR, LAMPUNG UTARA, LAMPUNG",31,110,46,156
https://kawalpemilu.org#23250,"PENAGAN RATU, ABUNG TIMUR, LAMPUNG UTARA, LAMPUNG",32,105,28,133
https://kawalpemilu.org#23250,"PENAGAN RATU, ABUNG TIMUR, LAMPUNG UTARA, LAMPUNG",33,155,56,211
https://kawalpemilu.org#23250,"PENAGAN RATU, ABUNG TIMUR, LAMPUNG UTARA, LAMPUNG",34,163,41,204
https://kawalpemilu.org#23250,"PENAGAN RATU, ABUNG TIMUR, LAMPUNG UTARA, LAMPUNG",35,175,47,222
https://kawalpemilu.org#23250,"PENAGAN RATU, ABUNG TIMUR, LAMPUNG UTARA, LAMPUNG",36,146,98,244
https://kawalpemilu.org#23250,"PENAGAN RATU, ABUNG TIMUR, LAMPUNG UTARA, LAMPUNG",37,177,60,237
https://kawalpemilu.org#23250,"PENAGAN RATU, ABUNG TIMUR, LAMPUNG UTARA, LAMPUNG",38,151,23,174
https://kawalpemilu.org#23250,"PENAGAN RATU, ABUNG TIMUR, LAMPUNG UTARA, LAMPUNG",39,143,20,163
https://kawalpemilu.org#23250,"PENAGAN RATU, ABUNG TIMUR, LAMPUNG UTARA, LAMPUNG",40,172,33,205
https://kawalpemilu.org#23250,"PENAGAN RATU, ABUNG TIMUR, LAMPUNG UTARA, LAMPUNG",41,181,21,202
https://kawalpemilu.org#23250,"PENAGAN RATU, ABUNG TIMUR, LAMPUNG UTARA, LAMPUNG",42,167,62,229
https://kawalpemilu.org#23250,"PENAGAN RATU, ABUNG TIMUR, LAMPUNG UTARA, LAMPUNG",43,181,51,232
https://kawalpemilu.org#23250,"PENAGAN RATU, ABUNG TIMUR, LAMPUNG UTARA, LAMPUNG",44,140,34,174
https://kawalpemilu.org#23250,"PENAGAN RATU, ABUNG TIMUR, LAMPUNG UTARA, LAMPUNG",45,129,33,162
https://kawalpemilu.org#23250,"PENAGAN RATU, ABUNG TIMUR, LAMPUNG UTARA, LAMPUNG",46,142,44,186
https://kawalpemilu.org#23250,"PENAGAN RATU, ABUNG TIMUR, LAMPUNG UTARA, LAMPUNG",47,119,47,166
https://kawalpemilu.org#23251,"PERADUAN WARAS, ABUNG TIMUR, LAMPUNG UTARA, LAMPUNG",1,0,0,0
https://kawalpemilu.org#23251,"PERADUAN WARAS, ABUNG TIMUR, LAMPUNG UTARA, LAMPUNG",2,0,0,0
https://kawalpemilu.org#23251,"PERADUAN WARAS, ABUNG TIMUR, LAMPUNG UTARA, LAMPUNG",3,0,0,0
https://kawalpemilu.org#23251,"PERADUAN WARAS, ABUNG TIMUR, LAMPUNG UTARA, LAMPUNG",4,0,0,0
https://kawalpemilu.org#23251,"PERADUAN WARAS, ABUNG TIMUR, LAMPUNG UTARA, LAMPUNG",5,0,0,0
https://kawalpemilu.org#23251,"PERADUAN WARAS, ABUNG TIMUR, LAMPUNG UTARA, LAMPUNG",6,0,0,0
https://kawalpemilu.org#23251,"PERADUAN WARAS, ABUNG TIMUR, LAMPUNG UTARA, LAMPUNG",7,0,0,0
https://kawalpemilu.org#23251,"PERADUAN WARAS, ABUNG TIMUR, LAMPUNG UTARA, LAMPUNG",61,27,159,186
https://kawalpemilu.org#23251,"PERADUAN WARAS, ABUNG TIMUR, LAMPUNG UTARA, LAMPUNG",62,18,152,170
https://kawalpemilu.org#23251,"PERADUAN WARAS, ABUNG TIMUR, LAMPUNG UTARA, LAMPUNG",63,33,132,165
https://kawalpemilu.org#23251,"PERADUAN WARAS, ABUNG TIMUR, LAMPUNG UTARA, LAMPUNG",64,52,101,153
https://kawalpemilu.org#23251,"PERADUAN WARAS, ABUNG TIMUR, LAMPUNG UTARA, LAMPUNG",65,40,126,166
https://kawalpemilu.org#23251,"PERADUAN WARAS, ABUNG TIMUR, LAMPUNG UTARA, LAMPUNG",66,78,145,223
https://kawalpemilu.org#23251,"PERADUAN WARAS, ABUNG TIMUR, LAMPUNG UTARA, LAMPUNG",67,114,133,247
https://kawalpemilu.org#23252,"SURAKARTA, ABUNG TIMUR, LAMPUNG UTARA, LAMPUNG",1,0,0,0
https://kawalpemilu.org#23252,"SURAKARTA, ABUNG TIMUR, LAMPUNG UTARA, LAMPUNG",2,0,0,0
https://kawalpemilu.org#23252,"SURAKARTA, ABUNG TIMUR, LAMPUNG UTARA, LAMPUNG",3,0,0,0
https://kawalpemilu.org#23252,"SURAKARTA, ABUNG TIMUR, LAMPUNG UTARA, LAMPUNG",4,0,0,0
https://kawalpemilu.org#23252,"SURAKARTA, ABUNG TIMUR, LAMPUNG UTARA, LAMPUNG",5,0,0,0
https://kawalpemilu.org#23252,"SURAKARTA, ABUNG TIMUR, LAMPUNG UTARA, LAMPUNG",6,0,0,0
https://kawalpemilu.org#23252,"SURAKARTA, ABUNG TIMUR, LAMPUNG UTARA, LAMPUNG",7,0,0,0
https://kawalpemilu.org#23252,"SURAKARTA, ABUNG TIMUR, LAMPUNG UTARA, LAMPUNG",8,0,0,0
https://kawalpemilu.org#23252,"SURAKARTA, ABUNG TIMUR, LAMPUNG UTARA, LAMPUNG",68,24,206,230
https://kawalpemilu.org#23252,"SURAKARTA, ABUNG TIMUR, LAMPUNG UTARA, LAMPUNG",69,19,167,186
https://kawalpemilu.org#23252,"SURAKARTA, ABUNG TIMUR, LAMPUNG UTARA, LAMPUNG",70,48,159,207
https://kawalpemilu.org#23252,"SURAKARTA, ABUNG TIMUR, LAMPUNG UTARA, LAMPUNG",71,30,179,209
https://kawalpemilu.org#23252,"SURAKARTA, ABUNG TIMUR, LAMPUNG UTARA, LAMPUNG",72,19,181,200
https://kawalpemilu.org#23252,"SURAKARTA, ABUNG TIMUR, LAMPUNG UTARA, LAMPUNG",73,60,106,166
https://kawalpemilu.org#23252,"SURAKARTA, ABUNG TIMUR, LAMPUNG UTARA, LAMPUNG",74,10,132,142
https://kawalpemilu.org#23252,"SURAKARTA, ABUNG TIMUR, LAMPUNG UTARA, LAMPUNG",75,99,85,184
https://kawalpemilu.org#23253,"REJO MULYO, ABUNG TIMUR, LAMPUNG UTARA, LAMPUNG",2,0,0,0
https://kawalpemilu.org#23253,"REJO MULYO, ABUNG TIMUR, LAMPUNG UTARA, LAMPUNG",4,0,0,0
https://kawalpemilu.org#23253,"REJO MULYO, ABUNG TIMUR, LAMPUNG UTARA, LAMPUNG",5,0,0,0
https://kawalpemilu.org#23253,"REJO MULYO, ABUNG TIMUR, LAMPUNG UTARA, LAMPUNG",7,0,0,0
https://kawalpemilu.org#23253,"REJO MULYO, ABUNG TIMUR, LAMPUNG UTARA, LAMPUNG",11,0,0,0
https://kawalpemilu.org#23253,"REJO MULYO, ABUNG TIMUR, LAMPUNG UTARA, LAMPUNG",107,117,41,158
https://kawalpemilu.org#23253,"REJO MULYO, ABUNG TIMUR, LAMPUNG UTARA, LAMPUNG",108,97,44,141
https://kawalpemilu.org#23253,"REJO MULYO, ABUNG TIMUR, LAMPUNG UTARA, LAMPUNG",109,100,49,149
https://kawalpemilu.org#23253,"REJO MULYO, ABUNG TIMUR, LAMPUNG UTARA, LAMPUNG",110,116,29,146
https://kawalpemilu.org#23253,"REJO MULYO, ABUNG TIMUR, LAMPUNG UTARA, LAMPUNG",111,117,34,151
https://kawalpemilu.org#23253,"REJO MULYO, ABUNG TIMUR, LAMPUNG UTARA, LAMPUNG",112,112,47,159
https://kawalpemilu.org#23253,"REJO MULYO, ABUNG TIMUR, LAMPUNG UTARA, LAMPUNG",113,110,33,143
https://kawalpemilu.org#23253,"REJO MULYO, ABUNG TIMUR, LAMPUNG UTARA, LAMPUNG",114,133,24,157
https://kawalpemilu.org#23253,"REJO MULYO, ABUNG TIMUR, LAMPUNG UTARA, LAMPUNG",115,134,17,151
https://kawalpemilu.org#23253,"REJO MULYO, ABUNG TIMUR, LAMPUNG UTARA, LAMPUNG",116,126,36,162
https://kawalpemilu.org#23253,"REJO MULYO, ABUNG TIMUR, LAMPUNG UTARA, LAMPUNG",117,90,102,192
https://kawalpemilu.org#23254,"SIDOMUKTI, ABUNG TIMUR, LAMPUNG UTARA, LAMPUNG",1,0,0,0
https://kawalpemilu.org#23254,"SIDOMUKTI, ABUNG TIMUR, LAMPUNG UTARA, LAMPUNG",2,0,0,0
https://kawalpemilu.org#23254,"SIDOMUKTI, ABUNG TIMUR, LAMPUNG UTARA, LAMPUNG",3,0,0,0
https://kawalpemilu.org#23254,"SIDOMUKTI, ABUNG TIMUR, LAMPUNG UTARA, LAMPUNG",4,0,0,0
https://kawalpemilu.org#23254,"SIDOMUKTI, ABUNG TIMUR, LAMPUNG UTARA, LAMPUNG",5,0,0,0
https://kawalpemilu.org#23254,"SIDOMUKTI, ABUNG TIMUR, LAMPUNG UTARA, LAMPUNG",6,0,0,0
https://kawalpemilu.org#23254,"SIDOMUKTI, ABUNG TIMUR, LAMPUNG UTARA, LAMPUNG",7,0,0,0
https://kawalpemilu.org#23254,"SIDOMUKTI, ABUNG TIMUR, LAMPUNG UTARA, LAMPUNG",8,0,0,0
https://kawalpemilu.org#23254,"SIDOMUKTI, ABUNG TIMUR, LAMPUNG UTARA, LAMPUNG",9,0,0,0
https://kawalpemilu.org#23254,"SIDOMUKTI, ABUNG TIMUR, LAMPUNG UTARA, LAMPUNG",10,0,0,0
https://kawalpemilu.org#23254,"SIDOMUKTI, ABUNG TIMUR, LAMPUNG UTARA, LAMPUNG",11,0,0,0
https://kawalpemilu.org#23254,"SIDOMUKTI, ABUNG TIMUR, LAMPUNG UTARA, LAMPUNG",12,0,0,0
https://kawalpemilu.org#23254,"SIDOMUKTI, ABUNG TIMUR, LAMPUNG UTARA, LAMPUNG",13,0,0,0
https://kawalpemilu.org#23254,"SIDOMUKTI, ABUNG TIMUR, LAMPUNG UTARA, LAMPUNG",14,0,0,0
https://kawalpemilu.org#23254,"SIDOMUKTI, ABUNG TIMUR, LAMPUNG UTARA, LAMPUNG",15,0,0,0
https://kawalpemilu.org#23254,"SIDOMUKTI, ABUNG TIMUR, LAMPUNG UTARA, LAMPUNG",16,0,0,0
https://kawalpemilu.org#23254,"SIDOMUKTI, ABUNG TIMUR, LAMPUNG UTARA, LAMPUNG",17,0,0,0
https://kawalpemilu.org#23254,"SIDOMUKTI, ABUNG TIMUR, LAMPUNG UTARA, LAMPUNG",18,0,0,0
https://kawalpemilu.org#23254,"SIDOMUKTI, ABUNG TIMUR, LAMPUNG UTARA, LAMPUNG",79,202,58,260
https://kawalpemilu.org#23254,"SIDOMUKTI, ABUNG TIMUR, LAMPUNG UTARA, LAMPUNG",80,219,30,249
https://kawalpemilu.org#23254,"SIDOMUKTI, ABUNG TIMUR, LAMPUNG UTARA, LAMPUNG",81,128,24,152
https://kawalpemilu.org#23254,"SIDOMUKTI, ABUNG TIMUR, LAMPUNG UTARA, LAMPUNG",82,111,55,166
https://kawalpemilu.org#23254,"SIDOMUKTI, ABUNG TIMUR, LAMPUNG UTARA, LAMPUNG",83,141,65,206
https://kawalpemilu.org#23254,"SIDOMUKTI, ABUNG TIMUR, LAMPUNG UTARA, LAMPUNG",84,137,82,219
https://kawalpemilu.org#23254,"SIDOMUKTI, ABUNG TIMUR, LAMPUNG UTARA, LAMPUNG",85,140,86,226
https://kawalpemilu.org#23254,"SIDOMUKTI, ABUNG TIMUR, LAMPUNG UTARA, LAMPUNG",86,125,33,158
https://kawalpemilu.org#23254,"SIDOMUKTI, ABUNG TIMUR, LAMPUNG UTARA, LAMPUNG",87,131,32,163
https://kawalpemilu.org#23254,"SIDOMUKTI, ABUNG TIMUR, LAMPUNG UTARA, LAMPUNG",88,125,27,152
https://kawalpemilu.org#23254,"SIDOMUKTI, ABUNG TIMUR, LAMPUNG UTARA, LAMPUNG",89,141,23,164
https://kawalpemilu.org#23254,"SIDOMUKTI, ABUNG TIMUR, LAMPUNG UTARA, LAMPUNG",90,182,53,235
https://kawalpemilu.org#23254,"SIDOMUKTI, ABUNG TIMUR, LAMPUNG UTARA, LAMPUNG",91,88,50,138
https://kawalpemilu.org#23254,"SIDOMUKTI, ABUNG TIMUR, LAMPUNG UTARA, LAMPUNG",92,76,53,129
https://kawalpemilu.org#23254,"SIDOMUKTI, ABUNG TIMUR, LAMPUNG UTARA, LAMPUNG",93,173,61,234
https://kawalpemilu.org#23254,"SIDOMUKTI, ABUNG TIMUR, LAMPUNG UTARA, LAMPUNG",94,197,42,239
https://kawalpemilu.org#23254,"SIDOMUKTI, ABUNG TIMUR, LAMPUNG UTARA, LAMPUNG",95,169,28,197
https://kawalpemilu.org#23254,"SIDOMUKTI, ABUNG TIMUR, LAMPUNG UTARA, LAMPUNG",96,188,46,234
https://kawalpemilu.org#23255,"BUMI JAYA, ABUNG TIMUR, LAMPUNG UTARA, LAMPUNG",1,0,0,0
https://kawalpemilu.org#23255,"BUMI JAYA, ABUNG TIMUR, LAMPUNG UTARA, LAMPUNG",2,0,0,0
https://kawalpemilu.org#23255,"BUMI JAYA, ABUNG TIMUR, LAMPUNG UTARA, LAMPUNG",3,0,0,0
https://kawalpemilu.org#23255,"BUMI JAYA, ABUNG TIMUR, LAMPUNG UTARA, LAMPUNG",4,0,0,0
https://kawalpemilu.org#23255,"BUMI JAYA, ABUNG TIMUR, LAMPUNG UTARA, LAMPUNG",5,0,0,0
https://kawalpemilu.org#23255,"BUMI JAYA, ABUNG TIMUR, LAMPUNG UTARA, LAMPUNG",6,0,0,0
https://kawalpemilu.org#23255,"BUMI JAYA, ABUNG TIMUR, LAMPUNG UTARA, LAMPUNG",7,0,0,0
https://kawalpemilu.org#23255,"BUMI JAYA, ABUNG TIMUR, LAMPUNG UTARA, LAMPUNG",8,0,0,0
https://kawalpemilu.org#23255,"BUMI JAYA, ABUNG TIMUR, LAMPUNG UTARA, LAMPUNG",9,0,0,0
https://kawalpemilu.org#23255,"BUMI JAYA, ABUNG TIMUR, LAMPUNG UTARA, LAMPUNG",10,0,0,0
https://kawalpemilu.org#23255,"BUMI JAYA, ABUNG TIMUR, LAMPUNG UTARA, LAMPUNG",97,77,42,119
https://kawalpemilu.org#23255,"BUMI JAYA, ABUNG TIMUR, LAMPUNG UTARA, LAMPUNG",98,82,40,122
https://kawalpemilu.org#23255,"BUMI JAYA, ABUNG TIMUR, LAMPUNG UTARA, LAMPUNG",99,112,42,154
https://kawalpemilu.org#23255,"BUMI JAYA, ABUNG TIMUR, LAMPUNG UTARA, LAMPUNG",100,112,32,144
https://kawalpemilu.org#23255,"BUMI JAYA, ABUNG TIMUR, LAMPUNG UTARA, LAMPUNG",101,93,46,139
https://kawalpemilu.org#23255,"BUMI JAYA, ABUNG TIMUR, LAMPUNG UTARA, LAMPUNG",102,111,29,140
https://kawalpemilu.org#23255,"BUMI JAYA, ABUNG TIMUR, LAMPUNG UTARA, LAMPUNG",103,139,53,192
https://kawalpemilu.org#23255,"BUMI JAYA, ABUNG TIMUR, LAMPUNG UTARA, LAMPUNG",104,168,25,193
https://kawalpemilu.org#23255,"BUMI JAYA, ABUNG TIMUR, LAMPUNG UTARA, LAMPUNG",105,130,28,158
https://kawalpemilu.org#23255,"BUMI JAYA, ABUNG TIMUR, LAMPUNG UTARA, LAMPUNG",106,145,28,173
https://kawalpemilu.org#23256,"PAPAN REJO, ABUNG TIMUR, LAMPUNG UTARA, LAMPUNG",1,0,0,0
https://kawalpemilu.org#23256,"PAPAN REJO, ABUNG TIMUR, LAMPUNG UTARA, LAMPUNG",2,0,0,0
https://kawalpemilu.org#23256,"PAPAN REJO, ABUNG TIMUR, LAMPUNG UTARA, LAMPUNG",4,0,0,0
https://kawalpemilu.org#23256,"PAPAN REJO, ABUNG TIMUR, LAMPUNG UTARA, LAMPUNG",5,0,0,0
https://kawalpemilu.org#23256,"PAPAN REJO, ABUNG TIMUR, LAMPUNG UTARA, LAMPUNG",12,0,0,0
https://kawalpemilu.org#23256,"PAPAN REJO, ABUNG TIMUR, LAMPUNG UTARA, LAMPUNG",48,81,142,223
https://kawalpemilu.org#23256,"PAPAN REJO, ABUNG TIMUR, LAMPUNG UTARA, LAMPUNG",49,70,142,212
https://kawalpemilu.org#23256,"PAPAN REJO, ABUNG TIMUR, LAMPUNG UTARA, LAMPUNG",50,116,75,191
https://kawalpemilu.org#23256,"PAPAN REJO, ABUNG TIMUR, LAMPUNG UTARA, LAMPUNG",51,76,69,145
https://kawalpemilu.org#23256,"PAPAN REJO, ABUNG TIMUR, LAMPUNG UTARA, LAMPUNG",52,46,121,167
https://kawalpemilu.org#23256,"PAPAN REJO, ABUNG TIMUR, LAMPUNG UTARA, LAMPUNG",53,43,118,161
https://kawalpemilu.org#23256,"PAPAN REJO, ABUNG TIMUR, LAMPUNG UTARA, LAMPUNG",54,69,78,147
https://kawalpemilu.org#23256,"PAPAN REJO, ABUNG TIMUR, LAMPUNG UTARA, LAMPUNG",55,89,123,212
https://kawalpemilu.org#23256,"PAPAN REJO, ABUNG TIMUR, LAMPUNG UTARA, LAMPUNG",56,100,140,240
https://kawalpemilu.org#23256,"PAPAN REJO, ABUNG TIMUR, LAMPUNG UTARA, LAMPUNG",57,61,58,119
https://kawalpemilu.org#23256,"PAPAN REJO, ABUNG TIMUR, LAMPUNG UTARA, LAMPUNG",58,87,80,167
https://kawalpemilu.org#23256,"PAPAN REJO, ABUNG TIMUR, LAMPUNG UTARA, LAMPUNG",59,80,57,137
https://kawalpemilu.org#23256,"PAPAN REJO, ABUNG TIMUR, LAMPUNG UTARA, LAMPUNG",60,74,67,141
https://kawalpemilu.org#23257,"SUMBER AGUNG, ABUNG TIMUR, LAMPUNG UTARA, LAMPUNG",1,0,0,0
https://kawalpemilu.org#23257,"SUMBER AGUNG, ABUNG TIMUR, LAMPUNG UTARA, LAMPUNG",2,0,0,0
https://kawalpemilu.org#23257,"SUMBER AGUNG, ABUNG TIMUR, LAMPUNG UTARA, LAMPUNG",3,0,0,0
https://kawalpemilu.org#23257,"SUMBER AGUNG, ABUNG TIMUR, LAMPUNG UTARA, LAMPUNG",76,44,153,197
https://kawalpemilu.org#23257,"SUMBER AGUNG, ABUNG TIMUR, LAMPUNG UTARA, LAMPUNG",77,67,93,160
https://kawalpemilu.org#23257,"SUMBER AGUNG, ABUNG TIMUR, LAMPUNG UTARA, LAMPUNG",78,167,43,210
https://kawalpemilu.org#23259,"OGAN LIMA, ABUNG BARAT, LAMPUNG UTARA, LAMPUNG",1,0,0,0
https://kawalpemilu.org#23259,"OGAN LIMA, ABUNG BARAT, LAMPUNG UTARA, LAMPUNG",3,0,0,0
https://kawalpemilu.org#23259,"OGAN LIMA, ABUNG BARAT, LAMPUNG UTARA, LAMPUNG",4,0,0,0
https://kawalpemilu.org#23259,"OGAN LIMA, ABUNG BARAT, LAMPUNG UTARA, LAMPUNG",8,0,0,0
https://kawalpemilu.org#23259,"OGAN LIMA, ABUNG BARAT, LAMPUNG UTARA, LAMPUNG",9,0,0,0
https://kawalpemilu.org#23259,"OGAN LIMA, ABUNG BARAT, LAMPUNG UTARA, LAMPUNG",10,0,0,0
https://kawalpemilu.org#23259,"OGAN LIMA, ABUNG BARAT, LAMPUNG UTARA, LAMPUNG",12,0,0,0
https://kawalpemilu.org#23259,"OGAN LIMA, ABUNG BARAT, LAMPUNG UTARA, LAMPUNG",13,0,0,0
https://kawalpemilu.org#23259,"OGAN LIMA, ABUNG BARAT, LAMPUNG UTARA, LAMPUNG",14,0,0,0
https://kawalpemilu.org#23259,"OGAN LIMA, ABUNG BARAT, LAMPUNG UTARA, LAMPUNG",15,0,0,0
https://kawalpemilu.org#23259,"OGAN LIMA, ABUNG BARAT, LAMPUNG UTARA, LAMPUNG",63,60,151,211
https://kawalpemilu.org#23259,"OGAN LIMA, ABUNG BARAT, LAMPUNG UTARA, LAMPUNG",64,53,187,240
https://kawalpemilu.org#23259,"OGAN LIMA, ABUNG BARAT, LAMPUNG UTARA, LAMPUNG",65,92,159,251
https://kawalpemilu.org#23259,"OGAN LIMA, ABUNG BARAT, LAMPUNG UTARA, LAMPUNG",66,40,106,146
https://kawalpemilu.org#23259,"OGAN LIMA, ABUNG BARAT, LAMPUNG UTARA, LAMPUNG",67,62,149,211
https://kawalpemilu.org#23259,"OGAN LIMA, ABUNG BARAT, LAMPUNG UTARA, LAMPUNG",68,90,150,240
https://kawalpemilu.org#23259,"OGAN LIMA, ABUNG BARAT, LAMPUNG UTARA, LAMPUNG",69,91,128,219
https://kawalpemilu.org#23259,"OGAN LIMA, ABUNG BARAT, LAMPUNG UTARA, LAMPUNG",70,35,120,155
https://kawalpemilu.org#23259,"OGAN LIMA, ABUNG BARAT, LAMPUNG UTARA, LAMPUNG",71,45,86,131
https://kawalpemilu.org#23259,"OGAN LIMA, ABUNG BARAT, LAMPUNG UTARA, LAMPUNG",72,36,85,121
https://kawalpemilu.org#23259,"OGAN LIMA, ABUNG BARAT, LAMPUNG UTARA, LAMPUNG",73,53,90,143
https://kawalpemilu.org#23259,"OGAN LIMA, ABUNG BARAT, LAMPUNG UTARA, LAMPUNG",74,48,103,151
https://kawalpemilu.org#23259,"OGAN LIMA, ABUNG BARAT, LAMPUNG UTARA, LAMPUNG",75,37,110,147
https://kawalpemilu.org#23259,"OGAN LIMA, ABUNG BARAT, LAMPUNG UTARA, LAMPUNG",76,29,82,111
https://kawalpemilu.org#23259,"OGAN LIMA, ABUNG BARAT, LAMPUNG UTARA, LAMPUNG",77,23,59,82
https://kawalpemilu.org#23260,"HUJAN MAS, ABUNG BARAT, LAMPUNG UTARA, LAMPUNG",2,0,0,0
https://kawalpemilu.org#23260,"HUJAN MAS, ABUNG BARAT, LAMPUNG UTARA, LAMPUNG",6,68,97,165
https://kawalpemilu.org#23260,"HUJAN MAS, ABUNG BARAT, LAMPUNG UTARA, LAMPUNG",7,60,79,139
https://kawalpemilu.org#23261,"SIMPANG ABUNG, ABUNG BARAT, LAMPUNG UTARA, LAMPUNG",19,30,120,150
https://kawalpemilu.org#23261,"SIMPANG ABUNG, ABUNG BARAT, LAMPUNG UTARA, LAMPUNG",20,11,123,134
https://kawalpemilu.org#23261,"SIMPANG ABUNG, ABUNG BARAT, LAMPUNG UTARA, LAMPUNG",21,51,69,120
https://kawalpemilu.org#23261,"SIMPANG ABUNG, ABUNG BARAT, LAMPUNG UTARA, LAMPUNG",22,26,199,225
https://kawalpemilu.org#23262,"BUMI NABUNG, ABUNG BARAT, LAMPUNG UTARA, LAMPUNG",1,0,0,0
https://kawalpemilu.org#23262,"BUMI NABUNG, ABUNG BARAT, LAMPUNG UTARA, LAMPUNG",8,0,0,0
https://kawalpemilu.org#23262,"BUMI NABUNG, ABUNG BARAT, LAMPUNG UTARA, LAMPUNG",9,0,0,0
https://kawalpemilu.org#23262,"BUMI NABUNG, ABUNG BARAT, LAMPUNG UTARA, LAMPUNG",39,73,37,110
https://kawalpemilu.org#23262,"BUMI NABUNG, ABUNG BARAT, LAMPUNG UTARA, LAMPUNG",40,43,130,173
https://kawalpemilu.org#23262,"BUMI NABUNG, ABUNG BARAT, LAMPUNG UTARA, LAMPUNG",41,33,145,178
https://kawalpemilu.org#23262,"BUMI NABUNG, ABUNG BARAT, LAMPUNG UTARA, LAMPUNG",42,16,129,145
https://kawalpemilu.org#23262,"BUMI NABUNG, ABUNG BARAT, LAMPUNG UTARA, LAMPUNG",43,22,126,148
https://kawalpemilu.org#23262,"BUMI NABUNG, ABUNG BARAT, LAMPUNG UTARA, LAMPUNG",44,15,82,97
https://kawalpemilu.org#23262,"BUMI NABUNG, ABUNG BARAT, LAMPUNG UTARA, LAMPUNG",45,52,91,143
https://kawalpemilu.org#23262,"BUMI NABUNG, ABUNG BARAT, LAMPUNG UTARA, LAMPUNG",46,41,156,197
https://kawalpemilu.org#23262,"BUMI NABUNG, ABUNG BARAT, LAMPUNG UTARA, LAMPUNG",47,48,78,126
https://kawalpemilu.org#23262,"BUMI NABUNG, ABUNG BARAT, LAMPUNG UTARA, LAMPUNG",48,44,90,134
https://kawalpemilu.org#23262,"BUMI NABUNG, ABUNG BARAT, LAMPUNG UTARA, LAMPUNG",49,33,168,201
https://kawalpemilu.org#23263,"KAMPLAS, ABUNG BARAT, LAMPUNG UTARA, LAMPUNG",1,0,0,0
https://kawalpemilu.org#23263,"KAMPLAS, ABUNG BARAT, LAMPUNG UTARA, LAMPUNG",2,0,0,0
https://kawalpemilu.org#23263,"KAMPLAS, ABUNG BARAT, LAMPUNG UTARA, LAMPUNG",3,0,0,0
https://kawalpemilu.org#23263,"KAMPLAS, ABUNG BARAT, LAMPUNG UTARA, LAMPUNG",4,0,0,0
https://kawalpemilu.org#23263,"KAMPLAS, ABUNG BARAT, LAMPUNG UTARA, LAMPUNG",15,55,89,144
https://kawalpemilu.org#23263,"KAMPLAS, ABUNG BARAT, LAMPUNG UTARA, LAMPUNG",16,29,51,80
https://kawalpemilu.org#23263,"KAMPLAS, ABUNG BARAT, LAMPUNG UTARA, LAMPUNG",17,66,73,139
https://kawalpemilu.org#23263,"KAMPLAS, ABUNG BARAT, LAMPUNG UTARA, LAMPUNG",18,101,41,142
https://kawalpemilu.org#23264,"KISTANG, ABUNG BARAT, LAMPUNG UTARA, LAMPUNG",1,0,0,0
https://kawalpemilu.org#23264,"KISTANG, ABUNG BARAT, LAMPUNG UTARA, LAMPUNG",2,0,0,0
https://kawalpemilu.org#23264,"KISTANG, ABUNG BARAT, LAMPUNG UTARA, LAMPUNG",4,0,0,0
https://kawalpemilu.org#23264,"KISTANG, ABUNG BARAT, LAMPUNG UTARA, LAMPUNG",23,78,56,134
https://kawalpemilu.org#23264,"KISTANG, ABUNG BARAT, LAMPUNG UTARA, LAMPUNG",24,91,103,194
https://kawalpemilu.org#23264,"KISTANG, ABUNG BARAT, LAMPUNG UTARA, LAMPUNG",25,51,153,204
https://kawalpemilu.org#23264,"KISTANG, ABUNG BARAT, LAMPUNG UTARA, LAMPUNG",26,34,103,137
https://kawalpemilu.org#23264,"KISTANG, ABUNG BARAT, LAMPUNG UTARA, LAMPUNG",27,56,94,150
https://kawalpemilu.org#23265,"CAHAYA NEGERI, ABUNG BARAT, LAMPUNG UTARA, LAMPUNG",4,0,0,0
https://kawalpemilu.org#23265,"CAHAYA NEGERI, ABUNG BARAT, LAMPUNG UTARA, LAMPUNG",9,0,0,0
https://kawalpemilu.org#23265,"CAHAYA NEGERI, ABUNG BARAT, LAMPUNG UTARA, LAMPUNG",11,0,0,0
https://kawalpemilu.org#23265,"CAHAYA NEGERI, ABUNG BARAT, LAMPUNG UTARA, LAMPUNG",12,0,0,0
https://kawalpemilu.org#23265,"CAHAYA NEGERI, ABUNG BARAT, LAMPUNG UTARA, LAMPUNG",50,33,87,120
https://kawalpemilu.org#23265,"CAHAYA NEGERI, ABUNG BARAT, LAMPUNG UTARA, LAMPUNG",51,35,65,100
https://kawalpemilu.org#23265,"CAHAYA NEGERI, ABUNG BARAT, LAMPUNG UTARA, LAMPUNG",52,41,79,120
https://kawalpemilu.org#23265,"CAHAYA NEGERI, ABUNG BARAT, LAMPUNG UTARA, LAMPUNG",53,37,56,93
https://kawalpemilu.org#23265,"CAHAYA NEGERI, ABUNG BARAT, LAMPUNG UTARA, LAMPUNG",54,39,56,95
https://kawalpemilu.org#23265,"CAHAYA NEGERI, ABUNG BARAT, LAMPUNG UTARA, LAMPUNG",57,39,93,132
https://kawalpemilu.org#23265,"CAHAYA NEGERI, ABUNG BARAT, LAMPUNG UTARA, LAMPUNG",58,107,67,174
https://kawalpemilu.org#23265,"CAHAYA NEGERI, ABUNG BARAT, LAMPUNG UTARA, LAMPUNG",59,133,53,186
https://kawalpemilu.org#23265,"CAHAYA NEGERI, ABUNG BARAT, LAMPUNG UTARA, LAMPUNG",61,70,70,140
https://kawalpemilu.org#23265,"CAHAYA NEGERI, ABUNG BARAT, LAMPUNG UTARA, LAMPUNG",62,61,68,129
https://kawalpemilu.org#23266,"LEPANG BESAR, ABUNG BARAT, LAMPUNG UTARA, LAMPUNG",1,0,0,0
https://kawalpemilu.org#23266,"LEPANG BESAR, ABUNG BARAT, LAMPUNG UTARA, LAMPUNG",35,19,87,106
https://kawalpemilu.org#23266,"LEPANG BESAR, ABUNG BARAT, LAMPUNG UTARA, LAMPUNG",36,27,102,129
https://kawalpemilu.org#23266,"LEPANG BESAR, ABUNG BARAT, LAMPUNG UTARA, LAMPUNG",37,41,68,109
https://kawalpemilu.org#23266,"LEPANG BESAR, ABUNG BARAT, LAMPUNG UTARA, LAMPUNG",38,13,110,123
https://kawalpemilu.org#23267,"TANJUNG HARTA, ABUNG BARAT, LAMPUNG UTARA, LAMPUNG",1,0,0,0
https://kawalpemilu.org#23267,"TANJUNG HARTA, ABUNG BARAT, LAMPUNG UTARA, LAMPUNG",11,88,96,184
https://kawalpemilu.org#23268,"PENGARINGAN, ABUNG BARAT, LAMPUNG UTARA, LAMPUNG",1,0,0,0
https://kawalpemilu.org#23268,"PENGARINGAN, ABUNG BARAT, LAMPUNG UTARA, LAMPUNG",13,48,98,146
https://kawalpemilu.org#23268,"PENGARINGAN, ABUNG BARAT, LAMPUNG UTARA, LAMPUNG",14,47,139,186
https://kawalpemilu.org#23269,"WAY WAKAK, ABUNG BARAT, LAMPUNG UTARA, LAMPUNG",1,0,0,0
https://kawalpemilu.org#23269,"WAY WAKAK, ABUNG BARAT, LAMPUNG UTARA, LAMPUNG",2,0,0,0
https://kawalpemilu.org#23269,"WAY WAKAK, ABUNG BARAT, LAMPUNG UTARA, LAMPUNG",3,46,60,106
https://kawalpemilu.org#23269,"WAY WAKAK, ABUNG BARAT, LAMPUNG UTARA, LAMPUNG",4,77,63,140
https://kawalpemilu.org#23269,"WAY WAKAK, ABUNG BARAT, LAMPUNG UTARA, LAMPUNG",5,88,105,193
https://kawalpemilu.org#23270,"PEMATANG KASIH, ABUNG BARAT, LAMPUNG UTARA, LAMPUNG",1,65,60,125
https://kawalpemilu.org#23270,"PEMATANG KASIH, ABUNG BARAT, LAMPUNG UTARA, LAMPUNG",2,56,115,171
https://kawalpemilu.org#23271,"GUNUNG BETUAH, ABUNG BARAT, LAMPUNG UTARA, LAMPUNG",1,0,0,0
https://kawalpemilu.org#23271,"GUNUNG BETUAH, ABUNG BARAT, LAMPUNG UTARA, LAMPUNG",2,0,0,0
https://kawalpemilu.org#23271,"GUNUNG BETUAH, ABUNG BARAT, LAMPUNG UTARA, LAMPUNG",4,0,0,0
https://kawalpemilu.org#23271,"GUNUNG BETUAH, ABUNG BARAT, LAMPUNG UTARA, LAMPUNG",7,0,0,0
https://kawalpemilu.org#23271,"GUNUNG BETUAH, ABUNG BARAT, LAMPUNG UTARA, LAMPUNG",28,39,69,108
https://kawalpemilu.org#23271,"GUNUNG BETUAH, ABUNG BARAT, LAMPUNG UTARA, LAMPUNG",29,45,51,96
https://kawalpemilu.org#23271,"GUNUNG BETUAH, ABUNG BARAT, LAMPUNG UTARA, LAMPUNG",30,26,77,103
https://kawalpemilu.org#23271,"GUNUNG BETUAH, ABUNG BARAT, LAMPUNG UTARA, LAMPUNG",31,40,106,146
https://kawalpemilu.org#23271,"GUNUNG BETUAH, ABUNG BARAT, LAMPUNG UTARA, LAMPUNG",32,43,74,117
https://kawalpemilu.org#23271,"GUNUNG BETUAH, ABUNG BARAT, LAMPUNG UTARA, LAMPUNG",33,32,70,102
https://kawalpemilu.org#23271,"GUNUNG BETUAH, ABUNG BARAT, LAMPUNG UTARA, LAMPUNG",34,51,81,132
https://kawalpemilu.org#23272,"BUMI MANDIRI, ABUNG BARAT, LAMPUNG UTARA, LAMPUNG",1,0,0,0
https://kawalpemilu.org#23272,"BUMI MANDIRI, ABUNG BARAT, LAMPUNG UTARA, LAMPUNG",2,0,0,0
https://kawalpemilu.org#23272,"BUMI MANDIRI, ABUNG BARAT, LAMPUNG UTARA, LAMPUNG",8,34,214,248
https://kawalpemilu.org#23272,"BUMI MANDIRI, ABUNG BARAT, LAMPUNG UTARA, LAMPUNG",9,54,102,156
https://kawalpemilu.org#23272,"BUMI MANDIRI, ABUNG BARAT, LAMPUNG UTARA, LAMPUNG",10,45,120,165
https://kawalpemilu.org#23274,"KALIBALANGAN, ABUNG SELATAN, LAMPUNG UTARA, LAMPUNG",11,0,0,0
https://kawalpemilu.org#23274,"KALIBALANGAN, ABUNG SELATAN, LAMPUNG UTARA, LAMPUNG",18,0,0,0
https://kawalpemilu.org#23274,"KALIBALANGAN, ABUNG SELATAN, LAMPUNG UTARA, LAMPUNG",19,0,0,0
https://kawalpemilu.org#23274,"KALIBALANGAN, ABUNG SELATAN, LAMPUNG UTARA, LAMPUNG",138,56,127,183
https://kawalpemilu.org#23274,"KALIBALANGAN, ABUNG SELATAN, LAMPUNG UTARA, LAMPUNG",139,56,109,165
https://kawalpemilu.org#23274,"KALIBALANGAN, ABUNG SELATAN, LAMPUNG UTARA, LAMPUNG",140,45,107,152
https://kawalpemilu.org#23274,"KALIBALANGAN, ABUNG SELATAN, LAMPUNG UTARA, LAMPUNG",141,33,114,147
https://kawalpemilu.org#23274,"KALIBALANGAN, ABUNG SELATAN, LAMPUNG UTARA, LAMPUNG",142,131,99,230
https://kawalpemilu.org#23274,"KALIBALANGAN, ABUNG SELATAN, LAMPUNG UTARA, LAMPUNG",143,85,119,204
https://kawalpemilu.org#23274,"KALIBALANGAN, ABUNG SELATAN, LAMPUNG UTARA, LAMPUNG",144,83,76,159
https://kawalpemilu.org#23274,"KALIBALANGAN, ABUNG SELATAN, LAMPUNG UTARA, LAMPUNG",145,87,85,172
https://kawalpemilu.org#23274,"KALIBALANGAN, ABUNG SELATAN, LAMPUNG UTARA, LAMPUNG",146,76,99,175
https://kawalpemilu.org#23274,"KALIBALANGAN, ABUNG SELATAN, LAMPUNG UTARA, LAMPUNG",147,66,142,208
https://kawalpemilu.org#23274,"KALIBALANGAN, ABUNG SELATAN, LAMPUNG UTARA, LAMPUNG",148,49,142,191
https://kawalpemilu.org#23274,"KALIBALANGAN, ABUNG SELATAN, LAMPUNG UTARA, LAMPUNG",149,53,138,191
https://kawalpemilu.org#23274,"KALIBALANGAN, ABUNG SELATAN, LAMPUNG UTARA, LAMPUNG",150,85,98,183
https://kawalpemilu.org#23274,"KALIBALANGAN, ABUNG SELATAN, LAMPUNG UTARA, LAMPUNG",151,64,91,155
https://kawalpemilu.org#23274,"KALIBALANGAN, ABUNG SELATAN, LAMPUNG UTARA, LAMPUNG",152,85,77,162
https://kawalpemilu.org#23274,"KALIBALANGAN, ABUNG SELATAN, LAMPUNG UTARA, LAMPUNG",153,47,92,139
https://kawalpemilu.org#23274,"KALIBALANGAN, ABUNG SELATAN, LAMPUNG UTARA, LAMPUNG",154,62,105,167
https://kawalpemilu.org#23274,"KALIBALANGAN, ABUNG SELATAN, LAMPUNG UTARA, LAMPUNG",155,103,59,162
https://kawalpemilu.org#23274,"KALIBALANGAN, ABUNG SELATAN, LAMPUNG UTARA, LAMPUNG",156,24,33,57
https://kawalpemilu.org#23275,"TRIMODADI, ABUNG SELATAN, LAMPUNG UTARA, LAMPUNG",1,0,0,0
https://kawalpemilu.org#23275,"TRIMODADI, ABUNG SELATAN, LAMPUNG UTARA, LAMPUNG",2,0,0,0
https://kawalpemilu.org#23275,"TRIMODADI, ABUNG SELATAN, LAMPUNG UTARA, LAMPUNG",3,0,0,0
https://kawalpemilu.org#23275,"TRIMODADI, ABUNG SELATAN, LAMPUNG UTARA, LAMPUNG",4,0,0,0
https://kawalpemilu.org#23275,"TRIMODADI, ABUNG SELATAN, LAMPUNG UTARA, LAMPUNG",5,0,0,0
https://kawalpemilu.org#23275,"TRIMODADI, ABUNG SELATAN, LAMPUNG UTARA, LAMPUNG",6,0,0,0
https://kawalpemilu.org#23275,"TRIMODADI, ABUNG SELATAN, LAMPUNG UTARA, LAMPUNG",7,0,0,0
https://kawalpemilu.org#23275,"TRIMODADI, ABUNG SELATAN, LAMPUNG UTARA, LAMPUNG",8,0,0,0
https://kawalpemilu.org#23275,"TRIMODADI, ABUNG SELATAN, LAMPUNG UTARA, LAMPUNG",62,111,86,197
https://kawalpemilu.org#23275,"TRIMODADI, ABUNG SELATAN, LAMPUNG UTARA, LAMPUNG",63,126,99,225
https://kawalpemilu.org#23275,"TRIMODADI, ABUNG SELATAN, LAMPUNG UTARA, LAMPUNG",64,71,130,201
https://kawalpemilu.org#23275,"TRIMODADI, ABUNG SELATAN, LAMPUNG UTARA, LAMPUNG",65,87,109,196
https://kawalpemilu.org#23275,"TRIMODADI, ABUNG SELATAN, LAMPUNG UTARA, LAMPUNG",66,131,85,216
https://kawalpemilu.org#23275,"TRIMODADI, ABUNG SELATAN, LAMPUNG UTARA, LAMPUNG",67,99,113,212
https://kawalpemilu.org#23275,"TRIMODADI, ABUNG SELATAN, LAMPUNG UTARA, LAMPUNG",68,117,74,191
https://kawalpemilu.org#23275,"TRIMODADI, ABUNG SELATAN, LAMPUNG UTARA, LAMPUNG",69,69,99,168
https://kawalpemilu.org#23275,"TRIMODADI, ABUNG SELATAN, LAMPUNG UTARA, LAMPUNG",70,66,103,169
https://kawalpemilu.org#23275,"TRIMODADI, ABUNG SELATAN, LAMPUNG UTARA, LAMPUNG",71,70,148,218
https://kawalpemilu.org#23275,"TRIMODADI, ABUNG SELATAN, LAMPUNG UTARA, LAMPUNG",72,105,104,209
https://kawalpemilu.org#23275,"TRIMODADI, ABUNG SELATAN, LAMPUNG UTARA, LAMPUNG",73,115,96,211
https://kawalpemilu.org#23276,"CABANG EMPAT, ABUNG SELATAN, LAMPUNG UTARA, LAMPUNG",10,65,145,210
https://kawalpemilu.org#23276,"CABANG EMPAT, ABUNG SELATAN, LAMPUNG UTARA, LAMPUNG",11,58,141,199
https://kawalpemilu.org#23276,"CABANG EMPAT, ABUNG SELATAN, LAMPUNG UTARA, LAMPUNG",12,69,143,213
https://kawalpemilu.org#23276,"CABANG EMPAT, ABUNG SELATAN, LAMPUNG UTARA, LAMPUNG",13,55,121,176
https://kawalpemilu.org#23276,"CABANG EMPAT, ABUNG SELATAN, LAMPUNG UTARA, LAMPUNG",14,53,110,163
https://kawalpemilu.org#23276,"CABANG EMPAT, ABUNG SELATAN, LAMPUNG UTARA, LAMPUNG",15,91,97,188
https://kawalpemilu.org#23276,"CABANG EMPAT, ABUNG SELATAN, LAMPUNG UTARA, LAMPUNG",16,87,85,172
https://kawalpemilu.org#23277,"SINAR OGAN, ABUNG SELATAN, LAMPUNG UTARA, LAMPUNG",17,67,104,171
https://kawalpemilu.org#23277,"SINAR OGAN, ABUNG SELATAN, LAMPUNG UTARA, LAMPUNG",18,49,95,144
https://kawalpemilu.org#23277,"SINAR OGAN, ABUNG SELATAN, LAMPUNG UTARA, LAMPUNG",19,61,99,160
https://kawalpemilu.org#23277,"SINAR OGAN, ABUNG SELATAN, LAMPUNG UTARA, LAMPUNG",20,26,70,96
https://kawalpemilu.org#23277,"SINAR OGAN, ABUNG SELATAN, LAMPUNG UTARA, LAMPUNG",21,54,121,175
https://kawalpemilu.org#23277,"SINAR OGAN, ABUNG SELATAN, LAMPUNG UTARA, LAMPUNG",22,23,57,80
https://kawalpemilu.org#23278,"GILIH SUKANEGERI, ABUNG SELATAN, LAMPUNG UTARA, LAMPUNG",1,42,116,158
https://kawalpemilu.org#23278,"GILIH SUKANEGERI, ABUNG SELATAN, LAMPUNG UTARA, LAMPUNG",2,43,124,167
https://kawalpemilu.org#23278,"GILIH SUKANEGERI, ABUNG SELATAN, LAMPUNG UTARA, LAMPUNG",3,90,136,226
https://kawalpemilu.org#23278,"GILIH SUKANEGERI, ABUNG SELATAN, LAMPUNG UTARA, LAMPUNG",4,88,130,218
https://kawalpemilu.org#23278,"GILIH SUKANEGERI, ABUNG SELATAN, LAMPUNG UTARA, LAMPUNG",5,26,82,108
https://kawalpemilu.org#23278,"GILIH SUKANEGERI, ABUNG SELATAN, LAMPUNG UTARA, LAMPUNG",6,7,108,115
https://kawalpemilu.org#23279,"CANDI MAS, ABUNG SELATAN, LAMPUNG UTARA, LAMPUNG",2,0,0,0
https://kawalpemilu.org#23279,"CANDI MAS, ABUNG SELATAN, LAMPUNG UTARA, LAMPUNG",3,0,0,0
https://kawalpemilu.org#23279,"CANDI MAS, ABUNG SELATAN, LAMPUNG UTARA, LAMPUNG",11,0,0,0
https://kawalpemilu.org#23279,"CANDI MAS, ABUNG SELATAN, LAMPUNG UTARA, LAMPUNG",12,0,0,0
https://kawalpemilu.org#23279,"CANDI MAS, ABUNG SELATAN, LAMPUNG UTARA, LAMPUNG",13,0,0,0
https://kawalpemilu.org#23279,"CANDI MAS, ABUNG SELATAN, LAMPUNG UTARA, LAMPUNG",14,0,0,0
https://kawalpemilu.org#23279,"CANDI MAS, ABUNG SELATAN, LAMPUNG UTARA, LAMPUNG",48,65,111,176
https://kawalpemilu.org#23279,"CANDI MAS, ABUNG SELATAN, LAMPUNG UTARA, LAMPUNG",49,67,205,272
https://kawalpemilu.org#23279,"CANDI MAS, ABUNG SELATAN, LAMPUNG UTARA, LAMPUNG",50,57,146,203
https://kawalpemilu.org#23279,"CANDI MAS, ABUNG SELATAN, LAMPUNG UTARA, LAMPUNG",51,71,217,288
https://kawalpemilu.org#23279,"CANDI MAS, ABUNG SELATAN, LAMPUNG UTARA, LAMPUNG",52,34,96,130
https://kawalpemilu.org#23279,"CANDI MAS, ABUNG SELATAN, LAMPUNG UTARA, LAMPUNG",53,36,122,158
https://kawalpemilu.org#23279,"CANDI MAS, ABUNG SELATAN, LAMPUNG UTARA, LAMPUNG",54,32,84,116
https://kawalpemilu.org#23279,"CANDI MAS, ABUNG SELATAN, LAMPUNG UTARA, LAMPUNG",55,86,167,253
https://kawalpemilu.org#23279,"CANDI MAS, ABUNG SELATAN, LAMPUNG UTARA, LAMPUNG",56,85,115,200
https://kawalpemilu.org#23279,"CANDI MAS, ABUNG SELATAN, LAMPUNG UTARA, LAMPUNG",57,70,128,198
https://kawalpemilu.org#23279,"CANDI MAS, ABUNG SELATAN, LAMPUNG UTARA, LAMPUNG",58,100,117,217
https://kawalpemilu.org#23279,"CANDI MAS, ABUNG SELATAN, LAMPUNG UTARA, LAMPUNG",59,94,139,233
https://kawalpemilu.org#23279,"CANDI MAS, ABUNG SELATAN, LAMPUNG UTARA, LAMPUNG",60,88,74,162
https://kawalpemilu.org#23279,"CANDI MAS, ABUNG SELATAN, LAMPUNG UTARA, LAMPUNG",61,28,113,141
https://kawalpemilu.org#23280,"KEMBANG TANJUNG, ABUNG SELATAN, LAMPUNG UTARA, LAMPUNG",3,0,0,0
https://kawalpemilu.org#23280,"KEMBANG TANJUNG, ABUNG SELATAN, LAMPUNG UTARA, LAMPUNG",4,0,0,0
https://kawalpemilu.org#23280,"KEMBANG TANJUNG, ABUNG SELATAN, LAMPUNG UTARA, LAMPUNG",6,0,0,0
https://kawalpemilu.org#23280,"KEMBANG TANJUNG, ABUNG SELATAN, LAMPUNG UTARA, LAMPUNG",11,0,0,0
https://kawalpemilu.org#23280,"KEMBANG TANJUNG, ABUNG SELATAN, LAMPUNG UTARA, LAMPUNG",12,0,0,0
https://kawalpemilu.org#23280,"KEMBANG TANJUNG, ABUNG SELATAN, LAMPUNG UTARA, LAMPUNG",13,0,0,0
https://kawalpemilu.org#23280,"KEMBANG TANJUNG, ABUNG SELATAN, LAMPUNG UTARA, LAMPUNG",14,0,0,0
https://kawalpemilu.org#23280,"KEMBANG TANJUNG, ABUNG SELATAN, LAMPUNG UTARA, LAMPUNG",15,0,0,0
https://kawalpemilu.org#23280,"KEMBANG TANJUNG, ABUNG SELATAN, LAMPUNG UTARA, LAMPUNG",123,74,116,190
https://kawalpemilu.org#23280,"KEMBANG TANJUNG, ABUNG SELATAN, LAMPUNG UTARA, LAMPUNG",124,58,128,186
https://kawalpemilu.org#23280,"KEMBANG TANJUNG, ABUNG SELATAN, LAMPUNG UTARA, LAMPUNG",125,53,115,168
https://kawalpemilu.org#23280,"KEMBANG TANJUNG, ABUNG SELATAN, LAMPUNG UTARA, LAMPUNG",126,38,145,183
https://kawalpemilu.org#23280,"KEMBANG TANJUNG, ABUNG SELATAN, LAMPUNG UTARA, LAMPUNG",127,47,156,203
https://kawalpemilu.org#23280,"KEMBANG TANJUNG, ABUNG SELATAN, LAMPUNG UTARA, LAMPUNG",128,67,137,204
https://kawalpemilu.org#23280,"KEMBANG TANJUNG, ABUNG SELATAN, LAMPUNG UTARA, LAMPUNG",129,86,83,169
https://kawalpemilu.org#23280,"KEMBANG TANJUNG, ABUNG SELATAN, LAMPUNG UTARA, LAMPUNG",130,70,163,233
https://kawalpemilu.org#23280,"KEMBANG TANJUNG, ABUNG SELATAN, LAMPUNG UTARA, LAMPUNG",131,77,114,191
https://kawalpemilu.org#23280,"KEMBANG TANJUNG, ABUNG SELATAN, LAMPUNG UTARA, LAMPUNG",132,86,128,214
https://kawalpemilu.org#23280,"KEMBANG TANJUNG, ABUNG SELATAN, LAMPUNG UTARA, LAMPUNG",133,87,112,199
https://kawalpemilu.org#23280,"KEMBANG TANJUNG, ABUNG SELATAN, LAMPUNG UTARA, LAMPUNG",134,110,80,190
https://kawalpemilu.org#23280,"KEMBANG TANJUNG, ABUNG SELATAN, LAMPUNG UTARA, LAMPUNG",135,105,79,184
https://kawalpemilu.org#23280,"KEMBANG TANJUNG, ABUNG SELATAN, LAMPUNG UTARA, LAMPUNG",136,113,80,193
https://kawalpemilu.org#23280,"KEMBANG TANJUNG, ABUNG SELATAN, LAMPUNG UTARA, LAMPUNG",137,14,126,140
https://kawalpemilu.org#23281,"ABUNG JAYO, ABUNG SELATAN, LAMPUNG UTARA, LAMPUNG",1,0,0,0
https://kawalpemilu.org#23281,"ABUNG JAYO, ABUNG SELATAN, LAMPUNG UTARA, LAMPUNG",2,0,0,0
https://kawalpemilu.org#23281,"ABUNG JAYO, ABUNG SELATAN, LAMPUNG UTARA, LAMPUNG",3,0,0,0
https://kawalpemilu.org#23281,"ABUNG JAYO, ABUNG SELATAN, LAMPUNG UTARA, LAMPUNG",4,0,0,0
https://kawalpemilu.org#23281,"ABUNG JAYO, ABUNG SELATAN, LAMPUNG UTARA, LAMPUNG",5,0,0,0
https://kawalpemilu.org#23281,"ABUNG JAYO, ABUNG SELATAN, LAMPUNG UTARA, LAMPUNG",6,0,0,0
https://kawalpemilu.org#23281,"ABUNG JAYO, ABUNG SELATAN, LAMPUNG UTARA, LAMPUNG",7,0,0,0
https://kawalpemilu.org#23281,"ABUNG JAYO, ABUNG SELATAN, LAMPUNG UTARA, LAMPUNG",8,0,0,0
https://kawalpemilu.org#23281,"ABUNG JAYO, ABUNG SELATAN, LAMPUNG UTARA, LAMPUNG",10,0,0,0
https://kawalpemilu.org#23281,"ABUNG JAYO, ABUNG SELATAN, LAMPUNG UTARA, LAMPUNG",11,0,0,0
https://kawalpemilu.org#23281,"ABUNG JAYO, ABUNG SELATAN, LAMPUNG UTARA, LAMPUNG",17,0,0,0
https://kawalpemilu.org#23281,"ABUNG JAYO, ABUNG SELATAN, LAMPUNG UTARA, LAMPUNG",32,69,138,207
https://kawalpemilu.org#23281,"ABUNG JAYO, ABUNG SELATAN, LAMPUNG UTARA, LAMPUNG",33,80,183,263
https://kawalpemilu.org#23281,"ABUNG JAYO, ABUNG SELATAN, LAMPUNG UTARA, LAMPUNG",34,88,91,179
https://kawalpemilu.org#23281,"ABUNG JAYO, ABUNG SELATAN, LAMPUNG UTARA, LAMPUNG",35,50,72,122
https://kawalpemilu.org#23281,"ABUNG JAYO, ABUNG SELATAN, LAMPUNG UTARA, LAMPUNG",36,130,122,252
https://kawalpemilu.org#23281,"ABUNG JAYO, ABUNG SELATAN, LAMPUNG UTARA, LAMPUNG",37,94,146,240
https://kawalpemilu.org#23281,"ABUNG JAYO, ABUNG SELATAN, LAMPUNG UTARA, LAMPUNG",38,105,112,227
https://kawalpemilu.org#23281,"ABUNG JAYO, ABUNG SELATAN, LAMPUNG UTARA, LAMPUNG",39,104,86,190
https://kawalpemilu.org#23281,"ABUNG JAYO, ABUNG SELATAN, LAMPUNG UTARA, LAMPUNG",40,144,55,199
https://kawalpemilu.org#23281,"ABUNG JAYO, ABUNG SELATAN, LAMPUNG UTARA, LAMPUNG",41,150,40,190
https://kawalpemilu.org#23281,"ABUNG JAYO, ABUNG SELATAN, LAMPUNG UTARA, LAMPUNG",42,138,79,217
https://kawalpemilu.org#23281,"ABUNG JAYO, ABUNG SELATAN, LAMPUNG UTARA, LAMPUNG",43,93,75,168
https://kawalpemilu.org#23281,"ABUNG JAYO, ABUNG SELATAN, LAMPUNG UTARA, LAMPUNG",44,80,138,218
https://kawalpemilu.org#23281,"ABUNG JAYO, ABUNG SELATAN, LAMPUNG UTARA, LAMPUNG",45,92,124,216
https://kawalpemilu.org#23281,"ABUNG JAYO, ABUNG SELATAN, LAMPUNG UTARA, LAMPUNG",46,115,121,236
https://kawalpemilu.org#23281,"ABUNG JAYO, ABUNG SELATAN, LAMPUNG UTARA, LAMPUNG",47,130,86,216
https://kawalpemilu.org#23282,"KALIBENING RAYA, ABUNG SELATAN, LAMPUNG UTARA, LAMPUNG",8,54,97,151
https://kawalpemilu.org#23282,"KALIBENING RAYA, ABUNG SELATAN, LAMPUNG UTARA, LAMPUNG",91,31,130,161
https://kawalpemilu.org#23282,"KALIBENING RAYA, ABUNG SELATAN, LAMPUNG UTARA, LAMPUNG",92,76,106,182
https://kawalpemilu.org#23282,"KALIBENING RAYA, ABUNG SELATAN, LAMPUNG UTARA, LAMPUNG",93,37,128,165
https://kawalpemilu.org#23282,"KALIBENING RAYA, ABUNG SELATAN, LAMPUNG UTARA, LAMPUNG",94,33,140,173
https://kawalpemilu.org#23282,"KALIBENING RAYA, ABUNG SELATAN, LAMPUNG UTARA, LAMPUNG",95,56,113,169
https://kawalpemilu.org#23282,"KALIBENING RAYA, ABUNG SELATAN, LAMPUNG UTARA, LAMPUNG",96,49,116,165
https://kawalpemilu.org#23282,"KALIBENING RAYA, ABUNG SELATAN, LAMPUNG UTARA, LAMPUNG",98,48,107,155
https://kawalpemilu.org#23283,"CABANG ABUNG RAYA, ABUNG SELATAN, LAMPUNG UTARA, LAMPUNG",1,0,0,0
https://kawalpemilu.org#23283,"CABANG ABUNG RAYA, ABUNG SELATAN, LAMPUNG UTARA, LAMPUNG",7,46,179,225
https://kawalpemilu.org#23283,"CABANG ABUNG RAYA, ABUNG SELATAN, LAMPUNG UTARA, LAMPUNG",8,29,129,158
https://kawalpemilu.org#23284,"KEMALO ABUNG, ABUNG SELATAN, LAMPUNG UTARA, LAMPUNG",6,0,0,0
https://kawalpemilu.org#23284,"KEMALO ABUNG, ABUNG SELATAN, LAMPUNG UTARA, LAMPUNG",74,134,86,220
https://kawalpemilu.org#23284,"KEMALO ABUNG, ABUNG SELATAN, LAMPUNG UTARA, LAMPUNG",75,107,95,202
https://kawalpemilu.org#23284,"KEMALO ABUNG, ABUNG SELATAN, LAMPUNG UTARA, LAMPUNG",76,129,80,209
https://kawalpemilu.org#23284,"KEMALO ABUNG, ABUNG SELATAN, LAMPUNG UTARA, LAMPUNG",77,114,59,173
https://kawalpemilu.org#23284,"KEMALO ABUNG, ABUNG SELATAN, LAMPUNG UTARA, LAMPUNG",78,135,70,205
https://kawalpemilu.org#23284,"KEMALO ABUNG, ABUNG SELATAN, LAMPUNG UTARA, LAMPUNG",79,131,62,193
https://kawalpemilu.org#23284,"KEMALO ABUNG, ABUNG SELATAN, LAMPUNG UTARA, LAMPUNG",80,97,70,167
https://kawalpemilu.org#23284,"KEMALO ABUNG, ABUNG SELATAN, LAMPUNG UTARA, LAMPUNG",81,101,66,167
https://kawalpemilu.org#23284,"KEMALO ABUNG, ABUNG SELATAN, LAMPUNG UTARA, LAMPUNG",82,116,90,206
https://kawalpemilu.org#23285,"BUMI RAYA, ABUNG SELATAN, LAMPUNG UTARA, LAMPUNG",2,0,0,0
https://kawalpemilu.org#23285,"BUMI RAYA, ABUNG SELATAN, LAMPUNG UTARA, LAMPUNG",6,0,0,0
https://kawalpemilu.org#23285,"BUMI RAYA, ABUNG SELATAN, LAMPUNG UTARA, LAMPUNG",8,0,0,0
https://kawalpemilu.org#23285,"BUMI RAYA, ABUNG SELATAN, LAMPUNG UTARA, LAMPUNG",9,0,0,0
https://kawalpemilu.org#23285,"BUMI RAYA, ABUNG SELATAN, LAMPUNG UTARA, LAMPUNG",12,0,0,0
https://kawalpemilu.org#23285,"BUMI RAYA, ABUNG SELATAN, LAMPUNG UTARA, LAMPUNG",99,23,167,190
https://kawalpemilu.org#23285,"BUMI RAYA, ABUNG SELATAN, LAMPUNG UTARA, LAMPUNG",100,21,189,210
https://kawalpemilu.org#23285,"BUMI RAYA, ABUNG SELATAN, LAMPUNG UTARA, LAMPUNG",101,35,142,177
https://kawalpemilu.org#23285,"BUMI RAYA, ABUNG SELATAN, LAMPUNG UTARA, LAMPUNG",102,74,178,252
https://kawalpemilu.org#23285,"BUMI RAYA, ABUNG SELATAN, LAMPUNG UTARA, LAMPUNG",103,78,149,227
https://kawalpemilu.org#23285,"BUMI RAYA, ABUNG SELATAN, LAMPUNG UTARA, LAMPUNG",104,71,161,232
https://kawalpemilu.org#23285,"BUMI RAYA, ABUNG SELATAN, LAMPUNG UTARA, LAMPUNG",105,48,94,142
https://kawalpemilu.org#23285,"BUMI RAYA, ABUNG SELATAN, LAMPUNG UTARA, LAMPUNG",106,43,122,165
https://kawalpemilu.org#23285,"BUMI RAYA, ABUNG SELATAN, LAMPUNG UTARA, LAMPUNG",107,46,130,176
https://kawalpemilu.org#23285,"BUMI RAYA, ABUNG SELATAN, LAMPUNG UTARA, LAMPUNG",108,68,124,192
https://kawalpemilu.org#23285,"BUMI RAYA, ABUNG SELATAN, LAMPUNG UTARA, LAMPUNG",109,83,150,233
https://kawalpemilu.org#23285,"BUMI RAYA, ABUNG SELATAN, LAMPUNG UTARA, LAMPUNG",110,58,149,207
https://kawalpemilu.org#23286,"RATU ABUNG, ABUNG SELATAN, LAMPUNG UTARA, LAMPUNG",1,0,0,0
https://kawalpemilu.org#23286,"RATU ABUNG, ABUNG SELATAN, LAMPUNG UTARA, LAMPUNG",2,0,0,0
https://kawalpemilu.org#23286,"RATU ABUNG, ABUNG SELATAN, LAMPUNG UTARA, LAMPUNG",3,0,0,0
https://kawalpemilu.org#23286,"RATU ABUNG, ABUNG SELATAN, LAMPUNG UTARA, LAMPUNG",4,0,0,0
https://kawalpemilu.org#23286,"RATU ABUNG, ABUNG SELATAN, LAMPUNG UTARA, LAMPUNG",5,0,0,0
https://kawalpemilu.org#23286,"RATU ABUNG, ABUNG SELATAN, LAMPUNG UTARA, LAMPUNG",83,86,81,167
https://kawalpemilu.org#23286,"RATU ABUNG, ABUNG SELATAN, LAMPUNG UTARA, LAMPUNG",84,103,139,242
https://kawalpemilu.org#23286,"RATU ABUNG, ABUNG SELATAN, LAMPUNG UTARA, LAMPUNG",85,106,88,194
https://kawalpemilu.org#23286,"RATU ABUNG, ABUNG SELATAN, LAMPUNG UTARA, LAMPUNG",86,92,91,183
https://kawalpemilu.org#23286,"RATU ABUNG, ABUNG SELATAN, LAMPUNG UTARA, LAMPUNG",87,133,103,236
https://kawalpemilu.org#23286,"RATU ABUNG, ABUNG SELATAN, LAMPUNG UTARA, LAMPUNG",88,121,91,212
https://kawalpemilu.org#23286,"RATU ABUNG, ABUNG SELATAN, LAMPUNG UTARA, LAMPUNG",89,103,62,165
https://kawalpemilu.org#23287,"BANDAR KAGUNGAN RAYA, ABUNG SELATAN, LAMPUNG UTARA, LAMPUNG",2,0,0,0
https://kawalpemilu.org#23287,"BANDAR KAGUNGAN RAYA, ABUNG SELATAN, LAMPUNG UTARA, LAMPUNG",9,0,0,0
https://kawalpemilu.org#23287,"BANDAR KAGUNGAN RAYA, ABUNG SELATAN, LAMPUNG UTARA, LAMPUNG",114,101,153,254
https://kawalpemilu.org#23287,"BANDAR KAGUNGAN RAYA, ABUNG SELATAN, LAMPUNG UTARA, LAMPUNG",115,122,117,239
https://kawalpemilu.org#23287,"BANDAR KAGUNGAN RAYA, ABUNG SELATAN, LAMPUNG UTARA, LAMPUNG",116,64,119,183
https://kawalpemilu.org#23287,"BANDAR KAGUNGAN RAYA, ABUNG SELATAN, LAMPUNG UTARA, LAMPUNG",117,63,131,194
https://kawalpemilu.org#23287,"BANDAR KAGUNGAN RAYA, ABUNG SELATAN, LAMPUNG UTARA, LAMPUNG",118,64,110,174
https://kawalpemilu.org#23287,"BANDAR KAGUNGAN RAYA, ABUNG SELATAN, LAMPUNG UTARA, LAMPUNG",119,42,109,151
https://kawalpemilu.org#23287,"BANDAR KAGUNGAN RAYA, ABUNG SELATAN, LAMPUNG UTARA, LAMPUNG",120,37,106,143
https://kawalpemilu.org#23287,"BANDAR KAGUNGAN RAYA, ABUNG SELATAN, LAMPUNG UTARA, LAMPUNG",121,89,144,233
https://kawalpemilu.org#23287,"BANDAR KAGUNGAN RAYA, ABUNG SELATAN, LAMPUNG UTARA, LAMPUNG",122,28,68,96
https://kawalpemilu.org#23288,"KEMBANG GADING, ABUNG SELATAN, LAMPUNG UTARA, LAMPUNG",1,0,0,0
https://kawalpemilu.org#23288,"KEMBANG GADING, ABUNG SELATAN, LAMPUNG UTARA, LAMPUNG",2,0,0,0
https://kawalpemilu.org#23288,"KEMBANG GADING, ABUNG SELATAN, LAMPUNG UTARA, LAMPUNG",5,0,0,0
https://kawalpemilu.org#23288,"KEMBANG GADING, ABUNG SELATAN, LAMPUNG UTARA, LAMPUNG",23,79,104,183
https://kawalpemilu.org#23288,"KEMBANG GADING, ABUNG SELATAN, LAMPUNG UTARA, LAMPUNG",24,51,134,185
https://kawalpemilu.org#23288,"KEMBANG GADING, ABUNG SELATAN, LAMPUNG UTARA, LAMPUNG",25,60,98,158
https://kawalpemilu.org#23288,"KEMBANG GADING, ABUNG SELATAN, LAMPUNG UTARA, LAMPUNG",26,60,108,168
https://kawalpemilu.org#23288,"KEMBANG GADING, ABUNG SELATAN, LAMPUNG UTARA, LAMPUNG",27,30,138,168
https://kawalpemilu.org#23288,"KEMBANG GADING, ABUNG SELATAN, LAMPUNG UTARA, LAMPUNG",28,25,147,172
https://kawalpemilu.org#23288,"KEMBANG GADING, ABUNG SELATAN, LAMPUNG UTARA, LAMPUNG",29,19,127,146
https://kawalpemilu.org#23288,"KEMBANG GADING, ABUNG SELATAN, LAMPUNG UTARA, LAMPUNG",30,22,125,147
https://kawalpemilu.org#23289,"WAY LUNIK, ABUNG SELATAN, LAMPUNG UTARA, LAMPUNG",1,0,0,0
https://kawalpemilu.org#23289,"WAY LUNIK, ABUNG SELATAN, LAMPUNG UTARA, LAMPUNG",2,0,0,0
https://kawalpemilu.org#23289,"WAY LUNIK, ABUNG SELATAN, LAMPUNG UTARA, LAMPUNG",3,0,0,0
https://kawalpemilu.org#23289,"WAY LUNIK, ABUNG SELATAN, LAMPUNG UTARA, LAMPUNG",111,54,180,234
https://kawalpemilu.org#23289,"WAY LUNIK, ABUNG SELATAN, LAMPUNG UTARA, LAMPUNG",112,88,122,210
https://kawalpemilu.org#23289,"WAY LUNIK, ABUNG SELATAN, LAMPUNG UTARA, LAMPUNG",113,65,122,187
https://kawalpemilu.org#23291,"OGAN JAYA, SUNGKAI UTARA, LAMPUNG UTARA, LAMPUNG",1,0,0,0
https://kawalpemilu.org#23291,"OGAN JAYA, SUNGKAI UTARA, LAMPUNG UTARA, LAMPUNG",2,0,0,0
https://kawalpemilu.org#23291,"OGAN JAYA, SUNGKAI UTARA, LAMPUNG UTARA, LAMPUNG",3,0,0,0
https://kawalpemilu.org#23291,"OGAN JAYA, SUNGKAI UTARA, LAMPUNG UTARA, LAMPUNG",5,0,0,0
https://kawalpemilu.org#23291,"OGAN JAYA, SUNGKAI UTARA, LAMPUNG UTARA, LAMPUNG",6,0,0,0
https://kawalpemilu.org#23291,"OGAN JAYA, SUNGKAI UTARA, LAMPUNG UTARA, LAMPUNG",7,0,0,0
https://kawalpemilu.org#23291,"OGAN JAYA, SUNGKAI UTARA, LAMPUNG UTARA, LAMPUNG",8,0,0,0
https://kawalpemilu.org#23291,"OGAN JAYA, SUNGKAI UTARA, LAMPUNG UTARA, LAMPUNG",9,0,0,0
https://kawalpemilu.org#23291,"OGAN JAYA, SUNGKAI UTARA, LAMPUNG UTARA, LAMPUNG",10,0,0,0
https://kawalpemilu.org#23291,"OGAN JAYA, SUNGKAI UTARA, LAMPUNG UTARA, LAMPUNG",11,0,0,0
https://kawalpemilu.org#23291,"OGAN JAYA, SUNGKAI UTARA, LAMPUNG UTARA, LAMPUNG",91,11,96,107
https://kawalpemilu.org#23291,"OGAN JAYA, SUNGKAI UTARA, LAMPUNG UTARA, LAMPUNG",92,121,82,203
https://kawalpemilu.org#23291,"OGAN JAYA, SUNGKAI UTARA, LAMPUNG UTARA, LAMPUNG",93,113,54,167
https://kawalpemilu.org#23291,"OGAN JAYA, SUNGKAI UTARA, LAMPUNG UTARA, LAMPUNG",94,105,66,171
https://kawalpemilu.org#23291,"OGAN JAYA, SUNGKAI UTARA, LAMPUNG UTARA, LAMPUNG",95,60,52,112
https://kawalpemilu.org#23291,"OGAN JAYA, SUNGKAI UTARA, LAMPUNG UTARA, LAMPUNG",96,35,215,250
https://kawalpemilu.org#23291,"OGAN JAYA, SUNGKAI UTARA, LAMPUNG UTARA, LAMPUNG",97,16,169,185
https://kawalpemilu.org#23291,"OGAN JAYA, SUNGKAI UTARA, LAMPUNG UTARA, LAMPUNG",98,119,48,167
https://kawalpemilu.org#23291,"OGAN JAYA, SUNGKAI UTARA, LAMPUNG UTARA, LAMPUNG",99,107,61,168
https://kawalpemilu.org#23291,"OGAN JAYA, SUNGKAI UTARA, LAMPUNG UTARA, LAMPUNG",100,75,89,164
https://kawalpemilu.org#23291,"OGAN JAYA, SUNGKAI UTARA, LAMPUNG UTARA, LAMPUNG",101,51,118,169
https://kawalpemilu.org#23292,"CIAMIS, SUNGKAI UTARA, LAMPUNG UTARA, LAMPUNG",1,0,0,0
https://kawalpemilu.org#23292,"CIAMIS, SUNGKAI UTARA, LAMPUNG UTARA, LAMPUNG",2,0,0,0
https://kawalpemilu.org#23292,"CIAMIS, SUNGKAI UTARA, LAMPUNG UTARA, LAMPUNG",3,0,0,0
https://kawalpemilu.org#23292,"CIAMIS, SUNGKAI UTARA, LAMPUNG UTARA, LAMPUNG",4,27,143,170
https://kawalpemilu.org#23292,"CIAMIS, SUNGKAI UTARA, LAMPUNG UTARA, LAMPUNG",5,13,192,205
https://kawalpemilu.org#23292,"CIAMIS, SUNGKAI UTARA, LAMPUNG UTARA, LAMPUNG",23,81,132,213
https://kawalpemilu.org#23292,"CIAMIS, SUNGKAI UTARA, LAMPUNG UTARA, LAMPUNG",24,55,136,191
https://kawalpemilu.org#23292,"CIAMIS, SUNGKAI UTARA, LAMPUNG UTARA, LAMPUNG",25,30,157,187
https://kawalpemilu.org#23292,"CIAMIS, SUNGKAI UTARA, LAMPUNG UTARA, LAMPUNG",26,27,143,170
https://kawalpemilu.org#23292,"CIAMIS, SUNGKAI UTARA, LAMPUNG UTARA, LAMPUNG",27,13,192,205
https://kawalpemilu.org#23293,"PADANG RATU, SUNGKAI UTARA, LAMPUNG UTARA, LAMPUNG",1,0,0,0
https://kawalpemilu.org#23293,"PADANG RATU, SUNGKAI UTARA, LAMPUNG UTARA, LAMPUNG",2,0,0,0
https://kawalpemilu.org#23293,"PADANG RATU, SUNGKAI UTARA, LAMPUNG UTARA, LAMPUNG",3,0,0,0
https://kawalpemilu.org#23293,"PADANG RATU, SUNGKAI UTARA, LAMPUNG UTARA, LAMPUNG",4,0,0,0
https://kawalpemilu.org#23293,"PADANG RATU, SUNGKAI UTARA, LAMPUNG UTARA, LAMPUNG",5,0,0,0
https://kawalpemilu.org#23293,"PADANG RATU, SUNGKAI UTARA, LAMPUNG UTARA, LAMPUNG",6,0,0,0
https://kawalpemilu.org#23293,"PADANG RATU, SUNGKAI UTARA, LAMPUNG UTARA, LAMPUNG",7,0,0,0
https://kawalpemilu.org#23293,"PADANG RATU, SUNGKAI UTARA, LAMPUNG UTARA, LAMPUNG",8,0,0,0
https://kawalpemilu.org#23293,"PADANG RATU, SUNGKAI UTARA, LAMPUNG UTARA, LAMPUNG",9,0,0,0
https://kawalpemilu.org#23293,"PADANG RATU, SUNGKAI UTARA, LAMPUNG UTARA, LAMPUNG",102,16,77,93
https://kawalpemilu.org#23293,"PADANG RATU, SUNGKAI UTARA, LAMPUNG UTARA, LAMPUNG",103,45,144,189
https://kawalpemilu.org#23293,"PADANG RATU, SUNGKAI UTARA, LAMPUNG UTARA, LAMPUNG",104,56,95,151
https://kawalpemilu.org#23293,"PADANG RATU, SUNGKAI UTARA, LAMPUNG UTARA, LAMPUNG",105,48,209,257
https://kawalpemilu.org#23293,"PADANG RATU, SUNGKAI UTARA, LAMPUNG UTARA, LAMPUNG",106,51,144,195
https://kawalpemilu.org#23293,"PADANG RATU, SUNGKAI UTARA, LAMPUNG UTARA, LAMPUNG",107,51,134,185
https://kawalpemilu.org#23293,"PADANG RATU, SUNGKAI UTARA, LAMPUNG UTARA, LAMPUNG",108,41,134,175
https://kawalpemilu.org#23293,"PADANG RATU, SUNGKAI UTARA, LAMPUNG UTARA, LAMPUNG",109,74,152,226
https://kawalpemilu.org#23293,"PADANG RATU, SUNGKAI UTARA, LAMPUNG UTARA, LAMPUNG",110,54,163,217
https://kawalpemilu.org#23294,"NEGERI SAKTI, SUNGKAI UTARA, LAMPUNG UTARA, LAMPUNG",1,0,0,0
https://kawalpemilu.org#23294,"NEGERI SAKTI, SUNGKAI UTARA, LAMPUNG UTARA, LAMPUNG",2,121,100,221
https://kawalpemilu.org#23294,"NEGERI SAKTI, SUNGKAI UTARA, LAMPUNG UTARA, LAMPUNG",89,68,140,208
https://kawalpemilu.org#23295,"NEGERI RATU, SUNGKAI UTARA, LAMPUNG UTARA, LAMPUNG",1,0,0,0
https://kawalpemilu.org#23295,"NEGERI RATU, SUNGKAI UTARA, LAMPUNG UTARA, LAMPUNG",2,0,0,0
https://kawalpemilu.org#23295,"NEGERI RATU, SUNGKAI UTARA, LAMPUNG UTARA, LAMPUNG",3,0,0,0
https://kawalpemilu.org#23295,"NEGERI RATU, SUNGKAI UTARA, LAMPUNG UTARA, LAMPUNG",4,0,0,0
https://kawalpemilu.org#23295,"NEGERI RATU, SUNGKAI UTARA, LAMPUNG UTARA, LAMPUNG",5,0,0,0
https://kawalpemilu.org#23295,"NEGERI RATU, SUNGKAI UTARA, LAMPUNG UTARA, LAMPUNG",6,0,0,0
https://kawalpemilu.org#23295,"NEGERI RATU, SUNGKAI UTARA, LAMPUNG UTARA, LAMPUNG",7,0,0,0
https://kawalpemilu.org#23295,"NEGERI RATU, SUNGKAI UTARA, LAMPUNG UTARA, LAMPUNG",82,37,217,254
https://kawalpemilu.org#23295,"NEGERI RATU, SUNGKAI UTARA, LAMPUNG UTARA, LAMPUNG",83,68,47,115
https://kawalpemilu.org#23295,"NEGERI RATU, SUNGKAI UTARA, LAMPUNG UTARA, LAMPUNG",84,76,74,150
https://kawalpemilu.org#23295,"NEGERI RATU, SUNGKAI UTARA, LAMPUNG UTARA, LAMPUNG",85,85,62,147
https://kawalpemilu.org#23295,"NEGERI RATU, SUNGKAI UTARA, LAMPUNG UTARA, LAMPUNG",86,73,78,151
https://kawalpemilu.org#23295,"NEGERI RATU, SUNGKAI UTARA, LAMPUNG UTARA, LAMPUNG",87,68,64,132
https://kawalpemilu.org#23295,"NEGERI RATU, SUNGKAI UTARA, LAMPUNG UTARA, LAMPUNG",88,122,103,225
https://kawalpemilu.org#23296,"NEGARA RATU, SUNGKAI UTARA, LAMPUNG UTARA, LAMPUNG",1,0,0,0
https://kawalpemilu.org#23296,"NEGARA RATU, SUNGKAI UTARA, LAMPUNG UTARA, LAMPUNG",2,0,0,0
https://kawalpemilu.org#23296,"NEGARA RATU, SUNGKAI UTARA, LAMPUNG UTARA, LAMPUNG",3,0,0,0
https://kawalpemilu.org#23296,"NEGARA RATU, SUNGKAI UTARA, LAMPUNG UTARA, LAMPUNG",4,44,111,155
https://kawalpemilu.org#23296,"NEGARA RATU, SUNGKAI UTARA, LAMPUNG UTARA, LAMPUNG",5,0,0,0
https://kawalpemilu.org#23296,"NEGARA RATU, SUNGKAI UTARA, LAMPUNG UTARA, LAMPUNG",6,0,0,0
https://kawalpemilu.org#23296,"NEGARA RATU, SUNGKAI UTARA, LAMPUNG UTARA, LAMPUNG",7,0,0,0
https://kawalpemilu.org#23296,"NEGARA RATU, SUNGKAI UTARA, LAMPUNG UTARA, LAMPUNG",8,0,0,0
https://kawalpemilu.org#23296,"NEGARA RATU, SUNGKAI UTARA, LAMPUNG UTARA, LAMPUNG",9,0,0,0
https://kawalpemilu.org#23296,"NEGARA RATU, SUNGKAI UTARA, LAMPUNG UTARA, LAMPUNG",10,0,0,0
https://kawalpemilu.org#23296,"NEGARA RATU, SUNGKAI UTARA, LAMPUNG UTARA, LAMPUNG",11,0,0,0
https://kawalpemilu.org#23296,"NEGARA RATU, SUNGKAI UTARA, LAMPUNG UTARA, LAMPUNG",12,0,0,0
https://kawalpemilu.org#23296,"NEGARA RATU, SUNGKAI UTARA, LAMPUNG UTARA, LAMPUNG",13,0,0,0
https://kawalpemilu.org#23296,"NEGARA RATU, SUNGKAI UTARA, LAMPUNG UTARA, LAMPUNG",14,0,0,0
https://kawalpemilu.org#23296,"NEGARA RATU, SUNGKAI UTARA, LAMPUNG UTARA, LAMPUNG",15,0,0,0
https://kawalpemilu.org#23296,"NEGARA RATU, SUNGKAI UTARA, LAMPUNG UTARA, LAMPUNG",16,0,0,0
https://kawalpemilu.org#23296,"NEGARA RATU, SUNGKAI UTARA, LAMPUNG UTARA, LAMPUNG",17,0,0,0
https://kawalpemilu.org#23296,"NEGARA RATU, SUNGKAI UTARA, LAMPUNG UTARA, LAMPUNG",18,0,0,0
https://kawalpemilu.org#23296,"NEGARA RATU, SUNGKAI UTARA, LAMPUNG UTARA, LAMPUNG",19,0,0,0
https://kawalpemilu.org#23296,"NEGARA RATU, SUNGKAI UTARA, LAMPUNG UTARA, LAMPUNG",20,0,0,0
https://kawalpemilu.org#23296,"NEGARA RATU, SUNGKAI UTARA, LAMPUNG UTARA, LAMPUNG",21,0,0,0
https://kawalpemilu.org#23296,"NEGARA RATU, SUNGKAI UTARA, LAMPUNG UTARA, LAMPUNG",22,0,0,0
https://kawalpemilu.org#23296,"NEGARA RATU, SUNGKAI UTARA, LAMPUNG UTARA, LAMPUNG",60,43,125,168
https://kawalpemilu.org#23296,"NEGARA RATU, SUNGKAI UTARA, LAMPUNG UTARA, LAMPUNG",61,43,124,167
https://kawalpemilu.org#23296,"NEGARA RATU, SUNGKAI UTARA, LAMPUNG UTARA, LAMPUNG",62,67,98,165
https://kawalpemilu.org#23296,"NEGARA RATU, SUNGKAI UTARA, LAMPUNG UTARA, LAMPUNG",64,54,134,188
https://kawalpemilu.org#23296,"NEGARA RATU, SUNGKAI UTARA, LAMPUNG UTARA, LAMPUNG",65,93,96,189
https://kawalpemilu.org#23296,"NEGARA RATU, SUNGKAI UTARA, LAMPUNG UTARA, LAMPUNG",66,56,109,165
https://kawalpemilu.org#23296,"NEGARA RATU, SUNGKAI UTARA, LAMPUNG UTARA, LAMPUNG",67,62,117,179
https://kawalpemilu.org#23296,"NEGARA RATU, SUNGKAI UTARA, LAMPUNG UTARA, LAMPUNG",68,78,129,207
https://kawalpemilu.org#23296,"NEGARA RATU, SUNGKAI UTARA, LAMPUNG UTARA, LAMPUNG",69,78,116,194
https://kawalpemilu.org#23296,"NEGARA RATU, SUNGKAI UTARA, LAMPUNG UTARA, LAMPUNG",70,94,134,228
https://kawalpemilu.org#23296,"NEGARA RATU, SUNGKAI UTARA, LAMPUNG UTARA, LAMPUNG",71,98,142,240
https://kawalpemilu.org#23296,"NEGARA RATU, SUNGKAI UTARA, LAMPUNG UTARA, LAMPUNG",72,152,53,205
https://kawalpemilu.org#23296,"NEGARA RATU, SUNGKAI UTARA, LAMPUNG UTARA, LAMPUNG",73,143,78,221
https://kawalpemilu.org#23296,"NEGARA RATU, SUNGKAI UTARA, LAMPUNG UTARA, LAMPUNG",74,186,50,236
https://kawalpemilu.org#23296,"NEGARA RATU, SUNGKAI UTARA, LAMPUNG UTARA, LAMPUNG",75,104,128,232
https://kawalpemilu.org#23296,"NEGARA RATU, SUNGKAI UTARA, LAMPUNG UTARA, LAMPUNG",76,137,96,233
https://kawalpemilu.org#23296,"NEGARA RATU, SUNGKAI UTARA, LAMPUNG UTARA, LAMPUNG",77,197,49,246
https://kawalpemilu.org#23296,"NEGARA RATU, SUNGKAI UTARA, LAMPUNG UTARA, LAMPUNG",78,114,59,173
https://kawalpemilu.org#23296,"NEGARA RATU, SUNGKAI UTARA, LAMPUNG UTARA, LAMPUNG",79,153,88,241
https://kawalpemilu.org#23296,"NEGARA RATU, SUNGKAI UTARA, LAMPUNG UTARA, LAMPUNG",80,64,143,207
https://kawalpemilu.org#23296,"NEGARA RATU, SUNGKAI UTARA, LAMPUNG UTARA, LAMPUNG",81,45,41,86
https://kawalpemilu.org#23297,"BATU RAJA, SUNGKAI UTARA, LAMPUNG UTARA, LAMPUNG",1,0,0,0
https://kawalpemilu.org#23297,"BATU RAJA, SUNGKAI UTARA, LAMPUNG UTARA, LAMPUNG",2,0,0,0
https://kawalpemilu.org#23297,"BATU RAJA, SUNGKAI UTARA, LAMPUNG UTARA, LAMPUNG",3,0,0,0
https://kawalpemilu.org#23297,"BATU RAJA, SUNGKAI UTARA, LAMPUNG UTARA, LAMPUNG",4,30,110,140
https://kawalpemilu.org#23297,"BATU RAJA, SUNGKAI UTARA, LAMPUNG UTARA, LAMPUNG",5,103,78,181
https://kawalpemilu.org#23297,"BATU RAJA, SUNGKAI UTARA, LAMPUNG UTARA, LAMPUNG",6,0,0,0
https://kawalpemilu.org#23297,"BATU RAJA, SUNGKAI UTARA, LAMPUNG UTARA, LAMPUNG",8,0,0,0
https://kawalpemilu.org#23297,"BATU RAJA, SUNGKAI UTARA, LAMPUNG UTARA, LAMPUNG",9,0,0,0
https://kawalpemilu.org#23297,"BATU RAJA, SUNGKAI UTARA, LAMPUNG UTARA, LAMPUNG",10,0,0,0
https://kawalpemilu.org#23297,"BATU RAJA, SUNGKAI UTARA, LAMPUNG UTARA, LAMPUNG",11,0,0,0
https://kawalpemilu.org#23297,"BATU RAJA, SUNGKAI UTARA, LAMPUNG UTARA, LAMPUNG",12,70,99,169
https://kawalpemilu.org#23297,"BATU RAJA, SUNGKAI UTARA, LAMPUNG UTARA, LAMPUNG",13,70,76,146
https://kawalpemilu.org#23297,"BATU RAJA, SUNGKAI UTARA, LAMPUNG UTARA, LAMPUNG",14,34,113,147
https://kawalpemilu.org#23297,"BATU RAJA, SUNGKAI UTARA, LAMPUNG UTARA, LAMPUNG",17,82,88,170
https://kawalpemilu.org#23297,"BATU RAJA, SUNGKAI UTARA, LAMPUNG UTARA, LAMPUNG",19,138,52,190
https://kawalpemilu.org#23297,"BATU RAJA, SUNGKAI UTARA, LAMPUNG UTARA, LAMPUNG",20,94,72,166
https://kawalpemilu.org#23297,"BATU RAJA, SUNGKAI UTARA, LAMPUNG UTARA, LAMPUNG",21,88,80,168
https://kawalpemilu.org#23297,"BATU RAJA, SUNGKAI UTARA, LAMPUNG UTARA, LAMPUNG",22,98,88,186
https://kawalpemilu.org#23298,"GEDUNG BATIN, SUNGKAI UTARA, LAMPUNG UTARA, LAMPUNG",1,0,0,0
https://kawalpemilu.org#23298,"GEDUNG BATIN, SUNGKAI UTARA, LAMPUNG UTARA, LAMPUNG",2,0,0,0
https://kawalpemilu.org#23298,"GEDUNG BATIN, SUNGKAI UTARA, LAMPUNG UTARA, LAMPUNG",3,98,96,194
https://kawalpemilu.org#23298,"GEDUNG BATIN, SUNGKAI UTARA, LAMPUNG UTARA, LAMPUNG",28,90,116,206
https://kawalpemilu.org#23298,"GEDUNG BATIN, SUNGKAI UTARA, LAMPUNG UTARA, LAMPUNG",29,74,116,190
https://kawalpemilu.org#23298,"GEDUNG BATIN, SUNGKAI UTARA, LAMPUNG UTARA, LAMPUNG",31,36,139,175
https://kawalpemilu.org#23298,"GEDUNG BATIN, SUNGKAI UTARA, LAMPUNG UTARA, LAMPUNG",32,59,137,196
https://kawalpemilu.org#23299,"NEGARA BATIN, SUNGKAI UTARA, LAMPUNG UTARA, LAMPUNG",1,19,153,172
https://kawalpemilu.org#23299,"NEGARA BATIN, SUNGKAI UTARA, LAMPUNG UTARA, LAMPUNG",2,119,110,229
https://kawalpemilu.org#23299,"NEGARA BATIN, SUNGKAI UTARA, LAMPUNG UTARA, LAMPUNG",3,145,58,203
https://kawalpemilu.org#23299,"NEGARA BATIN, SUNGKAI UTARA, LAMPUNG UTARA, LAMPUNG",4,118,92,210
https://kawalpemilu.org#23299,"NEGARA BATIN, SUNGKAI UTARA, LAMPUNG UTARA, LAMPUNG",54,19,153,172
https://kawalpemilu.org#23300,"KOTA NEGARA, SUNGKAI UTARA, LAMPUNG UTARA, LAMPUNG",1,0,0,0
https://kawalpemilu.org#23300,"KOTA NEGARA, SUNGKAI UTARA, LAMPUNG UTARA, LAMPUNG",2,0,0,0
https://kawalpemilu.org#23300,"KOTA NEGARA, SUNGKAI UTARA, LAMPUNG UTARA, LAMPUNG",3,0,0,0
https://kawalpemilu.org#23300,"KOTA NEGARA, SUNGKAI UTARA, LAMPUNG UTARA, LAMPUNG",4,0,0,0
https://kawalpemilu.org#23300,"KOTA NEGARA, SUNGKAI UTARA, LAMPUNG UTARA, LAMPUNG",5,0,0,0
https://kawalpemilu.org#23300,"KOTA NEGARA, SUNGKAI UTARA, LAMPUNG UTARA, LAMPUNG",6,0,0,0
https://kawalpemilu.org#23300,"KOTA NEGARA, SUNGKAI UTARA, LAMPUNG UTARA, LAMPUNG",7,0,0,0
https://kawalpemilu.org#23300,"KOTA NEGARA, SUNGKAI UTARA, LAMPUNG UTARA, LAMPUNG",8,0,0,0
https://kawalpemilu.org#23300,"KOTA NEGARA, SUNGKAI UTARA, LAMPUNG UTARA, LAMPUNG",9,0,0,0
https://kawalpemilu.org#23300,"KOTA NEGARA, SUNGKAI UTARA, LAMPUNG UTARA, LAMPUNG",41,72,184,256
https://kawalpemilu.org#23300,"KOTA NEGARA, SUNGKAI UTARA, LAMPUNG UTARA, LAMPUNG",42,108,84,192
https://kawalpemilu.org#23300,"KOTA NEGARA, SUNGKAI UTARA, LAMPUNG UTARA, LAMPUNG",43,143,66,209
https://kawalpemilu.org#23300,"KOTA NEGARA, SUNGKAI UTARA, LAMPUNG UTARA, LAMPUNG",44,103,55,158
https://kawalpemilu.org#23300,"KOTA NEGARA, SUNGKAI UTARA, LAMPUNG UTARA, LAMPUNG",45,141,72,213
https://kawalpemilu.org#23300,"KOTA NEGARA, SUNGKAI UTARA, LAMPUNG UTARA, LAMPUNG",46,92,67,159
https://kawalpemilu.org#23300,"KOTA NEGARA, SUNGKAI UTARA, LAMPUNG UTARA, LAMPUNG",47,107,69,176
https://kawalpemilu.org#23300,"KOTA NEGARA, SUNGKAI UTARA, LAMPUNG UTARA, LAMPUNG",48,124,71,195
https://kawalpemilu.org#23300,"KOTA NEGARA, SUNGKAI UTARA, LAMPUNG UTARA, LAMPUNG",49,118,101,219
https://kawalpemilu.org#23301,"BANGUN JAYA, SUNGKAI UTARA, LAMPUNG UTARA, LAMPUNG",1,67,74,141
https://kawalpemilu.org#23301,"BANGUN JAYA, SUNGKAI UTARA, LAMPUNG UTARA, LAMPUNG",2,40,129,169
https://kawalpemilu.org#23301,"BANGUN JAYA, SUNGKAI UTARA, LAMPUNG UTARA, LAMPUNG",3,64,85,149
https://kawalpemilu.org#23302,"BARU RAHARJA, SUNGKAI UTARA, LAMPUNG UTARA, LAMPUNG",1,0,0,0
https://kawalpemilu.org#23302,"BARU RAHARJA, SUNGKAI UTARA, LAMPUNG UTARA, LAMPUNG",2,0,0,0
https://kawalpemilu.org#23302,"BARU RAHARJA, SUNGKAI UTARA, LAMPUNG UTARA, LAMPUNG",3,0,0,0
https://kawalpemilu.org#23302,"BARU RAHARJA, SUNGKAI UTARA, LAMPUNG UTARA, LAMPUNG",4,85,101,186
https://kawalpemilu.org#23302,"BARU RAHARJA, SUNGKAI UTARA, LAMPUNG UTARA, LAMPUNG",5,162,36,198
https://kawalpemilu.org#23302,"BARU RAHARJA, SUNGKAI UTARA, LAMPUNG UTARA, LAMPUNG",6,100,45,145
https://kawalpemilu.org#23302,"BARU RAHARJA, SUNGKAI UTARA, LAMPUNG UTARA, LAMPUNG",7,110,39,149
https://kawalpemilu.org#23302,"BARU RAHARJA, SUNGKAI UTARA, LAMPUNG UTARA, LAMPUNG",8,109,41,150
https://kawalpemilu.org#23302,"BARU RAHARJA, SUNGKAI UTARA, LAMPUNG UTARA, LAMPUNG",9,63,85,148
https://kawalpemilu.org#23302,"BARU RAHARJA, SUNGKAI UTARA, LAMPUNG UTARA, LAMPUNG",10,104,20,124
https://kawalpemilu.org#23302,"BARU RAHARJA, SUNGKAI UTARA, LAMPUNG UTARA, LAMPUNG",11,11,54,65
https://kawalpemilu.org#23303,"HANAKAU JAYA, SUNGKAI UTARA, LAMPUNG UTARA, LAMPUNG",1,0,0,0
https://kawalpemilu.org#23303,"HANAKAU JAYA, SUNGKAI UTARA, LAMPUNG UTARA, LAMPUNG",2,0,0,0
https://kawalpemilu.org#23303,"HANAKAU JAYA, SUNGKAI UTARA, LAMPUNG UTARA, LAMPUNG",3,0,0,0
https://kawalpemilu.org#23303,"HANAKAU JAYA, SUNGKAI UTARA, LAMPUNG UTARA, LAMPUNG",4,0,0,0
https://kawalpemilu.org#23303,"HANAKAU JAYA, SUNGKAI UTARA, LAMPUNG UTARA, LAMPUNG",5,0,0,0
https://kawalpemilu.org#23303,"HANAKAU JAYA, SUNGKAI UTARA, LAMPUNG UTARA, LAMPUNG",6,0,0,0
https://kawalpemilu.org#23303,"HANAKAU JAYA, SUNGKAI UTARA, LAMPUNG UTARA, LAMPUNG",7,0,0,0
https://kawalpemilu.org#23303,"HANAKAU JAYA, SUNGKAI UTARA, LAMPUNG UTARA, LAMPUNG",8,0,0,0
https://kawalpemilu.org#23303,"HANAKAU JAYA, SUNGKAI UTARA, LAMPUNG UTARA, LAMPUNG",33,68,106,174
https://kawalpemilu.org#23303,"HANAKAU JAYA, SUNGKAI UTARA, LAMPUNG UTARA, LAMPUNG",34,63,110,173
https://kawalpemilu.org#23303,"HANAKAU JAYA, SUNGKAI UTARA, LAMPUNG UTARA, LAMPUNG",35,75,65,140
https://kawalpemilu.org#23303,"HANAKAU JAYA, SUNGKAI UTARA, LAMPUNG UTARA, LAMPUNG",36,65,70,135
https://kawalpemilu.org#23303,"HANAKAU JAYA, SUNGKAI UTARA, LAMPUNG UTARA, LAMPUNG",37,70,81,151
https://kawalpemilu.org#23303,"HANAKAU JAYA, SUNGKAI UTARA, LAMPUNG UTARA, LAMPUNG",38,96,49,145
https://kawalpemilu.org#23303,"HANAKAU JAYA, SUNGKAI UTARA, LAMPUNG UTARA, LAMPUNG",39,94,33,127
https://kawalpemilu.org#23303,"HANAKAU JAYA, SUNGKAI UTARA, LAMPUNG UTARA, LAMPUNG",40,31,93,124
https://kawalpemilu.org#23304,"KOTA NEGARA ILIR, SUNGKAI UTARA, LAMPUNG UTARA, LAMPUNG",2,0,0,0
https://kawalpemilu.org#23304,"KOTA NEGARA ILIR, SUNGKAI UTARA, LAMPUNG UTARA, LAMPUNG",3,0,0,0
https://kawalpemilu.org#23304,"KOTA NEGARA ILIR, SUNGKAI UTARA, LAMPUNG UTARA, LAMPUNG",4,0,0,0
https://kawalpemilu.org#23304,"KOTA NEGARA ILIR, SUNGKAI UTARA, LAMPUNG UTARA, LAMPUNG",50,80,91,171
https://kawalpemilu.org#23304,"KOTA NEGARA ILIR, SUNGKAI UTARA, LAMPUNG UTARA, LAMPUNG",51,85,59,144
https://kawalpemilu.org#23304,"KOTA NEGARA ILIR, SUNGKAI UTARA, LAMPUNG UTARA, LAMPUNG",52,136,54,190
https://kawalpemilu.org#23304,"KOTA NEGARA ILIR, SUNGKAI UTARA, LAMPUNG UTARA, LAMPUNG",53,102,45,147
https://kawalpemilu.org#23305,"NEGARA BATIN II, SUNGKAI UTARA, LAMPUNG UTARA, LAMPUNG",1,119,130,249
https://kawalpemilu.org#23305,"NEGARA BATIN II, SUNGKAI UTARA, LAMPUNG UTARA, LAMPUNG",2,118,146,264
https://kawalpemilu.org#23305,"NEGARA BATIN II, SUNGKAI UTARA, LAMPUNG UTARA, LAMPUNG",58,119,130,249
https://kawalpemilu.org#23305,"NEGARA BATIN II, SUNGKAI UTARA, LAMPUNG UTARA, LAMPUNG",59,118,146,264
https://kawalpemilu.org#23307,"MADUKORO, KOTABUMI UTARA, LAMPUNG UTARA, LAMPUNG",1,79,110,189
https://kawalpemilu.org#23307,"MADUKORO, KOTABUMI UTARA, LAMPUNG UTARA, LAMPUNG",2,114,94,208
https://kawalpemilu.org#23307,"MADUKORO, KOTABUMI UTARA, LAMPUNG UTARA, LAMPUNG",3,84,95,179
https://kawalpemilu.org#23307,"MADUKORO, KOTABUMI UTARA, LAMPUNG UTARA, LAMPUNG",4,107,59,166
https://kawalpemilu.org#23307,"MADUKORO, KOTABUMI UTARA, LAMPUNG UTARA, LAMPUNG",5,70,77,147
https://kawalpemilu.org#23307,"MADUKORO, KOTABUMI UTARA, LAMPUNG UTARA, LAMPUNG",6,112,66,178
https://kawalpemilu.org#23307,"MADUKORO, KOTABUMI UTARA, LAMPUNG UTARA, LAMPUNG",7,133,79,212
https://kawalpemilu.org#23307,"MADUKORO, KOTABUMI UTARA, LAMPUNG UTARA, LAMPUNG",8,114,76,190
https://kawalpemilu.org#23307,"MADUKORO, KOTABUMI UTARA, LAMPUNG UTARA, LAMPUNG",9,127,84,211
https://kawalpemilu.org#23307,"MADUKORO, KOTABUMI UTARA, LAMPUNG UTARA, LAMPUNG",10,122,119,241
https://kawalpemilu.org#23307,"MADUKORO, KOTABUMI UTARA, LAMPUNG UTARA, LAMPUNG",11,91,114,205
https://kawalpemilu.org#23307,"MADUKORO, KOTABUMI UTARA, LAMPUNG UTARA, LAMPUNG",12,128,122,250
https://kawalpemilu.org#23307,"MADUKORO, KOTABUMI UTARA, LAMPUNG UTARA, LAMPUNG",13,138,104,242
https://kawalpemilu.org#23307,"MADUKORO, KOTABUMI UTARA, LAMPUNG UTARA, LAMPUNG",14,108,78,186
https://kawalpemilu.org#23307,"MADUKORO, KOTABUMI UTARA, LAMPUNG UTARA, LAMPUNG",15,136,55,191
https://kawalpemilu.org#23307,"MADUKORO, KOTABUMI UTARA, LAMPUNG UTARA, LAMPUNG",16,118,100,218
https://kawalpemilu.org#23307,"MADUKORO, KOTABUMI UTARA, LAMPUNG UTARA, LAMPUNG",17,116,67,183
https://kawalpemilu.org#23307,"MADUKORO, KOTABUMI UTARA, LAMPUNG UTARA, LAMPUNG",18,34,39,73
https://kawalpemilu.org#23308,"KALI CINTA, KOTABUMI UTARA, LAMPUNG UTARA, LAMPUNG",1,0,0,0
https://kawalpemilu.org#23308,"KALI CINTA, KOTABUMI UTARA, LAMPUNG UTARA, LAMPUNG",2,0,0,0
https://kawalpemilu.org#23308,"KALI CINTA, KOTABUMI UTARA, LAMPUNG UTARA, LAMPUNG",3,112,129,241
https://kawalpemilu.org#23308,"KALI CINTA, KOTABUMI UTARA, LAMPUNG UTARA, LAMPUNG",4,109,111,220
https://kawalpemilu.org#23308,"KALI CINTA, KOTABUMI UTARA, LAMPUNG UTARA, LAMPUNG",8,125,86,211
https://kawalpemilu.org#23308,"KALI CINTA, KOTABUMI UTARA, LAMPUNG UTARA, LAMPUNG",9,54,112,166
https://kawalpemilu.org#23308,"KALI CINTA, KOTABUMI UTARA, LAMPUNG UTARA, LAMPUNG",14,0,0,0
https://kawalpemilu.org#23308,"KALI CINTA, KOTABUMI UTARA, LAMPUNG UTARA, LAMPUNG",20,14,126,140
https://kawalpemilu.org#23308,"KALI CINTA, KOTABUMI UTARA, LAMPUNG UTARA, LAMPUNG",21,141,51,192
https://kawalpemilu.org#23308,"KALI CINTA, KOTABUMI UTARA, LAMPUNG UTARA, LAMPUNG",24,163,42,205
https://kawalpemilu.org#23308,"KALI CINTA, KOTABUMI UTARA, LAMPUNG UTARA, LAMPUNG",25,64,91,155
https://kawalpemilu.org#23308,"KALI CINTA, KOTABUMI UTARA, LAMPUNG UTARA, LAMPUNG",26,59,84,143
https://kawalpemilu.org#23308,"KALI CINTA, KOTABUMI UTARA, LAMPUNG UTARA, LAMPUNG",29,79,79,158
https://kawalpemilu.org#23308,"KALI CINTA, KOTABUMI UTARA, LAMPUNG UTARA, LAMPUNG",30,115,124,239
https://kawalpemilu.org#23308,"KALI CINTA, KOTABUMI UTARA, LAMPUNG UTARA, LAMPUNG",31,97,128,225
https://kawalpemilu.org#23308,"KALI CINTA, KOTABUMI UTARA, LAMPUNG UTARA, LAMPUNG",32,70,82,152
https://kawalpemilu.org#23308,"KALI CINTA, KOTABUMI UTARA, LAMPUNG UTARA, LAMPUNG",33,101,56,157
https://kawalpemilu.org#23308,"KALI CINTA, KOTABUMI UTARA, LAMPUNG UTARA, LAMPUNG",34,101,150,251
https://kawalpemilu.org#23308,"KALI CINTA, KOTABUMI UTARA, LAMPUNG UTARA, LAMPUNG",35,80,105,185
https://kawalpemilu.org#23308,"KALI CINTA, KOTABUMI UTARA, LAMPUNG UTARA, LAMPUNG",37,73,78,151
https://kawalpemilu.org#23308,"KALI CINTA, KOTABUMI UTARA, LAMPUNG UTARA, LAMPUNG",38,24,138,162
https://kawalpemilu.org#23308,"KALI CINTA, KOTABUMI UTARA, LAMPUNG UTARA, LAMPUNG",39,14,126,140
https://kawalpemilu.org#23309,"WONO MARTO, KOTABUMI UTARA, LAMPUNG UTARA, LAMPUNG",2,0,0,0
https://kawalpemilu.org#23309,"WONO MARTO, KOTABUMI UTARA, LAMPUNG UTARA, LAMPUNG",3,0,0,0
https://kawalpemilu.org#23309,"WONO MARTO, KOTABUMI UTARA, LAMPUNG UTARA, LAMPUNG",5,0,0,0
https://kawalpemilu.org#23309,"WONO MARTO, KOTABUMI UTARA, LAMPUNG UTARA, LAMPUNG",6,0,0,0
https://kawalpemilu.org#23309,"WONO MARTO, KOTABUMI UTARA, LAMPUNG UTARA, LAMPUNG",7,0,0,0
https://kawalpemilu.org#23309,"WONO MARTO, KOTABUMI UTARA, LAMPUNG UTARA, LAMPUNG",8,0,0,0
https://kawalpemilu.org#23309,"WONO MARTO, KOTABUMI UTARA, LAMPUNG UTARA, LAMPUNG",9,0,0,0
https://kawalpemilu.org#23309,"WONO MARTO, KOTABUMI UTARA, LAMPUNG UTARA, LAMPUNG",10,0,0,0
https://kawalpemilu.org#23309,"WONO MARTO, KOTABUMI UTARA, LAMPUNG UTARA, LAMPUNG",12,0,0,0
https://kawalpemilu.org#23309,"WONO MARTO, KOTABUMI UTARA, LAMPUNG UTARA, LAMPUNG",50,65,66,131
https://kawalpemilu.org#23309,"WONO MARTO, KOTABUMI UTARA, LAMPUNG UTARA, LAMPUNG",51,92,34,126
https://kawalpemilu.org#23309,"WONO MARTO, KOTABUMI UTARA, LAMPUNG UTARA, LAMPUNG",52,68,94,162
https://kawalpemilu.org#23309,"WONO MARTO, KOTABUMI UTARA, LAMPUNG UTARA, LAMPUNG",53,103,74,177
https://kawalpemilu.org#23309,"WONO MARTO, KOTABUMI UTARA, LAMPUNG UTARA, LAMPUNG",54,77,41,118
https://kawalpemilu.org#23309,"WONO MARTO, KOTABUMI UTARA, LAMPUNG UTARA, LAMPUNG",55,135,39,174
https://kawalpemilu.org#23309,"WONO MARTO, KOTABUMI UTARA, LAMPUNG UTARA, LAMPUNG",56,155,82,237
https://kawalpemilu.org#23309,"WONO MARTO, KOTABUMI UTARA, LAMPUNG UTARA, LAMPUNG",57,169,48,217
https://kawalpemilu.org#23309,"WONO MARTO, KOTABUMI UTARA, LAMPUNG UTARA, LAMPUNG",58,129,50,179
https://kawalpemilu.org#23309,"WONO MARTO, KOTABUMI UTARA, LAMPUNG UTARA, LAMPUNG",59,131,37,168
https://kawalpemilu.org#23309,"WONO MARTO, KOTABUMI UTARA, LAMPUNG UTARA, LAMPUNG",60,145,25,170
https://kawalpemilu.org#23309,"WONO MARTO, KOTABUMI UTARA, LAMPUNG UTARA, LAMPUNG",61,90,28,118
https://kawalpemilu.org#23309,"WONO MARTO, KOTABUMI UTARA, LAMPUNG UTARA, LAMPUNG",62,109,36,145
https://kawalpemilu.org#23310,"TALANG JALI, KOTABUMI UTARA, LAMPUNG UTARA, LAMPUNG",5,0,0,0
https://kawalpemilu.org#23310,"TALANG JALI, KOTABUMI UTARA, LAMPUNG UTARA, LAMPUNG",40,133,113,246
https://kawalpemilu.org#23310,"TALANG JALI, KOTABUMI UTARA, LAMPUNG UTARA, LAMPUNG",41,165,93,258
https://kawalpemilu.org#23310,"TALANG JALI, KOTABUMI UTARA, LAMPUNG UTARA, LAMPUNG",42,144,43,187
https://kawalpemilu.org#23310,"TALANG JALI, KOTABUMI UTARA, LAMPUNG UTARA, LAMPUNG",43,140,85,225
https://kawalpemilu.org#23310,"TALANG JALI, KOTABUMI UTARA, LAMPUNG UTARA, LAMPUNG",44,151,55,206
https://kawalpemilu.org#23310,"TALANG JALI, KOTABUMI UTARA, LAMPUNG UTARA, LAMPUNG",48,128,42,170
https://kawalpemilu.org#23310,"TALANG JALI, KOTABUMI UTARA, LAMPUNG UTARA, LAMPUNG",49,134,25,159
https://kawalpemilu.org#23311,"MARGO REJO, KOTABUMI UTARA, LAMPUNG UTARA, LAMPUNG",8,0,0,0
https://kawalpemilu.org#23311,"MARGO REJO, KOTABUMI UTARA, LAMPUNG UTARA, LAMPUNG",63,71,118,189
https://kawalpemilu.org#23311,"MARGO REJO, KOTABUMI UTARA, LAMPUNG UTARA, LAMPUNG",64,59,122,181
https://kawalpemilu.org#23311,"MARGO REJO, KOTABUMI UTARA, LAMPUNG UTARA, LAMPUNG",65,102,103,205
https://kawalpemilu.org#23311,"MARGO REJO, KOTABUMI UTARA, LAMPUNG UTARA, LAMPUNG",66,70,120,190
https://kawalpemilu.org#23311,"MARGO REJO, KOTABUMI UTARA, LAMPUNG UTARA, LAMPUNG",67,63,108,171
https://kawalpemilu.org#23311,"MARGO REJO, KOTABUMI UTARA, LAMPUNG UTARA, LAMPUNG",68,97,54,151
https://kawalpemilu.org#23311,"MARGO REJO, KOTABUMI UTARA, LAMPUNG UTARA, LAMPUNG",69,62,75,137
https://kawalpemilu.org#23311,"MARGO REJO, KOTABUMI UTARA, LAMPUNG UTARA, LAMPUNG",70,84,85,169
https://kawalpemilu.org#23311,"MARGO REJO, KOTABUMI UTARA, LAMPUNG UTARA, LAMPUNG",71,86,108,194
https://kawalpemilu.org#23311,"MARGO REJO, KOTABUMI UTARA, LAMPUNG UTARA, LAMPUNG",72,72,102,174
https://kawalpemilu.org#23311,"MARGO REJO, KOTABUMI UTARA, LAMPUNG UTARA, LAMPUNG",73,76,110,186
https://kawalpemilu.org#23311,"MARGO REJO, KOTABUMI UTARA, LAMPUNG UTARA, LAMPUNG",74,19,94,113
https://kawalpemilu.org#23312,"BANJAR WANGI, KOTABUMI UTARA, LAMPUNG UTARA, LAMPUNG",1,54,126,180
https://kawalpemilu.org#23312,"BANJAR WANGI, KOTABUMI UTARA, LAMPUNG UTARA, LAMPUNG",2,60,85,145
https://kawalpemilu.org#23312,"BANJAR WANGI, KOTABUMI UTARA, LAMPUNG UTARA, LAMPUNG",78,77,67,144
https://kawalpemilu.org#23312,"BANJAR WANGI, KOTABUMI UTARA, LAMPUNG UTARA, LAMPUNG",79,91,48,139
https://kawalpemilu.org#23314,"SAWO JAJAR, KOTABUMI UTARA, LAMPUNG UTARA, LAMPUNG",90,84,78,162
https://kawalpemilu.org#23314,"SAWO JAJAR, KOTABUMI UTARA, LAMPUNG UTARA, LAMPUNG",91,70,78,148
https://kawalpemilu.org#23314,"SAWO JAJAR, KOTABUMI UTARA, LAMPUNG UTARA, LAMPUNG",92,107,138,245
https://kawalpemilu.org#23314,"SAWO JAJAR, KOTABUMI UTARA, LAMPUNG UTARA, LAMPUNG",93,85,126,211
https://kawalpemilu.org#23314,"SAWO JAJAR, KOTABUMI UTARA, LAMPUNG UTARA, LAMPUNG",94,112,136,248
https://kawalpemilu.org#23314,"SAWO JAJAR, KOTABUMI UTARA, LAMPUNG UTARA, LAMPUNG",95,67,74,141
https://kawalpemilu.org#23314,"SAWO JAJAR, KOTABUMI UTARA, LAMPUNG UTARA, LAMPUNG",96,93,145,238
https://kawalpemilu.org#23314,"SAWO JAJAR, KOTABUMI UTARA, LAMPUNG UTARA, LAMPUNG",97,111,99,210
https://kawalpemilu.org#23314,"SAWO JAJAR, KOTABUMI UTARA, LAMPUNG UTARA, LAMPUNG",98,49,85,134
https://kawalpemilu.org#23314,"SAWO JAJAR, KOTABUMI UTARA, LAMPUNG UTARA, LAMPUNG",99,136,112,248
https://kawalpemilu.org#23314,"SAWO JAJAR, KOTABUMI UTARA, LAMPUNG UTARA, LAMPUNG",100,131,84,215
https://kawalpemilu.org#23314,"SAWO JAJAR, KOTABUMI UTARA, LAMPUNG UTARA, LAMPUNG",101,72,143,215
https://kawalpemilu.org#23314,"SAWO JAJAR, KOTABUMI UTARA, LAMPUNG UTARA, LAMPUNG",102,91,111,202
https://kawalpemilu.org#23314,"SAWO JAJAR, KOTABUMI UTARA, LAMPUNG UTARA, LAMPUNG",103,51,85,136
https://kawalpemilu.org#84803,"MADOKORO BARU, KOTABUMI UTARA, LAMPUNG UTARA, LAMPUNG",80,95,39,134
https://kawalpemilu.org#84803,"MADOKORO BARU, KOTABUMI UTARA, LAMPUNG UTARA, LAMPUNG",81,102,39,141
https://kawalpemilu.org#84803,"MADOKORO BARU, KOTABUMI UTARA, LAMPUNG UTARA, LAMPUNG",82,104,69,173
https://kawalpemilu.org#84803,"MADOKORO BARU, KOTABUMI UTARA, LAMPUNG UTARA, LAMPUNG",84,85,75,160
https://kawalpemilu.org#84803,"MADOKORO BARU, KOTABUMI UTARA, LAMPUNG UTARA, LAMPUNG",85,101,70,171
https://kawalpemilu.org#84803,"MADOKORO BARU, KOTABUMI UTARA, LAMPUNG UTARA, LAMPUNG",86,68,39,107
https://kawalpemilu.org#84803,"MADOKORO BARU, KOTABUMI UTARA, LAMPUNG UTARA, LAMPUNG",87,120,70,190
https://kawalpemilu.org#84803,"MADOKORO BARU, KOTABUMI UTARA, LAMPUNG UTARA, LAMPUNG",88,110,27,137
https://kawalpemilu.org#84803,"MADOKORO BARU, KOTABUMI UTARA, LAMPUNG UTARA, LAMPUNG",89,140,44,184
https://kawalpemilu.org#23316,"KELAPA TUJUH, KOTABUMI SELATAN, LAMPUNG UTARA, LAMPUNG",1,0,0,0
https://kawalpemilu.org#23316,"KELAPA TUJUH, KOTABUMI SELATAN, LAMPUNG UTARA, LAMPUNG",2,0,0,0
https://kawalpemilu.org#23316,"KELAPA TUJUH, KOTABUMI SELATAN, LAMPUNG UTARA, LAMPUNG",3,0,0,0
https://kawalpemilu.org#23316,"KELAPA TUJUH, KOTABUMI SELATAN, LAMPUNG UTARA, LAMPUNG",5,0,0,0
https://kawalpemilu.org#23316,"KELAPA TUJUH, KOTABUMI SELATAN, LAMPUNG UTARA, LAMPUNG",7,0,0,0
https://kawalpemilu.org#23316,"KELAPA TUJUH, KOTABUMI SELATAN, LAMPUNG UTARA, LAMPUNG",8,0,0,0
https://kawalpemilu.org#23316,"KELAPA TUJUH, KOTABUMI SELATAN, LAMPUNG UTARA, LAMPUNG",11,0,0,0
https://kawalpemilu.org#23316,"KELAPA TUJUH, KOTABUMI SELATAN, LAMPUNG UTARA, LAMPUNG",14,0,0,0
https://kawalpemilu.org#23316,"KELAPA TUJUH, KOTABUMI SELATAN, LAMPUNG UTARA, LAMPUNG",15,0,0,0
https://kawalpemilu.org#23316,"KELAPA TUJUH, KOTABUMI SELATAN, LAMPUNG UTARA, LAMPUNG",19,0,0,0
https://kawalpemilu.org#23316,"KELAPA TUJUH, KOTABUMI SELATAN, LAMPUNG UTARA, LAMPUNG",27,0,0,0
https://kawalpemilu.org#23316,"KELAPA TUJUH, KOTABUMI SELATAN, LAMPUNG UTARA, LAMPUNG",31,0,0,0
https://kawalpemilu.org#23316,"KELAPA TUJUH, KOTABUMI SELATAN, LAMPUNG UTARA, LAMPUNG",38,0,0,0
https://kawalpemilu.org#23316,"KELAPA TUJUH, KOTABUMI SELATAN, LAMPUNG UTARA, LAMPUNG",46,0,0,0
https://kawalpemilu.org#23316,"KELAPA TUJUH, KOTABUMI SELATAN, LAMPUNG UTARA, LAMPUNG",101,92,169,261
https://kawalpemilu.org#23316,"KELAPA TUJUH, KOTABUMI SELATAN, LAMPUNG UTARA, LAMPUNG",102,57,167,224
https://kawalpemilu.org#23316,"KELAPA TUJUH, KOTABUMI SELATAN, LAMPUNG UTARA, LAMPUNG",103,48,95,143
https://kawalpemilu.org#23316,"KELAPA TUJUH, KOTABUMI SELATAN, LAMPUNG UTARA, LAMPUNG",104,39,151,190
https://kawalpemilu.org#23316,"KELAPA TUJUH, KOTABUMI SELATAN, LAMPUNG UTARA, LAMPUNG",105,62,157,219
https://kawalpemilu.org#23316,"KELAPA TUJUH, KOTABUMI SELATAN, LAMPUNG UTARA, LAMPUNG",106,38,103,141
https://kawalpemilu.org#23316,"KELAPA TUJUH, KOTABUMI SELATAN, LAMPUNG UTARA, LAMPUNG",107,43,98,141
https://kawalpemilu.org#23316,"KELAPA TUJUH, KOTABUMI SELATAN, LAMPUNG UTARA, LAMPUNG",108,54,151,205
https://kawalpemilu.org#23316,"KELAPA TUJUH, KOTABUMI SELATAN, LAMPUNG UTARA, LAMPUNG",109,28,128,156
https://kawalpemilu.org#23316,"KELAPA TUJUH, KOTABUMI SELATAN, LAMPUNG UTARA, LAMPUNG",110,24,81,105
https://kawalpemilu.org#23316,"KELAPA TUJUH, KOTABUMI SELATAN, LAMPUNG UTARA, LAMPUNG",111,15,60,75
https://kawalpemilu.org#23316,"KELAPA TUJUH, KOTABUMI SELATAN, LAMPUNG UTARA, LAMPUNG",112,28,117,28
https://kawalpemilu.org#23316,"KELAPA TUJUH, KOTABUMI SELATAN, LAMPUNG UTARA, LAMPUNG",113,12,97,109
https://kawalpemilu.org#23316,"KELAPA TUJUH, KOTABUMI SELATAN, LAMPUNG UTARA, LAMPUNG",114,21,89,110
https://kawalpemilu.org#23316,"KELAPA TUJUH, KOTABUMI SELATAN, LAMPUNG UTARA, LAMPUNG",115,27,135,162
https://kawalpemilu.org#23316,"KELAPA TUJUH, KOTABUMI SELATAN, LAMPUNG UTARA, LAMPUNG",116,24,101,125
https://kawalpemilu.org#23316,"KELAPA TUJUH, KOTABUMI SELATAN, LAMPUNG UTARA, LAMPUNG",117,29,132,161
https://kawalpemilu.org#23316,"KELAPA TUJUH, KOTABUMI SELATAN, LAMPUNG UTARA, LAMPUNG",118,14,116,130
https://kawalpemilu.org#23316,"KELAPA TUJUH, KOTABUMI SELATAN, LAMPUNG UTARA, LAMPUNG",119,32,103,135
https://kawalpemilu.org#23316,"KELAPA TUJUH, KOTABUMI SELATAN, LAMPUNG UTARA, LAMPUNG",120,48,73,121
https://kawalpemilu.org#23316,"KELAPA TUJUH, KOTABUMI SELATAN, LAMPUNG UTARA, LAMPUNG",121,28,162,190
https://kawalpemilu.org#23316,"KELAPA TUJUH, KOTABUMI SELATAN, LAMPUNG UTARA, LAMPUNG",122,31,139,170
https://kawalpemilu.org#23316,"KELAPA TUJUH, KOTABUMI SELATAN, LAMPUNG UTARA, LAMPUNG",123,34,221,255
https://kawalpemilu.org#23316,"KELAPA TUJUH, KOTABUMI SELATAN, LAMPUNG UTARA, LAMPUNG",124,57,121,178
https://kawalpemilu.org#23316,"KELAPA TUJUH, KOTABUMI SELATAN, LAMPUNG UTARA, LAMPUNG",125,77,115,192
https://kawalpemilu.org#23316,"KELAPA TUJUH, KOTABUMI SELATAN, LAMPUNG UTARA, LAMPUNG",126,45,108,153
https://kawalpemilu.org#23316,"KELAPA TUJUH, KOTABUMI SELATAN, LAMPUNG UTARA, LAMPUNG",127,37,119,156
https://kawalpemilu.org#23316,"KELAPA TUJUH, KOTABUMI SELATAN, LAMPUNG UTARA, LAMPUNG",128,0,0,0
https://kawalpemilu.org#23316,"KELAPA TUJUH, KOTABUMI SELATAN, LAMPUNG UTARA, LAMPUNG",129,56,122,178
https://kawalpemilu.org#23316,"KELAPA TUJUH, KOTABUMI SELATAN, LAMPUNG UTARA, LAMPUNG",130,67,96,163
https://kawalpemilu.org#23316,"KELAPA TUJUH, KOTABUMI SELATAN, LAMPUNG UTARA, LAMPUNG",131,38,123,161
https://kawalpemilu.org#23316,"KELAPA TUJUH, KOTABUMI SELATAN, LAMPUNG UTARA, LAMPUNG",132,51,166,217
https://kawalpemilu.org#23316,"KELAPA TUJUH, KOTABUMI SELATAN, LAMPUNG UTARA, LAMPUNG",133,71,150,221
https://kawalpemilu.org#23316,"KELAPA TUJUH, KOTABUMI SELATAN, LAMPUNG UTARA, LAMPUNG",134,49,142,191
https://kawalpemilu.org#23316,"KELAPA TUJUH, KOTABUMI SELATAN, LAMPUNG UTARA, LAMPUNG",135,60,163,223
https://kawalpemilu.org#23316,"KELAPA TUJUH, KOTABUMI SELATAN, LAMPUNG UTARA, LAMPUNG",136,37,101,138
https://kawalpemilu.org#23316,"KELAPA TUJUH, KOTABUMI SELATAN, LAMPUNG UTARA, LAMPUNG",137,95,137,232
https://kawalpemilu.org#23316,"KELAPA TUJUH, KOTABUMI SELATAN, LAMPUNG UTARA, LAMPUNG",138,106,162,268
https://kawalpemilu.org#23316,"KELAPA TUJUH, KOTABUMI SELATAN, LAMPUNG UTARA, LAMPUNG",139,41,133,174
https://kawalpemilu.org#23316,"KELAPA TUJUH, KOTABUMI SELATAN, LAMPUNG UTARA, LAMPUNG",140,43,157,200
https://kawalpemilu.org#23316,"KELAPA TUJUH, KOTABUMI SELATAN, LAMPUNG UTARA, LAMPUNG",141,39,144,183
https://kawalpemilu.org#23316,"KELAPA TUJUH, KOTABUMI SELATAN, LAMPUNG UTARA, LAMPUNG",142,41,118,159
https://kawalpemilu.org#23316,"KELAPA TUJUH, KOTABUMI SELATAN, LAMPUNG UTARA, LAMPUNG",143,35,162,197
https://kawalpemilu.org#23316,"KELAPA TUJUH, KOTABUMI SELATAN, LAMPUNG UTARA, LAMPUNG",144,41,242,283
https://kawalpemilu.org#23316,"KELAPA TUJUH, KOTABUMI SELATAN, LAMPUNG UTARA, LAMPUNG",145,14,58,72
https://kawalpemilu.org#23316,"KELAPA TUJUH, KOTABUMI SELATAN, LAMPUNG UTARA, LAMPUNG",224,7,42,49
https://kawalpemilu.org#23317,"TANJUNG AMAN, KOTABUMI SELATAN, LAMPUNG UTARA, LAMPUNG",16,0,0,0
https://kawalpemilu.org#23317,"TANJUNG AMAN, KOTABUMI SELATAN, LAMPUNG UTARA, LAMPUNG",17,0,0,0
https://kawalpemilu.org#23317,"TANJUNG AMAN, KOTABUMI SELATAN, LAMPUNG UTARA, LAMPUNG",18,0,0,0
https://kawalpemilu.org#23317,"TANJUNG AMAN, KOTABUMI SELATAN, LAMPUNG UTARA, LAMPUNG",19,0,0,0
https://kawalpemilu.org#23317,"TANJUNG AMAN, KOTABUMI SELATAN, LAMPUNG UTARA, LAMPUNG",20,0,0,0
https://kawalpemilu.org#23317,"TANJUNG AMAN, KOTABUMI SELATAN, LAMPUNG UTARA, LAMPUNG",22,0,0,0
https://kawalpemilu.org#23317,"TANJUNG AMAN, KOTABUMI SELATAN, LAMPUNG UTARA, LAMPUNG",25,0,0,0
https://kawalpemilu.org#23317,"TANJUNG AMAN, KOTABUMI SELATAN, LAMPUNG UTARA, LAMPUNG",26,0,0,0
https://kawalpemilu.org#23317,"TANJUNG AMAN, KOTABUMI SELATAN, LAMPUNG UTARA, LAMPUNG",27,0,0,0
https://kawalpemilu.org#23317,"TANJUNG AMAN, KOTABUMI SELATAN, LAMPUNG UTARA, LAMPUNG",28,0,0,0
https://kawalpemilu.org#23317,"TANJUNG AMAN, KOTABUMI SELATAN, LAMPUNG UTARA, LAMPUNG",30,0,0,0
https://kawalpemilu.org#23317,"TANJUNG AMAN, KOTABUMI SELATAN, LAMPUNG UTARA, LAMPUNG",31,0,0,0
https://kawalpemilu.org#23317,"TANJUNG AMAN, KOTABUMI SELATAN, LAMPUNG UTARA, LAMPUNG",33,0,0,0
https://kawalpemilu.org#23317,"TANJUNG AMAN, KOTABUMI SELATAN, LAMPUNG UTARA, LAMPUNG",188,48,202,250
https://kawalpemilu.org#23317,"TANJUNG AMAN, KOTABUMI SELATAN, LAMPUNG UTARA, LAMPUNG",189,38,160,198
https://kawalpemilu.org#23317,"TANJUNG AMAN, KOTABUMI SELATAN, LAMPUNG UTARA, LAMPUNG",190,65,170,235
https://kawalpemilu.org#23317,"TANJUNG AMAN, KOTABUMI SELATAN, LAMPUNG UTARA, LAMPUNG",191,82,194,276
https://kawalpemilu.org#23317,"TANJUNG AMAN, KOTABUMI SELATAN, LAMPUNG UTARA, LAMPUNG",192,57,187,244
https://kawalpemilu.org#23317,"TANJUNG AMAN, KOTABUMI SELATAN, LAMPUNG UTARA, LAMPUNG",193,56,162,218
https://kawalpemilu.org#23317,"TANJUNG AMAN, KOTABUMI SELATAN, LAMPUNG UTARA, LAMPUNG",194,55,152,207
https://kawalpemilu.org#23317,"TANJUNG AMAN, KOTABUMI SELATAN, LAMPUNG UTARA, LAMPUNG",195,45,144,189
https://kawalpemilu.org#23317,"TANJUNG AMAN, KOTABUMI SELATAN, LAMPUNG UTARA, LAMPUNG",196,43,135,178
https://kawalpemilu.org#23317,"TANJUNG AMAN, KOTABUMI SELATAN, LAMPUNG UTARA, LAMPUNG",197,60,162,222
https://kawalpemilu.org#23317,"TANJUNG AMAN, KOTABUMI SELATAN, LAMPUNG UTARA, LAMPUNG",198,77,117,194
https://kawalpemilu.org#23317,"TANJUNG AMAN, KOTABUMI SELATAN, LAMPUNG UTARA, LAMPUNG",199,37,164,201
https://kawalpemilu.org#23317,"TANJUNG AMAN, KOTABUMI SELATAN, LAMPUNG UTARA, LAMPUNG",200,52,142,194
https://kawalpemilu.org#23317,"TANJUNG AMAN, KOTABUMI SELATAN, LAMPUNG UTARA, LAMPUNG",201,40,117,157
https://kawalpemilu.org#23317,"TANJUNG AMAN, KOTABUMI SELATAN, LAMPUNG UTARA, LAMPUNG",202,57,112,169
https://kawalpemilu.org#23317,"TANJUNG AMAN, KOTABUMI SELATAN, LAMPUNG UTARA, LAMPUNG",203,72,176,248
https://kawalpemilu.org#23317,"TANJUNG AMAN, KOTABUMI SELATAN, LAMPUNG UTARA, LAMPUNG",204,48,189,237
https://kawalpemilu.org#23317,"TANJUNG AMAN, KOTABUMI SELATAN, LAMPUNG UTARA, LAMPUNG",205,50,168,218
https://kawalpemilu.org#23317,"TANJUNG AMAN, KOTABUMI SELATAN, LAMPUNG UTARA, LAMPUNG",206,48,196,244
https://kawalpemilu.org#23317,"TANJUNG AMAN, KOTABUMI SELATAN, LAMPUNG UTARA, LAMPUNG",207,31,137,168
https://kawalpemilu.org#23317,"TANJUNG AMAN, KOTABUMI SELATAN, LAMPUNG UTARA, LAMPUNG",208,20,166,186
https://kawalpemilu.org#23317,"TANJUNG AMAN, KOTABUMI SELATAN, LAMPUNG UTARA, LAMPUNG",209,54,184,238
https://kawalpemilu.org#23317,"TANJUNG AMAN, KOTABUMI SELATAN, LAMPUNG UTARA, LAMPUNG",210,35,172,207
https://kawalpemilu.org#23317,"TANJUNG AMAN, KOTABUMI SELATAN, LAMPUNG UTARA, LAMPUNG",211,52,133,185
https://kawalpemilu.org#23317,"TANJUNG AMAN, KOTABUMI SELATAN, LAMPUNG UTARA, LAMPUNG",212,54,136,190
https://kawalpemilu.org#23317,"TANJUNG AMAN, KOTABUMI SELATAN, LAMPUNG UTARA, LAMPUNG",213,33,132,165
https://kawalpemilu.org#23317,"TANJUNG AMAN, KOTABUMI SELATAN, LAMPUNG UTARA, LAMPUNG",214,37,134,171
https://kawalpemilu.org#23317,"TANJUNG AMAN, KOTABUMI SELATAN, LAMPUNG UTARA, LAMPUNG",215,58,164,222
https://kawalpemilu.org#23317,"TANJUNG AMAN, KOTABUMI SELATAN, LAMPUNG UTARA, LAMPUNG",216,57,147,204
https://kawalpemilu.org#23317,"TANJUNG AMAN, KOTABUMI SELATAN, LAMPUNG UTARA, LAMPUNG",217,48,103,151
https://kawalpemilu.org#23317,"TANJUNG AMAN, KOTABUMI SELATAN, LAMPUNG UTARA, LAMPUNG",218,73,249,322
https://kawalpemilu.org#23317,"TANJUNG AMAN, KOTABUMI SELATAN, LAMPUNG UTARA, LAMPUNG",219,33,187,220
https://kawalpemilu.org#23317,"TANJUNG AMAN, KOTABUMI SELATAN, LAMPUNG UTARA, LAMPUNG",220,64,167,231
https://kawalpemilu.org#23317,"TANJUNG AMAN, KOTABUMI SELATAN, LAMPUNG UTARA, LAMPUNG",221,20,33,53
https://kawalpemilu.org#23318,"KOTA ALAM, KOTABUMI SELATAN, LAMPUNG UTARA, LAMPUNG",6,0,0,0
https://kawalpemilu.org#23318,"KOTA ALAM, KOTABUMI SELATAN, LAMPUNG UTARA, LAMPUNG",13,0,0,0
https://kawalpemilu.org#23318,"KOTA ALAM, KOTABUMI SELATAN, LAMPUNG UTARA, LAMPUNG",35,0,0,0
https://kawalpemilu.org#23318,"KOTA ALAM, KOTABUMI SELATAN, LAMPUNG UTARA, LAMPUNG",39,0,0,0
https://kawalpemilu.org#23318,"KOTA ALAM, KOTABUMI SELATAN, LAMPUNG UTARA, LAMPUNG",146,76,172,248
https://kawalpemilu.org#23318,"KOTA ALAM, KOTABUMI SELATAN, LAMPUNG UTARA, LAMPUNG",147,30,135,165
https://kawalpemilu.org#23318,"KOTA ALAM, KOTABUMI SELATAN, LAMPUNG UTARA, LAMPUNG",148,22,89,111
https://kawalpemilu.org#23318,"KOTA ALAM, KOTABUMI SELATAN, LAMPUNG UTARA, LAMPUNG",149,40,135,175
https://kawalpemilu.org#23318,"KOTA ALAM, KOTABUMI SELATAN, LAMPUNG UTARA, LAMPUNG",150,21,111,132
https://kawalpemilu.org#23318,"KOTA ALAM, KOTABUMI SELATAN, LAMPUNG UTARA, LAMPUNG",151,15,136,151
https://kawalpemilu.org#23318,"KOTA ALAM, KOTABUMI SELATAN, LAMPUNG UTARA, LAMPUNG",152,21,94,115
https://kawalpemilu.org#23318,"KOTA ALAM, KOTABUMI SELATAN, LAMPUNG UTARA, LAMPUNG",153,38,202,240
https://kawalpemilu.org#23318,"KOTA ALAM, KOTABUMI SELATAN, LAMPUNG UTARA, LAMPUNG",154,24,197,221
https://kawalpemilu.org#23318,"KOTA ALAM, KOTABUMI SELATAN, LAMPUNG UTARA, LAMPUNG",155,27,164,191
https://kawalpemilu.org#23318,"KOTA ALAM, KOTABUMI SELATAN, LAMPUNG UTARA, LAMPUNG",156,53,141,194
https://kawalpemilu.org#23318,"KOTA ALAM, KOTABUMI SELATAN, LAMPUNG UTARA, LAMPUNG",157,23,143,166
https://kawalpemilu.org#23318,"KOTA ALAM, KOTABUMI SELATAN, LAMPUNG UTARA, LAMPUNG",158,39,146,185
https://kawalpemilu.org#23318,"KOTA ALAM, KOTABUMI SELATAN, LAMPUNG UTARA, LAMPUNG",159,18,103,121
https://kawalpemilu.org#23318,"KOTA ALAM, KOTABUMI SELATAN, LAMPUNG UTARA, LAMPUNG",160,47,154,201
https://kawalpemilu.org#23318,"KOTA ALAM, KOTABUMI SELATAN, LAMPUNG UTARA, LAMPUNG",161,28,131,159
https://kawalpemilu.org#23318,"KOTA ALAM, KOTABUMI SELATAN, LAMPUNG UTARA, LAMPUNG",162,36,141,177
https://kawalpemilu.org#23318,"KOTA ALAM, KOTABUMI SELATAN, LAMPUNG UTARA, LAMPUNG",163,33,124,157
https://kawalpemilu.org#23318,"KOTA ALAM, KOTABUMI SELATAN, LAMPUNG UTARA, LAMPUNG",164,21,133,154
https://kawalpemilu.org#23318,"KOTA ALAM, KOTABUMI SELATAN, LAMPUNG UTARA, LAMPUNG",165,45,158,203
https://kawalpemilu.org#23318,"KOTA ALAM, KOTABUMI SELATAN, LAMPUNG UTARA, LAMPUNG",166,44,166,210
https://kawalpemilu.org#23318,"KOTA ALAM, KOTABUMI SELATAN, LAMPUNG UTARA, LAMPUNG",167,50,168,218
https://kawalpemilu.org#23318,"KOTA ALAM, KOTABUMI SELATAN, LAMPUNG UTARA, LAMPUNG",168,40,105,145
https://kawalpemilu.org#23318,"KOTA ALAM, KOTABUMI SELATAN, LAMPUNG UTARA, LAMPUNG",169,30,103,133
https://kawalpemilu.org#23318,"KOTA ALAM, KOTABUMI SELATAN, LAMPUNG UTARA, LAMPUNG",170,26,130,156
https://kawalpemilu.org#23318,"KOTA ALAM, KOTABUMI SELATAN, LAMPUNG UTARA, LAMPUNG",171,33,96,129
https://kawalpemilu.org#23318,"KOTA ALAM, KOTABUMI SELATAN, LAMPUNG UTARA, LAMPUNG",172,38,134,172
https://kawalpemilu.org#23318,"KOTA ALAM, KOTABUMI SELATAN, LAMPUNG UTARA, LAMPUNG",173,31,132,163
https://kawalpemilu.org#23318,"KOTA ALAM, KOTABUMI SELATAN, LAMPUNG UTARA, LAMPUNG",174,39,112,151
https://kawalpemilu.org#23318,"KOTA ALAM, KOTABUMI SELATAN, LAMPUNG UTARA, LAMPUNG",175,46,160,206
https://kawalpemilu.org#23318,"KOTA ALAM, KOTABUMI SELATAN, LAMPUNG UTARA, LAMPUNG",176,42,123,165
https://kawalpemilu.org#23318,"KOTA ALAM, KOTABUMI SELATAN, LAMPUNG UTARA, LAMPUNG",177,33,163,196
https://kawalpemilu.org#23318,"KOTA ALAM, KOTABUMI SELATAN, LAMPUNG UTARA, LAMPUNG",178,38,143,181
https://kawalpemilu.org#23318,"KOTA ALAM, KOTABUMI SELATAN, LAMPUNG UTARA, LAMPUNG",179,36,111,147
https://kawalpemilu.org#23318,"KOTA ALAM, KOTABUMI SELATAN, LAMPUNG UTARA, LAMPUNG",180,8,75,83
https://kawalpemilu.org#23318,"KOTA ALAM, KOTABUMI SELATAN, LAMPUNG UTARA, LAMPUNG",181,18,127,145
https://kawalpemilu.org#23318,"KOTA ALAM, KOTABUMI SELATAN, LAMPUNG UTARA, LAMPUNG",182,65,179,244
https://kawalpemilu.org#23318,"KOTA ALAM, KOTABUMI SELATAN, LAMPUNG UTARA, LAMPUNG",183,33,101,134
https://kawalpemilu.org#23318,"KOTA ALAM, KOTABUMI SELATAN, LAMPUNG UTARA, LAMPUNG",184,34,88,122
https://kawalpemilu.org#23318,"KOTA ALAM, KOTABUMI SELATAN, LAMPUNG UTARA, LAMPUNG",185,2,99,101
https://kawalpemilu.org#23318,"KOTA ALAM, KOTABUMI SELATAN, LAMPUNG UTARA, LAMPUNG",186,32,233,265
https://kawalpemilu.org#23318,"KOTA ALAM, KOTABUMI SELATAN, LAMPUNG UTARA, LAMPUNG",187,25,111,136
https://kawalpemilu.org#23319,"MULANG MAYA, KOTABUMI SELATAN, LAMPUNG UTARA, LAMPUNG",1,0,0,0
https://kawalpemilu.org#23319,"MULANG MAYA, KOTABUMI SELATAN, LAMPUNG UTARA, LAMPUNG",2,0,0,0
https://kawalpemilu.org#23319,"MULANG MAYA, KOTABUMI SELATAN, LAMPUNG UTARA, LAMPUNG",3,0,0,0
https://kawalpemilu.org#23319,"MULANG MAYA, KOTABUMI SELATAN, LAMPUNG UTARA, LAMPUNG",4,0,0,0
https://kawalpemilu.org#23319,"MULANG MAYA, KOTABUMI SELATAN, LAMPUNG UTARA, LAMPUNG",5,0,0,0
https://kawalpemilu.org#23319,"MULANG MAYA, KOTABUMI SELATAN, LAMPUNG UTARA, LAMPUNG",6,0,0,0
https://kawalpemilu.org#23319,"MULANG MAYA, KOTABUMI SELATAN, LAMPUNG UTARA, LAMPUNG",7,0,0,0
https://kawalpemilu.org#23319,"MULANG MAYA, KOTABUMI SELATAN, LAMPUNG UTARA, LAMPUNG",8,0,0,0
https://kawalpemilu.org#23319,"MULANG MAYA, KOTABUMI SELATAN, LAMPUNG UTARA, LAMPUNG",9,0,0,0
https://kawalpemilu.org#23319,"MULANG MAYA, KOTABUMI SELATAN, LAMPUNG UTARA, LAMPUNG",10,0,0,0
https://kawalpemilu.org#23319,"MULANG MAYA, KOTABUMI SELATAN, LAMPUNG UTARA, LAMPUNG",11,0,0,0
https://kawalpemilu.org#23319,"MULANG MAYA, KOTABUMI SELATAN, LAMPUNG UTARA, LAMPUNG",12,0,0,0
https://kawalpemilu.org#23319,"MULANG MAYA, KOTABUMI SELATAN, LAMPUNG UTARA, LAMPUNG",13,0,0,0
https://kawalpemilu.org#23319,"MULANG MAYA, KOTABUMI SELATAN, LAMPUNG UTARA, LAMPUNG",14,0,0,0
https://kawalpemilu.org#23319,"MULANG MAYA, KOTABUMI SELATAN, LAMPUNG UTARA, LAMPUNG",15,0,0,0
https://kawalpemilu.org#23319,"MULANG MAYA, KOTABUMI SELATAN, LAMPUNG UTARA, LAMPUNG",16,0,0,0
https://kawalpemilu.org#23319,"MULANG MAYA, KOTABUMI SELATAN, LAMPUNG UTARA, LAMPUNG",17,0,0,0
https://kawalpemilu.org#23319,"MULANG MAYA, KOTABUMI SELATAN, LAMPUNG UTARA, LAMPUNG",18,0,0,0
https://kawalpemilu.org#23319,"MULANG MAYA, KOTABUMI SELATAN, LAMPUNG UTARA, LAMPUNG",19,0,0,0
https://kawalpemilu.org#23319,"MULANG MAYA, KOTABUMI SELATAN, LAMPUNG UTARA, LAMPUNG",20,0,0,0
https://kawalpemilu.org#23319,"MULANG MAYA, KOTABUMI SELATAN, LAMPUNG UTARA, LAMPUNG",21,0,0,0
https://kawalpemilu.org#23319,"MULANG MAYA, KOTABUMI SELATAN, LAMPUNG UTARA, LAMPUNG",22,0,0,0
https://kawalpemilu.org#23319,"MULANG MAYA, KOTABUMI SELATAN, LAMPUNG UTARA, LAMPUNG",47,28,118,146
https://kawalpemilu.org#23319,"MULANG MAYA, KOTABUMI SELATAN, LAMPUNG UTARA, LAMPUNG",48,51,145,196
https://kawalpemilu.org#23319,"MULANG MAYA, KOTABUMI SELATAN, LAMPUNG UTARA, LAMPUNG",49,40,149,189
https://kawalpemilu.org#23319,"MULANG MAYA, KOTABUMI SELATAN, LAMPUNG UTARA, LAMPUNG",50,58,174,232
https://kawalpemilu.org#23319,"MULANG MAYA, KOTABUMI SELATAN, LAMPUNG UTARA, LAMPUNG",51,113,87,200
https://kawalpemilu.org#23319,"MULANG MAYA, KOTABUMI SELATAN, LAMPUNG UTARA, LAMPUNG",52,40,101,141
https://kawalpemilu.org#23319,"MULANG MAYA, KOTABUMI SELATAN, LAMPUNG UTARA, LAMPUNG",53,130,67,197
https://kawalpemilu.org#23319,"MULANG MAYA, KOTABUMI SELATAN, LAMPUNG UTARA, LAMPUNG",54,65,138,203
https://kawalpemilu.org#23319,"MULANG MAYA, KOTABUMI SELATAN, LAMPUNG UTARA, LAMPUNG",55,53,126,179
https://kawalpemilu.org#23319,"MULANG MAYA, KOTABUMI SELATAN, LAMPUNG UTARA, LAMPUNG",56,59,155,214
https://kawalpemilu.org#23319,"MULANG MAYA, KOTABUMI SELATAN, LAMPUNG UTARA, LAMPUNG",57,47,139,186
https://kawalpemilu.org#23319,"MULANG MAYA, KOTABUMI SELATAN, LAMPUNG UTARA, LAMPUNG",58,49,76,125
https://kawalpemilu.org#23319,"MULANG MAYA, KOTABUMI SELATAN, LAMPUNG UTARA, LAMPUNG",59,46,116,162
https://kawalpemilu.org#23319,"MULANG MAYA, KOTABUMI SELATAN, LAMPUNG UTARA, LAMPUNG",60,95,102,197
https://kawalpemilu.org#23319,"MULANG MAYA, KOTABUMI SELATAN, LAMPUNG UTARA, LAMPUNG",61,82,116,198
https://kawalpemilu.org#23319,"MULANG MAYA, KOTABUMI SELATAN, LAMPUNG UTARA, LAMPUNG",62,39,144,183
https://kawalpemilu.org#23319,"MULANG MAYA, KOTABUMI SELATAN, LAMPUNG UTARA, LAMPUNG",63,4,109,113
https://kawalpemilu.org#23319,"MULANG MAYA, KOTABUMI SELATAN, LAMPUNG UTARA, LAMPUNG",64,11,100,111
https://kawalpemilu.org#23319,"MULANG MAYA, KOTABUMI SELATAN, LAMPUNG UTARA, LAMPUNG",65,48,70,118
https://kawalpemilu.org#23319,"MULANG MAYA, KOTABUMI SELATAN, LAMPUNG UTARA, LAMPUNG",66,61,73,134
https://kawalpemilu.org#23319,"MULANG MAYA, KOTABUMI SELATAN, LAMPUNG UTARA, LAMPUNG",67,43,69,112
https://kawalpemilu.org#23319,"MULANG MAYA, KOTABUMI SELATAN, LAMPUNG UTARA, LAMPUNG",68,67,137,204
https://kawalpemilu.org#23320,"BANDAR PUTIH, KOTABUMI SELATAN, LAMPUNG UTARA, LAMPUNG",1,40,128,168
https://kawalpemilu.org#23320,"BANDAR PUTIH, KOTABUMI SELATAN, LAMPUNG UTARA, LAMPUNG",2,79,71,150
https://kawalpemilu.org#23320,"BANDAR PUTIH, KOTABUMI SELATAN, LAMPUNG UTARA, LAMPUNG",3,88,82,170
https://kawalpemilu.org#23320,"BANDAR PUTIH, KOTABUMI SELATAN, LAMPUNG UTARA, LAMPUNG",4,0,0,0
https://kawalpemilu.org#23320,"BANDAR PUTIH, KOTABUMI SELATAN, LAMPUNG UTARA, LAMPUNG",5,0,0,0
https://kawalpemilu.org#23320,"BANDAR PUTIH, KOTABUMI SELATAN, LAMPUNG UTARA, LAMPUNG",20,57,33,90
https://kawalpemilu.org#23320,"BANDAR PUTIH, KOTABUMI SELATAN, LAMPUNG UTARA, LAMPUNG",21,23,77,100
https://kawalpemilu.org#23320,"BANDAR PUTIH, KOTABUMI SELATAN, LAMPUNG UTARA, LAMPUNG",22,25,110,135
https://kawalpemilu.org#23320,"BANDAR PUTIH, KOTABUMI SELATAN, LAMPUNG UTARA, LAMPUNG",24,70,29,99
https://kawalpemilu.org#23321,"KARANG AGUNG, KOTABUMI SELATAN, LAMPUNG UTARA, LAMPUNG",1,0,0,0
https://kawalpemilu.org#23321,"KARANG AGUNG, KOTABUMI SELATAN, LAMPUNG UTARA, LAMPUNG",2,0,0,0
https://kawalpemilu.org#23321,"KARANG AGUNG, KOTABUMI SELATAN, LAMPUNG UTARA, LAMPUNG",3,0,0,0
https://kawalpemilu.org#23321,"KARANG AGUNG, KOTABUMI SELATAN, LAMPUNG UTARA, LAMPUNG",7,28,110,138
https://kawalpemilu.org#23321,"KARANG AGUNG, KOTABUMI SELATAN, LAMPUNG UTARA, LAMPUNG",8,20,125,145
https://kawalpemilu.org#23321,"KARANG AGUNG, KOTABUMI SELATAN, LAMPUNG UTARA, LAMPUNG",9,26,106,132
https://kawalpemilu.org#23322,"CURUP GURUH KAGUNGAN, KOTABUMI SELATAN, LAMPUNG UTARA, LAMPUNG",1,0,0,0
https://kawalpemilu.org#23322,"CURUP GURUH KAGUNGAN, KOTABUMI SELATAN, LAMPUNG UTARA, LAMPUNG",2,0,0,0
https://kawalpemilu.org#23322,"CURUP GURUH KAGUNGAN, KOTABUMI SELATAN, LAMPUNG UTARA, LAMPUNG",3,27,132,159
https://kawalpemilu.org#23322,"CURUP GURUH KAGUNGAN, KOTABUMI SELATAN, LAMPUNG UTARA, LAMPUNG",4,15,160,175
https://kawalpemilu.org#23322,"CURUP GURUH KAGUNGAN, KOTABUMI SELATAN, LAMPUNG UTARA, LAMPUNG",5,15,107,122
https://kawalpemilu.org#23322,"CURUP GURUH KAGUNGAN, KOTABUMI SELATAN, LAMPUNG UTARA, LAMPUNG",6,28,100,128
https://kawalpemilu.org#23323,"JERANGKANG, KOTABUMI SELATAN, LAMPUNG UTARA, LAMPUNG",1,27,114,141
https://kawalpemilu.org#23323,"JERANGKANG, KOTABUMI SELATAN, LAMPUNG UTARA, LAMPUNG",2,25,97,122
https://kawalpemilu.org#23324,"WAY MELAN, KOTABUMI SELATAN, LAMPUNG UTARA, LAMPUNG",1,0,0,0
https://kawalpemilu.org#23324,"WAY MELAN, KOTABUMI SELATAN, LAMPUNG UTARA, LAMPUNG",2,0,0,0
https://kawalpemilu.org#23324,"WAY MELAN, KOTABUMI SELATAN, LAMPUNG UTARA, LAMPUNG",10,56,119,175
https://kawalpemilu.org#23324,"WAY MELAN, KOTABUMI SELATAN, LAMPUNG UTARA, LAMPUNG",11,25,90,115
https://kawalpemilu.org#23325,"TAMAN JAYA, KOTABUMI SELATAN, LAMPUNG UTARA, LAMPUNG",1,0,0,0
https://kawalpemilu.org#23325,"TAMAN JAYA, KOTABUMI SELATAN, LAMPUNG UTARA, LAMPUNG",2,0,0,0
https://kawalpemilu.org#23325,"TAMAN JAYA, KOTABUMI SELATAN, LAMPUNG UTARA, LAMPUNG",3,0,0,0
https://kawalpemilu.org#23325,"TAMAN JAYA, KOTABUMI SELATAN, LAMPUNG UTARA, LAMPUNG",4,0,0,0
https://kawalpemilu.org#23325,"TAMAN JAYA, KOTABUMI SELATAN, LAMPUNG UTARA, LAMPUNG",5,0,0,0
https://kawalpemilu.org#23325,"TAMAN JAYA, KOTABUMI SELATAN, LAMPUNG UTARA, LAMPUNG",25,27,114,141
https://kawalpemilu.org#23325,"TAMAN JAYA, KOTABUMI SELATAN, LAMPUNG UTARA, LAMPUNG",26,24,83,107
https://kawalpemilu.org#23325,"TAMAN JAYA, KOTABUMI SELATAN, LAMPUNG UTARA, LAMPUNG",27,8,108,116
https://kawalpemilu.org#23325,"TAMAN JAYA, KOTABUMI SELATAN, LAMPUNG UTARA, LAMPUNG",28,38,79,117
https://kawalpemilu.org#23325,"TAMAN JAYA, KOTABUMI SELATAN, LAMPUNG UTARA, LAMPUNG",29,20,107,127
https://kawalpemilu.org#23325,"TAMAN JAYA, KOTABUMI SELATAN, LAMPUNG UTARA, LAMPUNG",30,23,152,175
https://kawalpemilu.org#23326,"TANJUNG SENANG, KOTABUMI SELATAN, LAMPUNG UTARA, LAMPUNG",3,0,0,0
https://kawalpemilu.org#23326,"TANJUNG SENANG, KOTABUMI SELATAN, LAMPUNG UTARA, LAMPUNG",7,0,0,0
https://kawalpemilu.org#23326,"TANJUNG SENANG, KOTABUMI SELATAN, LAMPUNG UTARA, LAMPUNG",8,0,0,0
https://kawalpemilu.org#23326,"TANJUNG SENANG, KOTABUMI SELATAN, LAMPUNG UTARA, LAMPUNG",10,40,162,202
https://kawalpemilu.org#23326,"TANJUNG SENANG, KOTABUMI SELATAN, LAMPUNG UTARA, LAMPUNG",11,0,0,0
https://kawalpemilu.org#23326,"TANJUNG SENANG, KOTABUMI SELATAN, LAMPUNG UTARA, LAMPUNG",12,0,0,0
https://kawalpemilu.org#23326,"TANJUNG SENANG, KOTABUMI SELATAN, LAMPUNG UTARA, LAMPUNG",13,29,114,143
https://kawalpemilu.org#23326,"TANJUNG SENANG, KOTABUMI SELATAN, LAMPUNG UTARA, LAMPUNG",14,0,0,0
https://kawalpemilu.org#23326,"TANJUNG SENANG, KOTABUMI SELATAN, LAMPUNG UTARA, LAMPUNG",16,0,0,0
https://kawalpemilu.org#23326,"TANJUNG SENANG, KOTABUMI SELATAN, LAMPUNG UTARA, LAMPUNG",31,29,200,229
https://kawalpemilu.org#23326,"TANJUNG SENANG, KOTABUMI SELATAN, LAMPUNG UTARA, LAMPUNG",32,39,173,212
https://kawalpemilu.org#23326,"TANJUNG SENANG, KOTABUMI SELATAN, LAMPUNG UTARA, LAMPUNG",33,42,161,203
https://kawalpemilu.org#23326,"TANJUNG SENANG, KOTABUMI SELATAN, LAMPUNG UTARA, LAMPUNG",34,33,170,203
https://kawalpemilu.org#23326,"TANJUNG SENANG, KOTABUMI SELATAN, LAMPUNG UTARA, LAMPUNG",35,46,136,182
https://kawalpemilu.org#23326,"TANJUNG SENANG, KOTABUMI SELATAN, LAMPUNG UTARA, LAMPUNG",36,52,136,188
https://kawalpemilu.org#23326,"TANJUNG SENANG, KOTABUMI SELATAN, LAMPUNG UTARA, LAMPUNG",37,44,145,189
https://kawalpemilu.org#23326,"TANJUNG SENANG, KOTABUMI SELATAN, LAMPUNG UTARA, LAMPUNG",38,54,147,201
https://kawalpemilu.org#23326,"TANJUNG SENANG, KOTABUMI SELATAN, LAMPUNG UTARA, LAMPUNG",39,33,165,203
https://kawalpemilu.org#23326,"TANJUNG SENANG, KOTABUMI SELATAN, LAMPUNG UTARA, LAMPUNG",40,40,162,202
https://kawalpemilu.org#23326,"TANJUNG SENANG, KOTABUMI SELATAN, LAMPUNG UTARA, LAMPUNG",41,36,201,237
https://kawalpemilu.org#23326,"TANJUNG SENANG, KOTABUMI SELATAN, LAMPUNG UTARA, LAMPUNG",42,27,211,238
https://kawalpemilu.org#23326,"TANJUNG SENANG, KOTABUMI SELATAN, LAMPUNG UTARA, LAMPUNG",43,29,114,143
https://kawalpemilu.org#23326,"TANJUNG SENANG, KOTABUMI SELATAN, LAMPUNG UTARA, LAMPUNG",44,27,128,155
https://kawalpemilu.org#23326,"TANJUNG SENANG, KOTABUMI SELATAN, LAMPUNG UTARA, LAMPUNG",45,45,148,193
https://kawalpemilu.org#23326,"TANJUNG SENANG, KOTABUMI SELATAN, LAMPUNG UTARA, LAMPUNG",46,42,145,187
https://kawalpemilu.org#23328,"ALAM JAYA, KOTABUMI SELATAN, LAMPUNG UTARA, LAMPUNG",1,0,0,0
https://kawalpemilu.org#23328,"ALAM JAYA, KOTABUMI SELATAN, LAMPUNG UTARA, LAMPUNG",2,0,0,0
https://kawalpemilu.org#23328,"ALAM JAYA, KOTABUMI SELATAN, LAMPUNG UTARA, LAMPUNG",3,0,0,0
https://kawalpemilu.org#23328,"ALAM JAYA, KOTABUMI SELATAN, LAMPUNG UTARA, LAMPUNG",14,19,61,80
https://kawalpemilu.org#23328,"ALAM JAYA, KOTABUMI SELATAN, LAMPUNG UTARA, LAMPUNG",15,17,96,113
https://kawalpemilu.org#23328,"ALAM JAYA, KOTABUMI SELATAN, LAMPUNG UTARA, LAMPUNG",16,30,135,165
https://kawalpemilu.org#23329,"SINAR MAS ALAM, KOTABUMI SELATAN, LAMPUNG UTARA, LAMPUNG",1,0,0,0
https://kawalpemilu.org#23329,"SINAR MAS ALAM, KOTABUMI SELATAN, LAMPUNG UTARA, LAMPUNG",2,25,134,159
https://kawalpemilu.org#23329,"SINAR MAS ALAM, KOTABUMI SELATAN, LAMPUNG UTARA, LAMPUNG",12,33,130,163
https://kawalpemilu.org#88182,"TANJUNG HARAPAN, KOTABUMI SELATAN, LAMPUNG UTARA, LAMPUNG",10,0,0,0
https://kawalpemilu.org#88182,"TANJUNG HARAPAN, KOTABUMI SELATAN, LAMPUNG UTARA, LAMPUNG",69,42,97,139
https://kawalpemilu.org#88182,"TANJUNG HARAPAN, KOTABUMI SELATAN, LAMPUNG UTARA, LAMPUNG",70,27,93,120
https://kawalpemilu.org#88182,"TANJUNG HARAPAN, KOTABUMI SELATAN, LAMPUNG UTARA, LAMPUNG",71,38,160,198
https://kawalpemilu.org#88182,"TANJUNG HARAPAN, KOTABUMI SELATAN, LAMPUNG UTARA, LAMPUNG",72,55,136,191
https://kawalpemilu.org#88182,"TANJUNG HARAPAN, KOTABUMI SELATAN, LAMPUNG UTARA, LAMPUNG",73,39,139,178
https://kawalpemilu.org#88182,"TANJUNG HARAPAN, KOTABUMI SELATAN, LAMPUNG UTARA, LAMPUNG",74,33,137,170
https://kawalpemilu.org#88182,"TANJUNG HARAPAN, KOTABUMI SELATAN, LAMPUNG UTARA, LAMPUNG",75,14,200,214
https://kawalpemilu.org#88182,"TANJUNG HARAPAN, KOTABUMI SELATAN, LAMPUNG UTARA, LAMPUNG",76,22,153,175
https://kawalpemilu.org#88182,"TANJUNG HARAPAN, KOTABUMI SELATAN, LAMPUNG UTARA, LAMPUNG",77,79,168,247
https://kawalpemilu.org#88182,"TANJUNG HARAPAN, KOTABUMI SELATAN, LAMPUNG UTARA, LAMPUNG",78,70,163,233
https://kawalpemilu.org#88182,"TANJUNG HARAPAN, KOTABUMI SELATAN, LAMPUNG UTARA, LAMPUNG",79,26,51,77
https://kawalpemilu.org#88182,"TANJUNG HARAPAN, KOTABUMI SELATAN, LAMPUNG UTARA, LAMPUNG",80,18,198,216
https://kawalpemilu.org#88182,"TANJUNG HARAPAN, KOTABUMI SELATAN, LAMPUNG UTARA, LAMPUNG",81,43,130,173
https://kawalpemilu.org#88182,"TANJUNG HARAPAN, KOTABUMI SELATAN, LAMPUNG UTARA, LAMPUNG",83,45,159,204
https://kawalpemilu.org#88182,"TANJUNG HARAPAN, KOTABUMI SELATAN, LAMPUNG UTARA, LAMPUNG",84,45,190,235
https://kawalpemilu.org#88182,"TANJUNG HARAPAN, KOTABUMI SELATAN, LAMPUNG UTARA, LAMPUNG",85,41,157,198
https://kawalpemilu.org#88182,"TANJUNG HARAPAN, KOTABUMI SELATAN, LAMPUNG UTARA, LAMPUNG",86,31,131,162
https://kawalpemilu.org#88182,"TANJUNG HARAPAN, KOTABUMI SELATAN, LAMPUNG UTARA, LAMPUNG",87,17,175,192
https://kawalpemilu.org#88182,"TANJUNG HARAPAN, KOTABUMI SELATAN, LAMPUNG UTARA, LAMPUNG",88,16,105,121
https://kawalpemilu.org#88182,"TANJUNG HARAPAN, KOTABUMI SELATAN, LAMPUNG UTARA, LAMPUNG",89,20,126,146
https://kawalpemilu.org#88182,"TANJUNG HARAPAN, KOTABUMI SELATAN, LAMPUNG UTARA, LAMPUNG",90,37,131,168
https://kawalpemilu.org#88182,"TANJUNG HARAPAN, KOTABUMI SELATAN, LAMPUNG UTARA, LAMPUNG",91,26,171,171
https://kawalpemilu.org#88182,"TANJUNG HARAPAN, KOTABUMI SELATAN, LAMPUNG UTARA, LAMPUNG",92,10,92,102
https://kawalpemilu.org#88182,"TANJUNG HARAPAN, KOTABUMI SELATAN, LAMPUNG UTARA, LAMPUNG",93,44,162,206
https://kawalpemilu.org#88182,"TANJUNG HARAPAN, KOTABUMI SELATAN, LAMPUNG UTARA, LAMPUNG",94,50,139,189
https://kawalpemilu.org#88182,"TANJUNG HARAPAN, KOTABUMI SELATAN, LAMPUNG UTARA, LAMPUNG",95,55,177,232
https://kawalpemilu.org#88182,"TANJUNG HARAPAN, KOTABUMI SELATAN, LAMPUNG UTARA, LAMPUNG",96,53,176,229
https://kawalpemilu.org#88182,"TANJUNG HARAPAN, KOTABUMI SELATAN, LAMPUNG UTARA, LAMPUNG",97,15,143,158
https://kawalpemilu.org#88182,"TANJUNG HARAPAN, KOTABUMI SELATAN, LAMPUNG UTARA, LAMPUNG",98,9,91,100
https://kawalpemilu.org#88182,"TANJUNG HARAPAN, KOTABUMI SELATAN, LAMPUNG UTARA, LAMPUNG",99,18,123,141
https://kawalpemilu.org#88182,"TANJUNG HARAPAN, KOTABUMI SELATAN, LAMPUNG UTARA, LAMPUNG",100,30,125,155
https://kawalpemilu.org#88182,"TANJUNG HARAPAN, KOTABUMI SELATAN, LAMPUNG UTARA, LAMPUNG",222,8,38,46
https://kawalpemilu.org#88182,"TANJUNG HARAPAN, KOTABUMI SELATAN, LAMPUNG UTARA, LAMPUNG",223,6,26,32
https://kawalpemilu.org#23331,"GUNUNG BESAR, ABUNG TENGAH, LAMPUNG UTARA, LAMPUNG",1,26,138,164
https://kawalpemilu.org#23331,"GUNUNG BESAR, ABUNG TENGAH, LAMPUNG UTARA, LAMPUNG",2,41,137,178
https://kawalpemilu.org#23331,"GUNUNG BESAR, ABUNG TENGAH, LAMPUNG UTARA, LAMPUNG",3,53,193,246
https://kawalpemilu.org#23331,"GUNUNG BESAR, ABUNG TENGAH, LAMPUNG UTARA, LAMPUNG",4,82,83,165
https://kawalpemilu.org#23331,"GUNUNG BESAR, ABUNG TENGAH, LAMPUNG UTARA, LAMPUNG",5,69,82,151
https://kawalpemilu.org#23332,"KINCIRAN, ABUNG TENGAH, LAMPUNG UTARA, LAMPUNG",1,0,0,0
https://kawalpemilu.org#23332,"KINCIRAN, ABUNG TENGAH, LAMPUNG UTARA, LAMPUNG",2,0,0,0
https://kawalpemilu.org#23332,"KINCIRAN, ABUNG TENGAH, LAMPUNG UTARA, LAMPUNG",3,0,0,0
https://kawalpemilu.org#23332,"KINCIRAN, ABUNG TENGAH, LAMPUNG UTARA, LAMPUNG",4,0,0,0
https://kawalpemilu.org#23332,"KINCIRAN, ABUNG TENGAH, LAMPUNG UTARA, LAMPUNG",5,0,0,0
https://kawalpemilu.org#23332,"KINCIRAN, ABUNG TENGAH, LAMPUNG UTARA, LAMPUNG",6,0,0,0
https://kawalpemilu.org#23332,"KINCIRAN, ABUNG TENGAH, LAMPUNG UTARA, LAMPUNG",12,60,87,147
https://kawalpemilu.org#23332,"KINCIRAN, ABUNG TENGAH, LAMPUNG UTARA, LAMPUNG",13,37,101,138
https://kawalpemilu.org#23332,"KINCIRAN, ABUNG TENGAH, LAMPUNG UTARA, LAMPUNG",14,48,118,166
https://kawalpemilu.org#23332,"KINCIRAN, ABUNG TENGAH, LAMPUNG UTARA, LAMPUNG",15,53,122,175
https://kawalpemilu.org#23332,"KINCIRAN, ABUNG TENGAH, LAMPUNG UTARA, LAMPUNG",16,53,91,144
https://kawalpemilu.org#23332,"KINCIRAN, ABUNG TENGAH, LAMPUNG UTARA, LAMPUNG",17,68,79,147
https://kawalpemilu.org#23333,"NEGLA SARI, ABUNG TENGAH, LAMPUNG UTARA, LAMPUNG",1,0,0,0
https://kawalpemilu.org#23333,"NEGLA SARI, ABUNG TENGAH, LAMPUNG UTARA, LAMPUNG",2,0,0,0
https://kawalpemilu.org#23333,"NEGLA SARI, ABUNG TENGAH, LAMPUNG UTARA, LAMPUNG",3,0,0,0
https://kawalpemilu.org#23333,"NEGLA SARI, ABUNG TENGAH, LAMPUNG UTARA, LAMPUNG",4,0,0,0
https://kawalpemilu.org#23333,"NEGLA SARI, ABUNG TENGAH, LAMPUNG UTARA, LAMPUNG",5,0,0,0
https://kawalpemilu.org#23333,"NEGLA SARI, ABUNG TENGAH, LAMPUNG UTARA, LAMPUNG",6,51,106,157
https://kawalpemilu.org#23333,"NEGLA SARI, ABUNG TENGAH, LAMPUNG UTARA, LAMPUNG",7,30,105,135
https://kawalpemilu.org#23333,"NEGLA SARI, ABUNG TENGAH, LAMPUNG UTARA, LAMPUNG",8,39,92,131
https://kawalpemilu.org#23333,"NEGLA SARI, ABUNG TENGAH, LAMPUNG UTARA, LAMPUNG",9,36,97,133
https://kawalpemilu.org#23333,"NEGLA SARI, ABUNG TENGAH, LAMPUNG UTARA, LAMPUNG",10,37,97,134
https://kawalpemilu.org#23333,"NEGLA SARI, ABUNG TENGAH, LAMPUNG UTARA, LAMPUNG",11,25,85,110
https://kawalpemilu.org#23334,"KEDATON, ABUNG TENGAH, LAMPUNG UTARA, LAMPUNG",1,0,0,0
https://kawalpemilu.org#23334,"KEDATON, ABUNG TENGAH, LAMPUNG UTARA, LAMPUNG",2,0,0,0
https://kawalpemilu.org#23334,"KEDATON, ABUNG TENGAH, LAMPUNG UTARA, LAMPUNG",3,0,0,0
https://kawalpemilu.org#23334,"KEDATON, ABUNG TENGAH, LAMPUNG UTARA, LAMPUNG",4,0,0,0
https://kawalpemilu.org#23334,"KEDATON, ABUNG TENGAH, LAMPUNG UTARA, LAMPUNG",5,0,0,0
https://kawalpemilu.org#23334,"KEDATON, ABUNG TENGAH, LAMPUNG UTARA, LAMPUNG",23,23,79,102
https://kawalpemilu.org#23334,"KEDATON, ABUNG TENGAH, LAMPUNG UTARA, LAMPUNG",24,33,110,143
https://kawalpemilu.org#23334,"KEDATON, ABUNG TENGAH, LAMPUNG UTARA, LAMPUNG",25,63,133,196
https://kawalpemilu.org#23334,"KEDATON, ABUNG TENGAH, LAMPUNG UTARA, LAMPUNG",26,36,108,144
https://kawalpemilu.org#23334,"KEDATON, ABUNG TENGAH, LAMPUNG UTARA, LAMPUNG",27,33,101,134
https://kawalpemilu.org#23335,"SRI BANDUNG, ABUNG TENGAH, LAMPUNG UTARA, LAMPUNG",2,0,0,0
https://kawalpemilu.org#23335,"SRI BANDUNG, ABUNG TENGAH, LAMPUNG UTARA, LAMPUNG",4,0,0,0
https://kawalpemilu.org#23335,"SRI BANDUNG, ABUNG TENGAH, LAMPUNG UTARA, LAMPUNG",18,38,102,140
https://kawalpemilu.org#23335,"SRI BANDUNG, ABUNG TENGAH, LAMPUNG UTARA, LAMPUNG",19,27,120,147
https://kawalpemilu.org#23335,"SRI BANDUNG, ABUNG TENGAH, LAMPUNG UTARA, LAMPUNG",20,23,112,135
https://kawalpemilu.org#23335,"SRI BANDUNG, ABUNG TENGAH, LAMPUNG UTARA, LAMPUNG",21,25,96,121
https://kawalpemilu.org#23335,"SRI BANDUNG, ABUNG TENGAH, LAMPUNG UTARA, LAMPUNG",22,28,163,191
https://kawalpemilu.org#23336,"SUBIK, ABUNG TENGAH, LAMPUNG UTARA, LAMPUNG",1,69,68,137
https://kawalpemilu.org#23336,"SUBIK, ABUNG TENGAH, LAMPUNG UTARA, LAMPUNG",2,88,54,142
https://kawalpemilu.org#23336,"SUBIK, ABUNG TENGAH, LAMPUNG UTARA, LAMPUNG",3,96,33,129
https://kawalpemilu.org#23336,"SUBIK, ABUNG TENGAH, LAMPUNG UTARA, LAMPUNG",4,121,30,151
https://kawalpemilu.org#23336,"SUBIK, ABUNG TENGAH, LAMPUNG UTARA, LAMPUNG",5,98,94,192
https://kawalpemilu.org#23336,"SUBIK, ABUNG TENGAH, LAMPUNG UTARA, LAMPUNG",7,98,49,147
https://kawalpemilu.org#23336,"SUBIK, ABUNG TENGAH, LAMPUNG UTARA, LAMPUNG",8,92,63,155
https://kawalpemilu.org#23336,"SUBIK, ABUNG TENGAH, LAMPUNG UTARA, LAMPUNG",9,86,47,133
https://kawalpemilu.org#23336,"SUBIK, ABUNG TENGAH, LAMPUNG UTARA, LAMPUNG",10,100,37,137
https://kawalpemilu.org#23336,"SUBIK, ABUNG TENGAH, LAMPUNG UTARA, LAMPUNG",11,91,35,126
https://kawalpemilu.org#23336,"SUBIK, ABUNG TENGAH, LAMPUNG UTARA, LAMPUNG",12,111,18,129
https://kawalpemilu.org#23336,"SUBIK, ABUNG TENGAH, LAMPUNG UTARA, LAMPUNG",13,104,18,122
https://kawalpemilu.org#23336,"SUBIK, ABUNG TENGAH, LAMPUNG UTARA, LAMPUNG",14,95,25,120
https://kawalpemilu.org#23336,"SUBIK, ABUNG TENGAH, LAMPUNG UTARA, LAMPUNG",48,109,63,172
https://kawalpemilu.org#23337,"GUNUNG SADAR, ABUNG TENGAH, LAMPUNG UTARA, LAMPUNG",2,0,0,0
https://kawalpemilu.org#23337,"GUNUNG SADAR, ABUNG TENGAH, LAMPUNG UTARA, LAMPUNG",3,0,0,0
https://kawalpemilu.org#23337,"GUNUNG SADAR, ABUNG TENGAH, LAMPUNG UTARA, LAMPUNG",4,0,0,0
https://kawalpemilu.org#23337,"GUNUNG SADAR, ABUNG TENGAH, LAMPUNG UTARA, LAMPUNG",5,0,0,0
https://kawalpemilu.org#23337,"GUNUNG SADAR, ABUNG TENGAH, LAMPUNG UTARA, LAMPUNG",58,110,23,133
https://kawalpemilu.org#23337,"GUNUNG SADAR, ABUNG TENGAH, LAMPUNG UTARA, LAMPUNG",59,72,40,112
https://kawalpemilu.org#23337,"GUNUNG SADAR, ABUNG TENGAH, LAMPUNG UTARA, LAMPUNG",60,102,68,170
https://kawalpemilu.org#23337,"GUNUNG SADAR, ABUNG TENGAH, LAMPUNG UTARA, LAMPUNG",61,123,40,163
https://kawalpemilu.org#23338,"GUNUNG GIJUL, ABUNG TENGAH, LAMPUNG UTARA, LAMPUNG",1,0,0,0
https://kawalpemilu.org#23338,"GUNUNG GIJUL, ABUNG TENGAH, LAMPUNG UTARA, LAMPUNG",2,0,0,0
https://kawalpemilu.org#23338,"GUNUNG GIJUL, ABUNG TENGAH, LAMPUNG UTARA, LAMPUNG",3,0,0,0
https://kawalpemilu.org#23338,"GUNUNG GIJUL, ABUNG TENGAH, LAMPUNG UTARA, LAMPUNG",4,0,0,0
https://kawalpemilu.org#23338,"GUNUNG GIJUL, ABUNG TENGAH, LAMPUNG UTARA, LAMPUNG",62,23,93,116
https://kawalpemilu.org#23338,"GUNUNG GIJUL, ABUNG TENGAH, LAMPUNG UTARA, LAMPUNG",63,23,72,95
https://kawalpemilu.org#23338,"GUNUNG GIJUL, ABUNG TENGAH, LAMPUNG UTARA, LAMPUNG",64,50,89,139
https://kawalpemilu.org#23338,"GUNUNG GIJUL, ABUNG TENGAH, LAMPUNG UTARA, LAMPUNG",65,30,37,67
https://kawalpemilu.org#23339,"PEKURUN SELATAN, ABUNG TENGAH, LAMPUNG UTARA, LAMPUNG",1,0,0,0
https://kawalpemilu.org#23339,"PEKURUN SELATAN, ABUNG TENGAH, LAMPUNG UTARA, LAMPUNG",2,0,0,0
https://kawalpemilu.org#23339,"PEKURUN SELATAN, ABUNG TENGAH, LAMPUNG UTARA, LAMPUNG",3,0,0,0
https://kawalpemilu.org#23339,"PEKURUN SELATAN, ABUNG TENGAH, LAMPUNG UTARA, LAMPUNG",4,0,0,0
https://kawalpemilu.org#23339,"PEKURUN SELATAN, ABUNG TENGAH, LAMPUNG UTARA, LAMPUNG",5,0,0,0
https://kawalpemilu.org#23339,"PEKURUN SELATAN, ABUNG TENGAH, LAMPUNG UTARA, LAMPUNG",28,99,63,162
https://kawalpemilu.org#23339,"PEKURUN SELATAN, ABUNG TENGAH, LAMPUNG UTARA, LAMPUNG",29,58,80,138
https://kawalpemilu.org#23339,"PEKURUN SELATAN, ABUNG TENGAH, LAMPUNG UTARA, LAMPUNG",30,98,102,200
https://kawalpemilu.org#23339,"PEKURUN SELATAN, ABUNG TENGAH, LAMPUNG UTARA, LAMPUNG",31,77,67,144
https://kawalpemilu.org#23339,"PEKURUN SELATAN, ABUNG TENGAH, LAMPUNG UTARA, LAMPUNG",32,101,52,153
https://kawalpemilu.org#23340,"PEKURUN BARAT, ABUNG TENGAH, LAMPUNG UTARA, LAMPUNG",1,0,0,0
https://kawalpemilu.org#23340,"PEKURUN BARAT, ABUNG TENGAH, LAMPUNG UTARA, LAMPUNG",2,0,0,0
https://kawalpemilu.org#23340,"PEKURUN BARAT, ABUNG TENGAH, LAMPUNG UTARA, LAMPUNG",3,0,0,0
https://kawalpemilu.org#23340,"PEKURUN BARAT, ABUNG TENGAH, LAMPUNG UTARA, LAMPUNG",4,0,0,0
https://kawalpemilu.org#23340,"PEKURUN BARAT, ABUNG TENGAH, LAMPUNG UTARA, LAMPUNG",5,0,0,0
https://kawalpemilu.org#23340,"PEKURUN BARAT, ABUNG TENGAH, LAMPUNG UTARA, LAMPUNG",6,0,0,0
https://kawalpemilu.org#23340,"PEKURUN BARAT, ABUNG TENGAH, LAMPUNG UTARA, LAMPUNG",7,0,0,0
https://kawalpemilu.org#23340,"PEKURUN BARAT, ABUNG TENGAH, LAMPUNG UTARA, LAMPUNG",36,86,46,132
https://kawalpemilu.org#23340,"PEKURUN BARAT, ABUNG TENGAH, LAMPUNG UTARA, LAMPUNG",37,118,62,180
https://kawalpemilu.org#23340,"PEKURUN BARAT, ABUNG TENGAH, LAMPUNG UTARA, LAMPUNG",38,90,64,154
https://kawalpemilu.org#23340,"PEKURUN BARAT, ABUNG TENGAH, LAMPUNG UTARA, LAMPUNG",39,40,97,137
https://kawalpemilu.org#23340,"PEKURUN BARAT, ABUNG TENGAH, LAMPUNG UTARA, LAMPUNG",40,74,96,170
https://kawalpemilu.org#23340,"PEKURUN BARAT, ABUNG TENGAH, LAMPUNG UTARA, LAMPUNG",41,83,82,165
https://kawalpemilu.org#23340,"PEKURUN BARAT, ABUNG TENGAH, LAMPUNG UTARA, LAMPUNG",42,45,101,146
https://kawalpemilu.org#23341,"PEKURUN UTARA, ABUNG TENGAH, LAMPUNG UTARA, LAMPUNG",1,0,0,0
https://kawalpemilu.org#23341,"PEKURUN UTARA, ABUNG TENGAH, LAMPUNG UTARA, LAMPUNG",2,0,0,0
https://kawalpemilu.org#23341,"PEKURUN UTARA, ABUNG TENGAH, LAMPUNG UTARA, LAMPUNG",3,0,0,0
https://kawalpemilu.org#23341,"PEKURUN UTARA, ABUNG TENGAH, LAMPUNG UTARA, LAMPUNG",33,147,75,222
https://kawalpemilu.org#23341,"PEKURUN UTARA, ABUNG TENGAH, LAMPUNG UTARA, LAMPUNG",34,47,106,153
https://kawalpemilu.org#23341,"PEKURUN UTARA, ABUNG TENGAH, LAMPUNG UTARA, LAMPUNG",35,57,85,142
https://kawalpemilu.org#23343,"ULAK RENGAS, ABUNG TINGGI, LAMPUNG UTARA, LAMPUNG",1,0,0,0
https://kawalpemilu.org#23343,"ULAK RENGAS, ABUNG TINGGI, LAMPUNG UTARA, LAMPUNG",2,0,0,0
https://kawalpemilu.org#23343,"ULAK RENGAS, ABUNG TINGGI, LAMPUNG UTARA, LAMPUNG",3,0,0,0
https://kawalpemilu.org#23343,"ULAK RENGAS, ABUNG TINGGI, LAMPUNG UTARA, LAMPUNG",4,0,0,0
https://kawalpemilu.org#23343,"ULAK RENGAS, ABUNG TINGGI, LAMPUNG UTARA, LAMPUNG",6,0,0,0
https://kawalpemilu.org#23343,"ULAK RENGAS, ABUNG TINGGI, LAMPUNG UTARA, LAMPUNG",49,25,165,190
https://kawalpemilu.org#23343,"ULAK RENGAS, ABUNG TINGGI, LAMPUNG UTARA, LAMPUNG",50,23,155,178
https://kawalpemilu.org#23343,"ULAK RENGAS, ABUNG TINGGI, LAMPUNG UTARA, LAMPUNG",51,22,153,175
https://kawalpemilu.org#23343,"ULAK RENGAS, ABUNG TINGGI, LAMPUNG UTARA, LAMPUNG",52,20,124,144
https://kawalpemilu.org#23343,"ULAK RENGAS, ABUNG TINGGI, LAMPUNG UTARA, LAMPUNG",53,54,165,219
https://kawalpemilu.org#23343,"ULAK RENGAS, ABUNG TINGGI, LAMPUNG UTARA, LAMPUNG",54,36,162,198
https://kawalpemilu.org#23343,"ULAK RENGAS, ABUNG TINGGI, LAMPUNG UTARA, LAMPUNG",55,111,90,201
https://kawalpemilu.org#23343,"ULAK RENGAS, ABUNG TINGGI, LAMPUNG UTARA, LAMPUNG",56,36,137,202
https://kawalpemilu.org#23344,"MUARA DUA, ABUNG TINGGI, LAMPUNG UTARA, LAMPUNG",7,28,170,198
https://kawalpemilu.org#23344,"MUARA DUA, ABUNG TINGGI, LAMPUNG UTARA, LAMPUNG",8,31,127,158
https://kawalpemilu.org#23344,"MUARA DUA, ABUNG TINGGI, LAMPUNG UTARA, LAMPUNG",9,42,129,171
https://kawalpemilu.org#23345,"PULAU PANGGUNG, ABUNG TINGGI, LAMPUNG UTARA, LAMPUNG",1,0,0,0
https://kawalpemilu.org#23345,"PULAU PANGGUNG, ABUNG TINGGI, LAMPUNG UTARA, LAMPUNG",2,0,0,0
https://kawalpemilu.org#23345,"PULAU PANGGUNG, ABUNG TINGGI, LAMPUNG UTARA, LAMPUNG",3,0,0,0
https://kawalpemilu.org#23345,"PULAU PANGGUNG, ABUNG TINGGI, LAMPUNG UTARA, LAMPUNG",4,0,0,0
https://kawalpemilu.org#23345,"PULAU PANGGUNG, ABUNG TINGGI, LAMPUNG UTARA, LAMPUNG",5,0,0,0
https://kawalpemilu.org#23345,"PULAU PANGGUNG, ABUNG TINGGI, LAMPUNG UTARA, LAMPUNG",6,0,0,0
https://kawalpemilu.org#23345,"PULAU PANGGUNG, ABUNG TINGGI, LAMPUNG UTARA, LAMPUNG",7,0,0,0
https://kawalpemilu.org#23345,"PULAU PANGGUNG, ABUNG TINGGI, LAMPUNG UTARA, LAMPUNG",10,66,106,172
https://kawalpemilu.org#23345,"PULAU PANGGUNG, ABUNG TINGGI, LAMPUNG UTARA, LAMPUNG",11,56,133,189
https://kawalpemilu.org#23345,"PULAU PANGGUNG, ABUNG TINGGI, LAMPUNG UTARA, LAMPUNG",12,48,147,195
https://kawalpemilu.org#23345,"PULAU PANGGUNG, ABUNG TINGGI, LAMPUNG UTARA, LAMPUNG",13,32,163,195
https://kawalpemilu.org#23345,"PULAU PANGGUNG, ABUNG TINGGI, LAMPUNG UTARA, LAMPUNG",14,26,129,155
https://kawalpemilu.org#23345,"PULAU PANGGUNG, ABUNG TINGGI, LAMPUNG UTARA, LAMPUNG",15,71,168,239
https://kawalpemilu.org#23345,"PULAU PANGGUNG, ABUNG TINGGI, LAMPUNG UTARA, LAMPUNG",16,60,158,218
https://kawalpemilu.org#23346,"SEKIPI, ABUNG TINGGI, LAMPUNG UTARA, LAMPUNG",3,0,0,0
https://kawalpemilu.org#23346,"SEKIPI, ABUNG TINGGI, LAMPUNG UTARA, LAMPUNG",4,0,0,0
https://kawalpemilu.org#23346,"SEKIPI, ABUNG TINGGI, LAMPUNG UTARA, LAMPUNG",5,0,0,0
https://kawalpemilu.org#23346,"SEKIPI, ABUNG TINGGI, LAMPUNG UTARA, LAMPUNG",17,45,144,189
https://kawalpemilu.org#23346,"SEKIPI, ABUNG TINGGI, LAMPUNG UTARA, LAMPUNG",18,42,121,163
https://kawalpemilu.org#23346,"SEKIPI, ABUNG TINGGI, LAMPUNG UTARA, LAMPUNG",19,50,130,180
https://kawalpemilu.org#23346,"SEKIPI, ABUNG TINGGI, LAMPUNG UTARA, LAMPUNG",20,40,118,158
https://kawalpemilu.org#23346,"SEKIPI, ABUNG TINGGI, LAMPUNG UTARA, LAMPUNG",21,47,117,164
https://kawalpemilu.org#23346,"SEKIPI, ABUNG TINGGI, LAMPUNG UTARA, LAMPUNG",22,34,119,153
https://kawalpemilu.org#23347,"SIDO KAYO, ABUNG TINGGI, LAMPUNG UTARA, LAMPUNG",23,56,137,193
https://kawalpemilu.org#23347,"SIDO KAYO, ABUNG TINGGI, LAMPUNG UTARA, LAMPUNG",24,90,116,206
https://kawalpemilu.org#23347,"SIDO KAYO, ABUNG TINGGI, LAMPUNG UTARA, LAMPUNG",25,74,103,177
https://kawalpemilu.org#23347,"SIDO KAYO, ABUNG TINGGI, LAMPUNG UTARA, LAMPUNG",26,93,123,216
https://kawalpemilu.org#23347,"SIDO KAYO, ABUNG TINGGI, LAMPUNG UTARA, LAMPUNG",27,112,87,199
https://kawalpemilu.org#23347,"SIDO KAYO, ABUNG TINGGI, LAMPUNG UTARA, LAMPUNG",28,74,91,165
https://kawalpemilu.org#23347,"SIDO KAYO, ABUNG TINGGI, LAMPUNG UTARA, LAMPUNG",29,124,74,198
https://kawalpemilu.org#23347,"SIDO KAYO, ABUNG TINGGI, LAMPUNG UTARA, LAMPUNG",30,96,41,137
https://kawalpemilu.org#23347,"SIDO KAYO, ABUNG TINGGI, LAMPUNG UTARA, LAMPUNG",31,99,94,193
https://kawalpemilu.org#23347,"SIDO KAYO, ABUNG TINGGI, LAMPUNG UTARA, LAMPUNG",32,104,62,166
https://kawalpemilu.org#23347,"SIDO KAYO, ABUNG TINGGI, LAMPUNG UTARA, LAMPUNG",33,47,65,112
https://kawalpemilu.org#23347,"SIDO KAYO, ABUNG TINGGI, LAMPUNG UTARA, LAMPUNG",34,94,60,154
https://kawalpemilu.org#23348,"SUKA MARGA, ABUNG TINGGI, LAMPUNG UTARA, LAMPUNG",7,97,116,213
https://kawalpemilu.org#23348,"SUKA MARGA, ABUNG TINGGI, LAMPUNG UTARA, LAMPUNG",37,66,161,227
https://kawalpemilu.org#23348,"SUKA MARGA, ABUNG TINGGI, LAMPUNG UTARA, LAMPUNG",38,76,134,210
https://kawalpemilu.org#23348,"SUKA MARGA, ABUNG TINGGI, LAMPUNG UTARA, LAMPUNG",39,90,159,249
https://kawalpemilu.org#23348,"SUKA MARGA, ABUNG TINGGI, LAMPUNG UTARA, LAMPUNG",40,60,121,181
https://kawalpemilu.org#23348,"SUKA MARGA, ABUNG TINGGI, LAMPUNG UTARA, LAMPUNG",42,85,125,210
https://kawalpemilu.org#23348,"SUKA MARGA, ABUNG TINGGI, LAMPUNG UTARA, LAMPUNG",44,42,94,136
https://kawalpemilu.org#23348,"SUKA MARGA, ABUNG TINGGI, LAMPUNG UTARA, LAMPUNG",45,97,171,268
https://kawalpemilu.org#23348,"SUKA MARGA, ABUNG TINGGI, LAMPUNG UTARA, LAMPUNG",46,108,82,190
https://kawalpemilu.org#23348,"SUKA MARGA, ABUNG TINGGI, LAMPUNG UTARA, LAMPUNG",47,86,137,223
https://kawalpemilu.org#23348,"SUKA MARGA, ABUNG TINGGI, LAMPUNG UTARA, LAMPUNG",48,81,36,117
https://kawalpemilu.org#23349,"SUKA MAJU, ABUNG TINGGI, LAMPUNG UTARA, LAMPUNG",35,66,115,181
https://kawalpemilu.org#23349,"SUKA MAJU, ABUNG TINGGI, LAMPUNG UTARA, LAMPUNG",36,39,161,200
https://kawalpemilu.org#23350,"KEBUN DALAM, ABUNG TINGGI, LAMPUNG UTARA, LAMPUNG",1,18,131,149
https://kawalpemilu.org#23350,"KEBUN DALAM, ABUNG TINGGI, LAMPUNG UTARA, LAMPUNG",2,13,116,129
https://kawalpemilu.org#23350,"KEBUN DALAM, ABUNG TINGGI, LAMPUNG UTARA, LAMPUNG",3,21,118,139
https://kawalpemilu.org#23350,"KEBUN DALAM, ABUNG TINGGI, LAMPUNG UTARA, LAMPUNG",4,15,120,135
https://kawalpemilu.org#23350,"KEBUN DALAM, ABUNG TINGGI, LAMPUNG UTARA, LAMPUNG",5,46,107,153
https://kawalpemilu.org#23350,"KEBUN DALAM, ABUNG TINGGI, LAMPUNG UTARA, LAMPUNG",6,48,94,142
https://kawalpemilu.org#23352,"SUKA MAJU, ABUNG SEMULI, LAMPUNG UTARA, LAMPUNG",3,0,0,0
https://kawalpemilu.org#23352,"SUKA MAJU, ABUNG SEMULI, LAMPUNG UTARA, LAMPUNG",6,0,0,0
https://kawalpemilu.org#23352,"SUKA MAJU, ABUNG SEMULI, LAMPUNG UTARA, LAMPUNG",7,0,0,0
https://kawalpemilu.org#23352,"SUKA MAJU, ABUNG SEMULI, LAMPUNG UTARA, LAMPUNG",8,0,0,0
https://kawalpemilu.org#23352,"SUKA MAJU, ABUNG SEMULI, LAMPUNG UTARA, LAMPUNG",10,0,0,0
https://kawalpemilu.org#23352,"SUKA MAJU, ABUNG SEMULI, LAMPUNG UTARA, LAMPUNG",11,0,0,0
https://kawalpemilu.org#23352,"SUKA MAJU, ABUNG SEMULI, LAMPUNG UTARA, LAMPUNG",14,0,0,0
https://kawalpemilu.org#23352,"SUKA MAJU, ABUNG SEMULI, LAMPUNG UTARA, LAMPUNG",68,97,96,193
https://kawalpemilu.org#23352,"SUKA MAJU, ABUNG SEMULI, LAMPUNG UTARA, LAMPUNG",69,83,139,222
https://kawalpemilu.org#23352,"SUKA MAJU, ABUNG SEMULI, LAMPUNG UTARA, LAMPUNG",70,109,110,219
https://kawalpemilu.org#23352,"SUKA MAJU, ABUNG SEMULI, LAMPUNG UTARA, LAMPUNG",71,68,40,108
https://kawalpemilu.org#23352,"SUKA MAJU, ABUNG SEMULI, LAMPUNG UTARA, LAMPUNG",72,92,125,217
https://kawalpemilu.org#23352,"SUKA MAJU, ABUNG SEMULI, LAMPUNG UTARA, LAMPUNG",73,46,117,163
https://kawalpemilu.org#23352,"SUKA MAJU, ABUNG SEMULI, LAMPUNG UTARA, LAMPUNG",74,40,80,120
https://kawalpemilu.org#23352,"SUKA MAJU, ABUNG SEMULI, LAMPUNG UTARA, LAMPUNG",75,49,81,130
https://kawalpemilu.org#23352,"SUKA MAJU, ABUNG SEMULI, LAMPUNG UTARA, LAMPUNG",77,63,102,165
https://kawalpemilu.org#23352,"SUKA MAJU, ABUNG SEMULI, LAMPUNG UTARA, LAMPUNG",78,93,138,231
https://kawalpemilu.org#23352,"SUKA MAJU, ABUNG SEMULI, LAMPUNG UTARA, LAMPUNG",79,93,100,193
https://kawalpemilu.org#23352,"SUKA MAJU, ABUNG SEMULI, LAMPUNG UTARA, LAMPUNG",80,139,87,226
https://kawalpemilu.org#23352,"SUKA MAJU, ABUNG SEMULI, LAMPUNG UTARA, LAMPUNG",81,86,98,184
https://kawalpemilu.org#23352,"SUKA MAJU, ABUNG SEMULI, LAMPUNG UTARA, LAMPUNG",82,53,77,130
https://kawalpemilu.org#23353,"SEMULI RAYA, ABUNG SEMULI, LAMPUNG UTARA, LAMPUNG",1,0,0,0
https://kawalpemilu.org#23353,"SEMULI RAYA, ABUNG SEMULI, LAMPUNG UTARA, LAMPUNG",3,0,0,0
https://kawalpemilu.org#23353,"SEMULI RAYA, ABUNG SEMULI, LAMPUNG UTARA, LAMPUNG",11,0,0,0
https://kawalpemilu.org#23353,"SEMULI RAYA, ABUNG SEMULI, LAMPUNG UTARA, LAMPUNG",12,0,0,0
https://kawalpemilu.org#23353,"SEMULI RAYA, ABUNG SEMULI, LAMPUNG UTARA, LAMPUNG",13,0,0,0
https://kawalpemilu.org#23353,"SEMULI RAYA, ABUNG SEMULI, LAMPUNG UTARA, LAMPUNG",14,0,0,0
https://kawalpemilu.org#23353,"SEMULI RAYA, ABUNG SEMULI, LAMPUNG UTARA, LAMPUNG",15,0,0,0
https://kawalpemilu.org#23353,"SEMULI RAYA, ABUNG SEMULI, LAMPUNG UTARA, LAMPUNG",16,0,0,0
https://kawalpemilu.org#23353,"SEMULI RAYA, ABUNG SEMULI, LAMPUNG UTARA, LAMPUNG",17,0,0,0
https://kawalpemilu.org#23353,"SEMULI RAYA, ABUNG SEMULI, LAMPUNG UTARA, LAMPUNG",18,0,0,0
https://kawalpemilu.org#23353,"SEMULI RAYA, ABUNG SEMULI, LAMPUNG UTARA, LAMPUNG",19,0,0,0
https://kawalpemilu.org#23353,"SEMULI RAYA, ABUNG SEMULI, LAMPUNG UTARA, LAMPUNG",34,95,29,124
https://kawalpemilu.org#23353,"SEMULI RAYA, ABUNG SEMULI, LAMPUNG UTARA, LAMPUNG",35,105,40,145
https://kawalpemilu.org#23353,"SEMULI RAYA, ABUNG SEMULI, LAMPUNG UTARA, LAMPUNG",36,76,43,119
https://kawalpemilu.org#23353,"SEMULI RAYA, ABUNG SEMULI, LAMPUNG UTARA, LAMPUNG",37,48,84,132
https://kawalpemilu.org#23353,"SEMULI RAYA, ABUNG SEMULI, LAMPUNG UTARA, LAMPUNG",38,89,87,176
https://kawalpemilu.org#23353,"SEMULI RAYA, ABUNG SEMULI, LAMPUNG UTARA, LAMPUNG",39,123,58,181
https://kawalpemilu.org#23353,"SEMULI RAYA, ABUNG SEMULI, LAMPUNG UTARA, LAMPUNG",40,139,73,212
https://kawalpemilu.org#23353,"SEMULI RAYA, ABUNG SEMULI, LAMPUNG UTARA, LAMPUNG",41,120,57,177
https://kawalpemilu.org#23353,"SEMULI RAYA, ABUNG SEMULI, LAMPUNG UTARA, LAMPUNG",42,163,32,195
https://kawalpemilu.org#23353,"SEMULI RAYA, ABUNG SEMULI, LAMPUNG UTARA, LAMPUNG",43,147,52,199
https://kawalpemilu.org#23353,"SEMULI RAYA, ABUNG SEMULI, LAMPUNG UTARA, LAMPUNG",44,185,51,236
https://kawalpemilu.org#23353,"SEMULI RAYA, ABUNG SEMULI, LAMPUNG UTARA, LAMPUNG",45,141,57,198
https://kawalpemilu.org#23353,"SEMULI RAYA, ABUNG SEMULI, LAMPUNG UTARA, LAMPUNG",46,98,60,158
https://kawalpemilu.org#23353,"SEMULI RAYA, ABUNG SEMULI, LAMPUNG UTARA, LAMPUNG",47,127,41,168
https://kawalpemilu.org#23353,"SEMULI RAYA, ABUNG SEMULI, LAMPUNG UTARA, LAMPUNG",48,114,61,175
https://kawalpemilu.org#23353,"SEMULI RAYA, ABUNG SEMULI, LAMPUNG UTARA, LAMPUNG",49,155,21,176
https://kawalpemilu.org#23353,"SEMULI RAYA, ABUNG SEMULI, LAMPUNG UTARA, LAMPUNG",50,102,33,135
https://kawalpemilu.org#23353,"SEMULI RAYA, ABUNG SEMULI, LAMPUNG UTARA, LAMPUNG",51,83,46,129
https://kawalpemilu.org#23353,"SEMULI RAYA, ABUNG SEMULI, LAMPUNG UTARA, LAMPUNG",52,118,65,183
https://kawalpemilu.org#23353,"SEMULI RAYA, ABUNG SEMULI, LAMPUNG UTARA, LAMPUNG",53,92,76,168
https://kawalpemilu.org#23354,"SEMULI JAYA, ABUNG SEMULI, LAMPUNG UTARA, LAMPUNG",1,0,0,0
https://kawalpemilu.org#23354,"SEMULI JAYA, ABUNG SEMULI, LAMPUNG UTARA, LAMPUNG",2,0,0,0
https://kawalpemilu.org#23354,"SEMULI JAYA, ABUNG SEMULI, LAMPUNG UTARA, LAMPUNG",3,0,0,0
https://kawalpemilu.org#23354,"SEMULI JAYA, ABUNG SEMULI, LAMPUNG UTARA, LAMPUNG",4,0,0,0
https://kawalpemilu.org#23354,"SEMULI JAYA, ABUNG SEMULI, LAMPUNG UTARA, LAMPUNG",5,0,0,0
https://kawalpemilu.org#23354,"SEMULI JAYA, ABUNG SEMULI, LAMPUNG UTARA, LAMPUNG",6,0,0,0
https://kawalpemilu.org#23354,"SEMULI JAYA, ABUNG SEMULI, LAMPUNG UTARA, LAMPUNG",7,0,0,0
https://kawalpemilu.org#23354,"SEMULI JAYA, ABUNG SEMULI, LAMPUNG UTARA, LAMPUNG",8,0,0,0
https://kawalpemilu.org#23354,"SEMULI JAYA, ABUNG SEMULI, LAMPUNG UTARA, LAMPUNG",9,0,0,0
https://kawalpemilu.org#23354,"SEMULI JAYA, ABUNG SEMULI, LAMPUNG UTARA, LAMPUNG",10,0,0,0
https://kawalpemilu.org#23354,"SEMULI JAYA, ABUNG SEMULI, LAMPUNG UTARA, LAMPUNG",11,0,0,0
https://kawalpemilu.org#23354,"SEMULI JAYA, ABUNG SEMULI, LAMPUNG UTARA, LAMPUNG",12,0,0,0
https://kawalpemilu.org#23354,"SEMULI JAYA, ABUNG SEMULI, LAMPUNG UTARA, LAMPUNG",13,0,0,0
https://kawalpemilu.org#23354,"SEMULI JAYA, ABUNG SEMULI, LAMPUNG UTARA, LAMPUNG",14,0,0,0
https://kawalpemilu.org#23354,"SEMULI JAYA, ABUNG SEMULI, LAMPUNG UTARA, LAMPUNG",20,73,108,181
https://kawalpemilu.org#23354,"SEMULI JAYA, ABUNG SEMULI, LAMPUNG UTARA, LAMPUNG",21,43,90,133
https://kawalpemilu.org#23354,"SEMULI JAYA, ABUNG SEMULI, LAMPUNG UTARA, LAMPUNG",22,49,96,145
https://kawalpemilu.org#23354,"SEMULI JAYA, ABUNG SEMULI, LAMPUNG UTARA, LAMPUNG",23,69,64,133
https://kawalpemilu.org#23354,"SEMULI JAYA, ABUNG SEMULI, LAMPUNG UTARA, LAMPUNG",24,76,118,194
https://kawalpemilu.org#23354,"SEMULI JAYA, ABUNG SEMULI, LAMPUNG UTARA, LAMPUNG",25,77,118,195
https://kawalpemilu.org#23354,"SEMULI JAYA, ABUNG SEMULI, LAMPUNG UTARA, LAMPUNG",26,127,93,200
https://kawalpemilu.org#23354,"SEMULI JAYA, ABUNG SEMULI, LAMPUNG UTARA, LAMPUNG",27,138,44,182
https://kawalpemilu.org#23354,"SEMULI JAYA, ABUNG SEMULI, LAMPUNG UTARA, LAMPUNG",28,125,63,188
https://kawalpemilu.org#23354,"SEMULI JAYA, ABUNG SEMULI, LAMPUNG UTARA, LAMPUNG",29,93,51,144
https://kawalpemilu.org#23354,"SEMULI JAYA, ABUNG SEMULI, LAMPUNG UTARA, LAMPUNG",30,113,73,186
https://kawalpemilu.org#23354,"SEMULI JAYA, ABUNG SEMULI, LAMPUNG UTARA, LAMPUNG",31,107,55,162
https://kawalpemilu.org#23354,"SEMULI JAYA, ABUNG SEMULI, LAMPUNG UTARA, LAMPUNG",32,115,61,176
https://kawalpemilu.org#23354,"SEMULI JAYA, ABUNG SEMULI, LAMPUNG UTARA, LAMPUNG",33,136,46,182
https://kawalpemilu.org#23355,"PAPAN ASRI, ABUNG SEMULI, LAMPUNG UTARA, LAMPUNG",1,0,0,0
https://kawalpemilu.org#23355,"PAPAN ASRI, ABUNG SEMULI, LAMPUNG UTARA, LAMPUNG",2,0,0,0
https://kawalpemilu.org#23355,"PAPAN ASRI, ABUNG SEMULI, LAMPUNG UTARA, LAMPUNG",3,0,0,0
https://kawalpemilu.org#23355,"PAPAN ASRI, ABUNG SEMULI, LAMPUNG UTARA, LAMPUNG",4,0,0,0
https://kawalpemilu.org#23355,"PAPAN ASRI, ABUNG SEMULI, LAMPUNG UTARA, LAMPUNG",5,0,0,0
https://kawalpemilu.org#23355,"PAPAN ASRI, ABUNG SEMULI, LAMPUNG UTARA, LAMPUNG",6,0,0,0
https://kawalpemilu.org#23355,"PAPAN ASRI, ABUNG SEMULI, LAMPUNG UTARA, LAMPUNG",7,0,0,0
https://kawalpemilu.org#23355,"PAPAN ASRI, ABUNG SEMULI, LAMPUNG UTARA, LAMPUNG",8,0,0,0
https://kawalpemilu.org#23355,"PAPAN ASRI, ABUNG SEMULI, LAMPUNG UTARA, LAMPUNG",12,134,56,190
https://kawalpemilu.org#23355,"PAPAN ASRI, ABUNG SEMULI, LAMPUNG UTARA, LAMPUNG",13,112,38,150
https://kawalpemilu.org#23355,"PAPAN ASRI, ABUNG SEMULI, LAMPUNG UTARA, LAMPUNG",14,116,47,163
https://kawalpemilu.org#23355,"PAPAN ASRI, ABUNG SEMULI, LAMPUNG UTARA, LAMPUNG",15,127,46,173
https://kawalpemilu.org#23355,"PAPAN ASRI, ABUNG SEMULI, LAMPUNG UTARA, LAMPUNG",17,118,63,181
https://kawalpemilu.org#23355,"PAPAN ASRI, ABUNG SEMULI, LAMPUNG UTARA, LAMPUNG",18,125,49,174
https://kawalpemilu.org#23355,"PAPAN ASRI, ABUNG SEMULI, LAMPUNG UTARA, LAMPUNG",19,151,87,238
https://kawalpemilu.org#23356,"GUNUNG KERAMAT, ABUNG SEMULI, LAMPUNG UTARA, LAMPUNG",1,35,207,242
https://kawalpemilu.org#23356,"GUNUNG KERAMAT, ABUNG SEMULI, LAMPUNG UTARA, LAMPUNG",2,131,54,185
https://kawalpemilu.org#23356,"GUNUNG KERAMAT, ABUNG SEMULI, LAMPUNG UTARA, LAMPUNG",3,61,131,192
https://kawalpemilu.org#23356,"GUNUNG KERAMAT, ABUNG SEMULI, LAMPUNG UTARA, LAMPUNG",4,49,191,240
https://kawalpemilu.org#23357,"SIDO RAHAYU, ABUNG SEMULI, LAMPUNG UTARA, LAMPUNG",1,0,0,0
https://kawalpemilu.org#23357,"SIDO RAHAYU, ABUNG SEMULI, LAMPUNG UTARA, LAMPUNG",2,0,0,0
https://kawalpemilu.org#23357,"SIDO RAHAYU, ABUNG SEMULI, LAMPUNG UTARA, LAMPUNG",3,0,0,0
https://kawalpemilu.org#23357,"SIDO RAHAYU, ABUNG SEMULI, LAMPUNG UTARA, LAMPUNG",4,0,0,0
https://kawalpemilu.org#23357,"SIDO RAHAYU, ABUNG SEMULI, LAMPUNG UTARA, LAMPUNG",5,0,0,0
https://kawalpemilu.org#23357,"SIDO RAHAYU, ABUNG SEMULI, LAMPUNG UTARA, LAMPUNG",6,0,0,0
https://kawalpemilu.org#23357,"SIDO RAHAYU, ABUNG SEMULI, LAMPUNG UTARA, LAMPUNG",7,0,0,0
https://kawalpemilu.org#23357,"SIDO RAHAYU, ABUNG SEMULI, LAMPUNG UTARA, LAMPUNG",13,0,0,0
https://kawalpemilu.org#23357,"SIDO RAHAYU, ABUNG SEMULI, LAMPUNG UTARA, LAMPUNG",14,0,0,0
https://kawalpemilu.org#23357,"SIDO RAHAYU, ABUNG SEMULI, LAMPUNG UTARA, LAMPUNG",54,137,32,169
https://kawalpemilu.org#23357,"SIDO RAHAYU, ABUNG SEMULI, LAMPUNG UTARA, LAMPUNG",55,123,66,189
https://kawalpemilu.org#23357,"SIDO RAHAYU, ABUNG SEMULI, LAMPUNG UTARA, LAMPUNG",56,153,71,224
https://kawalpemilu.org#23357,"SIDO RAHAYU, ABUNG SEMULI, LAMPUNG UTARA, LAMPUNG",57,151,101,252
https://kawalpemilu.org#23357,"SIDO RAHAYU, ABUNG SEMULI, LAMPUNG UTARA, LAMPUNG",58,156,55,211
https://kawalpemilu.org#23357,"SIDO RAHAYU, ABUNG SEMULI, LAMPUNG UTARA, LAMPUNG",59,158,58,216
https://kawalpemilu.org#23357,"SIDO RAHAYU, ABUNG SEMULI, LAMPUNG UTARA, LAMPUNG",60,101,59,160
https://kawalpemilu.org#23357,"SIDO RAHAYU, ABUNG SEMULI, LAMPUNG UTARA, LAMPUNG",61,106,80,186
https://kawalpemilu.org#23357,"SIDO RAHAYU, ABUNG SEMULI, LAMPUNG UTARA, LAMPUNG",62,77,94,171
https://kawalpemilu.org#23357,"SIDO RAHAYU, ABUNG SEMULI, LAMPUNG UTARA, LAMPUNG",63,111,51,162
https://kawalpemilu.org#23357,"SIDO RAHAYU, ABUNG SEMULI, LAMPUNG UTARA, LAMPUNG",64,145,46,191
https://kawalpemilu.org#23357,"SIDO RAHAYU, ABUNG SEMULI, LAMPUNG UTARA, LAMPUNG",65,133,67,200
https://kawalpemilu.org#23357,"SIDO RAHAYU, ABUNG SEMULI, LAMPUNG UTARA, LAMPUNG",66,147,77,224
https://kawalpemilu.org#23357,"SIDO RAHAYU, ABUNG SEMULI, LAMPUNG UTARA, LAMPUNG",67,162,62,224
https://kawalpemilu.org#23358,"GUNUNG SARI, ABUNG SEMULI, LAMPUNG UTARA, LAMPUNG",1,0,0,0
https://kawalpemilu.org#23358,"GUNUNG SARI, ABUNG SEMULI, LAMPUNG UTARA, LAMPUNG",2,0,0,0
https://kawalpemilu.org#23358,"GUNUNG SARI, ABUNG SEMULI, LAMPUNG UTARA, LAMPUNG",3,0,0,0
https://kawalpemilu.org#23358,"GUNUNG SARI, ABUNG SEMULI, LAMPUNG UTARA, LAMPUNG",5,27,224,251
https://kawalpemilu.org#23358,"GUNUNG SARI, ABUNG SEMULI, LAMPUNG UTARA, LAMPUNG",6,112,110,122
https://kawalpemilu.org#23358,"GUNUNG SARI, ABUNG SEMULI, LAMPUNG UTARA, LAMPUNG",7,82,162,244
https://kawalpemilu.org#23358,"GUNUNG SARI, ABUNG SEMULI, LAMPUNG UTARA, LAMPUNG",8,29,169,198
https://kawalpemilu.org#23358,"GUNUNG SARI, ABUNG SEMULI, LAMPUNG UTARA, LAMPUNG",9,147,44,191
https://kawalpemilu.org#23358,"GUNUNG SARI, ABUNG SEMULI, LAMPUNG UTARA, LAMPUNG",10,21,238,259
https://kawalpemilu.org#23358,"GUNUNG SARI, ABUNG SEMULI, LAMPUNG UTARA, LAMPUNG",11,30,174,204
https://kawalpemilu.org#23360,"TATAKARYA, ABUNG SURAKARTA, LAMPUNG UTARA, LAMPUNG",11,0,0,0
https://kawalpemilu.org#23360,"TATAKARYA, ABUNG SURAKARTA, LAMPUNG UTARA, LAMPUNG",13,0,0,0
https://kawalpemilu.org#23360,"TATAKARYA, ABUNG SURAKARTA, LAMPUNG UTARA, LAMPUNG",14,0,0,0
https://kawalpemilu.org#23360,"TATAKARYA, ABUNG SURAKARTA, LAMPUNG UTARA, LAMPUNG",19,0,0,0
https://kawalpemilu.org#23360,"TATAKARYA, ABUNG SURAKARTA, LAMPUNG UTARA, LAMPUNG",20,0,0,0
https://kawalpemilu.org#23360,"TATAKARYA, ABUNG SURAKARTA, LAMPUNG UTARA, LAMPUNG",82,133,61,194
https://kawalpemilu.org#23360,"TATAKARYA, ABUNG SURAKARTA, LAMPUNG UTARA, LAMPUNG",83,155,50,205
https://kawalpemilu.org#23360,"TATAKARYA, ABUNG SURAKARTA, LAMPUNG UTARA, LAMPUNG",84,116,55,171
https://kawalpemilu.org#23360,"TATAKARYA, ABUNG SURAKARTA, LAMPUNG UTARA, LAMPUNG",85,86,61,147
https://kawalpemilu.org#23360,"TATAKARYA, ABUNG SURAKARTA, LAMPUNG UTARA, LAMPUNG",87,93,76,0
https://kawalpemilu.org#23360,"TATAKARYA, ABUNG SURAKARTA, LAMPUNG UTARA, LAMPUNG",88,72,102,174
https://kawalpemilu.org#23360,"TATAKARYA, ABUNG SURAKARTA, LAMPUNG UTARA, LAMPUNG",89,56,113,169
https://kawalpemilu.org#23360,"TATAKARYA, ABUNG SURAKARTA, LAMPUNG UTARA, LAMPUNG",90,44,104,148
https://kawalpemilu.org#23360,"TATAKARYA, ABUNG SURAKARTA, LAMPUNG UTARA, LAMPUNG",91,63,121,184
https://kawalpemilu.org#23360,"TATAKARYA, ABUNG SURAKARTA, LAMPUNG UTARA, LAMPUNG",92,62,100,162
https://kawalpemilu.org#23360,"TATAKARYA, ABUNG SURAKARTA, LAMPUNG UTARA, LAMPUNG",93,147,57,204
https://kawalpemilu.org#23360,"TATAKARYA, ABUNG SURAKARTA, LAMPUNG UTARA, LAMPUNG",94,127,53,180
https://kawalpemilu.org#23360,"TATAKARYA, ABUNG SURAKARTA, LAMPUNG UTARA, LAMPUNG",95,93,100,193
https://kawalpemilu.org#23360,"TATAKARYA, ABUNG SURAKARTA, LAMPUNG UTARA, LAMPUNG",96,103,57,160
https://kawalpemilu.org#23360,"TATAKARYA, ABUNG SURAKARTA, LAMPUNG UTARA, LAMPUNG",97,134,52,186
https://kawalpemilu.org#23360,"TATAKARYA, ABUNG SURAKARTA, LAMPUNG UTARA, LAMPUNG",98,111,52,163
https://kawalpemilu.org#23360,"TATAKARYA, ABUNG SURAKARTA, LAMPUNG UTARA, LAMPUNG",99,120,47,167
https://kawalpemilu.org#23360,"TATAKARYA, ABUNG SURAKARTA, LAMPUNG UTARA, LAMPUNG",100,118,76,194
https://kawalpemilu.org#23360,"TATAKARYA, ABUNG SURAKARTA, LAMPUNG UTARA, LAMPUNG",101,80,83,163
https://kawalpemilu.org#23360,"TATAKARYA, ABUNG SURAKARTA, LAMPUNG UTARA, LAMPUNG",102,92,72,164
https://kawalpemilu.org#23360,"TATAKARYA, ABUNG SURAKARTA, LAMPUNG UTARA, LAMPUNG",103,68,84,152
https://kawalpemilu.org#23361,"BANDAR ABUNG, ABUNG SURAKARTA, LAMPUNG UTARA, LAMPUNG",1,46,148,194
https://kawalpemilu.org#23361,"BANDAR ABUNG, ABUNG SURAKARTA, LAMPUNG UTARA, LAMPUNG",2,24,121,145
https://kawalpemilu.org#23361,"BANDAR ABUNG, ABUNG SURAKARTA, LAMPUNG UTARA, LAMPUNG",3,104,60,164
https://kawalpemilu.org#23361,"BANDAR ABUNG, ABUNG SURAKARTA, LAMPUNG UTARA, LAMPUNG",4,63,129,192
https://kawalpemilu.org#23361,"BANDAR ABUNG, ABUNG SURAKARTA, LAMPUNG UTARA, LAMPUNG",5,57,96,157
https://kawalpemilu.org#23362,"BANGUN SARI, ABUNG SURAKARTA, LAMPUNG UTARA, LAMPUNG",6,0,0,0
https://kawalpemilu.org#23362,"BANGUN SARI, ABUNG SURAKARTA, LAMPUNG UTARA, LAMPUNG",7,104,76,180
https://kawalpemilu.org#23362,"BANGUN SARI, ABUNG SURAKARTA, LAMPUNG UTARA, LAMPUNG",19,33,104,137
https://kawalpemilu.org#23362,"BANGUN SARI, ABUNG SURAKARTA, LAMPUNG UTARA, LAMPUNG",20,35,97,132
https://kawalpemilu.org#23362,"BANGUN SARI, ABUNG SURAKARTA, LAMPUNG UTARA, LAMPUNG",22,80,71,151
https://kawalpemilu.org#23362,"BANGUN SARI, ABUNG SURAKARTA, LAMPUNG UTARA, LAMPUNG",23,90,80,170
https://kawalpemilu.org#23362,"BANGUN SARI, ABUNG SURAKARTA, LAMPUNG UTARA, LAMPUNG",24,122,84,206
https://kawalpemilu.org#23363,"PURBA SAKTI, ABUNG SURAKARTA, LAMPUNG UTARA, LAMPUNG",2,0,0,0
https://kawalpemilu.org#23363,"PURBA SAKTI, ABUNG SURAKARTA, LAMPUNG UTARA, LAMPUNG",3,0,0,0
https://kawalpemilu.org#23363,"PURBA SAKTI, ABUNG SURAKARTA, LAMPUNG UTARA, LAMPUNG",5,0,0,0
https://kawalpemilu.org#23363,"PURBA SAKTI, ABUNG SURAKARTA, LAMPUNG UTARA, LAMPUNG",6,0,0,0
https://kawalpemilu.org#23363,"PURBA SAKTI, ABUNG SURAKARTA, LAMPUNG UTARA, LAMPUNG",8,0,0,0
https://kawalpemilu.org#23363,"PURBA SAKTI, ABUNG SURAKARTA, LAMPUNG UTARA, LAMPUNG",9,0,0,0
https://kawalpemilu.org#23363,"PURBA SAKTI, ABUNG SURAKARTA, LAMPUNG UTARA, LAMPUNG",10,0,0,0
https://kawalpemilu.org#23363,"PURBA SAKTI, ABUNG SURAKARTA, LAMPUNG UTARA, LAMPUNG",64,139,44,183
https://kawalpemilu.org#23363,"PURBA SAKTI, ABUNG SURAKARTA, LAMPUNG UTARA, LAMPUNG",65,114,21,135
https://kawalpemilu.org#23363,"PURBA SAKTI, ABUNG SURAKARTA, LAMPUNG UTARA, LAMPUNG",67,85,32,117
https://kawalpemilu.org#23363,"PURBA SAKTI, ABUNG SURAKARTA, LAMPUNG UTARA, LAMPUNG",69,113,28,141
https://kawalpemilu.org#23363,"PURBA SAKTI, ABUNG SURAKARTA, LAMPUNG UTARA, LAMPUNG",70,84,74,158
https://kawalpemilu.org#23363,"PURBA SAKTI, ABUNG SURAKARTA, LAMPUNG UTARA, LAMPUNG",72,121,50,171
https://kawalpemilu.org#23363,"PURBA SAKTI, ABUNG SURAKARTA, LAMPUNG UTARA, LAMPUNG",73,173,61,234
https://kawalpemilu.org#23364,"BUMI RAHARJA, ABUNG SURAKARTA, LAMPUNG UTARA, LAMPUNG",27,187,21,208
https://kawalpemilu.org#23364,"BUMI RAHARJA, ABUNG SURAKARTA, LAMPUNG UTARA, LAMPUNG",28,102,35,137
https://kawalpemilu.org#23364,"BUMI RAHARJA, ABUNG SURAKARTA, LAMPUNG UTARA, LAMPUNG",29,140,27,167
https://kawalpemilu.org#23364,"BUMI RAHARJA, ABUNG SURAKARTA, LAMPUNG UTARA, LAMPUNG",30,114,6,120
https://kawalpemilu.org#23364,"BUMI RAHARJA, ABUNG SURAKARTA, LAMPUNG UTARA, LAMPUNG",31,152,32,184
https://kawalpemilu.org#23364,"BUMI RAHARJA, ABUNG SURAKARTA, LAMPUNG UTARA, LAMPUNG",32,138,24,162
https://kawalpemilu.org#23364,"BUMI RAHARJA, ABUNG SURAKARTA, LAMPUNG UTARA, LAMPUNG",33,174,54,228
https://kawalpemilu.org#23364,"BUMI RAHARJA, ABUNG SURAKARTA, LAMPUNG UTARA, LAMPUNG",34,122,65,187
https://kawalpemilu.org#23364,"BUMI RAHARJA, ABUNG SURAKARTA, LAMPUNG UTARA, LAMPUNG",35,132,33,165
https://kawalpemilu.org#23365,"BUMI RESTU, ABUNG SURAKARTA, LAMPUNG UTARA, LAMPUNG",3,0,0,0
https://kawalpemilu.org#23365,"BUMI RESTU, ABUNG SURAKARTA, LAMPUNG UTARA, LAMPUNG",4,0,0,0
https://kawalpemilu.org#23365,"BUMI RESTU, ABUNG SURAKARTA, LAMPUNG UTARA, LAMPUNG",5,0,0,0
https://kawalpemilu.org#23365,"BUMI RESTU, ABUNG SURAKARTA, LAMPUNG UTARA, LAMPUNG",6,0,0,0
https://kawalpemilu.org#23365,"BUMI RESTU, ABUNG SURAKARTA, LAMPUNG UTARA, LAMPUNG",7,0,0,0
https://kawalpemilu.org#23365,"BUMI RESTU, ABUNG SURAKARTA, LAMPUNG UTARA, LAMPUNG",8,0,0,0
https://kawalpemilu.org#23365,"BUMI RESTU, ABUNG SURAKARTA, LAMPUNG UTARA, LAMPUNG",9,0,0,0
https://kawalpemilu.org#23365,"BUMI RESTU, ABUNG SURAKARTA, LAMPUNG UTARA, LAMPUNG",10,0,0,0
https://kawalpemilu.org#23365,"BUMI RESTU, ABUNG SURAKARTA, LAMPUNG UTARA, LAMPUNG",11,0,0,0
https://kawalpemilu.org#23365,"BUMI RESTU, ABUNG SURAKARTA, LAMPUNG UTARA, LAMPUNG",12,0,0,0
https://kawalpemilu.org#23365,"BUMI RESTU, ABUNG SURAKARTA, LAMPUNG UTARA, LAMPUNG",36,122,42,164
https://kawalpemilu.org#23365,"BUMI RESTU, ABUNG SURAKARTA, LAMPUNG UTARA, LAMPUNG",37,136,42,178
https://kawalpemilu.org#23365,"BUMI RESTU, ABUNG SURAKARTA, LAMPUNG UTARA, LAMPUNG",38,110,30,140
https://kawalpemilu.org#23365,"BUMI RESTU, ABUNG SURAKARTA, LAMPUNG UTARA, LAMPUNG",39,105,20,125
https://kawalpemilu.org#23365,"BUMI RESTU, ABUNG SURAKARTA, LAMPUNG UTARA, LAMPUNG",40,156,22,178
https://kawalpemilu.org#23365,"BUMI RESTU, ABUNG SURAKARTA, LAMPUNG UTARA, LAMPUNG",41,138,13,151
https://kawalpemilu.org#23365,"BUMI RESTU, ABUNG SURAKARTA, LAMPUNG UTARA, LAMPUNG",42,117,33,150
https://kawalpemilu.org#23365,"BUMI RESTU, ABUNG SURAKARTA, LAMPUNG UTARA, LAMPUNG",43,109,30,139
https://kawalpemilu.org#23365,"BUMI RESTU, ABUNG SURAKARTA, LAMPUNG UTARA, LAMPUNG",44,131,40,171
https://kawalpemilu.org#23365,"BUMI RESTU, ABUNG SURAKARTA, LAMPUNG UTARA, LAMPUNG",45,132,45,177
https://kawalpemilu.org#23365,"BUMI RESTU, ABUNG SURAKARTA, LAMPUNG UTARA, LAMPUNG",46,131,25,156
https://kawalpemilu.org#23365,"BUMI RESTU, ABUNG SURAKARTA, LAMPUNG UTARA, LAMPUNG",47,140,24,164
https://kawalpemilu.org#23366,"BANDAR SAKTI, ABUNG SURAKARTA, LAMPUNG UTARA, LAMPUNG",6,92,146,238
https://kawalpemilu.org#23366,"BANDAR SAKTI, ABUNG SURAKARTA, LAMPUNG UTARA, LAMPUNG",7,73,103,176
https://kawalpemilu.org#23366,"BANDAR SAKTI, ABUNG SURAKARTA, LAMPUNG UTARA, LAMPUNG",8,130,95,225
https://kawalpemilu.org#23366,"BANDAR SAKTI, ABUNG SURAKARTA, LAMPUNG UTARA, LAMPUNG",9,112,115,227
https://kawalpemilu.org#23366,"BANDAR SAKTI, ABUNG SURAKARTA, LAMPUNG UTARA, LAMPUNG",10,98,119,217
https://kawalpemilu.org#23366,"BANDAR SAKTI, ABUNG SURAKARTA, LAMPUNG UTARA, LAMPUNG",11,133,122,255
https://kawalpemilu.org#23366,"BANDAR SAKTI, ABUNG SURAKARTA, LAMPUNG UTARA, LAMPUNG",12,59,84,143
https://kawalpemilu.org#23366,"BANDAR SAKTI, ABUNG SURAKARTA, LAMPUNG UTARA, LAMPUNG",13,44,99,143
https://kawalpemilu.org#23366,"BANDAR SAKTI, ABUNG SURAKARTA, LAMPUNG UTARA, LAMPUNG",14,144,58,202
https://kawalpemilu.org#23366,"BANDAR SAKTI, ABUNG SURAKARTA, LAMPUNG UTARA, LAMPUNG",15,151,41,192
https://kawalpemilu.org#23366,"BANDAR SAKTI, ABUNG SURAKARTA, LAMPUNG UTARA, LAMPUNG",16,113,48,161
https://kawalpemilu.org#23366,"BANDAR SAKTI, ABUNG SURAKARTA, LAMPUNG UTARA, LAMPUNG",17,97,12,109
https://kawalpemilu.org#23366,"BANDAR SAKTI, ABUNG SURAKARTA, LAMPUNG UTARA, LAMPUNG",18,183,41,224
https://kawalpemilu.org#23367,"KARYA SAKTI, ABUNG SURAKARTA, LAMPUNG UTARA, LAMPUNG",1,0,0,0
https://kawalpemilu.org#23367,"KARYA SAKTI, ABUNG SURAKARTA, LAMPUNG UTARA, LAMPUNG",2,0,0,0
https://kawalpemilu.org#23367,"KARYA SAKTI, ABUNG SURAKARTA, LAMPUNG UTARA, LAMPUNG",3,0,0,0
https://kawalpemilu.org#23367,"KARYA SAKTI, ABUNG SURAKARTA, LAMPUNG UTARA, LAMPUNG",4,0,0,0
https://kawalpemilu.org#23367,"KARYA SAKTI, ABUNG SURAKARTA, LAMPUNG UTARA, LAMPUNG",5,0,0,0
https://kawalpemilu.org#23367,"KARYA SAKTI, ABUNG SURAKARTA, LAMPUNG UTARA, LAMPUNG",6,0,0,0
https://kawalpemilu.org#23367,"KARYA SAKTI, ABUNG SURAKARTA, LAMPUNG UTARA, LAMPUNG",8,0,0,0
https://kawalpemilu.org#23367,"KARYA SAKTI, ABUNG SURAKARTA, LAMPUNG UTARA, LAMPUNG",10,0,0,0
https://kawalpemilu.org#23367,"KARYA SAKTI, ABUNG SURAKARTA, LAMPUNG UTARA, LAMPUNG",13,0,0,0
https://kawalpemilu.org#23367,"KARYA SAKTI, ABUNG SURAKARTA, LAMPUNG UTARA, LAMPUNG",14,0,0,0
https://kawalpemilu.org#23367,"KARYA SAKTI, ABUNG SURAKARTA, LAMPUNG UTARA, LAMPUNG",15,0,0,0
https://kawalpemilu.org#23367,"KARYA SAKTI, ABUNG SURAKARTA, LAMPUNG UTARA, LAMPUNG",16,0,0,0
https://kawalpemilu.org#23367,"KARYA SAKTI, ABUNG SURAKARTA, LAMPUNG UTARA, LAMPUNG",48,126,23,149
https://kawalpemilu.org#23367,"KARYA SAKTI, ABUNG SURAKARTA, LAMPUNG UTARA, LAMPUNG",49,144,24,168
https://kawalpemilu.org#23367,"KARYA SAKTI, ABUNG SURAKARTA, LAMPUNG UTARA, LAMPUNG",50,146,17,163
https://kawalpemilu.org#23367,"KARYA SAKTI, ABUNG SURAKARTA, LAMPUNG UTARA, LAMPUNG",51,138,25,163
https://kawalpemilu.org#23367,"KARYA SAKTI, ABUNG SURAKARTA, LAMPUNG UTARA, LAMPUNG",52,120,79,199
https://kawalpemilu.org#23367,"KARYA SAKTI, ABUNG SURAKARTA, LAMPUNG UTARA, LAMPUNG",53,134,39,173
https://kawalpemilu.org#23367,"KARYA SAKTI, ABUNG SURAKARTA, LAMPUNG UTARA, LAMPUNG",54,103,46,149
https://kawalpemilu.org#23367,"KARYA SAKTI, ABUNG SURAKARTA, LAMPUNG UTARA, LAMPUNG",55,91,60,151
https://kawalpemilu.org#23367,"KARYA SAKTI, ABUNG SURAKARTA, LAMPUNG UTARA, LAMPUNG",56,89,19,108
https://kawalpemilu.org#23367,"KARYA SAKTI, ABUNG SURAKARTA, LAMPUNG UTARA, LAMPUNG",57,99,16,115
https://kawalpemilu.org#23367,"KARYA SAKTI, ABUNG SURAKARTA, LAMPUNG UTARA, LAMPUNG",58,102,31,133
https://kawalpemilu.org#23367,"KARYA SAKTI, ABUNG SURAKARTA, LAMPUNG UTARA, LAMPUNG",59,111,45,156
https://kawalpemilu.org#23367,"KARYA SAKTI, ABUNG SURAKARTA, LAMPUNG UTARA, LAMPUNG",60,142,49,191
https://kawalpemilu.org#23367,"KARYA SAKTI, ABUNG SURAKARTA, LAMPUNG UTARA, LAMPUNG",61,134,38,172
https://kawalpemilu.org#23367,"KARYA SAKTI, ABUNG SURAKARTA, LAMPUNG UTARA, LAMPUNG",62,100,30,130
https://kawalpemilu.org#23367,"KARYA SAKTI, ABUNG SURAKARTA, LAMPUNG UTARA, LAMPUNG",63,118,59,177
https://kawalpemilu.org#23368,"SUKO HARJO, ABUNG SURAKARTA, LAMPUNG UTARA, LAMPUNG",1,119,12,131
https://kawalpemilu.org#23368,"SUKO HARJO, ABUNG SURAKARTA, LAMPUNG UTARA, LAMPUNG",2,113,32,145
https://kawalpemilu.org#23368,"SUKO HARJO, ABUNG SURAKARTA, LAMPUNG UTARA, LAMPUNG",3,130,28,158
https://kawalpemilu.org#23368,"SUKO HARJO, ABUNG SURAKARTA, LAMPUNG UTARA, LAMPUNG",4,148,18,166
https://kawalpemilu.org#23368,"SUKO HARJO, ABUNG SURAKARTA, LAMPUNG UTARA, LAMPUNG",5,160,35,195
https://kawalpemilu.org#23368,"SUKO HARJO, ABUNG SURAKARTA, LAMPUNG UTARA, LAMPUNG",6,167,30,197
https://kawalpemilu.org#23370,"NEGERI UJUNG KARANG, MUARA SUNGKAI, LAMPUNG UTARA, LAMPUNG",1,0,0,0
https://kawalpemilu.org#23370,"NEGERI UJUNG KARANG, MUARA SUNGKAI, LAMPUNG UTARA, LAMPUNG",2,0,0,0
https://kawalpemilu.org#23370,"NEGERI UJUNG KARANG, MUARA SUNGKAI, LAMPUNG UTARA, LAMPUNG",3,0,0,0
https://kawalpemilu.org#23370,"NEGERI UJUNG KARANG, MUARA SUNGKAI, LAMPUNG UTARA, LAMPUNG",4,0,0,0
https://kawalpemilu.org#23370,"NEGERI UJUNG KARANG, MUARA SUNGKAI, LAMPUNG UTARA, LAMPUNG",6,0,0,0
https://kawalpemilu.org#23370,"NEGERI UJUNG KARANG, MUARA SUNGKAI, LAMPUNG UTARA, LAMPUNG",7,0,0,0
https://kawalpemilu.org#23370,"NEGERI UJUNG KARANG, MUARA SUNGKAI, LAMPUNG UTARA, LAMPUNG",35,9,112,121
https://kawalpemilu.org#23370,"NEGERI UJUNG KARANG, MUARA SUNGKAI, LAMPUNG UTARA, LAMPUNG",36,20,85,105
https://kawalpemilu.org#23370,"NEGERI UJUNG KARANG, MUARA SUNGKAI, LAMPUNG UTARA, LAMPUNG",37,72,66,138
https://kawalpemilu.org#23370,"NEGERI UJUNG KARANG, MUARA SUNGKAI, LAMPUNG UTARA, LAMPUNG",38,93,49,142
https://kawalpemilu.org#23370,"NEGERI UJUNG KARANG, MUARA SUNGKAI, LAMPUNG UTARA, LAMPUNG",39,107,44,151
https://kawalpemilu.org#23370,"NEGERI UJUNG KARANG, MUARA SUNGKAI, LAMPUNG UTARA, LAMPUNG",40,111,35,146
https://kawalpemilu.org#23370,"NEGERI UJUNG KARANG, MUARA SUNGKAI, LAMPUNG UTARA, LAMPUNG",41,154,79,233
https://kawalpemilu.org#23371,"BANDAR AGUNG, MUARA SUNGKAI, LAMPUNG UTARA, LAMPUNG",1,96,117,213
https://kawalpemilu.org#23371,"BANDAR AGUNG, MUARA SUNGKAI, LAMPUNG UTARA, LAMPUNG",2,76,28,104
https://kawalpemilu.org#23371,"BANDAR AGUNG, MUARA SUNGKAI, LAMPUNG UTARA, LAMPUNG",3,162,74,236
https://kawalpemilu.org#23371,"BANDAR AGUNG, MUARA SUNGKAI, LAMPUNG UTARA, LAMPUNG",4,196,31,227
https://kawalpemilu.org#23371,"BANDAR AGUNG, MUARA SUNGKAI, LAMPUNG UTARA, LAMPUNG",5,168,38,206
https://kawalpemilu.org#23371,"BANDAR AGUNG, MUARA SUNGKAI, LAMPUNG UTARA, LAMPUNG",6,141,26,167
https://kawalpemilu.org#23372,"KARANG SARI, MUARA SUNGKAI, LAMPUNG UTARA, LAMPUNG",1,127,79,206
https://kawalpemilu.org#23372,"KARANG SARI, MUARA SUNGKAI, LAMPUNG UTARA, LAMPUNG",2,132,77,209
https://kawalpemilu.org#23372,"KARANG SARI, MUARA SUNGKAI, LAMPUNG UTARA, LAMPUNG",3,102,101,203
https://kawalpemilu.org#23372,"KARANG SARI, MUARA SUNGKAI, LAMPUNG UTARA, LAMPUNG",4,117,54,171
https://kawalpemilu.org#23372,"KARANG SARI, MUARA SUNGKAI, LAMPUNG UTARA, LAMPUNG",5,171,25,196
https://kawalpemilu.org#23372,"KARANG SARI, MUARA SUNGKAI, LAMPUNG UTARA, LAMPUNG",6,193,19,212
https://kawalpemilu.org#23373,"KARANG REJO II, MUARA SUNGKAI, LAMPUNG UTARA, LAMPUNG",1,0,0,0
https://kawalpemilu.org#23373,"KARANG REJO II, MUARA SUNGKAI, LAMPUNG UTARA, LAMPUNG",2,0,0,0
https://kawalpemilu.org#23373,"KARANG REJO II, MUARA SUNGKAI, LAMPUNG UTARA, LAMPUNG",3,0,0,0
https://kawalpemilu.org#23373,"KARANG REJO II, MUARA SUNGKAI, LAMPUNG UTARA, LAMPUNG",4,0,0,0
https://kawalpemilu.org#23373,"KARANG REJO II, MUARA SUNGKAI, LAMPUNG UTARA, LAMPUNG",16,88,26,114
https://kawalpemilu.org#23373,"KARANG REJO II, MUARA SUNGKAI, LAMPUNG UTARA, LAMPUNG",17,88,26,114
https://kawalpemilu.org#23373,"KARANG REJO II, MUARA SUNGKAI, LAMPUNG UTARA, LAMPUNG",18,120,39,159
https://kawalpemilu.org#23373,"KARANG REJO II, MUARA SUNGKAI, LAMPUNG UTARA, LAMPUNG",19,97,73,170
https://kawalpemilu.org#23374,"KARANG SAKTI, MUARA SUNGKAI, LAMPUNG UTARA, LAMPUNG",1,117,55,172
https://kawalpemilu.org#23374,"KARANG SAKTI, MUARA SUNGKAI, LAMPUNG UTARA, LAMPUNG",2,115,65,180
https://kawalpemilu.org#23374,"KARANG SAKTI, MUARA SUNGKAI, LAMPUNG UTARA, LAMPUNG",3,77,75,152
https://kawalpemilu.org#23374,"KARANG SAKTI, MUARA SUNGKAI, LAMPUNG UTARA, LAMPUNG",4,48,124,172
https://kawalpemilu.org#23375,"KARANG MULYA, MUARA SUNGKAI, LAMPUNG UTARA, LAMPUNG",3,42,63,105
https://kawalpemilu.org#23375,"KARANG MULYA, MUARA SUNGKAI, LAMPUNG UTARA, LAMPUNG",4,93,115,208
https://kawalpemilu.org#23375,"KARANG MULYA, MUARA SUNGKAI, LAMPUNG UTARA, LAMPUNG",12,61,132,193
https://kawalpemilu.org#23375,"KARANG MULYA, MUARA SUNGKAI, LAMPUNG UTARA, LAMPUNG",14,42,63,105
https://kawalpemilu.org#23375,"KARANG MULYA, MUARA SUNGKAI, LAMPUNG UTARA, LAMPUNG",15,93,115,208
https://kawalpemilu.org#23376,"BANJAR NEGERI, MUARA SUNGKAI, LAMPUNG UTARA, LAMPUNG",1,20,94,114
https://kawalpemilu.org#23376,"BANJAR NEGERI, MUARA SUNGKAI, LAMPUNG UTARA, LAMPUNG",2,25,84,109
https://kawalpemilu.org#23376,"BANJAR NEGERI, MUARA SUNGKAI, LAMPUNG UTARA, LAMPUNG",4,49,59,108
https://kawalpemilu.org#23376,"BANJAR NEGERI, MUARA SUNGKAI, LAMPUNG UTARA, LAMPUNG",9,38,97,135
https://kawalpemilu.org#23377,"BANJAR RATU, MUARA SUNGKAI, LAMPUNG UTARA, LAMPUNG",1,0,0,0
https://kawalpemilu.org#23377,"BANJAR RATU, MUARA SUNGKAI, LAMPUNG UTARA, LAMPUNG",11,81,86,167
https://kawalpemilu.org#23378,"NEGERI RATU, MUARA SUNGKAI, LAMPUNG UTARA, LAMPUNG",1,69,116,185
https://kawalpemilu.org#23378,"NEGERI RATU, MUARA SUNGKAI, LAMPUNG UTARA, LAMPUNG",3,121,84,205
https://kawalpemilu.org#23378,"NEGERI RATU, MUARA SUNGKAI, LAMPUNG UTARA, LAMPUNG",4,97,92,189
https://kawalpemilu.org#23378,"NEGERI RATU, MUARA SUNGKAI, LAMPUNG UTARA, LAMPUNG",5,57,133,190
https://kawalpemilu.org#23378,"NEGERI RATU, MUARA SUNGKAI, LAMPUNG UTARA, LAMPUNG",30,69,116,185
https://kawalpemilu.org#23378,"NEGERI RATU, MUARA SUNGKAI, LAMPUNG UTARA, LAMPUNG",31,95,114,209
https://kawalpemilu.org#23378,"NEGERI RATU, MUARA SUNGKAI, LAMPUNG UTARA, LAMPUNG",32,121,84,205
https://kawalpemilu.org#23378,"NEGERI RATU, MUARA SUNGKAI, LAMPUNG UTARA, LAMPUNG",33,97,92,189
https://kawalpemilu.org#23378,"NEGERI RATU, MUARA SUNGKAI, LAMPUNG UTARA, LAMPUNG",34,57,133,190
https://kawalpemilu.org#23379,"PAKUAN AGUNG, MUARA SUNGKAI, LAMPUNG UTARA, LAMPUNG",1,39,82,121
https://kawalpemilu.org#23379,"PAKUAN AGUNG, MUARA SUNGKAI, LAMPUNG UTARA, LAMPUNG",2,46,131,177
https://kawalpemilu.org#23379,"PAKUAN AGUNG, MUARA SUNGKAI, LAMPUNG UTARA, LAMPUNG",3,0,0,0
https://kawalpemilu.org#23379,"PAKUAN AGUNG, MUARA SUNGKAI, LAMPUNG UTARA, LAMPUNG",4,21,26,47
https://kawalpemilu.org#23379,"PAKUAN AGUNG, MUARA SUNGKAI, LAMPUNG UTARA, LAMPUNG",5,36,92,128
https://kawalpemilu.org#23379,"PAKUAN AGUNG, MUARA SUNGKAI, LAMPUNG UTARA, LAMPUNG",6,58,119,177
https://kawalpemilu.org#23379,"PAKUAN AGUNG, MUARA SUNGKAI, LAMPUNG UTARA, LAMPUNG",7,125,6,131
https://kawalpemilu.org#23380,"SUMBER AGUNG, MUARA SUNGKAI, LAMPUNG UTARA, LAMPUNG",1,0,0,0
https://kawalpemilu.org#23380,"SUMBER AGUNG, MUARA SUNGKAI, LAMPUNG UTARA, LAMPUNG",2,0,0,0
https://kawalpemilu.org#23380,"SUMBER AGUNG, MUARA SUNGKAI, LAMPUNG UTARA, LAMPUNG",3,0,0,0
https://kawalpemilu.org#23380,"SUMBER AGUNG, MUARA SUNGKAI, LAMPUNG UTARA, LAMPUNG",4,0,0,0
https://kawalpemilu.org#23380,"SUMBER AGUNG, MUARA SUNGKAI, LAMPUNG UTARA, LAMPUNG",49,146,48,194
https://kawalpemilu.org#23380,"SUMBER AGUNG, MUARA SUNGKAI, LAMPUNG UTARA, LAMPUNG",50,115,62,177
https://kawalpemilu.org#23380,"SUMBER AGUNG, MUARA SUNGKAI, LAMPUNG UTARA, LAMPUNG",51,132,50,182
https://kawalpemilu.org#23380,"SUMBER AGUNG, MUARA SUNGKAI, LAMPUNG UTARA, LAMPUNG",52,120,70,190
https://kawalpemilu.org#23382,"NEGARA TULANG BAWANG, BUNGA MAYANG, LAMPUNG UTARA, LAMPUNG",23,73,180,253
https://kawalpemilu.org#23382,"NEGARA TULANG BAWANG, BUNGA MAYANG, LAMPUNG UTARA, LAMPUNG",57,39,150,189
https://kawalpemilu.org#23382,"NEGARA TULANG BAWANG, BUNGA MAYANG, LAMPUNG UTARA, LAMPUNG",58,68,119,187
https://kawalpemilu.org#23382,"NEGARA TULANG BAWANG, BUNGA MAYANG, LAMPUNG UTARA, LAMPUNG",59,85,157,242
https://kawalpemilu.org#23382,"NEGARA TULANG BAWANG, BUNGA MAYANG, LAMPUNG UTARA, LAMPUNG",60,58,97,155
https://kawalpemilu.org#23382,"NEGARA TULANG BAWANG, BUNGA MAYANG, LAMPUNG UTARA, LAMPUNG",61,151,49,200
https://kawalpemilu.org#23382,"NEGARA TULANG BAWANG, BUNGA MAYANG, LAMPUNG UTARA, LAMPUNG",62,125,79,204
https://kawalpemilu.org#23382,"NEGARA TULANG BAWANG, BUNGA MAYANG, LAMPUNG UTARA, LAMPUNG",63,62,27,89
https://kawalpemilu.org#23382,"NEGARA TULANG BAWANG, BUNGA MAYANG, LAMPUNG UTARA, LAMPUNG",64,134,54,188
https://kawalpemilu.org#23382,"NEGARA TULANG BAWANG, BUNGA MAYANG, LAMPUNG UTARA, LAMPUNG",65,172,60,232
https://kawalpemilu.org#23382,"NEGARA TULANG BAWANG, BUNGA MAYANG, LAMPUNG UTARA, LAMPUNG",66,141,188,229
https://kawalpemilu.org#23382,"NEGARA TULANG BAWANG, BUNGA MAYANG, LAMPUNG UTARA, LAMPUNG",67,109,57,166
https://kawalpemilu.org#23382,"NEGARA TULANG BAWANG, BUNGA MAYANG, LAMPUNG UTARA, LAMPUNG",68,51,68,119
https://kawalpemilu.org#23382,"NEGARA TULANG BAWANG, BUNGA MAYANG, LAMPUNG UTARA, LAMPUNG",69,94,102,196
https://kawalpemilu.org#23382,"NEGARA TULANG BAWANG, BUNGA MAYANG, LAMPUNG UTARA, LAMPUNG",70,81,60,141
https://kawalpemilu.org#23382,"NEGARA TULANG BAWANG, BUNGA MAYANG, LAMPUNG UTARA, LAMPUNG",71,111,59,170
https://kawalpemilu.org#23382,"NEGARA TULANG BAWANG, BUNGA MAYANG, LAMPUNG UTARA, LAMPUNG",73,88,66,154
https://kawalpemilu.org#23382,"NEGARA TULANG BAWANG, BUNGA MAYANG, LAMPUNG UTARA, LAMPUNG",74,23,53,76
https://kawalpemilu.org#23382,"NEGARA TULANG BAWANG, BUNGA MAYANG, LAMPUNG UTARA, LAMPUNG",75,49,65,114
https://kawalpemilu.org#23382,"NEGARA TULANG BAWANG, BUNGA MAYANG, LAMPUNG UTARA, LAMPUNG",76,111,57,168
https://kawalpemilu.org#23382,"NEGARA TULANG BAWANG, BUNGA MAYANG, LAMPUNG UTARA, LAMPUNG",77,49,88,137
https://kawalpemilu.org#23382,"NEGARA TULANG BAWANG, BUNGA MAYANG, LAMPUNG UTARA, LAMPUNG",79,73,180,253
https://kawalpemilu.org#23383,"KOTA NAPAL, BUNGA MAYANG, LAMPUNG UTARA, LAMPUNG",3,93,18,111
https://kawalpemilu.org#23383,"KOTA NAPAL, BUNGA MAYANG, LAMPUNG UTARA, LAMPUNG",13,0,0,0
https://kawalpemilu.org#23383,"KOTA NAPAL, BUNGA MAYANG, LAMPUNG UTARA, LAMPUNG",18,40,145,185
https://kawalpemilu.org#23383,"KOTA NAPAL, BUNGA MAYANG, LAMPUNG UTARA, LAMPUNG",19,93,18,111
https://kawalpemilu.org#23383,"KOTA NAPAL, BUNGA MAYANG, LAMPUNG UTARA, LAMPUNG",20,100,42,142
https://kawalpemilu.org#23383,"KOTA NAPAL, BUNGA MAYANG, LAMPUNG UTARA, LAMPUNG",21,133,89,222
https://kawalpemilu.org#23383,"KOTA NAPAL, BUNGA MAYANG, LAMPUNG UTARA, LAMPUNG",22,105,108,213
https://kawalpemilu.org#23383,"KOTA NAPAL, BUNGA MAYANG, LAMPUNG UTARA, LAMPUNG",23,80,33,113
https://kawalpemilu.org#23383,"KOTA NAPAL, BUNGA MAYANG, LAMPUNG UTARA, LAMPUNG",24,87,48,135
https://kawalpemilu.org#23383,"KOTA NAPAL, BUNGA MAYANG, LAMPUNG UTARA, LAMPUNG",25,98,41,139
https://kawalpemilu.org#23383,"KOTA NAPAL, BUNGA MAYANG, LAMPUNG UTARA, LAMPUNG",26,83,27,110
https://kawalpemilu.org#23383,"KOTA NAPAL, BUNGA MAYANG, LAMPUNG UTARA, LAMPUNG",27,120,26,146
https://kawalpemilu.org#23383,"KOTA NAPAL, BUNGA MAYANG, LAMPUNG UTARA, LAMPUNG",28,85,73,158
https://kawalpemilu.org#23383,"KOTA NAPAL, BUNGA MAYANG, LAMPUNG UTARA, LAMPUNG",29,148,3,151
https://kawalpemilu.org#23383,"KOTA NAPAL, BUNGA MAYANG, LAMPUNG UTARA, LAMPUNG",30,133,6,139
https://kawalpemilu.org#23384,"TANAH ABANG, BUNGA MAYANG, LAMPUNG UTARA, LAMPUNG",6,172,80,252
https://kawalpemilu.org#23384,"TANAH ABANG, BUNGA MAYANG, LAMPUNG UTARA, LAMPUNG",100,105,106,211
https://kawalpemilu.org#23384,"TANAH ABANG, BUNGA MAYANG, LAMPUNG UTARA, LAMPUNG",101,163,38,201
https://kawalpemilu.org#23384,"TANAH ABANG, BUNGA MAYANG, LAMPUNG UTARA, LAMPUNG",102,109,115,224
https://kawalpemilu.org#23384,"TANAH ABANG, BUNGA MAYANG, LAMPUNG UTARA, LAMPUNG",103,153,76,229
https://kawalpemilu.org#23384,"TANAH ABANG, BUNGA MAYANG, LAMPUNG UTARA, LAMPUNG",104,118,53,171
https://kawalpemilu.org#23384,"TANAH ABANG, BUNGA MAYANG, LAMPUNG UTARA, LAMPUNG",105,172,80,252
https://kawalpemilu.org#23385,"SUKADANA UDIK, BUNGA MAYANG, LAMPUNG UTARA, LAMPUNG",2,79,38,117
https://kawalpemilu.org#23385,"SUKADANA UDIK, BUNGA MAYANG, LAMPUNG UTARA, LAMPUNG",3,115,47,162
https://kawalpemilu.org#23385,"SUKADANA UDIK, BUNGA MAYANG, LAMPUNG UTARA, LAMPUNG",4,129,37,166
https://kawalpemilu.org#23385,"SUKADANA UDIK, BUNGA MAYANG, LAMPUNG UTARA, LAMPUNG",5,146,27,173
https://kawalpemilu.org#23385,"SUKADANA UDIK, BUNGA MAYANG, LAMPUNG UTARA, LAMPUNG",6,123,53,176
https://kawalpemilu.org#23385,"SUKADANA UDIK, BUNGA MAYANG, LAMPUNG UTARA, LAMPUNG",8,48,97,145
https://kawalpemilu.org#23385,"SUKADANA UDIK, BUNGA MAYANG, LAMPUNG UTARA, LAMPUNG",9,34,101,135
https://kawalpemilu.org#23385,"SUKADANA UDIK, BUNGA MAYANG, LAMPUNG UTARA, LAMPUNG",10,44,87,131
https://kawalpemilu.org#23385,"SUKADANA UDIK, BUNGA MAYANG, LAMPUNG UTARA, LAMPUNG",85,36,82,118
https://kawalpemilu.org#23385,"SUKADANA UDIK, BUNGA MAYANG, LAMPUNG UTARA, LAMPUNG",86,79,38,117
https://kawalpemilu.org#23385,"SUKADANA UDIK, BUNGA MAYANG, LAMPUNG UTARA, LAMPUNG",87,115,47,162
https://kawalpemilu.org#23385,"SUKADANA UDIK, BUNGA MAYANG, LAMPUNG UTARA, LAMPUNG",88,129,37,166
https://kawalpemilu.org#23385,"SUKADANA UDIK, BUNGA MAYANG, LAMPUNG UTARA, LAMPUNG",89,146,27,173
https://kawalpemilu.org#23385,"SUKADANA UDIK, BUNGA MAYANG, LAMPUNG UTARA, LAMPUNG",90,123,53,176
https://kawalpemilu.org#23385,"SUKADANA UDIK, BUNGA MAYANG, LAMPUNG UTARA, LAMPUNG",91,78,103,181
https://kawalpemilu.org#23385,"SUKADANA UDIK, BUNGA MAYANG, LAMPUNG UTARA, LAMPUNG",92,48,97,145
https://kawalpemilu.org#23385,"SUKADANA UDIK, BUNGA MAYANG, LAMPUNG UTARA, LAMPUNG",93,34,101,135
https://kawalpemilu.org#23385,"SUKADANA UDIK, BUNGA MAYANG, LAMPUNG UTARA, LAMPUNG",94,44,87,131
https://kawalpemilu.org#23386,"SUKADANA ILIR, BUNGA MAYANG, LAMPUNG UTARA, LAMPUNG",80,20,92,112
https://kawalpemilu.org#23386,"SUKADANA ILIR, BUNGA MAYANG, LAMPUNG UTARA, LAMPUNG",81,109,59,168
https://kawalpemilu.org#23386,"SUKADANA ILIR, BUNGA MAYANG, LAMPUNG UTARA, LAMPUNG",82,165,53,218
https://kawalpemilu.org#23386,"SUKADANA ILIR, BUNGA MAYANG, LAMPUNG UTARA, LAMPUNG",83,181,54,235
https://kawalpemilu.org#23386,"SUKADANA ILIR, BUNGA MAYANG, LAMPUNG UTARA, LAMPUNG",84,199,46,245
https://kawalpemilu.org#23387,"HADUYANG RATU, BUNGA MAYANG, LAMPUNG UTARA, LAMPUNG",31,81,81,162
https://kawalpemilu.org#23387,"HADUYANG RATU, BUNGA MAYANG, LAMPUNG UTARA, LAMPUNG",32,96,41,137
https://kawalpemilu.org#23387,"HADUYANG RATU, BUNGA MAYANG, LAMPUNG UTARA, LAMPUNG",33,146,22,168
https://kawalpemilu.org#23387,"HADUYANG RATU, BUNGA MAYANG, LAMPUNG UTARA, LAMPUNG",34,126,34,160
https://kawalpemilu.org#23387,"HADUYANG RATU, BUNGA MAYANG, LAMPUNG UTARA, LAMPUNG",35,104,31,135
https://kawalpemilu.org#23387,"HADUYANG RATU, BUNGA MAYANG, LAMPUNG UTARA, LAMPUNG",36,104,32,136
https://kawalpemilu.org#23388,"ISO REJO, BUNGA MAYANG, LAMPUNG UTARA, LAMPUNG",1,123,25,148
https://kawalpemilu.org#23388,"ISO REJO, BUNGA MAYANG, LAMPUNG UTARA, LAMPUNG",2,144,30,174
https://kawalpemilu.org#23388,"ISO REJO, BUNGA MAYANG, LAMPUNG UTARA, LAMPUNG",3,147,45,192
https://kawalpemilu.org#23388,"ISO REJO, BUNGA MAYANG, LAMPUNG UTARA, LAMPUNG",4,143,51,194
https://kawalpemilu.org#23388,"ISO REJO, BUNGA MAYANG, LAMPUNG UTARA, LAMPUNG",5,113,44,157
https://kawalpemilu.org#23388,"ISO REJO, BUNGA MAYANG, LAMPUNG UTARA, LAMPUNG",6,97,47,144
https://kawalpemilu.org#23388,"ISO REJO, BUNGA MAYANG, LAMPUNG UTARA, LAMPUNG",7,85,42,127
https://kawalpemilu.org#23388,"ISO REJO, BUNGA MAYANG, LAMPUNG UTARA, LAMPUNG",8,55,45,100
https://kawalpemilu.org#23388,"ISO REJO, BUNGA MAYANG, LAMPUNG UTARA, LAMPUNG",9,115,19,134
https://kawalpemilu.org#23388,"ISO REJO, BUNGA MAYANG, LAMPUNG UTARA, LAMPUNG",10,110,14,124
https://kawalpemilu.org#23388,"ISO REJO, BUNGA MAYANG, LAMPUNG UTARA, LAMPUNG",11,120,35,155
https://kawalpemilu.org#23388,"ISO REJO, BUNGA MAYANG, LAMPUNG UTARA, LAMPUNG",12,118,28,146
https://kawalpemilu.org#23388,"ISO REJO, BUNGA MAYANG, LAMPUNG UTARA, LAMPUNG",13,177,39,216
https://kawalpemilu.org#23388,"ISO REJO, BUNGA MAYANG, LAMPUNG UTARA, LAMPUNG",14,125,72,197
https://kawalpemilu.org#23388,"ISO REJO, BUNGA MAYANG, LAMPUNG UTARA, LAMPUNG",15,96,47,145
https://kawalpemilu.org#23388,"ISO REJO, BUNGA MAYANG, LAMPUNG UTARA, LAMPUNG",16,105,87,192
https://kawalpemilu.org#23389,"MULYO REJO II, BUNGA MAYANG, LAMPUNG UTARA, LAMPUNG",1,0,0,0
https://kawalpemilu.org#23389,"MULYO REJO II, BUNGA MAYANG, LAMPUNG UTARA, LAMPUNG",2,0,0,0
https://kawalpemilu.org#23389,"MULYO REJO II, BUNGA MAYANG, LAMPUNG UTARA, LAMPUNG",3,0,0,0
https://kawalpemilu.org#23389,"MULYO REJO II, BUNGA MAYANG, LAMPUNG UTARA, LAMPUNG",4,0,0,0
https://kawalpemilu.org#23389,"MULYO REJO II, BUNGA MAYANG, LAMPUNG UTARA, LAMPUNG",5,0,0,0
https://kawalpemilu.org#23389,"MULYO REJO II, BUNGA MAYANG, LAMPUNG UTARA, LAMPUNG",6,0,0,0
https://kawalpemilu.org#23389,"MULYO REJO II, BUNGA MAYANG, LAMPUNG UTARA, LAMPUNG",8,0,0,0
https://kawalpemilu.org#23389,"MULYO REJO II, BUNGA MAYANG, LAMPUNG UTARA, LAMPUNG",47,127,46,173
https://kawalpemilu.org#23389,"MULYO REJO II, BUNGA MAYANG, LAMPUNG UTARA, LAMPUNG",48,123,55,178
https://kawalpemilu.org#23389,"MULYO REJO II, BUNGA MAYANG, LAMPUNG UTARA, LAMPUNG",49,111,72,183
https://kawalpemilu.org#23389,"MULYO REJO II, BUNGA MAYANG, LAMPUNG UTARA, LAMPUNG",50,155,28,183
https://kawalpemilu.org#23389,"MULYO REJO II, BUNGA MAYANG, LAMPUNG UTARA, LAMPUNG",51,118,40,158
https://kawalpemilu.org#23389,"MULYO REJO II, BUNGA MAYANG, LAMPUNG UTARA, LAMPUNG",52,111,40,151
https://kawalpemilu.org#23389,"MULYO REJO II, BUNGA MAYANG, LAMPUNG UTARA, LAMPUNG",53,124,46,170
https://kawalpemilu.org#23389,"MULYO REJO II, BUNGA MAYANG, LAMPUNG UTARA, LAMPUNG",54,130,24,154
https://kawalpemilu.org#23389,"MULYO REJO II, BUNGA MAYANG, LAMPUNG UTARA, LAMPUNG",55,123,28,151
https://kawalpemilu.org#23389,"MULYO REJO II, BUNGA MAYANG, LAMPUNG UTARA, LAMPUNG",56,106,39,145
https://kawalpemilu.org#23390,"TULANG BAWANG BARU, BUNGA MAYANG, LAMPUNG UTARA, LAMPUNG",106,113,46,159
https://kawalpemilu.org#23390,"TULANG BAWANG BARU, BUNGA MAYANG, LAMPUNG UTARA, LAMPUNG",107,132,35,167
https://kawalpemilu.org#23390,"TULANG BAWANG BARU, BUNGA MAYANG, LAMPUNG UTARA, LAMPUNG",108,100,31,131
https://kawalpemilu.org#23390,"TULANG BAWANG BARU, BUNGA MAYANG, LAMPUNG UTARA, LAMPUNG",109,122,53,175
https://kawalpemilu.org#23390,"TULANG BAWANG BARU, BUNGA MAYANG, LAMPUNG UTARA, LAMPUNG",110,135,48,183
https://kawalpemilu.org#23390,"TULANG BAWANG BARU, BUNGA MAYANG, LAMPUNG UTARA, LAMPUNG",111,135,39,174
https://kawalpemilu.org#23390,"TULANG BAWANG BARU, BUNGA MAYANG, LAMPUNG UTARA, LAMPUNG",112,115,45,160
https://kawalpemilu.org#23390,"TULANG BAWANG BARU, BUNGA MAYANG, LAMPUNG UTARA, LAMPUNG",113,128,68,196
https://kawalpemilu.org#23390,"TULANG BAWANG BARU, BUNGA MAYANG, LAMPUNG UTARA, LAMPUNG",114,87,27,114
https://kawalpemilu.org#23390,"TULANG BAWANG BARU, BUNGA MAYANG, LAMPUNG UTARA, LAMPUNG",115,154,18,172
https://kawalpemilu.org#23390,"TULANG BAWANG BARU, BUNGA MAYANG, LAMPUNG UTARA, LAMPUNG",116,106,29,135
https://kawalpemilu.org#23391,"MULYO REJO I, BUNGA MAYANG, LAMPUNG UTARA, LAMPUNG",37,109,47,156
https://kawalpemilu.org#23391,"MULYO REJO I, BUNGA MAYANG, LAMPUNG UTARA, LAMPUNG",38,109,54,163
https://kawalpemilu.org#23391,"MULYO REJO I, BUNGA MAYANG, LAMPUNG UTARA, LAMPUNG",39,96,27,123
https://kawalpemilu.org#23391,"MULYO REJO I, BUNGA MAYANG, LAMPUNG UTARA, LAMPUNG",40,83,15,98
https://kawalpemilu.org#23391,"MULYO REJO I, BUNGA MAYANG, LAMPUNG UTARA, LAMPUNG",41,136,33,169
https://kawalpemilu.org#23391,"MULYO REJO I, BUNGA MAYANG, LAMPUNG UTARA, LAMPUNG",42,142,38,180
https://kawalpemilu.org#23391,"MULYO REJO I, BUNGA MAYANG, LAMPUNG UTARA, LAMPUNG",43,90,75,165
https://kawalpemilu.org#23391,"MULYO REJO I, BUNGA MAYANG, LAMPUNG UTARA, LAMPUNG",44,88,55,143
https://kawalpemilu.org#23391,"MULYO REJO I, BUNGA MAYANG, LAMPUNG UTARA, LAMPUNG",45,110,61,171
https://kawalpemilu.org#23391,"MULYO REJO I, BUNGA MAYANG, LAMPUNG UTARA, LAMPUNG",46,94,77,171
https://kawalpemilu.org#23392,"SUKAMAJU, BUNGA MAYANG, LAMPUNG UTARA, LAMPUNG",1,0,0,0
https://kawalpemilu.org#23392,"SUKAMAJU, BUNGA MAYANG, LAMPUNG UTARA, LAMPUNG",2,0,0,0
https://kawalpemilu.org#23392,"SUKAMAJU, BUNGA MAYANG, LAMPUNG UTARA, LAMPUNG",3,0,0,0
https://kawalpemilu.org#23392,"SUKAMAJU, BUNGA MAYANG, LAMPUNG UTARA, LAMPUNG",4,167,64,231
https://kawalpemilu.org#23392,"SUKAMAJU, BUNGA MAYANG, LAMPUNG UTARA, LAMPUNG",5,0,0,0
https://kawalpemilu.org#23392,"SUKAMAJU, BUNGA MAYANG, LAMPUNG UTARA, LAMPUNG",95,134,48,182
https://kawalpemilu.org#23392,"SUKAMAJU, BUNGA MAYANG, LAMPUNG UTARA, LAMPUNG",96,147,58,205
https://kawalpemilu.org#23392,"SUKAMAJU, BUNGA MAYANG, LAMPUNG UTARA, LAMPUNG",97,173,56,229
https://kawalpemilu.org#23392,"SUKAMAJU, BUNGA MAYANG, LAMPUNG UTARA, LAMPUNG",98,167,64,231
https://kawalpemilu.org#23392,"SUKAMAJU, BUNGA MAYANG, LAMPUNG UTARA, LAMPUNG",99,109,102,211
https://kawalpemilu.org#23394,"NEGARA KEMAKMURAN, HULU SUNGKAI, LAMPUNG UTARA, LAMPUNG",45,22,92,114
https://kawalpemilu.org#23394,"NEGARA KEMAKMURAN, HULU SUNGKAI, LAMPUNG UTARA, LAMPUNG",46,16,84,100
https://kawalpemilu.org#23394,"NEGARA KEMAKMURAN, HULU SUNGKAI, LAMPUNG UTARA, LAMPUNG",47,50,134,184
https://kawalpemilu.org#23394,"NEGARA KEMAKMURAN, HULU SUNGKAI, LAMPUNG UTARA, LAMPUNG",48,51,99,150
https://kawalpemilu.org#23396,"BONGLAI TENGAH, HULU SUNGKAI, LAMPUNG UTARA, LAMPUNG",2,24,104,128
https://kawalpemilu.org#23396,"BONGLAI TENGAH, HULU SUNGKAI, LAMPUNG UTARA, LAMPUNG",37,22,153,175
https://kawalpemilu.org#23396,"BONGLAI TENGAH, HULU SUNGKAI, LAMPUNG UTARA, LAMPUNG",38,24,104,128
https://kawalpemilu.org#23397,"TANJUNG HARAPAN, HULU SUNGKAI, LAMPUNG UTARA, LAMPUNG",49,27,105,132
https://kawalpemilu.org#23397,"TANJUNG HARAPAN, HULU SUNGKAI, LAMPUNG UTARA, LAMPUNG",50,33,122,155
https://kawalpemilu.org#23397,"TANJUNG HARAPAN, HULU SUNGKAI, LAMPUNG UTARA, LAMPUNG",51,58,91,149
https://kawalpemilu.org#23398,"LUBUK RUKAM, HULU SUNGKAI, LAMPUNG UTARA, LAMPUNG",1,6,134,140
https://kawalpemilu.org#23398,"LUBUK RUKAM, HULU SUNGKAI, LAMPUNG UTARA, LAMPUNG",2,0,0,0
https://kawalpemilu.org#23398,"LUBUK RUKAM, HULU SUNGKAI, LAMPUNG UTARA, LAMPUNG",3,0,0,0
https://kawalpemilu.org#23398,"LUBUK RUKAM, HULU SUNGKAI, LAMPUNG UTARA, LAMPUNG",4,0,0,0
https://kawalpemilu.org#23398,"LUBUK RUKAM, HULU SUNGKAI, LAMPUNG UTARA, LAMPUNG",5,0,0,0
https://kawalpemilu.org#23398,"LUBUK RUKAM, HULU SUNGKAI, LAMPUNG UTARA, LAMPUNG",6,0,0,0
https://kawalpemilu.org#23398,"LUBUK RUKAM, HULU SUNGKAI, LAMPUNG UTARA, LAMPUNG",39,6,134,140
https://kawalpemilu.org#23398,"LUBUK RUKAM, HULU SUNGKAI, LAMPUNG UTARA, LAMPUNG",40,11,125,136
https://kawalpemilu.org#23398,"LUBUK RUKAM, HULU SUNGKAI, LAMPUNG UTARA, LAMPUNG",41,9,136,145
https://kawalpemilu.org#23398,"LUBUK RUKAM, HULU SUNGKAI, LAMPUNG UTARA, LAMPUNG",42,16,112,128
https://kawalpemilu.org#23398,"LUBUK RUKAM, HULU SUNGKAI, LAMPUNG UTARA, LAMPUNG",44,38,144,152
https://kawalpemilu.org#23399,"IBUL JAYA, HULU SUNGKAI, LAMPUNG UTARA, LAMPUNG",3,0,0,0
https://kawalpemilu.org#23399,"IBUL JAYA, HULU SUNGKAI, LAMPUNG UTARA, LAMPUNG",4,0,0,0
https://kawalpemilu.org#23399,"IBUL JAYA, HULU SUNGKAI, LAMPUNG UTARA, LAMPUNG",29,22,193,215
https://kawalpemilu.org#23399,"IBUL JAYA, HULU SUNGKAI, LAMPUNG UTARA, LAMPUNG",30,141,114,255
https://kawalpemilu.org#23399,"IBUL JAYA, HULU SUNGKAI, LAMPUNG UTARA, LAMPUNG",31,106,94,200
https://kawalpemilu.org#23399,"IBUL JAYA, HULU SUNGKAI, LAMPUNG UTARA, LAMPUNG",32,106,78,184
https://kawalpemilu.org#23399,"IBUL JAYA, HULU SUNGKAI, LAMPUNG UTARA, LAMPUNG",33,85,62,147
https://kawalpemilu.org#23399,"IBUL JAYA, HULU SUNGKAI, LAMPUNG UTARA, LAMPUNG",34,30,129,159
https://kawalpemilu.org#23400,"BERINGIN JAYA, HULU SUNGKAI, LAMPUNG UTARA, LAMPUNG",35,8,124,132
https://kawalpemilu.org#23401,"GEDUNG RAJA, HULU SUNGKAI, LAMPUNG UTARA, LAMPUNG",1,0,0,0
https://kawalpemilu.org#23401,"GEDUNG RAJA, HULU SUNGKAI, LAMPUNG UTARA, LAMPUNG",2,0,0,0
https://kawalpemilu.org#23401,"GEDUNG RAJA, HULU SUNGKAI, LAMPUNG UTARA, LAMPUNG",3,64,166,230
https://kawalpemilu.org#23401,"GEDUNG RAJA, HULU SUNGKAI, LAMPUNG UTARA, LAMPUNG",4,0,0,0
https://kawalpemilu.org#23401,"GEDUNG RAJA, HULU SUNGKAI, LAMPUNG UTARA, LAMPUNG",5,37,165,202
https://kawalpemilu.org#23401,"GEDUNG RAJA, HULU SUNGKAI, LAMPUNG UTARA, LAMPUNG",6,0,0,0
https://kawalpemilu.org#23401,"GEDUNG RAJA, HULU SUNGKAI, LAMPUNG UTARA, LAMPUNG",7,0,0,0
https://kawalpemilu.org#23401,"GEDUNG RAJA, HULU SUNGKAI, LAMPUNG UTARA, LAMPUNG",8,130,54,184
https://kawalpemilu.org#23401,"GEDUNG RAJA, HULU SUNGKAI, LAMPUNG UTARA, LAMPUNG",15,96,60,156
https://kawalpemilu.org#23401,"GEDUNG RAJA, HULU SUNGKAI, LAMPUNG UTARA, LAMPUNG",16,114,92,206
https://kawalpemilu.org#23401,"GEDUNG RAJA, HULU SUNGKAI, LAMPUNG UTARA, LAMPUNG",17,64,166,230
https://kawalpemilu.org#23401,"GEDUNG RAJA, HULU SUNGKAI, LAMPUNG UTARA, LAMPUNG",18,62,134,196
https://kawalpemilu.org#23401,"GEDUNG RAJA, HULU SUNGKAI, LAMPUNG UTARA, LAMPUNG",19,37,165,202
https://kawalpemilu.org#23401,"GEDUNG RAJA, HULU SUNGKAI, LAMPUNG UTARA, LAMPUNG",22,130,54,184
https://kawalpemilu.org#23402,"GEDUNG NEGARA, HULU SUNGKAI, LAMPUNG UTARA, LAMPUNG",2,0,0,0
https://kawalpemilu.org#23402,"GEDUNG NEGARA, HULU SUNGKAI, LAMPUNG UTARA, LAMPUNG",4,0,0,0
https://kawalpemilu.org#23402,"GEDUNG NEGARA, HULU SUNGKAI, LAMPUNG UTARA, LAMPUNG",7,51,128,179
https://kawalpemilu.org#23402,"GEDUNG NEGARA, HULU SUNGKAI, LAMPUNG UTARA, LAMPUNG",8,65,120,185
https://kawalpemilu.org#23402,"GEDUNG NEGARA, HULU SUNGKAI, LAMPUNG UTARA, LAMPUNG",9,40,151,191
https://kawalpemilu.org#23402,"GEDUNG NEGARA, HULU SUNGKAI, LAMPUNG UTARA, LAMPUNG",10,25,186,211
https://kawalpemilu.org#23402,"GEDUNG NEGARA, HULU SUNGKAI, LAMPUNG UTARA, LAMPUNG",11,14,78,92
https://kawalpemilu.org#23402,"GEDUNG NEGARA, HULU SUNGKAI, LAMPUNG UTARA, LAMPUNG",12,66,195,261
https://kawalpemilu.org#23402,"GEDUNG NEGARA, HULU SUNGKAI, LAMPUNG UTARA, LAMPUNG",13,54,194,248
https://kawalpemilu.org#23402,"GEDUNG NEGARA, HULU SUNGKAI, LAMPUNG UTARA, LAMPUNG",14,60,137,197
https://kawalpemilu.org#23403,"TULUNG BUYUT, HULU SUNGKAI, LAMPUNG UTARA, LAMPUNG",1,57,131,188
https://kawalpemilu.org#23403,"TULUNG BUYUT, HULU SUNGKAI, LAMPUNG UTARA, LAMPUNG",2,0,0,0
https://kawalpemilu.org#23403,"TULUNG BUYUT, HULU SUNGKAI, LAMPUNG UTARA, LAMPUNG",3,0,0,0
https://kawalpemilu.org#23403,"TULUNG BUYUT, HULU SUNGKAI, LAMPUNG UTARA, LAMPUNG",4,39,79,118
https://kawalpemilu.org#23403,"TULUNG BUYUT, HULU SUNGKAI, LAMPUNG UTARA, LAMPUNG",5,0,0,0
https://kawalpemilu.org#23403,"TULUNG BUYUT, HULU SUNGKAI, LAMPUNG UTARA, LAMPUNG",6,0,0,0
https://kawalpemilu.org#23403,"TULUNG BUYUT, HULU SUNGKAI, LAMPUNG UTARA, LAMPUNG",23,57,131,188
https://kawalpemilu.org#23403,"TULUNG BUYUT, HULU SUNGKAI, LAMPUNG UTARA, LAMPUNG",24,24,112,136
https://kawalpemilu.org#23403,"TULUNG BUYUT, HULU SUNGKAI, LAMPUNG UTARA, LAMPUNG",25,64,135,199
https://kawalpemilu.org#23403,"TULUNG BUYUT, HULU SUNGKAI, LAMPUNG UTARA, LAMPUNG",26,39,79,118
https://kawalpemilu.org#23403,"TULUNG BUYUT, HULU SUNGKAI, LAMPUNG UTARA, LAMPUNG",27,54,54,108
https://kawalpemilu.org#23403,"TULUNG BUYUT, HULU SUNGKAI, LAMPUNG UTARA, LAMPUNG",28,73,66,139
https://kawalpemilu.org#84804,"GEDUNG MAKRIFAT, HULU SUNGKAI, LAMPUNG UTARA, LAMPUNG",1,67,81,148
https://kawalpemilu.org#84804,"GEDUNG MAKRIFAT, HULU SUNGKAI, LAMPUNG UTARA, LAMPUNG",2,19,109,128
https://kawalpemilu.org#84804,"GEDUNG MAKRIFAT, HULU SUNGKAI, LAMPUNG UTARA, LAMPUNG",3,30,119,149
https://kawalpemilu.org#84804,"GEDUNG MAKRIFAT, HULU SUNGKAI, LAMPUNG UTARA, LAMPUNG",4,39,76,115
https://kawalpemilu.org#84804,"GEDUNG MAKRIFAT, HULU SUNGKAI, LAMPUNG UTARA, LAMPUNG",5,12,131,143
https://kawalpemilu.org#84804,"GEDUNG MAKRIFAT, HULU SUNGKAI, LAMPUNG UTARA, LAMPUNG",6,52,98,150
https://kawalpemilu.org#23405,"BATU NANGKOP, SUNGKAI TENGAH, LAMPUNG UTARA, LAMPUNG",1,126,79,205
https://kawalpemilu.org#23405,"BATU NANGKOP, SUNGKAI TENGAH, LAMPUNG UTARA, LAMPUNG",2,72,46,118
https://kawalpemilu.org#23405,"BATU NANGKOP, SUNGKAI TENGAH, LAMPUNG UTARA, LAMPUNG",3,134,54,188
https://kawalpemilu.org#23405,"BATU NANGKOP, SUNGKAI TENGAH, LAMPUNG UTARA, LAMPUNG",4,77,93,170
https://kawalpemilu.org#23405,"BATU NANGKOP, SUNGKAI TENGAH, LAMPUNG UTARA, LAMPUNG",5,62,99,161
https://kawalpemilu.org#23405,"BATU NANGKOP, SUNGKAI TENGAH, LAMPUNG UTARA, LAMPUNG",6,51,106,157
https://kawalpemilu.org#23405,"BATU NANGKOP, SUNGKAI TENGAH, LAMPUNG UTARA, LAMPUNG",7,133,12,145
https://kawalpemilu.org#23405,"BATU NANGKOP, SUNGKAI TENGAH, LAMPUNG UTARA, LAMPUNG",8,98,33,131
https://kawalpemilu.org#23405,"BATU NANGKOP, SUNGKAI TENGAH, LAMPUNG UTARA, LAMPUNG",9,61,119,184
https://kawalpemilu.org#23405,"BATU NANGKOP, SUNGKAI TENGAH, LAMPUNG UTARA, LAMPUNG",10,54,110,164
https://kawalpemilu.org#23406,"NEGARA BUMI, SUNGKAI TENGAH, LAMPUNG UTARA, LAMPUNG",1,41,162,203
https://kawalpemilu.org#23406,"NEGARA BUMI, SUNGKAI TENGAH, LAMPUNG UTARA, LAMPUNG",2,74,112,186
https://kawalpemilu.org#23406,"NEGARA BUMI, SUNGKAI TENGAH, LAMPUNG UTARA, LAMPUNG",3,138,59,197
https://kawalpemilu.org#23406,"NEGARA BUMI, SUNGKAI TENGAH, LAMPUNG UTARA, LAMPUNG",4,91,101,192
https://kawalpemilu.org#23406,"NEGARA BUMI, SUNGKAI TENGAH, LAMPUNG UTARA, LAMPUNG",5,139,71,210
https://kawalpemilu.org#23406,"NEGARA BUMI, SUNGKAI TENGAH, LAMPUNG UTARA, LAMPUNG",6,166,34,200
https://kawalpemilu.org#23406,"NEGARA BUMI, SUNGKAI TENGAH, LAMPUNG UTARA, LAMPUNG",7,110,41,151
https://kawalpemilu.org#23406,"NEGARA BUMI, SUNGKAI TENGAH, LAMPUNG UTARA, LAMPUNG",8,147,92,239
https://kawalpemilu.org#23406,"NEGARA BUMI, SUNGKAI TENGAH, LAMPUNG UTARA, LAMPUNG",9,81,59,140
https://kawalpemilu.org#23406,"NEGARA BUMI, SUNGKAI TENGAH, LAMPUNG UTARA, LAMPUNG",24,41,162,203
https://kawalpemilu.org#23406,"NEGARA BUMI, SUNGKAI TENGAH, LAMPUNG UTARA, LAMPUNG",25,74,112,186
https://kawalpemilu.org#23406,"NEGARA BUMI, SUNGKAI TENGAH, LAMPUNG UTARA, LAMPUNG",26,138,59,197
https://kawalpemilu.org#23406,"NEGARA BUMI, SUNGKAI TENGAH, LAMPUNG UTARA, LAMPUNG",27,91,101,192
https://kawalpemilu.org#23406,"NEGARA BUMI, SUNGKAI TENGAH, LAMPUNG UTARA, LAMPUNG",28,139,71,210
https://kawalpemilu.org#23406,"NEGARA BUMI, SUNGKAI TENGAH, LAMPUNG UTARA, LAMPUNG",29,166,34,200
https://kawalpemilu.org#23406,"NEGARA BUMI, SUNGKAI TENGAH, LAMPUNG UTARA, LAMPUNG",30,110,41,151
https://kawalpemilu.org#23406,"NEGARA BUMI, SUNGKAI TENGAH, LAMPUNG UTARA, LAMPUNG",31,81,59,140
https://kawalpemilu.org#23406,"NEGARA BUMI, SUNGKAI TENGAH, LAMPUNG UTARA, LAMPUNG",32,147,92,239
https://kawalpemilu.org#23407,"MELUNGUN RATU, SUNGKAI TENGAH, LAMPUNG UTARA, LAMPUNG",1,120,59,179
https://kawalpemilu.org#23407,"MELUNGUN RATU, SUNGKAI TENGAH, LAMPUNG UTARA, LAMPUNG",2,74,100,174
https://kawalpemilu.org#23407,"MELUNGUN RATU, SUNGKAI TENGAH, LAMPUNG UTARA, LAMPUNG",3,73,79,152
https://kawalpemilu.org#23407,"MELUNGUN RATU, SUNGKAI TENGAH, LAMPUNG UTARA, LAMPUNG",4,121,31,152
https://kawalpemilu.org#23408,"NEGERI CAMPANG JAYA, SUNGKAI TENGAH, LAMPUNG UTARA, LAMPUNG",1,30,150,180
https://kawalpemilu.org#23408,"NEGERI CAMPANG JAYA, SUNGKAI TENGAH, LAMPUNG UTARA, LAMPUNG",2,145,21,166
https://kawalpemilu.org#23408,"NEGERI CAMPANG JAYA, SUNGKAI TENGAH, LAMPUNG UTARA, LAMPUNG",3,108,67,175
https://kawalpemilu.org#23408,"NEGERI CAMPANG JAYA, SUNGKAI TENGAH, LAMPUNG UTARA, LAMPUNG",4,112,56,168
https://kawalpemilu.org#23408,"NEGERI CAMPANG JAYA, SUNGKAI TENGAH, LAMPUNG UTARA, LAMPUNG",5,110,48,158
https://kawalpemilu.org#23408,"NEGERI CAMPANG JAYA, SUNGKAI TENGAH, LAMPUNG UTARA, LAMPUNG",6,98,58,156
https://kawalpemilu.org#23408,"NEGERI CAMPANG JAYA, SUNGKAI TENGAH, LAMPUNG UTARA, LAMPUNG",7,89,71,160
https://kawalpemilu.org#23408,"NEGERI CAMPANG JAYA, SUNGKAI TENGAH, LAMPUNG UTARA, LAMPUNG",8,75,94,169
https://kawalpemilu.org#23409,"PAMPANG TANGGUK JAYA, SUNGKAI TENGAH, LAMPUNG UTARA, LAMPUNG",1,14,96,110
https://kawalpemilu.org#23409,"PAMPANG TANGGUK JAYA, SUNGKAI TENGAH, LAMPUNG UTARA, LAMPUNG",3,93,93,186
https://kawalpemilu.org#23409,"PAMPANG TANGGUK JAYA, SUNGKAI TENGAH, LAMPUNG UTARA, LAMPUNG",4,87,53,140
https://kawalpemilu.org#23409,"PAMPANG TANGGUK JAYA, SUNGKAI TENGAH, LAMPUNG UTARA, LAMPUNG",5,76,60,136
https://kawalpemilu.org#23409,"PAMPANG TANGGUK JAYA, SUNGKAI TENGAH, LAMPUNG UTARA, LAMPUNG",6,41,118,159
https://kawalpemilu.org#23409,"PAMPANG TANGGUK JAYA, SUNGKAI TENGAH, LAMPUNG UTARA, LAMPUNG",48,69,140,209
https://kawalpemilu.org#23409,"PAMPANG TANGGUK JAYA, SUNGKAI TENGAH, LAMPUNG UTARA, LAMPUNG",53,138,26,164
https://kawalpemilu.org#23410,"NEGERI GALIH REJO, SUNGKAI TENGAH, LAMPUNG UTARA, LAMPUNG",1,86,112,198
https://kawalpemilu.org#23410,"NEGERI GALIH REJO, SUNGKAI TENGAH, LAMPUNG UTARA, LAMPUNG",2,103,51,154
https://kawalpemilu.org#23410,"NEGERI GALIH REJO, SUNGKAI TENGAH, LAMPUNG UTARA, LAMPUNG",3,14,37,121
https://kawalpemilu.org#23410,"NEGERI GALIH REJO, SUNGKAI TENGAH, LAMPUNG UTARA, LAMPUNG",4,142,51,193
https://kawalpemilu.org#23410,"NEGERI GALIH REJO, SUNGKAI TENGAH, LAMPUNG UTARA, LAMPUNG",5,91,21,112
https://kawalpemilu.org#23410,"NEGERI GALIH REJO, SUNGKAI TENGAH, LAMPUNG UTARA, LAMPUNG",6,129,16,145
https://kawalpemilu.org#23411,"RATU JAYA, SUNGKAI TENGAH, LAMPUNG UTARA, LAMPUNG",1,0,0,0
https://kawalpemilu.org#23411,"RATU JAYA, SUNGKAI TENGAH, LAMPUNG UTARA, LAMPUNG",2,39,71,110
https://kawalpemilu.org#23411,"RATU JAYA, SUNGKAI TENGAH, LAMPUNG UTARA, LAMPUNG",3,106,19,125
https://kawalpemilu.org#23411,"RATU JAYA, SUNGKAI TENGAH, LAMPUNG UTARA, LAMPUNG",4,0,0,0
https://kawalpemilu.org#23411,"RATU JAYA, SUNGKAI TENGAH, LAMPUNG UTARA, LAMPUNG",5,10,104,114
https://kawalpemilu.org#23411,"RATU JAYA, SUNGKAI TENGAH, LAMPUNG UTARA, LAMPUNG",54,63,118,181
https://kawalpemilu.org#23411,"RATU JAYA, SUNGKAI TENGAH, LAMPUNG UTARA, LAMPUNG",55,39,71,110
https://kawalpemilu.org#23411,"RATU JAYA, SUNGKAI TENGAH, LAMPUNG UTARA, LAMPUNG",56,106,19,125
https://kawalpemilu.org#23411,"RATU JAYA, SUNGKAI TENGAH, LAMPUNG UTARA, LAMPUNG",57,95,34,129
https://kawalpemilu.org#23411,"RATU JAYA, SUNGKAI TENGAH, LAMPUNG UTARA, LAMPUNG",58,10,104,114
https://kawalpemilu.org#23412,"MEKAR ASRI, SUNGKAI TENGAH, LAMPUNG UTARA, LAMPUNG",1,0,0,0
https://kawalpemilu.org#23412,"MEKAR ASRI, SUNGKAI TENGAH, LAMPUNG UTARA, LAMPUNG",2,0,0,0
https://kawalpemilu.org#23412,"MEKAR ASRI, SUNGKAI TENGAH, LAMPUNG UTARA, LAMPUNG",3,134,47,181
https://kawalpemilu.org#23412,"MEKAR ASRI, SUNGKAI TENGAH, LAMPUNG UTARA, LAMPUNG",4,135,23,158
https://kawalpemilu.org#23412,"MEKAR ASRI, SUNGKAI TENGAH, LAMPUNG UTARA, LAMPUNG",5,0,0,0
https://kawalpemilu.org#23412,"MEKAR ASRI, SUNGKAI TENGAH, LAMPUNG UTARA, LAMPUNG",6,0,0,0
https://kawalpemilu.org#23412,"MEKAR ASRI, SUNGKAI TENGAH, LAMPUNG UTARA, LAMPUNG",7,0,0,0
https://kawalpemilu.org#23412,"MEKAR ASRI, SUNGKAI TENGAH, LAMPUNG UTARA, LAMPUNG",8,0,0,0
https://kawalpemilu.org#23412,"MEKAR ASRI, SUNGKAI TENGAH, LAMPUNG UTARA, LAMPUNG",9,0,0,0
https://kawalpemilu.org#23412,"MEKAR ASRI, SUNGKAI TENGAH, LAMPUNG UTARA, LAMPUNG",11,149,27,176
https://kawalpemilu.org#23412,"MEKAR ASRI, SUNGKAI TENGAH, LAMPUNG UTARA, LAMPUNG",12,82,33,115
https://kawalpemilu.org#23412,"MEKAR ASRI, SUNGKAI TENGAH, LAMPUNG UTARA, LAMPUNG",13,134,47,181
https://kawalpemilu.org#23412,"MEKAR ASRI, SUNGKAI TENGAH, LAMPUNG UTARA, LAMPUNG",14,135,23,158
https://kawalpemilu.org#23412,"MEKAR ASRI, SUNGKAI TENGAH, LAMPUNG UTARA, LAMPUNG",15,149,15,164
https://kawalpemilu.org#23412,"MEKAR ASRI, SUNGKAI TENGAH, LAMPUNG UTARA, LAMPUNG",17,57,92,149
https://kawalpemilu.org#23412,"MEKAR ASRI, SUNGKAI TENGAH, LAMPUNG UTARA, LAMPUNG",18,63,129,192
https://kawalpemilu.org#23412,"MEKAR ASRI, SUNGKAI TENGAH, LAMPUNG UTARA, LAMPUNG",19,53,86,139
https://kawalpemilu.org#23414,"PEKURUN TENGAH, ABUNG PEKURUN, LAMPUNG UTARA, LAMPUNG",4,43,139,182
https://kawalpemilu.org#23414,"PEKURUN TENGAH, ABUNG PEKURUN, LAMPUNG UTARA, LAMPUNG",7,0,0,0
https://kawalpemilu.org#23414,"PEKURUN TENGAH, ABUNG PEKURUN, LAMPUNG UTARA, LAMPUNG",8,0,0,0
https://kawalpemilu.org#23414,"PEKURUN TENGAH, ABUNG PEKURUN, LAMPUNG UTARA, LAMPUNG",9,49,185,234
https://kawalpemilu.org#23414,"PEKURUN TENGAH, ABUNG PEKURUN, LAMPUNG UTARA, LAMPUNG",10,67,133,200
https://kawalpemilu.org#23414,"PEKURUN TENGAH, ABUNG PEKURUN, LAMPUNG UTARA, LAMPUNG",11,35,115,150
https://kawalpemilu.org#23414,"PEKURUN TENGAH, ABUNG PEKURUN, LAMPUNG UTARA, LAMPUNG",13,22,111,133
https://kawalpemilu.org#23414,"PEKURUN TENGAH, ABUNG PEKURUN, LAMPUNG UTARA, LAMPUNG",15,35,119,154
https://kawalpemilu.org#23414,"PEKURUN TENGAH, ABUNG PEKURUN, LAMPUNG UTARA, LAMPUNG",16,27,120,147
https://kawalpemilu.org#23414,"PEKURUN TENGAH, ABUNG PEKURUN, LAMPUNG UTARA, LAMPUNG",17,24,75,99
https://kawalpemilu.org#23414,"PEKURUN TENGAH, ABUNG PEKURUN, LAMPUNG UTARA, LAMPUNG",18,88,114,202
https://kawalpemilu.org#23415,"NYAPAH BANYU, ABUNG PEKURUN, LAMPUNG UTARA, LAMPUNG",1,0,0,0
https://kawalpemilu.org#23415,"NYAPAH BANYU, ABUNG PEKURUN, LAMPUNG UTARA, LAMPUNG",2,0,0,0
https://kawalpemilu.org#23415,"NYAPAH BANYU, ABUNG PEKURUN, LAMPUNG UTARA, LAMPUNG",3,0,0,0
https://kawalpemilu.org#23415,"NYAPAH BANYU, ABUNG PEKURUN, LAMPUNG UTARA, LAMPUNG",4,0,0,0
https://kawalpemilu.org#23415,"NYAPAH BANYU, ABUNG PEKURUN, LAMPUNG UTARA, LAMPUNG",27,81,99,180
https://kawalpemilu.org#23415,"NYAPAH BANYU, ABUNG PEKURUN, LAMPUNG UTARA, LAMPUNG",28,38,94,132
https://kawalpemilu.org#23415,"NYAPAH BANYU, ABUNG PEKURUN, LAMPUNG UTARA, LAMPUNG",29,52,157,209
https://kawalpemilu.org#23415,"NYAPAH BANYU, ABUNG PEKURUN, LAMPUNG UTARA, LAMPUNG",30,30,120,150
https://kawalpemilu.org#23416,"SINAR GUNUNG, ABUNG PEKURUN, LAMPUNG UTARA, LAMPUNG",1,97,90,187
https://kawalpemilu.org#23416,"SINAR GUNUNG, ABUNG PEKURUN, LAMPUNG UTARA, LAMPUNG",32,83,55,138
https://kawalpemilu.org#23417,"CAMPANG GIJUL, ABUNG PEKURUN, LAMPUNG UTARA, LAMPUNG",35,97,96,193
https://kawalpemilu.org#23418,"SUMBER TANI, ABUNG PEKURUN, LAMPUNG UTARA, LAMPUNG",1,0,0,0
https://kawalpemilu.org#23418,"SUMBER TANI, ABUNG PEKURUN, LAMPUNG UTARA, LAMPUNG",2,145,32,177
https://kawalpemilu.org#23418,"SUMBER TANI, ABUNG PEKURUN, LAMPUNG UTARA, LAMPUNG",3,52,36,88
https://kawalpemilu.org#23418,"SUMBER TANI, ABUNG PEKURUN, LAMPUNG UTARA, LAMPUNG",4,59,113,172
https://kawalpemilu.org#23418,"SUMBER TANI, ABUNG PEKURUN, LAMPUNG UTARA, LAMPUNG",36,74,131,205
https://kawalpemilu.org#23419,"OGAN CAMPANG, ABUNG PEKURUN, LAMPUNG UTARA, LAMPUNG",33,71,140,211
https://kawalpemilu.org#23419,"OGAN CAMPANG, ABUNG PEKURUN, LAMPUNG UTARA, LAMPUNG",34,39,94,133
https://kawalpemilu.org#23420,"PEKURUN, ABUNG PEKURUN, LAMPUNG UTARA, LAMPUNG",1,58,83,141
https://kawalpemilu.org#23420,"PEKURUN, ABUNG PEKURUN, LAMPUNG UTARA, LAMPUNG",2,72,114,186
https://kawalpemilu.org#23420,"PEKURUN, ABUNG PEKURUN, LAMPUNG UTARA, LAMPUNG",3,71,86,157
https://kawalpemilu.org#23420,"PEKURUN, ABUNG PEKURUN, LAMPUNG UTARA, LAMPUNG",4,93,105,198
https://kawalpemilu.org#23420,"PEKURUN, ABUNG PEKURUN, LAMPUNG UTARA, LAMPUNG",5,104,86,190
https://kawalpemilu.org#23420,"PEKURUN, ABUNG PEKURUN, LAMPUNG UTARA, LAMPUNG",6,81,100,181
https://kawalpemilu.org#23420,"PEKURUN, ABUNG PEKURUN, LAMPUNG UTARA, LAMPUNG",8,41,109,150
https://kawalpemilu.org#23421,"PEKURUN UDIK, ABUNG PEKURUN, LAMPUNG UTARA, LAMPUNG",19,73,126,199
https://kawalpemilu.org#23421,"PEKURUN UDIK, ABUNG PEKURUN, LAMPUNG UTARA, LAMPUNG",20,55,124,179
https://kawalpemilu.org#23421,"PEKURUN UDIK, ABUNG PEKURUN, LAMPUNG UTARA, LAMPUNG",21,93,108,201
https://kawalpemilu.org#23421,"PEKURUN UDIK, ABUNG PEKURUN, LAMPUNG UTARA, LAMPUNG",22,23,140,163
https://kawalpemilu.org#23421,"PEKURUN UDIK, ABUNG PEKURUN, LAMPUNG UTARA, LAMPUNG",23,18,164,182
https://kawalpemilu.org#23422,"OGAN JAYA, ABUNG PEKURUN, LAMPUNG UTARA, LAMPUNG",24,18,148,166
https://kawalpemilu.org#23422,"OGAN JAYA, ABUNG PEKURUN, LAMPUNG UTARA, LAMPUNG",26,30,155,185
https://kawalpemilu.org#23424,"CEMPAKA, SUNGKAI JAYA, LAMPUNG UTARA, LAMPUNG",1,0,0,0
https://kawalpemilu.org#23424,"CEMPAKA, SUNGKAI JAYA, LAMPUNG UTARA, LAMPUNG",2,79,98,177
https://kawalpemilu.org#23424,"CEMPAKA, SUNGKAI JAYA, LAMPUNG UTARA, LAMPUNG",3,0,0,0
https://kawalpemilu.org#23424,"CEMPAKA, SUNGKAI JAYA, LAMPUNG UTARA, LAMPUNG",4,0,0,0
https://kawalpemilu.org#23424,"CEMPAKA, SUNGKAI JAYA, LAMPUNG UTARA, LAMPUNG",5,0,0,0
https://kawalpemilu.org#23424,"CEMPAKA, SUNGKAI JAYA, LAMPUNG UTARA, LAMPUNG",6,66,115,181
https://kawalpemilu.org#23424,"CEMPAKA, SUNGKAI JAYA, LAMPUNG UTARA, LAMPUNG",7,0,0,0
https://kawalpemilu.org#23424,"CEMPAKA, SUNGKAI JAYA, LAMPUNG UTARA, LAMPUNG",8,40,118,158
https://kawalpemilu.org#23424,"CEMPAKA, SUNGKAI JAYA, LAMPUNG UTARA, LAMPUNG",9,79,98,177
https://kawalpemilu.org#23424,"CEMPAKA, SUNGKAI JAYA, LAMPUNG UTARA, LAMPUNG",10,37,102,139
https://kawalpemilu.org#23424,"CEMPAKA, SUNGKAI JAYA, LAMPUNG UTARA, LAMPUNG",11,30,67,97
https://kawalpemilu.org#23424,"CEMPAKA, SUNGKAI JAYA, LAMPUNG UTARA, LAMPUNG",12,48,139,187
https://kawalpemilu.org#23424,"CEMPAKA, SUNGKAI JAYA, LAMPUNG UTARA, LAMPUNG",13,66,115,181
https://kawalpemilu.org#23424,"CEMPAKA, SUNGKAI JAYA, LAMPUNG UTARA, LAMPUNG",14,45,126,171
https://kawalpemilu.org#23424,"CEMPAKA, SUNGKAI JAYA, LAMPUNG UTARA, LAMPUNG",15,17,44,61
https://kawalpemilu.org#23425,"SUKA JAYA, SUNGKAI JAYA, LAMPUNG UTARA, LAMPUNG",33,30,126,156
https://kawalpemilu.org#23425,"SUKA JAYA, SUNGKAI JAYA, LAMPUNG UTARA, LAMPUNG",34,36,101,137
https://kawalpemilu.org#23425,"SUKA JAYA, SUNGKAI JAYA, LAMPUNG UTARA, LAMPUNG",35,36,68,104
https://kawalpemilu.org#23426,"SRI JAYA, SUNGKAI JAYA, LAMPUNG UTARA, LAMPUNG",1,52,99,151
https://kawalpemilu.org#23426,"SRI JAYA, SUNGKAI JAYA, LAMPUNG UTARA, LAMPUNG",2,34,95,129
https://kawalpemilu.org#23426,"SRI JAYA, SUNGKAI JAYA, LAMPUNG UTARA, LAMPUNG",3,70,107,177
https://kawalpemilu.org#23426,"SRI JAYA, SUNGKAI JAYA, LAMPUNG UTARA, LAMPUNG",30,52,99,151
https://kawalpemilu.org#23426,"SRI JAYA, SUNGKAI JAYA, LAMPUNG UTARA, LAMPUNG",31,34,95,129
https://kawalpemilu.org#23426,"SRI JAYA, SUNGKAI JAYA, LAMPUNG UTARA, LAMPUNG",32,70,107,177
https://kawalpemilu.org#23427,"NEGARA AGUNG, SUNGKAI JAYA, LAMPUNG UTARA, LAMPUNG",23,17,160,177
https://kawalpemilu.org#23427,"NEGARA AGUNG, SUNGKAI JAYA, LAMPUNG UTARA, LAMPUNG",24,54,60,114
https://kawalpemilu.org#23427,"NEGARA AGUNG, SUNGKAI JAYA, LAMPUNG UTARA, LAMPUNG",25,12,122,134
https://kawalpemilu.org#23428,"CEMPAKA BARAT, SUNGKAI JAYA, LAMPUNG UTARA, LAMPUNG",1,75,92,167
https://kawalpemilu.org#23428,"CEMPAKA BARAT, SUNGKAI JAYA, LAMPUNG UTARA, LAMPUNG",2,28,98,126
https://kawalpemilu.org#23428,"CEMPAKA BARAT, SUNGKAI JAYA, LAMPUNG UTARA, LAMPUNG",3,80,64,144
https://kawalpemilu.org#23429,"CEMPAKA TIMUR, SUNGKAI JAYA, LAMPUNG UTARA, LAMPUNG",1,120,55,175
https://kawalpemilu.org#23429,"CEMPAKA TIMUR, SUNGKAI JAYA, LAMPUNG UTARA, LAMPUNG",2,96,36,132
https://kawalpemilu.org#23429,"CEMPAKA TIMUR, SUNGKAI JAYA, LAMPUNG UTARA, LAMPUNG",3,51,106,157
https://kawalpemilu.org#23429,"CEMPAKA TIMUR, SUNGKAI JAYA, LAMPUNG UTARA, LAMPUNG",4,135,66,201
https://kawalpemilu.org#23430,"LEPANG TENGAH, SUNGKAI JAYA, LAMPUNG UTARA, LAMPUNG",20,16,70,86
https://kawalpemilu.org#23430,"LEPANG TENGAH, SUNGKAI JAYA, LAMPUNG UTARA, LAMPUNG",21,20,80,100
https://kawalpemilu.org#23430,"LEPANG TENGAH, SUNGKAI JAYA, LAMPUNG UTARA, LAMPUNG",22,36,128,164
https://kawalpemilu.org#23431,"CAHAYA MAKMUR, SUNGKAI JAYA, LAMPUNG UTARA, LAMPUNG",1,97,133,230
https://kawalpemilu.org#23431,"CAHAYA MAKMUR, SUNGKAI JAYA, LAMPUNG UTARA, LAMPUNG",2,23,102,125
https://kawalpemilu.org#23431,"CAHAYA MAKMUR, SUNGKAI JAYA, LAMPUNG UTARA, LAMPUNG",3,107,74,181
https://kawalpemilu.org#23431,"CAHAYA MAKMUR, SUNGKAI JAYA, LAMPUNG UTARA, LAMPUNG",4,120,36,156
https://kawalpemilu.org#23432,"SRI AGUNG, SUNGKAI JAYA, LAMPUNG UTARA, LAMPUNG",1,34,119,153
https://kawalpemilu.org#23432,"SRI AGUNG, SUNGKAI JAYA, LAMPUNG UTARA, LAMPUNG",27,34,82,116
https://kawalpemilu.org#23432,"SRI AGUNG, SUNGKAI JAYA, LAMPUNG UTARA, LAMPUNG",28,23,60,83
https://kawalpemilu.org#23432,"SRI AGUNG, SUNGKAI JAYA, LAMPUNG UTARA, LAMPUNG",29,44,110,154
https://kawalpemilu.org#23434,"SINAR HARAPAN, SUNGKAI BARAT, LAMPUNG UTARA, LAMPUNG",32,64,95,159
https://kawalpemilu.org#23434,"SINAR HARAPAN, SUNGKAI BARAT, LAMPUNG UTARA, LAMPUNG",33,106,81,187
https://kawalpemilu.org#23434,"SINAR HARAPAN, SUNGKAI BARAT, LAMPUNG UTARA, LAMPUNG",34,69,76,145
https://kawalpemilu.org#23434,"SINAR HARAPAN, SUNGKAI BARAT, LAMPUNG UTARA, LAMPUNG",35,84,67,151
https://kawalpemilu.org#23434,"SINAR HARAPAN, SUNGKAI BARAT, LAMPUNG UTARA, LAMPUNG",36,35,122,157
https://kawalpemilu.org#23435,"NEGERI BATIN JAYA, SUNGKAI BARAT, LAMPUNG UTARA, LAMPUNG",1,43,98,141
https://kawalpemilu.org#23435,"NEGERI BATIN JAYA, SUNGKAI BARAT, LAMPUNG UTARA, LAMPUNG",3,13,77,90
https://kawalpemilu.org#23435,"NEGERI BATIN JAYA, SUNGKAI BARAT, LAMPUNG UTARA, LAMPUNG",4,45,88,133
https://kawalpemilu.org#23435,"NEGERI BATIN JAYA, SUNGKAI BARAT, LAMPUNG UTARA, LAMPUNG",26,54,127,181
https://kawalpemilu.org#23437,"KUBU HITU, SUNGKAI BARAT, LAMPUNG UTARA, LAMPUNG",2,31,86,117
https://kawalpemilu.org#23437,"KUBU HITU, SUNGKAI BARAT, LAMPUNG UTARA, LAMPUNG",20,48,138,186
https://kawalpemilu.org#23437,"KUBU HITU, SUNGKAI BARAT, LAMPUNG UTARA, LAMPUNG",22,37,144,181
https://kawalpemilu.org#23437,"KUBU HITU, SUNGKAI BARAT, LAMPUNG UTARA, LAMPUNG",23,48,70,118
https://kawalpemilu.org#23437,"KUBU HITU, SUNGKAI BARAT, LAMPUNG UTARA, LAMPUNG",24,9,54,63
https://kawalpemilu.org#23438,"NEGERI SAKTI, SUNGKAI BARAT, LAMPUNG UTARA, LAMPUNG",29,10,170,180
https://kawalpemilu.org#23438,"NEGERI SAKTI, SUNGKAI BARAT, LAMPUNG UTARA, LAMPUNG",30,4,134,138
https://kawalpemilu.org#23438,"NEGERI SAKTI, SUNGKAI BARAT, LAMPUNG UTARA, LAMPUNG",31,10,89,99
https://kawalpemilu.org#23440,"GUNUNG RAJA, SUNGKAI BARAT, LAMPUNG UTARA, LAMPUNG",6,43,122,165
https://kawalpemilu.org#23440,"GUNUNG RAJA, SUNGKAI BARAT, LAMPUNG UTARA, LAMPUNG",13,27,165,192
https://kawalpemilu.org#23440,"GUNUNG RAJA, SUNGKAI BARAT, LAMPUNG UTARA, LAMPUNG",14,19,113,132
https://kawalpemilu.org#23440,"GUNUNG RAJA, SUNGKAI BARAT, LAMPUNG UTARA, LAMPUNG",16,69,54,123
https://kawalpemilu.org#23440,"GUNUNG RAJA, SUNGKAI BARAT, LAMPUNG UTARA, LAMPUNG",17,18,210,228
https://kawalpemilu.org#23440,"GUNUNG RAJA, SUNGKAI BARAT, LAMPUNG UTARA, LAMPUNG",19,26,78,104
https://kawalpemilu.org#23441,"COMOK SINAR JAYA, SUNGKAI BARAT, LAMPUNG UTARA, LAMPUNG",6,13,75,88
https://kawalpemilu.org#23441,"COMOK SINAR JAYA, SUNGKAI BARAT, LAMPUNG UTARA, LAMPUNG",7,85,77,162
https://kawalpemilu.org#23441,"COMOK SINAR JAYA, SUNGKAI BARAT, LAMPUNG UTARA, LAMPUNG",8,47,62,109
https://kawalpemilu.org#23441,"COMOK SINAR JAYA, SUNGKAI BARAT, LAMPUNG UTARA, LAMPUNG",9,25,66,91
https://kawalpemilu.org#23441,"COMOK SINAR JAYA, SUNGKAI BARAT, LAMPUNG UTARA, LAMPUNG",10,34,97,131
https://kawalpemilu.org#23442,"CAHAYA MAS, SUNGKAI BARAT, LAMPUNG UTARA, LAMPUNG",1,42,66,108
https://kawalpemilu.org#23442,"CAHAYA MAS, SUNGKAI BARAT, LAMPUNG UTARA, LAMPUNG",2,45,108,153
https://kawalpemilu.org#23442,"CAHAYA MAS, SUNGKAI BARAT, LAMPUNG UTARA, LAMPUNG",3,55,85,140
https://kawalpemilu.org#23442,"CAHAYA MAS, SUNGKAI BARAT, LAMPUNG UTARA, LAMPUNG",4,27,160,187
https://kawalpemilu.org#23442,"CAHAYA MAS, SUNGKAI BARAT, LAMPUNG UTARA, LAMPUNG",5,57,110,167
https://kawalpemilu.org#23443,"WAY ISEM, SUNGKAI BARAT, LAMPUNG UTARA, LAMPUNG",41,54,118,172
https://kawalpemilu.org#23443,"WAY ISEM, SUNGKAI BARAT, LAMPUNG UTARA, LAMPUNG",42,55,31,86
https://kawalpemilu.org#23443,"WAY ISEM, SUNGKAI BARAT, LAMPUNG UTARA, LAMPUNG",43,122,47,169
https://kawalpemilu.org#23443,"WAY ISEM, SUNGKAI BARAT, LAMPUNG UTARA, LAMPUNG",44,70,62,132
https://kawalpemilu.org#23443,"WAY ISEM, SUNGKAI BARAT, LAMPUNG UTARA, LAMPUNG",45,95,59,154
https://kawalpemilu.org#23443,"WAY ISEM, SUNGKAI BARAT, LAMPUNG UTARA, LAMPUNG",46,109,50,159
https://kawalpemilu.org#84805,"GUNUNG MAKNIBAI, SUNGKAI BARAT, LAMPUNG UTARA, LAMPUNG",1,31,110,141
https://kawalpemilu.org#84805,"GUNUNG MAKNIBAI, SUNGKAI BARAT, LAMPUNG UTARA, LAMPUNG",2,20,108,128
https://kawalpemilu.org#88289,"TANJUNG JAYA, SUNGKAI BARAT, LAMPUNG UTARA, LAMPUNG",1,47,131,178
https://kawalpemilu.org#88289,"TANJUNG JAYA, SUNGKAI BARAT, LAMPUNG UTARA, LAMPUNG",2,15,142,157
https://kawalpemilu.org#88289,"TANJUNG JAYA, SUNGKAI BARAT, LAMPUNG UTARA, LAMPUNG",3,44,76,120
https://kawalpemilu.org#88289,"TANJUNG JAYA, SUNGKAI BARAT, LAMPUNG UTARA, LAMPUNG",4,21,126,1
https://kawalpemilu.org#23445,"AJI KAGUNGAN, ABUNG KUNANG, LAMPUNG UTARA, LAMPUNG",1,33,136,169
https://kawalpemilu.org#23445,"AJI KAGUNGAN, ABUNG KUNANG, LAMPUNG UTARA, LAMPUNG",2,35,140,175
https://kawalpemilu.org#23445,"AJI KAGUNGAN, ABUNG KUNANG, LAMPUNG UTARA, LAMPUNG",3,26,97,123
https://kawalpemilu.org#23445,"AJI KAGUNGAN, ABUNG KUNANG, LAMPUNG UTARA, LAMPUNG",4,6,107,113
https://kawalpemilu.org#23445,"AJI KAGUNGAN, ABUNG KUNANG, LAMPUNG UTARA, LAMPUNG",5,62,68,130
https://kawalpemilu.org#23445,"AJI KAGUNGAN, ABUNG KUNANG, LAMPUNG UTARA, LAMPUNG",6,30,109,139
https://kawalpemilu.org#23445,"AJI KAGUNGAN, ABUNG KUNANG, LAMPUNG UTARA, LAMPUNG",7,53,85,138
https://kawalpemilu.org#23445,"AJI KAGUNGAN, ABUNG KUNANG, LAMPUNG UTARA, LAMPUNG",8,11,139,150
https://kawalpemilu.org#23445,"AJI KAGUNGAN, ABUNG KUNANG, LAMPUNG UTARA, LAMPUNG",9,13,74,87
https://kawalpemilu.org#23445,"AJI KAGUNGAN, ABUNG KUNANG, LAMPUNG UTARA, LAMPUNG",10,35,52,87
https://kawalpemilu.org#23445,"AJI KAGUNGAN, ABUNG KUNANG, LAMPUNG UTARA, LAMPUNG",11,38,80,118
https://kawalpemilu.org#23445,"AJI KAGUNGAN, ABUNG KUNANG, LAMPUNG UTARA, LAMPUNG",12,17,73,90
https://kawalpemilu.org#23445,"AJI KAGUNGAN, ABUNG KUNANG, LAMPUNG UTARA, LAMPUNG",13,41,80,121
https://kawalpemilu.org#23446,"TALANG JEMBATAN, ABUNG KUNANG, LAMPUNG UTARA, LAMPUNG",3,69,135,204
https://kawalpemilu.org#23447,"SABUK EMPAT, ABUNG KUNANG, LAMPUNG UTARA, LAMPUNG",19,36,126,162
https://kawalpemilu.org#23447,"SABUK EMPAT, ABUNG KUNANG, LAMPUNG UTARA, LAMPUNG",20,60,97,157
https://kawalpemilu.org#23447,"SABUK EMPAT, ABUNG KUNANG, LAMPUNG UTARA, LAMPUNG",21,49,98,147
https://kawalpemilu.org#23447,"SABUK EMPAT, ABUNG KUNANG, LAMPUNG UTARA, LAMPUNG",23,68,127,195
https://kawalpemilu.org#23448,"BERINGIN, ABUNG KUNANG, LAMPUNG UTARA, LAMPUNG",26,27,141,168
https://kawalpemilu.org#23448,"BERINGIN, ABUNG KUNANG, LAMPUNG UTARA, LAMPUNG",27,25,142,167
https://kawalpemilu.org#23448,"BERINGIN, ABUNG KUNANG, LAMPUNG UTARA, LAMPUNG",28,29,138,167
https://kawalpemilu.org#23449,"SABUK INDAH, ABUNG KUNANG, LAMPUNG UTARA, LAMPUNG",33,41,137,178
https://kawalpemilu.org#23449,"SABUK INDAH, ABUNG KUNANG, LAMPUNG UTARA, LAMPUNG",34,43,129,172
https://kawalpemilu.org#23449,"SABUK INDAH, ABUNG KUNANG, LAMPUNG UTARA, LAMPUNG",35,58,101,159
https://kawalpemilu.org#23450,"BINDU, ABUNG KUNANG, LAMPUNG UTARA, LAMPUNG",4,31,145,176
https://kawalpemilu.org#23450,"BINDU, ABUNG KUNANG, LAMPUNG UTARA, LAMPUNG",5,65,168,233
https://kawalpemilu.org#23450,"BINDU, ABUNG KUNANG, LAMPUNG UTARA, LAMPUNG",14,23,197,220
https://kawalpemilu.org#23450,"BINDU, ABUNG KUNANG, LAMPUNG UTARA, LAMPUNG",15,22,197,219
https://kawalpemilu.org#23450,"BINDU, ABUNG KUNANG, LAMPUNG UTARA, LAMPUNG",16,23,134,157
https://kawalpemilu.org#23451,"WAY PERANCANG, ABUNG KUNANG, LAMPUNG UTARA, LAMPUNG",1,30,114,144
https://kawalpemilu.org#23451,"WAY PERANCANG, ABUNG KUNANG, LAMPUNG UTARA, LAMPUNG",2,47,94,141
https://kawalpemilu.org#23453,"BLAMBANGAN, BLAMBANGAN PAGAR, LAMPUNG UTARA, LAMPUNG",1,46,149,195
https://kawalpemilu.org#23453,"BLAMBANGAN, BLAMBANGAN PAGAR, LAMPUNG UTARA, LAMPUNG",2,34,122,156
https://kawalpemilu.org#23453,"BLAMBANGAN, BLAMBANGAN PAGAR, LAMPUNG UTARA, LAMPUNG",3,32,149,181
https://kawalpemilu.org#23453,"BLAMBANGAN, BLAMBANGAN PAGAR, LAMPUNG UTARA, LAMPUNG",4,60,93,153
https://kawalpemilu.org#23453,"BLAMBANGAN, BLAMBANGAN PAGAR, LAMPUNG UTARA, LAMPUNG",5,38,102,140
https://kawalpemilu.org#23453,"BLAMBANGAN, BLAMBANGAN PAGAR, LAMPUNG UTARA, LAMPUNG",6,69,94,163
https://kawalpemilu.org#23453,"BLAMBANGAN, BLAMBANGAN PAGAR, LAMPUNG UTARA, LAMPUNG",7,82,138,220
https://kawalpemilu.org#23453,"BLAMBANGAN, BLAMBANGAN PAGAR, LAMPUNG UTARA, LAMPUNG",8,88,106,194
https://kawalpemilu.org#23453,"BLAMBANGAN, BLAMBANGAN PAGAR, LAMPUNG UTARA, LAMPUNG",9,95,105,200
https://kawalpemilu.org#23453,"BLAMBANGAN, BLAMBANGAN PAGAR, LAMPUNG UTARA, LAMPUNG",10,115,87,202
https://kawalpemilu.org#23454,"PAGAR, BLAMBANGAN PAGAR, LAMPUNG UTARA, LAMPUNG",25,40,95,135
https://kawalpemilu.org#23454,"PAGAR, BLAMBANGAN PAGAR, LAMPUNG UTARA, LAMPUNG",26,60,94,154
https://kawalpemilu.org#23454,"PAGAR, BLAMBANGAN PAGAR, LAMPUNG UTARA, LAMPUNG",27,77,78,155
https://kawalpemilu.org#23454,"PAGAR, BLAMBANGAN PAGAR, LAMPUNG UTARA, LAMPUNG",28,72,67,139
https://kawalpemilu.org#23454,"PAGAR, BLAMBANGAN PAGAR, LAMPUNG UTARA, LAMPUNG",29,97,32,129
https://kawalpemilu.org#23454,"PAGAR, BLAMBANGAN PAGAR, LAMPUNG UTARA, LAMPUNG",30,79,46,125
https://kawalpemilu.org#23455,"JAGANG, BLAMBANGAN PAGAR, LAMPUNG UTARA, LAMPUNG",5,0,0,0
https://kawalpemilu.org#23455,"JAGANG, BLAMBANGAN PAGAR, LAMPUNG UTARA, LAMPUNG",6,0,0,0
https://kawalpemilu.org#23455,"JAGANG, BLAMBANGAN PAGAR, LAMPUNG UTARA, LAMPUNG",7,0,0,0
https://kawalpemilu.org#23455,"JAGANG, BLAMBANGAN PAGAR, LAMPUNG UTARA, LAMPUNG",15,43,117,160
https://kawalpemilu.org#23455,"JAGANG, BLAMBANGAN PAGAR, LAMPUNG UTARA, LAMPUNG",18,95,95,190
https://kawalpemilu.org#23455,"JAGANG, BLAMBANGAN PAGAR, LAMPUNG UTARA, LAMPUNG",19,81,115,196
https://kawalpemilu.org#23455,"JAGANG, BLAMBANGAN PAGAR, LAMPUNG UTARA, LAMPUNG",20,74,122,196
https://kawalpemilu.org#23455,"JAGANG, BLAMBANGAN PAGAR, LAMPUNG UTARA, LAMPUNG",21,81,148,229
https://kawalpemilu.org#23455,"JAGANG, BLAMBANGAN PAGAR, LAMPUNG UTARA, LAMPUNG",22,79,109,188
https://kawalpemilu.org#23455,"JAGANG, BLAMBANGAN PAGAR, LAMPUNG UTARA, LAMPUNG",23,123,129,252
https://kawalpemilu.org#23456,"TANJUNG IMAN, BLAMBANGAN PAGAR, LAMPUNG UTARA, LAMPUNG",3,81,108,189
https://kawalpemilu.org#23456,"TANJUNG IMAN, BLAMBANGAN PAGAR, LAMPUNG UTARA, LAMPUNG",4,67,91,158
https://kawalpemilu.org#23456,"TANJUNG IMAN, BLAMBANGAN PAGAR, LAMPUNG UTARA, LAMPUNG",5,45,179,224
https://kawalpemilu.org#23456,"TANJUNG IMAN, BLAMBANGAN PAGAR, LAMPUNG UTARA, LAMPUNG",6,49,166,215
https://kawalpemilu.org#23456,"TANJUNG IMAN, BLAMBANGAN PAGAR, LAMPUNG UTARA, LAMPUNG",7,50,129,173
https://kawalpemilu.org#23456,"TANJUNG IMAN, BLAMBANGAN PAGAR, LAMPUNG UTARA, LAMPUNG",10,13,127,140
https://kawalpemilu.org#23456,"TANJUNG IMAN, BLAMBANGAN PAGAR, LAMPUNG UTARA, LAMPUNG",12,0,0,0
https://kawalpemilu.org#23456,"TANJUNG IMAN, BLAMBANGAN PAGAR, LAMPUNG UTARA, LAMPUNG",14,98,78,176
https://kawalpemilu.org#23456,"TANJUNG IMAN, BLAMBANGAN PAGAR, LAMPUNG UTARA, LAMPUNG",16,0,0,0
https://kawalpemilu.org#23456,"TANJUNG IMAN, BLAMBANGAN PAGAR, LAMPUNG UTARA, LAMPUNG",18,99,115,214
https://kawalpemilu.org#23456,"TANJUNG IMAN, BLAMBANGAN PAGAR, LAMPUNG UTARA, LAMPUNG",20,0,0,0
https://kawalpemilu.org#23456,"TANJUNG IMAN, BLAMBANGAN PAGAR, LAMPUNG UTARA, LAMPUNG",37,108,36,144
https://kawalpemilu.org#23456,"TANJUNG IMAN, BLAMBANGAN PAGAR, LAMPUNG UTARA, LAMPUNG",38,102,44,146
https://kawalpemilu.org#23456,"TANJUNG IMAN, BLAMBANGAN PAGAR, LAMPUNG UTARA, LAMPUNG",44,62,94,156
https://kawalpemilu.org#23456,"TANJUNG IMAN, BLAMBANGAN PAGAR, LAMPUNG UTARA, LAMPUNG",45,8,110,118
https://kawalpemilu.org#23456,"TANJUNG IMAN, BLAMBANGAN PAGAR, LAMPUNG UTARA, LAMPUNG",46,60,98,158
https://kawalpemilu.org#23456,"TANJUNG IMAN, BLAMBANGAN PAGAR, LAMPUNG UTARA, LAMPUNG",49,69,83,152
https://kawalpemilu.org#23456,"TANJUNG IMAN, BLAMBANGAN PAGAR, LAMPUNG UTARA, LAMPUNG",51,99,94,193
https://kawalpemilu.org#23456,"TANJUNG IMAN, BLAMBANGAN PAGAR, LAMPUNG UTARA, LAMPUNG",52,135,118,253
https://kawalpemilu.org#23456,"TANJUNG IMAN, BLAMBANGAN PAGAR, LAMPUNG UTARA, LAMPUNG",53,107,104,211
https://kawalpemilu.org#23456,"TANJUNG IMAN, BLAMBANGAN PAGAR, LAMPUNG UTARA, LAMPUNG",55,114,88,202
https://kawalpemilu.org#23456,"TANJUNG IMAN, BLAMBANGAN PAGAR, LAMPUNG UTARA, LAMPUNG",56,107,36,143
https://kawalpemilu.org#23456,"TANJUNG IMAN, BLAMBANGAN PAGAR, LAMPUNG UTARA, LAMPUNG",57,93,59,152
https://kawalpemilu.org#23457,"PAGAR GADING, BLAMBANGAN PAGAR, LAMPUNG UTARA, LAMPUNG",1,0,0,0
https://kawalpemilu.org#23457,"PAGAR GADING, BLAMBANGAN PAGAR, LAMPUNG UTARA, LAMPUNG",2,0,0,0
https://kawalpemilu.org#23457,"PAGAR GADING, BLAMBANGAN PAGAR, LAMPUNG UTARA, LAMPUNG",3,0,0,0
https://kawalpemilu.org#23457,"PAGAR GADING, BLAMBANGAN PAGAR, LAMPUNG UTARA, LAMPUNG",4,0,0,0
https://kawalpemilu.org#23457,"PAGAR GADING, BLAMBANGAN PAGAR, LAMPUNG UTARA, LAMPUNG",5,0,0,0
https://kawalpemilu.org#23457,"PAGAR GADING, BLAMBANGAN PAGAR, LAMPUNG UTARA, LAMPUNG",31,124,42,166
https://kawalpemilu.org#23457,"PAGAR GADING, BLAMBANGAN PAGAR, LAMPUNG UTARA, LAMPUNG",32,117,44,161
https://kawalpemilu.org#23457,"PAGAR GADING, BLAMBANGAN PAGAR, LAMPUNG UTARA, LAMPUNG",33,162,43,205
https://kawalpemilu.org#23457,"PAGAR GADING, BLAMBANGAN PAGAR, LAMPUNG UTARA, LAMPUNG",34,165,48,213
https://kawalpemilu.org#23457,"PAGAR GADING, BLAMBANGAN PAGAR, LAMPUNG UTARA, LAMPUNG",35,179,34,213
https://kawalpemilu.org#23458,"TULUNG SINGKIP, BLAMBANGAN PAGAR, LAMPUNG UTARA, LAMPUNG",1,158,68,226
https://kawalpemilu.org#23458,"TULUNG SINGKIP, BLAMBANGAN PAGAR, LAMPUNG UTARA, LAMPUNG",2,178,54,232
https://kawalpemilu.org#23458,"TULUNG SINGKIP, BLAMBANGAN PAGAR, LAMPUNG UTARA, LAMPUNG",3,198,33,231
https://kawalpemilu.org#23458,"TULUNG SINGKIP, BLAMBANGAN PAGAR, LAMPUNG UTARA, LAMPUNG",4,212,48,260
https://kawalpemilu.org#23458,"TULUNG SINGKIP, BLAMBANGAN PAGAR, LAMPUNG UTARA, LAMPUNG",61,212,48,260
https://kawalpemilu.org#23459,"BURING KENCANA, BLAMBANGAN PAGAR, LAMPUNG UTARA, LAMPUNG",2,78,40,0
https://kawalpemilu.org#23459,"BURING KENCANA, BLAMBANGAN PAGAR, LAMPUNG UTARA, LAMPUNG",4,70,81,151
https://kawalpemilu.org#23459,"BURING KENCANA, BLAMBANGAN PAGAR, LAMPUNG UTARA, LAMPUNG",11,78,111,189
https://kawalpemilu.org#23459,"BURING KENCANA, BLAMBANGAN PAGAR, LAMPUNG UTARA, LAMPUNG",13,126,70,196
https://kawalpemilu.org#23459,"BURING KENCANA, BLAMBANGAN PAGAR, LAMPUNG UTARA, LAMPUNG",14,70,81,151
https://kawalpemilu.org#23506,"PASAR LIWA, BALIK BUKIT, LAMPUNG BARAT, LAMPUNG",1,85,167,252
https://kawalpemilu.org#23506,"PASAR LIWA, BALIK BUKIT, LAMPUNG BARAT, LAMPUNG",2,51,133,184
https://kawalpemilu.org#23506,"PASAR LIWA, BALIK BUKIT, LAMPUNG BARAT, LAMPUNG",3,51,114,165
https://kawalpemilu.org#23506,"PASAR LIWA, BALIK BUKIT, LAMPUNG BARAT, LAMPUNG",4,89,130,219
https://kawalpemilu.org#23506,"PASAR LIWA, BALIK BUKIT, LAMPUNG BARAT, LAMPUNG",5,64,165,229
https://kawalpemilu.org#23506,"PASAR LIWA, BALIK BUKIT, LAMPUNG BARAT, LAMPUNG",6,86,177,263
https://kawalpemilu.org#23506,"PASAR LIWA, BALIK BUKIT, LAMPUNG BARAT, LAMPUNG",7,103,107,210
https://kawalpemilu.org#23506,"PASAR LIWA, BALIK BUKIT, LAMPUNG BARAT, LAMPUNG",8,150,99,249
https://kawalpemilu.org#23506,"PASAR LIWA, BALIK BUKIT, LAMPUNG BARAT, LAMPUNG",9,92,51,143
https://kawalpemilu.org#23506,"PASAR LIWA, BALIK BUKIT, LAMPUNG BARAT, LAMPUNG",10,74,82,156
https://kawalpemilu.org#23506,"PASAR LIWA, BALIK BUKIT, LAMPUNG BARAT, LAMPUNG",11,55,128,183
https://kawalpemilu.org#23506,"PASAR LIWA, BALIK BUKIT, LAMPUNG BARAT, LAMPUNG",12,47,90,137
https://kawalpemilu.org#23506,"PASAR LIWA, BALIK BUKIT, LAMPUNG BARAT, LAMPUNG",13,61,116,177
https://kawalpemilu.org#23506,"PASAR LIWA, BALIK BUKIT, LAMPUNG BARAT, LAMPUNG",14,71,129,200
https://kawalpemilu.org#23506,"PASAR LIWA, BALIK BUKIT, LAMPUNG BARAT, LAMPUNG",15,106,132,238
https://kawalpemilu.org#23506,"PASAR LIWA, BALIK BUKIT, LAMPUNG BARAT, LAMPUNG",16,92,59,151
https://kawalpemilu.org#23506,"PASAR LIWA, BALIK BUKIT, LAMPUNG BARAT, LAMPUNG",17,59,53,112
https://kawalpemilu.org#23507,"KUBU PERAHU, BALIK BUKIT, LAMPUNG BARAT, LAMPUNG",1,151,82,233
https://kawalpemilu.org#23507,"KUBU PERAHU, BALIK BUKIT, LAMPUNG BARAT, LAMPUNG",2,61,187,248
https://kawalpemilu.org#23507,"KUBU PERAHU, BALIK BUKIT, LAMPUNG BARAT, LAMPUNG",3,115,139,254
https://kawalpemilu.org#23507,"KUBU PERAHU, BALIK BUKIT, LAMPUNG BARAT, LAMPUNG",4,90,102,192
https://kawalpemilu.org#23507,"KUBU PERAHU, BALIK BUKIT, LAMPUNG BARAT, LAMPUNG",5,59,168,227
https://kawalpemilu.org#23508,"WAY MENGAKU, BALIK BUKIT, LAMPUNG BARAT, LAMPUNG",1,119,122,241
https://kawalpemilu.org#23508,"WAY MENGAKU, BALIK BUKIT, LAMPUNG BARAT, LAMPUNG",2,100,111,211
https://kawalpemilu.org#23508,"WAY MENGAKU, BALIK BUKIT, LAMPUNG BARAT, LAMPUNG",3,60,182,242
https://kawalpemilu.org#23508,"WAY MENGAKU, BALIK BUKIT, LAMPUNG BARAT, LAMPUNG",4,57,197,254
https://kawalpemilu.org#23508,"WAY MENGAKU, BALIK BUKIT, LAMPUNG BARAT, LAMPUNG",5,77,174,251
https://kawalpemilu.org#23508,"WAY MENGAKU, BALIK BUKIT, LAMPUNG BARAT, LAMPUNG",6,108,166,274
https://kawalpemilu.org#23508,"WAY MENGAKU, BALIK BUKIT, LAMPUNG BARAT, LAMPUNG",7,96,149,245
https://kawalpemilu.org#23508,"WAY MENGAKU, BALIK BUKIT, LAMPUNG BARAT, LAMPUNG",8,91,140,231
https://kawalpemilu.org#23508,"WAY MENGAKU, BALIK BUKIT, LAMPUNG BARAT, LAMPUNG",9,99,107,206
https://kawalpemilu.org#23508,"WAY MENGAKU, BALIK BUKIT, LAMPUNG BARAT, LAMPUNG",10,109,146,255
https://kawalpemilu.org#23508,"WAY MENGAKU, BALIK BUKIT, LAMPUNG BARAT, LAMPUNG",11,144,72,216
https://kawalpemilu.org#23508,"WAY MENGAKU, BALIK BUKIT, LAMPUNG BARAT, LAMPUNG",12,71,33,104
https://kawalpemilu.org#23508,"WAY MENGAKU, BALIK BUKIT, LAMPUNG BARAT, LAMPUNG",13,61,86,147
https://kawalpemilu.org#23508,"WAY MENGAKU, BALIK BUKIT, LAMPUNG BARAT, LAMPUNG",14,42,68,110
https://kawalpemilu.org#23508,"WAY MENGAKU, BALIK BUKIT, LAMPUNG BARAT, LAMPUNG",15,57,153,210
https://kawalpemilu.org#23508,"WAY MENGAKU, BALIK BUKIT, LAMPUNG BARAT, LAMPUNG",16,56,100,156
https://kawalpemilu.org#23508,"WAY MENGAKU, BALIK BUKIT, LAMPUNG BARAT, LAMPUNG",17,95,129,224
https://kawalpemilu.org#23508,"WAY MENGAKU, BALIK BUKIT, LAMPUNG BARAT, LAMPUNG",18,93,143,236
https://kawalpemilu.org#23508,"WAY MENGAKU, BALIK BUKIT, LAMPUNG BARAT, LAMPUNG",19,39,59,98
https://kawalpemilu.org#23508,"WAY MENGAKU, BALIK BUKIT, LAMPUNG BARAT, LAMPUNG",20,117,89,206
https://kawalpemilu.org#23509,"PADANG CAHYA, BALIK BUKIT, LAMPUNG BARAT, LAMPUNG",1,73,151,224
https://kawalpemilu.org#23509,"PADANG CAHYA, BALIK BUKIT, LAMPUNG BARAT, LAMPUNG",2,46,180,226
https://kawalpemilu.org#23509,"PADANG CAHYA, BALIK BUKIT, LAMPUNG BARAT, LAMPUNG",3,77,125,202
https://kawalpemilu.org#23509,"PADANG CAHYA, BALIK BUKIT, LAMPUNG BARAT, LAMPUNG",4,31,194,225
https://kawalpemilu.org#23509,"PADANG CAHYA, BALIK BUKIT, LAMPUNG BARAT, LAMPUNG",5,83,67,150
https://kawalpemilu.org#23509,"PADANG CAHYA, BALIK BUKIT, LAMPUNG BARAT, LAMPUNG",6,113,46,159
https://kawalpemilu.org#23509,"PADANG CAHYA, BALIK BUKIT, LAMPUNG BARAT, LAMPUNG",7,111,37,148
https://kawalpemilu.org#23509,"PADANG CAHYA, BALIK BUKIT, LAMPUNG BARAT, LAMPUNG",8,115,43,158
https://kawalpemilu.org#23509,"PADANG CAHYA, BALIK BUKIT, LAMPUNG BARAT, LAMPUNG",9,122,58,180
https://kawalpemilu.org#23509,"PADANG CAHYA, BALIK BUKIT, LAMPUNG BARAT, LAMPUNG",10,104,124,228
https://kawalpemilu.org#23509,"PADANG CAHYA, BALIK BUKIT, LAMPUNG BARAT, LAMPUNG",11,100,125,225
https://kawalpemilu.org#23509,"PADANG CAHYA, BALIK BUKIT, LAMPUNG BARAT, LAMPUNG",12,44,154,198
https://kawalpemilu.org#23509,"PADANG CAHYA, BALIK BUKIT, LAMPUNG BARAT, LAMPUNG",13,50,104,154
https://kawalpemilu.org#23509,"PADANG CAHYA, BALIK BUKIT, LAMPUNG BARAT, LAMPUNG",14,35,189,224
https://kawalpemilu.org#23509,"PADANG CAHYA, BALIK BUKIT, LAMPUNG BARAT, LAMPUNG",15,56,85,141
https://kawalpemilu.org#23509,"PADANG CAHYA, BALIK BUKIT, LAMPUNG BARAT, LAMPUNG",16,133,55,188
https://kawalpemilu.org#23509,"PADANG CAHYA, BALIK BUKIT, LAMPUNG BARAT, LAMPUNG",17,100,38,138
https://kawalpemilu.org#23510,"SEBARUS, BALIK BUKIT, LAMPUNG BARAT, LAMPUNG",1,21,170,191
https://kawalpemilu.org#23510,"SEBARUS, BALIK BUKIT, LAMPUNG BARAT, LAMPUNG",2,51,179,230
https://kawalpemilu.org#23510,"SEBARUS, BALIK BUKIT, LAMPUNG BARAT, LAMPUNG",3,62,131,193
https://kawalpemilu.org#23510,"SEBARUS, BALIK BUKIT, LAMPUNG BARAT, LAMPUNG",4,129,85,214
https://kawalpemilu.org#23510,"SEBARUS, BALIK BUKIT, LAMPUNG BARAT, LAMPUNG",5,49,164,213
https://kawalpemilu.org#23510,"SEBARUS, BALIK BUKIT, LAMPUNG BARAT, LAMPUNG",6,19,72,91
https://kawalpemilu.org#23510,"SEBARUS, BALIK BUKIT, LAMPUNG BARAT, LAMPUNG",7,35,131,166
https://kawalpemilu.org#23510,"SEBARUS, BALIK BUKIT, LAMPUNG BARAT, LAMPUNG",8,68,118,186
https://kawalpemilu.org#23510,"SEBARUS, BALIK BUKIT, LAMPUNG BARAT, LAMPUNG",9,50,81,131
https://kawalpemilu.org#23510,"SEBARUS, BALIK BUKIT, LAMPUNG BARAT, LAMPUNG",10,121,82,203
https://kawalpemilu.org#23511,"WAY EMPULAU ULU, BALIK BUKIT, LAMPUNG BARAT, LAMPUNG",1,56,142,198
https://kawalpemilu.org#23511,"WAY EMPULAU ULU, BALIK BUKIT, LAMPUNG BARAT, LAMPUNG",2,47,183,230
https://kawalpemilu.org#23511,"WAY EMPULAU ULU, BALIK BUKIT, LAMPUNG BARAT, LAMPUNG",3,111,68,179
https://kawalpemilu.org#23511,"WAY EMPULAU ULU, BALIK BUKIT, LAMPUNG BARAT, LAMPUNG",4,41,164,205
https://kawalpemilu.org#23511,"WAY EMPULAU ULU, BALIK BUKIT, LAMPUNG BARAT, LAMPUNG",5,34,209,243
https://kawalpemilu.org#23511,"WAY EMPULAU ULU, BALIK BUKIT, LAMPUNG BARAT, LAMPUNG",6,91,114,205
https://kawalpemilu.org#23512,"GUNUNG SUGIH, BALIK BUKIT, LAMPUNG BARAT, LAMPUNG",1,42,184,226
https://kawalpemilu.org#23512,"GUNUNG SUGIH, BALIK BUKIT, LAMPUNG BARAT, LAMPUNG",2,42,221,263
https://kawalpemilu.org#23512,"GUNUNG SUGIH, BALIK BUKIT, LAMPUNG BARAT, LAMPUNG",3,53,184,237
https://kawalpemilu.org#23512,"GUNUNG SUGIH, BALIK BUKIT, LAMPUNG BARAT, LAMPUNG",4,26,159,185
https://kawalpemilu.org#23513,"WATES, BALIK BUKIT, LAMPUNG BARAT, LAMPUNG",1,36,110,146
https://kawalpemilu.org#23513,"WATES, BALIK BUKIT, LAMPUNG BARAT, LAMPUNG",2,32,82,114
https://kawalpemilu.org#23513,"WATES, BALIK BUKIT, LAMPUNG BARAT, LAMPUNG",3,52,209,261
https://kawalpemilu.org#23513,"WATES, BALIK BUKIT, LAMPUNG BARAT, LAMPUNG",4,30,172,202
https://kawalpemilu.org#23513,"WATES, BALIK BUKIT, LAMPUNG BARAT, LAMPUNG",5,27,118,145
https://kawalpemilu.org#23513,"WATES, BALIK BUKIT, LAMPUNG BARAT, LAMPUNG",7,90,107,197
https://kawalpemilu.org#23513,"WATES, BALIK BUKIT, LAMPUNG BARAT, LAMPUNG",8,77,89,166
https://kawalpemilu.org#23514,"PADANG DALOM, BALIK BUKIT, LAMPUNG BARAT, LAMPUNG",1,76,166,242
https://kawalpemilu.org#23514,"PADANG DALOM, BALIK BUKIT, LAMPUNG BARAT, LAMPUNG",2,59,96,155
https://kawalpemilu.org#23514,"PADANG DALOM, BALIK BUKIT, LAMPUNG BARAT, LAMPUNG",3,60,147,207
https://kawalpemilu.org#23514,"PADANG DALOM, BALIK BUKIT, LAMPUNG BARAT, LAMPUNG",4,105,126,231
https://kawalpemilu.org#23515,"SUKARAME, BALIK BUKIT, LAMPUNG BARAT, LAMPUNG",1,20,103,123
https://kawalpemilu.org#23515,"SUKARAME, BALIK BUKIT, LAMPUNG BARAT, LAMPUNG",2,130,112,242
https://kawalpemilu.org#23515,"SUKARAME, BALIK BUKIT, LAMPUNG BARAT, LAMPUNG",3,124,61,185
https://kawalpemilu.org#23515,"SUKARAME, BALIK BUKIT, LAMPUNG BARAT, LAMPUNG",4,115,42,157
https://kawalpemilu.org#23515,"SUKARAME, BALIK BUKIT, LAMPUNG BARAT, LAMPUNG",5,111,102,213
https://kawalpemilu.org#23515,"SUKARAME, BALIK BUKIT, LAMPUNG BARAT, LAMPUNG",6,130,49,179
https://kawalpemilu.org#23515,"SUKARAME, BALIK BUKIT, LAMPUNG BARAT, LAMPUNG",7,75,113,186
https://kawalpemilu.org#23515,"SUKARAME, BALIK BUKIT, LAMPUNG BARAT, LAMPUNG",8,35,118,153
https://kawalpemilu.org#23515,"SUKARAME, BALIK BUKIT, LAMPUNG BARAT, LAMPUNG",9,66,81,147
https://kawalpemilu.org#23515,"SUKARAME, BALIK BUKIT, LAMPUNG BARAT, LAMPUNG",10,108,67,175
https://kawalpemilu.org#23515,"SUKARAME, BALIK BUKIT, LAMPUNG BARAT, LAMPUNG",11,142,45,187
https://kawalpemilu.org#23515,"SUKARAME, BALIK BUKIT, LAMPUNG BARAT, LAMPUNG",12,101,82,183
https://kawalpemilu.org#23516,"BAHWAY, BALIK BUKIT, LAMPUNG BARAT, LAMPUNG",2,132,115,247
https://kawalpemilu.org#23516,"BAHWAY, BALIK BUKIT, LAMPUNG BARAT, LAMPUNG",3,130,134,264
https://kawalpemilu.org#23516,"BAHWAY, BALIK BUKIT, LAMPUNG BARAT, LAMPUNG",4,135,104,239
https://kawalpemilu.org#23516,"BAHWAY, BALIK BUKIT, LAMPUNG BARAT, LAMPUNG",5,192,45,237
https://kawalpemilu.org#23516,"BAHWAY, BALIK BUKIT, LAMPUNG BARAT, LAMPUNG",6,212,34,246
https://kawalpemilu.org#23516,"BAHWAY, BALIK BUKIT, LAMPUNG BARAT, LAMPUNG",7,66,125,191
https://kawalpemilu.org#23516,"BAHWAY, BALIK BUKIT, LAMPUNG BARAT, LAMPUNG",8,116,60,176
https://kawalpemilu.org#23516,"BAHWAY, BALIK BUKIT, LAMPUNG BARAT, LAMPUNG",9,77,114,191
https://kawalpemilu.org#23517,"SEDAMPAH INDAH, BALIK BUKIT, LAMPUNG BARAT, LAMPUNG",1,91,39,130
https://kawalpemilu.org#23517,"SEDAMPAH INDAH, BALIK BUKIT, LAMPUNG BARAT, LAMPUNG",2,133,57,190
https://kawalpemilu.org#23517,"SEDAMPAH INDAH, BALIK BUKIT, LAMPUNG BARAT, LAMPUNG",3,132,79,211
https://kawalpemilu.org#23517,"SEDAMPAH INDAH, BALIK BUKIT, LAMPUNG BARAT, LAMPUNG",4,153,54,207
https://kawalpemilu.org#23519,"SIMPANGSARI, SUMBER JAYA, LAMPUNG BARAT, LAMPUNG",1,71,36,107
https://kawalpemilu.org#23519,"SIMPANGSARI, SUMBER JAYA, LAMPUNG BARAT, LAMPUNG",2,139,91,230
https://kawalpemilu.org#23519,"SIMPANGSARI, SUMBER JAYA, LAMPUNG BARAT, LAMPUNG",3,177,70,247
https://kawalpemilu.org#23519,"SIMPANGSARI, SUMBER JAYA, LAMPUNG BARAT, LAMPUNG",4,129,30,159
https://kawalpemilu.org#23519,"SIMPANGSARI, SUMBER JAYA, LAMPUNG BARAT, LAMPUNG",5,162,40,202
https://kawalpemilu.org#23519,"SIMPANGSARI, SUMBER JAYA, LAMPUNG BARAT, LAMPUNG",6,131,73,204
https://kawalpemilu.org#23519,"SIMPANGSARI, SUMBER JAYA, LAMPUNG BARAT, LAMPUNG",7,88,25,113
https://kawalpemilu.org#23519,"SIMPANGSARI, SUMBER JAYA, LAMPUNG BARAT, LAMPUNG",8,100,47,147
https://kawalpemilu.org#23519,"SIMPANGSARI, SUMBER JAYA, LAMPUNG BARAT, LAMPUNG",9,173,29,202
https://kawalpemilu.org#23520,"TUGU SARI, SUMBER JAYA, LAMPUNG BARAT, LAMPUNG",1,71,76,147
https://kawalpemilu.org#23520,"TUGU SARI, SUMBER JAYA, LAMPUNG BARAT, LAMPUNG",2,80,71,151
https://kawalpemilu.org#23520,"TUGU SARI, SUMBER JAYA, LAMPUNG BARAT, LAMPUNG",3,142,100,242
https://kawalpemilu.org#23520,"TUGU SARI, SUMBER JAYA, LAMPUNG BARAT, LAMPUNG",4,60,106,166
https://kawalpemilu.org#23520,"TUGU SARI, SUMBER JAYA, LAMPUNG BARAT, LAMPUNG",5,69,116,185
https://kawalpemilu.org#23520,"TUGU SARI, SUMBER JAYA, LAMPUNG BARAT, LAMPUNG",6,49,131,180
https://kawalpemilu.org#23520,"TUGU SARI, SUMBER JAYA, LAMPUNG BARAT, LAMPUNG",8,60,127,187
https://kawalpemilu.org#23520,"TUGU SARI, SUMBER JAYA, LAMPUNG BARAT, LAMPUNG",9,154,92,246
https://kawalpemilu.org#23520,"TUGU SARI, SUMBER JAYA, LAMPUNG BARAT, LAMPUNG",10,79,65,144
https://kawalpemilu.org#23520,"TUGU SARI, SUMBER JAYA, LAMPUNG BARAT, LAMPUNG",11,97,64,161
https://kawalpemilu.org#23520,"TUGU SARI, SUMBER JAYA, LAMPUNG BARAT, LAMPUNG",12,70,109,179
https://kawalpemilu.org#23520,"TUGU SARI, SUMBER JAYA, LAMPUNG BARAT, LAMPUNG",13,80,112,192
https://kawalpemilu.org#23520,"TUGU SARI, SUMBER JAYA, LAMPUNG BARAT, LAMPUNG",14,84,88,172
https://kawalpemilu.org#23520,"TUGU SARI, SUMBER JAYA, LAMPUNG BARAT, LAMPUNG",15,98,89,187
https://kawalpemilu.org#23520,"TUGU SARI, SUMBER JAYA, LAMPUNG BARAT, LAMPUNG",16,76,91,167
https://kawalpemilu.org#23520,"TUGU SARI, SUMBER JAYA, LAMPUNG BARAT, LAMPUNG",17,97,75,172
https://kawalpemilu.org#23520,"TUGU SARI, SUMBER JAYA, LAMPUNG BARAT, LAMPUNG",18,89,93,182
https://kawalpemilu.org#23520,"TUGU SARI, SUMBER JAYA, LAMPUNG BARAT, LAMPUNG",19,103,114,217
https://kawalpemilu.org#23520,"TUGU SARI, SUMBER JAYA, LAMPUNG BARAT, LAMPUNG",20,87,126,213
https://kawalpemilu.org#23520,"TUGU SARI, SUMBER JAYA, LAMPUNG BARAT, LAMPUNG",21,40,89,129
https://kawalpemilu.org#23520,"TUGU SARI, SUMBER JAYA, LAMPUNG BARAT, LAMPUNG",22,59,71,130
https://kawalpemilu.org#23522,"SINDANG PAGAR, SUMBER JAYA, LAMPUNG BARAT, LAMPUNG",1,98,78,176
https://kawalpemilu.org#23522,"SINDANG PAGAR, SUMBER JAYA, LAMPUNG BARAT, LAMPUNG",2,62,105,167
https://kawalpemilu.org#23522,"SINDANG PAGAR, SUMBER JAYA, LAMPUNG BARAT, LAMPUNG",3,60,100,160
https://kawalpemilu.org#23522,"SINDANG PAGAR, SUMBER JAYA, LAMPUNG BARAT, LAMPUNG",4,76,88,164
https://kawalpemilu.org#23522,"SINDANG PAGAR, SUMBER JAYA, LAMPUNG BARAT, LAMPUNG",5,93,48,141
https://kawalpemilu.org#23522,"SINDANG PAGAR, SUMBER JAYA, LAMPUNG BARAT, LAMPUNG",6,88,49,137
https://kawalpemilu.org#23522,"SINDANG PAGAR, SUMBER JAYA, LAMPUNG BARAT, LAMPUNG",7,110,18,128
https://kawalpemilu.org#23522,"SINDANG PAGAR, SUMBER JAYA, LAMPUNG BARAT, LAMPUNG",8,115,19,134
https://kawalpemilu.org#23523,"SUKAPURA, SUMBER JAYA, LAMPUNG BARAT, LAMPUNG",1,41,107,148
https://kawalpemilu.org#23523,"SUKAPURA, SUMBER JAYA, LAMPUNG BARAT, LAMPUNG",2,60,132,192
https://kawalpemilu.org#23523,"SUKAPURA, SUMBER JAYA, LAMPUNG BARAT, LAMPUNG",3,67,148,215
https://kawalpemilu.org#23523,"SUKAPURA, SUMBER JAYA, LAMPUNG BARAT, LAMPUNG",4,90,106,196
https://kawalpemilu.org#23523,"SUKAPURA, SUMBER JAYA, LAMPUNG BARAT, LAMPUNG",5,113,114,227
https://kawalpemilu.org#23523,"SUKAPURA, SUMBER JAYA, LAMPUNG BARAT, LAMPUNG",6,97,155,252
https://kawalpemilu.org#23523,"SUKAPURA, SUMBER JAYA, LAMPUNG BARAT, LAMPUNG",7,97,118,215
https://kawalpemilu.org#23523,"SUKAPURA, SUMBER JAYA, LAMPUNG BARAT, LAMPUNG",8,117,82,199
https://kawalpemilu.org#23523,"SUKAPURA, SUMBER JAYA, LAMPUNG BARAT, LAMPUNG",9,60,81,141
https://kawalpemilu.org#23523,"SUKAPURA, SUMBER JAYA, LAMPUNG BARAT, LAMPUNG",10,71,82,153
https://kawalpemilu.org#23523,"SUKAPURA, SUMBER JAYA, LAMPUNG BARAT, LAMPUNG",11,105,71,176
https://kawalpemilu.org#23523,"SUKAPURA, SUMBER JAYA, LAMPUNG BARAT, LAMPUNG",12,122,73,195
https://kawalpemilu.org#23524,"SUKAJAYA, SUMBER JAYA, LAMPUNG BARAT, LAMPUNG",1,76,59,135
https://kawalpemilu.org#23524,"SUKAJAYA, SUMBER JAYA, LAMPUNG BARAT, LAMPUNG",2,79,54,133
https://kawalpemilu.org#23524,"SUKAJAYA, SUMBER JAYA, LAMPUNG BARAT, LAMPUNG",3,82,122,204
https://kawalpemilu.org#23524,"SUKAJAYA, SUMBER JAYA, LAMPUNG BARAT, LAMPUNG",4,80,127,207
https://kawalpemilu.org#23524,"SUKAJAYA, SUMBER JAYA, LAMPUNG BARAT, LAMPUNG",5,121,101,222
https://kawalpemilu.org#23524,"SUKAJAYA, SUMBER JAYA, LAMPUNG BARAT, LAMPUNG",6,98,136,234
https://kawalpemilu.org#23524,"SUKAJAYA, SUMBER JAYA, LAMPUNG BARAT, LAMPUNG",7,129,130,259
https://kawalpemilu.org#23524,"SUKAJAYA, SUMBER JAYA, LAMPUNG BARAT, LAMPUNG",8,175,45,220
https://kawalpemilu.org#87519,"WAY PETAI, SUMBER JAYA, LAMPUNG BARAT, LAMPUNG",1,82,84,166
https://kawalpemilu.org#87519,"WAY PETAI, SUMBER JAYA, LAMPUNG BARAT, LAMPUNG",2,56,79,135
https://kawalpemilu.org#87519,"WAY PETAI, SUMBER JAYA, LAMPUNG BARAT, LAMPUNG",3,73,100,173
https://kawalpemilu.org#87519,"WAY PETAI, SUMBER JAYA, LAMPUNG BARAT, LAMPUNG",4,82,122,204
https://kawalpemilu.org#87519,"WAY PETAI, SUMBER JAYA, LAMPUNG BARAT, LAMPUNG",5,41,89,130
https://kawalpemilu.org#87519,"WAY PETAI, SUMBER JAYA, LAMPUNG BARAT, LAMPUNG",6,31,94,125
https://kawalpemilu.org#87519,"WAY PETAI, SUMBER JAYA, LAMPUNG BARAT, LAMPUNG",7,45,90,135
https://kawalpemilu.org#87519,"WAY PETAI, SUMBER JAYA, LAMPUNG BARAT, LAMPUNG",8,63,119,182
https://kawalpemilu.org#87519,"WAY PETAI, SUMBER JAYA, LAMPUNG BARAT, LAMPUNG",9,59,86,145
https://kawalpemilu.org#87519,"WAY PETAI, SUMBER JAYA, LAMPUNG BARAT, LAMPUNG",10,70,90,160
https://kawalpemilu.org#87519,"WAY PETAI, SUMBER JAYA, LAMPUNG BARAT, LAMPUNG",11,104,62,166
https://kawalpemilu.org#87519,"WAY PETAI, SUMBER JAYA, LAMPUNG BARAT, LAMPUNG",12,90,77,167
https://kawalpemilu.org#87519,"WAY PETAI, SUMBER JAYA, LAMPUNG BARAT, LAMPUNG",13,41,186,227
https://kawalpemilu.org#87519,"WAY PETAI, SUMBER JAYA, LAMPUNG BARAT, LAMPUNG",14,68,120,188
https://kawalpemilu.org#87519,"WAY PETAI, SUMBER JAYA, LAMPUNG BARAT, LAMPUNG",15,112,110,222
https://kawalpemilu.org#87519,"WAY PETAI, SUMBER JAYA, LAMPUNG BARAT, LAMPUNG",16,117,91,208
https://kawalpemilu.org#87519,"WAY PETAI, SUMBER JAYA, LAMPUNG BARAT, LAMPUNG",17,96,95,191
https://kawalpemilu.org#87519,"WAY PETAI, SUMBER JAYA, LAMPUNG BARAT, LAMPUNG",18,144,44,188
https://kawalpemilu.org#23526,"KENALI, BELALAU, LAMPUNG BARAT, LAMPUNG",1,73,164,237
https://kawalpemilu.org#23526,"KENALI, BELALAU, LAMPUNG BARAT, LAMPUNG",2,62,118,180
https://kawalpemilu.org#23526,"KENALI, BELALAU, LAMPUNG BARAT, LAMPUNG",3,52,172,224
https://kawalpemilu.org#23526,"KENALI, BELALAU, LAMPUNG BARAT, LAMPUNG",4,53,156,209
https://kawalpemilu.org#23526,"KENALI, BELALAU, LAMPUNG BARAT, LAMPUNG",5,60,122,182
https://kawalpemilu.org#23526,"KENALI, BELALAU, LAMPUNG BARAT, LAMPUNG",6,58,82,140
https://kawalpemilu.org#23526,"KENALI, BELALAU, LAMPUNG BARAT, LAMPUNG",7,45,135,180
https://kawalpemilu.org#23527,"KEJADIAN, BELALAU, LAMPUNG BARAT, LAMPUNG",1,68,141,209
https://kawalpemilu.org#23527,"KEJADIAN, BELALAU, LAMPUNG BARAT, LAMPUNG",2,45,87,132
https://kawalpemilu.org#23527,"KEJADIAN, BELALAU, LAMPUNG BARAT, LAMPUNG",3,44,81,125
https://kawalpemilu.org#23527,"KEJADIAN, BELALAU, LAMPUNG BARAT, LAMPUNG",4,61,55,116
https://kawalpemilu.org#23528,"BUMI AGUNG, BELALAU, LAMPUNG BARAT, LAMPUNG",1,25,119,144
https://kawalpemilu.org#23528,"BUMI AGUNG, BELALAU, LAMPUNG BARAT, LAMPUNG",2,34,108,142
https://kawalpemilu.org#23528,"BUMI AGUNG, BELALAU, LAMPUNG BARAT, LAMPUNG",3,52,167,219
https://kawalpemilu.org#23529,"TURGAK, BELALAU, LAMPUNG BARAT, LAMPUNG",1,85,125,210
https://kawalpemilu.org#23529,"TURGAK, BELALAU, LAMPUNG BARAT, LAMPUNG",2,65,159,224
https://kawalpemilu.org#23529,"TURGAK, BELALAU, LAMPUNG BARAT, LAMPUNG",3,63,105,168
https://kawalpemilu.org#23530,"BEDUDU, BELALAU, LAMPUNG BARAT, LAMPUNG",1,78,99,177
https://kawalpemilu.org#23530,"BEDUDU, BELALAU, LAMPUNG BARAT, LAMPUNG",2,37,165,202
https://kawalpemilu.org#23530,"BEDUDU, BELALAU, LAMPUNG BARAT, LAMPUNG",3,59,47,106
https://kawalpemilu.org#23530,"BEDUDU, BELALAU, LAMPUNG BARAT, LAMPUNG",4,67,98,165
https://kawalpemilu.org#23530,"BEDUDU, BELALAU, LAMPUNG BARAT, LAMPUNG",5,48,92,140
https://kawalpemilu.org#23531,"SUKARAME, BELALAU, LAMPUNG BARAT, LAMPUNG",1,88,154,242
https://kawalpemilu.org#23531,"SUKARAME, BELALAU, LAMPUNG BARAT, LAMPUNG",2,140,115,255
https://kawalpemilu.org#23531,"SUKARAME, BELALAU, LAMPUNG BARAT, LAMPUNG",3,49,107,156
https://kawalpemilu.org#23532,"HUJUNG, BELALAU, LAMPUNG BARAT, LAMPUNG",1,77,120,197
https://kawalpemilu.org#23532,"HUJUNG, BELALAU, LAMPUNG BARAT, LAMPUNG",2,115,118,233
https://kawalpemilu.org#23532,"HUJUNG, BELALAU, LAMPUNG BARAT, LAMPUNG",3,45,29,74
https://kawalpemilu.org#23532,"HUJUNG, BELALAU, LAMPUNG BARAT, LAMPUNG",4,77,6,83
https://kawalpemilu.org#23532,"HUJUNG, BELALAU, LAMPUNG BARAT, LAMPUNG",5,64,80,144
https://kawalpemilu.org#23532,"HUJUNG, BELALAU, LAMPUNG BARAT, LAMPUNG",6,159,7,166
https://kawalpemilu.org#23532,"HUJUNG, BELALAU, LAMPUNG BARAT, LAMPUNG",7,135,10,145
https://kawalpemilu.org#23532,"HUJUNG, BELALAU, LAMPUNG BARAT, LAMPUNG",8,75,25,100
https://kawalpemilu.org#23532,"HUJUNG, BELALAU, LAMPUNG BARAT, LAMPUNG",9,49,81,130
https://kawalpemilu.org#23532,"HUJUNG, BELALAU, LAMPUNG BARAT, LAMPUNG",10,97,148,245
https://kawalpemilu.org#23532,"HUJUNG, BELALAU, LAMPUNG BARAT, LAMPUNG",11,77,76,153
https://kawalpemilu.org#23532,"HUJUNG, BELALAU, LAMPUNG BARAT, LAMPUNG",12,103,19,122
https://kawalpemilu.org#23533,"SERUNGKUK, BELALAU, LAMPUNG BARAT, LAMPUNG",1,64,125,189
https://kawalpemilu.org#23533,"SERUNGKUK, BELALAU, LAMPUNG BARAT, LAMPUNG",2,64,61,125
https://kawalpemilu.org#23533,"SERUNGKUK, BELALAU, LAMPUNG BARAT, LAMPUNG",3,35,45,80
https://kawalpemilu.org#23535,"FAJAR AGUNG, BELALAU, LAMPUNG BARAT, LAMPUNG",1,104,112,216
https://kawalpemilu.org#84017,"SUKA MAKMUR, BELALAU, LAMPUNG BARAT, LAMPUNG",1,131,55,186
https://kawalpemilu.org#84017,"SUKA MAKMUR, BELALAU, LAMPUNG BARAT, LAMPUNG",2,93,44,137
https://kawalpemilu.org#84017,"SUKA MAKMUR, BELALAU, LAMPUNG BARAT, LAMPUNG",3,80,3,83
https://kawalpemilu.org#84017,"SUKA MAKMUR, BELALAU, LAMPUNG BARAT, LAMPUNG",4,70,16,86
https://kawalpemilu.org#23537,"PAJAR BULAN, WAY TENONG, LAMPUNG BARAT, LAMPUNG",1,114,34,148
https://kawalpemilu.org#23537,"PAJAR BULAN, WAY TENONG, LAMPUNG BARAT, LAMPUNG",2,107,25,132
https://kawalpemilu.org#23537,"PAJAR BULAN, WAY TENONG, LAMPUNG BARAT, LAMPUNG",3,92,180,272
https://kawalpemilu.org#23537,"PAJAR BULAN, WAY TENONG, LAMPUNG BARAT, LAMPUNG",4,110,139,249
https://kawalpemilu.org#23537,"PAJAR BULAN, WAY TENONG, LAMPUNG BARAT, LAMPUNG",5,49,116,165
https://kawalpemilu.org#23537,"PAJAR BULAN, WAY TENONG, LAMPUNG BARAT, LAMPUNG",6,57,108,165
https://kawalpemilu.org#23537,"PAJAR BULAN, WAY TENONG, LAMPUNG BARAT, LAMPUNG",7,35,115,150
https://kawalpemilu.org#23537,"PAJAR BULAN, WAY TENONG, LAMPUNG BARAT, LAMPUNG",8,36,132,168
https://kawalpemilu.org#23537,"PAJAR BULAN, WAY TENONG, LAMPUNG BARAT, LAMPUNG",9,49,144,193
https://kawalpemilu.org#23537,"PAJAR BULAN, WAY TENONG, LAMPUNG BARAT, LAMPUNG",10,84,131,215
https://kawalpemilu.org#23537,"PAJAR BULAN, WAY TENONG, LAMPUNG BARAT, LAMPUNG",11,46,128,174
https://kawalpemilu.org#23537,"PAJAR BULAN, WAY TENONG, LAMPUNG BARAT, LAMPUNG",12,49,123,172
https://kawalpemilu.org#23537,"PAJAR BULAN, WAY TENONG, LAMPUNG BARAT, LAMPUNG",13,46,99,145
https://kawalpemilu.org#23537,"PAJAR BULAN, WAY TENONG, LAMPUNG BARAT, LAMPUNG",14,40,106,146
https://kawalpemilu.org#23537,"PAJAR BULAN, WAY TENONG, LAMPUNG BARAT, LAMPUNG",15,81,139,220
https://kawalpemilu.org#23537,"PAJAR BULAN, WAY TENONG, LAMPUNG BARAT, LAMPUNG",16,72,155,227
https://kawalpemilu.org#23537,"PAJAR BULAN, WAY TENONG, LAMPUNG BARAT, LAMPUNG",17,36,126,162
https://kawalpemilu.org#23537,"PAJAR BULAN, WAY TENONG, LAMPUNG BARAT, LAMPUNG",18,66,96,162
https://kawalpemilu.org#23537,"PAJAR BULAN, WAY TENONG, LAMPUNG BARAT, LAMPUNG",19,26,140,166
https://kawalpemilu.org#23537,"PAJAR BULAN, WAY TENONG, LAMPUNG BARAT, LAMPUNG",20,34,107,141
https://kawalpemilu.org#23537,"PAJAR BULAN, WAY TENONG, LAMPUNG BARAT, LAMPUNG",21,43,160,203
https://kawalpemilu.org#23537,"PAJAR BULAN, WAY TENONG, LAMPUNG BARAT, LAMPUNG",22,63,163,226
https://kawalpemilu.org#23537,"PAJAR BULAN, WAY TENONG, LAMPUNG BARAT, LAMPUNG",23,60,122,182
https://kawalpemilu.org#23537,"PAJAR BULAN, WAY TENONG, LAMPUNG BARAT, LAMPUNG",24,32,117,149
https://kawalpemilu.org#23537,"PAJAR BULAN, WAY TENONG, LAMPUNG BARAT, LAMPUNG",25,88,76,164
https://kawalpemilu.org#23537,"PAJAR BULAN, WAY TENONG, LAMPUNG BARAT, LAMPUNG",26,113,61,174
https://kawalpemilu.org#23537,"PAJAR BULAN, WAY TENONG, LAMPUNG BARAT, LAMPUNG",27,83,71,154
https://kawalpemilu.org#23537,"PAJAR BULAN, WAY TENONG, LAMPUNG BARAT, LAMPUNG",28,159,99,258
https://kawalpemilu.org#23538,"PURALAKSANA, WAY TENONG, LAMPUNG BARAT, LAMPUNG",1,55,126,181
https://kawalpemilu.org#23538,"PURALAKSANA, WAY TENONG, LAMPUNG BARAT, LAMPUNG",2,30,155,185
https://kawalpemilu.org#23538,"PURALAKSANA, WAY TENONG, LAMPUNG BARAT, LAMPUNG",3,69,92,161
https://kawalpemilu.org#23538,"PURALAKSANA, WAY TENONG, LAMPUNG BARAT, LAMPUNG",4,48,98,146
https://kawalpemilu.org#23538,"PURALAKSANA, WAY TENONG, LAMPUNG BARAT, LAMPUNG",5,46,90,136
https://kawalpemilu.org#23538,"PURALAKSANA, WAY TENONG, LAMPUNG BARAT, LAMPUNG",6,37,108,145
https://kawalpemilu.org#23538,"PURALAKSANA, WAY TENONG, LAMPUNG BARAT, LAMPUNG",7,49,115,164
https://kawalpemilu.org#23538,"PURALAKSANA, WAY TENONG, LAMPUNG BARAT, LAMPUNG",8,52,116,168
https://kawalpemilu.org#23538,"PURALAKSANA, WAY TENONG, LAMPUNG BARAT, LAMPUNG",9,129,115,244
https://kawalpemilu.org#23538,"PURALAKSANA, WAY TENONG, LAMPUNG BARAT, LAMPUNG",10,107,131,238
https://kawalpemilu.org#23538,"PURALAKSANA, WAY TENONG, LAMPUNG BARAT, LAMPUNG",11,115,131,246
https://kawalpemilu.org#23538,"PURALAKSANA, WAY TENONG, LAMPUNG BARAT, LAMPUNG",12,95,129,224
https://kawalpemilu.org#23539,"KARANG AGUNG, WAY TENONG, LAMPUNG BARAT, LAMPUNG",1,108,67,175
https://kawalpemilu.org#23539,"KARANG AGUNG, WAY TENONG, LAMPUNG BARAT, LAMPUNG",2,120,117,237
https://kawalpemilu.org#23539,"KARANG AGUNG, WAY TENONG, LAMPUNG BARAT, LAMPUNG",3,61,107,168
https://kawalpemilu.org#23539,"KARANG AGUNG, WAY TENONG, LAMPUNG BARAT, LAMPUNG",4,66,125,191
https://kawalpemilu.org#23539,"KARANG AGUNG, WAY TENONG, LAMPUNG BARAT, LAMPUNG",5,139,73,212
https://kawalpemilu.org#23539,"KARANG AGUNG, WAY TENONG, LAMPUNG BARAT, LAMPUNG",6,147,53,200
https://kawalpemilu.org#23539,"KARANG AGUNG, WAY TENONG, LAMPUNG BARAT, LAMPUNG",7,108,67,175
https://kawalpemilu.org#23540,"MUTAR ALAM, WAY TENONG, LAMPUNG BARAT, LAMPUNG",1,145,60,205
https://kawalpemilu.org#23540,"MUTAR ALAM, WAY TENONG, LAMPUNG BARAT, LAMPUNG",2,164,66,230
https://kawalpemilu.org#23540,"MUTAR ALAM, WAY TENONG, LAMPUNG BARAT, LAMPUNG",3,112,106,218
https://kawalpemilu.org#23540,"MUTAR ALAM, WAY TENONG, LAMPUNG BARAT, LAMPUNG",4,117,110,227
https://kawalpemilu.org#23540,"MUTAR ALAM, WAY TENONG, LAMPUNG BARAT, LAMPUNG",5,59,87,146
https://kawalpemilu.org#23540,"MUTAR ALAM, WAY TENONG, LAMPUNG BARAT, LAMPUNG",6,56,100,156
https://kawalpemilu.org#23540,"MUTAR ALAM, WAY TENONG, LAMPUNG BARAT, LAMPUNG",7,65,92,157
https://kawalpemilu.org#23540,"MUTAR ALAM, WAY TENONG, LAMPUNG BARAT, LAMPUNG",8,59,85,144
https://kawalpemilu.org#23540,"MUTAR ALAM, WAY TENONG, LAMPUNG BARAT, LAMPUNG",9,53,65,118
https://kawalpemilu.org#23540,"MUTAR ALAM, WAY TENONG, LAMPUNG BARAT, LAMPUNG",10,69,51,120
https://kawalpemilu.org#23541,"TANJUNGRAYA, WAY TENONG, LAMPUNG BARAT, LAMPUNG",1,111,28,139
https://kawalpemilu.org#23541,"TANJUNGRAYA, WAY TENONG, LAMPUNG BARAT, LAMPUNG",2,50,75,125
https://kawalpemilu.org#23541,"TANJUNGRAYA, WAY TENONG, LAMPUNG BARAT, LAMPUNG",3,58,95,153
https://kawalpemilu.org#23541,"TANJUNGRAYA, WAY TENONG, LAMPUNG BARAT, LAMPUNG",4,35,111,146
https://kawalpemilu.org#23541,"TANJUNGRAYA, WAY TENONG, LAMPUNG BARAT, LAMPUNG",5,152,39,191
https://kawalpemilu.org#23541,"TANJUNGRAYA, WAY TENONG, LAMPUNG BARAT, LAMPUNG",6,133,42,175
https://kawalpemilu.org#23541,"TANJUNGRAYA, WAY TENONG, LAMPUNG BARAT, LAMPUNG",7,114,13,127
https://kawalpemilu.org#23541,"TANJUNGRAYA, WAY TENONG, LAMPUNG BARAT, LAMPUNG",8,107,9,116
https://kawalpemilu.org#23542,"SUKANANTI, WAY TENONG, LAMPUNG BARAT, LAMPUNG",1,78,134,212
https://kawalpemilu.org#23542,"SUKANANTI, WAY TENONG, LAMPUNG BARAT, LAMPUNG",2,78,155,233
https://kawalpemilu.org#23542,"SUKANANTI, WAY TENONG, LAMPUNG BARAT, LAMPUNG",3,66,124,190
https://kawalpemilu.org#23542,"SUKANANTI, WAY TENONG, LAMPUNG BARAT, LAMPUNG",4,60,114,174
https://kawalpemilu.org#23542,"SUKANANTI, WAY TENONG, LAMPUNG BARAT, LAMPUNG",5,46,110,156
https://kawalpemilu.org#23542,"SUKANANTI, WAY TENONG, LAMPUNG BARAT, LAMPUNG",6,39,149,188
https://kawalpemilu.org#23542,"SUKANANTI, WAY TENONG, LAMPUNG BARAT, LAMPUNG",7,43,157,200
https://kawalpemilu.org#23542,"SUKANANTI, WAY TENONG, LAMPUNG BARAT, LAMPUNG",8,50,80,130
https://kawalpemilu.org#23542,"SUKANANTI, WAY TENONG, LAMPUNG BARAT, LAMPUNG",9,35,79,114
https://kawalpemilu.org#23542,"SUKANANTI, WAY TENONG, LAMPUNG BARAT, LAMPUNG",10,66,106,172
https://kawalpemilu.org#23542,"SUKANANTI, WAY TENONG, LAMPUNG BARAT, LAMPUNG",11,59,84,143
https://kawalpemilu.org#23542,"SUKANANTI, WAY TENONG, LAMPUNG BARAT, LAMPUNG",12,129,20,149
https://kawalpemilu.org#23542,"SUKANANTI, WAY TENONG, LAMPUNG BARAT, LAMPUNG",13,128,14,142
https://kawalpemilu.org#23542,"SUKANANTI, WAY TENONG, LAMPUNG BARAT, LAMPUNG",14,165,18,183
https://kawalpemilu.org#23543,"SUKARAJA, WAY TENONG, LAMPUNG BARAT, LAMPUNG",1,105,130,235
https://kawalpemilu.org#23543,"SUKARAJA, WAY TENONG, LAMPUNG BARAT, LAMPUNG",2,112,120,232
https://kawalpemilu.org#23543,"SUKARAJA, WAY TENONG, LAMPUNG BARAT, LAMPUNG",3,80,58,138
https://kawalpemilu.org#23543,"SUKARAJA, WAY TENONG, LAMPUNG BARAT, LAMPUNG",4,76,55,131
https://kawalpemilu.org#23543,"SUKARAJA, WAY TENONG, LAMPUNG BARAT, LAMPUNG",5,98,117,215
https://kawalpemilu.org#23543,"SUKARAJA, WAY TENONG, LAMPUNG BARAT, LAMPUNG",6,80,130,210
https://kawalpemilu.org#23543,"SUKARAJA, WAY TENONG, LAMPUNG BARAT, LAMPUNG",7,55,73,128
https://kawalpemilu.org#23543,"SUKARAJA, WAY TENONG, LAMPUNG BARAT, LAMPUNG",8,65,75,140
https://kawalpemilu.org#23543,"SUKARAJA, WAY TENONG, LAMPUNG BARAT, LAMPUNG",9,112,49,161
https://kawalpemilu.org#23543,"SUKARAJA, WAY TENONG, LAMPUNG BARAT, LAMPUNG",10,97,57,154
https://kawalpemilu.org#23544,"PADANG TAMBAK, WAY TENONG, LAMPUNG BARAT, LAMPUNG",1,36,116,152
https://kawalpemilu.org#23544,"PADANG TAMBAK, WAY TENONG, LAMPUNG BARAT, LAMPUNG",2,32,127,159
https://kawalpemilu.org#23544,"PADANG TAMBAK, WAY TENONG, LAMPUNG BARAT, LAMPUNG",3,80,94,174
https://kawalpemilu.org#23544,"PADANG TAMBAK, WAY TENONG, LAMPUNG BARAT, LAMPUNG",4,44,102,146
https://kawalpemilu.org#23544,"PADANG TAMBAK, WAY TENONG, LAMPUNG BARAT, LAMPUNG",5,22,90,112
https://kawalpemilu.org#23544,"PADANG TAMBAK, WAY TENONG, LAMPUNG BARAT, LAMPUNG",6,65,57,122
https://kawalpemilu.org#23544,"PADANG TAMBAK, WAY TENONG, LAMPUNG BARAT, LAMPUNG",7,118,62,180
https://kawalpemilu.org#23544,"PADANG TAMBAK, WAY TENONG, LAMPUNG BARAT, LAMPUNG",8,139,44,183
https://kawalpemilu.org#23544,"PADANG TAMBAK, WAY TENONG, LAMPUNG BARAT, LAMPUNG",9,144,55,199
https://kawalpemilu.org#23544,"PADANG TAMBAK, WAY TENONG, LAMPUNG BARAT, LAMPUNG",10,79,66,145
https://kawalpemilu.org#23544,"PADANG TAMBAK, WAY TENONG, LAMPUNG BARAT, LAMPUNG",11,85,63,148
https://kawalpemilu.org#23544,"PADANG TAMBAK, WAY TENONG, LAMPUNG BARAT, LAMPUNG",12,124,36,160
https://kawalpemilu.org#23544,"PADANG TAMBAK, WAY TENONG, LAMPUNG BARAT, LAMPUNG",13,137,40,177
https://kawalpemilu.org#23545,"TAMBAK JAYA, WAY TENONG, LAMPUNG BARAT, LAMPUNG",1,151,59,210
https://kawalpemilu.org#23545,"TAMBAK JAYA, WAY TENONG, LAMPUNG BARAT, LAMPUNG",2,133,66,199
https://kawalpemilu.org#23545,"TAMBAK JAYA, WAY TENONG, LAMPUNG BARAT, LAMPUNG",3,128,54,182
https://kawalpemilu.org#23545,"TAMBAK JAYA, WAY TENONG, LAMPUNG BARAT, LAMPUNG",4,95,73,168
https://kawalpemilu.org#23545,"TAMBAK JAYA, WAY TENONG, LAMPUNG BARAT, LAMPUNG",5,165,52,217
https://kawalpemilu.org#23545,"TAMBAK JAYA, WAY TENONG, LAMPUNG BARAT, LAMPUNG",6,160,73,233
https://kawalpemilu.org#23545,"TAMBAK JAYA, WAY TENONG, LAMPUNG BARAT, LAMPUNG",7,163,47,210
https://kawalpemilu.org#23545,"TAMBAK JAYA, WAY TENONG, LAMPUNG BARAT, LAMPUNG",8,146,55,201
https://kawalpemilu.org#23547,"PAMPANGAN, SEKINCAU, LAMPUNG BARAT, LAMPUNG",1,169,46,215
https://kawalpemilu.org#23547,"PAMPANGAN, SEKINCAU, LAMPUNG BARAT, LAMPUNG",2,173,61,234
https://kawalpemilu.org#23547,"PAMPANGAN, SEKINCAU, LAMPUNG BARAT, LAMPUNG",3,150,50,200
https://kawalpemilu.org#23547,"PAMPANGAN, SEKINCAU, LAMPUNG BARAT, LAMPUNG",4,112,27,139
https://kawalpemilu.org#23547,"PAMPANGAN, SEKINCAU, LAMPUNG BARAT, LAMPUNG",5,86,32,118
https://kawalpemilu.org#23547,"PAMPANGAN, SEKINCAU, LAMPUNG BARAT, LAMPUNG",6,155,39,194
https://kawalpemilu.org#23547,"PAMPANGAN, SEKINCAU, LAMPUNG BARAT, LAMPUNG",7,110,54,164
https://kawalpemilu.org#23547,"PAMPANGAN, SEKINCAU, LAMPUNG BARAT, LAMPUNG",8,100,12,112
https://kawalpemilu.org#23547,"PAMPANGAN, SEKINCAU, LAMPUNG BARAT, LAMPUNG",9,169,42,211
https://kawalpemilu.org#23547,"PAMPANGAN, SEKINCAU, LAMPUNG BARAT, LAMPUNG",10,145,16,161
https://kawalpemilu.org#23547,"PAMPANGAN, SEKINCAU, LAMPUNG BARAT, LAMPUNG",11,80,49,129
https://kawalpemilu.org#23547,"PAMPANGAN, SEKINCAU, LAMPUNG BARAT, LAMPUNG",12,101,43,144
https://kawalpemilu.org#23548,"SEKINCAU, SEKINCAU, LAMPUNG BARAT, LAMPUNG",1,80,105,185
https://kawalpemilu.org#23548,"SEKINCAU, SEKINCAU, LAMPUNG BARAT, LAMPUNG",2,81,87,168
https://kawalpemilu.org#23548,"SEKINCAU, SEKINCAU, LAMPUNG BARAT, LAMPUNG",3,103,65,168
https://kawalpemilu.org#23548,"SEKINCAU, SEKINCAU, LAMPUNG BARAT, LAMPUNG",4,101,65,166
https://kawalpemilu.org#23548,"SEKINCAU, SEKINCAU, LAMPUNG BARAT, LAMPUNG",5,97,64,161
https://kawalpemilu.org#23548,"SEKINCAU, SEKINCAU, LAMPUNG BARAT, LAMPUNG",6,104,65,169
https://kawalpemilu.org#23548,"SEKINCAU, SEKINCAU, LAMPUNG BARAT, LAMPUNG",7,116,69,185
https://kawalpemilu.org#23548,"SEKINCAU, SEKINCAU, LAMPUNG BARAT, LAMPUNG",8,94,115,209
https://kawalpemilu.org#23548,"SEKINCAU, SEKINCAU, LAMPUNG BARAT, LAMPUNG",9,67,140,207
https://kawalpemilu.org#23548,"SEKINCAU, SEKINCAU, LAMPUNG BARAT, LAMPUNG",10,145,85,230
https://kawalpemilu.org#23548,"SEKINCAU, SEKINCAU, LAMPUNG BARAT, LAMPUNG",11,107,39,146
https://kawalpemilu.org#23548,"SEKINCAU, SEKINCAU, LAMPUNG BARAT, LAMPUNG",12,103,43,146
https://kawalpemilu.org#23548,"SEKINCAU, SEKINCAU, LAMPUNG BARAT, LAMPUNG",13,148,57,205
https://kawalpemilu.org#23548,"SEKINCAU, SEKINCAU, LAMPUNG BARAT, LAMPUNG",14,152,56,208
https://kawalpemilu.org#23548,"SEKINCAU, SEKINCAU, LAMPUNG BARAT, LAMPUNG",15,102,30,132
https://kawalpemilu.org#23548,"SEKINCAU, SEKINCAU, LAMPUNG BARAT, LAMPUNG",16,99,41,140
https://kawalpemilu.org#23548,"SEKINCAU, SEKINCAU, LAMPUNG BARAT, LAMPUNG",17,194,29,223
https://kawalpemilu.org#23548,"SEKINCAU, SEKINCAU, LAMPUNG BARAT, LAMPUNG",18,92,94,186
https://kawalpemilu.org#23548,"SEKINCAU, SEKINCAU, LAMPUNG BARAT, LAMPUNG",19,87,48,135
https://kawalpemilu.org#23548,"SEKINCAU, SEKINCAU, LAMPUNG BARAT, LAMPUNG",20,100,51,151
https://kawalpemilu.org#23549,"WASPADA, SEKINCAU, LAMPUNG BARAT, LAMPUNG",1,143,53,196
https://kawalpemilu.org#23549,"WASPADA, SEKINCAU, LAMPUNG BARAT, LAMPUNG",2,150,55,205
https://kawalpemilu.org#23549,"WASPADA, SEKINCAU, LAMPUNG BARAT, LAMPUNG",3,88,97,185
https://kawalpemilu.org#23549,"WASPADA, SEKINCAU, LAMPUNG BARAT, LAMPUNG",4,122,70,192
https://kawalpemilu.org#23549,"WASPADA, SEKINCAU, LAMPUNG BARAT, LAMPUNG",5,152,54,206
https://kawalpemilu.org#23549,"WASPADA, SEKINCAU, LAMPUNG BARAT, LAMPUNG",6,109,94,203
https://kawalpemilu.org#23550,"TIGA JAYA, SEKINCAU, LAMPUNG BARAT, LAMPUNG",1,119,69,188
https://kawalpemilu.org#23550,"TIGA JAYA, SEKINCAU, LAMPUNG BARAT, LAMPUNG",2,140,62,202
https://kawalpemilu.org#23550,"TIGA JAYA, SEKINCAU, LAMPUNG BARAT, LAMPUNG",3,121,31,152
https://kawalpemilu.org#23550,"TIGA JAYA, SEKINCAU, LAMPUNG BARAT, LAMPUNG",4,105,19,124
https://kawalpemilu.org#23550,"TIGA JAYA, SEKINCAU, LAMPUNG BARAT, LAMPUNG",5,99,27,126
https://kawalpemilu.org#23550,"TIGA JAYA, SEKINCAU, LAMPUNG BARAT, LAMPUNG",6,95,49,144
https://kawalpemilu.org#23550,"TIGA JAYA, SEKINCAU, LAMPUNG BARAT, LAMPUNG",7,116,56,172
https://kawalpemilu.org#23550,"TIGA JAYA, SEKINCAU, LAMPUNG BARAT, LAMPUNG",8,137,36,173
https://kawalpemilu.org#23550,"TIGA JAYA, SEKINCAU, LAMPUNG BARAT, LAMPUNG",9,123,10,133
https://kawalpemilu.org#23550,"TIGA JAYA, SEKINCAU, LAMPUNG BARAT, LAMPUNG",10,118,7,125
https://kawalpemilu.org#23551,"GIHAM SUKAMAJU, SEKINCAU, LAMPUNG BARAT, LAMPUNG",1,77,78,155
https://kawalpemilu.org#23551,"GIHAM SUKAMAJU, SEKINCAU, LAMPUNG BARAT, LAMPUNG",2,99,70,169
https://kawalpemilu.org#23551,"GIHAM SUKAMAJU, SEKINCAU, LAMPUNG BARAT, LAMPUNG",3,56,70,126
https://kawalpemilu.org#23551,"GIHAM SUKAMAJU, SEKINCAU, LAMPUNG BARAT, LAMPUNG",4,46,79,125
https://kawalpemilu.org#23551,"GIHAM SUKAMAJU, SEKINCAU, LAMPUNG BARAT, LAMPUNG",5,55,75,130
https://kawalpemilu.org#23551,"GIHAM SUKAMAJU, SEKINCAU, LAMPUNG BARAT, LAMPUNG",6,64,99,163
https://kawalpemilu.org#23551,"GIHAM SUKAMAJU, SEKINCAU, LAMPUNG BARAT, LAMPUNG",7,108,80,188
https://kawalpemilu.org#23551,"GIHAM SUKAMAJU, SEKINCAU, LAMPUNG BARAT, LAMPUNG",8,123,64,187
https://kawalpemilu.org#23551,"GIHAM SUKAMAJU, SEKINCAU, LAMPUNG BARAT, LAMPUNG",9,124,50,174
https://kawalpemilu.org#23551,"GIHAM SUKAMAJU, SEKINCAU, LAMPUNG BARAT, LAMPUNG",10,119,59,178
https://kawalpemilu.org#23551,"GIHAM SUKAMAJU, SEKINCAU, LAMPUNG BARAT, LAMPUNG",11,118,76,194
https://kawalpemilu.org#23551,"GIHAM SUKAMAJU, SEKINCAU, LAMPUNG BARAT, LAMPUNG",12,113,63,176
https://kawalpemilu.org#23551,"GIHAM SUKAMAJU, SEKINCAU, LAMPUNG BARAT, LAMPUNG",13,120,57,177
https://kawalpemilu.org#23551,"GIHAM SUKAMAJU, SEKINCAU, LAMPUNG BARAT, LAMPUNG",14,87,35,122
https://kawalpemilu.org#23551,"GIHAM SUKAMAJU, SEKINCAU, LAMPUNG BARAT, LAMPUNG",15,113,37,150
https://kawalpemilu.org#23551,"GIHAM SUKAMAJU, SEKINCAU, LAMPUNG BARAT, LAMPUNG",16,106,35,141
https://kawalpemilu.org#23551,"GIHAM SUKAMAJU, SEKINCAU, LAMPUNG BARAT, LAMPUNG",17,110,41,151
https://kawalpemilu.org#23553,"SUKAMARGA, SUOH, LAMPUNG BARAT, LAMPUNG",2,92,99,191
https://kawalpemilu.org#23553,"SUKAMARGA, SUOH, LAMPUNG BARAT, LAMPUNG",3,95,73,168
https://kawalpemilu.org#23553,"SUKAMARGA, SUOH, LAMPUNG BARAT, LAMPUNG",4,88,107,195
https://kawalpemilu.org#23553,"SUKAMARGA, SUOH, LAMPUNG BARAT, LAMPUNG",5,86,83,169
https://kawalpemilu.org#23553,"SUKAMARGA, SUOH, LAMPUNG BARAT, LAMPUNG",6,101,71,172
https://kawalpemilu.org#23553,"SUKAMARGA, SUOH, LAMPUNG BARAT, LAMPUNG",7,110,54,164
https://kawalpemilu.org#23553,"SUKAMARGA, SUOH, LAMPUNG BARAT, LAMPUNG",8,136,47,183
https://kawalpemilu.org#23553,"SUKAMARGA, SUOH, LAMPUNG BARAT, LAMPUNG",9,202,47,249
https://kawalpemilu.org#23554,"SUMBER AGUNG, SUOH, LAMPUNG BARAT, LAMPUNG",1,135,65,200
https://kawalpemilu.org#23554,"SUMBER AGUNG, SUOH, LAMPUNG BARAT, LAMPUNG",2,129,65,194
https://kawalpemilu.org#23554,"SUMBER AGUNG, SUOH, LAMPUNG BARAT, LAMPUNG",3,152,26,178
https://kawalpemilu.org#23554,"SUMBER AGUNG, SUOH, LAMPUNG BARAT, LAMPUNG",4,135,31,166
https://kawalpemilu.org#23554,"SUMBER AGUNG, SUOH, LAMPUNG BARAT, LAMPUNG",5,155,44,199
https://kawalpemilu.org#23554,"SUMBER AGUNG, SUOH, LAMPUNG BARAT, LAMPUNG",6,151,61,212
https://kawalpemilu.org#23554,"SUMBER AGUNG, SUOH, LAMPUNG BARAT, LAMPUNG",7,121,54,175
https://kawalpemilu.org#23554,"SUMBER AGUNG, SUOH, LAMPUNG BARAT, LAMPUNG",8,150,71,221
https://kawalpemilu.org#23555,"TUGURATU, SUOH, LAMPUNG BARAT, LAMPUNG",1,217,37,254
https://kawalpemilu.org#23555,"TUGURATU, SUOH, LAMPUNG BARAT, LAMPUNG",2,210,55,265
https://kawalpemilu.org#23555,"TUGURATU, SUOH, LAMPUNG BARAT, LAMPUNG",3,175,48,223
https://kawalpemilu.org#23555,"TUGURATU, SUOH, LAMPUNG BARAT, LAMPUNG",4,140,84,224
https://kawalpemilu.org#23555,"TUGURATU, SUOH, LAMPUNG BARAT, LAMPUNG",5,178,40,218
https://kawalpemilu.org#23555,"TUGURATU, SUOH, LAMPUNG BARAT, LAMPUNG",6,174,66,240
https://kawalpemilu.org#23555,"TUGURATU, SUOH, LAMPUNG BARAT, LAMPUNG",7,130,69,199
https://kawalpemilu.org#23555,"TUGURATU, SUOH, LAMPUNG BARAT, LAMPUNG",8,198,34,232
https://kawalpemilu.org#23555,"TUGURATU, SUOH, LAMPUNG BARAT, LAMPUNG",9,130,69,199
https://kawalpemilu.org#23555,"TUGURATU, SUOH, LAMPUNG BARAT, LAMPUNG",10,128,58,186
https://kawalpemilu.org#23555,"TUGURATU, SUOH, LAMPUNG BARAT, LAMPUNG",11,104,71,175
https://kawalpemilu.org#23555,"TUGURATU, SUOH, LAMPUNG BARAT, LAMPUNG",12,213,45,258
https://kawalpemilu.org#23555,"TUGURATU, SUOH, LAMPUNG BARAT, LAMPUNG",13,175,54,229
https://kawalpemilu.org#23556,"BANDING AGUNG, SUOH, LAMPUNG BARAT, LAMPUNG",1,113,83,196
https://kawalpemilu.org#23556,"BANDING AGUNG, SUOH, LAMPUNG BARAT, LAMPUNG",2,108,81,189
https://kawalpemilu.org#23556,"BANDING AGUNG, SUOH, LAMPUNG BARAT, LAMPUNG",3,174,29,203
https://kawalpemilu.org#23556,"BANDING AGUNG, SUOH, LAMPUNG BARAT, LAMPUNG",4,133,40,173
https://kawalpemilu.org#23556,"BANDING AGUNG, SUOH, LAMPUNG BARAT, LAMPUNG",5,80,64,144
https://kawalpemilu.org#23556,"BANDING AGUNG, SUOH, LAMPUNG BARAT, LAMPUNG",6,63,39,102
https://kawalpemilu.org#23556,"BANDING AGUNG, SUOH, LAMPUNG BARAT, LAMPUNG",7,132,107,239
https://kawalpemilu.org#23556,"BANDING AGUNG, SUOH, LAMPUNG BARAT, LAMPUNG",8,187,76,263
https://kawalpemilu.org#23556,"BANDING AGUNG, SUOH, LAMPUNG BARAT, LAMPUNG",9,131,27,158
https://kawalpemilu.org#23557,"ROWOREJO, SUOH, LAMPUNG BARAT, LAMPUNG",1,135,25,160
https://kawalpemilu.org#23557,"ROWOREJO, SUOH, LAMPUNG BARAT, LAMPUNG",2,123,80,203
https://kawalpemilu.org#23557,"ROWOREJO, SUOH, LAMPUNG BARAT, LAMPUNG",3,91,53,144
https://kawalpemilu.org#23557,"ROWOREJO, SUOH, LAMPUNG BARAT, LAMPUNG",4,77,41,118
https://kawalpemilu.org#23557,"ROWOREJO, SUOH, LAMPUNG BARAT, LAMPUNG",5,218,20,238
https://kawalpemilu.org#23557,"ROWOREJO, SUOH, LAMPUNG BARAT, LAMPUNG",6,207,21,228
https://kawalpemilu.org#23557,"ROWOREJO, SUOH, LAMPUNG BARAT, LAMPUNG",7,205,59,264
https://kawalpemilu.org#23557,"ROWOREJO, SUOH, LAMPUNG BARAT, LAMPUNG",8,197,49,246
https://kawalpemilu.org#23557,"ROWOREJO, SUOH, LAMPUNG BARAT, LAMPUNG",9,171,47,218
https://kawalpemilu.org#23559,"SIDOREJO, SUOH, LAMPUNG BARAT, LAMPUNG",1,112,40,152
https://kawalpemilu.org#23559,"SIDOREJO, SUOH, LAMPUNG BARAT, LAMPUNG",2,118,30,148
https://kawalpemilu.org#23559,"SIDOREJO, SUOH, LAMPUNG BARAT, LAMPUNG",3,107,50,157
https://kawalpemilu.org#23559,"SIDOREJO, SUOH, LAMPUNG BARAT, LAMPUNG",4,130,29,159
https://kawalpemilu.org#23559,"SIDOREJO, SUOH, LAMPUNG BARAT, LAMPUNG",5,89,31,120
https://kawalpemilu.org#23559,"SIDOREJO, SUOH, LAMPUNG BARAT, LAMPUNG",6,161,27,188
https://kawalpemilu.org#23560,"RINGIN SARI, SUOH, LAMPUNG BARAT, LAMPUNG",1,219,47,266
https://kawalpemilu.org#23560,"RINGIN SARI, SUOH, LAMPUNG BARAT, LAMPUNG",2,196,59,255
https://kawalpemilu.org#23560,"RINGIN SARI, SUOH, LAMPUNG BARAT, LAMPUNG",3,170,53,223
https://kawalpemilu.org#23560,"RINGIN SARI, SUOH, LAMPUNG BARAT, LAMPUNG",4,186,81,267
https://kawalpemilu.org#23562,"KEMBAHANG, BATU BRAK, LAMPUNG BARAT, LAMPUNG",1,62,173,235
https://kawalpemilu.org#23562,"KEMBAHANG, BATU BRAK, LAMPUNG BARAT, LAMPUNG",2,24,163,187
https://kawalpemilu.org#23562,"KEMBAHANG, BATU BRAK, LAMPUNG BARAT, LAMPUNG",3,62,173,235
https://kawalpemilu.org#23562,"KEMBAHANG, BATU BRAK, LAMPUNG BARAT, LAMPUNG",4,51,38,89
https://kawalpemilu.org#23562,"KEMBAHANG, BATU BRAK, LAMPUNG BARAT, LAMPUNG",5,64,90,154
https://kawalpemilu.org#23562,"KEMBAHANG, BATU BRAK, LAMPUNG BARAT, LAMPUNG",6,42,167,209
https://kawalpemilu.org#23562,"KEMBAHANG, BATU BRAK, LAMPUNG BARAT, LAMPUNG",7,28,115,143
https://kawalpemilu.org#23562,"KEMBAHANG, BATU BRAK, LAMPUNG BARAT, LAMPUNG",8,20,119,139
https://kawalpemilu.org#23562,"KEMBAHANG, BATU BRAK, LAMPUNG BARAT, LAMPUNG",9,43,99,142
https://kawalpemilu.org#23563,"NEGERI RATU, BATU BRAK, LAMPUNG BARAT, LAMPUNG",1,35,151,186
https://kawalpemilu.org#23563,"NEGERI RATU, BATU BRAK, LAMPUNG BARAT, LAMPUNG",2,147,33,180
https://kawalpemilu.org#23563,"NEGERI RATU, BATU BRAK, LAMPUNG BARAT, LAMPUNG",3,32,196,228
https://kawalpemilu.org#23564,"KEGERINGAN, BATU BRAK, LAMPUNG BARAT, LAMPUNG",1,30,154,184
https://kawalpemilu.org#23564,"KEGERINGAN, BATU BRAK, LAMPUNG BARAT, LAMPUNG",2,41,140,181
https://kawalpemilu.org#23564,"KEGERINGAN, BATU BRAK, LAMPUNG BARAT, LAMPUNG",3,136,78,214
https://kawalpemilu.org#23564,"KEGERINGAN, BATU BRAK, LAMPUNG BARAT, LAMPUNG",4,50,147,197
https://kawalpemilu.org#23564,"KEGERINGAN, BATU BRAK, LAMPUNG BARAT, LAMPUNG",5,48,142,190
https://kawalpemilu.org#23565,"GUNUNG SUGIH, BATU BRAK, LAMPUNG BARAT, LAMPUNG",1,53,193,246
https://kawalpemilu.org#23565,"GUNUNG SUGIH, BATU BRAK, LAMPUNG BARAT, LAMPUNG",2,93,125,218
https://kawalpemilu.org#23566,"PEKON BALAK, BATU BRAK, LAMPUNG BARAT, LAMPUNG",1,90,148,238
https://kawalpemilu.org#23566,"PEKON BALAK, BATU BRAK, LAMPUNG BARAT, LAMPUNG",2,54,119,173
https://kawalpemilu.org#23566,"PEKON BALAK, BATU BRAK, LAMPUNG BARAT, LAMPUNG",3,88,74,162
https://kawalpemilu.org#23566,"PEKON BALAK, BATU BRAK, LAMPUNG BARAT, LAMPUNG",4,52,94,146
https://kawalpemilu.org#23567,"SUKABUMI, BATU BRAK, LAMPUNG BARAT, LAMPUNG",1,62,115,177
https://kawalpemilu.org#23567,"SUKABUMI, BATU BRAK, LAMPUNG BARAT, LAMPUNG",2,90,86,176
https://kawalpemilu.org#23567,"SUKABUMI, BATU BRAK, LAMPUNG BARAT, LAMPUNG",3,146,53,199
https://kawalpemilu.org#23567,"SUKABUMI, BATU BRAK, LAMPUNG BARAT, LAMPUNG",4,215,18,233
https://kawalpemilu.org#23567,"SUKABUMI, BATU BRAK, LAMPUNG BARAT, LAMPUNG",5,48,103,151
https://kawalpemilu.org#23567,"SUKABUMI, BATU BRAK, LAMPUNG BARAT, LAMPUNG",6,91,91,182
https://kawalpemilu.org#23568,"CANGGU, BATU BRAK, LAMPUNG BARAT, LAMPUNG",1,81,138,219
https://kawalpemilu.org#23568,"CANGGU, BATU BRAK, LAMPUNG BARAT, LAMPUNG",2,87,102,189
https://kawalpemilu.org#23568,"CANGGU, BATU BRAK, LAMPUNG BARAT, LAMPUNG",3,66,134,200
https://kawalpemilu.org#23569,"KOTA BESI, BATU BRAK, LAMPUNG BARAT, LAMPUNG",1,62,181,243
https://kawalpemilu.org#23569,"KOTA BESI, BATU BRAK, LAMPUNG BARAT, LAMPUNG",2,39,113,152
https://kawalpemilu.org#23569,"KOTA BESI, BATU BRAK, LAMPUNG BARAT, LAMPUNG",3,90,33,123
https://kawalpemilu.org#23569,"KOTA BESI, BATU BRAK, LAMPUNG BARAT, LAMPUNG",4,70,119,189
https://kawalpemilu.org#23569,"KOTA BESI, BATU BRAK, LAMPUNG BARAT, LAMPUNG",5,41,117,158
https://kawalpemilu.org#23569,"KOTA BESI, BATU BRAK, LAMPUNG BARAT, LAMPUNG",6,65,169,234
https://kawalpemilu.org#23569,"KOTA BESI, BATU BRAK, LAMPUNG BARAT, LAMPUNG",7,30,167,197
https://kawalpemilu.org#23569,"KOTA BESI, BATU BRAK, LAMPUNG BARAT, LAMPUNG",8,149,43,192
https://kawalpemilu.org#23569,"KOTA BESI, BATU BRAK, LAMPUNG BARAT, LAMPUNG",9,69,71,140
https://kawalpemilu.org#23569,"KOTA BESI, BATU BRAK, LAMPUNG BARAT, LAMPUNG",10,24,88,112
https://kawalpemilu.org#23570,"SUKARAJA, BATU BRAK, LAMPUNG BARAT, LAMPUNG",1,58,166,224
https://kawalpemilu.org#23570,"SUKARAJA, BATU BRAK, LAMPUNG BARAT, LAMPUNG",2,32,124,156
https://kawalpemilu.org#23571,"KERANG, BATU BRAK, LAMPUNG BARAT, LAMPUNG",1,47,165,212
https://kawalpemilu.org#23572,"TEBA LIYOKH, BATU BRAK, LAMPUNG BARAT, LAMPUNG",1,103,42,145
https://kawalpemilu.org#23572,"TEBA LIYOKH, BATU BRAK, LAMPUNG BARAT, LAMPUNG",2,129,29,158
https://kawalpemilu.org#23574,"TANJUNGRAYA, SUKAU, LAMPUNG BARAT, LAMPUNG",1,111,81,192
https://kawalpemilu.org#23574,"TANJUNGRAYA, SUKAU, LAMPUNG BARAT, LAMPUNG",2,88,87,175
https://kawalpemilu.org#23574,"TANJUNGRAYA, SUKAU, LAMPUNG BARAT, LAMPUNG",3,39,120,159
https://kawalpemilu.org#23574,"TANJUNGRAYA, SUKAU, LAMPUNG BARAT, LAMPUNG",4,71,114,185
https://kawalpemilu.org#23574,"TANJUNGRAYA, SUKAU, LAMPUNG BARAT, LAMPUNG",5,91,118,209
https://kawalpemilu.org#23574,"TANJUNGRAYA, SUKAU, LAMPUNG BARAT, LAMPUNG",6,71,100,171
https://kawalpemilu.org#23574,"TANJUNGRAYA, SUKAU, LAMPUNG BARAT, LAMPUNG",7,90,113,203
https://kawalpemilu.org#23574,"TANJUNGRAYA, SUKAU, LAMPUNG BARAT, LAMPUNG",8,79,94,173
https://kawalpemilu.org#23574,"TANJUNGRAYA, SUKAU, LAMPUNG BARAT, LAMPUNG",9,87,88,175
https://kawalpemilu.org#23574,"TANJUNGRAYA, SUKAU, LAMPUNG BARAT, LAMPUNG",10,100,94,194
https://kawalpemilu.org#23574,"TANJUNGRAYA, SUKAU, LAMPUNG BARAT, LAMPUNG",11,176,104,280
https://kawalpemilu.org#23574,"TANJUNGRAYA, SUKAU, LAMPUNG BARAT, LAMPUNG",12,152,65,217
https://kawalpemilu.org#23574,"TANJUNGRAYA, SUKAU, LAMPUNG BARAT, LAMPUNG",13,122,85,207
https://kawalpemilu.org#23574,"TANJUNGRAYA, SUKAU, LAMPUNG BARAT, LAMPUNG",14,119,96,215
https://kawalpemilu.org#23574,"TANJUNGRAYA, SUKAU, LAMPUNG BARAT, LAMPUNG",15,128,86,214
https://kawalpemilu.org#23574,"TANJUNGRAYA, SUKAU, LAMPUNG BARAT, LAMPUNG",16,95,104,199
https://kawalpemilu.org#23574,"TANJUNGRAYA, SUKAU, LAMPUNG BARAT, LAMPUNG",17,74,70,144
https://kawalpemilu.org#23574,"TANJUNGRAYA, SUKAU, LAMPUNG BARAT, LAMPUNG",18,91,44,135
https://kawalpemilu.org#23575,"HANAKAU, SUKAU, LAMPUNG BARAT, LAMPUNG",1,105,124,229
https://kawalpemilu.org#23575,"HANAKAU, SUKAU, LAMPUNG BARAT, LAMPUNG",2,139,96,235
https://kawalpemilu.org#23575,"HANAKAU, SUKAU, LAMPUNG BARAT, LAMPUNG",3,108,47,155
https://kawalpemilu.org#23575,"HANAKAU, SUKAU, LAMPUNG BARAT, LAMPUNG",4,63,64,127
https://kawalpemilu.org#23575,"HANAKAU, SUKAU, LAMPUNG BARAT, LAMPUNG",5,134,53,187
https://kawalpemilu.org#23575,"HANAKAU, SUKAU, LAMPUNG BARAT, LAMPUNG",6,85,85,170
https://kawalpemilu.org#23575,"HANAKAU, SUKAU, LAMPUNG BARAT, LAMPUNG",7,104,37,141
https://kawalpemilu.org#23575,"HANAKAU, SUKAU, LAMPUNG BARAT, LAMPUNG",8,143,39,182
https://kawalpemilu.org#23575,"HANAKAU, SUKAU, LAMPUNG BARAT, LAMPUNG",9,99,17,116
https://kawalpemilu.org#23575,"HANAKAU, SUKAU, LAMPUNG BARAT, LAMPUNG",10,179,75,254
https://kawalpemilu.org#23575,"HANAKAU, SUKAU, LAMPUNG BARAT, LAMPUNG",11,115,32,147
https://kawalpemilu.org#23575,"HANAKAU, SUKAU, LAMPUNG BARAT, LAMPUNG",12,35,101,136
https://kawalpemilu.org#23575,"HANAKAU, SUKAU, LAMPUNG BARAT, LAMPUNG",13,69,91,160
https://kawalpemilu.org#23576,"BUAY NYERUPA, SUKAU, LAMPUNG BARAT, LAMPUNG",1,51,182,233
https://kawalpemilu.org#23576,"BUAY NYERUPA, SUKAU, LAMPUNG BARAT, LAMPUNG",2,41,195,236
https://kawalpemilu.org#23576,"BUAY NYERUPA, SUKAU, LAMPUNG BARAT, LAMPUNG",3,26,133,159
https://kawalpemilu.org#23576,"BUAY NYERUPA, SUKAU, LAMPUNG BARAT, LAMPUNG",4,25,137,162
https://kawalpemilu.org#23576,"BUAY NYERUPA, SUKAU, LAMPUNG BARAT, LAMPUNG",5,33,102,135
https://kawalpemilu.org#23576,"BUAY NYERUPA, SUKAU, LAMPUNG BARAT, LAMPUNG",6,46,90,136
https://kawalpemilu.org#23576,"BUAY NYERUPA, SUKAU, LAMPUNG BARAT, LAMPUNG",7,78,149,227
https://kawalpemilu.org#23576,"BUAY NYERUPA, SUKAU, LAMPUNG BARAT, LAMPUNG",8,48,100,148
https://kawalpemilu.org#23576,"BUAY NYERUPA, SUKAU, LAMPUNG BARAT, LAMPUNG",9,81,162,243
https://kawalpemilu.org#23576,"BUAY NYERUPA, SUKAU, LAMPUNG BARAT, LAMPUNG",10,89,51,140
https://kawalpemilu.org#23577,"TAPAK SIRING, SUKAU, LAMPUNG BARAT, LAMPUNG",1,18,99,117
https://kawalpemilu.org#23577,"TAPAK SIRING, SUKAU, LAMPUNG BARAT, LAMPUNG",2,18,102,120
https://kawalpemilu.org#23577,"TAPAK SIRING, SUKAU, LAMPUNG BARAT, LAMPUNG",3,115,31,146
https://kawalpemilu.org#23577,"TAPAK SIRING, SUKAU, LAMPUNG BARAT, LAMPUNG",4,107,45,152
https://kawalpemilu.org#23577,"TAPAK SIRING, SUKAU, LAMPUNG BARAT, LAMPUNG",5,196,44,240
https://kawalpemilu.org#23577,"TAPAK SIRING, SUKAU, LAMPUNG BARAT, LAMPUNG",6,41,130,171
https://kawalpemilu.org#23577,"TAPAK SIRING, SUKAU, LAMPUNG BARAT, LAMPUNG",7,56,122,178
https://kawalpemilu.org#23578,"JAGA RAGA, SUKAU, LAMPUNG BARAT, LAMPUNG",1,66,157,223
https://kawalpemilu.org#23578,"JAGA RAGA, SUKAU, LAMPUNG BARAT, LAMPUNG",2,41,105,146
https://kawalpemilu.org#23578,"JAGA RAGA, SUKAU, LAMPUNG BARAT, LAMPUNG",3,62,133,195
https://kawalpemilu.org#23578,"JAGA RAGA, SUKAU, LAMPUNG BARAT, LAMPUNG",4,69,129,198
https://kawalpemilu.org#23579,"PAGAR DEWA, SUKAU, LAMPUNG BARAT, LAMPUNG",1,39,104,143
https://kawalpemilu.org#23579,"PAGAR DEWA, SUKAU, LAMPUNG BARAT, LAMPUNG",2,56,106,162
https://kawalpemilu.org#23579,"PAGAR DEWA, SUKAU, LAMPUNG BARAT, LAMPUNG",3,56,98,154
https://kawalpemilu.org#23579,"PAGAR DEWA, SUKAU, LAMPUNG BARAT, LAMPUNG",4,45,120,165
https://kawalpemilu.org#23579,"PAGAR DEWA, SUKAU, LAMPUNG BARAT, LAMPUNG",5,67,154,221
https://kawalpemilu.org#23579,"PAGAR DEWA, SUKAU, LAMPUNG BARAT, LAMPUNG",6,58,167,225
https://kawalpemilu.org#23579,"PAGAR DEWA, SUKAU, LAMPUNG BARAT, LAMPUNG",7,65,114,179
https://kawalpemilu.org#23579,"PAGAR DEWA, SUKAU, LAMPUNG BARAT, LAMPUNG",8,97,102,199
https://kawalpemilu.org#23579,"PAGAR DEWA, SUKAU, LAMPUNG BARAT, LAMPUNG",9,65,104,166
https://kawalpemilu.org#23580,"SUKA MULYA, SUKAU, LAMPUNG BARAT, LAMPUNG",1,106,141,247
https://kawalpemilu.org#23580,"SUKA MULYA, SUKAU, LAMPUNG BARAT, LAMPUNG",2,80,145,225
https://kawalpemilu.org#23580,"SUKA MULYA, SUKAU, LAMPUNG BARAT, LAMPUNG",3,19,116,135
https://kawalpemilu.org#23580,"SUKA MULYA, SUKAU, LAMPUNG BARAT, LAMPUNG",4,36,106,142
https://kawalpemilu.org#23581,"BANDAR BARU, SUKAU, LAMPUNG BARAT, LAMPUNG",1,110,104,214
https://kawalpemilu.org#23581,"BANDAR BARU, SUKAU, LAMPUNG BARAT, LAMPUNG",2,105,27,132
https://kawalpemilu.org#23581,"BANDAR BARU, SUKAU, LAMPUNG BARAT, LAMPUNG",3,99,85,184
https://kawalpemilu.org#23581,"BANDAR BARU, SUKAU, LAMPUNG BARAT, LAMPUNG",4,151,27,178
https://kawalpemilu.org#23581,"BANDAR BARU, SUKAU, LAMPUNG BARAT, LAMPUNG",5,116,27,143
https://kawalpemilu.org#23582,"BUMI JAYA, SUKAU, LAMPUNG BARAT, LAMPUNG",1,42,202,244
https://kawalpemilu.org#23582,"BUMI JAYA, SUKAU, LAMPUNG BARAT, LAMPUNG",2,43,149,192
https://kawalpemilu.org#23582,"BUMI JAYA, SUKAU, LAMPUNG BARAT, LAMPUNG",3,61,17,78
https://kawalpemilu.org#23583,"TEBA PERING JAYA, SUKAU, LAMPUNG BARAT, LAMPUNG",1,26,134,160
https://kawalpemilu.org#23583,"TEBA PERING JAYA, SUKAU, LAMPUNG BARAT, LAMPUNG",2,28,115,143
https://kawalpemilu.org#23583,"TEBA PERING JAYA, SUKAU, LAMPUNG BARAT, LAMPUNG",3,35,132,167
https://kawalpemilu.org#23583,"TEBA PERING JAYA, SUKAU, LAMPUNG BARAT, LAMPUNG",4,68,100,168
https://kawalpemilu.org#23622,"CIPTA WARAS, GEDUNG SURIAN, LAMPUNG BARAT, LAMPUNG",1,86,126,212
https://kawalpemilu.org#23622,"CIPTA WARAS, GEDUNG SURIAN, LAMPUNG BARAT, LAMPUNG",2,139,119,258
https://kawalpemilu.org#23622,"CIPTA WARAS, GEDUNG SURIAN, LAMPUNG BARAT, LAMPUNG",3,176,84,260
https://kawalpemilu.org#23622,"CIPTA WARAS, GEDUNG SURIAN, LAMPUNG BARAT, LAMPUNG",4,86,132,218
https://kawalpemilu.org#23622,"CIPTA WARAS, GEDUNG SURIAN, LAMPUNG BARAT, LAMPUNG",5,156,108,264
https://kawalpemilu.org#23622,"CIPTA WARAS, GEDUNG SURIAN, LAMPUNG BARAT, LAMPUNG",6,123,78,201
https://kawalpemilu.org#23623,"GEDUNG SURIAN, GEDUNG SURIAN, LAMPUNG BARAT, LAMPUNG",1,142,63,205
https://kawalpemilu.org#23623,"GEDUNG SURIAN, GEDUNG SURIAN, LAMPUNG BARAT, LAMPUNG",2,111,70,181
https://kawalpemilu.org#23623,"GEDUNG SURIAN, GEDUNG SURIAN, LAMPUNG BARAT, LAMPUNG",3,128,55,183
https://kawalpemilu.org#23623,"GEDUNG SURIAN, GEDUNG SURIAN, LAMPUNG BARAT, LAMPUNG",4,174,80,254
https://kawalpemilu.org#23623,"GEDUNG SURIAN, GEDUNG SURIAN, LAMPUNG BARAT, LAMPUNG",5,134,56,190
https://kawalpemilu.org#23623,"GEDUNG SURIAN, GEDUNG SURIAN, LAMPUNG BARAT, LAMPUNG",6,198,49,247
https://kawalpemilu.org#23623,"GEDUNG SURIAN, GEDUNG SURIAN, LAMPUNG BARAT, LAMPUNG",7,93,32,125
https://kawalpemilu.org#23623,"GEDUNG SURIAN, GEDUNG SURIAN, LAMPUNG BARAT, LAMPUNG",8,122,36,158
https://kawalpemilu.org#23623,"GEDUNG SURIAN, GEDUNG SURIAN, LAMPUNG BARAT, LAMPUNG",9,122,87,209
https://kawalpemilu.org#23624,"PURA MEKAR, GEDUNG SURIAN, LAMPUNG BARAT, LAMPUNG",1,171,92,263
https://kawalpemilu.org#23624,"PURA MEKAR, GEDUNG SURIAN, LAMPUNG BARAT, LAMPUNG",2,79,117,196
https://kawalpemilu.org#23624,"PURA MEKAR, GEDUNG SURIAN, LAMPUNG BARAT, LAMPUNG",3,97,123,220
https://kawalpemilu.org#23624,"PURA MEKAR, GEDUNG SURIAN, LAMPUNG BARAT, LAMPUNG",4,87,66,153
https://kawalpemilu.org#23624,"PURA MEKAR, GEDUNG SURIAN, LAMPUNG BARAT, LAMPUNG",5,90,103,193
https://kawalpemilu.org#23624,"PURA MEKAR, GEDUNG SURIAN, LAMPUNG BARAT, LAMPUNG",6,45,106,151
https://kawalpemilu.org#23624,"PURA MEKAR, GEDUNG SURIAN, LAMPUNG BARAT, LAMPUNG",7,175,66,241
https://kawalpemilu.org#23624,"PURA MEKAR, GEDUNG SURIAN, LAMPUNG BARAT, LAMPUNG",8,93,36,129
https://kawalpemilu.org#23624,"PURA MEKAR, GEDUNG SURIAN, LAMPUNG BARAT, LAMPUNG",9,144,85,229
https://kawalpemilu.org#23624,"PURA MEKAR, GEDUNG SURIAN, LAMPUNG BARAT, LAMPUNG",10,116,76,192
https://kawalpemilu.org#23624,"PURA MEKAR, GEDUNG SURIAN, LAMPUNG BARAT, LAMPUNG",11,72,65,137
https://kawalpemilu.org#23624,"PURA MEKAR, GEDUNG SURIAN, LAMPUNG BARAT, LAMPUNG",12,79,117,196
https://kawalpemilu.org#23624,"PURA MEKAR, GEDUNG SURIAN, LAMPUNG BARAT, LAMPUNG",13,49,121,170
https://kawalpemilu.org#23624,"PURA MEKAR, GEDUNG SURIAN, LAMPUNG BARAT, LAMPUNG",14,46,116,162
https://kawalpemilu.org#23625,"TRI MULYO, GEDUNG SURIAN, LAMPUNG BARAT, LAMPUNG",1,186,50,236
https://kawalpemilu.org#23625,"TRI MULYO, GEDUNG SURIAN, LAMPUNG BARAT, LAMPUNG",2,129,24,153
https://kawalpemilu.org#23625,"TRI MULYO, GEDUNG SURIAN, LAMPUNG BARAT, LAMPUNG",3,115,17,132
https://kawalpemilu.org#23625,"TRI MULYO, GEDUNG SURIAN, LAMPUNG BARAT, LAMPUNG",5,110,53,163
https://kawalpemilu.org#23625,"TRI MULYO, GEDUNG SURIAN, LAMPUNG BARAT, LAMPUNG",6,192,52,244
https://kawalpemilu.org#23625,"TRI MULYO, GEDUNG SURIAN, LAMPUNG BARAT, LAMPUNG",7,137,23,160
https://kawalpemilu.org#23625,"TRI MULYO, GEDUNG SURIAN, LAMPUNG BARAT, LAMPUNG",8,176,16,192
https://kawalpemilu.org#23625,"TRI MULYO, GEDUNG SURIAN, LAMPUNG BARAT, LAMPUNG",9,123,33,156
https://kawalpemilu.org#23625,"TRI MULYO, GEDUNG SURIAN, LAMPUNG BARAT, LAMPUNG",10,132,62,194
https://kawalpemilu.org#23625,"TRI MULYO, GEDUNG SURIAN, LAMPUNG BARAT, LAMPUNG",11,144,30,174
https://kawalpemilu.org#23626,"MEKAR JAYA, GEDUNG SURIAN, LAMPUNG BARAT, LAMPUNG",1,148,104,252
https://kawalpemilu.org#23626,"MEKAR JAYA, GEDUNG SURIAN, LAMPUNG BARAT, LAMPUNG",2,107,38,145
https://kawalpemilu.org#23626,"MEKAR JAYA, GEDUNG SURIAN, LAMPUNG BARAT, LAMPUNG",3,86,96,182
https://kawalpemilu.org#23626,"MEKAR JAYA, GEDUNG SURIAN, LAMPUNG BARAT, LAMPUNG",4,130,109,239
https://kawalpemilu.org#23626,"MEKAR JAYA, GEDUNG SURIAN, LAMPUNG BARAT, LAMPUNG",5,110,64,174
https://kawalpemilu.org#23626,"MEKAR JAYA, GEDUNG SURIAN, LAMPUNG BARAT, LAMPUNG",6,106,102,208
https://kawalpemilu.org#23626,"MEKAR JAYA, GEDUNG SURIAN, LAMPUNG BARAT, LAMPUNG",7,158,74,232
https://kawalpemilu.org#23626,"MEKAR JAYA, GEDUNG SURIAN, LAMPUNG BARAT, LAMPUNG",8,91,57,148
https://kawalpemilu.org#23626,"MEKAR JAYA, GEDUNG SURIAN, LAMPUNG BARAT, LAMPUNG",9,70,71,141
https://kawalpemilu.org#23626,"MEKAR JAYA, GEDUNG SURIAN, LAMPUNG BARAT, LAMPUNG",10,69,75,144
https://kawalpemilu.org#23626,"MEKAR JAYA, GEDUNG SURIAN, LAMPUNG BARAT, LAMPUNG",11,110,67,177
https://kawalpemilu.org#23626,"MEKAR JAYA, GEDUNG SURIAN, LAMPUNG BARAT, LAMPUNG",12,120,80,200
https://kawalpemilu.org#23674,"SUKA BANJAR, LUMBOK SEMINUNG, LAMPUNG BARAT, LAMPUNG",1,93,104,197
https://kawalpemilu.org#23674,"SUKA BANJAR, LUMBOK SEMINUNG, LAMPUNG BARAT, LAMPUNG",2,88,72,160
https://kawalpemilu.org#23674,"SUKA BANJAR, LUMBOK SEMINUNG, LAMPUNG BARAT, LAMPUNG",3,92,99,191
https://kawalpemilu.org#23675,"LOMBOK, LUMBOK SEMINUNG, LAMPUNG BARAT, LAMPUNG",1,94,114,208
https://kawalpemilu.org#23675,"LOMBOK, LUMBOK SEMINUNG, LAMPUNG BARAT, LAMPUNG",2,115,125,240
https://kawalpemilu.org#23675,"LOMBOK, LUMBOK SEMINUNG, LAMPUNG BARAT, LAMPUNG",3,117,92,209
https://kawalpemilu.org#23675,"LOMBOK, LUMBOK SEMINUNG, LAMPUNG BARAT, LAMPUNG",4,141,69,210
https://kawalpemilu.org#23676,"HENI  ARONG, LUMBOK SEMINUNG, LAMPUNG BARAT, LAMPUNG",1,72,152,224
https://kawalpemilu.org#23676,"HENI  ARONG, LUMBOK SEMINUNG, LAMPUNG BARAT, LAMPUNG",2,51,122,173
https://kawalpemilu.org#23677,"SUKA BANJAR II UJUNG REMBUN, LUMBOK SEMINUNG, LAMPUNG BARAT, LAMPUNG",1,137,15,152
https://kawalpemilu.org#23677,"SUKA BANJAR II UJUNG REMBUN, LUMBOK SEMINUNG, LAMPUNG BARAT, LAMPUNG",2,144,14,158
https://kawalpemilu.org#23677,"SUKA BANJAR II UJUNG REMBUN, LUMBOK SEMINUNG, LAMPUNG BARAT, LAMPUNG",3,130,56,186
https://kawalpemilu.org#23678,"LOMBOK TIMUR, LUMBOK SEMINUNG, LAMPUNG BARAT, LAMPUNG",1,140,85,225
https://kawalpemilu.org#23678,"LOMBOK TIMUR, LUMBOK SEMINUNG, LAMPUNG BARAT, LAMPUNG",2,118,98,216
https://kawalpemilu.org#23679,"TAWAN SUKA MULYA, LUMBOK SEMINUNG, LAMPUNG BARAT, LAMPUNG",1,113,118,231
https://kawalpemilu.org#23679,"TAWAN SUKA MULYA, LUMBOK SEMINUNG, LAMPUNG BARAT, LAMPUNG",2,82,57,139
https://kawalpemilu.org#23683,"LOMBOK SELATAN, LUMBOK SEMINUNG, LAMPUNG BARAT, LAMPUNG",1,84,44,128
https://kawalpemilu.org#23683,"LOMBOK SELATAN, LUMBOK SEMINUNG, LAMPUNG BARAT, LAMPUNG",2,109,27,136
https://kawalpemilu.org#84009,"SUKA MAJU, LUMBOK SEMINUNG, LAMPUNG BARAT, LAMPUNG",1,122,82,204
https://kawalpemilu.org#84009,"SUKA MAJU, LUMBOK SEMINUNG, LAMPUNG BARAT, LAMPUNG",2,123,78,201
https://kawalpemilu.org#84011,"UJUNG, LUMBOK SEMINUNG, LAMPUNG BARAT, LAMPUNG",1,216,44,260
https://kawalpemilu.org#84013,"KEAGUNGAN, LUMBOK SEMINUNG, LAMPUNG BARAT, LAMPUNG",1,104,88,192
https://kawalpemilu.org#84013,"KEAGUNGAN, LUMBOK SEMINUNG, LAMPUNG BARAT, LAMPUNG",2,80,142,222
https://kawalpemilu.org#84014,"PANCUR MAS, LUMBOK SEMINUNG, LAMPUNG BARAT, LAMPUNG",1,83,18,101
https://kawalpemilu.org#84014,"PANCUR MAS, LUMBOK SEMINUNG, LAMPUNG BARAT, LAMPUNG",2,146,12,158
https://kawalpemilu.org#23685,"SRI MENANTI, AIR HITAM, LAMPUNG BARAT, LAMPUNG",1,156,18,174
https://kawalpemilu.org#23685,"SRI MENANTI, AIR HITAM, LAMPUNG BARAT, LAMPUNG",2,121,24,145
https://kawalpemilu.org#23685,"SRI MENANTI, AIR HITAM, LAMPUNG BARAT, LAMPUNG",3,123,18,141
https://kawalpemilu.org#23685,"SRI MENANTI, AIR HITAM, LAMPUNG BARAT, LAMPUNG",4,118,36,154
https://kawalpemilu.org#23686,"SIDODADI, AIR HITAM, LAMPUNG BARAT, LAMPUNG",1,244,18,262
https://kawalpemilu.org#23686,"SIDODADI, AIR HITAM, LAMPUNG BARAT, LAMPUNG",2,224,19,243
https://kawalpemilu.org#23687,"SEMARANG JAYA, AIR HITAM, LAMPUNG BARAT, LAMPUNG",1,157,74,231
https://kawalpemilu.org#23687,"SEMARANG JAYA, AIR HITAM, LAMPUNG BARAT, LAMPUNG",2,172,66,238
https://kawalpemilu.org#23687,"SEMARANG JAYA, AIR HITAM, LAMPUNG BARAT, LAMPUNG",3,177,52,229
https://kawalpemilu.org#23687,"SEMARANG JAYA, AIR HITAM, LAMPUNG BARAT, LAMPUNG",4,160,53,213
https://kawalpemilu.org#23687,"SEMARANG JAYA, AIR HITAM, LAMPUNG BARAT, LAMPUNG",5,170,55,225
https://kawalpemilu.org#23687,"SEMARANG JAYA, AIR HITAM, LAMPUNG BARAT, LAMPUNG",6,162,57,219
https://kawalpemilu.org#23688,"SUMBER ALAM, AIR HITAM, LAMPUNG BARAT, LAMPUNG",1,137,86,223
https://kawalpemilu.org#23688,"SUMBER ALAM, AIR HITAM, LAMPUNG BARAT, LAMPUNG",2,143,76,219
https://kawalpemilu.org#23688,"SUMBER ALAM, AIR HITAM, LAMPUNG BARAT, LAMPUNG",3,129,53,182
https://kawalpemilu.org#23688,"SUMBER ALAM, AIR HITAM, LAMPUNG BARAT, LAMPUNG",4,106,97,203
https://kawalpemilu.org#23688,"SUMBER ALAM, AIR HITAM, LAMPUNG BARAT, LAMPUNG",5,110,67,177
https://kawalpemilu.org#23689,"GUNUNGTERANG, AIR HITAM, LAMPUNG BARAT, LAMPUNG",1,78,135,213
https://kawalpemilu.org#23689,"GUNUNGTERANG, AIR HITAM, LAMPUNG BARAT, LAMPUNG",2,175,52,227
https://kawalpemilu.org#23689,"GUNUNGTERANG, AIR HITAM, LAMPUNG BARAT, LAMPUNG",3,149,64,213
https://kawalpemilu.org#23689,"GUNUNGTERANG, AIR HITAM, LAMPUNG BARAT, LAMPUNG",4,182,46,228
https://kawalpemilu.org#23689,"GUNUNGTERANG, AIR HITAM, LAMPUNG BARAT, LAMPUNG",5,170,38,208
https://kawalpemilu.org#23690,"SUKAJADI, AIR HITAM, LAMPUNG BARAT, LAMPUNG",1,213,49,262
https://kawalpemilu.org#23690,"SUKAJADI, AIR HITAM, LAMPUNG BARAT, LAMPUNG",2,197,41,238
https://kawalpemilu.org#23691,"SUKA DAMAI, AIR HITAM, LAMPUNG BARAT, LAMPUNG",1,240,34,274
https://kawalpemilu.org#23691,"SUKA DAMAI, AIR HITAM, LAMPUNG BARAT, LAMPUNG",2,239,24,263
https://kawalpemilu.org#23692,"MANGGARAI, AIR HITAM, LAMPUNG BARAT, LAMPUNG",1,189,46,235
https://kawalpemilu.org#23692,"MANGGARAI, AIR HITAM, LAMPUNG BARAT, LAMPUNG",2,177,50,227
https://kawalpemilu.org#23693,"SINAR JAYA, AIR HITAM, LAMPUNG BARAT, LAMPUNG",1,118,58,176
https://kawalpemilu.org#23693,"SINAR JAYA, AIR HITAM, LAMPUNG BARAT, LAMPUNG",2,115,69,184
https://kawalpemilu.org#23693,"SINAR JAYA, AIR HITAM, LAMPUNG BARAT, LAMPUNG",3,111,74,185
https://kawalpemilu.org#23693,"SINAR JAYA, AIR HITAM, LAMPUNG BARAT, LAMPUNG",4,88,97,185
https://kawalpemilu.org#84024,"RIGIS JAYA, AIR HITAM, LAMPUNG BARAT, LAMPUNG",1,234,18,252
https://kawalpemilu.org#84024,"RIGIS JAYA, AIR HITAM, LAMPUNG BARAT, LAMPUNG",2,181,30,211
https://kawalpemilu.org#23696,"MUARA JAYA I, KEBUN TEBU, LAMPUNG BARAT, LAMPUNG",1,104,92,196
https://kawalpemilu.org#23696,"MUARA JAYA I, KEBUN TEBU, LAMPUNG BARAT, LAMPUNG",2,125,26,151
https://kawalpemilu.org#23696,"MUARA JAYA I, KEBUN TEBU, LAMPUNG BARAT, LAMPUNG",3,119,47,166
https://kawalpemilu.org#23696,"MUARA JAYA I, KEBUN TEBU, LAMPUNG BARAT, LAMPUNG",4,117,16,133
https://kawalpemilu.org#23696,"MUARA JAYA I, KEBUN TEBU, LAMPUNG BARAT, LAMPUNG",5,195,31,226
https://kawalpemilu.org#23697,"MUARA JAYA II, KEBUN TEBU, LAMPUNG BARAT, LAMPUNG",1,83,80,163
https://kawalpemilu.org#23697,"MUARA JAYA II, KEBUN TEBU, LAMPUNG BARAT, LAMPUNG",2,68,90,158
https://kawalpemilu.org#23697,"MUARA JAYA II, KEBUN TEBU, LAMPUNG BARAT, LAMPUNG",3,134,42,176
https://kawalpemilu.org#23697,"MUARA JAYA II, KEBUN TEBU, LAMPUNG BARAT, LAMPUNG",4,116,52,168
https://kawalpemilu.org#23697,"MUARA JAYA II, KEBUN TEBU, LAMPUNG BARAT, LAMPUNG",5,125,52,177
https://kawalpemilu.org#23697,"MUARA JAYA II, KEBUN TEBU, LAMPUNG BARAT, LAMPUNG",6,126,61,187
https://kawalpemilu.org#23698,"PURAWIWITAN, KEBUN TEBU, LAMPUNG BARAT, LAMPUNG",1,103,116,219
https://kawalpemilu.org#23698,"PURAWIWITAN, KEBUN TEBU, LAMPUNG BARAT, LAMPUNG",2,69,130,199
https://kawalpemilu.org#23698,"PURAWIWITAN, KEBUN TEBU, LAMPUNG BARAT, LAMPUNG",3,121,115,236
https://kawalpemilu.org#23698,"PURAWIWITAN, KEBUN TEBU, LAMPUNG BARAT, LAMPUNG",4,138,67,205
https://kawalpemilu.org#23698,"PURAWIWITAN, KEBUN TEBU, LAMPUNG BARAT, LAMPUNG",5,73,99,172
https://kawalpemilu.org#23698,"PURAWIWITAN, KEBUN TEBU, LAMPUNG BARAT, LAMPUNG",6,129,94,223
https://kawalpemilu.org#23698,"PURAWIWITAN, KEBUN TEBU, LAMPUNG BARAT, LAMPUNG",7,110,108,218
https://kawalpemilu.org#23698,"PURAWIWITAN, KEBUN TEBU, LAMPUNG BARAT, LAMPUNG",8,154,21,175
https://kawalpemilu.org#23698,"PURAWIWITAN, KEBUN TEBU, LAMPUNG BARAT, LAMPUNG",9,108,47,155
https://kawalpemilu.org#23698,"PURAWIWITAN, KEBUN TEBU, LAMPUNG BARAT, LAMPUNG",10,99,14,113
https://kawalpemilu.org#23699,"TRIBUDI SYUKUR, KEBUN TEBU, LAMPUNG BARAT, LAMPUNG",1,24,184,208
https://kawalpemilu.org#23699,"TRIBUDI SYUKUR, KEBUN TEBU, LAMPUNG BARAT, LAMPUNG",2,31,176,207
https://kawalpemilu.org#23699,"TRIBUDI SYUKUR, KEBUN TEBU, LAMPUNG BARAT, LAMPUNG",3,32,125,157
https://kawalpemilu.org#23699,"TRIBUDI SYUKUR, KEBUN TEBU, LAMPUNG BARAT, LAMPUNG",4,42,108,150
https://kawalpemilu.org#23699,"TRIBUDI SYUKUR, KEBUN TEBU, LAMPUNG BARAT, LAMPUNG",5,49,116,165
https://kawalpemilu.org#23699,"TRIBUDI SYUKUR, KEBUN TEBU, LAMPUNG BARAT, LAMPUNG",6,36,120,156
https://kawalpemilu.org#23699,"TRIBUDI SYUKUR, KEBUN TEBU, LAMPUNG BARAT, LAMPUNG",7,54,88,142
https://kawalpemilu.org#23699,"TRIBUDI SYUKUR, KEBUN TEBU, LAMPUNG BARAT, LAMPUNG",8,53,88,141
https://kawalpemilu.org#23700,"PURAJAYA, KEBUN TEBU, LAMPUNG BARAT, LAMPUNG",1,159,60,219
https://kawalpemilu.org#23700,"PURAJAYA, KEBUN TEBU, LAMPUNG BARAT, LAMPUNG",2,82,86,168
https://kawalpemilu.org#23700,"PURAJAYA, KEBUN TEBU, LAMPUNG BARAT, LAMPUNG",3,98,75,173
https://kawalpemilu.org#23700,"PURAJAYA, KEBUN TEBU, LAMPUNG BARAT, LAMPUNG",4,99,108,207
https://kawalpemilu.org#23700,"PURAJAYA, KEBUN TEBU, LAMPUNG BARAT, LAMPUNG",5,105,99,204
https://kawalpemilu.org#23700,"PURAJAYA, KEBUN TEBU, LAMPUNG BARAT, LAMPUNG",6,81,83,164
https://kawalpemilu.org#23700,"PURAJAYA, KEBUN TEBU, LAMPUNG BARAT, LAMPUNG",7,76,92,167
https://kawalpemilu.org#23700,"PURAJAYA, KEBUN TEBU, LAMPUNG BARAT, LAMPUNG",8,75,102,177
https://kawalpemilu.org#23700,"PURAJAYA, KEBUN TEBU, LAMPUNG BARAT, LAMPUNG",9,77,110,187
https://kawalpemilu.org#23700,"PURAJAYA, KEBUN TEBU, LAMPUNG BARAT, LAMPUNG",10,99,110,209
https://kawalpemilu.org#23700,"PURAJAYA, KEBUN TEBU, LAMPUNG BARAT, LAMPUNG",11,101,85,186
https://kawalpemilu.org#23700,"PURAJAYA, KEBUN TEBU, LAMPUNG BARAT, LAMPUNG",12,96,15,111
https://kawalpemilu.org#23700,"PURAJAYA, KEBUN TEBU, LAMPUNG BARAT, LAMPUNG",13,105,55,160
https://kawalpemilu.org#23700,"PURAJAYA, KEBUN TEBU, LAMPUNG BARAT, LAMPUNG",14,105,39,144
https://kawalpemilu.org#23701,"SINAR LUAS, KEBUN TEBU, LAMPUNG BARAT, LAMPUNG",1,92,74,166
https://kawalpemilu.org#23701,"SINAR LUAS, KEBUN TEBU, LAMPUNG BARAT, LAMPUNG",2,119,51,170
https://kawalpemilu.org#23701,"SINAR LUAS, KEBUN TEBU, LAMPUNG BARAT, LAMPUNG",3,129,51,180
https://kawalpemilu.org#23701,"SINAR LUAS, KEBUN TEBU, LAMPUNG BARAT, LAMPUNG",4,146,46,192
https://kawalpemilu.org#23702,"CIPTA MULYA, KEBUN TEBU, LAMPUNG BARAT, LAMPUNG",1,166,20,186
https://kawalpemilu.org#23702,"CIPTA MULYA, KEBUN TEBU, LAMPUNG BARAT, LAMPUNG",2,118,64,182
https://kawalpemilu.org#23702,"CIPTA MULYA, KEBUN TEBU, LAMPUNG BARAT, LAMPUNG",3,166,28,194
https://kawalpemilu.org#23702,"CIPTA MULYA, KEBUN TEBU, LAMPUNG BARAT, LAMPUNG",4,140,72,212
https://kawalpemilu.org#23702,"CIPTA MULYA, KEBUN TEBU, LAMPUNG BARAT, LAMPUNG",5,130,50,180
https://kawalpemilu.org#23702,"CIPTA MULYA, KEBUN TEBU, LAMPUNG BARAT, LAMPUNG",6,136,38,174
https://kawalpemilu.org#23704,"MUARA BARU, KEBUN TEBU, LAMPUNG BARAT, LAMPUNG",1,123,46,169
https://kawalpemilu.org#23704,"MUARA BARU, KEBUN TEBU, LAMPUNG BARAT, LAMPUNG",2,141,56,197
https://kawalpemilu.org#23704,"MUARA BARU, KEBUN TEBU, LAMPUNG BARAT, LAMPUNG",3,116,48,164
https://kawalpemilu.org#23705,"TRIBUDI MAKMUR, KEBUN TEBU, LAMPUNG BARAT, LAMPUNG",1,90,153,243
https://kawalpemilu.org#23705,"TRIBUDI MAKMUR, KEBUN TEBU, LAMPUNG BARAT, LAMPUNG",2,104,128,232
https://kawalpemilu.org#23705,"TRIBUDI MAKMUR, KEBUN TEBU, LAMPUNG BARAT, LAMPUNG",3,93,115,208
https://kawalpemilu.org#23705,"TRIBUDI MAKMUR, KEBUN TEBU, LAMPUNG BARAT, LAMPUNG",4,82,112,194
https://kawalpemilu.org#93363,"TUGU MULYA, KEBUN TEBU, LAMPUNG BARAT, LAMPUNG",1,140,65,205
https://kawalpemilu.org#93363,"TUGU MULYA, KEBUN TEBU, LAMPUNG BARAT, LAMPUNG",2,115,83,198
https://kawalpemilu.org#93363,"TUGU MULYA, KEBUN TEBU, LAMPUNG BARAT, LAMPUNG",3,129,55,184
https://kawalpemilu.org#93363,"TUGU MULYA, KEBUN TEBU, LAMPUNG BARAT, LAMPUNG",4,137,67,204
https://kawalpemilu.org#93363,"TUGU MULYA, KEBUN TEBU, LAMPUNG BARAT, LAMPUNG",5,116,86,202
https://kawalpemilu.org#93363,"TUGU MULYA, KEBUN TEBU, LAMPUNG BARAT, LAMPUNG",6,96,13,109
https://kawalpemilu.org#23707,"MEKARSARI, PAGAR DEWA, LAMPUNG BARAT, LAMPUNG",1,132,94,226
https://kawalpemilu.org#23707,"MEKARSARI, PAGAR DEWA, LAMPUNG BARAT, LAMPUNG",2,121,68,189
https://kawalpemilu.org#23707,"MEKARSARI, PAGAR DEWA, LAMPUNG BARAT, LAMPUNG",3,71,125,196
https://kawalpemilu.org#23707,"MEKARSARI, PAGAR DEWA, LAMPUNG BARAT, LAMPUNG",4,138,75,213
https://kawalpemilu.org#23708,"PAHAYU JAYA, PAGAR DEWA, LAMPUNG BARAT, LAMPUNG",1,160,81,241
https://kawalpemilu.org#23708,"PAHAYU JAYA, PAGAR DEWA, LAMPUNG BARAT, LAMPUNG",2,171,68,239
https://kawalpemilu.org#23708,"PAHAYU JAYA, PAGAR DEWA, LAMPUNG BARAT, LAMPUNG",3,109,65,174
https://kawalpemilu.org#23708,"PAHAYU JAYA, PAGAR DEWA, LAMPUNG BARAT, LAMPUNG",4,94,33,127
https://kawalpemilu.org#23708,"PAHAYU JAYA, PAGAR DEWA, LAMPUNG BARAT, LAMPUNG",5,198,28,226
https://kawalpemilu.org#23708,"PAHAYU JAYA, PAGAR DEWA, LAMPUNG BARAT, LAMPUNG",6,99,30,129
https://kawalpemilu.org#23708,"PAHAYU JAYA, PAGAR DEWA, LAMPUNG BARAT, LAMPUNG",7,112,39,151
https://kawalpemilu.org#23709,"BASUNGAN, PAGAR DEWA, LAMPUNG BARAT, LAMPUNG",1,153,65,218
https://kawalpemilu.org#23709,"BASUNGAN, PAGAR DEWA, LAMPUNG BARAT, LAMPUNG",2,127,77,204
https://kawalpemilu.org#23709,"BASUNGAN, PAGAR DEWA, LAMPUNG BARAT, LAMPUNG",3,152,38,190
https://kawalpemilu.org#23709,"BASUNGAN, PAGAR DEWA, LAMPUNG BARAT, LAMPUNG",4,93,57,150
https://kawalpemilu.org#23709,"BASUNGAN, PAGAR DEWA, LAMPUNG BARAT, LAMPUNG",5,144,32,176
https://kawalpemilu.org#23709,"BASUNGAN, PAGAR DEWA, LAMPUNG BARAT, LAMPUNG",6,203,56,259
https://kawalpemilu.org#23710,"SIDOMULYO, PAGAR DEWA, LAMPUNG BARAT, LAMPUNG",1,92,84,176
https://kawalpemilu.org#23710,"SIDOMULYO, PAGAR DEWA, LAMPUNG BARAT, LAMPUNG",2,61,106,167
https://kawalpemilu.org#23710,"SIDOMULYO, PAGAR DEWA, LAMPUNG BARAT, LAMPUNG",3,98,37,135
https://kawalpemilu.org#23710,"SIDOMULYO, PAGAR DEWA, LAMPUNG BARAT, LAMPUNG",4,98,34,132
https://kawalpemilu.org#23710,"SIDOMULYO, PAGAR DEWA, LAMPUNG BARAT, LAMPUNG",5,106,59,165
https://kawalpemilu.org#23710,"SIDOMULYO, PAGAR DEWA, LAMPUNG BARAT, LAMPUNG",6,125,57,182
https://kawalpemilu.org#23710,"SIDOMULYO, PAGAR DEWA, LAMPUNG BARAT, LAMPUNG",7,103,26,129
https://kawalpemilu.org#23710,"SIDOMULYO, PAGAR DEWA, LAMPUNG BARAT, LAMPUNG",8,88,72,160
https://kawalpemilu.org#23710,"SIDOMULYO, PAGAR DEWA, LAMPUNG BARAT, LAMPUNG",9,173,39,212
https://kawalpemilu.org#23710,"SIDOMULYO, PAGAR DEWA, LAMPUNG BARAT, LAMPUNG",10,181,28,209
https://kawalpemilu.org#23710,"SIDOMULYO, PAGAR DEWA, LAMPUNG BARAT, LAMPUNG",11,125,34,159
https://kawalpemilu.org#23710,"SIDOMULYO, PAGAR DEWA, LAMPUNG BARAT, LAMPUNG",12,157,69,226
https://kawalpemilu.org#23710,"SIDOMULYO, PAGAR DEWA, LAMPUNG BARAT, LAMPUNG",13,117,44,161
https://kawalpemilu.org#23710,"SIDOMULYO, PAGAR DEWA, LAMPUNG BARAT, LAMPUNG",14,144,52,196
https://kawalpemilu.org#23710,"SIDOMULYO, PAGAR DEWA, LAMPUNG BARAT, LAMPUNG",15,99,36,135
https://kawalpemilu.org#23710,"SIDOMULYO, PAGAR DEWA, LAMPUNG BARAT, LAMPUNG",16,113,47,160
https://kawalpemilu.org#23711,"SIDODADI, PAGAR DEWA, LAMPUNG BARAT, LAMPUNG",1,207,28,235
https://kawalpemilu.org#23711,"SIDODADI, PAGAR DEWA, LAMPUNG BARAT, LAMPUNG",2,184,11,195
https://kawalpemilu.org#23711,"SIDODADI, PAGAR DEWA, LAMPUNG BARAT, LAMPUNG",3,260,13,273
https://kawalpemilu.org#23711,"SIDODADI, PAGAR DEWA, LAMPUNG BARAT, LAMPUNG",4,127,30,157
https://kawalpemilu.org#23712,"MARGA JAYA, PAGAR DEWA, LAMPUNG BARAT, LAMPUNG",1,136,65,201
https://kawalpemilu.org#23712,"MARGA JAYA, PAGAR DEWA, LAMPUNG BARAT, LAMPUNG",2,93,26,119
https://kawalpemilu.org#23712,"MARGA JAYA, PAGAR DEWA, LAMPUNG BARAT, LAMPUNG",3,143,42,185
https://kawalpemilu.org#23712,"MARGA JAYA, PAGAR DEWA, LAMPUNG BARAT, LAMPUNG",4,135,72,207
https://kawalpemilu.org#23712,"MARGA JAYA, PAGAR DEWA, LAMPUNG BARAT, LAMPUNG",5,75,26,101
https://kawalpemilu.org#23712,"MARGA JAYA, PAGAR DEWA, LAMPUNG BARAT, LAMPUNG",6,126,98,224
https://kawalpemilu.org#23713,"SUKA JAYA, PAGAR DEWA, LAMPUNG BARAT, LAMPUNG",1,134,79,213
https://kawalpemilu.org#23713,"SUKA JAYA, PAGAR DEWA, LAMPUNG BARAT, LAMPUNG",2,143,62,205
https://kawalpemilu.org#23713,"SUKA JAYA, PAGAR DEWA, LAMPUNG BARAT, LAMPUNG",3,129,117,246
https://kawalpemilu.org#23714,"PAGAR DEWA, PAGAR DEWA, LAMPUNG BARAT, LAMPUNG",1,160,94,254
https://kawalpemilu.org#23714,"PAGAR DEWA, PAGAR DEWA, LAMPUNG BARAT, LAMPUNG",2,119,50,169
https://kawalpemilu.org#23714,"PAGAR DEWA, PAGAR DEWA, LAMPUNG BARAT, LAMPUNG",3,0,0,0
https://kawalpemilu.org#23714,"PAGAR DEWA, PAGAR DEWA, LAMPUNG BARAT, LAMPUNG",4,165,39,207
https://kawalpemilu.org#23715,"SUKA MULYA, PAGAR DEWA, LAMPUNG BARAT, LAMPUNG",1,112,87,199
https://kawalpemilu.org#23715,"SUKA MULYA, PAGAR DEWA, LAMPUNG BARAT, LAMPUNG",2,89,106,195
https://kawalpemilu.org#23715,"SUKA MULYA, PAGAR DEWA, LAMPUNG BARAT, LAMPUNG",3,147,109,256
https://kawalpemilu.org#84022,"BATU API, PAGAR DEWA, LAMPUNG BARAT, LAMPUNG",1,178,26,204
https://kawalpemilu.org#84022,"BATU API, PAGAR DEWA, LAMPUNG BARAT, LAMPUNG",2,166,33,199
https://kawalpemilu.org#84022,"BATU API, PAGAR DEWA, LAMPUNG BARAT, LAMPUNG",3,111,24,135
https://kawalpemilu.org#84022,"BATU API, PAGAR DEWA, LAMPUNG BARAT, LAMPUNG",4,178,22,200
https://kawalpemilu.org#23717,"BAKHU, BATU KETULIS, LAMPUNG BARAT, LAMPUNG",1,59,138,197
https://kawalpemilu.org#23717,"BAKHU, BATU KETULIS, LAMPUNG BARAT, LAMPUNG",2,49,127,176
https://kawalpemilu.org#23717,"BAKHU, BATU KETULIS, LAMPUNG BARAT, LAMPUNG",3,146,73,219
https://kawalpemilu.org#23717,"BAKHU, BATU KETULIS, LAMPUNG BARAT, LAMPUNG",4,149,45,194
https://kawalpemilu.org#23717,"BAKHU, BATU KETULIS, LAMPUNG BARAT, LAMPUNG",5,193,25,218
https://kawalpemilu.org#23717,"BAKHU, BATU KETULIS, LAMPUNG BARAT, LAMPUNG",6,95,112,207
https://kawalpemilu.org#23717,"BAKHU, BATU KETULIS, LAMPUNG BARAT, LAMPUNG",7,68,105,173
https://kawalpemilu.org#23718,"LUAS, BATU KETULIS, LAMPUNG BARAT, LAMPUNG",1,119,91,210
https://kawalpemilu.org#23718,"LUAS, BATU KETULIS, LAMPUNG BARAT, LAMPUNG",2,85,161,246
https://kawalpemilu.org#23718,"LUAS, BATU KETULIS, LAMPUNG BARAT, LAMPUNG",3,111,51,162
https://kawalpemilu.org#23718,"LUAS, BATU KETULIS, LAMPUNG BARAT, LAMPUNG",4,204,23,227
https://kawalpemilu.org#23718,"LUAS, BATU KETULIS, LAMPUNG BARAT, LAMPUNG",5,146,47,193
https://kawalpemilu.org#23718,"LUAS, BATU KETULIS, LAMPUNG BARAT, LAMPUNG",6,115,41,156
https://kawalpemilu.org#23718,"LUAS, BATU KETULIS, LAMPUNG BARAT, LAMPUNG",7,99,48,147
https://kawalpemilu.org#23718,"LUAS, BATU KETULIS, LAMPUNG BARAT, LAMPUNG",8,71,76,147
https://kawalpemilu.org#23718,"LUAS, BATU KETULIS, LAMPUNG BARAT, LAMPUNG",9,51,131,182
https://kawalpemilu.org#23718,"LUAS, BATU KETULIS, LAMPUNG BARAT, LAMPUNG",10,93,22,105
https://kawalpemilu.org#23718,"LUAS, BATU KETULIS, LAMPUNG BARAT, LAMPUNG",11,81,54,135
https://kawalpemilu.org#23718,"LUAS, BATU KETULIS, LAMPUNG BARAT, LAMPUNG",12,117,31,148
https://kawalpemilu.org#23718,"LUAS, BATU KETULIS, LAMPUNG BARAT, LAMPUNG",13,110,25,135
https://kawalpemilu.org#23718,"LUAS, BATU KETULIS, LAMPUNG BARAT, LAMPUNG",14,95,27,122
https://kawalpemilu.org#23719,"ARGOMULYO, BATU KETULIS, LAMPUNG BARAT, LAMPUNG",1,155,61,216
https://kawalpemilu.org#23719,"ARGOMULYO, BATU KETULIS, LAMPUNG BARAT, LAMPUNG",2,120,26,146
https://kawalpemilu.org#23719,"ARGOMULYO, BATU KETULIS, LAMPUNG BARAT, LAMPUNG",3,136,50,186
https://kawalpemilu.org#23719,"ARGOMULYO, BATU KETULIS, LAMPUNG BARAT, LAMPUNG",4,133,17,150
https://kawalpemilu.org#23719,"ARGOMULYO, BATU KETULIS, LAMPUNG BARAT, LAMPUNG",5,122,8,130
https://kawalpemilu.org#23719,"ARGOMULYO, BATU KETULIS, LAMPUNG BARAT, LAMPUNG",6,92,25,117
https://kawalpemilu.org#23720,"BATU KEBAYAN, BATU KETULIS, LAMPUNG BARAT, LAMPUNG",1,154,57,211
https://kawalpemilu.org#23720,"BATU KEBAYAN, BATU KETULIS, LAMPUNG BARAT, LAMPUNG",2,116,114,230
https://kawalpemilu.org#23720,"BATU KEBAYAN, BATU KETULIS, LAMPUNG BARAT, LAMPUNG",3,133,59,192
https://kawalpemilu.org#23721,"ATAR BAWANG, BATU KETULIS, LAMPUNG BARAT, LAMPUNG",1,167,65,232
https://kawalpemilu.org#23721,"ATAR BAWANG, BATU KETULIS, LAMPUNG BARAT, LAMPUNG",2,124,48,172
https://kawalpemilu.org#23721,"ATAR BAWANG, BATU KETULIS, LAMPUNG BARAT, LAMPUNG",3,146,69,215
https://kawalpemilu.org#23722,"CAMPANG TIGA, BATU KETULIS, LAMPUNG BARAT, LAMPUNG",1,170,57,227
https://kawalpemilu.org#23722,"CAMPANG TIGA, BATU KETULIS, LAMPUNG BARAT, LAMPUNG",2,125,31,156
https://kawalpemilu.org#23722,"CAMPANG TIGA, BATU KETULIS, LAMPUNG BARAT, LAMPUNG",3,86,34,120
https://kawalpemilu.org#23722,"CAMPANG TIGA, BATU KETULIS, LAMPUNG BARAT, LAMPUNG",4,134,41,175
https://kawalpemilu.org#23723,"WAY NGISON, BATU KETULIS, LAMPUNG BARAT, LAMPUNG",1,145,82,227
https://kawalpemilu.org#23723,"WAY NGISON, BATU KETULIS, LAMPUNG BARAT, LAMPUNG",2,120,87,207
https://kawalpemilu.org#23723,"WAY NGISON, BATU KETULIS, LAMPUNG BARAT, LAMPUNG",3,133,99,232
https://kawalpemilu.org#23723,"WAY NGISON, BATU KETULIS, LAMPUNG BARAT, LAMPUNG",4,145,82,227
https://kawalpemilu.org#23724,"KUBU LIKU JAYA, BATU KETULIS, LAMPUNG BARAT, LAMPUNG",1,117,40,157
https://kawalpemilu.org#23724,"KUBU LIKU JAYA, BATU KETULIS, LAMPUNG BARAT, LAMPUNG",2,100,51,151
https://kawalpemilu.org#23724,"KUBU LIKU JAYA, BATU KETULIS, LAMPUNG BARAT, LAMPUNG",3,109,83,192
https://kawalpemilu.org#23724,"KUBU LIKU JAYA, BATU KETULIS, LAMPUNG BARAT, LAMPUNG",4,67,17,84
https://kawalpemilu.org#23724,"KUBU LIKU JAYA, BATU KETULIS, LAMPUNG BARAT, LAMPUNG",5,120,49,169
https://kawalpemilu.org#23724,"KUBU LIKU JAYA, BATU KETULIS, LAMPUNG BARAT, LAMPUNG",6,59,25,84
https://kawalpemilu.org#23726,"ATAR KUWAU, BATU KETULIS, LAMPUNG BARAT, LAMPUNG",1,148,57,205
https://kawalpemilu.org#23726,"ATAR KUWAU, BATU KETULIS, LAMPUNG BARAT, LAMPUNG",2,105,58,163
https://kawalpemilu.org#84021,"SUMBER REJO, BATU KETULIS, LAMPUNG BARAT, LAMPUNG",1,107,35,142
https://kawalpemilu.org#84021,"SUMBER REJO, BATU KETULIS, LAMPUNG BARAT, LAMPUNG",2,106,35,141
https://kawalpemilu.org#23728,"SUOH, BANDAR NEGERI SUOH, LAMPUNG BARAT, LAMPUNG",1,189,30,219
https://kawalpemilu.org#23728,"SUOH, BANDAR NEGERI SUOH, LAMPUNG BARAT, LAMPUNG",2,182,71,253
https://kawalpemilu.org#23728,"SUOH, BANDAR NEGERI SUOH, LAMPUNG BARAT, LAMPUNG",3,159,57,216
https://kawalpemilu.org#23728,"SUOH, BANDAR NEGERI SUOH, LAMPUNG BARAT, LAMPUNG",4,135,95,230
https://kawalpemilu.org#23728,"SUOH, BANDAR NEGERI SUOH, LAMPUNG BARAT, LAMPUNG",5,222,21,243
https://kawalpemilu.org#23728,"SUOH, BANDAR NEGERI SUOH, LAMPUNG BARAT, LAMPUNG",6,170,21,191
https://kawalpemilu.org#23728,"SUOH, BANDAR NEGERI SUOH, LAMPUNG BARAT, LAMPUNG",7,91,14,105
https://kawalpemilu.org#23728,"SUOH, BANDAR NEGERI SUOH, LAMPUNG BARAT, LAMPUNG",8,25,70,95
https://kawalpemilu.org#23728,"SUOH, BANDAR NEGERI SUOH, LAMPUNG BARAT, LAMPUNG",9,123,25,148
https://kawalpemilu.org#23728,"SUOH, BANDAR NEGERI SUOH, LAMPUNG BARAT, LAMPUNG",10,91,15,106
https://kawalpemilu.org#23728,"SUOH, BANDAR NEGERI SUOH, LAMPUNG BARAT, LAMPUNG",11,143,37,180
https://kawalpemilu.org#23728,"SUOH, BANDAR NEGERI SUOH, LAMPUNG BARAT, LAMPUNG",12,190,39,229
https://kawalpemilu.org#23728,"SUOH, BANDAR NEGERI SUOH, LAMPUNG BARAT, LAMPUNG",13,191,65,256
https://kawalpemilu.org#23728,"SUOH, BANDAR NEGERI SUOH, LAMPUNG BARAT, LAMPUNG",14,70,46,116
https://kawalpemilu.org#23728,"SUOH, BANDAR NEGERI SUOH, LAMPUNG BARAT, LAMPUNG",15,178,58,236
https://kawalpemilu.org#23729,"SRIMULYO, BANDAR NEGERI SUOH, LAMPUNG BARAT, LAMPUNG",1,174,83,257
https://kawalpemilu.org#23729,"SRIMULYO, BANDAR NEGERI SUOH, LAMPUNG BARAT, LAMPUNG",2,188,91,279
https://kawalpemilu.org#23729,"SRIMULYO, BANDAR NEGERI SUOH, LAMPUNG BARAT, LAMPUNG",3,184,44,228
https://kawalpemilu.org#23729,"SRIMULYO, BANDAR NEGERI SUOH, LAMPUNG BARAT, LAMPUNG",4,134,47,181
https://kawalpemilu.org#23730,"BANDAR AGUNG, BANDAR NEGERI SUOH, LAMPUNG BARAT, LAMPUNG",1,190,28,218
https://kawalpemilu.org#23730,"BANDAR AGUNG, BANDAR NEGERI SUOH, LAMPUNG BARAT, LAMPUNG",2,73,7,80
https://kawalpemilu.org#23730,"BANDAR AGUNG, BANDAR NEGERI SUOH, LAMPUNG BARAT, LAMPUNG",3,154,24,178
https://kawalpemilu.org#23730,"BANDAR AGUNG, BANDAR NEGERI SUOH, LAMPUNG BARAT, LAMPUNG",4,146,28,174
https://kawalpemilu.org#23730,"BANDAR AGUNG, BANDAR NEGERI SUOH, LAMPUNG BARAT, LAMPUNG",5,69,27,96
https://kawalpemilu.org#23730,"BANDAR AGUNG, BANDAR NEGERI SUOH, LAMPUNG BARAT, LAMPUNG",6,177,13,190
https://kawalpemilu.org#23730,"BANDAR AGUNG, BANDAR NEGERI SUOH, LAMPUNG BARAT, LAMPUNG",7,106,18,124
https://kawalpemilu.org#23730,"BANDAR AGUNG, BANDAR NEGERI SUOH, LAMPUNG BARAT, LAMPUNG",8,138,16,154
https://kawalpemilu.org#23730,"BANDAR AGUNG, BANDAR NEGERI SUOH, LAMPUNG BARAT, LAMPUNG",9,203,50,253
https://kawalpemilu.org#23730,"BANDAR AGUNG, BANDAR NEGERI SUOH, LAMPUNG BARAT, LAMPUNG",10,186,10,196
https://kawalpemilu.org#23730,"BANDAR AGUNG, BANDAR NEGERI SUOH, LAMPUNG BARAT, LAMPUNG",11,147,29,176
https://kawalpemilu.org#23730,"BANDAR AGUNG, BANDAR NEGERI SUOH, LAMPUNG BARAT, LAMPUNG",12,142,17,159
https://kawalpemilu.org#23730,"BANDAR AGUNG, BANDAR NEGERI SUOH, LAMPUNG BARAT, LAMPUNG",13,154,39,193
https://kawalpemilu.org#23730,"BANDAR AGUNG, BANDAR NEGERI SUOH, LAMPUNG BARAT, LAMPUNG",14,135,35,170
https://kawalpemilu.org#23730,"BANDAR AGUNG, BANDAR NEGERI SUOH, LAMPUNG BARAT, LAMPUNG",15,218,16,234
https://kawalpemilu.org#23730,"BANDAR AGUNG, BANDAR NEGERI SUOH, LAMPUNG BARAT, LAMPUNG",16,155,83,238
https://kawalpemilu.org#23730,"BANDAR AGUNG, BANDAR NEGERI SUOH, LAMPUNG BARAT, LAMPUNG",17,267,11,278
https://kawalpemilu.org#23730,"BANDAR AGUNG, BANDAR NEGERI SUOH, LAMPUNG BARAT, LAMPUNG",18,141,46,187
https://kawalpemilu.org#23730,"BANDAR AGUNG, BANDAR NEGERI SUOH, LAMPUNG BARAT, LAMPUNG",19,148,15,163
https://kawalpemilu.org#23730,"BANDAR AGUNG, BANDAR NEGERI SUOH, LAMPUNG BARAT, LAMPUNG",20,206,40,246
https://kawalpemilu.org#23730,"BANDAR AGUNG, BANDAR NEGERI SUOH, LAMPUNG BARAT, LAMPUNG",21,114,17,131
https://kawalpemilu.org#23730,"BANDAR AGUNG, BANDAR NEGERI SUOH, LAMPUNG BARAT, LAMPUNG",22,121,7,128
https://kawalpemilu.org#23730,"BANDAR AGUNG, BANDAR NEGERI SUOH, LAMPUNG BARAT, LAMPUNG",23,102,59,161
https://kawalpemilu.org#23730,"BANDAR AGUNG, BANDAR NEGERI SUOH, LAMPUNG BARAT, LAMPUNG",24,150,55,205
https://kawalpemilu.org#23730,"BANDAR AGUNG, BANDAR NEGERI SUOH, LAMPUNG BARAT, LAMPUNG",25,185,25,210
https://kawalpemilu.org#23730,"BANDAR AGUNG, BANDAR NEGERI SUOH, LAMPUNG BARAT, LAMPUNG",26,132,50,182
https://kawalpemilu.org#23731,"BUMI HATATAI, BANDAR NEGERI SUOH, LAMPUNG BARAT, LAMPUNG",1,187,55,242
https://kawalpemilu.org#23731,"BUMI HATATAI, BANDAR NEGERI SUOH, LAMPUNG BARAT, LAMPUNG",2,128,25,153
https://kawalpemilu.org#23731,"BUMI HATATAI, BANDAR NEGERI SUOH, LAMPUNG BARAT, LAMPUNG",3,172,19,191
https://kawalpemilu.org#23731,"BUMI HATATAI, BANDAR NEGERI SUOH, LAMPUNG BARAT, LAMPUNG",4,140,27,167
https://kawalpemilu.org#23731,"BUMI HATATAI, BANDAR NEGERI SUOH, LAMPUNG BARAT, LAMPUNG",5,96,13,109
https://kawalpemilu.org#23731,"BUMI HATATAI, BANDAR NEGERI SUOH, LAMPUNG BARAT, LAMPUNG",6,137,24,161
https://kawalpemilu.org#23731,"BUMI HATATAI, BANDAR NEGERI SUOH, LAMPUNG BARAT, LAMPUNG",7,88,78,166
https://kawalpemilu.org#23731,"BUMI HATATAI, BANDAR NEGERI SUOH, LAMPUNG BARAT, LAMPUNG",8,153,12,165
https://kawalpemilu.org#23731,"BUMI HATATAI, BANDAR NEGERI SUOH, LAMPUNG BARAT, LAMPUNG",9,205,14,219
https://kawalpemilu.org#23732,"GUNUNGRATU, BANDAR NEGERI SUOH, LAMPUNG BARAT, LAMPUNG",1,142,25,167
https://kawalpemilu.org#23732,"GUNUNGRATU, BANDAR NEGERI SUOH, LAMPUNG BARAT, LAMPUNG",2,90,25,115
https://kawalpemilu.org#23732,"GUNUNGRATU, BANDAR NEGERI SUOH, LAMPUNG BARAT, LAMPUNG",3,137,78,215
https://kawalpemilu.org#23732,"GUNUNGRATU, BANDAR NEGERI SUOH, LAMPUNG BARAT, LAMPUNG",4,130,16,146
https://kawalpemilu.org#23732,"GUNUNGRATU, BANDAR NEGERI SUOH, LAMPUNG BARAT, LAMPUNG",5,141,14,155
https://kawalpemilu.org#23732,"GUNUNGRATU, BANDAR NEGERI SUOH, LAMPUNG BARAT, LAMPUNG",6,171,28,199
https://kawalpemilu.org#23733,"RINGIN JAYA, BANDAR NEGERI SUOH, LAMPUNG BARAT, LAMPUNG",1,185,23,208
https://kawalpemilu.org#23733,"RINGIN JAYA, BANDAR NEGERI SUOH, LAMPUNG BARAT, LAMPUNG",2,169,56,225
https://kawalpemilu.org#23733,"RINGIN JAYA, BANDAR NEGERI SUOH, LAMPUNG BARAT, LAMPUNG",3,134,28,162
https://kawalpemilu.org#23733,"RINGIN JAYA, BANDAR NEGERI SUOH, LAMPUNG BARAT, LAMPUNG",4,110,16,126
https://kawalpemilu.org#23734,"TRI MEKAR JAYA, BANDAR NEGERI SUOH, LAMPUNG BARAT, LAMPUNG",1,147,47,194
https://kawalpemilu.org#23734,"TRI MEKAR JAYA, BANDAR NEGERI SUOH, LAMPUNG BARAT, LAMPUNG",2,185,56,241
https://kawalpemilu.org#23734,"TRI MEKAR JAYA, BANDAR NEGERI SUOH, LAMPUNG BARAT, LAMPUNG",3,150,26,176
https://kawalpemilu.org#23734,"TRI MEKAR JAYA, BANDAR NEGERI SUOH, LAMPUNG BARAT, LAMPUNG",4,225,40,265
https://kawalpemilu.org#23734,"TRI MEKAR JAYA, BANDAR NEGERI SUOH, LAMPUNG BARAT, LAMPUNG",5,95,30,125
https://kawalpemilu.org#23734,"TRI MEKAR JAYA, BANDAR NEGERI SUOH, LAMPUNG BARAT, LAMPUNG",6,125,19,144
https://kawalpemilu.org#23734,"TRI MEKAR JAYA, BANDAR NEGERI SUOH, LAMPUNG BARAT, LAMPUNG",7,181,72,253
https://kawalpemilu.org#23735,"TEMBELANG, BANDAR NEGERI SUOH, LAMPUNG BARAT, LAMPUNG",1,92,21,113
https://kawalpemilu.org#23735,"TEMBELANG, BANDAR NEGERI SUOH, LAMPUNG BARAT, LAMPUNG",2,113,37,150
https://kawalpemilu.org#23735,"TEMBELANG, BANDAR NEGERI SUOH, LAMPUNG BARAT, LAMPUNG",3,114,26,140
https://kawalpemilu.org#23735,"TEMBELANG, BANDAR NEGERI SUOH, LAMPUNG BARAT, LAMPUNG",4,98,56,154
https://kawalpemilu.org#23736,"TANJUNGSARI, BANDAR NEGERI SUOH, LAMPUNG BARAT, LAMPUNG",1,144,42,186
https://kawalpemilu.org#23736,"TANJUNGSARI, BANDAR NEGERI SUOH, LAMPUNG BARAT, LAMPUNG",2,197,41,238
https://kawalpemilu.org#23736,"TANJUNGSARI, BANDAR NEGERI SUOH, LAMPUNG BARAT, LAMPUNG",3,77,23,100
https://kawalpemilu.org#23736,"TANJUNGSARI, BANDAR NEGERI SUOH, LAMPUNG BARAT, LAMPUNG",4,133,21,154
https://kawalpemilu.org#84025,"NEGERI JAYA, BANDAR NEGERI SUOH, LAMPUNG BARAT, LAMPUNG",1,181,16,197
https://kawalpemilu.org#84025,"NEGERI JAYA, BANDAR NEGERI SUOH, LAMPUNG BARAT, LAMPUNG",2,182,30,212
https://kawalpemilu.org#84025,"NEGERI JAYA, BANDAR NEGERI SUOH, LAMPUNG BARAT, LAMPUNG",3,191,11,202
https://kawalpemilu.org#84025,"NEGERI JAYA, BANDAR NEGERI SUOH, LAMPUNG BARAT, LAMPUNG",4,95,10,105
https://kawalpemilu.org#23739,"MENGGALA SELATAN, MENGGALA, TULANG BAWANG, LAMPUNG",1,52,128,180
https://kawalpemilu.org#23739,"MENGGALA SELATAN, MENGGALA, TULANG BAWANG, LAMPUNG",2,72,218,290
https://kawalpemilu.org#23739,"MENGGALA SELATAN, MENGGALA, TULANG BAWANG, LAMPUNG",3,33,162,195
https://kawalpemilu.org#23739,"MENGGALA SELATAN, MENGGALA, TULANG BAWANG, LAMPUNG",4,63,179,242
https://kawalpemilu.org#23739,"MENGGALA SELATAN, MENGGALA, TULANG BAWANG, LAMPUNG",5,70,229,299
https://kawalpemilu.org#23739,"MENGGALA SELATAN, MENGGALA, TULANG BAWANG, LAMPUNG",7,51,161,212
https://kawalpemilu.org#23739,"MENGGALA SELATAN, MENGGALA, TULANG BAWANG, LAMPUNG",8,75,137,212
https://kawalpemilu.org#23739,"MENGGALA SELATAN, MENGGALA, TULANG BAWANG, LAMPUNG",9,75,194,269
https://kawalpemilu.org#23739,"MENGGALA SELATAN, MENGGALA, TULANG BAWANG, LAMPUNG",10,122,71,193
https://kawalpemilu.org#23739,"MENGGALA SELATAN, MENGGALA, TULANG BAWANG, LAMPUNG",11,103,115,218
https://kawalpemilu.org#23739,"MENGGALA SELATAN, MENGGALA, TULANG BAWANG, LAMPUNG",12,96,135,231
https://kawalpemilu.org#23739,"MENGGALA SELATAN, MENGGALA, TULANG BAWANG, LAMPUNG",13,137,111,248
https://kawalpemilu.org#23739,"MENGGALA SELATAN, MENGGALA, TULANG BAWANG, LAMPUNG",14,128,89,217
https://kawalpemilu.org#23739,"MENGGALA SELATAN, MENGGALA, TULANG BAWANG, LAMPUNG",15,40,122,162
https://kawalpemilu.org#23739,"MENGGALA SELATAN, MENGGALA, TULANG BAWANG, LAMPUNG",16,45,151,196
https://kawalpemilu.org#23739,"MENGGALA SELATAN, MENGGALA, TULANG BAWANG, LAMPUNG",17,57,150,207
https://kawalpemilu.org#23739,"MENGGALA SELATAN, MENGGALA, TULANG BAWANG, LAMPUNG",18,54,175,229
https://kawalpemilu.org#23739,"MENGGALA SELATAN, MENGGALA, TULANG BAWANG, LAMPUNG",19,45,158,203
https://kawalpemilu.org#23739,"MENGGALA SELATAN, MENGGALA, TULANG BAWANG, LAMPUNG",20,83,78,171
https://kawalpemilu.org#23739,"MENGGALA SELATAN, MENGGALA, TULANG BAWANG, LAMPUNG",21,131,70,201
https://kawalpemilu.org#23739,"MENGGALA SELATAN, MENGGALA, TULANG BAWANG, LAMPUNG",22,23,123,146
https://kawalpemilu.org#23739,"MENGGALA SELATAN, MENGGALA, TULANG BAWANG, LAMPUNG",23,67,70,137
https://kawalpemilu.org#23739,"MENGGALA SELATAN, MENGGALA, TULANG BAWANG, LAMPUNG",24,57,70,127
https://kawalpemilu.org#23740,"UJUNG GUNUNG, MENGGALA, TULANG BAWANG, LAMPUNG",1,81,155,236
https://kawalpemilu.org#23740,"UJUNG GUNUNG, MENGGALA, TULANG BAWANG, LAMPUNG",2,67,143,210
https://kawalpemilu.org#23740,"UJUNG GUNUNG, MENGGALA, TULANG BAWANG, LAMPUNG",3,50,207,257
https://kawalpemilu.org#23740,"UJUNG GUNUNG, MENGGALA, TULANG BAWANG, LAMPUNG",4,168,100,268
https://kawalpemilu.org#23740,"UJUNG GUNUNG, MENGGALA, TULANG BAWANG, LAMPUNG",5,48,145,193
https://kawalpemilu.org#23740,"UJUNG GUNUNG, MENGGALA, TULANG BAWANG, LAMPUNG",6,32,100,132
https://kawalpemilu.org#23740,"UJUNG GUNUNG, MENGGALA, TULANG BAWANG, LAMPUNG",7,62,189,251
https://kawalpemilu.org#23740,"UJUNG GUNUNG, MENGGALA, TULANG BAWANG, LAMPUNG",8,33,122,155
https://kawalpemilu.org#23740,"UJUNG GUNUNG, MENGGALA, TULANG BAWANG, LAMPUNG",9,50,146,196
https://kawalpemilu.org#23740,"UJUNG GUNUNG, MENGGALA, TULANG BAWANG, LAMPUNG",10,76,189,275
https://kawalpemilu.org#23740,"UJUNG GUNUNG, MENGGALA, TULANG BAWANG, LAMPUNG",11,67,144,211
https://kawalpemilu.org#23740,"UJUNG GUNUNG, MENGGALA, TULANG BAWANG, LAMPUNG",12,45,79,124
https://kawalpemilu.org#23740,"UJUNG GUNUNG, MENGGALA, TULANG BAWANG, LAMPUNG",13,34,127,161
https://kawalpemilu.org#23740,"UJUNG GUNUNG, MENGGALA, TULANG BAWANG, LAMPUNG",14,64,159,223
https://kawalpemilu.org#23740,"UJUNG GUNUNG, MENGGALA, TULANG BAWANG, LAMPUNG",15,65,166,231
https://kawalpemilu.org#23740,"UJUNG GUNUNG, MENGGALA, TULANG BAWANG, LAMPUNG",16,49,152,201
https://kawalpemilu.org#23740,"UJUNG GUNUNG, MENGGALA, TULANG BAWANG, LAMPUNG",17,163,109,272
https://kawalpemilu.org#23740,"UJUNG GUNUNG, MENGGALA, TULANG BAWANG, LAMPUNG",18,74,134,208
https://kawalpemilu.org#23740,"UJUNG GUNUNG, MENGGALA, TULANG BAWANG, LAMPUNG",19,29,93,122
https://kawalpemilu.org#23740,"UJUNG GUNUNG, MENGGALA, TULANG BAWANG, LAMPUNG",20,45,190,235
https://kawalpemilu.org#23740,"UJUNG GUNUNG, MENGGALA, TULANG BAWANG, LAMPUNG",21,75,154,229
https://kawalpemilu.org#23740,"UJUNG GUNUNG, MENGGALA, TULANG BAWANG, LAMPUNG",22,70,93,163
https://kawalpemilu.org#23740,"UJUNG GUNUNG, MENGGALA, TULANG BAWANG, LAMPUNG",23,34,130,164
https://kawalpemilu.org#23740,"UJUNG GUNUNG, MENGGALA, TULANG BAWANG, LAMPUNG",24,51,146,197
https://kawalpemilu.org#23740,"UJUNG GUNUNG, MENGGALA, TULANG BAWANG, LAMPUNG",25,21,87,108
https://kawalpemilu.org#23740,"UJUNG GUNUNG, MENGGALA, TULANG BAWANG, LAMPUNG",26,58,141,199
https://kawalpemilu.org#23741,"MENGGALA TENGAH, MENGGALA, TULANG BAWANG, LAMPUNG",1,31,171,202
https://kawalpemilu.org#23741,"MENGGALA TENGAH, MENGGALA, TULANG BAWANG, LAMPUNG",2,45,128,173
https://kawalpemilu.org#23741,"MENGGALA TENGAH, MENGGALA, TULANG BAWANG, LAMPUNG",3,55,167,222
https://kawalpemilu.org#23741,"MENGGALA TENGAH, MENGGALA, TULANG BAWANG, LAMPUNG",4,80,146,226
https://kawalpemilu.org#23741,"MENGGALA TENGAH, MENGGALA, TULANG BAWANG, LAMPUNG",5,55,152,207
https://kawalpemilu.org#23741,"MENGGALA TENGAH, MENGGALA, TULANG BAWANG, LAMPUNG",6,51,101,152
https://kawalpemilu.org#23741,"MENGGALA TENGAH, MENGGALA, TULANG BAWANG, LAMPUNG",7,106,133,239
https://kawalpemilu.org#23741,"MENGGALA TENGAH, MENGGALA, TULANG BAWANG, LAMPUNG",8,75,117,193
https://kawalpemilu.org#23741,"MENGGALA TENGAH, MENGGALA, TULANG BAWANG, LAMPUNG",9,39,77,116
https://kawalpemilu.org#23741,"MENGGALA TENGAH, MENGGALA, TULANG BAWANG, LAMPUNG",10,41,113,154
https://kawalpemilu.org#23741,"MENGGALA TENGAH, MENGGALA, TULANG BAWANG, LAMPUNG",11,47,152,199
https://kawalpemilu.org#23741,"MENGGALA TENGAH, MENGGALA, TULANG BAWANG, LAMPUNG",12,93,127,220
https://kawalpemilu.org#23741,"MENGGALA TENGAH, MENGGALA, TULANG BAWANG, LAMPUNG",13,129,104,233
https://kawalpemilu.org#23741,"MENGGALA TENGAH, MENGGALA, TULANG BAWANG, LAMPUNG",14,38,98,136
https://kawalpemilu.org#23741,"MENGGALA TENGAH, MENGGALA, TULANG BAWANG, LAMPUNG",15,74,142,216
https://kawalpemilu.org#23741,"MENGGALA TENGAH, MENGGALA, TULANG BAWANG, LAMPUNG",16,52,100,152
https://kawalpemilu.org#23741,"MENGGALA TENGAH, MENGGALA, TULANG BAWANG, LAMPUNG",17,68,70,138
https://kawalpemilu.org#23741,"MENGGALA TENGAH, MENGGALA, TULANG BAWANG, LAMPUNG",18,65,100,165
https://kawalpemilu.org#23741,"MENGGALA TENGAH, MENGGALA, TULANG BAWANG, LAMPUNG",19,27,101,128
https://kawalpemilu.org#23741,"MENGGALA TENGAH, MENGGALA, TULANG BAWANG, LAMPUNG",20,46,103,149
https://kawalpemilu.org#23741,"MENGGALA TENGAH, MENGGALA, TULANG BAWANG, LAMPUNG",21,27,80,107
https://kawalpemilu.org#23741,"MENGGALA TENGAH, MENGGALA, TULANG BAWANG, LAMPUNG",22,7,20,27
https://kawalpemilu.org#23741,"MENGGALA TENGAH, MENGGALA, TULANG BAWANG, LAMPUNG",23,2,5,7
https://kawalpemilu.org#23742,"MENGGALA KOTA, MENGGALA, TULANG BAWANG, LAMPUNG",1,62,193,255
https://kawalpemilu.org#23742,"MENGGALA KOTA, MENGGALA, TULANG BAWANG, LAMPUNG",2,51,148,199
https://kawalpemilu.org#23742,"MENGGALA KOTA, MENGGALA, TULANG BAWANG, LAMPUNG",3,71,180,251
https://kawalpemilu.org#23742,"MENGGALA KOTA, MENGGALA, TULANG BAWANG, LAMPUNG",4,71,156,227
https://kawalpemilu.org#23742,"MENGGALA KOTA, MENGGALA, TULANG BAWANG, LAMPUNG",5,72,189,261
https://kawalpemilu.org#23742,"MENGGALA KOTA, MENGGALA, TULANG BAWANG, LAMPUNG",6,58,130,188
https://kawalpemilu.org#23742,"MENGGALA KOTA, MENGGALA, TULANG BAWANG, LAMPUNG",7,77,208,285
https://kawalpemilu.org#23742,"MENGGALA KOTA, MENGGALA, TULANG BAWANG, LAMPUNG",8,130,155,285
https://kawalpemilu.org#23742,"MENGGALA KOTA, MENGGALA, TULANG BAWANG, LAMPUNG",9,20,117,137
https://kawalpemilu.org#23742,"MENGGALA KOTA, MENGGALA, TULANG BAWANG, LAMPUNG",10,49,104,153
https://kawalpemilu.org#23742,"MENGGALA KOTA, MENGGALA, TULANG BAWANG, LAMPUNG",11,86,136,222
https://kawalpemilu.org#23742,"MENGGALA KOTA, MENGGALA, TULANG BAWANG, LAMPUNG",12,53,132,185
https://kawalpemilu.org#23742,"MENGGALA KOTA, MENGGALA, TULANG BAWANG, LAMPUNG",13,93,144,237
https://kawalpemilu.org#23742,"MENGGALA KOTA, MENGGALA, TULANG BAWANG, LAMPUNG",14,40,144,184
https://kawalpemilu.org#23742,"MENGGALA KOTA, MENGGALA, TULANG BAWANG, LAMPUNG",15,81,88,169
https://kawalpemilu.org#23742,"MENGGALA KOTA, MENGGALA, TULANG BAWANG, LAMPUNG",16,29,102,131
https://kawalpemilu.org#23742,"MENGGALA KOTA, MENGGALA, TULANG BAWANG, LAMPUNG",17,37,81,118
https://kawalpemilu.org#23743,"BUJUNG TENUK, MENGGALA, TULANG BAWANG, LAMPUNG",1,52,83,135
https://kawalpemilu.org#23743,"BUJUNG TENUK, MENGGALA, TULANG BAWANG, LAMPUNG",2,143,84,227
https://kawalpemilu.org#23743,"BUJUNG TENUK, MENGGALA, TULANG BAWANG, LAMPUNG",3,95,142,237
https://kawalpemilu.org#23743,"BUJUNG TENUK, MENGGALA, TULANG BAWANG, LAMPUNG",4,134,26,160
https://kawalpemilu.org#23743,"BUJUNG TENUK, MENGGALA, TULANG BAWANG, LAMPUNG",5,80,56,136
https://kawalpemilu.org#23743,"BUJUNG TENUK, MENGGALA, TULANG BAWANG, LAMPUNG",6,141,55,196
https://kawalpemilu.org#23743,"BUJUNG TENUK, MENGGALA, TULANG BAWANG, LAMPUNG",7,107,130,237
https://kawalpemilu.org#23743,"BUJUNG TENUK, MENGGALA, TULANG BAWANG, LAMPUNG",8,116,51,167
https://kawalpemilu.org#23744,"UJUNG GUNUNG ILIR, MENGGALA, TULANG BAWANG, LAMPUNG",1,149,24,173
https://kawalpemilu.org#23744,"UJUNG GUNUNG ILIR, MENGGALA, TULANG BAWANG, LAMPUNG",2,179,39,218
https://kawalpemilu.org#23744,"UJUNG GUNUNG ILIR, MENGGALA, TULANG BAWANG, LAMPUNG",3,135,46,181
https://kawalpemilu.org#23744,"UJUNG GUNUNG ILIR, MENGGALA, TULANG BAWANG, LAMPUNG",4,144,46,190
https://kawalpemilu.org#23744,"UJUNG GUNUNG ILIR, MENGGALA, TULANG BAWANG, LAMPUNG",5,201,50,251
https://kawalpemilu.org#23744,"UJUNG GUNUNG ILIR, MENGGALA, TULANG BAWANG, LAMPUNG",6,119,46,165
https://kawalpemilu.org#23744,"UJUNG GUNUNG ILIR, MENGGALA, TULANG BAWANG, LAMPUNG",7,94,66,160
https://kawalpemilu.org#23744,"UJUNG GUNUNG ILIR, MENGGALA, TULANG BAWANG, LAMPUNG",8,97,68,165
https://kawalpemilu.org#23744,"UJUNG GUNUNG ILIR, MENGGALA, TULANG BAWANG, LAMPUNG",9,106,26,132
https://kawalpemilu.org#23744,"UJUNG GUNUNG ILIR, MENGGALA, TULANG BAWANG, LAMPUNG",10,126,29,155
https://kawalpemilu.org#23744,"UJUNG GUNUNG ILIR, MENGGALA, TULANG BAWANG, LAMPUNG",11,129,36,165
https://kawalpemilu.org#23744,"UJUNG GUNUNG ILIR, MENGGALA, TULANG BAWANG, LAMPUNG",12,135,31,166
https://kawalpemilu.org#23744,"UJUNG GUNUNG ILIR, MENGGALA, TULANG BAWANG, LAMPUNG",13,85,66,151
https://kawalpemilu.org#23744,"UJUNG GUNUNG ILIR, MENGGALA, TULANG BAWANG, LAMPUNG",14,99,35,134
https://kawalpemilu.org#23744,"UJUNG GUNUNG ILIR, MENGGALA, TULANG BAWANG, LAMPUNG",15,94,33,127
https://kawalpemilu.org#23746,"ASTRA KSETRA, MENGGALA, TULANG BAWANG, LAMPUNG",1,100,90,190
https://kawalpemilu.org#23746,"ASTRA KSETRA, MENGGALA, TULANG BAWANG, LAMPUNG",4,159,81,240
https://kawalpemilu.org#23746,"ASTRA KSETRA, MENGGALA, TULANG BAWANG, LAMPUNG",5,81,66,147
https://kawalpemilu.org#23746,"ASTRA KSETRA, MENGGALA, TULANG BAWANG, LAMPUNG",6,108,59,167
https://kawalpemilu.org#23746,"ASTRA KSETRA, MENGGALA, TULANG BAWANG, LAMPUNG",7,126,39,165
https://kawalpemilu.org#23747,"KAGUNGAN RAHAYU, MENGGALA, TULANG BAWANG, LAMPUNG",1,129,33,162
https://kawalpemilu.org#23747,"KAGUNGAN RAHAYU, MENGGALA, TULANG BAWANG, LAMPUNG",2,120,39,159
https://kawalpemilu.org#23747,"KAGUNGAN RAHAYU, MENGGALA, TULANG BAWANG, LAMPUNG",3,159,40,199
https://kawalpemilu.org#23747,"KAGUNGAN RAHAYU, MENGGALA, TULANG BAWANG, LAMPUNG",4,158,33,191
https://kawalpemilu.org#23747,"KAGUNGAN RAHAYU, MENGGALA, TULANG BAWANG, LAMPUNG",5,134,117,251
https://kawalpemilu.org#23747,"KAGUNGAN RAHAYU, MENGGALA, TULANG BAWANG, LAMPUNG",6,102,60,162
https://kawalpemilu.org#23747,"KAGUNGAN RAHAYU, MENGGALA, TULANG BAWANG, LAMPUNG",7,96,58,154
https://kawalpemilu.org#23747,"KAGUNGAN RAHAYU, MENGGALA, TULANG BAWANG, LAMPUNG",8,188,62,250
https://kawalpemilu.org#23747,"KAGUNGAN RAHAYU, MENGGALA, TULANG BAWANG, LAMPUNG",9,152,29,181
https://kawalpemilu.org#23747,"KAGUNGAN RAHAYU, MENGGALA, TULANG BAWANG, LAMPUNG",10,106,40,146
https://kawalpemilu.org#23747,"KAGUNGAN RAHAYU, MENGGALA, TULANG BAWANG, LAMPUNG",11,128,44,172
https://kawalpemilu.org#23747,"KAGUNGAN RAHAYU, MENGGALA, TULANG BAWANG, LAMPUNG",12,127,53,180
https://kawalpemilu.org#23747,"KAGUNGAN RAHAYU, MENGGALA, TULANG BAWANG, LAMPUNG",13,90,60,150
https://kawalpemilu.org#23748,"TIUH TOHOU, MENGGALA, TULANG BAWANG, LAMPUNG",1,121,84,205
https://kawalpemilu.org#23748,"TIUH TOHOU, MENGGALA, TULANG BAWANG, LAMPUNG",2,138,74,212
https://kawalpemilu.org#23748,"TIUH TOHOU, MENGGALA, TULANG BAWANG, LAMPUNG",3,40,79,119
https://kawalpemilu.org#23748,"TIUH TOHOU, MENGGALA, TULANG BAWANG, LAMPUNG",4,84,117,201
https://kawalpemilu.org#23748,"TIUH TOHOU, MENGGALA, TULANG BAWANG, LAMPUNG",5,81,32,113
https://kawalpemilu.org#23748,"TIUH TOHOU, MENGGALA, TULANG BAWANG, LAMPUNG",6,106,62,168
https://kawalpemilu.org#23748,"TIUH TOHOU, MENGGALA, TULANG BAWANG, LAMPUNG",7,60,124,184
https://kawalpemilu.org#23750,"AJI JAYA KNPI, GEDUNG AJI, TULANG BAWANG, LAMPUNG",1,163,66,229
https://kawalpemilu.org#23750,"AJI JAYA KNPI, GEDUNG AJI, TULANG BAWANG, LAMPUNG",2,131,90,221
https://kawalpemilu.org#23750,"AJI JAYA KNPI, GEDUNG AJI, TULANG BAWANG, LAMPUNG",3,122,92,214
https://kawalpemilu.org#23750,"AJI JAYA KNPI, GEDUNG AJI, TULANG BAWANG, LAMPUNG",4,129,106,235
https://kawalpemilu.org#23750,"AJI JAYA KNPI, GEDUNG AJI, TULANG BAWANG, LAMPUNG",5,123,93,216
https://kawalpemilu.org#23750,"AJI JAYA KNPI, GEDUNG AJI, TULANG BAWANG, LAMPUNG",6,70,54,124
https://kawalpemilu.org#23750,"AJI JAYA KNPI, GEDUNG AJI, TULANG BAWANG, LAMPUNG",7,76,48,124
https://kawalpemilu.org#23750,"AJI JAYA KNPI, GEDUNG AJI, TULANG BAWANG, LAMPUNG",8,65,64,129
https://kawalpemilu.org#23750,"AJI JAYA KNPI, GEDUNG AJI, TULANG BAWANG, LAMPUNG",9,67,47,114
https://kawalpemilu.org#23750,"AJI JAYA KNPI, GEDUNG AJI, TULANG BAWANG, LAMPUNG",10,90,24,114
https://kawalpemilu.org#23751,"KECUBUNG JAYA, GEDUNG AJI, TULANG BAWANG, LAMPUNG",1,103,66,169
https://kawalpemilu.org#23751,"KECUBUNG JAYA, GEDUNG AJI, TULANG BAWANG, LAMPUNG",2,103,36,139
https://kawalpemilu.org#23751,"KECUBUNG JAYA, GEDUNG AJI, TULANG BAWANG, LAMPUNG",3,114,70,184
https://kawalpemilu.org#23751,"KECUBUNG JAYA, GEDUNG AJI, TULANG BAWANG, LAMPUNG",4,97,75,172
https://kawalpemilu.org#23751,"KECUBUNG JAYA, GEDUNG AJI, TULANG BAWANG, LAMPUNG",5,115,41,156
https://kawalpemilu.org#23751,"KECUBUNG JAYA, GEDUNG AJI, TULANG BAWANG, LAMPUNG",6,136,41,177
https://kawalpemilu.org#23752,"KECUBUNG MULYA, GEDUNG AJI, TULANG BAWANG, LAMPUNG",1,206,38,244
https://kawalpemilu.org#23752,"KECUBUNG MULYA, GEDUNG AJI, TULANG BAWANG, LAMPUNG",2,171,55,226
https://kawalpemilu.org#23752,"KECUBUNG MULYA, GEDUNG AJI, TULANG BAWANG, LAMPUNG",3,161,76,237
https://kawalpemilu.org#23752,"KECUBUNG MULYA, GEDUNG AJI, TULANG BAWANG, LAMPUNG",4,78,24,102
https://kawalpemilu.org#23752,"KECUBUNG MULYA, GEDUNG AJI, TULANG BAWANG, LAMPUNG",5,92,24,116
https://kawalpemilu.org#23752,"KECUBUNG MULYA, GEDUNG AJI, TULANG BAWANG, LAMPUNG",6,64,31,95
https://kawalpemilu.org#23753,"GEDUNG AJI, GEDUNG AJI, TULANG BAWANG, LAMPUNG",1,42,90,132
https://kawalpemilu.org#23753,"GEDUNG AJI, GEDUNG AJI, TULANG BAWANG, LAMPUNG",2,63,73,136
https://kawalpemilu.org#23753,"GEDUNG AJI, GEDUNG AJI, TULANG BAWANG, LAMPUNG",3,41,93,134
https://kawalpemilu.org#23753,"GEDUNG AJI, GEDUNG AJI, TULANG BAWANG, LAMPUNG",4,55,91,146
https://kawalpemilu.org#23754,"PENAWAR, GEDUNG AJI, TULANG BAWANG, LAMPUNG",1,47,130,177
https://kawalpemilu.org#23754,"PENAWAR, GEDUNG AJI, TULANG BAWANG, LAMPUNG",2,67,52,119
https://kawalpemilu.org#23754,"PENAWAR, GEDUNG AJI, TULANG BAWANG, LAMPUNG",3,64,125,189
https://kawalpemilu.org#23755,"PENAWAR BARU, GEDUNG AJI, TULANG BAWANG, LAMPUNG",1,100,52,152
https://kawalpemilu.org#23755,"PENAWAR BARU, GEDUNG AJI, TULANG BAWANG, LAMPUNG",2,90,46,136
https://kawalpemilu.org#23755,"PENAWAR BARU, GEDUNG AJI, TULANG BAWANG, LAMPUNG",3,117,28,145
https://kawalpemilu.org#23755,"PENAWAR BARU, GEDUNG AJI, TULANG BAWANG, LAMPUNG",4,94,57,151
https://kawalpemilu.org#23755,"PENAWAR BARU, GEDUNG AJI, TULANG BAWANG, LAMPUNG",5,112,22,134
https://kawalpemilu.org#23755,"PENAWAR BARU, GEDUNG AJI, TULANG BAWANG, LAMPUNG",6,99,35,134
https://kawalpemilu.org#23756,"AJI MURNI JAYA, GEDUNG AJI, TULANG BAWANG, LAMPUNG",1,135,27,162
https://kawalpemilu.org#23756,"AJI MURNI JAYA, GEDUNG AJI, TULANG BAWANG, LAMPUNG",2,117,35,152
https://kawalpemilu.org#23756,"AJI MURNI JAYA, GEDUNG AJI, TULANG BAWANG, LAMPUNG",3,83,32,115
https://kawalpemilu.org#23756,"AJI MURNI JAYA, GEDUNG AJI, TULANG BAWANG, LAMPUNG",4,115,25,140
https://kawalpemilu.org#23757,"AJI MESIR, GEDUNG AJI, TULANG BAWANG, LAMPUNG",1,129,15,144
https://kawalpemilu.org#23757,"AJI MESIR, GEDUNG AJI, TULANG BAWANG, LAMPUNG",2,137,11,148
https://kawalpemilu.org#23757,"AJI MESIR, GEDUNG AJI, TULANG BAWANG, LAMPUNG",3,168,8,176
https://kawalpemilu.org#23757,"AJI MESIR, GEDUNG AJI, TULANG BAWANG, LAMPUNG",4,132,17,149
https://kawalpemilu.org#23758,"AJI PERMAI TALANG BUAH, GEDUNG AJI, TULANG BAWANG, LAMPUNG",1,137,31,168
https://kawalpemilu.org#23758,"AJI PERMAI TALANG BUAH, GEDUNG AJI, TULANG BAWANG, LAMPUNG",2,170,31,201
https://kawalpemilu.org#23758,"AJI PERMAI TALANG BUAH, GEDUNG AJI, TULANG BAWANG, LAMPUNG",3,101,19,120
https://kawalpemilu.org#23759,"BANDAR AJI JAYA, GEDUNG AJI, TULANG BAWANG, LAMPUNG",1,210,18,228
https://kawalpemilu.org#23759,"BANDAR AJI JAYA, GEDUNG AJI, TULANG BAWANG, LAMPUNG",2,237,18,255
https://kawalpemilu.org#23761,"BANJAR AGUNG, BANJAR AGUNG, TULANG BAWANG, LAMPUNG",1,69,102,171
https://kawalpemilu.org#23761,"BANJAR AGUNG, BANJAR AGUNG, TULANG BAWANG, LAMPUNG",2,61,79,140
https://kawalpemilu.org#23761,"BANJAR AGUNG, BANJAR AGUNG, TULANG BAWANG, LAMPUNG",3,159,47,206
https://kawalpemilu.org#23761,"BANJAR AGUNG, BANJAR AGUNG, TULANG BAWANG, LAMPUNG",4,94,99,193
https://kawalpemilu.org#23761,"BANJAR AGUNG, BANJAR AGUNG, TULANG BAWANG, LAMPUNG",5,135,107,242
https://kawalpemilu.org#23761,"BANJAR AGUNG, BANJAR AGUNG, TULANG BAWANG, LAMPUNG",6,120,37,157
https://kawalpemilu.org#23761,"BANJAR AGUNG, BANJAR AGUNG, TULANG BAWANG, LAMPUNG",7,40,77,117
https://kawalpemilu.org#23761,"BANJAR AGUNG, BANJAR AGUNG, TULANG BAWANG, LAMPUNG",8,104,66,170
https://kawalpemilu.org#23761,"BANJAR AGUNG, BANJAR AGUNG, TULANG BAWANG, LAMPUNG",9,41,71,112
https://kawalpemilu.org#23761,"BANJAR AGUNG, BANJAR AGUNG, TULANG BAWANG, LAMPUNG",10,115,61,176
https://kawalpemilu.org#23761,"BANJAR AGUNG, BANJAR AGUNG, TULANG BAWANG, LAMPUNG",11,108,41,149
https://kawalpemilu.org#23763,"TRI DARMA WIRAJAYA, BANJAR AGUNG, TULANG BAWANG, LAMPUNG",1,86,92,178
https://kawalpemilu.org#23763,"TRI DARMA WIRAJAYA, BANJAR AGUNG, TULANG BAWANG, LAMPUNG",2,78,62,140
https://kawalpemilu.org#23763,"TRI DARMA WIRAJAYA, BANJAR AGUNG, TULANG BAWANG, LAMPUNG",3,164,37,201
https://kawalpemilu.org#23763,"TRI DARMA WIRAJAYA, BANJAR AGUNG, TULANG BAWANG, LAMPUNG",4,64,66,130
https://kawalpemilu.org#23763,"TRI DARMA WIRAJAYA, BANJAR AGUNG, TULANG BAWANG, LAMPUNG",5,130,58,188
https://kawalpemilu.org#23763,"TRI DARMA WIRAJAYA, BANJAR AGUNG, TULANG BAWANG, LAMPUNG",6,77,90,167
https://kawalpemilu.org#23763,"TRI DARMA WIRAJAYA, BANJAR AGUNG, TULANG BAWANG, LAMPUNG",7,98,60,158
https://kawalpemilu.org#23764,"MORIS JAYA, BANJAR AGUNG, TULANG BAWANG, LAMPUNG",1,149,91,240
https://kawalpemilu.org#23764,"MORIS JAYA, BANJAR AGUNG, TULANG BAWANG, LAMPUNG",2,70,95,165
https://kawalpemilu.org#23764,"MORIS JAYA, BANJAR AGUNG, TULANG BAWANG, LAMPUNG",3,109,134,243
https://kawalpemilu.org#23764,"MORIS JAYA, BANJAR AGUNG, TULANG BAWANG, LAMPUNG",4,99,118,217
https://kawalpemilu.org#23764,"MORIS JAYA, BANJAR AGUNG, TULANG BAWANG, LAMPUNG",5,211,12,223
https://kawalpemilu.org#23764,"MORIS JAYA, BANJAR AGUNG, TULANG BAWANG, LAMPUNG",6,56,86,142
https://kawalpemilu.org#23764,"MORIS JAYA, BANJAR AGUNG, TULANG BAWANG, LAMPUNG",7,142,61,203
https://kawalpemilu.org#23764,"MORIS JAYA, BANJAR AGUNG, TULANG BAWANG, LAMPUNG",8,118,80,198
https://kawalpemilu.org#23764,"MORIS JAYA, BANJAR AGUNG, TULANG BAWANG, LAMPUNG",9,118,109,227
https://kawalpemilu.org#23764,"MORIS JAYA, BANJAR AGUNG, TULANG BAWANG, LAMPUNG",10,90,126,216
https://kawalpemilu.org#23764,"MORIS JAYA, BANJAR AGUNG, TULANG BAWANG, LAMPUNG",11,93,51,144
https://kawalpemilu.org#23765,"TUNGGAL WARGA, BANJAR AGUNG, TULANG BAWANG, LAMPUNG",1,89,83,172
https://kawalpemilu.org#23765,"TUNGGAL WARGA, BANJAR AGUNG, TULANG BAWANG, LAMPUNG",2,94,57,150
https://kawalpemilu.org#23765,"TUNGGAL WARGA, BANJAR AGUNG, TULANG BAWANG, LAMPUNG",3,104,87,191
https://kawalpemilu.org#23765,"TUNGGAL WARGA, BANJAR AGUNG, TULANG BAWANG, LAMPUNG",4,124,67,191
https://kawalpemilu.org#23765,"TUNGGAL WARGA, BANJAR AGUNG, TULANG BAWANG, LAMPUNG",5,102,86,188
https://kawalpemilu.org#23765,"TUNGGAL WARGA, BANJAR AGUNG, TULANG BAWANG, LAMPUNG",6,116,67,183
https://kawalpemilu.org#23765,"TUNGGAL WARGA, BANJAR AGUNG, TULANG BAWANG, LAMPUNG",7,125,72,197
https://kawalpemilu.org#23765,"TUNGGAL WARGA, BANJAR AGUNG, TULANG BAWANG, LAMPUNG",8,141,82,223
https://kawalpemilu.org#23765,"TUNGGAL WARGA, BANJAR AGUNG, TULANG BAWANG, LAMPUNG",9,110,70,180
https://kawalpemilu.org#23765,"TUNGGAL WARGA, BANJAR AGUNG, TULANG BAWANG, LAMPUNG",10,142,81,223
https://kawalpemilu.org#23765,"TUNGGAL WARGA, BANJAR AGUNG, TULANG BAWANG, LAMPUNG",12,113,71,184
https://kawalpemilu.org#23765,"TUNGGAL WARGA, BANJAR AGUNG, TULANG BAWANG, LAMPUNG",13,97,41,138
https://kawalpemilu.org#23765,"TUNGGAL WARGA, BANJAR AGUNG, TULANG BAWANG, LAMPUNG",14,102,74,176
https://kawalpemilu.org#23765,"TUNGGAL WARGA, BANJAR AGUNG, TULANG BAWANG, LAMPUNG",15,141,75,216
https://kawalpemilu.org#23766,"DWI WARGA TUNGGAL JAYA, BANJAR AGUNG, TULANG BAWANG, LAMPUNG",1,147,58,205
https://kawalpemilu.org#23766,"DWI WARGA TUNGGAL JAYA, BANJAR AGUNG, TULANG BAWANG, LAMPUNG",2,101,99,200
https://kawalpemilu.org#23766,"DWI WARGA TUNGGAL JAYA, BANJAR AGUNG, TULANG BAWANG, LAMPUNG",3,134,115,249
https://kawalpemilu.org#23766,"DWI WARGA TUNGGAL JAYA, BANJAR AGUNG, TULANG BAWANG, LAMPUNG",4,76,84,160
https://kawalpemilu.org#23766,"DWI WARGA TUNGGAL JAYA, BANJAR AGUNG, TULANG BAWANG, LAMPUNG",5,84,44,128
https://kawalpemilu.org#23766,"DWI WARGA TUNGGAL JAYA, BANJAR AGUNG, TULANG BAWANG, LAMPUNG",6,52,111,164
https://kawalpemilu.org#23766,"DWI WARGA TUNGGAL JAYA, BANJAR AGUNG, TULANG BAWANG, LAMPUNG",7,94,160,254
https://kawalpemilu.org#23766,"DWI WARGA TUNGGAL JAYA, BANJAR AGUNG, TULANG BAWANG, LAMPUNG",8,122,135,257
https://kawalpemilu.org#23766,"DWI WARGA TUNGGAL JAYA, BANJAR AGUNG, TULANG BAWANG, LAMPUNG",9,101,94,195
https://kawalpemilu.org#23766,"DWI WARGA TUNGGAL JAYA, BANJAR AGUNG, TULANG BAWANG, LAMPUNG",10,135,10,145
https://kawalpemilu.org#23766,"DWI WARGA TUNGGAL JAYA, BANJAR AGUNG, TULANG BAWANG, LAMPUNG",11,119,132,251
https://kawalpemilu.org#23766,"DWI WARGA TUNGGAL JAYA, BANJAR AGUNG, TULANG BAWANG, LAMPUNG",12,85,138,223
https://kawalpemilu.org#23766,"DWI WARGA TUNGGAL JAYA, BANJAR AGUNG, TULANG BAWANG, LAMPUNG",13,165,103,268
https://kawalpemilu.org#23766,"DWI WARGA TUNGGAL JAYA, BANJAR AGUNG, TULANG BAWANG, LAMPUNG",14,80,80,160
https://kawalpemilu.org#23766,"DWI WARGA TUNGGAL JAYA, BANJAR AGUNG, TULANG BAWANG, LAMPUNG",15,81,127,208
https://kawalpemilu.org#23766,"DWI WARGA TUNGGAL JAYA, BANJAR AGUNG, TULANG BAWANG, LAMPUNG",16,80,76,156
https://kawalpemilu.org#23766,"DWI WARGA TUNGGAL JAYA, BANJAR AGUNG, TULANG BAWANG, LAMPUNG",17,74,77,151
https://kawalpemilu.org#23766,"DWI WARGA TUNGGAL JAYA, BANJAR AGUNG, TULANG BAWANG, LAMPUNG",18,122,135,257
https://kawalpemilu.org#23766,"DWI WARGA TUNGGAL JAYA, BANJAR AGUNG, TULANG BAWANG, LAMPUNG",19,51,103,154
https://kawalpemilu.org#23766,"DWI WARGA TUNGGAL JAYA, BANJAR AGUNG, TULANG BAWANG, LAMPUNG",20,112,61,173
https://kawalpemilu.org#23766,"DWI WARGA TUNGGAL JAYA, BANJAR AGUNG, TULANG BAWANG, LAMPUNG",21,95,110,205
https://kawalpemilu.org#23766,"DWI WARGA TUNGGAL JAYA, BANJAR AGUNG, TULANG BAWANG, LAMPUNG",22,125,159,284
https://kawalpemilu.org#23766,"DWI WARGA TUNGGAL JAYA, BANJAR AGUNG, TULANG BAWANG, LAMPUNG",23,62,45,107
https://kawalpemilu.org#23766,"DWI WARGA TUNGGAL JAYA, BANJAR AGUNG, TULANG BAWANG, LAMPUNG",24,78,73,151
https://kawalpemilu.org#23766,"DWI WARGA TUNGGAL JAYA, BANJAR AGUNG, TULANG BAWANG, LAMPUNG",25,120,6,126
https://kawalpemilu.org#23767,"TRI MULYA JAYA, BANJAR AGUNG, TULANG BAWANG, LAMPUNG",1,110,82,192
https://kawalpemilu.org#23767,"TRI MULYA JAYA, BANJAR AGUNG, TULANG BAWANG, LAMPUNG",2,148,46,194
https://kawalpemilu.org#23767,"TRI MULYA JAYA, BANJAR AGUNG, TULANG BAWANG, LAMPUNG",3,140,31,171
https://kawalpemilu.org#23767,"TRI MULYA JAYA, BANJAR AGUNG, TULANG BAWANG, LAMPUNG",4,113,87,200
https://kawalpemilu.org#23767,"TRI MULYA JAYA, BANJAR AGUNG, TULANG BAWANG, LAMPUNG",5,142,34,176
https://kawalpemilu.org#23768,"TRI MUKTI JAYA, BANJAR AGUNG, TULANG BAWANG, LAMPUNG",1,68,88,156
https://kawalpemilu.org#23768,"TRI MUKTI JAYA, BANJAR AGUNG, TULANG BAWANG, LAMPUNG",2,122,111,233
https://kawalpemilu.org#23768,"TRI MUKTI JAYA, BANJAR AGUNG, TULANG BAWANG, LAMPUNG",3,136,63,199
https://kawalpemilu.org#23768,"TRI MUKTI JAYA, BANJAR AGUNG, TULANG BAWANG, LAMPUNG",4,128,82,210
https://kawalpemilu.org#23769,"TRI TUNGGAL JAYA, BANJAR AGUNG, TULANG BAWANG, LAMPUNG",1,96,56,152
https://kawalpemilu.org#23769,"TRI TUNGGAL JAYA, BANJAR AGUNG, TULANG BAWANG, LAMPUNG",2,103,76,179
https://kawalpemilu.org#23769,"TRI TUNGGAL JAYA, BANJAR AGUNG, TULANG BAWANG, LAMPUNG",3,101,95,196
https://kawalpemilu.org#23769,"TRI TUNGGAL JAYA, BANJAR AGUNG, TULANG BAWANG, LAMPUNG",4,157,92,249
https://kawalpemilu.org#23769,"TRI TUNGGAL JAYA, BANJAR AGUNG, TULANG BAWANG, LAMPUNG",5,123,69,192
https://kawalpemilu.org#23769,"TRI TUNGGAL JAYA, BANJAR AGUNG, TULANG BAWANG, LAMPUNG",6,82,77,159
https://kawalpemilu.org#23769,"TRI TUNGGAL JAYA, BANJAR AGUNG, TULANG BAWANG, LAMPUNG",7,134,89,223
https://kawalpemilu.org#23769,"TRI TUNGGAL JAYA, BANJAR AGUNG, TULANG BAWANG, LAMPUNG",8,144,52,196
https://kawalpemilu.org#23769,"TRI TUNGGAL JAYA, BANJAR AGUNG, TULANG BAWANG, LAMPUNG",9,146,86,232
https://kawalpemilu.org#23769,"TRI TUNGGAL JAYA, BANJAR AGUNG, TULANG BAWANG, LAMPUNG",10,102,46,148
https://kawalpemilu.org#23769,"TRI TUNGGAL JAYA, BANJAR AGUNG, TULANG BAWANG, LAMPUNG",11,63,97,160
https://kawalpemilu.org#23769,"TRI TUNGGAL JAYA, BANJAR AGUNG, TULANG BAWANG, LAMPUNG",12,106,98,204
https://kawalpemilu.org#23769,"TRI TUNGGAL JAYA, BANJAR AGUNG, TULANG BAWANG, LAMPUNG",13,119,153,272
https://kawalpemilu.org#23769,"TRI TUNGGAL JAYA, BANJAR AGUNG, TULANG BAWANG, LAMPUNG",14,93,105,198
https://kawalpemilu.org#23769,"TRI TUNGGAL JAYA, BANJAR AGUNG, TULANG BAWANG, LAMPUNG",15,66,78,144
https://kawalpemilu.org#23769,"TRI TUNGGAL JAYA, BANJAR AGUNG, TULANG BAWANG, LAMPUNG",16,148,58,206
https://kawalpemilu.org#23769,"TRI TUNGGAL JAYA, BANJAR AGUNG, TULANG BAWANG, LAMPUNG",17,90,63,153
https://kawalpemilu.org#23769,"TRI TUNGGAL JAYA, BANJAR AGUNG, TULANG BAWANG, LAMPUNG",18,82,70,152
https://kawalpemilu.org#23770,"WARGA MAKMUR JAYA, BANJAR AGUNG, TULANG BAWANG, LAMPUNG",1,117,98,215
https://kawalpemilu.org#23770,"WARGA MAKMUR JAYA, BANJAR AGUNG, TULANG BAWANG, LAMPUNG",2,126,66,192
https://kawalpemilu.org#23770,"WARGA MAKMUR JAYA, BANJAR AGUNG, TULANG BAWANG, LAMPUNG",3,102,84,186
https://kawalpemilu.org#23770,"WARGA MAKMUR JAYA, BANJAR AGUNG, TULANG BAWANG, LAMPUNG",4,115,50,165
https://kawalpemilu.org#23770,"WARGA MAKMUR JAYA, BANJAR AGUNG, TULANG BAWANG, LAMPUNG",5,99,66,165
https://kawalpemilu.org#23770,"WARGA MAKMUR JAYA, BANJAR AGUNG, TULANG BAWANG, LAMPUNG",6,103,115,218
https://kawalpemilu.org#23770,"WARGA MAKMUR JAYA, BANJAR AGUNG, TULANG BAWANG, LAMPUNG",7,123,64,187
https://kawalpemilu.org#23770,"WARGA MAKMUR JAYA, BANJAR AGUNG, TULANG BAWANG, LAMPUNG",8,106,70,176
https://kawalpemilu.org#23770,"WARGA MAKMUR JAYA, BANJAR AGUNG, TULANG BAWANG, LAMPUNG",9,126,48,174
https://kawalpemilu.org#23771,"WARGA INDAH JAYA, BANJAR AGUNG, TULANG BAWANG, LAMPUNG",1,203,35,238
https://kawalpemilu.org#23771,"WARGA INDAH JAYA, BANJAR AGUNG, TULANG BAWANG, LAMPUNG",2,234,4,238
https://kawalpemilu.org#23772,"BANJAR DEWA, BANJAR AGUNG, TULANG BAWANG, LAMPUNG",1,149,39,188
https://kawalpemilu.org#23772,"BANJAR DEWA, BANJAR AGUNG, TULANG BAWANG, LAMPUNG",2,171,36,207
https://kawalpemilu.org#23772,"BANJAR DEWA, BANJAR AGUNG, TULANG BAWANG, LAMPUNG",3,217,18,235
https://kawalpemilu.org#23772,"BANJAR DEWA, BANJAR AGUNG, TULANG BAWANG, LAMPUNG",4,244,5,249
https://kawalpemilu.org#23772,"BANJAR DEWA, BANJAR AGUNG, TULANG BAWANG, LAMPUNG",5,136,51,187
https://kawalpemilu.org#23772,"BANJAR DEWA, BANJAR AGUNG, TULANG BAWANG, LAMPUNG",6,144,53,197
https://kawalpemilu.org#23772,"BANJAR DEWA, BANJAR AGUNG, TULANG BAWANG, LAMPUNG",7,205,10,215
https://kawalpemilu.org#23774,"GUNUNG TAPA, GEDUNG MENENG, TULANG BAWANG, LAMPUNG",1,39,152,191
https://kawalpemilu.org#23774,"GUNUNG TAPA, GEDUNG MENENG, TULANG BAWANG, LAMPUNG",2,31,110,141
https://kawalpemilu.org#23774,"GUNUNG TAPA, GEDUNG MENENG, TULANG BAWANG, LAMPUNG",3,165,83,248
https://kawalpemilu.org#23774,"GUNUNG TAPA, GEDUNG MENENG, TULANG BAWANG, LAMPUNG",4,33,94,127
https://kawalpemilu.org#23774,"GUNUNG TAPA, GEDUNG MENENG, TULANG BAWANG, LAMPUNG",5,128,51,179
https://kawalpemilu.org#23774,"GUNUNG TAPA, GEDUNG MENENG, TULANG BAWANG, LAMPUNG",6,104,62,166
https://kawalpemilu.org#23774,"GUNUNG TAPA, GEDUNG MENENG, TULANG BAWANG, LAMPUNG",7,115,47,162
https://kawalpemilu.org#23774,"GUNUNG TAPA, GEDUNG MENENG, TULANG BAWANG, LAMPUNG",8,30,114,144
https://kawalpemilu.org#23775,"GEDUNG MENENG, GEDUNG MENENG, TULANG BAWANG, LAMPUNG",1,87,147,234
https://kawalpemilu.org#23775,"GEDUNG MENENG, GEDUNG MENENG, TULANG BAWANG, LAMPUNG",2,72,158,230
https://kawalpemilu.org#23775,"GEDUNG MENENG, GEDUNG MENENG, TULANG BAWANG, LAMPUNG",3,48,172,220
https://kawalpemilu.org#23775,"GEDUNG MENENG, GEDUNG MENENG, TULANG BAWANG, LAMPUNG",4,175,23,198
https://kawalpemilu.org#23775,"GEDUNG MENENG, GEDUNG MENENG, TULANG BAWANG, LAMPUNG",5,129,58,187
https://kawalpemilu.org#23775,"GEDUNG MENENG, GEDUNG MENENG, TULANG BAWANG, LAMPUNG",6,127,62,189
https://kawalpemilu.org#23775,"GEDUNG MENENG, GEDUNG MENENG, TULANG BAWANG, LAMPUNG",7,168,18,186
https://kawalpemilu.org#23775,"GEDUNG MENENG, GEDUNG MENENG, TULANG BAWANG, LAMPUNG",8,169,35,204
https://kawalpemilu.org#23775,"GEDUNG MENENG, GEDUNG MENENG, TULANG BAWANG, LAMPUNG",9,218,8,226
https://kawalpemilu.org#23775,"GEDUNG MENENG, GEDUNG MENENG, TULANG BAWANG, LAMPUNG",10,92,6,98
https://kawalpemilu.org#23775,"GEDUNG MENENG, GEDUNG MENENG, TULANG BAWANG, LAMPUNG",11,79,24,103
https://kawalpemilu.org#23775,"GEDUNG MENENG, GEDUNG MENENG, TULANG BAWANG, LAMPUNG",12,124,116,240
https://kawalpemilu.org#23775,"GEDUNG MENENG, GEDUNG MENENG, TULANG BAWANG, LAMPUNG",13,111,99,210
https://kawalpemilu.org#23775,"GEDUNG MENENG, GEDUNG MENENG, TULANG BAWANG, LAMPUNG",14,93,73,166
https://kawalpemilu.org#23775,"GEDUNG MENENG, GEDUNG MENENG, TULANG BAWANG, LAMPUNG",15,127,106,233
https://kawalpemilu.org#23775,"GEDUNG MENENG, GEDUNG MENENG, TULANG BAWANG, LAMPUNG",16,133,91,224
https://kawalpemilu.org#23775,"GEDUNG MENENG, GEDUNG MENENG, TULANG BAWANG, LAMPUNG",17,88,91,179
https://kawalpemilu.org#23775,"GEDUNG MENENG, GEDUNG MENENG, TULANG BAWANG, LAMPUNG",18,133,81,214
https://kawalpemilu.org#23775,"GEDUNG MENENG, GEDUNG MENENG, TULANG BAWANG, LAMPUNG",19,108,108,216
https://kawalpemilu.org#23775,"GEDUNG MENENG, GEDUNG MENENG, TULANG BAWANG, LAMPUNG",20,113,99,212
https://kawalpemilu.org#23775,"GEDUNG MENENG, GEDUNG MENENG, TULANG BAWANG, LAMPUNG",21,79,118,197
https://kawalpemilu.org#23775,"GEDUNG MENENG, GEDUNG MENENG, TULANG BAWANG, LAMPUNG",22,94,94,188
https://kawalpemilu.org#23775,"GEDUNG MENENG, GEDUNG MENENG, TULANG BAWANG, LAMPUNG",23,69,25,94
https://kawalpemilu.org#23775,"GEDUNG MENENG, GEDUNG MENENG, TULANG BAWANG, LAMPUNG",24,142,83,225
https://kawalpemilu.org#23775,"GEDUNG MENENG, GEDUNG MENENG, TULANG BAWANG, LAMPUNG",25,83,63,146
https://kawalpemilu.org#23775,"GEDUNG MENENG, GEDUNG MENENG, TULANG BAWANG, LAMPUNG",26,77,91,168
https://kawalpemilu.org#23775,"GEDUNG MENENG, GEDUNG MENENG, TULANG BAWANG, LAMPUNG",27,27,29,56
https://kawalpemilu.org#23775,"GEDUNG MENENG, GEDUNG MENENG, TULANG BAWANG, LAMPUNG",28,116,110,226
https://kawalpemilu.org#23775,"GEDUNG MENENG, GEDUNG MENENG, TULANG BAWANG, LAMPUNG",29,84,68,152
https://kawalpemilu.org#23775,"GEDUNG MENENG, GEDUNG MENENG, TULANG BAWANG, LAMPUNG",30,102,50,152
https://kawalpemilu.org#23775,"GEDUNG MENENG, GEDUNG MENENG, TULANG BAWANG, LAMPUNG",31,143,70,213
https://kawalpemilu.org#23775,"GEDUNG MENENG, GEDUNG MENENG, TULANG BAWANG, LAMPUNG",32,204,65,269
https://kawalpemilu.org#23775,"GEDUNG MENENG, GEDUNG MENENG, TULANG BAWANG, LAMPUNG",33,79,78,157
https://kawalpemilu.org#23775,"GEDUNG MENENG, GEDUNG MENENG, TULANG BAWANG, LAMPUNG",34,101,69,170
https://kawalpemilu.org#23775,"GEDUNG MENENG, GEDUNG MENENG, TULANG BAWANG, LAMPUNG",35,76,94,170
https://kawalpemilu.org#23775,"GEDUNG MENENG, GEDUNG MENENG, TULANG BAWANG, LAMPUNG",36,85,83,168
https://kawalpemilu.org#23775,"GEDUNG MENENG, GEDUNG MENENG, TULANG BAWANG, LAMPUNG",37,70,55,125
https://kawalpemilu.org#23775,"GEDUNG MENENG, GEDUNG MENENG, TULANG BAWANG, LAMPUNG",38,85,53,138
https://kawalpemilu.org#23775,"GEDUNG MENENG, GEDUNG MENENG, TULANG BAWANG, LAMPUNG",39,62,39,101
https://kawalpemilu.org#23775,"GEDUNG MENENG, GEDUNG MENENG, TULANG BAWANG, LAMPUNG",40,101,101,202
https://kawalpemilu.org#23775,"GEDUNG MENENG, GEDUNG MENENG, TULANG BAWANG, LAMPUNG",41,34,41,75
https://kawalpemilu.org#23775,"GEDUNG MENENG, GEDUNG MENENG, TULANG BAWANG, LAMPUNG",42,43,70,113
https://kawalpemilu.org#23775,"GEDUNG MENENG, GEDUNG MENENG, TULANG BAWANG, LAMPUNG",43,51,50,101
https://kawalpemilu.org#23775,"GEDUNG MENENG, GEDUNG MENENG, TULANG BAWANG, LAMPUNG",44,79,124,203
https://kawalpemilu.org#23775,"GEDUNG MENENG, GEDUNG MENENG, TULANG BAWANG, LAMPUNG",45,68,99,167
https://kawalpemilu.org#23775,"GEDUNG MENENG, GEDUNG MENENG, TULANG BAWANG, LAMPUNG",46,103,38,141
https://kawalpemilu.org#23775,"GEDUNG MENENG, GEDUNG MENENG, TULANG BAWANG, LAMPUNG",47,141,26,167
https://kawalpemilu.org#23775,"GEDUNG MENENG, GEDUNG MENENG, TULANG BAWANG, LAMPUNG",48,98,91,189
https://kawalpemilu.org#23775,"GEDUNG MENENG, GEDUNG MENENG, TULANG BAWANG, LAMPUNG",49,117,111,228
https://kawalpemilu.org#23775,"GEDUNG MENENG, GEDUNG MENENG, TULANG BAWANG, LAMPUNG",50,95,103,198
https://kawalpemilu.org#23775,"GEDUNG MENENG, GEDUNG MENENG, TULANG BAWANG, LAMPUNG",51,67,49,116
https://kawalpemilu.org#23775,"GEDUNG MENENG, GEDUNG MENENG, TULANG BAWANG, LAMPUNG",52,85,87,172
https://kawalpemilu.org#23775,"GEDUNG MENENG, GEDUNG MENENG, TULANG BAWANG, LAMPUNG",53,87,86,173
https://kawalpemilu.org#23775,"GEDUNG MENENG, GEDUNG MENENG, TULANG BAWANG, LAMPUNG",54,94,49,143
https://kawalpemilu.org#23775,"GEDUNG MENENG, GEDUNG MENENG, TULANG BAWANG, LAMPUNG",55,56,75,131
https://kawalpemilu.org#23775,"GEDUNG MENENG, GEDUNG MENENG, TULANG BAWANG, LAMPUNG",56,83,70,153
https://kawalpemilu.org#23775,"GEDUNG MENENG, GEDUNG MENENG, TULANG BAWANG, LAMPUNG",57,118,82,200
https://kawalpemilu.org#23775,"GEDUNG MENENG, GEDUNG MENENG, TULANG BAWANG, LAMPUNG",58,86,64,150
https://kawalpemilu.org#23776,"BAKUNG UDIK, GEDUNG MENENG, TULANG BAWANG, LAMPUNG",1,86,185,271
https://kawalpemilu.org#23776,"BAKUNG UDIK, GEDUNG MENENG, TULANG BAWANG, LAMPUNG",2,25,248,273
https://kawalpemilu.org#23776,"BAKUNG UDIK, GEDUNG MENENG, TULANG BAWANG, LAMPUNG",3,63,165,228
https://kawalpemilu.org#23776,"BAKUNG UDIK, GEDUNG MENENG, TULANG BAWANG, LAMPUNG",4,49,124,173
https://kawalpemilu.org#23776,"BAKUNG UDIK, GEDUNG MENENG, TULANG BAWANG, LAMPUNG",5,73,158,231
https://kawalpemilu.org#23776,"BAKUNG UDIK, GEDUNG MENENG, TULANG BAWANG, LAMPUNG",6,72,130,202
https://kawalpemilu.org#23777,"BAKUNG ILIR, GEDUNG MENENG, TULANG BAWANG, LAMPUNG",1,74,143,217
https://kawalpemilu.org#23777,"BAKUNG ILIR, GEDUNG MENENG, TULANG BAWANG, LAMPUNG",2,101,87,188
https://kawalpemilu.org#23777,"BAKUNG ILIR, GEDUNG MENENG, TULANG BAWANG, LAMPUNG",3,87,62,149
https://kawalpemilu.org#23777,"BAKUNG ILIR, GEDUNG MENENG, TULANG BAWANG, LAMPUNG",4,92,39,131
https://kawalpemilu.org#23777,"BAKUNG ILIR, GEDUNG MENENG, TULANG BAWANG, LAMPUNG",5,14,13,27
https://kawalpemilu.org#23778,"GD. BANDAR RAHAYU, GEDUNG MENENG, TULANG BAWANG, LAMPUNG",1,117,43,160
https://kawalpemilu.org#23778,"GD. BANDAR RAHAYU, GEDUNG MENENG, TULANG BAWANG, LAMPUNG",2,148,37,185
https://kawalpemilu.org#23778,"GD. BANDAR RAHAYU, GEDUNG MENENG, TULANG BAWANG, LAMPUNG",3,131,41,172
https://kawalpemilu.org#23778,"GD. BANDAR RAHAYU, GEDUNG MENENG, TULANG BAWANG, LAMPUNG",4,176,41,217
https://kawalpemilu.org#23778,"GD. BANDAR RAHAYU, GEDUNG MENENG, TULANG BAWANG, LAMPUNG",5,165,47,212
https://kawalpemilu.org#23778,"GD. BANDAR RAHAYU, GEDUNG MENENG, TULANG BAWANG, LAMPUNG",6,139,70,209
https://kawalpemilu.org#23778,"GD. BANDAR RAHAYU, GEDUNG MENENG, TULANG BAWANG, LAMPUNG",7,143,31,174
https://kawalpemilu.org#23778,"GD. BANDAR RAHAYU, GEDUNG MENENG, TULANG BAWANG, LAMPUNG",8,160,22,182
https://kawalpemilu.org#23778,"GD. BANDAR RAHAYU, GEDUNG MENENG, TULANG BAWANG, LAMPUNG",9,186,34,220
https://kawalpemilu.org#23778,"GD. BANDAR RAHAYU, GEDUNG MENENG, TULANG BAWANG, LAMPUNG",10,140,32,172
https://kawalpemilu.org#23778,"GD. BANDAR RAHAYU, GEDUNG MENENG, TULANG BAWANG, LAMPUNG",11,79,26,105
https://kawalpemilu.org#23778,"GD. BANDAR RAHAYU, GEDUNG MENENG, TULANG BAWANG, LAMPUNG",12,136,51,187
https://kawalpemilu.org#23778,"GD. BANDAR RAHAYU, GEDUNG MENENG, TULANG BAWANG, LAMPUNG",13,186,45,231
https://kawalpemilu.org#23779,"GUNUNG TAPA ILIR, GEDUNG MENENG, TULANG BAWANG, LAMPUNG",1,138,37,175
https://kawalpemilu.org#23779,"GUNUNG TAPA ILIR, GEDUNG MENENG, TULANG BAWANG, LAMPUNG",2,124,38,162
https://kawalpemilu.org#23779,"GUNUNG TAPA ILIR, GEDUNG MENENG, TULANG BAWANG, LAMPUNG",3,139,38,177
https://kawalpemilu.org#23779,"GUNUNG TAPA ILIR, GEDUNG MENENG, TULANG BAWANG, LAMPUNG",4,148,34,182
https://kawalpemilu.org#23779,"GUNUNG TAPA ILIR, GEDUNG MENENG, TULANG BAWANG, LAMPUNG",5,140,31,171
https://kawalpemilu.org#23779,"GUNUNG TAPA ILIR, GEDUNG MENENG, TULANG BAWANG, LAMPUNG",6,151,40,191
https://kawalpemilu.org#23780,"GUNUNG TAPA TENGAH, GEDUNG MENENG, TULANG BAWANG, LAMPUNG",1,102,42,144
https://kawalpemilu.org#23780,"GUNUNG TAPA TENGAH, GEDUNG MENENG, TULANG BAWANG, LAMPUNG",2,84,37,121
https://kawalpemilu.org#23780,"GUNUNG TAPA TENGAH, GEDUNG MENENG, TULANG BAWANG, LAMPUNG",3,108,27,135
https://kawalpemilu.org#23780,"GUNUNG TAPA TENGAH, GEDUNG MENENG, TULANG BAWANG, LAMPUNG",4,101,30,131
https://kawalpemilu.org#23780,"GUNUNG TAPA TENGAH, GEDUNG MENENG, TULANG BAWANG, LAMPUNG",5,97,44,141
https://kawalpemilu.org#23780,"GUNUNG TAPA TENGAH, GEDUNG MENENG, TULANG BAWANG, LAMPUNG",6,111,23,134
https://kawalpemilu.org#23781,"GUNUNG TAPA UDIK, GEDUNG MENENG, TULANG BAWANG, LAMPUNG",1,46,77,123
https://kawalpemilu.org#23781,"GUNUNG TAPA UDIK, GEDUNG MENENG, TULANG BAWANG, LAMPUNG",2,124,73,197
https://kawalpemilu.org#23781,"GUNUNG TAPA UDIK, GEDUNG MENENG, TULANG BAWANG, LAMPUNG",3,94,88,182
https://kawalpemilu.org#23781,"GUNUNG TAPA UDIK, GEDUNG MENENG, TULANG BAWANG, LAMPUNG",4,40,88,128
https://kawalpemilu.org#23782,"GEDUNG BANDAR REJO, GEDUNG MENENG, TULANG BAWANG, LAMPUNG",1,134,77,211
https://kawalpemilu.org#23782,"GEDUNG BANDAR REJO, GEDUNG MENENG, TULANG BAWANG, LAMPUNG",2,169,73,242
https://kawalpemilu.org#23782,"GEDUNG BANDAR REJO, GEDUNG MENENG, TULANG BAWANG, LAMPUNG",3,124,66,190
https://kawalpemilu.org#23782,"GEDUNG BANDAR REJO, GEDUNG MENENG, TULANG BAWANG, LAMPUNG",4,194,19,213
https://kawalpemilu.org#23782,"GEDUNG BANDAR REJO, GEDUNG MENENG, TULANG BAWANG, LAMPUNG",5,148,24,172
https://kawalpemilu.org#23782,"GEDUNG BANDAR REJO, GEDUNG MENENG, TULANG BAWANG, LAMPUNG",6,159,81,240
https://kawalpemilu.org#23782,"GEDUNG BANDAR REJO, GEDUNG MENENG, TULANG BAWANG, LAMPUNG",7,159,23,182
https://kawalpemilu.org#23782,"GEDUNG BANDAR REJO, GEDUNG MENENG, TULANG BAWANG, LAMPUNG",8,163,42,205
https://kawalpemilu.org#23783,"BAKUNG RAHAYU, GEDUNG MENENG, TULANG BAWANG, LAMPUNG",1,99,20,119
https://kawalpemilu.org#23783,"BAKUNG RAHAYU, GEDUNG MENENG, TULANG BAWANG, LAMPUNG",2,204,24,228
https://kawalpemilu.org#23783,"BAKUNG RAHAYU, GEDUNG MENENG, TULANG BAWANG, LAMPUNG",3,116,12,128
https://kawalpemilu.org#23783,"BAKUNG RAHAYU, GEDUNG MENENG, TULANG BAWANG, LAMPUNG",4,122,14,136
https://kawalpemilu.org#23783,"BAKUNG RAHAYU, GEDUNG MENENG, TULANG BAWANG, LAMPUNG",5,102,24,126
https://kawalpemilu.org#23783,"BAKUNG RAHAYU, GEDUNG MENENG, TULANG BAWANG, LAMPUNG",6,93,16,109
https://kawalpemilu.org#23783,"BAKUNG RAHAYU, GEDUNG MENENG, TULANG BAWANG, LAMPUNG",7,120,23,143
https://kawalpemilu.org#23784,"GEDUNG MENENG BARU, GEDUNG MENENG, TULANG BAWANG, LAMPUNG",1,131,36,167
https://kawalpemilu.org#23784,"GEDUNG MENENG BARU, GEDUNG MENENG, TULANG BAWANG, LAMPUNG",2,17,8,25
https://kawalpemilu.org#23786,"YUDHA KARYA JITU, RAWA JITU SELATAN, TULANG BAWANG, LAMPUNG",1,223,29,252
https://kawalpemilu.org#23786,"YUDHA KARYA JITU, RAWA JITU SELATAN, TULANG BAWANG, LAMPUNG",2,223,17,240
https://kawalpemilu.org#23786,"YUDHA KARYA JITU, RAWA JITU SELATAN, TULANG BAWANG, LAMPUNG",3,217,39,256
https://kawalpemilu.org#23786,"YUDHA KARYA JITU, RAWA JITU SELATAN, TULANG BAWANG, LAMPUNG",4,166,34,200
https://kawalpemilu.org#23786,"YUDHA KARYA JITU, RAWA JITU SELATAN, TULANG BAWANG, LAMPUNG",5,195,41,236
https://kawalpemilu.org#23787,"GEDUNG KARYA JITU, RAWA JITU SELATAN, TULANG BAWANG, LAMPUNG",1,190,28,218
https://kawalpemilu.org#23787,"GEDUNG KARYA JITU, RAWA JITU SELATAN, TULANG BAWANG, LAMPUNG",2,146,29,175
https://kawalpemilu.org#23787,"GEDUNG KARYA JITU, RAWA JITU SELATAN, TULANG BAWANG, LAMPUNG",3,178,69,247
https://kawalpemilu.org#23787,"GEDUNG KARYA JITU, RAWA JITU SELATAN, TULANG BAWANG, LAMPUNG",4,142,39,181
https://kawalpemilu.org#23787,"GEDUNG KARYA JITU, RAWA JITU SELATAN, TULANG BAWANG, LAMPUNG",5,173,28,201
https://kawalpemilu.org#23787,"GEDUNG KARYA JITU, RAWA JITU SELATAN, TULANG BAWANG, LAMPUNG",6,148,21,169
https://kawalpemilu.org#23787,"GEDUNG KARYA JITU, RAWA JITU SELATAN, TULANG BAWANG, LAMPUNG",7,184,37,221
https://kawalpemilu.org#23787,"GEDUNG KARYA JITU, RAWA JITU SELATAN, TULANG BAWANG, LAMPUNG",8,208,27,235
https://kawalpemilu.org#23787,"GEDUNG KARYA JITU, RAWA JITU SELATAN, TULANG BAWANG, LAMPUNG",9,200,45,245
https://kawalpemilu.org#23787,"GEDUNG KARYA JITU, RAWA JITU SELATAN, TULANG BAWANG, LAMPUNG",11,137,47,184
https://kawalpemilu.org#23787,"GEDUNG KARYA JITU, RAWA JITU SELATAN, TULANG BAWANG, LAMPUNG",12,150,26,176
https://kawalpemilu.org#23787,"GEDUNG KARYA JITU, RAWA JITU SELATAN, TULANG BAWANG, LAMPUNG",13,149,48,197
https://kawalpemilu.org#23787,"GEDUNG KARYA JITU, RAWA JITU SELATAN, TULANG BAWANG, LAMPUNG",14,136,45,181
https://kawalpemilu.org#23787,"GEDUNG KARYA JITU, RAWA JITU SELATAN, TULANG BAWANG, LAMPUNG",15,91,51,142
https://kawalpemilu.org#23787,"GEDUNG KARYA JITU, RAWA JITU SELATAN, TULANG BAWANG, LAMPUNG",16,117,81,198
https://kawalpemilu.org#23787,"GEDUNG KARYA JITU, RAWA JITU SELATAN, TULANG BAWANG, LAMPUNG",17,110,20,130
https://kawalpemilu.org#23787,"GEDUNG KARYA JITU, RAWA JITU SELATAN, TULANG BAWANG, LAMPUNG",18,121,39,160
https://kawalpemilu.org#23787,"GEDUNG KARYA JITU, RAWA JITU SELATAN, TULANG BAWANG, LAMPUNG",19,124,28,152
https://kawalpemilu.org#23787,"GEDUNG KARYA JITU, RAWA JITU SELATAN, TULANG BAWANG, LAMPUNG",21,128,49,177
https://kawalpemilu.org#23787,"GEDUNG KARYA JITU, RAWA JITU SELATAN, TULANG BAWANG, LAMPUNG",22,133,45,180
https://kawalpemilu.org#23787,"GEDUNG KARYA JITU, RAWA JITU SELATAN, TULANG BAWANG, LAMPUNG",23,135,53,188
https://kawalpemilu.org#23787,"GEDUNG KARYA JITU, RAWA JITU SELATAN, TULANG BAWANG, LAMPUNG",24,75,23,98
https://kawalpemilu.org#23787,"GEDUNG KARYA JITU, RAWA JITU SELATAN, TULANG BAWANG, LAMPUNG",25,116,77,193
https://kawalpemilu.org#23788,"HARGO REJO, RAWA JITU SELATAN, TULANG BAWANG, LAMPUNG",1,151,29,180
https://kawalpemilu.org#23788,"HARGO REJO, RAWA JITU SELATAN, TULANG BAWANG, LAMPUNG",2,151,24,175
https://kawalpemilu.org#23788,"HARGO REJO, RAWA JITU SELATAN, TULANG BAWANG, LAMPUNG",3,190,6,196
https://kawalpemilu.org#23788,"HARGO REJO, RAWA JITU SELATAN, TULANG BAWANG, LAMPUNG",4,165,19,184
https://kawalpemilu.org#23788,"HARGO REJO, RAWA JITU SELATAN, TULANG BAWANG, LAMPUNG",5,129,28,157
https://kawalpemilu.org#23788,"HARGO REJO, RAWA JITU SELATAN, TULANG BAWANG, LAMPUNG",6,180,25,205
https://kawalpemilu.org#23788,"HARGO REJO, RAWA JITU SELATAN, TULANG BAWANG, LAMPUNG",7,184,25,209
https://kawalpemilu.org#23788,"HARGO REJO, RAWA JITU SELATAN, TULANG BAWANG, LAMPUNG",8,167,14,181
https://kawalpemilu.org#23789,"WONO AGUNG, RAWA JITU SELATAN, TULANG BAWANG, LAMPUNG",1,172,38,210
https://kawalpemilu.org#23789,"WONO AGUNG, RAWA JITU SELATAN, TULANG BAWANG, LAMPUNG",2,144,18,162
https://kawalpemilu.org#23789,"WONO AGUNG, RAWA JITU SELATAN, TULANG BAWANG, LAMPUNG",3,129,37,166
https://kawalpemilu.org#23789,"WONO AGUNG, RAWA JITU SELATAN, TULANG BAWANG, LAMPUNG",4,131,18,149
https://kawalpemilu.org#23789,"WONO AGUNG, RAWA JITU SELATAN, TULANG BAWANG, LAMPUNG",5,155,17,172
https://kawalpemilu.org#23789,"WONO AGUNG, RAWA JITU SELATAN, TULANG BAWANG, LAMPUNG",6,135,17,152
https://kawalpemilu.org#23789,"WONO AGUNG, RAWA JITU SELATAN, TULANG BAWANG, LAMPUNG",7,113,36,149
https://kawalpemilu.org#23789,"WONO AGUNG, RAWA JITU SELATAN, TULANG BAWANG, LAMPUNG",8,164,27,191
https://kawalpemilu.org#23789,"WONO AGUNG, RAWA JITU SELATAN, TULANG BAWANG, LAMPUNG",9,163,25,188
https://kawalpemilu.org#23789,"WONO AGUNG, RAWA JITU SELATAN, TULANG BAWANG, LAMPUNG",10,111,14,125
https://kawalpemilu.org#23789,"WONO AGUNG, RAWA JITU SELATAN, TULANG BAWANG, LAMPUNG",11,121,15,136
https://kawalpemilu.org#23789,"WONO AGUNG, RAWA JITU SELATAN, TULANG BAWANG, LAMPUNG",12,121,37,158
https://kawalpemilu.org#23789,"WONO AGUNG, RAWA JITU SELATAN, TULANG BAWANG, LAMPUNG",13,156,33,189
https://kawalpemilu.org#23789,"WONO AGUNG, RAWA JITU SELATAN, TULANG BAWANG, LAMPUNG",14,144,42,186
https://kawalpemilu.org#23790,"KARYA JITU MUKTI, RAWA JITU SELATAN, TULANG BAWANG, LAMPUNG",1,99,32,131
https://kawalpemilu.org#23790,"KARYA JITU MUKTI, RAWA JITU SELATAN, TULANG BAWANG, LAMPUNG",2,146,26,172
https://kawalpemilu.org#23790,"KARYA JITU MUKTI, RAWA JITU SELATAN, TULANG BAWANG, LAMPUNG",3,161,21,182
https://kawalpemilu.org#23790,"KARYA JITU MUKTI, RAWA JITU SELATAN, TULANG BAWANG, LAMPUNG",4,175,14,189
https://kawalpemilu.org#23790,"KARYA JITU MUKTI, RAWA JITU SELATAN, TULANG BAWANG, LAMPUNG",5,176,17,193
https://kawalpemilu.org#23790,"KARYA JITU MUKTI, RAWA JITU SELATAN, TULANG BAWANG, LAMPUNG",6,188,35,223
https://kawalpemilu.org#23790,"KARYA JITU MUKTI, RAWA JITU SELATAN, TULANG BAWANG, LAMPUNG",7,189,34,223
https://kawalpemilu.org#23792,"HARGO MULYO, RAWA JITU SELATAN, TULANG BAWANG, LAMPUNG",1,140,9,149
https://kawalpemilu.org#23792,"HARGO MULYO, RAWA JITU SELATAN, TULANG BAWANG, LAMPUNG",2,130,18,148
https://kawalpemilu.org#23792,"HARGO MULYO, RAWA JITU SELATAN, TULANG BAWANG, LAMPUNG",3,112,28,140
https://kawalpemilu.org#23792,"HARGO MULYO, RAWA JITU SELATAN, TULANG BAWANG, LAMPUNG",5,108,10,118
https://kawalpemilu.org#23792,"HARGO MULYO, RAWA JITU SELATAN, TULANG BAWANG, LAMPUNG",6,127,24,151
https://kawalpemilu.org#23792,"HARGO MULYO, RAWA JITU SELATAN, TULANG BAWANG, LAMPUNG",7,94,21,115
https://kawalpemilu.org#23792,"HARGO MULYO, RAWA JITU SELATAN, TULANG BAWANG, LAMPUNG",8,121,9,130
https://kawalpemilu.org#23793,"BUMI RATU, RAWA JITU SELATAN, TULANG BAWANG, LAMPUNG",1,195,8,203
https://kawalpemilu.org#23793,"BUMI RATU, RAWA JITU SELATAN, TULANG BAWANG, LAMPUNG",2,175,28,203
https://kawalpemilu.org#23793,"BUMI RATU, RAWA JITU SELATAN, TULANG BAWANG, LAMPUNG",3,166,34,200
https://kawalpemilu.org#23793,"BUMI RATU, RAWA JITU SELATAN, TULANG BAWANG, LAMPUNG",4,201,18,219
https://kawalpemilu.org#23793,"BUMI RATU, RAWA JITU SELATAN, TULANG BAWANG, LAMPUNG",5,167,52,219
https://kawalpemilu.org#23794,"MEDASARI, RAWA JITU SELATAN, TULANG BAWANG, LAMPUNG",1,73,33,106
https://kawalpemilu.org#23794,"MEDASARI, RAWA JITU SELATAN, TULANG BAWANG, LAMPUNG",2,169,46,215
https://kawalpemilu.org#23794,"MEDASARI, RAWA JITU SELATAN, TULANG BAWANG, LAMPUNG",3,147,37,184
https://kawalpemilu.org#23794,"MEDASARI, RAWA JITU SELATAN, TULANG BAWANG, LAMPUNG",4,142,21,163
https://kawalpemilu.org#23794,"MEDASARI, RAWA JITU SELATAN, TULANG BAWANG, LAMPUNG",5,155,22,177
https://kawalpemilu.org#23794,"MEDASARI, RAWA JITU SELATAN, TULANG BAWANG, LAMPUNG",6,135,40,175
https://kawalpemilu.org#23794,"MEDASARI, RAWA JITU SELATAN, TULANG BAWANG, LAMPUNG",7,152,46,198
https://kawalpemilu.org#23794,"MEDASARI, RAWA JITU SELATAN, TULANG BAWANG, LAMPUNG",8,134,42,176
https://kawalpemilu.org#23794,"MEDASARI, RAWA JITU SELATAN, TULANG BAWANG, LAMPUNG",9,114,52,166
https://kawalpemilu.org#23794,"MEDASARI, RAWA JITU SELATAN, TULANG BAWANG, LAMPUNG",10,154,27,181
https://kawalpemilu.org#23794,"MEDASARI, RAWA JITU SELATAN, TULANG BAWANG, LAMPUNG",11,100,35,135
https://kawalpemilu.org#23794,"MEDASARI, RAWA JITU SELATAN, TULANG BAWANG, LAMPUNG",12,126,27,153
https://kawalpemilu.org#23794,"MEDASARI, RAWA JITU SELATAN, TULANG BAWANG, LAMPUNG",13,155,30,185
https://kawalpemilu.org#23794,"MEDASARI, RAWA JITU SELATAN, TULANG BAWANG, LAMPUNG",14,149,22,171
https://kawalpemilu.org#23794,"MEDASARI, RAWA JITU SELATAN, TULANG BAWANG, LAMPUNG",15,51,13,64
https://kawalpemilu.org#23794,"MEDASARI, RAWA JITU SELATAN, TULANG BAWANG, LAMPUNG",16,132,58,190
https://kawalpemilu.org#23795,"KARYA CIPTA ABADI, RAWA JITU SELATAN, TULANG BAWANG, LAMPUNG",1,140,32,172
https://kawalpemilu.org#23797,"TRI REJO MULYO, PENAWAR TAMA, TULANG BAWANG, LAMPUNG",1,115,43,158
https://kawalpemilu.org#23797,"TRI REJO MULYO, PENAWAR TAMA, TULANG BAWANG, LAMPUNG",2,111,35,146
https://kawalpemilu.org#23797,"TRI REJO MULYO, PENAWAR TAMA, TULANG BAWANG, LAMPUNG",3,127,41,168
https://kawalpemilu.org#23797,"TRI REJO MULYO, PENAWAR TAMA, TULANG BAWANG, LAMPUNG",4,124,26,150
https://kawalpemilu.org#23797,"TRI REJO MULYO, PENAWAR TAMA, TULANG BAWANG, LAMPUNG",5,115,36,151
https://kawalpemilu.org#23797,"TRI REJO MULYO, PENAWAR TAMA, TULANG BAWANG, LAMPUNG",6,144,22,166
https://kawalpemilu.org#23797,"TRI REJO MULYO, PENAWAR TAMA, TULANG BAWANG, LAMPUNG",7,133,57,190
https://kawalpemilu.org#23797,"TRI REJO MULYO, PENAWAR TAMA, TULANG BAWANG, LAMPUNG",8,112,33,145
https://kawalpemilu.org#23797,"TRI REJO MULYO, PENAWAR TAMA, TULANG BAWANG, LAMPUNG",9,131,25,156
https://kawalpemilu.org#23797,"TRI REJO MULYO, PENAWAR TAMA, TULANG BAWANG, LAMPUNG",10,153,35,188
https://kawalpemilu.org#23797,"TRI REJO MULYO, PENAWAR TAMA, TULANG BAWANG, LAMPUNG",11,121,22,143
https://kawalpemilu.org#23797,"TRI REJO MULYO, PENAWAR TAMA, TULANG BAWANG, LAMPUNG",12,134,27,161
https://kawalpemilu.org#23798,"TRI JAYA, PENAWAR TAMA, TULANG BAWANG, LAMPUNG",1,140,44,184
https://kawalpemilu.org#23798,"TRI JAYA, PENAWAR TAMA, TULANG BAWANG, LAMPUNG",2,166,51,217
https://kawalpemilu.org#23798,"TRI JAYA, PENAWAR TAMA, TULANG BAWANG, LAMPUNG",3,141,35,176
https://kawalpemilu.org#23798,"TRI JAYA, PENAWAR TAMA, TULANG BAWANG, LAMPUNG",4,184,48,232
https://kawalpemilu.org#23798,"TRI JAYA, PENAWAR TAMA, TULANG BAWANG, LAMPUNG",5,150,59,209
https://kawalpemilu.org#23799,"SIDOHARJO, PENAWAR TAMA, TULANG BAWANG, LAMPUNG",1,132,27,159
https://kawalpemilu.org#23799,"SIDOHARJO, PENAWAR TAMA, TULANG BAWANG, LAMPUNG",2,194,36,230
https://kawalpemilu.org#23799,"SIDOHARJO, PENAWAR TAMA, TULANG BAWANG, LAMPUNG",3,83,40,123
https://kawalpemilu.org#23799,"SIDOHARJO, PENAWAR TAMA, TULANG BAWANG, LAMPUNG",4,155,97,252
https://kawalpemilu.org#23799,"SIDOHARJO, PENAWAR TAMA, TULANG BAWANG, LAMPUNG",5,125,29,154
https://kawalpemilu.org#23799,"SIDOHARJO, PENAWAR TAMA, TULANG BAWANG, LAMPUNG",6,141,73,214
https://kawalpemilu.org#23799,"SIDOHARJO, PENAWAR TAMA, TULANG BAWANG, LAMPUNG",7,126,37,163
https://kawalpemilu.org#23799,"SIDOHARJO, PENAWAR TAMA, TULANG BAWANG, LAMPUNG",8,121,50,171
https://kawalpemilu.org#23799,"SIDOHARJO, PENAWAR TAMA, TULANG BAWANG, LAMPUNG",9,146,24,170
https://kawalpemilu.org#23799,"SIDOHARJO, PENAWAR TAMA, TULANG BAWANG, LAMPUNG",10,153,37,190
https://kawalpemilu.org#23799,"SIDOHARJO, PENAWAR TAMA, TULANG BAWANG, LAMPUNG",11,107,55,162
https://kawalpemilu.org#23799,"SIDOHARJO, PENAWAR TAMA, TULANG BAWANG, LAMPUNG",12,100,24,124
https://kawalpemilu.org#23799,"SIDOHARJO, PENAWAR TAMA, TULANG BAWANG, LAMPUNG",13,126,65,191
https://kawalpemilu.org#23799,"SIDOHARJO, PENAWAR TAMA, TULANG BAWANG, LAMPUNG",14,115,55,170
https://kawalpemilu.org#23799,"SIDOHARJO, PENAWAR TAMA, TULANG BAWANG, LAMPUNG",15,145,53,198
https://kawalpemilu.org#23800,"SIDOMULYO, PENAWAR TAMA, TULANG BAWANG, LAMPUNG",1,172,32,204
https://kawalpemilu.org#23800,"SIDOMULYO, PENAWAR TAMA, TULANG BAWANG, LAMPUNG",2,117,25,142
https://kawalpemilu.org#23800,"SIDOMULYO, PENAWAR TAMA, TULANG BAWANG, LAMPUNG",3,121,24,145
https://kawalpemilu.org#23800,"SIDOMULYO, PENAWAR TAMA, TULANG BAWANG, LAMPUNG",4,97,24,121
https://kawalpemilu.org#23800,"SIDOMULYO, PENAWAR TAMA, TULANG BAWANG, LAMPUNG",5,82,18,100
https://kawalpemilu.org#23800,"SIDOMULYO, PENAWAR TAMA, TULANG BAWANG, LAMPUNG",6,167,32,199
https://kawalpemilu.org#23800,"SIDOMULYO, PENAWAR TAMA, TULANG BAWANG, LAMPUNG",7,175,33,208
https://kawalpemilu.org#23800,"SIDOMULYO, PENAWAR TAMA, TULANG BAWANG, LAMPUNG",8,114,24,138
https://kawalpemilu.org#23800,"SIDOMULYO, PENAWAR TAMA, TULANG BAWANG, LAMPUNG",9,111,27,138
https://kawalpemilu.org#23800,"SIDOMULYO, PENAWAR TAMA, TULANG BAWANG, LAMPUNG",10,80,21,101
https://kawalpemilu.org#23800,"SIDOMULYO, PENAWAR TAMA, TULANG BAWANG, LAMPUNG",11,78,17,95
https://kawalpemilu.org#23800,"SIDOMULYO, PENAWAR TAMA, TULANG BAWANG, LAMPUNG",12,79,44,123
https://kawalpemilu.org#23802,"BOGATAMA, PENAWAR TAMA, TULANG BAWANG, LAMPUNG",1,145,25,170
https://kawalpemilu.org#23802,"BOGATAMA, PENAWAR TAMA, TULANG BAWANG, LAMPUNG",2,115,43,158
https://kawalpemilu.org#23802,"BOGATAMA, PENAWAR TAMA, TULANG BAWANG, LAMPUNG",3,157,38,195
https://kawalpemilu.org#23802,"BOGATAMA, PENAWAR TAMA, TULANG BAWANG, LAMPUNG",4,119,28,147
https://kawalpemilu.org#23802,"BOGATAMA, PENAWAR TAMA, TULANG BAWANG, LAMPUNG",5,182,44,226
https://kawalpemilu.org#23802,"BOGATAMA, PENAWAR TAMA, TULANG BAWANG, LAMPUNG",6,155,63,218
https://kawalpemilu.org#23802,"BOGATAMA, PENAWAR TAMA, TULANG BAWANG, LAMPUNG",7,139,47,186
https://kawalpemilu.org#23802,"BOGATAMA, PENAWAR TAMA, TULANG BAWANG, LAMPUNG",8,132,30,162
https://kawalpemilu.org#23802,"BOGATAMA, PENAWAR TAMA, TULANG BAWANG, LAMPUNG",9,129,31,160
https://kawalpemilu.org#23802,"BOGATAMA, PENAWAR TAMA, TULANG BAWANG, LAMPUNG",10,130,37,167
https://kawalpemilu.org#23802,"BOGATAMA, PENAWAR TAMA, TULANG BAWANG, LAMPUNG",11,175,28,203
https://kawalpemilu.org#23802,"BOGATAMA, PENAWAR TAMA, TULANG BAWANG, LAMPUNG",12,126,88,214
https://kawalpemilu.org#23804,"PULO GADUNG, PENAWAR TAMA, TULANG BAWANG, LAMPUNG",1,131,22,153
https://kawalpemilu.org#23804,"PULO GADUNG, PENAWAR TAMA, TULANG BAWANG, LAMPUNG",2,169,33,202
https://kawalpemilu.org#23804,"PULO GADUNG, PENAWAR TAMA, TULANG BAWANG, LAMPUNG",3,122,25,147
https://kawalpemilu.org#23805,"SIDODADI, PENAWAR TAMA, TULANG BAWANG, LAMPUNG",1,110,12,122
https://kawalpemilu.org#23805,"SIDODADI, PENAWAR TAMA, TULANG BAWANG, LAMPUNG",2,99,45,144
https://kawalpemilu.org#23805,"SIDODADI, PENAWAR TAMA, TULANG BAWANG, LAMPUNG",3,176,24,200
https://kawalpemilu.org#23805,"SIDODADI, PENAWAR TAMA, TULANG BAWANG, LAMPUNG",4,118,17,135
https://kawalpemilu.org#23805,"SIDODADI, PENAWAR TAMA, TULANG BAWANG, LAMPUNG",5,117,33,150
https://kawalpemilu.org#23806,"DWIMULYO, PENAWAR TAMA, TULANG BAWANG, LAMPUNG",1,109,41,150
https://kawalpemilu.org#23806,"DWIMULYO, PENAWAR TAMA, TULANG BAWANG, LAMPUNG",2,107,32,139
https://kawalpemilu.org#23806,"DWIMULYO, PENAWAR TAMA, TULANG BAWANG, LAMPUNG",3,103,41,144
https://kawalpemilu.org#23806,"DWIMULYO, PENAWAR TAMA, TULANG BAWANG, LAMPUNG",4,132,18,150
https://kawalpemilu.org#23807,"REJO SARI, PENAWAR TAMA, TULANG BAWANG, LAMPUNG",1,179,15,194
https://kawalpemilu.org#23807,"REJO SARI, PENAWAR TAMA, TULANG BAWANG, LAMPUNG",2,197,30,227
https://kawalpemilu.org#23807,"REJO SARI, PENAWAR TAMA, TULANG BAWANG, LAMPUNG",3,203,34,237
https://kawalpemilu.org#23808,"WIRA AGUNG SARI, PENAWAR TAMA, TULANG BAWANG, LAMPUNG",1,132,35,167
https://kawalpemilu.org#23808,"WIRA AGUNG SARI, PENAWAR TAMA, TULANG BAWANG, LAMPUNG",2,198,28,226
https://kawalpemilu.org#23808,"WIRA AGUNG SARI, PENAWAR TAMA, TULANG BAWANG, LAMPUNG",3,153,31,184
https://kawalpemilu.org#23809,"SIDOMAKMUR, PENAWAR TAMA, TULANG BAWANG, LAMPUNG",1,115,24,139
https://kawalpemilu.org#23809,"SIDOMAKMUR, PENAWAR TAMA, TULANG BAWANG, LAMPUNG",2,101,37,138
https://kawalpemilu.org#23809,"SIDOMAKMUR, PENAWAR TAMA, TULANG BAWANG, LAMPUNG",3,130,27,157
https://kawalpemilu.org#23809,"SIDOMAKMUR, PENAWAR TAMA, TULANG BAWANG, LAMPUNG",4,105,12,117
https://kawalpemilu.org#23809,"SIDOMAKMUR, PENAWAR TAMA, TULANG BAWANG, LAMPUNG",5,106,26,132
https://kawalpemilu.org#23809,"SIDOMAKMUR, PENAWAR TAMA, TULANG BAWANG, LAMPUNG",6,99,24,123
https://kawalpemilu.org#23810,"TRIKARYA, PENAWAR TAMA, TULANG BAWANG, LAMPUNG",1,93,65,158
https://kawalpemilu.org#23810,"TRIKARYA, PENAWAR TAMA, TULANG BAWANG, LAMPUNG",2,135,19,154
https://kawalpemilu.org#23810,"TRIKARYA, PENAWAR TAMA, TULANG BAWANG, LAMPUNG",3,113,43,156
https://kawalpemilu.org#23810,"TRIKARYA, PENAWAR TAMA, TULANG BAWANG, LAMPUNG",4,130,14,144
https://kawalpemilu.org#23863,"TRI TUNGGAL JAYA, PENAWAR TAMA, TULANG BAWANG, LAMPUNG",1,158,30,188
https://kawalpemilu.org#23863,"TRI TUNGGAL JAYA, PENAWAR TAMA, TULANG BAWANG, LAMPUNG",2,158,33,191
https://kawalpemilu.org#23863,"TRI TUNGGAL JAYA, PENAWAR TAMA, TULANG BAWANG, LAMPUNG",3,145,65,210
https://kawalpemilu.org#23863,"TRI TUNGGAL JAYA, PENAWAR TAMA, TULANG BAWANG, LAMPUNG",4,150,33,183
https://kawalpemilu.org#23863,"TRI TUNGGAL JAYA, PENAWAR TAMA, TULANG BAWANG, LAMPUNG",5,171,30,201
https://kawalpemilu.org#23863,"TRI TUNGGAL JAYA, PENAWAR TAMA, TULANG BAWANG, LAMPUNG",6,150,30,180
https://kawalpemilu.org#23863,"TRI TUNGGAL JAYA, PENAWAR TAMA, TULANG BAWANG, LAMPUNG",7,141,44,185
https://kawalpemilu.org#23863,"TRI TUNGGAL JAYA, PENAWAR TAMA, TULANG BAWANG, LAMPUNG",8,163,17,180
https://kawalpemilu.org#89244,"WIRATAMA, PENAWAR TAMA, TULANG BAWANG, LAMPUNG",1,151,12,163
https://kawalpemilu.org#89244,"WIRATAMA, PENAWAR TAMA, TULANG BAWANG, LAMPUNG",2,136,30,166
https://kawalpemilu.org#89244,"WIRATAMA, PENAWAR TAMA, TULANG BAWANG, LAMPUNG",3,123,33,156
https://kawalpemilu.org#89244,"WIRATAMA, PENAWAR TAMA, TULANG BAWANG, LAMPUNG",4,146,27,173
https://kawalpemilu.org#89244,"WIRATAMA, PENAWAR TAMA, TULANG BAWANG, LAMPUNG",5,113,47,160
https://kawalpemilu.org#89244,"WIRATAMA, PENAWAR TAMA, TULANG BAWANG, LAMPUNG",6,121,30,151
https://kawalpemilu.org#89244,"WIRATAMA, PENAWAR TAMA, TULANG BAWANG, LAMPUNG",7,119,39,158
https://kawalpemilu.org#89244,"WIRATAMA, PENAWAR TAMA, TULANG BAWANG, LAMPUNG",8,133,27,160
https://kawalpemilu.org#23812,"BUMI DIPASENA UTAMA, RAWA JITU TIMUR, TULANG BAWANG, LAMPUNG",1,122,31,153
https://kawalpemilu.org#23812,"BUMI DIPASENA UTAMA, RAWA JITU TIMUR, TULANG BAWANG, LAMPUNG",2,110,63,173
https://kawalpemilu.org#23812,"BUMI DIPASENA UTAMA, RAWA JITU TIMUR, TULANG BAWANG, LAMPUNG",3,101,68,169
https://kawalpemilu.org#23812,"BUMI DIPASENA UTAMA, RAWA JITU TIMUR, TULANG BAWANG, LAMPUNG",4,125,53,178
https://kawalpemilu.org#23812,"BUMI DIPASENA UTAMA, RAWA JITU TIMUR, TULANG BAWANG, LAMPUNG",5,112,53,165
https://kawalpemilu.org#23813,"BUMI DIPASENA AGUNG, RAWA JITU TIMUR, TULANG BAWANG, LAMPUNG",1,46,25,71
https://kawalpemilu.org#23813,"BUMI DIPASENA AGUNG, RAWA JITU TIMUR, TULANG BAWANG, LAMPUNG",2,73,48,121
https://kawalpemilu.org#23813,"BUMI DIPASENA AGUNG, RAWA JITU TIMUR, TULANG BAWANG, LAMPUNG",3,69,30,99
https://kawalpemilu.org#23813,"BUMI DIPASENA AGUNG, RAWA JITU TIMUR, TULANG BAWANG, LAMPUNG",4,105,52,157
https://kawalpemilu.org#23813,"BUMI DIPASENA AGUNG, RAWA JITU TIMUR, TULANG BAWANG, LAMPUNG",5,69,28,97
https://kawalpemilu.org#23813,"BUMI DIPASENA AGUNG, RAWA JITU TIMUR, TULANG BAWANG, LAMPUNG",6,31,17,48
https://kawalpemilu.org#23813,"BUMI DIPASENA AGUNG, RAWA JITU TIMUR, TULANG BAWANG, LAMPUNG",7,53,36,89
https://kawalpemilu.org#23813,"BUMI DIPASENA AGUNG, RAWA JITU TIMUR, TULANG BAWANG, LAMPUNG",8,59,27,86
https://kawalpemilu.org#23814,"BUMI DIPASENA JAYA, RAWA JITU TIMUR, TULANG BAWANG, LAMPUNG",1,67,79,146
https://kawalpemilu.org#23814,"BUMI DIPASENA JAYA, RAWA JITU TIMUR, TULANG BAWANG, LAMPUNG",2,125,50,175
https://kawalpemilu.org#23814,"BUMI DIPASENA JAYA, RAWA JITU TIMUR, TULANG BAWANG, LAMPUNG",3,116,78,194
https://kawalpemilu.org#23814,"BUMI DIPASENA JAYA, RAWA JITU TIMUR, TULANG BAWANG, LAMPUNG",4,131,76,207
https://kawalpemilu.org#23814,"BUMI DIPASENA JAYA, RAWA JITU TIMUR, TULANG BAWANG, LAMPUNG",5,160,83,243
https://kawalpemilu.org#23814,"BUMI DIPASENA JAYA, RAWA JITU TIMUR, TULANG BAWANG, LAMPUNG",6,156,82,238
https://kawalpemilu.org#23815,"BUMI DIPASENA ABADI, RAWA JITU TIMUR, TULANG BAWANG, LAMPUNG",1,71,55,126
https://kawalpemilu.org#23815,"BUMI DIPASENA ABADI, RAWA JITU TIMUR, TULANG BAWANG, LAMPUNG",2,71,69,140
https://kawalpemilu.org#23815,"BUMI DIPASENA ABADI, RAWA JITU TIMUR, TULANG BAWANG, LAMPUNG",3,90,30,120
https://kawalpemilu.org#23815,"BUMI DIPASENA ABADI, RAWA JITU TIMUR, TULANG BAWANG, LAMPUNG",4,91,42,133
https://kawalpemilu.org#23815,"BUMI DIPASENA ABADI, RAWA JITU TIMUR, TULANG BAWANG, LAMPUNG",5,65,1,66
https://kawalpemilu.org#23815,"BUMI DIPASENA ABADI, RAWA JITU TIMUR, TULANG BAWANG, LAMPUNG",6,87,28,115
https://kawalpemilu.org#23815,"BUMI DIPASENA ABADI, RAWA JITU TIMUR, TULANG BAWANG, LAMPUNG",7,62,13,75
https://kawalpemilu.org#23816,"BUMI DIPASENA MAKMUR, RAWA JITU TIMUR, TULANG BAWANG, LAMPUNG",1,96,76,172
https://kawalpemilu.org#23816,"BUMI DIPASENA MAKMUR, RAWA JITU TIMUR, TULANG BAWANG, LAMPUNG",2,127,86,213
https://kawalpemilu.org#23816,"BUMI DIPASENA MAKMUR, RAWA JITU TIMUR, TULANG BAWANG, LAMPUNG",3,113,90,203
https://kawalpemilu.org#23816,"BUMI DIPASENA MAKMUR, RAWA JITU TIMUR, TULANG BAWANG, LAMPUNG",4,103,76,179
https://kawalpemilu.org#23816,"BUMI DIPASENA MAKMUR, RAWA JITU TIMUR, TULANG BAWANG, LAMPUNG",5,105,94,199
https://kawalpemilu.org#23817,"BUMI DIPASENA MULYA, RAWA JITU TIMUR, TULANG BAWANG, LAMPUNG",1,106,53,159
https://kawalpemilu.org#23817,"BUMI DIPASENA MULYA, RAWA JITU TIMUR, TULANG BAWANG, LAMPUNG",2,98,82,180
https://kawalpemilu.org#23817,"BUMI DIPASENA MULYA, RAWA JITU TIMUR, TULANG BAWANG, LAMPUNG",3,130,56,186
https://kawalpemilu.org#23817,"BUMI DIPASENA MULYA, RAWA JITU TIMUR, TULANG BAWANG, LAMPUNG",4,118,81,199
https://kawalpemilu.org#23817,"BUMI DIPASENA MULYA, RAWA JITU TIMUR, TULANG BAWANG, LAMPUNG",5,71,58,129
https://kawalpemilu.org#23817,"BUMI DIPASENA MULYA, RAWA JITU TIMUR, TULANG BAWANG, LAMPUNG",6,111,75,186
https://kawalpemilu.org#23817,"BUMI DIPASENA MULYA, RAWA JITU TIMUR, TULANG BAWANG, LAMPUNG",7,85,82,167
https://kawalpemilu.org#23819,"BUMI SENTOSA, RAWA JITU TIMUR, TULANG BAWANG, LAMPUNG",1,137,66,203
https://kawalpemilu.org#23819,"BUMI SENTOSA, RAWA JITU TIMUR, TULANG BAWANG, LAMPUNG",2,135,46,181
https://kawalpemilu.org#84810,"BUMI DIPASENA SEJAHTERA, RAWA JITU TIMUR, TULANG BAWANG, LAMPUNG",1,62,52,114
https://kawalpemilu.org#84810,"BUMI DIPASENA SEJAHTERA, RAWA JITU TIMUR, TULANG BAWANG, LAMPUNG",2,110,66,176
https://kawalpemilu.org#84810,"BUMI DIPASENA SEJAHTERA, RAWA JITU TIMUR, TULANG BAWANG, LAMPUNG",3,100,68,168
https://kawalpemilu.org#84810,"BUMI DIPASENA SEJAHTERA, RAWA JITU TIMUR, TULANG BAWANG, LAMPUNG",4,97,59,156
https://kawalpemilu.org#84810,"BUMI DIPASENA SEJAHTERA, RAWA JITU TIMUR, TULANG BAWANG, LAMPUNG",5,97,61,158
https://kawalpemilu.org#84810,"BUMI DIPASENA SEJAHTERA, RAWA JITU TIMUR, TULANG BAWANG, LAMPUNG",6,62,85,147
https://kawalpemilu.org#84810,"BUMI DIPASENA SEJAHTERA, RAWA JITU TIMUR, TULANG BAWANG, LAMPUNG",7,61,39,100
https://kawalpemilu.org#23821,"BUJUK AGUNG, BANJAR MARGO, TULANG BAWANG, LAMPUNG",1,174,56,230
https://kawalpemilu.org#23821,"BUJUK AGUNG, BANJAR MARGO, TULANG BAWANG, LAMPUNG",2,171,66,237
https://kawalpemilu.org#23821,"BUJUK AGUNG, BANJAR MARGO, TULANG BAWANG, LAMPUNG",3,203,42,245
https://kawalpemilu.org#23821,"BUJUK AGUNG, BANJAR MARGO, TULANG BAWANG, LAMPUNG",4,214,40,254
https://kawalpemilu.org#23821,"BUJUK AGUNG, BANJAR MARGO, TULANG BAWANG, LAMPUNG",5,173,58,231
https://kawalpemilu.org#23821,"BUJUK AGUNG, BANJAR MARGO, TULANG BAWANG, LAMPUNG",6,147,66,213
https://kawalpemilu.org#23821,"BUJUK AGUNG, BANJAR MARGO, TULANG BAWANG, LAMPUNG",7,146,52,198
https://kawalpemilu.org#23821,"BUJUK AGUNG, BANJAR MARGO, TULANG BAWANG, LAMPUNG",8,198,27,225
https://kawalpemilu.org#23821,"BUJUK AGUNG, BANJAR MARGO, TULANG BAWANG, LAMPUNG",9,132,63,195
https://kawalpemilu.org#23821,"BUJUK AGUNG, BANJAR MARGO, TULANG BAWANG, LAMPUNG",10,96,38,134
https://kawalpemilu.org#23822,"RINGIN SARI, BANJAR MARGO, TULANG BAWANG, LAMPUNG",1,194,19,213
https://kawalpemilu.org#23822,"RINGIN SARI, BANJAR MARGO, TULANG BAWANG, LAMPUNG",2,193,43,236
https://kawalpemilu.org#23822,"RINGIN SARI, BANJAR MARGO, TULANG BAWANG, LAMPUNG",3,199,34,233
https://kawalpemilu.org#23822,"RINGIN SARI, BANJAR MARGO, TULANG BAWANG, LAMPUNG",5,170,40,210
https://kawalpemilu.org#23822,"RINGIN SARI, BANJAR MARGO, TULANG BAWANG, LAMPUNG",6,179,50,229
https://kawalpemilu.org#23822,"RINGIN SARI, BANJAR MARGO, TULANG BAWANG, LAMPUNG",7,202,31,233
https://kawalpemilu.org#23822,"RINGIN SARI, BANJAR MARGO, TULANG BAWANG, LAMPUNG",8,184,43,227
https://kawalpemilu.org#23822,"RINGIN SARI, BANJAR MARGO, TULANG BAWANG, LAMPUNG",9,136,49,185
https://kawalpemilu.org#23822,"RINGIN SARI, BANJAR MARGO, TULANG BAWANG, LAMPUNG",10,130,73,203
https://kawalpemilu.org#23822,"RINGIN SARI, BANJAR MARGO, TULANG BAWANG, LAMPUNG",11,110,32,142
https://kawalpemilu.org#23823,"SUKAMAJU, BANJAR MARGO, TULANG BAWANG, LAMPUNG",1,106,97,203
https://kawalpemilu.org#23823,"SUKAMAJU, BANJAR MARGO, TULANG BAWANG, LAMPUNG",2,124,122,246
https://kawalpemilu.org#23823,"SUKAMAJU, BANJAR MARGO, TULANG BAWANG, LAMPUNG",3,114,131,245
https://kawalpemilu.org#23823,"SUKAMAJU, BANJAR MARGO, TULANG BAWANG, LAMPUNG",4,163,74,237
https://kawalpemilu.org#23823,"SUKAMAJU, BANJAR MARGO, TULANG BAWANG, LAMPUNG",5,163,88,251
https://kawalpemilu.org#23823,"SUKAMAJU, BANJAR MARGO, TULANG BAWANG, LAMPUNG",6,208,27,235
https://kawalpemilu.org#23823,"SUKAMAJU, BANJAR MARGO, TULANG BAWANG, LAMPUNG",7,123,130,253
https://kawalpemilu.org#23823,"SUKAMAJU, BANJAR MARGO, TULANG BAWANG, LAMPUNG",8,118,28,146
https://kawalpemilu.org#23824,"CATUR KARYA BUANA JAYA, BANJAR MARGO, TULANG BAWANG, LAMPUNG",1,189,33,222
https://kawalpemilu.org#23824,"CATUR KARYA BUANA JAYA, BANJAR MARGO, TULANG BAWANG, LAMPUNG",2,152,58,210
https://kawalpemilu.org#23824,"CATUR KARYA BUANA JAYA, BANJAR MARGO, TULANG BAWANG, LAMPUNG",3,145,50,195
https://kawalpemilu.org#23824,"CATUR KARYA BUANA JAYA, BANJAR MARGO, TULANG BAWANG, LAMPUNG",4,165,66,231
https://kawalpemilu.org#23824,"CATUR KARYA BUANA JAYA, BANJAR MARGO, TULANG BAWANG, LAMPUNG",5,171,37,208
https://kawalpemilu.org#23824,"CATUR KARYA BUANA JAYA, BANJAR MARGO, TULANG BAWANG, LAMPUNG",6,126,53,179
https://kawalpemilu.org#23825,"PURWA JAYA, BANJAR MARGO, TULANG BAWANG, LAMPUNG",1,156,85,241
https://kawalpemilu.org#23825,"PURWA JAYA, BANJAR MARGO, TULANG BAWANG, LAMPUNG",2,153,81,234
https://kawalpemilu.org#23825,"PURWA JAYA, BANJAR MARGO, TULANG BAWANG, LAMPUNG",3,157,70,227
https://kawalpemilu.org#23825,"PURWA JAYA, BANJAR MARGO, TULANG BAWANG, LAMPUNG",4,140,63,203
https://kawalpemilu.org#23825,"PURWA JAYA, BANJAR MARGO, TULANG BAWANG, LAMPUNG",5,148,68,216
https://kawalpemilu.org#23825,"PURWA JAYA, BANJAR MARGO, TULANG BAWANG, LAMPUNG",6,132,70,202
https://kawalpemilu.org#23825,"PURWA JAYA, BANJAR MARGO, TULANG BAWANG, LAMPUNG",7,62,198,265
https://kawalpemilu.org#23825,"PURWA JAYA, BANJAR MARGO, TULANG BAWANG, LAMPUNG",8,99,80,179
https://kawalpemilu.org#23825,"PURWA JAYA, BANJAR MARGO, TULANG BAWANG, LAMPUNG",9,32,20,52
https://kawalpemilu.org#23826,"PENAWAR JAYA, BANJAR MARGO, TULANG BAWANG, LAMPUNG",1,192,47,239
https://kawalpemilu.org#23826,"PENAWAR JAYA, BANJAR MARGO, TULANG BAWANG, LAMPUNG",2,181,46,227
https://kawalpemilu.org#23826,"PENAWAR JAYA, BANJAR MARGO, TULANG BAWANG, LAMPUNG",3,144,104,248
https://kawalpemilu.org#23826,"PENAWAR JAYA, BANJAR MARGO, TULANG BAWANG, LAMPUNG",4,195,46,241
https://kawalpemilu.org#23826,"PENAWAR JAYA, BANJAR MARGO, TULANG BAWANG, LAMPUNG",5,169,57,226
https://kawalpemilu.org#23826,"PENAWAR JAYA, BANJAR MARGO, TULANG BAWANG, LAMPUNG",6,125,80,205
https://kawalpemilu.org#23826,"PENAWAR JAYA, BANJAR MARGO, TULANG BAWANG, LAMPUNG",7,122,97,219
https://kawalpemilu.org#23826,"PENAWAR JAYA, BANJAR MARGO, TULANG BAWANG, LAMPUNG",8,141,53,194
https://kawalpemilu.org#23826,"PENAWAR JAYA, BANJAR MARGO, TULANG BAWANG, LAMPUNG",9,116,65,181
https://kawalpemilu.org#23826,"PENAWAR JAYA, BANJAR MARGO, TULANG BAWANG, LAMPUNG",10,168,54,222
https://kawalpemilu.org#23827,"AGUNG DALEM, BANJAR MARGO, TULANG BAWANG, LAMPUNG",1,176,105,281
https://kawalpemilu.org#23827,"AGUNG DALEM, BANJAR MARGO, TULANG BAWANG, LAMPUNG",2,102,147,249
https://kawalpemilu.org#23827,"AGUNG DALEM, BANJAR MARGO, TULANG BAWANG, LAMPUNG",3,129,134,263
https://kawalpemilu.org#23827,"AGUNG DALEM, BANJAR MARGO, TULANG BAWANG, LAMPUNG",5,164,64,228
https://kawalpemilu.org#23827,"AGUNG DALEM, BANJAR MARGO, TULANG BAWANG, LAMPUNG",6,174,87,261
https://kawalpemilu.org#23827,"AGUNG DALEM, BANJAR MARGO, TULANG BAWANG, LAMPUNG",7,72,53,125
https://kawalpemilu.org#23828,"SUMBER MAKMUR, BANJAR MARGO, TULANG BAWANG, LAMPUNG",1,149,54,203
https://kawalpemilu.org#23828,"SUMBER MAKMUR, BANJAR MARGO, TULANG BAWANG, LAMPUNG",3,91,76,167
https://kawalpemilu.org#23828,"SUMBER MAKMUR, BANJAR MARGO, TULANG BAWANG, LAMPUNG",5,145,47,192
https://kawalpemilu.org#23829,"TRI TUNGGAL JAYA, BANJAR MARGO, TULANG BAWANG, LAMPUNG",1,187,60,247
https://kawalpemilu.org#23829,"TRI TUNGGAL JAYA, BANJAR MARGO, TULANG BAWANG, LAMPUNG",2,144,80,224
https://kawalpemilu.org#23829,"TRI TUNGGAL JAYA, BANJAR MARGO, TULANG BAWANG, LAMPUNG",3,163,76,239
https://kawalpemilu.org#23829,"TRI TUNGGAL JAYA, BANJAR MARGO, TULANG BAWANG, LAMPUNG",4,129,112,241
https://kawalpemilu.org#23829,"TRI TUNGGAL JAYA, BANJAR MARGO, TULANG BAWANG, LAMPUNG",5,153,72,225
https://kawalpemilu.org#23829,"TRI TUNGGAL JAYA, BANJAR MARGO, TULANG BAWANG, LAMPUNG",6,153,61,214
https://kawalpemilu.org#23830,"AGUNG JAYA, BANJAR MARGO, TULANG BAWANG, LAMPUNG",1,179,84,263
https://kawalpemilu.org#23830,"AGUNG JAYA, BANJAR MARGO, TULANG BAWANG, LAMPUNG",2,129,68,197
https://kawalpemilu.org#23830,"AGUNG JAYA, BANJAR MARGO, TULANG BAWANG, LAMPUNG",3,156,70,226
https://kawalpemilu.org#23830,"AGUNG JAYA, BANJAR MARGO, TULANG BAWANG, LAMPUNG",4,176,31,207
https://kawalpemilu.org#23830,"AGUNG JAYA, BANJAR MARGO, TULANG BAWANG, LAMPUNG",5,159,34,193
https://kawalpemilu.org#23830,"AGUNG JAYA, BANJAR MARGO, TULANG BAWANG, LAMPUNG",6,178,45,223
https://kawalpemilu.org#23830,"AGUNG JAYA, BANJAR MARGO, TULANG BAWANG, LAMPUNG",7,137,58,195
https://kawalpemilu.org#23830,"AGUNG JAYA, BANJAR MARGO, TULANG BAWANG, LAMPUNG",8,154,52,206
https://kawalpemilu.org#23830,"AGUNG JAYA, BANJAR MARGO, TULANG BAWANG, LAMPUNG",9,179,46,225
https://kawalpemilu.org#23830,"AGUNG JAYA, BANJAR MARGO, TULANG BAWANG, LAMPUNG",10,170,49,219
https://kawalpemilu.org#23830,"AGUNG JAYA, BANJAR MARGO, TULANG BAWANG, LAMPUNG",11,174,44,218
https://kawalpemilu.org#23831,"PENAWAR REJO, BANJAR MARGO, TULANG BAWANG, LAMPUNG",1,136,36,172
https://kawalpemilu.org#23831,"PENAWAR REJO, BANJAR MARGO, TULANG BAWANG, LAMPUNG",2,157,73,230
https://kawalpemilu.org#23831,"PENAWAR REJO, BANJAR MARGO, TULANG BAWANG, LAMPUNG",3,174,38,212
https://kawalpemilu.org#23831,"PENAWAR REJO, BANJAR MARGO, TULANG BAWANG, LAMPUNG",5,138,75,213
https://kawalpemilu.org#23831,"PENAWAR REJO, BANJAR MARGO, TULANG BAWANG, LAMPUNG",6,138,73,211
https://kawalpemilu.org#23831,"PENAWAR REJO, BANJAR MARGO, TULANG BAWANG, LAMPUNG",7,145,79,224
https://kawalpemilu.org#23831,"PENAWAR REJO, BANJAR MARGO, TULANG BAWANG, LAMPUNG",8,145,52,197
https://kawalpemilu.org#23831,"PENAWAR REJO, BANJAR MARGO, TULANG BAWANG, LAMPUNG",9,120,49,169
https://kawalpemilu.org#23831,"PENAWAR REJO, BANJAR MARGO, TULANG BAWANG, LAMPUNG",10,172,51,223
https://kawalpemilu.org#23832,"MEKAR JAYA, BANJAR MARGO, TULANG BAWANG, LAMPUNG",1,162,73,235
https://kawalpemilu.org#23832,"MEKAR JAYA, BANJAR MARGO, TULANG BAWANG, LAMPUNG",2,140,59,199
https://kawalpemilu.org#23832,"MEKAR JAYA, BANJAR MARGO, TULANG BAWANG, LAMPUNG",3,175,61,236
https://kawalpemilu.org#23832,"MEKAR JAYA, BANJAR MARGO, TULANG BAWANG, LAMPUNG",4,133,45,178
https://kawalpemilu.org#23834,"RAWA RAGIL, RAWA PITU, TULANG BAWANG, LAMPUNG",1,209,48,257
https://kawalpemilu.org#23834,"RAWA RAGIL, RAWA PITU, TULANG BAWANG, LAMPUNG",2,152,41,193
https://kawalpemilu.org#23834,"RAWA RAGIL, RAWA PITU, TULANG BAWANG, LAMPUNG",3,196,19,215
https://kawalpemilu.org#23834,"RAWA RAGIL, RAWA PITU, TULANG BAWANG, LAMPUNG",4,241,9,250
https://kawalpemilu.org#23834,"RAWA RAGIL, RAWA PITU, TULANG BAWANG, LAMPUNG",5,222,15,237
https://kawalpemilu.org#23834,"RAWA RAGIL, RAWA PITU, TULANG BAWANG, LAMPUNG",6,194,24,218
https://kawalpemilu.org#23835,"GEDUNG JAYA, RAWA PITU, TULANG BAWANG, LAMPUNG",1,191,27,218
https://kawalpemilu.org#23835,"GEDUNG JAYA, RAWA PITU, TULANG BAWANG, LAMPUNG",2,209,31,240
https://kawalpemilu.org#23835,"GEDUNG JAYA, RAWA PITU, TULANG BAWANG, LAMPUNG",3,205,38,243
https://kawalpemilu.org#23835,"GEDUNG JAYA, RAWA PITU, TULANG BAWANG, LAMPUNG",4,189,42,231
https://kawalpemilu.org#23835,"GEDUNG JAYA, RAWA PITU, TULANG BAWANG, LAMPUNG",5,166,32,198
https://kawalpemilu.org#23836,"BATANGHARI, RAWA PITU, TULANG BAWANG, LAMPUNG",1,189,33,222
https://kawalpemilu.org#23836,"BATANGHARI, RAWA PITU, TULANG BAWANG, LAMPUNG",2,162,66,228
https://kawalpemilu.org#23836,"BATANGHARI, RAWA PITU, TULANG BAWANG, LAMPUNG",3,141,36,177
https://kawalpemilu.org#23836,"BATANGHARI, RAWA PITU, TULANG BAWANG, LAMPUNG",4,145,56,201
https://kawalpemilu.org#23836,"BATANGHARI, RAWA PITU, TULANG BAWANG, LAMPUNG",5,146,43,189
https://kawalpemilu.org#23836,"BATANGHARI, RAWA PITU, TULANG BAWANG, LAMPUNG",6,139,35,174
https://kawalpemilu.org#23837,"PANGGUNG MULYO, RAWA PITU, TULANG BAWANG, LAMPUNG",1,130,46,176
https://kawalpemilu.org#23837,"PANGGUNG MULYO, RAWA PITU, TULANG BAWANG, LAMPUNG",2,134,46,180
https://kawalpemilu.org#23837,"PANGGUNG MULYO, RAWA PITU, TULANG BAWANG, LAMPUNG",3,164,24,188
https://kawalpemilu.org#23838,"SUMBER AGUNG, RAWA PITU, TULANG BAWANG, LAMPUNG",1,177,32,209
https://kawalpemilu.org#23838,"SUMBER AGUNG, RAWA PITU, TULANG BAWANG, LAMPUNG",2,166,64,230
https://kawalpemilu.org#23838,"SUMBER AGUNG, RAWA PITU, TULANG BAWANG, LAMPUNG",3,193,19,212
https://kawalpemilu.org#23838,"SUMBER AGUNG, RAWA PITU, TULANG BAWANG, LAMPUNG",4,194,13,207
https://kawalpemilu.org#23838,"SUMBER AGUNG, RAWA PITU, TULANG BAWANG, LAMPUNG",5,183,21,204
https://kawalpemilu.org#23838,"SUMBER AGUNG, RAWA PITU, TULANG BAWANG, LAMPUNG",6,214,12,226
https://kawalpemilu.org#23838,"SUMBER AGUNG, RAWA PITU, TULANG BAWANG, LAMPUNG",7,84,6,90
https://kawalpemilu.org#23839,"ANDALAS CERMIN, RAWA PITU, TULANG BAWANG, LAMPUNG",1,95,79,174
https://kawalpemilu.org#23839,"ANDALAS CERMIN, RAWA PITU, TULANG BAWANG, LAMPUNG",2,191,50,241
https://kawalpemilu.org#23839,"ANDALAS CERMIN, RAWA PITU, TULANG BAWANG, LAMPUNG",3,202,43,245
https://kawalpemilu.org#23839,"ANDALAS CERMIN, RAWA PITU, TULANG BAWANG, LAMPUNG",4,122,61,183
https://kawalpemilu.org#23839,"ANDALAS CERMIN, RAWA PITU, TULANG BAWANG, LAMPUNG",5,123,51,174
https://kawalpemilu.org#23839,"ANDALAS CERMIN, RAWA PITU, TULANG BAWANG, LAMPUNG",6,73,71,144
https://kawalpemilu.org#23839,"ANDALAS CERMIN, RAWA PITU, TULANG BAWANG, LAMPUNG",7,97,86,183
https://kawalpemilu.org#23839,"ANDALAS CERMIN, RAWA PITU, TULANG BAWANG, LAMPUNG",8,117,33,150
https://kawalpemilu.org#23840,"DUTO YOSO MULYO, RAWA PITU, TULANG BAWANG, LAMPUNG",1,246,18,264
https://kawalpemilu.org#23840,"DUTO YOSO MULYO, RAWA PITU, TULANG BAWANG, LAMPUNG",2,192,34,226
https://kawalpemilu.org#23840,"DUTO YOSO MULYO, RAWA PITU, TULANG BAWANG, LAMPUNG",3,187,33,220
https://kawalpemilu.org#23840,"DUTO YOSO MULYO, RAWA PITU, TULANG BAWANG, LAMPUNG",4,169,42,211
https://kawalpemilu.org#23841,"BUMI SARI, RAWA PITU, TULANG BAWANG, LAMPUNG",1,153,25,178
https://kawalpemilu.org#23841,"BUMI SARI, RAWA PITU, TULANG BAWANG, LAMPUNG",2,128,23,151
https://kawalpemilu.org#23841,"BUMI SARI, RAWA PITU, TULANG BAWANG, LAMPUNG",3,165,13,178
https://kawalpemilu.org#23842,"MULYO DADI, RAWA PITU, TULANG BAWANG, LAMPUNG",1,122,43,165
https://kawalpemilu.org#23842,"MULYO DADI, RAWA PITU, TULANG BAWANG, LAMPUNG",2,179,28,207
https://kawalpemilu.org#23842,"MULYO DADI, RAWA PITU, TULANG BAWANG, LAMPUNG",3,109,47,156
https://kawalpemilu.org#23844,"GEDUNG HARAPAN, PENAWAR AJI, TULANG BAWANG, LAMPUNG",1,116,29,145
https://kawalpemilu.org#23844,"GEDUNG HARAPAN, PENAWAR AJI, TULANG BAWANG, LAMPUNG",2,108,19,127
https://kawalpemilu.org#23844,"GEDUNG HARAPAN, PENAWAR AJI, TULANG BAWANG, LAMPUNG",3,109,31,140
https://kawalpemilu.org#23844,"GEDUNG HARAPAN, PENAWAR AJI, TULANG BAWANG, LAMPUNG",4,115,32,147
https://kawalpemilu.org#23844,"GEDUNG HARAPAN, PENAWAR AJI, TULANG BAWANG, LAMPUNG",5,108,39,147
https://kawalpemilu.org#23844,"GEDUNG HARAPAN, PENAWAR AJI, TULANG BAWANG, LAMPUNG",6,96,35,131
https://kawalpemilu.org#23845,"GEDUNG ASRI, PENAWAR AJI, TULANG BAWANG, LAMPUNG",1,101,53,154
https://kawalpemilu.org#23845,"GEDUNG ASRI, PENAWAR AJI, TULANG BAWANG, LAMPUNG",2,120,23,143
https://kawalpemilu.org#23845,"GEDUNG ASRI, PENAWAR AJI, TULANG BAWANG, LAMPUNG",3,132,17,149
https://kawalpemilu.org#23845,"GEDUNG ASRI, PENAWAR AJI, TULANG BAWANG, LAMPUNG",4,136,22,158
https://kawalpemilu.org#23845,"GEDUNG ASRI, PENAWAR AJI, TULANG BAWANG, LAMPUNG",5,201,10,211
https://kawalpemilu.org#23845,"GEDUNG ASRI, PENAWAR AJI, TULANG BAWANG, LAMPUNG",6,97,27,124
https://kawalpemilu.org#23845,"GEDUNG ASRI, PENAWAR AJI, TULANG BAWANG, LAMPUNG",7,118,28,146
https://kawalpemilu.org#23845,"GEDUNG ASRI, PENAWAR AJI, TULANG BAWANG, LAMPUNG",8,124,24,148
https://kawalpemilu.org#23845,"GEDUNG ASRI, PENAWAR AJI, TULANG BAWANG, LAMPUNG",9,127,19,146
https://kawalpemilu.org#23846,"GEDUNG REJO SAKTI, PENAWAR AJI, TULANG BAWANG, LAMPUNG",1,135,24,159
https://kawalpemilu.org#23846,"GEDUNG REJO SAKTI, PENAWAR AJI, TULANG BAWANG, LAMPUNG",2,104,58,162
https://kawalpemilu.org#23846,"GEDUNG REJO SAKTI, PENAWAR AJI, TULANG BAWANG, LAMPUNG",3,130,31,161
https://kawalpemilu.org#23846,"GEDUNG REJO SAKTI, PENAWAR AJI, TULANG BAWANG, LAMPUNG",4,137,27,164
https://kawalpemilu.org#23846,"GEDUNG REJO SAKTI, PENAWAR AJI, TULANG BAWANG, LAMPUNG",5,122,39,161
https://kawalpemilu.org#23846,"GEDUNG REJO SAKTI, PENAWAR AJI, TULANG BAWANG, LAMPUNG",6,111,24,135
https://kawalpemilu.org#23846,"GEDUNG REJO SAKTI, PENAWAR AJI, TULANG BAWANG, LAMPUNG",7,136,19,155
https://kawalpemilu.org#23846,"GEDUNG REJO SAKTI, PENAWAR AJI, TULANG BAWANG, LAMPUNG",8,141,10,151
https://kawalpemilu.org#23847,"PASAR BATANG, PENAWAR AJI, TULANG BAWANG, LAMPUNG",1,126,44,170
https://kawalpemilu.org#23847,"PASAR BATANG, PENAWAR AJI, TULANG BAWANG, LAMPUNG",2,123,41,164
https://kawalpemilu.org#23847,"PASAR BATANG, PENAWAR AJI, TULANG BAWANG, LAMPUNG",3,98,48,146
https://kawalpemilu.org#23847,"PASAR BATANG, PENAWAR AJI, TULANG BAWANG, LAMPUNG",4,131,49,180
https://kawalpemilu.org#23847,"PASAR BATANG, PENAWAR AJI, TULANG BAWANG, LAMPUNG",5,136,67,203
https://kawalpemilu.org#23847,"PASAR BATANG, PENAWAR AJI, TULANG BAWANG, LAMPUNG",6,97,42,139
https://kawalpemilu.org#23848,"SUKA MAKMUR, PENAWAR AJI, TULANG BAWANG, LAMPUNG",1,166,38,204
https://kawalpemilu.org#23848,"SUKA MAKMUR, PENAWAR AJI, TULANG BAWANG, LAMPUNG",2,153,50,203
https://kawalpemilu.org#23848,"SUKA MAKMUR, PENAWAR AJI, TULANG BAWANG, LAMPUNG",3,157,12,169
https://kawalpemilu.org#23848,"SUKA MAKMUR, PENAWAR AJI, TULANG BAWANG, LAMPUNG",4,127,63,190
https://kawalpemilu.org#23848,"SUKA MAKMUR, PENAWAR AJI, TULANG BAWANG, LAMPUNG",5,128,56,184
https://kawalpemilu.org#23849,"KARYA MAKMUR, PENAWAR AJI, TULANG BAWANG, LAMPUNG",1,123,34,157
https://kawalpemilu.org#23849,"KARYA MAKMUR, PENAWAR AJI, TULANG BAWANG, LAMPUNG",2,129,38,167
https://kawalpemilu.org#23849,"KARYA MAKMUR, PENAWAR AJI, TULANG BAWANG, LAMPUNG",3,81,50,131
https://kawalpemilu.org#23849,"KARYA MAKMUR, PENAWAR AJI, TULANG BAWANG, LAMPUNG",4,124,53,177
https://kawalpemilu.org#23849,"KARYA MAKMUR, PENAWAR AJI, TULANG BAWANG, LAMPUNG",5,72,7,79
https://kawalpemilu.org#23849,"KARYA MAKMUR, PENAWAR AJI, TULANG BAWANG, LAMPUNG",6,101,15,116
https://kawalpemilu.org#23849,"KARYA MAKMUR, PENAWAR AJI, TULANG BAWANG, LAMPUNG",7,77,30,107
https://kawalpemilu.org#23849,"KARYA MAKMUR, PENAWAR AJI, TULANG BAWANG, LAMPUNG",8,122,32,154
https://kawalpemilu.org#23850,"WONO REJO, PENAWAR AJI, TULANG BAWANG, LAMPUNG",1,161,44,205
https://kawalpemilu.org#23850,"WONO REJO, PENAWAR AJI, TULANG BAWANG, LAMPUNG",2,214,36,250
https://kawalpemilu.org#23850,"WONO REJO, PENAWAR AJI, TULANG BAWANG, LAMPUNG",3,171,28,199
https://kawalpemilu.org#23850,"WONO REJO, PENAWAR AJI, TULANG BAWANG, LAMPUNG",4,157,16,173
https://kawalpemilu.org#23850,"WONO REJO, PENAWAR AJI, TULANG BAWANG, LAMPUNG",5,148,17,165
https://kawalpemilu.org#23850,"WONO REJO, PENAWAR AJI, TULANG BAWANG, LAMPUNG",6,160,24,184
https://kawalpemilu.org#23850,"WONO REJO, PENAWAR AJI, TULANG BAWANG, LAMPUNG",7,168,21,189
https://kawalpemilu.org#23851,"PANCA TUNGGAL JAYA, PENAWAR AJI, TULANG BAWANG, LAMPUNG",1,221,22,243
https://kawalpemilu.org#23851,"PANCA TUNGGAL JAYA, PENAWAR AJI, TULANG BAWANG, LAMPUNG",2,204,42,246
https://kawalpemilu.org#23851,"PANCA TUNGGAL JAYA, PENAWAR AJI, TULANG BAWANG, LAMPUNG",3,144,23,167
https://kawalpemilu.org#23851,"PANCA TUNGGAL JAYA, PENAWAR AJI, TULANG BAWANG, LAMPUNG",4,206,12,218
https://kawalpemilu.org#23851,"PANCA TUNGGAL JAYA, PENAWAR AJI, TULANG BAWANG, LAMPUNG",5,205,20,225
https://kawalpemilu.org#23851,"PANCA TUNGGAL JAYA, PENAWAR AJI, TULANG BAWANG, LAMPUNG",6,154,12,166
https://kawalpemilu.org#23851,"PANCA TUNGGAL JAYA, PENAWAR AJI, TULANG BAWANG, LAMPUNG",7,143,17,160
https://kawalpemilu.org#23851,"PANCA TUNGGAL JAYA, PENAWAR AJI, TULANG BAWANG, LAMPUNG",8,127,8,135
https://kawalpemilu.org#23852,"SUMBER SARI, PENAWAR AJI, TULANG BAWANG, LAMPUNG",1,232,3,235
https://kawalpemilu.org#23852,"SUMBER SARI, PENAWAR AJI, TULANG BAWANG, LAMPUNG",2,142,14,156
https://kawalpemilu.org#23852,"SUMBER SARI, PENAWAR AJI, TULANG BAWANG, LAMPUNG",3,99,24,123
https://kawalpemilu.org#23852,"SUMBER SARI, PENAWAR AJI, TULANG BAWANG, LAMPUNG",4,125,14,139
https://kawalpemilu.org#23852,"SUMBER SARI, PENAWAR AJI, TULANG BAWANG, LAMPUNG",5,136,21,157
https://kawalpemilu.org#23852,"SUMBER SARI, PENAWAR AJI, TULANG BAWANG, LAMPUNG",6,116,18,134
https://kawalpemilu.org#23852,"SUMBER SARI, PENAWAR AJI, TULANG BAWANG, LAMPUNG",7,108,16,124
https://kawalpemilu.org#23854,"BANGUN REJO, MERAKSA AJI, TULANG BAWANG, LAMPUNG",1,155,30,185
https://kawalpemilu.org#23854,"BANGUN REJO, MERAKSA AJI, TULANG BAWANG, LAMPUNG",2,150,40,190
https://kawalpemilu.org#23854,"BANGUN REJO, MERAKSA AJI, TULANG BAWANG, LAMPUNG",3,116,64,180
https://kawalpemilu.org#23854,"BANGUN REJO, MERAKSA AJI, TULANG BAWANG, LAMPUNG",4,153,31,184
https://kawalpemilu.org#23854,"BANGUN REJO, MERAKSA AJI, TULANG BAWANG, LAMPUNG",5,108,57,165
https://kawalpemilu.org#23854,"BANGUN REJO, MERAKSA AJI, TULANG BAWANG, LAMPUNG",6,162,16,178
https://kawalpemilu.org#23855,"PADUAN RAJAWALI, MERAKSA AJI, TULANG BAWANG, LAMPUNG",1,144,70,214
https://kawalpemilu.org#23855,"PADUAN RAJAWALI, MERAKSA AJI, TULANG BAWANG, LAMPUNG",2,142,52,194
https://kawalpemilu.org#23855,"PADUAN RAJAWALI, MERAKSA AJI, TULANG BAWANG, LAMPUNG",3,130,54,184
https://kawalpemilu.org#23855,"PADUAN RAJAWALI, MERAKSA AJI, TULANG BAWANG, LAMPUNG",4,140,64,204
https://kawalpemilu.org#23855,"PADUAN RAJAWALI, MERAKSA AJI, TULANG BAWANG, LAMPUNG",5,161,48,209
https://kawalpemilu.org#23855,"PADUAN RAJAWALI, MERAKSA AJI, TULANG BAWANG, LAMPUNG",6,146,51,197
https://kawalpemilu.org#23856,"KARYA BHAKTI, MERAKSA AJI, TULANG BAWANG, LAMPUNG",1,108,66,174
https://kawalpemilu.org#23856,"KARYA BHAKTI, MERAKSA AJI, TULANG BAWANG, LAMPUNG",2,135,50,185
https://kawalpemilu.org#23856,"KARYA BHAKTI, MERAKSA AJI, TULANG BAWANG, LAMPUNG",3,148,29,177
https://kawalpemilu.org#23856,"KARYA BHAKTI, MERAKSA AJI, TULANG BAWANG, LAMPUNG",4,132,31,163
https://kawalpemilu.org#23856,"KARYA BHAKTI, MERAKSA AJI, TULANG BAWANG, LAMPUNG",5,130,41,171
https://kawalpemilu.org#23856,"KARYA BHAKTI, MERAKSA AJI, TULANG BAWANG, LAMPUNG",7,134,52,186
https://kawalpemilu.org#23856,"KARYA BHAKTI, MERAKSA AJI, TULANG BAWANG, LAMPUNG",8,129,29,158
https://kawalpemilu.org#23857,"KECUBUNG RAYA, MERAKSA AJI, TULANG BAWANG, LAMPUNG",1,136,85,221
https://kawalpemilu.org#23857,"KECUBUNG RAYA, MERAKSA AJI, TULANG BAWANG, LAMPUNG",2,130,84,214
https://kawalpemilu.org#23857,"KECUBUNG RAYA, MERAKSA AJI, TULANG BAWANG, LAMPUNG",3,130,84,214
https://kawalpemilu.org#23857,"KECUBUNG RAYA, MERAKSA AJI, TULANG BAWANG, LAMPUNG",4,98,63,161
https://kawalpemilu.org#23858,"MARGA JAYA, MERAKSA AJI, TULANG BAWANG, LAMPUNG",1,117,36,153
https://kawalpemilu.org#23858,"MARGA JAYA, MERAKSA AJI, TULANG BAWANG, LAMPUNG",2,105,56,161
https://kawalpemilu.org#23859,"MULYO AJI, MERAKSA AJI, TULANG BAWANG, LAMPUNG",1,113,34,147
https://kawalpemilu.org#23859,"MULYO AJI, MERAKSA AJI, TULANG BAWANG, LAMPUNG",2,156,61,217
https://kawalpemilu.org#23859,"MULYO AJI, MERAKSA AJI, TULANG BAWANG, LAMPUNG",3,175,15,190
https://kawalpemilu.org#23859,"MULYO AJI, MERAKSA AJI, TULANG BAWANG, LAMPUNG",4,119,33,152
https://kawalpemilu.org#23859,"MULYO AJI, MERAKSA AJI, TULANG BAWANG, LAMPUNG",5,148,48,196
https://kawalpemilu.org#23860,"BINA BUMI, MERAKSA AJI, TULANG BAWANG, LAMPUNG",1,131,81,212
https://kawalpemilu.org#23860,"BINA BUMI, MERAKSA AJI, TULANG BAWANG, LAMPUNG",2,166,66,232
https://kawalpemilu.org#23860,"BINA BUMI, MERAKSA AJI, TULANG BAWANG, LAMPUNG",3,163,57,220
https://kawalpemilu.org#23860,"BINA BUMI, MERAKSA AJI, TULANG BAWANG, LAMPUNG",4,129,75,204
https://kawalpemilu.org#23860,"BINA BUMI, MERAKSA AJI, TULANG BAWANG, LAMPUNG",5,144,55,199
https://kawalpemilu.org#23861,"SUKARAME, MERAKSA AJI, TULANG BAWANG, LAMPUNG",1,101,55,156
https://kawalpemilu.org#23861,"SUKARAME, MERAKSA AJI, TULANG BAWANG, LAMPUNG",2,101,31,132
https://kawalpemilu.org#23861,"SUKARAME, MERAKSA AJI, TULANG BAWANG, LAMPUNG",3,106,38,144
https://kawalpemilu.org#23861,"SUKARAME, MERAKSA AJI, TULANG BAWANG, LAMPUNG",4,128,38,166
https://kawalpemilu.org#23861,"SUKARAME, MERAKSA AJI, TULANG BAWANG, LAMPUNG",5,116,39,155
https://kawalpemilu.org#23861,"SUKARAME, MERAKSA AJI, TULANG BAWANG, LAMPUNG",6,100,62,162
https://kawalpemilu.org#23861,"SUKARAME, MERAKSA AJI, TULANG BAWANG, LAMPUNG",7,142,19,161
https://kawalpemilu.org#23864,"MESIR DWI JAYA, GEDUNG AJI BARU, TULANG BAWANG, LAMPUNG",1,83,115,198
https://kawalpemilu.org#23864,"MESIR DWI JAYA, GEDUNG AJI BARU, TULANG BAWANG, LAMPUNG",2,118,30,148
https://kawalpemilu.org#23865,"MAKARTITAMA, GEDUNG AJI BARU, TULANG BAWANG, LAMPUNG",1,163,86,249
https://kawalpemilu.org#23865,"MAKARTITAMA, GEDUNG AJI BARU, TULANG BAWANG, LAMPUNG",2,147,67,214
https://kawalpemilu.org#23865,"MAKARTITAMA, GEDUNG AJI BARU, TULANG BAWANG, LAMPUNG",3,173,51,224
https://kawalpemilu.org#23865,"MAKARTITAMA, GEDUNG AJI BARU, TULANG BAWANG, LAMPUNG",4,171,43,214
https://kawalpemilu.org#23865,"MAKARTITAMA, GEDUNG AJI BARU, TULANG BAWANG, LAMPUNG",5,157,39,196
https://kawalpemilu.org#23865,"MAKARTITAMA, GEDUNG AJI BARU, TULANG BAWANG, LAMPUNG",6,135,106,241
https://kawalpemilu.org#23865,"MAKARTITAMA, GEDUNG AJI BARU, TULANG BAWANG, LAMPUNG",7,120,51,171
https://kawalpemilu.org#23865,"MAKARTITAMA, GEDUNG AJI BARU, TULANG BAWANG, LAMPUNG",8,143,62,205
https://kawalpemilu.org#23865,"MAKARTITAMA, GEDUNG AJI BARU, TULANG BAWANG, LAMPUNG",9,185,31,216
https://kawalpemilu.org#23865,"MAKARTITAMA, GEDUNG AJI BARU, TULANG BAWANG, LAMPUNG",10,153,48,201
https://kawalpemilu.org#23865,"MAKARTITAMA, GEDUNG AJI BARU, TULANG BAWANG, LAMPUNG",11,149,44,193
https://kawalpemilu.org#23865,"MAKARTITAMA, GEDUNG AJI BARU, TULANG BAWANG, LAMPUNG",12,66,45,111
https://kawalpemilu.org#23865,"MAKARTITAMA, GEDUNG AJI BARU, TULANG BAWANG, LAMPUNG",13,131,32,163
https://kawalpemilu.org#23865,"MAKARTITAMA, GEDUNG AJI BARU, TULANG BAWANG, LAMPUNG",14,83,40,123
https://kawalpemilu.org#23865,"MAKARTITAMA, GEDUNG AJI BARU, TULANG BAWANG, LAMPUNG",15,96,34,130
https://kawalpemilu.org#23866,"SUKA BHAKTI, GEDUNG AJI BARU, TULANG BAWANG, LAMPUNG",1,183,32,215
https://kawalpemilu.org#23866,"SUKA BHAKTI, GEDUNG AJI BARU, TULANG BAWANG, LAMPUNG",2,160,40,200
https://kawalpemilu.org#23866,"SUKA BHAKTI, GEDUNG AJI BARU, TULANG BAWANG, LAMPUNG",3,178,29,207
https://kawalpemilu.org#23866,"SUKA BHAKTI, GEDUNG AJI BARU, TULANG BAWANG, LAMPUNG",4,177,31,208
https://kawalpemilu.org#23866,"SUKA BHAKTI, GEDUNG AJI BARU, TULANG BAWANG, LAMPUNG",5,124,50,174
https://kawalpemilu.org#23866,"SUKA BHAKTI, GEDUNG AJI BARU, TULANG BAWANG, LAMPUNG",6,115,48,163
https://kawalpemilu.org#23866,"SUKA BHAKTI, GEDUNG AJI BARU, TULANG BAWANG, LAMPUNG",7,167,48,215
https://kawalpemilu.org#23866,"SUKA BHAKTI, GEDUNG AJI BARU, TULANG BAWANG, LAMPUNG",8,185,32,217
https://kawalpemilu.org#23866,"SUKA BHAKTI, GEDUNG AJI BARU, TULANG BAWANG, LAMPUNG",9,166,28,194
https://kawalpemilu.org#23866,"SUKA BHAKTI, GEDUNG AJI BARU, TULANG BAWANG, LAMPUNG",10,185,32,217
https://kawalpemilu.org#23866,"SUKA BHAKTI, GEDUNG AJI BARU, TULANG BAWANG, LAMPUNG",11,121,54,175
https://kawalpemilu.org#23866,"SUKA BHAKTI, GEDUNG AJI BARU, TULANG BAWANG, LAMPUNG",12,113,56,169
https://kawalpemilu.org#23866,"SUKA BHAKTI, GEDUNG AJI BARU, TULANG BAWANG, LAMPUNG",13,149,22,171
https://kawalpemilu.org#23866,"SUKA BHAKTI, GEDUNG AJI BARU, TULANG BAWANG, LAMPUNG",14,207,31,238
https://kawalpemilu.org#89567,"SIDOMUKTI, GEDUNG AJI BARU, TULANG BAWANG, LAMPUNG",1,130,38,168
https://kawalpemilu.org#89567,"SIDOMUKTI, GEDUNG AJI BARU, TULANG BAWANG, LAMPUNG",2,124,50,174
https://kawalpemilu.org#89567,"SIDOMUKTI, GEDUNG AJI BARU, TULANG BAWANG, LAMPUNG",3,121,56,177
https://kawalpemilu.org#89567,"SIDOMUKTI, GEDUNG AJI BARU, TULANG BAWANG, LAMPUNG",4,129,55,184
https://kawalpemilu.org#89567,"SIDOMUKTI, GEDUNG AJI BARU, TULANG BAWANG, LAMPUNG",5,137,52,189
https://kawalpemilu.org#89567,"SIDOMUKTI, GEDUNG AJI BARU, TULANG BAWANG, LAMPUNG",6,159,27,186
https://kawalpemilu.org#89567,"SIDOMUKTI, GEDUNG AJI BARU, TULANG BAWANG, LAMPUNG",7,148,30,178
https://kawalpemilu.org#89567,"SIDOMUKTI, GEDUNG AJI BARU, TULANG BAWANG, LAMPUNG",8,89,45,134
https://kawalpemilu.org#89567,"SIDOMUKTI, GEDUNG AJI BARU, TULANG BAWANG, LAMPUNG",9,116,49,165
https://kawalpemilu.org#89567,"SIDOMUKTI, GEDUNG AJI BARU, TULANG BAWANG, LAMPUNG",10,117,55,172
https://kawalpemilu.org#89567,"SIDOMUKTI, GEDUNG AJI BARU, TULANG BAWANG, LAMPUNG",11,169,35,204
https://kawalpemilu.org#89567,"SIDOMUKTI, GEDUNG AJI BARU, TULANG BAWANG, LAMPUNG",12,116,32,148
https://kawalpemilu.org#89568,"BATU AMPAR, GEDUNG AJI BARU, TULANG BAWANG, LAMPUNG",1,211,32,243
https://kawalpemilu.org#89568,"BATU AMPAR, GEDUNG AJI BARU, TULANG BAWANG, LAMPUNG",2,188,52,240
https://kawalpemilu.org#89568,"BATU AMPAR, GEDUNG AJI BARU, TULANG BAWANG, LAMPUNG",3,166,31,197
https://kawalpemilu.org#89568,"BATU AMPAR, GEDUNG AJI BARU, TULANG BAWANG, LAMPUNG",4,194,25,219
https://kawalpemilu.org#89568,"BATU AMPAR, GEDUNG AJI BARU, TULANG BAWANG, LAMPUNG",5,215,28,243
https://kawalpemilu.org#89568,"BATU AMPAR, GEDUNG AJI BARU, TULANG BAWANG, LAMPUNG",6,170,32,202
https://kawalpemilu.org#89569,"SETIA TAMA, GEDUNG AJI BARU, TULANG BAWANG, LAMPUNG",1,114,50,164
https://kawalpemilu.org#89569,"SETIA TAMA, GEDUNG AJI BARU, TULANG BAWANG, LAMPUNG",2,156,27,183
https://kawalpemilu.org#89569,"SETIA TAMA, GEDUNG AJI BARU, TULANG BAWANG, LAMPUNG",3,133,57,190
https://kawalpemilu.org#89569,"SETIA TAMA, GEDUNG AJI BARU, TULANG BAWANG, LAMPUNG",4,140,33,173
https://kawalpemilu.org#89569,"SETIA TAMA, GEDUNG AJI BARU, TULANG BAWANG, LAMPUNG",5,136,26,162
https://kawalpemilu.org#89570,"SUMBER JAYA, GEDUNG AJI BARU, TULANG BAWANG, LAMPUNG",1,126,20,146
https://kawalpemilu.org#89570,"SUMBER JAYA, GEDUNG AJI BARU, TULANG BAWANG, LAMPUNG",2,146,41,187
https://kawalpemilu.org#89570,"SUMBER JAYA, GEDUNG AJI BARU, TULANG BAWANG, LAMPUNG",3,156,41,197
https://kawalpemilu.org#89570,"SUMBER JAYA, GEDUNG AJI BARU, TULANG BAWANG, LAMPUNG",4,109,11,120
https://kawalpemilu.org#89570,"SUMBER JAYA, GEDUNG AJI BARU, TULANG BAWANG, LAMPUNG",5,121,35,156
https://kawalpemilu.org#89571,"MEKAR ASRI, GEDUNG AJI BARU, TULANG BAWANG, LAMPUNG",1,159,40,199
https://kawalpemilu.org#89571,"MEKAR ASRI, GEDUNG AJI BARU, TULANG BAWANG, LAMPUNG",2,143,37,180
https://kawalpemilu.org#89572,"SIDOMEKAR, GEDUNG AJI BARU, TULANG BAWANG, LAMPUNG",1,118,51,169
https://kawalpemilu.org#89572,"SIDOMEKAR, GEDUNG AJI BARU, TULANG BAWANG, LAMPUNG",2,104,59,163
https://kawalpemilu.org#89572,"SIDOMEKAR, GEDUNG AJI BARU, TULANG BAWANG, LAMPUNG",3,137,30,167
https://kawalpemilu.org#89572,"SIDOMEKAR, GEDUNG AJI BARU, TULANG BAWANG, LAMPUNG",4,139,45,184
https://kawalpemilu.org#89572,"SIDOMEKAR, GEDUNG AJI BARU, TULANG BAWANG, LAMPUNG",5,118,46,164
https://kawalpemilu.org#89572,"SIDOMEKAR, GEDUNG AJI BARU, TULANG BAWANG, LAMPUNG",6,97,41,138
https://kawalpemilu.org#89572,"SIDOMEKAR, GEDUNG AJI BARU, TULANG BAWANG, LAMPUNG",7,132,29,161
https://kawalpemilu.org#23868,"BRATASENA ADIWARNA, DENTE TELADAS, TULANG BAWANG, LAMPUNG",1,77,54,131
https://kawalpemilu.org#23868,"BRATASENA ADIWARNA, DENTE TELADAS, TULANG BAWANG, LAMPUNG",2,102,66,168
https://kawalpemilu.org#23868,"BRATASENA ADIWARNA, DENTE TELADAS, TULANG BAWANG, LAMPUNG",3,122,50,172
https://kawalpemilu.org#23868,"BRATASENA ADIWARNA, DENTE TELADAS, TULANG BAWANG, LAMPUNG",4,111,60,171
https://kawalpemilu.org#23868,"BRATASENA ADIWARNA, DENTE TELADAS, TULANG BAWANG, LAMPUNG",5,63,44,107
https://kawalpemilu.org#23868,"BRATASENA ADIWARNA, DENTE TELADAS, TULANG BAWANG, LAMPUNG",6,100,69,169
https://kawalpemilu.org#23868,"BRATASENA ADIWARNA, DENTE TELADAS, TULANG BAWANG, LAMPUNG",7,126,43,169
https://kawalpemilu.org#23868,"BRATASENA ADIWARNA, DENTE TELADAS, TULANG BAWANG, LAMPUNG",8,54,41,95
https://kawalpemilu.org#23868,"BRATASENA ADIWARNA, DENTE TELADAS, TULANG BAWANG, LAMPUNG",9,52,53,105
https://kawalpemilu.org#23868,"BRATASENA ADIWARNA, DENTE TELADAS, TULANG BAWANG, LAMPUNG",10,49,43,92
https://kawalpemilu.org#23868,"BRATASENA ADIWARNA, DENTE TELADAS, TULANG BAWANG, LAMPUNG",11,119,62,181
https://kawalpemilu.org#23868,"BRATASENA ADIWARNA, DENTE TELADAS, TULANG BAWANG, LAMPUNG",12,67,48,115
https://kawalpemilu.org#23868,"BRATASENA ADIWARNA, DENTE TELADAS, TULANG BAWANG, LAMPUNG",13,108,72,180
https://kawalpemilu.org#23869,"BRATASENA MANDIRI, DENTE TELADAS, TULANG BAWANG, LAMPUNG",1,98,62,160
https://kawalpemilu.org#23869,"BRATASENA MANDIRI, DENTE TELADAS, TULANG BAWANG, LAMPUNG",2,58,80,138
https://kawalpemilu.org#23869,"BRATASENA MANDIRI, DENTE TELADAS, TULANG BAWANG, LAMPUNG",3,82,97,179
https://kawalpemilu.org#23869,"BRATASENA MANDIRI, DENTE TELADAS, TULANG BAWANG, LAMPUNG",4,121,63,184
https://kawalpemilu.org#23869,"BRATASENA MANDIRI, DENTE TELADAS, TULANG BAWANG, LAMPUNG",5,116,42,158
https://kawalpemilu.org#23869,"BRATASENA MANDIRI, DENTE TELADAS, TULANG BAWANG, LAMPUNG",6,45,14,59
https://kawalpemilu.org#23869,"BRATASENA MANDIRI, DENTE TELADAS, TULANG BAWANG, LAMPUNG",7,81,24,105
https://kawalpemilu.org#23870,"KEKATUNG, DENTE TELADAS, TULANG BAWANG, LAMPUNG",1,199,13,212
https://kawalpemilu.org#23870,"KEKATUNG, DENTE TELADAS, TULANG BAWANG, LAMPUNG",2,205,14,219
https://kawalpemilu.org#23870,"KEKATUNG, DENTE TELADAS, TULANG BAWANG, LAMPUNG",3,182,32,214
https://kawalpemilu.org#23870,"KEKATUNG, DENTE TELADAS, TULANG BAWANG, LAMPUNG",4,192,57,249
https://kawalpemilu.org#23870,"KEKATUNG, DENTE TELADAS, TULANG BAWANG, LAMPUNG",5,155,15,170
https://kawalpemilu.org#23870,"KEKATUNG, DENTE TELADAS, TULANG BAWANG, LAMPUNG",6,168,44,212
https://kawalpemilu.org#23870,"KEKATUNG, DENTE TELADAS, TULANG BAWANG, LAMPUNG",7,167,24,191
https://kawalpemilu.org#23870,"KEKATUNG, DENTE TELADAS, TULANG BAWANG, LAMPUNG",8,136,6,142
https://kawalpemilu.org#23870,"KEKATUNG, DENTE TELADAS, TULANG BAWANG, LAMPUNG",9,196,34,230
https://kawalpemilu.org#23870,"KEKATUNG, DENTE TELADAS, TULANG BAWANG, LAMPUNG",10,140,28,168
https://kawalpemilu.org#23870,"KEKATUNG, DENTE TELADAS, TULANG BAWANG, LAMPUNG",11,192,50,242
https://kawalpemilu.org#23870,"KEKATUNG, DENTE TELADAS, TULANG BAWANG, LAMPUNG",12,121,13,134
https://kawalpemilu.org#23870,"KEKATUNG, DENTE TELADAS, TULANG BAWANG, LAMPUNG",13,171,35,206
https://kawalpemilu.org#23871,"KUALA TELADAS, DENTE TELADAS, TULANG BAWANG, LAMPUNG",1,141,33,174
https://kawalpemilu.org#23871,"KUALA TELADAS, DENTE TELADAS, TULANG BAWANG, LAMPUNG",2,115,32,147
https://kawalpemilu.org#23871,"KUALA TELADAS, DENTE TELADAS, TULANG BAWANG, LAMPUNG",3,155,39,194
https://kawalpemilu.org#23871,"KUALA TELADAS, DENTE TELADAS, TULANG BAWANG, LAMPUNG",4,118,15,133
https://kawalpemilu.org#23871,"KUALA TELADAS, DENTE TELADAS, TULANG BAWANG, LAMPUNG",5,155,50,205
https://kawalpemilu.org#23872,"MAHABANG, DENTE TELADAS, TULANG BAWANG, LAMPUNG",1,158,49,207
https://kawalpemilu.org#23872,"MAHABANG, DENTE TELADAS, TULANG BAWANG, LAMPUNG",2,206,42,248
https://kawalpemilu.org#23872,"MAHABANG, DENTE TELADAS, TULANG BAWANG, LAMPUNG",3,161,37,198
https://kawalpemilu.org#23872,"MAHABANG, DENTE TELADAS, TULANG BAWANG, LAMPUNG",4,184,21,205
https://kawalpemilu.org#23872,"MAHABANG, DENTE TELADAS, TULANG BAWANG, LAMPUNG",5,93,53,146
https://kawalpemilu.org#23872,"MAHABANG, DENTE TELADAS, TULANG BAWANG, LAMPUNG",7,136,40,176
https://kawalpemilu.org#23873,"PASIRAN JAYA, DENTE TELADAS, TULANG BAWANG, LAMPUNG",1,80,10,90
https://kawalpemilu.org#23873,"PASIRAN JAYA, DENTE TELADAS, TULANG BAWANG, LAMPUNG",2,104,66,170
https://kawalpemilu.org#23873,"PASIRAN JAYA, DENTE TELADAS, TULANG BAWANG, LAMPUNG",3,78,69,147
https://kawalpemilu.org#23873,"PASIRAN JAYA, DENTE TELADAS, TULANG BAWANG, LAMPUNG",4,204,84,288
https://kawalpemilu.org#23873,"PASIRAN JAYA, DENTE TELADAS, TULANG BAWANG, LAMPUNG",5,110,65,175
https://kawalpemilu.org#23873,"PASIRAN JAYA, DENTE TELADAS, TULANG BAWANG, LAMPUNG",6,85,60,145
https://kawalpemilu.org#23873,"PASIRAN JAYA, DENTE TELADAS, TULANG BAWANG, LAMPUNG",7,153,66,219
https://kawalpemilu.org#23873,"PASIRAN JAYA, DENTE TELADAS, TULANG BAWANG, LAMPUNG",8,194,23,217
https://kawalpemilu.org#23873,"PASIRAN JAYA, DENTE TELADAS, TULANG BAWANG, LAMPUNG",9,102,22,124
https://kawalpemilu.org#23873,"PASIRAN JAYA, DENTE TELADAS, TULANG BAWANG, LAMPUNG",10,201,13,214
https://kawalpemilu.org#23873,"PASIRAN JAYA, DENTE TELADAS, TULANG BAWANG, LAMPUNG",11,106,8,114
https://kawalpemilu.org#23873,"PASIRAN JAYA, DENTE TELADAS, TULANG BAWANG, LAMPUNG",12,190,18,208
https://kawalpemilu.org#23873,"PASIRAN JAYA, DENTE TELADAS, TULANG BAWANG, LAMPUNG",13,62,16,78
https://kawalpemilu.org#23873,"PASIRAN JAYA, DENTE TELADAS, TULANG BAWANG, LAMPUNG",14,119,66,185
https://kawalpemilu.org#23873,"PASIRAN JAYA, DENTE TELADAS, TULANG BAWANG, LAMPUNG",15,112,11,123
https://kawalpemilu.org#23873,"PASIRAN JAYA, DENTE TELADAS, TULANG BAWANG, LAMPUNG",16,96,73,169
https://kawalpemilu.org#23873,"PASIRAN JAYA, DENTE TELADAS, TULANG BAWANG, LAMPUNG",17,122,76,198
https://kawalpemilu.org#23873,"PASIRAN JAYA, DENTE TELADAS, TULANG BAWANG, LAMPUNG",18,150,57,207
https://kawalpemilu.org#23873,"PASIRAN JAYA, DENTE TELADAS, TULANG BAWANG, LAMPUNG",19,77,20,97
https://kawalpemilu.org#23873,"PASIRAN JAYA, DENTE TELADAS, TULANG BAWANG, LAMPUNG",20,76,16,92
https://kawalpemilu.org#23873,"PASIRAN JAYA, DENTE TELADAS, TULANG BAWANG, LAMPUNG",21,99,13,112
https://kawalpemilu.org#23873,"PASIRAN JAYA, DENTE TELADAS, TULANG BAWANG, LAMPUNG",22,144,14,158
https://kawalpemilu.org#23874,"SUNGAI NIBUNG, DENTE TELADAS, TULANG BAWANG, LAMPUNG",1,193,13,206
https://kawalpemilu.org#23874,"SUNGAI NIBUNG, DENTE TELADAS, TULANG BAWANG, LAMPUNG",2,206,29,235
https://kawalpemilu.org#23874,"SUNGAI NIBUNG, DENTE TELADAS, TULANG BAWANG, LAMPUNG",3,246,28,274
https://kawalpemilu.org#23874,"SUNGAI NIBUNG, DENTE TELADAS, TULANG BAWANG, LAMPUNG",4,130,45,175
https://kawalpemilu.org#23874,"SUNGAI NIBUNG, DENTE TELADAS, TULANG BAWANG, LAMPUNG",5,257,9,266
https://kawalpemilu.org#23874,"SUNGAI NIBUNG, DENTE TELADAS, TULANG BAWANG, LAMPUNG",6,144,12,156
https://kawalpemilu.org#23874,"SUNGAI NIBUNG, DENTE TELADAS, TULANG BAWANG, LAMPUNG",7,128,9,137
https://kawalpemilu.org#23874,"SUNGAI NIBUNG, DENTE TELADAS, TULANG BAWANG, LAMPUNG",8,110,12,122
https://kawalpemilu.org#23874,"SUNGAI NIBUNG, DENTE TELADAS, TULANG BAWANG, LAMPUNG",9,196,36,232
https://kawalpemilu.org#23874,"SUNGAI NIBUNG, DENTE TELADAS, TULANG BAWANG, LAMPUNG",10,136,22,158
https://kawalpemilu.org#23874,"SUNGAI NIBUNG, DENTE TELADAS, TULANG BAWANG, LAMPUNG",11,180,10,190
https://kawalpemilu.org#23874,"SUNGAI NIBUNG, DENTE TELADAS, TULANG BAWANG, LAMPUNG",12,154,36,190
https://kawalpemilu.org#23874,"SUNGAI NIBUNG, DENTE TELADAS, TULANG BAWANG, LAMPUNG",13,106,31,137
https://kawalpemilu.org#23874,"SUNGAI NIBUNG, DENTE TELADAS, TULANG BAWANG, LAMPUNG",14,199,30,229
https://kawalpemilu.org#23874,"SUNGAI NIBUNG, DENTE TELADAS, TULANG BAWANG, LAMPUNG",15,217,2,219
https://kawalpemilu.org#23874,"SUNGAI NIBUNG, DENTE TELADAS, TULANG BAWANG, LAMPUNG",16,214,58,272
https://kawalpemilu.org#23874,"SUNGAI NIBUNG, DENTE TELADAS, TULANG BAWANG, LAMPUNG",17,158,14,172
https://kawalpemilu.org#23874,"SUNGAI NIBUNG, DENTE TELADAS, TULANG BAWANG, LAMPUNG",18,195,18,213
https://kawalpemilu.org#23874,"SUNGAI NIBUNG, DENTE TELADAS, TULANG BAWANG, LAMPUNG",19,130,13,143
https://kawalpemilu.org#23874,"SUNGAI NIBUNG, DENTE TELADAS, TULANG BAWANG, LAMPUNG",20,177,20,197
https://kawalpemilu.org#23874,"SUNGAI NIBUNG, DENTE TELADAS, TULANG BAWANG, LAMPUNG",21,160,51,211
https://kawalpemilu.org#23874,"SUNGAI NIBUNG, DENTE TELADAS, TULANG BAWANG, LAMPUNG",22,186,60,246
https://kawalpemilu.org#23874,"SUNGAI NIBUNG, DENTE TELADAS, TULANG BAWANG, LAMPUNG",23,168,56,224
https://kawalpemilu.org#23874,"SUNGAI NIBUNG, DENTE TELADAS, TULANG BAWANG, LAMPUNG",24,137,27,164
https://kawalpemilu.org#23874,"SUNGAI NIBUNG, DENTE TELADAS, TULANG BAWANG, LAMPUNG",25,133,28,161
https://kawalpemilu.org#23874,"SUNGAI NIBUNG, DENTE TELADAS, TULANG BAWANG, LAMPUNG",26,169,19,188
https://kawalpemilu.org#23874,"SUNGAI NIBUNG, DENTE TELADAS, TULANG BAWANG, LAMPUNG",27,196,29,225
https://kawalpemilu.org#23874,"SUNGAI NIBUNG, DENTE TELADAS, TULANG BAWANG, LAMPUNG",28,145,25,170
https://kawalpemilu.org#23874,"SUNGAI NIBUNG, DENTE TELADAS, TULANG BAWANG, LAMPUNG",29,185,12,197
https://kawalpemilu.org#23874,"SUNGAI NIBUNG, DENTE TELADAS, TULANG BAWANG, LAMPUNG",30,146,8,154
https://kawalpemilu.org#23874,"SUNGAI NIBUNG, DENTE TELADAS, TULANG BAWANG, LAMPUNG",31,128,12,140
https://kawalpemilu.org#23874,"SUNGAI NIBUNG, DENTE TELADAS, TULANG BAWANG, LAMPUNG",32,101,19,120
https://kawalpemilu.org#23874,"SUNGAI NIBUNG, DENTE TELADAS, TULANG BAWANG, LAMPUNG",33,132,28,160
https://kawalpemilu.org#23874,"SUNGAI NIBUNG, DENTE TELADAS, TULANG BAWANG, LAMPUNG",34,120,54,174
https://kawalpemilu.org#23875,"TELADAS, DENTE TELADAS, TULANG BAWANG, LAMPUNG",1,150,121,271
https://kawalpemilu.org#23875,"TELADAS, DENTE TELADAS, TULANG BAWANG, LAMPUNG",2,120,80,200
https://kawalpemilu.org#23875,"TELADAS, DENTE TELADAS, TULANG BAWANG, LAMPUNG",3,196,90,286
https://kawalpemilu.org#23875,"TELADAS, DENTE TELADAS, TULANG BAWANG, LAMPUNG",4,83,7,90
https://kawalpemilu.org#23875,"TELADAS, DENTE TELADAS, TULANG BAWANG, LAMPUNG",5,141,11,152
https://kawalpemilu.org#23875,"TELADAS, DENTE TELADAS, TULANG BAWANG, LAMPUNG",6,105,24,129
https://kawalpemilu.org#23875,"TELADAS, DENTE TELADAS, TULANG BAWANG, LAMPUNG",7,172,13,185
https://kawalpemilu.org#23875,"TELADAS, DENTE TELADAS, TULANG BAWANG, LAMPUNG",8,122,12,134
https://kawalpemilu.org#23875,"TELADAS, DENTE TELADAS, TULANG BAWANG, LAMPUNG",9,84,112,196
https://kawalpemilu.org#23875,"TELADAS, DENTE TELADAS, TULANG BAWANG, LAMPUNG",10,81,34,115
https://kawalpemilu.org#23875,"TELADAS, DENTE TELADAS, TULANG BAWANG, LAMPUNG",11,186,13,199
https://kawalpemilu.org#23875,"TELADAS, DENTE TELADAS, TULANG BAWANG, LAMPUNG",12,116,22,138
https://kawalpemilu.org#23875,"TELADAS, DENTE TELADAS, TULANG BAWANG, LAMPUNG",13,137,5,142
https://kawalpemilu.org#23876,"WAY DENTE, DENTE TELADAS, TULANG BAWANG, LAMPUNG",1,164,93,257
https://kawalpemilu.org#23876,"WAY DENTE, DENTE TELADAS, TULANG BAWANG, LAMPUNG",2,219,50,269
https://kawalpemilu.org#23876,"WAY DENTE, DENTE TELADAS, TULANG BAWANG, LAMPUNG",3,181,54,235
https://kawalpemilu.org#23876,"WAY DENTE, DENTE TELADAS, TULANG BAWANG, LAMPUNG",4,133,48,181
https://kawalpemilu.org#23876,"WAY DENTE, DENTE TELADAS, TULANG BAWANG, LAMPUNG",5,159,63,222
https://kawalpemilu.org#23876,"WAY DENTE, DENTE TELADAS, TULANG BAWANG, LAMPUNG",6,140,17,157
https://kawalpemilu.org#23876,"WAY DENTE, DENTE TELADAS, TULANG BAWANG, LAMPUNG",7,186,42,228
https://kawalpemilu.org#23876,"WAY DENTE, DENTE TELADAS, TULANG BAWANG, LAMPUNG",8,178,35,213
https://kawalpemilu.org#23876,"WAY DENTE, DENTE TELADAS, TULANG BAWANG, LAMPUNG",9,192,41,233
https://kawalpemilu.org#23877,"PENDOWO ASRI, DENTE TELADAS, TULANG BAWANG, LAMPUNG",2,131,13,144
https://kawalpemilu.org#23877,"PENDOWO ASRI, DENTE TELADAS, TULANG BAWANG, LAMPUNG",3,99,46,145
https://kawalpemilu.org#23877,"PENDOWO ASRI, DENTE TELADAS, TULANG BAWANG, LAMPUNG",4,150,66,216
https://kawalpemilu.org#23877,"PENDOWO ASRI, DENTE TELADAS, TULANG BAWANG, LAMPUNG",5,143,37,180
https://kawalpemilu.org#23877,"PENDOWO ASRI, DENTE TELADAS, TULANG BAWANG, LAMPUNG",6,104,28,132
https://kawalpemilu.org#23877,"PENDOWO ASRI, DENTE TELADAS, TULANG BAWANG, LAMPUNG",7,102,27,129
https://kawalpemilu.org#23877,"PENDOWO ASRI, DENTE TELADAS, TULANG BAWANG, LAMPUNG",8,96,23,119
https://kawalpemilu.org#23877,"PENDOWO ASRI, DENTE TELADAS, TULANG BAWANG, LAMPUNG",9,126,63,189
https://kawalpemilu.org#23877,"PENDOWO ASRI, DENTE TELADAS, TULANG BAWANG, LAMPUNG",10,133,38,172
https://kawalpemilu.org#23877,"PENDOWO ASRI, DENTE TELADAS, TULANG BAWANG, LAMPUNG",11,143,43,186
https://kawalpemilu.org#23877,"PENDOWO ASRI, DENTE TELADAS, TULANG BAWANG, LAMPUNG",12,202,61,263
https://kawalpemilu.org#23877,"PENDOWO ASRI, DENTE TELADAS, TULANG BAWANG, LAMPUNG",13,101,37,138
https://kawalpemilu.org#23877,"PENDOWO ASRI, DENTE TELADAS, TULANG BAWANG, LAMPUNG",14,80,49,129
https://kawalpemilu.org#23877,"PENDOWO ASRI, DENTE TELADAS, TULANG BAWANG, LAMPUNG",15,101,35,136
https://kawalpemilu.org#23877,"PENDOWO ASRI, DENTE TELADAS, TULANG BAWANG, LAMPUNG",16,74,14,88
https://kawalpemilu.org#23877,"PENDOWO ASRI, DENTE TELADAS, TULANG BAWANG, LAMPUNG",17,83,47,130
https://kawalpemilu.org#23877,"PENDOWO ASRI, DENTE TELADAS, TULANG BAWANG, LAMPUNG",18,87,23,110
https://kawalpemilu.org#23877,"PENDOWO ASRI, DENTE TELADAS, TULANG BAWANG, LAMPUNG",19,85,67,152
https://kawalpemilu.org#23877,"PENDOWO ASRI, DENTE TELADAS, TULANG BAWANG, LAMPUNG",20,115,52,167
https://kawalpemilu.org#23877,"PENDOWO ASRI, DENTE TELADAS, TULANG BAWANG, LAMPUNG",21,145,42,187
https://kawalpemilu.org#23877,"PENDOWO ASRI, DENTE TELADAS, TULANG BAWANG, LAMPUNG",22,137,47,184
https://kawalpemilu.org#23878,"DENTE MAKMUR, DENTE TELADAS, TULANG BAWANG, LAMPUNG",1,149,33,182
https://kawalpemilu.org#23878,"DENTE MAKMUR, DENTE TELADAS, TULANG BAWANG, LAMPUNG",2,175,34,209
https://kawalpemilu.org#23878,"DENTE MAKMUR, DENTE TELADAS, TULANG BAWANG, LAMPUNG",3,163,29,192
https://kawalpemilu.org#23878,"DENTE MAKMUR, DENTE TELADAS, TULANG BAWANG, LAMPUNG",4,188,18,206
https://kawalpemilu.org#23878,"DENTE MAKMUR, DENTE TELADAS, TULANG BAWANG, LAMPUNG",5,178,46,224
https://kawalpemilu.org#23878,"DENTE MAKMUR, DENTE TELADAS, TULANG BAWANG, LAMPUNG",6,208,21,229
https://kawalpemilu.org#23878,"DENTE MAKMUR, DENTE TELADAS, TULANG BAWANG, LAMPUNG",7,172,27,199
https://kawalpemilu.org#23878,"DENTE MAKMUR, DENTE TELADAS, TULANG BAWANG, LAMPUNG",8,152,15,167
https://kawalpemilu.org#89532,"SUNGAI BURUNG, DENTE TELADAS, TULANG BAWANG, LAMPUNG",1,199,34,233
https://kawalpemilu.org#89532,"SUNGAI BURUNG, DENTE TELADAS, TULANG BAWANG, LAMPUNG",2,193,44,237
https://kawalpemilu.org#89532,"SUNGAI BURUNG, DENTE TELADAS, TULANG BAWANG, LAMPUNG",3,63,11,74
https://kawalpemilu.org#23880,"PANCA MULIA, BANJAR BARU, TULANG BAWANG, LAMPUNG",1,136,94,230
https://kawalpemilu.org#23880,"PANCA MULIA, BANJAR BARU, TULANG BAWANG, LAMPUNG",2,152,74,226
https://kawalpemilu.org#23880,"PANCA MULIA, BANJAR BARU, TULANG BAWANG, LAMPUNG",3,150,74,224
https://kawalpemilu.org#23880,"PANCA MULIA, BANJAR BARU, TULANG BAWANG, LAMPUNG",4,163,46,209
https://kawalpemilu.org#23881,"PANCA KARSA PURNA JAYA, BANJAR BARU, TULANG BAWANG, LAMPUNG",1,95,126,221
https://kawalpemilu.org#23881,"PANCA KARSA PURNA JAYA, BANJAR BARU, TULANG BAWANG, LAMPUNG",2,119,114,233
https://kawalpemilu.org#23881,"PANCA KARSA PURNA JAYA, BANJAR BARU, TULANG BAWANG, LAMPUNG",3,101,127,228
https://kawalpemilu.org#23881,"PANCA KARSA PURNA JAYA, BANJAR BARU, TULANG BAWANG, LAMPUNG",4,84,139,223
https://kawalpemilu.org#23881,"PANCA KARSA PURNA JAYA, BANJAR BARU, TULANG BAWANG, LAMPUNG",5,112,129,241
https://kawalpemilu.org#23881,"PANCA KARSA PURNA JAYA, BANJAR BARU, TULANG BAWANG, LAMPUNG",6,114,100,214
https://kawalpemilu.org#23882,"KAHURIPAN JAYA, BANJAR BARU, TULANG BAWANG, LAMPUNG",1,103,132,235
https://kawalpemilu.org#23882,"KAHURIPAN JAYA, BANJAR BARU, TULANG BAWANG, LAMPUNG",2,138,104,242
https://kawalpemilu.org#23882,"KAHURIPAN JAYA, BANJAR BARU, TULANG BAWANG, LAMPUNG",3,134,63,197
https://kawalpemilu.org#23882,"KAHURIPAN JAYA, BANJAR BARU, TULANG BAWANG, LAMPUNG",4,115,76,191
https://kawalpemilu.org#23882,"KAHURIPAN JAYA, BANJAR BARU, TULANG BAWANG, LAMPUNG",5,78,117,195
https://kawalpemilu.org#23883,"BAWANG SAKTI JAYA, BANJAR BARU, TULANG BAWANG, LAMPUNG",1,128,94,222
https://kawalpemilu.org#23883,"BAWANG SAKTI JAYA, BANJAR BARU, TULANG BAWANG, LAMPUNG",2,114,70,184
https://kawalpemilu.org#23883,"BAWANG SAKTI JAYA, BANJAR BARU, TULANG BAWANG, LAMPUNG",3,90,119,209
https://kawalpemilu.org#23883,"BAWANG SAKTI JAYA, BANJAR BARU, TULANG BAWANG, LAMPUNG",4,140,56,196
https://kawalpemilu.org#23884,"MEKAR JAYA, BANJAR BARU, TULANG BAWANG, LAMPUNG",1,89,106,192
https://kawalpemilu.org#23884,"MEKAR JAYA, BANJAR BARU, TULANG BAWANG, LAMPUNG",2,159,48,207
https://kawalpemilu.org#23885,"BALAI MURNI JAYA, BANJAR BARU, TULANG BAWANG, LAMPUNG",1,105,94,199
https://kawalpemilu.org#23885,"BALAI MURNI JAYA, BANJAR BARU, TULANG BAWANG, LAMPUNG",2,90,103,193
https://kawalpemilu.org#23885,"BALAI MURNI JAYA, BANJAR BARU, TULANG BAWANG, LAMPUNG",3,86,19,105
https://kawalpemilu.org#23886,"MEKAR INDAH JAYA, BANJAR BARU, TULANG BAWANG, LAMPUNG",1,94,117,211
https://kawalpemilu.org#23886,"MEKAR INDAH JAYA, BANJAR BARU, TULANG BAWANG, LAMPUNG",2,73,108,181
https://kawalpemilu.org#23886,"MEKAR INDAH JAYA, BANJAR BARU, TULANG BAWANG, LAMPUNG",3,101,36,137
https://kawalpemilu.org#23887,"JAYA MAKMUR, BANJAR BARU, TULANG BAWANG, LAMPUNG",1,91,143,234
https://kawalpemilu.org#23887,"JAYA MAKMUR, BANJAR BARU, TULANG BAWANG, LAMPUNG",2,143,103,246
https://kawalpemilu.org#23887,"JAYA MAKMUR, BANJAR BARU, TULANG BAWANG, LAMPUNG",3,158,56,214
https://kawalpemilu.org#23887,"JAYA MAKMUR, BANJAR BARU, TULANG BAWANG, LAMPUNG",4,111,112,223
https://kawalpemilu.org#23887,"JAYA MAKMUR, BANJAR BARU, TULANG BAWANG, LAMPUNG",5,121,113,234
https://kawalpemilu.org#23887,"JAYA MAKMUR, BANJAR BARU, TULANG BAWANG, LAMPUNG",6,87,118,205
https://kawalpemilu.org#23888,"BAWANG TIRTO MULYO, BANJAR BARU, TULANG BAWANG, LAMPUNG",1,120,91,211
https://kawalpemilu.org#23888,"BAWANG TIRTO MULYO, BANJAR BARU, TULANG BAWANG, LAMPUNG",2,182,37,219
https://kawalpemilu.org#23888,"BAWANG TIRTO MULYO, BANJAR BARU, TULANG BAWANG, LAMPUNG",3,121,83,204
https://kawalpemilu.org#23888,"BAWANG TIRTO MULYO, BANJAR BARU, TULANG BAWANG, LAMPUNG",4,145,59,204
https://kawalpemilu.org#23888,"BAWANG TIRTO MULYO, BANJAR BARU, TULANG BAWANG, LAMPUNG",5,105,81,186
https://kawalpemilu.org#23889,"KARYA MURNI JAYA, BANJAR BARU, TULANG BAWANG, LAMPUNG",2,109,98,207
https://kawalpemilu.org#23889,"KARYA MURNI JAYA, BANJAR BARU, TULANG BAWANG, LAMPUNG",3,108,54,162
https://kawalpemilu.org#23762,"CEMPAKA JAYA, MENGGALA TIMUR, TULANG BAWANG, LAMPUNG",1,109,75,184
https://kawalpemilu.org#23762,"CEMPAKA JAYA, MENGGALA TIMUR, TULANG BAWANG, LAMPUNG",2,96,91,187
https://kawalpemilu.org#23762,"CEMPAKA JAYA, MENGGALA TIMUR, TULANG BAWANG, LAMPUNG",3,82,101,183
https://kawalpemilu.org#23762,"CEMPAKA JAYA, MENGGALA TIMUR, TULANG BAWANG, LAMPUNG",4,86,109,194
https://kawalpemilu.org#23762,"CEMPAKA JAYA, MENGGALA TIMUR, TULANG BAWANG, LAMPUNG",5,118,68,186
https://kawalpemilu.org#23891,"LEBUH DALEM, MENGGALA TIMUR, TULANG BAWANG, LAMPUNG",1,134,105,239
https://kawalpemilu.org#23891,"LEBUH DALEM, MENGGALA TIMUR, TULANG BAWANG, LAMPUNG",2,135,138,273
https://kawalpemilu.org#23891,"LEBUH DALEM, MENGGALA TIMUR, TULANG BAWANG, LAMPUNG",3,146,120,266
https://kawalpemilu.org#23891,"LEBUH DALEM, MENGGALA TIMUR, TULANG BAWANG, LAMPUNG",4,169,77,246
https://kawalpemilu.org#23891,"LEBUH DALEM, MENGGALA TIMUR, TULANG BAWANG, LAMPUNG",5,184,58,242
https://kawalpemilu.org#23892,"MENGGALA, MENGGALA TIMUR, TULANG BAWANG, LAMPUNG",1,56,113,169
https://kawalpemilu.org#23892,"MENGGALA, MENGGALA TIMUR, TULANG BAWANG, LAMPUNG",2,103,116,219
https://kawalpemilu.org#23892,"MENGGALA, MENGGALA TIMUR, TULANG BAWANG, LAMPUNG",3,256,21,277
https://kawalpemilu.org#23892,"MENGGALA, MENGGALA TIMUR, TULANG BAWANG, LAMPUNG",4,227,43,270
https://kawalpemilu.org#23892,"MENGGALA, MENGGALA TIMUR, TULANG BAWANG, LAMPUNG",5,166,5,171
https://kawalpemilu.org#23892,"MENGGALA, MENGGALA TIMUR, TULANG BAWANG, LAMPUNG",6,202,48,250
https://kawalpemilu.org#23892,"MENGGALA, MENGGALA TIMUR, TULANG BAWANG, LAMPUNG",7,128,122,250
https://kawalpemilu.org#23892,"MENGGALA, MENGGALA TIMUR, TULANG BAWANG, LAMPUNG",8,197,75,272
https://kawalpemilu.org#23893,"LINGAI, MENGGALA TIMUR, TULANG BAWANG, LAMPUNG",1,79,34,113
https://kawalpemilu.org#23893,"LINGAI, MENGGALA TIMUR, TULANG BAWANG, LAMPUNG",2,152,58,210
https://kawalpemilu.org#23893,"LINGAI, MENGGALA TIMUR, TULANG BAWANG, LAMPUNG",3,115,67,182
https://kawalpemilu.org#23894,"KIBANG PACING, MENGGALA TIMUR, TULANG BAWANG, LAMPUNG",1,163,52,215
https://kawalpemilu.org#23894,"KIBANG PACING, MENGGALA TIMUR, TULANG BAWANG, LAMPUNG",2,178,50,228
https://kawalpemilu.org#23894,"KIBANG PACING, MENGGALA TIMUR, TULANG BAWANG, LAMPUNG",3,83,82,165
https://kawalpemilu.org#23894,"KIBANG PACING, MENGGALA TIMUR, TULANG BAWANG, LAMPUNG",4,108,60,168
https://kawalpemilu.org#23895,"SUNGAI LUAR, MENGGALA TIMUR, TULANG BAWANG, LAMPUNG",1,83,111,194
https://kawalpemilu.org#23895,"SUNGAI LUAR, MENGGALA TIMUR, TULANG BAWANG, LAMPUNG",2,112,73,185
https://kawalpemilu.org#23895,"SUNGAI LUAR, MENGGALA TIMUR, TULANG BAWANG, LAMPUNG",3,130,71,201
https://kawalpemilu.org#23896,"KAHURIPAN DALAM, MENGGALA TIMUR, TULANG BAWANG, LAMPUNG",1,223,25,248
https://kawalpemilu.org#23896,"KAHURIPAN DALAM, MENGGALA TIMUR, TULANG BAWANG, LAMPUNG",2,149,16,165
https://kawalpemilu.org#23896,"KAHURIPAN DALAM, MENGGALA TIMUR, TULANG BAWANG, LAMPUNG",3,183,59,242
https://kawalpemilu.org#23897,"CEMPAKA DALEM, MENGGALA TIMUR, TULANG BAWANG, LAMPUNG",1,179,59,238
https://kawalpemilu.org#23897,"CEMPAKA DALEM, MENGGALA TIMUR, TULANG BAWANG, LAMPUNG",2,127,65,192
https://kawalpemilu.org#23897,"CEMPAKA DALEM, MENGGALA TIMUR, TULANG BAWANG, LAMPUNG",3,102,91,193
https://kawalpemilu.org#23898,"BEDAROU INDAH, MENGGALA TIMUR, TULANG BAWANG, LAMPUNG",1,132,73,205
https://kawalpemilu.org#23898,"BEDAROU INDAH, MENGGALA TIMUR, TULANG BAWANG, LAMPUNG",2,175,61,236
https://kawalpemilu.org#23898,"BEDAROU INDAH, MENGGALA TIMUR, TULANG BAWANG, LAMPUNG",3,162,68,230
https://kawalpemilu.org#23899,"TRI MAKMUR JAYA, MENGGALA TIMUR, TULANG BAWANG, LAMPUNG",1,59,66,125
https://kawalpemilu.org#23899,"TRI MAKMUR JAYA, MENGGALA TIMUR, TULANG BAWANG, LAMPUNG",2,106,110,216
https://kawalpemilu.org#23899,"TRI MAKMUR JAYA, MENGGALA TIMUR, TULANG BAWANG, LAMPUNG",3,141,87,228
https://kawalpemilu.org#23905,"BAROS, KOTA AGUNG, TANGGAMUS, LAMPUNG",1,60,80,140
https://kawalpemilu.org#23905,"BAROS, KOTA AGUNG, TANGGAMUS, LAMPUNG",2,100,81,181
https://kawalpemilu.org#23905,"BAROS, KOTA AGUNG, TANGGAMUS, LAMPUNG",3,88,53,141
https://kawalpemilu.org#23905,"BAROS, KOTA AGUNG, TANGGAMUS, LAMPUNG",4,62,133,195
https://kawalpemilu.org#23905,"BAROS, KOTA AGUNG, TANGGAMUS, LAMPUNG",5,114,112,226
https://kawalpemilu.org#23905,"BAROS, KOTA AGUNG, TANGGAMUS, LAMPUNG",6,91,118,209
https://kawalpemilu.org#23905,"BAROS, KOTA AGUNG, TANGGAMUS, LAMPUNG",7,108,87,195
https://kawalpemilu.org#23905,"BAROS, KOTA AGUNG, TANGGAMUS, LAMPUNG",8,128,76,204
https://kawalpemilu.org#23905,"BAROS, KOTA AGUNG, TANGGAMUS, LAMPUNG",9,129,77,206
https://kawalpemilu.org#23905,"BAROS, KOTA AGUNG, TANGGAMUS, LAMPUNG",10,68,109,177
https://kawalpemilu.org#23905,"BAROS, KOTA AGUNG, TANGGAMUS, LAMPUNG",11,59,60,119
https://kawalpemilu.org#23905,"BAROS, KOTA AGUNG, TANGGAMUS, LAMPUNG",12,91,60,151
https://kawalpemilu.org#23906,"PASAR MADANG, KOTA AGUNG, TANGGAMUS, LAMPUNG",1,96,72,168
https://kawalpemilu.org#23906,"PASAR MADANG, KOTA AGUNG, TANGGAMUS, LAMPUNG",2,57,76,133
https://kawalpemilu.org#23906,"PASAR MADANG, KOTA AGUNG, TANGGAMUS, LAMPUNG",3,100,65,165
https://kawalpemilu.org#23906,"PASAR MADANG, KOTA AGUNG, TANGGAMUS, LAMPUNG",4,93,101,194
https://kawalpemilu.org#23906,"PASAR MADANG, KOTA AGUNG, TANGGAMUS, LAMPUNG",5,110,115,225
https://kawalpemilu.org#23906,"PASAR MADANG, KOTA AGUNG, TANGGAMUS, LAMPUNG",6,115,126,241
https://kawalpemilu.org#23906,"PASAR MADANG, KOTA AGUNG, TANGGAMUS, LAMPUNG",7,110,112,222
https://kawalpemilu.org#23906,"PASAR MADANG, KOTA AGUNG, TANGGAMUS, LAMPUNG",8,126,101,227
https://kawalpemilu.org#23906,"PASAR MADANG, KOTA AGUNG, TANGGAMUS, LAMPUNG",9,99,109,208
https://kawalpemilu.org#23906,"PASAR MADANG, KOTA AGUNG, TANGGAMUS, LAMPUNG",10,115,61,176
https://kawalpemilu.org#23906,"PASAR MADANG, KOTA AGUNG, TANGGAMUS, LAMPUNG",11,93,53,146
https://kawalpemilu.org#23906,"PASAR MADANG, KOTA AGUNG, TANGGAMUS, LAMPUNG",12,131,113,244
https://kawalpemilu.org#23906,"PASAR MADANG, KOTA AGUNG, TANGGAMUS, LAMPUNG",13,143,77,220
https://kawalpemilu.org#23906,"PASAR MADANG, KOTA AGUNG, TANGGAMUS, LAMPUNG",14,152,60,212
https://kawalpemilu.org#23906,"PASAR MADANG, KOTA AGUNG, TANGGAMUS, LAMPUNG",15,140,80,220
https://kawalpemilu.org#23906,"PASAR MADANG, KOTA AGUNG, TANGGAMUS, LAMPUNG",16,87,94,181
https://kawalpemilu.org#23906,"PASAR MADANG, KOTA AGUNG, TANGGAMUS, LAMPUNG",17,101,75,176
https://kawalpemilu.org#23906,"PASAR MADANG, KOTA AGUNG, TANGGAMUS, LAMPUNG",18,68,124,192
https://kawalpemilu.org#23906,"PASAR MADANG, KOTA AGUNG, TANGGAMUS, LAMPUNG",19,83,105,188
https://kawalpemilu.org#23907,"KURIPAN, KOTA AGUNG, TANGGAMUS, LAMPUNG",1,99,96,195
https://kawalpemilu.org#23907,"KURIPAN, KOTA AGUNG, TANGGAMUS, LAMPUNG",2,88,129,217
https://kawalpemilu.org#23907,"KURIPAN, KOTA AGUNG, TANGGAMUS, LAMPUNG",3,70,97,167
https://kawalpemilu.org#23907,"KURIPAN, KOTA AGUNG, TANGGAMUS, LAMPUNG",4,50,122,172
https://kawalpemilu.org#23907,"KURIPAN, KOTA AGUNG, TANGGAMUS, LAMPUNG",5,51,103,154
https://kawalpemilu.org#23907,"KURIPAN, KOTA AGUNG, TANGGAMUS, LAMPUNG",6,56,92,148
https://kawalpemilu.org#23907,"KURIPAN, KOTA AGUNG, TANGGAMUS, LAMPUNG",7,63,103,166
https://kawalpemilu.org#23907,"KURIPAN, KOTA AGUNG, TANGGAMUS, LAMPUNG",8,71,73,144
https://kawalpemilu.org#23907,"KURIPAN, KOTA AGUNG, TANGGAMUS, LAMPUNG",9,73,95,168
https://kawalpemilu.org#23907,"KURIPAN, KOTA AGUNG, TANGGAMUS, LAMPUNG",10,46,68,114
https://kawalpemilu.org#23907,"KURIPAN, KOTA AGUNG, TANGGAMUS, LAMPUNG",11,66,134,200
https://kawalpemilu.org#23907,"KURIPAN, KOTA AGUNG, TANGGAMUS, LAMPUNG",12,60,99,159
https://kawalpemilu.org#23907,"KURIPAN, KOTA AGUNG, TANGGAMUS, LAMPUNG",13,71,130,201
https://kawalpemilu.org#23907,"KURIPAN, KOTA AGUNG, TANGGAMUS, LAMPUNG",14,84,108,192
https://kawalpemilu.org#23907,"KURIPAN, KOTA AGUNG, TANGGAMUS, LAMPUNG",15,37,91,128
https://kawalpemilu.org#23907,"KURIPAN, KOTA AGUNG, TANGGAMUS, LAMPUNG",16,70,78,148
https://kawalpemilu.org#23907,"KURIPAN, KOTA AGUNG, TANGGAMUS, LAMPUNG",17,60,86,146
https://kawalpemilu.org#23907,"KURIPAN, KOTA AGUNG, TANGGAMUS, LAMPUNG",18,83,137,220
https://kawalpemilu.org#23907,"KURIPAN, KOTA AGUNG, TANGGAMUS, LAMPUNG",19,55,133,188
https://kawalpemilu.org#23907,"KURIPAN, KOTA AGUNG, TANGGAMUS, LAMPUNG",20,93,96,189
https://kawalpemilu.org#23907,"KURIPAN, KOTA AGUNG, TANGGAMUS, LAMPUNG",21,122,110,232
https://kawalpemilu.org#23907,"KURIPAN, KOTA AGUNG, TANGGAMUS, LAMPUNG",22,134,104,238
https://kawalpemilu.org#23907,"KURIPAN, KOTA AGUNG, TANGGAMUS, LAMPUNG",23,18,100,118
https://kawalpemilu.org#23907,"KURIPAN, KOTA AGUNG, TANGGAMUS, LAMPUNG",24,76,78,154
https://kawalpemilu.org#23907,"KURIPAN, KOTA AGUNG, TANGGAMUS, LAMPUNG",25,45,82,127
https://kawalpemilu.org#23907,"KURIPAN, KOTA AGUNG, TANGGAMUS, LAMPUNG",26,59,63,122
https://kawalpemilu.org#23907,"KURIPAN, KOTA AGUNG, TANGGAMUS, LAMPUNG",27,64,90,154
https://kawalpemilu.org#23907,"KURIPAN, KOTA AGUNG, TANGGAMUS, LAMPUNG",28,23,83,106
https://kawalpemilu.org#23907,"KURIPAN, KOTA AGUNG, TANGGAMUS, LAMPUNG",29,54,81,135
https://kawalpemilu.org#23907,"KURIPAN, KOTA AGUNG, TANGGAMUS, LAMPUNG",30,68,122,190
https://kawalpemilu.org#23907,"KURIPAN, KOTA AGUNG, TANGGAMUS, LAMPUNG",31,51,101,152
https://kawalpemilu.org#23908,"NEGERI RATU, KOTA AGUNG, TANGGAMUS, LAMPUNG",1,76,55,131
https://kawalpemilu.org#23908,"NEGERI RATU, KOTA AGUNG, TANGGAMUS, LAMPUNG",2,81,82,163
https://kawalpemilu.org#23908,"NEGERI RATU, KOTA AGUNG, TANGGAMUS, LAMPUNG",3,63,79,142
https://kawalpemilu.org#23908,"NEGERI RATU, KOTA AGUNG, TANGGAMUS, LAMPUNG",4,57,85,142
https://kawalpemilu.org#23908,"NEGERI RATU, KOTA AGUNG, TANGGAMUS, LAMPUNG",5,83,135,218
https://kawalpemilu.org#23908,"NEGERI RATU, KOTA AGUNG, TANGGAMUS, LAMPUNG",6,82,125,207
https://kawalpemilu.org#23908,"NEGERI RATU, KOTA AGUNG, TANGGAMUS, LAMPUNG",7,58,130,188
https://kawalpemilu.org#23908,"NEGERI RATU, KOTA AGUNG, TANGGAMUS, LAMPUNG",8,74,57,131
https://kawalpemilu.org#23908,"NEGERI RATU, KOTA AGUNG, TANGGAMUS, LAMPUNG",9,55,79,134
https://kawalpemilu.org#23908,"NEGERI RATU, KOTA AGUNG, TANGGAMUS, LAMPUNG",10,48,78,126
https://kawalpemilu.org#23908,"NEGERI RATU, KOTA AGUNG, TANGGAMUS, LAMPUNG",11,65,112,177
https://kawalpemilu.org#23909,"PENANGGUNGAN, KOTA AGUNG, TANGGAMUS, LAMPUNG",1,31,168,199
https://kawalpemilu.org#23909,"PENANGGUNGAN, KOTA AGUNG, TANGGAMUS, LAMPUNG",2,51,167,218
https://kawalpemilu.org#23909,"PENANGGUNGAN, KOTA AGUNG, TANGGAMUS, LAMPUNG",3,54,148,202
https://kawalpemilu.org#23909,"PENANGGUNGAN, KOTA AGUNG, TANGGAMUS, LAMPUNG",4,41,174,215
https://kawalpemilu.org#23910,"TERDANA, KOTA AGUNG, TANGGAMUS, LAMPUNG",1,15,109,124
https://kawalpemilu.org#23910,"TERDANA, KOTA AGUNG, TANGGAMUS, LAMPUNG",2,50,166,216
https://kawalpemilu.org#23910,"TERDANA, KOTA AGUNG, TANGGAMUS, LAMPUNG",3,27,84,111
https://kawalpemilu.org#23911,"KELUNGU, KOTA AGUNG, TANGGAMUS, LAMPUNG",1,73,142,215
https://kawalpemilu.org#23911,"KELUNGU, KOTA AGUNG, TANGGAMUS, LAMPUNG",2,92,42,134
https://kawalpemilu.org#23911,"KELUNGU, KOTA AGUNG, TANGGAMUS, LAMPUNG",3,83,12,95
https://kawalpemilu.org#23912,"PARDASUKA, KOTA AGUNG, TANGGAMUS, LAMPUNG",1,0,0,0
https://kawalpemilu.org#23912,"PARDASUKA, KOTA AGUNG, TANGGAMUS, LAMPUNG",2,94,134,228
https://kawalpemilu.org#23913,"TERATAS, KOTA AGUNG, TANGGAMUS, LAMPUNG",1,27,120,147
https://kawalpemilu.org#23913,"TERATAS, KOTA AGUNG, TANGGAMUS, LAMPUNG",2,84,136,220
https://kawalpemilu.org#23913,"TERATAS, KOTA AGUNG, TANGGAMUS, LAMPUNG",3,90,157,247
https://kawalpemilu.org#23913,"TERATAS, KOTA AGUNG, TANGGAMUS, LAMPUNG",4,37,31,68
https://kawalpemilu.org#23913,"TERATAS, KOTA AGUNG, TANGGAMUS, LAMPUNG",5,25,95,120
https://kawalpemilu.org#23914,"KUSA, KOTA AGUNG, TANGGAMUS, LAMPUNG",1,38,168,206
https://kawalpemilu.org#23914,"KUSA, KOTA AGUNG, TANGGAMUS, LAMPUNG",2,64,120,184
https://kawalpemilu.org#23914,"KUSA, KOTA AGUNG, TANGGAMUS, LAMPUNG",3,25,114,139
https://kawalpemilu.org#23914,"KUSA, KOTA AGUNG, TANGGAMUS, LAMPUNG",4,44,72,116
https://kawalpemilu.org#23914,"KUSA, KOTA AGUNG, TANGGAMUS, LAMPUNG",5,41,68,109
https://kawalpemilu.org#23914,"KUSA, KOTA AGUNG, TANGGAMUS, LAMPUNG",6,98,102,200
https://kawalpemilu.org#23914,"KUSA, KOTA AGUNG, TANGGAMUS, LAMPUNG",7,110,81,191
https://kawalpemilu.org#23914,"KUSA, KOTA AGUNG, TANGGAMUS, LAMPUNG",8,72,132,204
https://kawalpemilu.org#23914,"KUSA, KOTA AGUNG, TANGGAMUS, LAMPUNG",9,67,71,138
https://kawalpemilu.org#23914,"KUSA, KOTA AGUNG, TANGGAMUS, LAMPUNG",10,61,58,119
https://kawalpemilu.org#23914,"KUSA, KOTA AGUNG, TANGGAMUS, LAMPUNG",11,53,86,139
https://kawalpemilu.org#23914,"KUSA, KOTA AGUNG, TANGGAMUS, LAMPUNG",12,115,41,156
https://kawalpemilu.org#23914,"KUSA, KOTA AGUNG, TANGGAMUS, LAMPUNG",13,58,95,153
https://kawalpemilu.org#23915,"TERBAYA, KOTA AGUNG, TANGGAMUS, LAMPUNG",1,54,156,210
https://kawalpemilu.org#23915,"TERBAYA, KOTA AGUNG, TANGGAMUS, LAMPUNG",2,39,125,164
https://kawalpemilu.org#23915,"TERBAYA, KOTA AGUNG, TANGGAMUS, LAMPUNG",3,39,89,128
https://kawalpemilu.org#23915,"TERBAYA, KOTA AGUNG, TANGGAMUS, LAMPUNG",4,27,118,145
https://kawalpemilu.org#23915,"TERBAYA, KOTA AGUNG, TANGGAMUS, LAMPUNG",5,44,99,143
https://kawalpemilu.org#23915,"TERBAYA, KOTA AGUNG, TANGGAMUS, LAMPUNG",7,29,157,186
https://kawalpemilu.org#23915,"TERBAYA, KOTA AGUNG, TANGGAMUS, LAMPUNG",8,50,97,147
https://kawalpemilu.org#23915,"TERBAYA, KOTA AGUNG, TANGGAMUS, LAMPUNG",9,37,112,143
https://kawalpemilu.org#23915,"TERBAYA, KOTA AGUNG, TANGGAMUS, LAMPUNG",10,108,40,148
https://kawalpemilu.org#23916,"KEDAMAIAN, KOTA AGUNG, TANGGAMUS, LAMPUNG",1,19,151,170
https://kawalpemilu.org#23916,"KEDAMAIAN, KOTA AGUNG, TANGGAMUS, LAMPUNG",2,13,142,155
https://kawalpemilu.org#23916,"KEDAMAIAN, KOTA AGUNG, TANGGAMUS, LAMPUNG",3,31,130,161
https://kawalpemilu.org#23916,"KEDAMAIAN, KOTA AGUNG, TANGGAMUS, LAMPUNG",4,135,65,200
https://kawalpemilu.org#23916,"KEDAMAIAN, KOTA AGUNG, TANGGAMUS, LAMPUNG",5,48,118,166
https://kawalpemilu.org#23916,"KEDAMAIAN, KOTA AGUNG, TANGGAMUS, LAMPUNG",6,90,127,217
https://kawalpemilu.org#23916,"KEDAMAIAN, KOTA AGUNG, TANGGAMUS, LAMPUNG",7,66,144,210
https://kawalpemilu.org#23917,"KOTA AGUNG, KOTA AGUNG, TANGGAMUS, LAMPUNG",1,85,146,231
https://kawalpemilu.org#23917,"KOTA AGUNG, KOTA AGUNG, TANGGAMUS, LAMPUNG",2,38,139,177
https://kawalpemilu.org#23917,"KOTA AGUNG, KOTA AGUNG, TANGGAMUS, LAMPUNG",3,43,112,155
https://kawalpemilu.org#23917,"KOTA AGUNG, KOTA AGUNG, TANGGAMUS, LAMPUNG",4,71,95,166
https://kawalpemilu.org#23917,"KOTA AGUNG, KOTA AGUNG, TANGGAMUS, LAMPUNG",5,118,82,200
https://kawalpemilu.org#23917,"KOTA AGUNG, KOTA AGUNG, TANGGAMUS, LAMPUNG",6,49,145,194
https://kawalpemilu.org#23917,"KOTA AGUNG, KOTA AGUNG, TANGGAMUS, LAMPUNG",7,50,160,210
https://kawalpemilu.org#23917,"KOTA AGUNG, KOTA AGUNG, TANGGAMUS, LAMPUNG",8,53,153,206
https://kawalpemilu.org#23917,"KOTA AGUNG, KOTA AGUNG, TANGGAMUS, LAMPUNG",9,38,133,171
https://kawalpemilu.org#23917,"KOTA AGUNG, KOTA AGUNG, TANGGAMUS, LAMPUNG",10,98,84,182
https://kawalpemilu.org#23918,"KOTA BATU, KOTA AGUNG, TANGGAMUS, LAMPUNG",1,40,143,183
https://kawalpemilu.org#23918,"KOTA BATU, KOTA AGUNG, TANGGAMUS, LAMPUNG",2,109,100,209
https://kawalpemilu.org#23918,"KOTA BATU, KOTA AGUNG, TANGGAMUS, LAMPUNG",3,35,160,195
https://kawalpemilu.org#23918,"KOTA BATU, KOTA AGUNG, TANGGAMUS, LAMPUNG",4,75,131,206
https://kawalpemilu.org#23919,"CAMPANG TIGA, KOTA AGUNG, TANGGAMUS, LAMPUNG",1,100,96,196
https://kawalpemilu.org#23919,"CAMPANG TIGA, KOTA AGUNG, TANGGAMUS, LAMPUNG",2,60,60,120
https://kawalpemilu.org#23919,"CAMPANG TIGA, KOTA AGUNG, TANGGAMUS, LAMPUNG",3,58,75,133
https://kawalpemilu.org#84811,"BENTENG JAYA, KOTA AGUNG, TANGGAMUS, LAMPUNG",1,59,132,191
https://kawalpemilu.org#84811,"BENTENG JAYA, KOTA AGUNG, TANGGAMUS, LAMPUNG",2,47,126,173
https://kawalpemilu.org#84811,"BENTENG JAYA, KOTA AGUNG, TANGGAMUS, LAMPUNG",3,74,91,165
https://kawalpemilu.org#84811,"BENTENG JAYA, KOTA AGUNG, TANGGAMUS, LAMPUNG",4,75,97,172
https://kawalpemilu.org#23921,"KALIBENING, TALANG PADANG, TANGGAMUS, LAMPUNG",1,100,105,205
https://kawalpemilu.org#23921,"KALIBENING, TALANG PADANG, TANGGAMUS, LAMPUNG",2,87,117,204
https://kawalpemilu.org#23921,"KALIBENING, TALANG PADANG, TANGGAMUS, LAMPUNG",3,56,145,201
https://kawalpemilu.org#23921,"KALIBENING, TALANG PADANG, TANGGAMUS, LAMPUNG",4,51,150,201
https://kawalpemilu.org#23921,"KALIBENING, TALANG PADANG, TANGGAMUS, LAMPUNG",5,52,154,206
https://kawalpemilu.org#23921,"KALIBENING, TALANG PADANG, TANGGAMUS, LAMPUNG",6,40,103,143
https://kawalpemilu.org#23921,"KALIBENING, TALANG PADANG, TANGGAMUS, LAMPUNG",7,62,151,213
https://kawalpemilu.org#23921,"KALIBENING, TALANG PADANG, TANGGAMUS, LAMPUNG",8,92,95,187
https://kawalpemilu.org#23921,"KALIBENING, TALANG PADANG, TANGGAMUS, LAMPUNG",9,95,104,199
https://kawalpemilu.org#23921,"KALIBENING, TALANG PADANG, TANGGAMUS, LAMPUNG",10,56,126,182
https://kawalpemilu.org#23921,"KALIBENING, TALANG PADANG, TANGGAMUS, LAMPUNG",11,45,105,150
https://kawalpemilu.org#23922,"KEJAYAAN, TALANG PADANG, TANGGAMUS, LAMPUNG",1,0,0,0
https://kawalpemilu.org#23922,"KEJAYAAN, TALANG PADANG, TANGGAMUS, LAMPUNG",2,41,153,194
https://kawalpemilu.org#23922,"KEJAYAAN, TALANG PADANG, TANGGAMUS, LAMPUNG",3,38,69,107
https://kawalpemilu.org#23922,"KEJAYAAN, TALANG PADANG, TANGGAMUS, LAMPUNG",4,39,123,162
https://kawalpemilu.org#23922,"KEJAYAAN, TALANG PADANG, TANGGAMUS, LAMPUNG",5,20,79,99
https://kawalpemilu.org#23923,"SUKABUMI, TALANG PADANG, TANGGAMUS, LAMPUNG",1,50,152,202
https://kawalpemilu.org#23923,"SUKABUMI, TALANG PADANG, TANGGAMUS, LAMPUNG",2,66,133,199
https://kawalpemilu.org#23923,"SUKABUMI, TALANG PADANG, TANGGAMUS, LAMPUNG",3,93,34,127
https://kawalpemilu.org#23923,"SUKABUMI, TALANG PADANG, TANGGAMUS, LAMPUNG",4,58,50,108
https://kawalpemilu.org#23924,"SUKA NEGERI JAYA, TALANG PADANG, TANGGAMUS, LAMPUNG",1,16,164,180
https://kawalpemilu.org#23924,"SUKA NEGERI JAYA, TALANG PADANG, TANGGAMUS, LAMPUNG",2,38,165,203
https://kawalpemilu.org#23924,"SUKA NEGERI JAYA, TALANG PADANG, TANGGAMUS, LAMPUNG",3,42,88,130
https://kawalpemilu.org#23925,"BANJAR SARI, TALANG PADANG, TANGGAMUS, LAMPUNG",1,33,119,152
https://kawalpemilu.org#23925,"BANJAR SARI, TALANG PADANG, TANGGAMUS, LAMPUNG",2,27,109,136
https://kawalpemilu.org#23925,"BANJAR SARI, TALANG PADANG, TANGGAMUS, LAMPUNG",3,55,66,121
https://kawalpemilu.org#23925,"BANJAR SARI, TALANG PADANG, TANGGAMUS, LAMPUNG",4,21,135,156
https://kawalpemilu.org#23925,"BANJAR SARI, TALANG PADANG, TANGGAMUS, LAMPUNG",5,27,110,137
https://kawalpemilu.org#23925,"BANJAR SARI, TALANG PADANG, TANGGAMUS, LAMPUNG",6,46,90,136
https://kawalpemilu.org#23925,"BANJAR SARI, TALANG PADANG, TANGGAMUS, LAMPUNG",7,29,109,138
https://kawalpemilu.org#23926,"SINGOSARI, TALANG PADANG, TANGGAMUS, LAMPUNG",1,43,105,148
https://kawalpemilu.org#23926,"SINGOSARI, TALANG PADANG, TANGGAMUS, LAMPUNG",2,108,75,183
https://kawalpemilu.org#23926,"SINGOSARI, TALANG PADANG, TANGGAMUS, LAMPUNG",3,80,122,202
https://kawalpemilu.org#23926,"SINGOSARI, TALANG PADANG, TANGGAMUS, LAMPUNG",4,82,76,158
https://kawalpemilu.org#23926,"SINGOSARI, TALANG PADANG, TANGGAMUS, LAMPUNG",5,63,75,138
https://kawalpemilu.org#23926,"SINGOSARI, TALANG PADANG, TANGGAMUS, LAMPUNG",6,76,72,148
https://kawalpemilu.org#23927,"SINAR BANTEN, TALANG PADANG, TANGGAMUS, LAMPUNG",1,23,144,167
https://kawalpemilu.org#23927,"SINAR BANTEN, TALANG PADANG, TANGGAMUS, LAMPUNG",3,28,165,193
https://kawalpemilu.org#23927,"SINAR BANTEN, TALANG PADANG, TANGGAMUS, LAMPUNG",4,66,173,239
https://kawalpemilu.org#23927,"SINAR BANTEN, TALANG PADANG, TANGGAMUS, LAMPUNG",5,38,135,173
https://kawalpemilu.org#23927,"SINAR BANTEN, TALANG PADANG, TANGGAMUS, LAMPUNG",6,46,150,196
https://kawalpemilu.org#23927,"SINAR BANTEN, TALANG PADANG, TANGGAMUS, LAMPUNG",7,31,154,185
https://kawalpemilu.org#23927,"SINAR BANTEN, TALANG PADANG, TANGGAMUS, LAMPUNG",8,66,153,219
https://kawalpemilu.org#23927,"SINAR BANTEN, TALANG PADANG, TANGGAMUS, LAMPUNG",9,61,158,219
https://kawalpemilu.org#23927,"SINAR BANTEN, TALANG PADANG, TANGGAMUS, LAMPUNG",10,29,135,164
https://kawalpemilu.org#23927,"SINAR BANTEN, TALANG PADANG, TANGGAMUS, LAMPUNG",11,31,131,162
https://kawalpemilu.org#23927,"SINAR BANTEN, TALANG PADANG, TANGGAMUS, LAMPUNG",12,62,119,181
https://kawalpemilu.org#23927,"SINAR BANTEN, TALANG PADANG, TANGGAMUS, LAMPUNG",13,41,177,218
https://kawalpemilu.org#23927,"SINAR BANTEN, TALANG PADANG, TANGGAMUS, LAMPUNG",14,74,131,205
https://kawalpemilu.org#23928,"SUKARAME, TALANG PADANG, TANGGAMUS, LAMPUNG",1,95,62,157
https://kawalpemilu.org#23928,"SUKARAME, TALANG PADANG, TANGGAMUS, LAMPUNG",2,67,111,178
https://kawalpemilu.org#23928,"SUKARAME, TALANG PADANG, TANGGAMUS, LAMPUNG",3,39,100,139
https://kawalpemilu.org#23928,"SUKARAME, TALANG PADANG, TANGGAMUS, LAMPUNG",4,68,109,177
https://kawalpemilu.org#23928,"SUKARAME, TALANG PADANG, TANGGAMUS, LAMPUNG",5,63,147,210
https://kawalpemilu.org#23928,"SUKARAME, TALANG PADANG, TANGGAMUS, LAMPUNG",6,46,113,159
https://kawalpemilu.org#23928,"SUKARAME, TALANG PADANG, TANGGAMUS, LAMPUNG",7,65,112,177
https://kawalpemilu.org#23928,"SUKARAME, TALANG PADANG, TANGGAMUS, LAMPUNG",8,45,163,208
https://kawalpemilu.org#23928,"SUKARAME, TALANG PADANG, TANGGAMUS, LAMPUNG",9,49,100,149
https://kawalpemilu.org#23928,"SUKARAME, TALANG PADANG, TANGGAMUS, LAMPUNG",10,124,57,181
https://kawalpemilu.org#23928,"SUKARAME, TALANG PADANG, TANGGAMUS, LAMPUNG",11,49,114,163
https://kawalpemilu.org#23928,"SUKARAME, TALANG PADANG, TANGGAMUS, LAMPUNG",12,52,53,105
https://kawalpemilu.org#23928,"SUKARAME, TALANG PADANG, TANGGAMUS, LAMPUNG",13,50,71,121
https://kawalpemilu.org#23929,"BANDING AGUNG, TALANG PADANG, TANGGAMUS, LAMPUNG",1,42,87,129
https://kawalpemilu.org#23929,"BANDING AGUNG, TALANG PADANG, TANGGAMUS, LAMPUNG",2,47,111,158
https://kawalpemilu.org#23929,"BANDING AGUNG, TALANG PADANG, TANGGAMUS, LAMPUNG",3,43,133,176
https://kawalpemilu.org#23929,"BANDING AGUNG, TALANG PADANG, TANGGAMUS, LAMPUNG",4,35,131,166
https://kawalpemilu.org#23929,"BANDING AGUNG, TALANG PADANG, TANGGAMUS, LAMPUNG",5,53,110,163
https://kawalpemilu.org#23929,"BANDING AGUNG, TALANG PADANG, TANGGAMUS, LAMPUNG",6,44,118,162
https://kawalpemilu.org#23929,"BANDING AGUNG, TALANG PADANG, TANGGAMUS, LAMPUNG",7,33,74,107
https://kawalpemilu.org#23929,"BANDING AGUNG, TALANG PADANG, TANGGAMUS, LAMPUNG",8,65,72,137
https://kawalpemilu.org#23929,"BANDING AGUNG, TALANG PADANG, TANGGAMUS, LAMPUNG",9,51,128,179
https://kawalpemilu.org#23929,"BANDING AGUNG, TALANG PADANG, TANGGAMUS, LAMPUNG",10,68,81,149
https://kawalpemilu.org#23929,"BANDING AGUNG, TALANG PADANG, TANGGAMUS, LAMPUNG",11,32,62,94
https://kawalpemilu.org#23929,"BANDING AGUNG, TALANG PADANG, TANGGAMUS, LAMPUNG",12,36,98,134
https://kawalpemilu.org#23929,"BANDING AGUNG, TALANG PADANG, TANGGAMUS, LAMPUNG",13,40,77,117
https://kawalpemilu.org#23929,"BANDING AGUNG, TALANG PADANG, TANGGAMUS, LAMPUNG",14,47,96,143
https://kawalpemilu.org#23929,"BANDING AGUNG, TALANG PADANG, TANGGAMUS, LAMPUNG",15,45,69,114
https://kawalpemilu.org#23930,"TALANG PADANG, TALANG PADANG, TANGGAMUS, LAMPUNG",1,73,128,201
https://kawalpemilu.org#23930,"TALANG PADANG, TALANG PADANG, TANGGAMUS, LAMPUNG",2,43,110,153
https://kawalpemilu.org#23930,"TALANG PADANG, TALANG PADANG, TANGGAMUS, LAMPUNG",3,47,98,145
https://kawalpemilu.org#23930,"TALANG PADANG, TALANG PADANG, TANGGAMUS, LAMPUNG",4,36,82,118
https://kawalpemilu.org#23930,"TALANG PADANG, TALANG PADANG, TANGGAMUS, LAMPUNG",5,29,125,154
https://kawalpemilu.org#23930,"TALANG PADANG, TALANG PADANG, TANGGAMUS, LAMPUNG",6,25,129,154
https://kawalpemilu.org#23930,"TALANG PADANG, TALANG PADANG, TANGGAMUS, LAMPUNG",7,32,113,145
https://kawalpemilu.org#23930,"TALANG PADANG, TALANG PADANG, TANGGAMUS, LAMPUNG",8,71,161,232
https://kawalpemilu.org#23930,"TALANG PADANG, TALANG PADANG, TANGGAMUS, LAMPUNG",9,94,98,192
https://kawalpemilu.org#23930,"TALANG PADANG, TALANG PADANG, TANGGAMUS, LAMPUNG",10,88,96,184
https://kawalpemilu.org#23930,"TALANG PADANG, TALANG PADANG, TANGGAMUS, LAMPUNG",11,35,86,121
https://kawalpemilu.org#23930,"TALANG PADANG, TALANG PADANG, TANGGAMUS, LAMPUNG",12,36,110,146
https://kawalpemilu.org#23930,"TALANG PADANG, TALANG PADANG, TANGGAMUS, LAMPUNG",13,67,142,209
https://kawalpemilu.org#23930,"TALANG PADANG, TALANG PADANG, TANGGAMUS, LAMPUNG",14,53,89,142
https://kawalpemilu.org#23930,"TALANG PADANG, TALANG PADANG, TANGGAMUS, LAMPUNG",15,59,122,181
https://kawalpemilu.org#23930,"TALANG PADANG, TALANG PADANG, TANGGAMUS, LAMPUNG",16,75,80,155
https://kawalpemilu.org#23930,"TALANG PADANG, TALANG PADANG, TANGGAMUS, LAMPUNG",17,85,95,180
https://kawalpemilu.org#23930,"TALANG PADANG, TALANG PADANG, TANGGAMUS, LAMPUNG",18,53,77,130
https://kawalpemilu.org#23931,"SUKA NEGERI, TALANG PADANG, TANGGAMUS, LAMPUNG",1,32,117,149
https://kawalpemilu.org#23931,"SUKA NEGERI, TALANG PADANG, TANGGAMUS, LAMPUNG",2,22,82,104
https://kawalpemilu.org#23932,"SUKA BANDUNG, TALANG PADANG, TANGGAMUS, LAMPUNG",1,84,135,219
https://kawalpemilu.org#23932,"SUKA BANDUNG, TALANG PADANG, TANGGAMUS, LAMPUNG",2,50,136,186
https://kawalpemilu.org#23932,"SUKA BANDUNG, TALANG PADANG, TANGGAMUS, LAMPUNG",3,95,149,244
https://kawalpemilu.org#23933,"SUKA MERINDU, TALANG PADANG, TANGGAMUS, LAMPUNG",1,75,129,204
https://kawalpemilu.org#23933,"SUKA MERINDU, TALANG PADANG, TANGGAMUS, LAMPUNG",2,88,130,218
https://kawalpemilu.org#23933,"SUKA MERINDU, TALANG PADANG, TANGGAMUS, LAMPUNG",3,65,38,103
https://kawalpemilu.org#23933,"SUKA MERINDU, TALANG PADANG, TANGGAMUS, LAMPUNG",4,87,70,157
https://kawalpemilu.org#23933,"SUKA MERINDU, TALANG PADANG, TANGGAMUS, LAMPUNG",5,30,58,88
https://kawalpemilu.org#23933,"SUKA MERINDU, TALANG PADANG, TANGGAMUS, LAMPUNG",6,115,56,171
https://kawalpemilu.org#23933,"SUKA MERINDU, TALANG PADANG, TANGGAMUS, LAMPUNG",7,52,48,100
https://kawalpemilu.org#23934,"SINAR SEMENDO, TALANG PADANG, TANGGAMUS, LAMPUNG",1,33,97,130
https://kawalpemilu.org#23934,"SINAR SEMENDO, TALANG PADANG, TANGGAMUS, LAMPUNG",2,66,140,206
https://kawalpemilu.org#23934,"SINAR SEMENDO, TALANG PADANG, TANGGAMUS, LAMPUNG",3,71,134,205
https://kawalpemilu.org#23934,"SINAR SEMENDO, TALANG PADANG, TANGGAMUS, LAMPUNG",4,39,98,137
https://kawalpemilu.org#23934,"SINAR SEMENDO, TALANG PADANG, TANGGAMUS, LAMPUNG",5,52,93,145
https://kawalpemilu.org#23934,"SINAR SEMENDO, TALANG PADANG, TANGGAMUS, LAMPUNG",6,52,123,175
https://kawalpemilu.org#23934,"SINAR SEMENDO, TALANG PADANG, TANGGAMUS, LAMPUNG",7,44,55,99
https://kawalpemilu.org#23935,"NEGERI AGUNG, TALANG PADANG, TANGGAMUS, LAMPUNG",1,56,147,203
https://kawalpemilu.org#23935,"NEGERI AGUNG, TALANG PADANG, TANGGAMUS, LAMPUNG",2,46,173,219
https://kawalpemilu.org#23935,"NEGERI AGUNG, TALANG PADANG, TANGGAMUS, LAMPUNG",3,71,186,257
https://kawalpemilu.org#23935,"NEGERI AGUNG, TALANG PADANG, TANGGAMUS, LAMPUNG",4,58,77,135
https://kawalpemilu.org#23935,"NEGERI AGUNG, TALANG PADANG, TANGGAMUS, LAMPUNG",5,81,82,163
https://kawalpemilu.org#23935,"NEGERI AGUNG, TALANG PADANG, TANGGAMUS, LAMPUNG",6,69,100,169
https://kawalpemilu.org#23935,"NEGERI AGUNG, TALANG PADANG, TANGGAMUS, LAMPUNG",7,81,95,176
https://kawalpemilu.org#23935,"NEGERI AGUNG, TALANG PADANG, TANGGAMUS, LAMPUNG",8,95,145,240
https://kawalpemilu.org#23935,"NEGERI AGUNG, TALANG PADANG, TANGGAMUS, LAMPUNG",9,91,81,172
https://kawalpemilu.org#23935,"NEGERI AGUNG, TALANG PADANG, TANGGAMUS, LAMPUNG",10,44,100,144
https://kawalpemilu.org#23935,"NEGERI AGUNG, TALANG PADANG, TANGGAMUS, LAMPUNG",11,64,106,170
https://kawalpemilu.org#23935,"NEGERI AGUNG, TALANG PADANG, TANGGAMUS, LAMPUNG",12,82,103,185
https://kawalpemilu.org#23935,"NEGERI AGUNG, TALANG PADANG, TANGGAMUS, LAMPUNG",13,47,103,150
https://kawalpemilu.org#23935,"NEGERI AGUNG, TALANG PADANG, TANGGAMUS, LAMPUNG",14,18,130,148
https://kawalpemilu.org#23935,"NEGERI AGUNG, TALANG PADANG, TANGGAMUS, LAMPUNG",15,72,125,197
https://kawalpemilu.org#23935,"NEGERI AGUNG, TALANG PADANG, TANGGAMUS, LAMPUNG",16,94,41,135
https://kawalpemilu.org#23935,"NEGERI AGUNG, TALANG PADANG, TANGGAMUS, LAMPUNG",17,59,51,110
https://kawalpemilu.org#23935,"NEGERI AGUNG, TALANG PADANG, TANGGAMUS, LAMPUNG",18,64,103,167
https://kawalpemilu.org#23935,"NEGERI AGUNG, TALANG PADANG, TANGGAMUS, LAMPUNG",19,38,118,156
https://kawalpemilu.org#23935,"NEGERI AGUNG, TALANG PADANG, TANGGAMUS, LAMPUNG",20,27,117,144
https://kawalpemilu.org#23936,"SINAR PETIR, TALANG PADANG, TANGGAMUS, LAMPUNG",1,35,100,135
https://kawalpemilu.org#23936,"SINAR PETIR, TALANG PADANG, TANGGAMUS, LAMPUNG",2,47,100,147
https://kawalpemilu.org#23936,"SINAR PETIR, TALANG PADANG, TANGGAMUS, LAMPUNG",3,69,86,155
https://kawalpemilu.org#23936,"SINAR PETIR, TALANG PADANG, TANGGAMUS, LAMPUNG",4,41,119,160
https://kawalpemilu.org#23936,"SINAR PETIR, TALANG PADANG, TANGGAMUS, LAMPUNG",5,46,94,140
https://kawalpemilu.org#23937,"WAY HALOM, TALANG PADANG, TANGGAMUS, LAMPUNG",1,72,88,160
https://kawalpemilu.org#23937,"WAY HALOM, TALANG PADANG, TANGGAMUS, LAMPUNG",2,87,62,149
https://kawalpemilu.org#23937,"WAY HALOM, TALANG PADANG, TANGGAMUS, LAMPUNG",3,92,86,178
https://kawalpemilu.org#23937,"WAY HALOM, TALANG PADANG, TANGGAMUS, LAMPUNG",4,32,103,135
https://kawalpemilu.org#23937,"WAY HALOM, TALANG PADANG, TANGGAMUS, LAMPUNG",5,65,114,179
https://kawalpemilu.org#23938,"TALANG SEPUH, TALANG PADANG, TANGGAMUS, LAMPUNG",1,116,72,188
https://kawalpemilu.org#23938,"TALANG SEPUH, TALANG PADANG, TANGGAMUS, LAMPUNG",2,88,56,144
https://kawalpemilu.org#23938,"TALANG SEPUH, TALANG PADANG, TANGGAMUS, LAMPUNG",3,59,170,229
https://kawalpemilu.org#23938,"TALANG SEPUH, TALANG PADANG, TANGGAMUS, LAMPUNG",4,56,75,131
https://kawalpemilu.org#23938,"TALANG SEPUH, TALANG PADANG, TANGGAMUS, LAMPUNG",5,47,90,137
https://kawalpemilu.org#23938,"TALANG SEPUH, TALANG PADANG, TANGGAMUS, LAMPUNG",6,62,78,140
https://kawalpemilu.org#23938,"TALANG SEPUH, TALANG PADANG, TANGGAMUS, LAMPUNG",7,38,79,117
https://kawalpemilu.org#23938,"TALANG SEPUH, TALANG PADANG, TANGGAMUS, LAMPUNG",8,37,157,194
https://kawalpemilu.org#23939,"SINAR HARAPAN, TALANG PADANG, TANGGAMUS, LAMPUNG",1,86,122,208
https://kawalpemilu.org#23939,"SINAR HARAPAN, TALANG PADANG, TANGGAMUS, LAMPUNG",2,48,127,175
https://kawalpemilu.org#23939,"SINAR HARAPAN, TALANG PADANG, TANGGAMUS, LAMPUNG",3,64,140,204
https://kawalpemilu.org#23939,"SINAR HARAPAN, TALANG PADANG, TANGGAMUS, LAMPUNG",4,52,71,123
https://kawalpemilu.org#23939,"SINAR HARAPAN, TALANG PADANG, TANGGAMUS, LAMPUNG",5,54,82,136
https://kawalpemilu.org#84812,"SINAR BETUNG, TALANG PADANG, TANGGAMUS, LAMPUNG",1,72,133,205
https://kawalpemilu.org#84812,"SINAR BETUNG, TALANG PADANG, TANGGAMUS, LAMPUNG",2,29,156,185
https://kawalpemilu.org#84812,"SINAR BETUNG, TALANG PADANG, TANGGAMUS, LAMPUNG",3,28,85,113
https://kawalpemilu.org#84812,"SINAR BETUNG, TALANG PADANG, TANGGAMUS, LAMPUNG",4,19,118,137
https://kawalpemilu.org#23941,"KARANG ANYAR, WONOSOBO, TANGGAMUS, LAMPUNG",1,103,32,135
https://kawalpemilu.org#23941,"KARANG ANYAR, WONOSOBO, TANGGAMUS, LAMPUNG",2,121,52,173
https://kawalpemilu.org#23941,"KARANG ANYAR, WONOSOBO, TANGGAMUS, LAMPUNG",3,57,63,120
https://kawalpemilu.org#23941,"KARANG ANYAR, WONOSOBO, TANGGAMUS, LAMPUNG",4,80,92,172
https://kawalpemilu.org#23941,"KARANG ANYAR, WONOSOBO, TANGGAMUS, LAMPUNG",5,70,84,154
https://kawalpemilu.org#23941,"KARANG ANYAR, WONOSOBO, TANGGAMUS, LAMPUNG",6,121,93,214
https://kawalpemilu.org#23942,"KALIREJO, WONOSOBO, TANGGAMUS, LAMPUNG",1,104,84,188
https://kawalpemilu.org#23942,"KALIREJO, WONOSOBO, TANGGAMUS, LAMPUNG",2,84,69,153
https://kawalpemilu.org#23942,"KALIREJO, WONOSOBO, TANGGAMUS, LAMPUNG",3,80,32,112
https://kawalpemilu.org#23942,"KALIREJO, WONOSOBO, TANGGAMUS, LAMPUNG",4,117,45,162
https://kawalpemilu.org#23942,"KALIREJO, WONOSOBO, TANGGAMUS, LAMPUNG",5,144,51,195
https://kawalpemilu.org#23943,"DADIREJO, WONOSOBO, TANGGAMUS, LAMPUNG",1,106,87,193
https://kawalpemilu.org#23943,"DADIREJO, WONOSOBO, TANGGAMUS, LAMPUNG",2,126,70,196
https://kawalpemilu.org#23943,"DADIREJO, WONOSOBO, TANGGAMUS, LAMPUNG",3,82,100,182
https://kawalpemilu.org#23943,"DADIREJO, WONOSOBO, TANGGAMUS, LAMPUNG",4,130,67,197
https://kawalpemilu.org#23944,"BANYU URIP, WONOSOBO, TANGGAMUS, LAMPUNG",1,149,57,206
https://kawalpemilu.org#23944,"BANYU URIP, WONOSOBO, TANGGAMUS, LAMPUNG",2,162,53,215
https://kawalpemilu.org#23944,"BANYU URIP, WONOSOBO, TANGGAMUS, LAMPUNG",3,119,85,204
https://kawalpemilu.org#23945,"WONOSOBO, WONOSOBO, TANGGAMUS, LAMPUNG",1,141,54,195
https://kawalpemilu.org#23945,"WONOSOBO, WONOSOBO, TANGGAMUS, LAMPUNG",2,103,50,153
https://kawalpemilu.org#23945,"WONOSOBO, WONOSOBO, TANGGAMUS, LAMPUNG",3,140,77,217
https://kawalpemilu.org#23945,"WONOSOBO, WONOSOBO, TANGGAMUS, LAMPUNG",4,158,52,210
https://kawalpemilu.org#23946,"SOPONYONO, WONOSOBO, TANGGAMUS, LAMPUNG",1,96,122,218
https://kawalpemilu.org#23946,"SOPONYONO, WONOSOBO, TANGGAMUS, LAMPUNG",2,114,106,220
https://kawalpemilu.org#23946,"SOPONYONO, WONOSOBO, TANGGAMUS, LAMPUNG",3,118,84,202
https://kawalpemilu.org#23946,"SOPONYONO, WONOSOBO, TANGGAMUS, LAMPUNG",4,107,131,238
https://kawalpemilu.org#23946,"SOPONYONO, WONOSOBO, TANGGAMUS, LAMPUNG",5,114,71,185
https://kawalpemilu.org#23946,"SOPONYONO, WONOSOBO, TANGGAMUS, LAMPUNG",6,95,37,132
https://kawalpemilu.org#23947,"BANDAR KEJADIAN, WONOSOBO, TANGGAMUS, LAMPUNG",1,56,115,171
https://kawalpemilu.org#23947,"BANDAR KEJADIAN, WONOSOBO, TANGGAMUS, LAMPUNG",2,31,117,148
https://kawalpemilu.org#23947,"BANDAR KEJADIAN, WONOSOBO, TANGGAMUS, LAMPUNG",3,67,66,133
https://kawalpemilu.org#23947,"BANDAR KEJADIAN, WONOSOBO, TANGGAMUS, LAMPUNG",4,55,89,144
https://kawalpemilu.org#23947,"BANDAR KEJADIAN, WONOSOBO, TANGGAMUS, LAMPUNG",5,37,131,168
https://kawalpemilu.org#23947,"BANDAR KEJADIAN, WONOSOBO, TANGGAMUS, LAMPUNG",6,46,136,182
https://kawalpemilu.org#23948,"WAY PANAS, WONOSOBO, TANGGAMUS, LAMPUNG",1,17,124,141
https://kawalpemilu.org#23948,"WAY PANAS, WONOSOBO, TANGGAMUS, LAMPUNG",2,54,168,222
https://kawalpemilu.org#23948,"WAY PANAS, WONOSOBO, TANGGAMUS, LAMPUNG",3,35,159,194
https://kawalpemilu.org#23948,"WAY PANAS, WONOSOBO, TANGGAMUS, LAMPUNG",4,40,189,229
https://kawalpemilu.org#23948,"WAY PANAS, WONOSOBO, TANGGAMUS, LAMPUNG",5,39,174,213
https://kawalpemilu.org#23948,"WAY PANAS, WONOSOBO, TANGGAMUS, LAMPUNG",6,28,101,129
https://kawalpemilu.org#23949,"SINAR SAUDARA, WONOSOBO, TANGGAMUS, LAMPUNG",1,40,115,155
https://kawalpemilu.org#23949,"SINAR SAUDARA, WONOSOBO, TANGGAMUS, LAMPUNG",2,42,91,133
https://kawalpemilu.org#23949,"SINAR SAUDARA, WONOSOBO, TANGGAMUS, LAMPUNG",3,65,87,152
https://kawalpemilu.org#23949,"SINAR SAUDARA, WONOSOBO, TANGGAMUS, LAMPUNG",4,90,84,174
https://kawalpemilu.org#23949,"SINAR SAUDARA, WONOSOBO, TANGGAMUS, LAMPUNG",5,45,116,161
https://kawalpemilu.org#23950,"SRI DADI, WONOSOBO, TANGGAMUS, LAMPUNG",1,89,90,179
https://kawalpemilu.org#23950,"SRI DADI, WONOSOBO, TANGGAMUS, LAMPUNG",2,84,48,132
https://kawalpemilu.org#23950,"SRI DADI, WONOSOBO, TANGGAMUS, LAMPUNG",3,99,57,156
https://kawalpemilu.org#23950,"SRI DADI, WONOSOBO, TANGGAMUS, LAMPUNG",4,93,73,166
https://kawalpemilu.org#23950,"SRI DADI, WONOSOBO, TANGGAMUS, LAMPUNG",5,121,85,206
https://kawalpemilu.org#23950,"SRI DADI, WONOSOBO, TANGGAMUS, LAMPUNG",6,128,102,230
https://kawalpemilu.org#23951,"LAKARAN, WONOSOBO, TANGGAMUS, LAMPUNG",1,24,98,122
https://kawalpemilu.org#23951,"LAKARAN, WONOSOBO, TANGGAMUS, LAMPUNG",2,91,75,166
https://kawalpemilu.org#23951,"LAKARAN, WONOSOBO, TANGGAMUS, LAMPUNG",3,32,88,120
https://kawalpemilu.org#23952,"PADANG RATU, WONOSOBO, TANGGAMUS, LAMPUNG",1,38,101,139
https://kawalpemilu.org#23952,"PADANG RATU, WONOSOBO, TANGGAMUS, LAMPUNG",2,30,88,118
https://kawalpemilu.org#23952,"PADANG RATU, WONOSOBO, TANGGAMUS, LAMPUNG",3,36,106,142
https://kawalpemilu.org#23952,"PADANG RATU, WONOSOBO, TANGGAMUS, LAMPUNG",4,60,131,191
https://kawalpemilu.org#23952,"PADANG RATU, WONOSOBO, TANGGAMUS, LAMPUNG",5,50,101,151
https://kawalpemilu.org#23952,"PADANG RATU, WONOSOBO, TANGGAMUS, LAMPUNG",6,25,107,132
https://kawalpemilu.org#23953,"PARDASUKA, WONOSOBO, TANGGAMUS, LAMPUNG",1,65,67,132
https://kawalpemilu.org#23953,"PARDASUKA, WONOSOBO, TANGGAMUS, LAMPUNG",2,61,112,173
https://kawalpemilu.org#23953,"PARDASUKA, WONOSOBO, TANGGAMUS, LAMPUNG",3,51,81,132
https://kawalpemilu.org#23954,"TANJUNG KURUNG, WONOSOBO, TANGGAMUS, LAMPUNG",1,27,109,136
https://kawalpemilu.org#23954,"TANJUNG KURUNG, WONOSOBO, TANGGAMUS, LAMPUNG",2,52,78,130
https://kawalpemilu.org#23955,"PADANG MANIS, WONOSOBO, TANGGAMUS, LAMPUNG",1,37,93,130
https://kawalpemilu.org#23955,"PADANG MANIS, WONOSOBO, TANGGAMUS, LAMPUNG",2,68,103,171
https://kawalpemilu.org#23955,"PADANG MANIS, WONOSOBO, TANGGAMUS, LAMPUNG",3,47,40,87
https://kawalpemilu.org#23955,"PADANG MANIS, WONOSOBO, TANGGAMUS, LAMPUNG",4,23,99,122
https://kawalpemilu.org#23956,"KEJADIAN, WONOSOBO, TANGGAMUS, LAMPUNG",1,62,106,168
https://kawalpemilu.org#23956,"KEJADIAN, WONOSOBO, TANGGAMUS, LAMPUNG",2,33,39,72
https://kawalpemilu.org#23956,"KEJADIAN, WONOSOBO, TANGGAMUS, LAMPUNG",3,71,38,109
https://kawalpemilu.org#23957,"DADISARI, WONOSOBO, TANGGAMUS, LAMPUNG",1,99,44,143
https://kawalpemilu.org#23957,"DADISARI, WONOSOBO, TANGGAMUS, LAMPUNG",2,60,36,96
https://kawalpemilu.org#23957,"DADISARI, WONOSOBO, TANGGAMUS, LAMPUNG",3,59,33,92
https://kawalpemilu.org#23957,"DADISARI, WONOSOBO, TANGGAMUS, LAMPUNG",4,104,50,154
https://kawalpemilu.org#23958,"KALISARI, WONOSOBO, TANGGAMUS, LAMPUNG",1,132,62,194
https://kawalpemilu.org#23958,"KALISARI, WONOSOBO, TANGGAMUS, LAMPUNG",2,146,62,208
https://kawalpemilu.org#23958,"KALISARI, WONOSOBO, TANGGAMUS, LAMPUNG",3,99,103,202
https://kawalpemilu.org#23959,"BANJAR NEGORO, WONOSOBO, TANGGAMUS, LAMPUNG",1,128,82,210
https://kawalpemilu.org#23959,"BANJAR NEGORO, WONOSOBO, TANGGAMUS, LAMPUNG",2,126,37,163
https://kawalpemilu.org#23959,"BANJAR NEGORO, WONOSOBO, TANGGAMUS, LAMPUNG",3,107,29,136
https://kawalpemilu.org#23959,"BANJAR NEGORO, WONOSOBO, TANGGAMUS, LAMPUNG",4,135,65,200
https://kawalpemilu.org#23959,"BANJAR NEGORO, WONOSOBO, TANGGAMUS, LAMPUNG",5,102,63,165
https://kawalpemilu.org#23959,"BANJAR NEGORO, WONOSOBO, TANGGAMUS, LAMPUNG",6,112,56,168
https://kawalpemilu.org#23960,"KUNYAYAN, WONOSOBO, TANGGAMUS, LAMPUNG",1,33,66,99
https://kawalpemilu.org#23960,"KUNYAYAN, WONOSOBO, TANGGAMUS, LAMPUNG",2,35,87,122
https://kawalpemilu.org#23960,"KUNYAYAN, WONOSOBO, TANGGAMUS, LAMPUNG",3,26,116,142
https://kawalpemilu.org#23960,"KUNYAYAN, WONOSOBO, TANGGAMUS, LAMPUNG",4,56,139,195
https://kawalpemilu.org#23960,"KUNYAYAN, WONOSOBO, TANGGAMUS, LAMPUNG",5,50,86,136
https://kawalpemilu.org#23961,"PEKON BALAK, WONOSOBO, TANGGAMUS, LAMPUNG",1,92,128,220
https://kawalpemilu.org#23961,"PEKON BALAK, WONOSOBO, TANGGAMUS, LAMPUNG",2,80,77,157
https://kawalpemilu.org#23961,"PEKON BALAK, WONOSOBO, TANGGAMUS, LAMPUNG",3,59,138,197
https://kawalpemilu.org#23961,"PEKON BALAK, WONOSOBO, TANGGAMUS, LAMPUNG",4,96,104,200
https://kawalpemilu.org#23961,"PEKON BALAK, WONOSOBO, TANGGAMUS, LAMPUNG",5,111,91,202
https://kawalpemilu.org#23961,"PEKON BALAK, WONOSOBO, TANGGAMUS, LAMPUNG",6,98,84,182
https://kawalpemilu.org#23961,"PEKON BALAK, WONOSOBO, TANGGAMUS, LAMPUNG",7,103,106,209
https://kawalpemilu.org#23961,"PEKON BALAK, WONOSOBO, TANGGAMUS, LAMPUNG",8,90,55,145
https://kawalpemilu.org#23962,"BANJAR SARI, WONOSOBO, TANGGAMUS, LAMPUNG",1,116,83,199
https://kawalpemilu.org#23962,"BANJAR SARI, WONOSOBO, TANGGAMUS, LAMPUNG",2,155,49,204
https://kawalpemilu.org#23962,"BANJAR SARI, WONOSOBO, TANGGAMUS, LAMPUNG",3,142,45,187
https://kawalpemilu.org#23962,"BANJAR SARI, WONOSOBO, TANGGAMUS, LAMPUNG",4,103,85,188
https://kawalpemilu.org#23962,"BANJAR SARI, WONOSOBO, TANGGAMUS, LAMPUNG",5,129,74,203
https://kawalpemilu.org#23962,"BANJAR SARI, WONOSOBO, TANGGAMUS, LAMPUNG",6,144,55,199
https://kawalpemilu.org#23963,"NEGERI NGARIP, WONOSOBO, TANGGAMUS, LAMPUNG",1,78,115,193
https://kawalpemilu.org#23963,"NEGERI NGARIP, WONOSOBO, TANGGAMUS, LAMPUNG",2,56,96,152
https://kawalpemilu.org#23963,"NEGERI NGARIP, WONOSOBO, TANGGAMUS, LAMPUNG",3,77,76,153
https://kawalpemilu.org#23963,"NEGERI NGARIP, WONOSOBO, TANGGAMUS, LAMPUNG",4,53,85,138
https://kawalpemilu.org#23963,"NEGERI NGARIP, WONOSOBO, TANGGAMUS, LAMPUNG",5,71,116,187
https://kawalpemilu.org#23963,"NEGERI NGARIP, WONOSOBO, TANGGAMUS, LAMPUNG",6,41,105,146
https://kawalpemilu.org#87414,"DADIMULYO, WONOSOBO, TANGGAMUS, LAMPUNG",1,77,78,155
https://kawalpemilu.org#87414,"DADIMULYO, WONOSOBO, TANGGAMUS, LAMPUNG",2,118,65,183
https://kawalpemilu.org#87414,"DADIMULYO, WONOSOBO, TANGGAMUS, LAMPUNG",3,98,86,184
https://kawalpemilu.org#87414,"DADIMULYO, WONOSOBO, TANGGAMUS, LAMPUNG",4,102,49,151
https://kawalpemilu.org#87415,"SAMPANG TURUS, WONOSOBO, TANGGAMUS, LAMPUNG",1,17,185,202
https://kawalpemilu.org#87415,"SAMPANG TURUS, WONOSOBO, TANGGAMUS, LAMPUNG",2,21,134,155
https://kawalpemilu.org#87415,"SAMPANG TURUS, WONOSOBO, TANGGAMUS, LAMPUNG",3,10,104,114
https://kawalpemilu.org#87416,"SRI MELATI, WONOSOBO, TANGGAMUS, LAMPUNG",1,91,106,197
https://kawalpemilu.org#87416,"SRI MELATI, WONOSOBO, TANGGAMUS, LAMPUNG",2,88,132,220
https://kawalpemilu.org#87416,"SRI MELATI, WONOSOBO, TANGGAMUS, LAMPUNG",3,70,81,151
https://kawalpemilu.org#87416,"SRI MELATI, WONOSOBO, TANGGAMUS, LAMPUNG",4,69,112,181
https://kawalpemilu.org#87417,"WAY LIWOK, WONOSOBO, TANGGAMUS, LAMPUNG",1,21,109,130
https://kawalpemilu.org#87417,"WAY LIWOK, WONOSOBO, TANGGAMUS, LAMPUNG",2,54,138,192
https://kawalpemilu.org#87417,"WAY LIWOK, WONOSOBO, TANGGAMUS, LAMPUNG",3,14,60,74
https://kawalpemilu.org#87418,"SUMUR TUJUH, WONOSOBO, TANGGAMUS, LAMPUNG",1,147,35,182
https://kawalpemilu.org#87418,"SUMUR TUJUH, WONOSOBO, TANGGAMUS, LAMPUNG",2,166,52,218
https://kawalpemilu.org#87418,"SUMUR TUJUH, WONOSOBO, TANGGAMUS, LAMPUNG",3,149,23,172
https://kawalpemilu.org#23965,"TALANG BERINGIN, PULAU PANGGUNG, TANGGAMUS, LAMPUNG",1,185,56,241
https://kawalpemilu.org#23965,"TALANG BERINGIN, PULAU PANGGUNG, TANGGAMUS, LAMPUNG",2,99,141,240
https://kawalpemilu.org#23965,"TALANG BERINGIN, PULAU PANGGUNG, TANGGAMUS, LAMPUNG",3,120,129,249
https://kawalpemilu.org#23965,"TALANG BERINGIN, PULAU PANGGUNG, TANGGAMUS, LAMPUNG",4,186,82,268
https://kawalpemilu.org#23966,"GUNUNG MEGANG, PULAU PANGGUNG, TANGGAMUS, LAMPUNG",1,50,191,246
https://kawalpemilu.org#23966,"GUNUNG MEGANG, PULAU PANGGUNG, TANGGAMUS, LAMPUNG",2,51,186,237
https://kawalpemilu.org#23966,"GUNUNG MEGANG, PULAU PANGGUNG, TANGGAMUS, LAMPUNG",3,45,188,233
https://kawalpemilu.org#23966,"GUNUNG MEGANG, PULAU PANGGUNG, TANGGAMUS, LAMPUNG",4,19,142,161
https://kawalpemilu.org#23966,"GUNUNG MEGANG, PULAU PANGGUNG, TANGGAMUS, LAMPUNG",5,41,108,149
https://kawalpemilu.org#23967,"TANJUNG REJO, PULAU PANGGUNG, TANGGAMUS, LAMPUNG",1,118,130,248
https://kawalpemilu.org#23967,"TANJUNG REJO, PULAU PANGGUNG, TANGGAMUS, LAMPUNG",2,99,140,239
https://kawalpemilu.org#23967,"TANJUNG REJO, PULAU PANGGUNG, TANGGAMUS, LAMPUNG",3,169,82,251
https://kawalpemilu.org#23967,"TANJUNG REJO, PULAU PANGGUNG, TANGGAMUS, LAMPUNG",4,118,102,220
https://kawalpemilu.org#23968,"TANJUNG BEGELUNG, PULAU PANGGUNG, TANGGAMUS, LAMPUNG",1,170,53,223
https://kawalpemilu.org#23968,"TANJUNG BEGELUNG, PULAU PANGGUNG, TANGGAMUS, LAMPUNG",2,36,166,202
https://kawalpemilu.org#23968,"TANJUNG BEGELUNG, PULAU PANGGUNG, TANGGAMUS, LAMPUNG",3,22,105,127
https://kawalpemilu.org#23968,"TANJUNG BEGELUNG, PULAU PANGGUNG, TANGGAMUS, LAMPUNG",4,21,138,159
https://kawalpemilu.org#23968,"TANJUNG BEGELUNG, PULAU PANGGUNG, TANGGAMUS, LAMPUNG",5,29,146,175
https://kawalpemilu.org#23968,"TANJUNG BEGELUNG, PULAU PANGGUNG, TANGGAMUS, LAMPUNG",6,37,145,182
https://kawalpemilu.org#23969,"SINAR MULYO, PULAU PANGGUNG, TANGGAMUS, LAMPUNG",1,158,14,172
https://kawalpemilu.org#23969,"SINAR MULYO, PULAU PANGGUNG, TANGGAMUS, LAMPUNG",2,130,45,175
https://kawalpemilu.org#23969,"SINAR MULYO, PULAU PANGGUNG, TANGGAMUS, LAMPUNG",3,133,55,188
https://kawalpemilu.org#23970,"KEMUNING, PULAU PANGGUNG, TANGGAMUS, LAMPUNG",1,190,43,233
https://kawalpemilu.org#23970,"KEMUNING, PULAU PANGGUNG, TANGGAMUS, LAMPUNG",2,194,59,253
https://kawalpemilu.org#23970,"KEMUNING, PULAU PANGGUNG, TANGGAMUS, LAMPUNG",3,131,78,109
https://kawalpemilu.org#23970,"KEMUNING, PULAU PANGGUNG, TANGGAMUS, LAMPUNG",4,58,76,134
https://kawalpemilu.org#23971,"GEDUNG AGUNG, PULAU PANGGUNG, TANGGAMUS, LAMPUNG",1,46,129,175
https://kawalpemilu.org#23971,"GEDUNG AGUNG, PULAU PANGGUNG, TANGGAMUS, LAMPUNG",2,64,103,167
https://kawalpemilu.org#23971,"GEDUNG AGUNG, PULAU PANGGUNG, TANGGAMUS, LAMPUNG",3,155,30,185
https://kawalpemilu.org#23971,"GEDUNG AGUNG, PULAU PANGGUNG, TANGGAMUS, LAMPUNG",4,152,38,190
https://kawalpemilu.org#23971,"GEDUNG AGUNG, PULAU PANGGUNG, TANGGAMUS, LAMPUNG",5,40,97,137
https://kawalpemilu.org#23972,"PENANTIAN, PULAU PANGGUNG, TANGGAMUS, LAMPUNG",1,59,204,263
https://kawalpemilu.org#23972,"PENANTIAN, PULAU PANGGUNG, TANGGAMUS, LAMPUNG",2,38,178,216
https://kawalpemilu.org#23972,"PENANTIAN, PULAU PANGGUNG, TANGGAMUS, LAMPUNG",3,55,176,231
https://kawalpemilu.org#23972,"PENANTIAN, PULAU PANGGUNG, TANGGAMUS, LAMPUNG",4,55,168,223
https://kawalpemilu.org#23972,"PENANTIAN, PULAU PANGGUNG, TANGGAMUS, LAMPUNG",5,56,137,193
https://kawalpemilu.org#23972,"PENANTIAN, PULAU PANGGUNG, TANGGAMUS, LAMPUNG",6,137,73,210
https://kawalpemilu.org#23972,"PENANTIAN, PULAU PANGGUNG, TANGGAMUS, LAMPUNG",7,26,173,199
https://kawalpemilu.org#23973,"MUARA DUA, PULAU PANGGUNG, TANGGAMUS, LAMPUNG",1,71,127,198
https://kawalpemilu.org#23973,"MUARA DUA, PULAU PANGGUNG, TANGGAMUS, LAMPUNG",2,55,144,199
https://kawalpemilu.org#23973,"MUARA DUA, PULAU PANGGUNG, TANGGAMUS, LAMPUNG",3,65,147,212
https://kawalpemilu.org#23973,"MUARA DUA, PULAU PANGGUNG, TANGGAMUS, LAMPUNG",4,47,146,193
https://kawalpemilu.org#23974,"TEKAD, PULAU PANGGUNG, TANGGAMUS, LAMPUNG",1,78,150,228
https://kawalpemilu.org#23974,"TEKAD, PULAU PANGGUNG, TANGGAMUS, LAMPUNG",2,82,122,204
https://kawalpemilu.org#23974,"TEKAD, PULAU PANGGUNG, TANGGAMUS, LAMPUNG",3,93,106,199
https://kawalpemilu.org#23974,"TEKAD, PULAU PANGGUNG, TANGGAMUS, LAMPUNG",4,76,131,207
https://kawalpemilu.org#23974,"TEKAD, PULAU PANGGUNG, TANGGAMUS, LAMPUNG",5,64,165,229
https://kawalpemilu.org#23974,"TEKAD, PULAU PANGGUNG, TANGGAMUS, LAMPUNG",6,43,151,194
https://kawalpemilu.org#23974,"TEKAD, PULAU PANGGUNG, TANGGAMUS, LAMPUNG",7,54,156,210
https://kawalpemilu.org#23974,"TEKAD, PULAU PANGGUNG, TANGGAMUS, LAMPUNG",8,141,81,222
https://kawalpemilu.org#23974,"TEKAD, PULAU PANGGUNG, TANGGAMUS, LAMPUNG",9,157,84,241
https://kawalpemilu.org#23974,"TEKAD, PULAU PANGGUNG, TANGGAMUS, LAMPUNG",10,123,116,239
https://kawalpemilu.org#23974,"TEKAD, PULAU PANGGUNG, TANGGAMUS, LAMPUNG",11,149,85,234
https://kawalpemilu.org#23974,"TEKAD, PULAU PANGGUNG, TANGGAMUS, LAMPUNG",12,118,103,221
https://kawalpemilu.org#23974,"TEKAD, PULAU PANGGUNG, TANGGAMUS, LAMPUNG",13,69,100,169
https://kawalpemilu.org#23974,"TEKAD, PULAU PANGGUNG, TANGGAMUS, LAMPUNG",14,75,139,214
https://kawalpemilu.org#23974,"TEKAD, PULAU PANGGUNG, TANGGAMUS, LAMPUNG",15,67,117,184
https://kawalpemilu.org#23975,"PULAU PANGGUNG, PULAU PANGGUNG, TANGGAMUS, LAMPUNG",1,40,160,200
https://kawalpemilu.org#23975,"PULAU PANGGUNG, PULAU PANGGUNG, TANGGAMUS, LAMPUNG",2,24,132,156
https://kawalpemilu.org#23975,"PULAU PANGGUNG, PULAU PANGGUNG, TANGGAMUS, LAMPUNG",3,54,103,157
https://kawalpemilu.org#23975,"PULAU PANGGUNG, PULAU PANGGUNG, TANGGAMUS, LAMPUNG",4,89,106,195
https://kawalpemilu.org#23975,"PULAU PANGGUNG, PULAU PANGGUNG, TANGGAMUS, LAMPUNG",5,51,163,214
https://kawalpemilu.org#23975,"PULAU PANGGUNG, PULAU PANGGUNG, TANGGAMUS, LAMPUNG",6,51,127,178
https://kawalpemilu.org#23976,"GUNUNG MERAKSA, PULAU PANGGUNG, TANGGAMUS, LAMPUNG",1,24,133,157
https://kawalpemilu.org#23976,"GUNUNG MERAKSA, PULAU PANGGUNG, TANGGAMUS, LAMPUNG",2,14,136,150
https://kawalpemilu.org#23976,"GUNUNG MERAKSA, PULAU PANGGUNG, TANGGAMUS, LAMPUNG",3,21,163,184
https://kawalpemilu.org#23976,"GUNUNG MERAKSA, PULAU PANGGUNG, TANGGAMUS, LAMPUNG",4,43,149,192
https://kawalpemilu.org#23976,"GUNUNG MERAKSA, PULAU PANGGUNG, TANGGAMUS, LAMPUNG",5,18,120,138
https://kawalpemilu.org#23976,"GUNUNG MERAKSA, PULAU PANGGUNG, TANGGAMUS, LAMPUNG",6,17,128,145
https://kawalpemilu.org#23976,"GUNUNG MERAKSA, PULAU PANGGUNG, TANGGAMUS, LAMPUNG",7,14,137,151
https://kawalpemilu.org#23976,"GUNUNG MERAKSA, PULAU PANGGUNG, TANGGAMUS, LAMPUNG",8,12,134,146
https://kawalpemilu.org#23977,"WAY ILAHAN, PULAU PANGGUNG, TANGGAMUS, LAMPUNG",1,127,93,220
https://kawalpemilu.org#23977,"WAY ILAHAN, PULAU PANGGUNG, TANGGAMUS, LAMPUNG",2,141,74,215
https://kawalpemilu.org#23977,"WAY ILAHAN, PULAU PANGGUNG, TANGGAMUS, LAMPUNG",3,101,69,170
https://kawalpemilu.org#23977,"WAY ILAHAN, PULAU PANGGUNG, TANGGAMUS, LAMPUNG",4,74,46,120
https://kawalpemilu.org#23977,"WAY ILAHAN, PULAU PANGGUNG, TANGGAMUS, LAMPUNG",5,131,60,191
https://kawalpemilu.org#23978,"BATU BEDIL, PULAU PANGGUNG, TANGGAMUS, LAMPUNG",1,40,190,230
https://kawalpemilu.org#23978,"BATU BEDIL, PULAU PANGGUNG, TANGGAMUS, LAMPUNG",2,30,152,182
https://kawalpemilu.org#23978,"BATU BEDIL, PULAU PANGGUNG, TANGGAMUS, LAMPUNG",3,54,92,146
https://kawalpemilu.org#23978,"BATU BEDIL, PULAU PANGGUNG, TANGGAMUS, LAMPUNG",4,113,97,210
https://kawalpemilu.org#23978,"BATU BEDIL, PULAU PANGGUNG, TANGGAMUS, LAMPUNG",5,19,77,96
https://kawalpemilu.org#23978,"BATU BEDIL, PULAU PANGGUNG, TANGGAMUS, LAMPUNG",6,59,90,149
https://kawalpemilu.org#23979,"AIR BAKOMAN, PULAU PANGGUNG, TANGGAMUS, LAMPUNG",1,82,109,191
https://kawalpemilu.org#23979,"AIR BAKOMAN, PULAU PANGGUNG, TANGGAMUS, LAMPUNG",2,84,98,182
https://kawalpemilu.org#23979,"AIR BAKOMAN, PULAU PANGGUNG, TANGGAMUS, LAMPUNG",3,136,91,227
https://kawalpemilu.org#23979,"AIR BAKOMAN, PULAU PANGGUNG, TANGGAMUS, LAMPUNG",4,192,40,232
https://kawalpemilu.org#23979,"AIR BAKOMAN, PULAU PANGGUNG, TANGGAMUS, LAMPUNG",5,80,21,101
https://kawalpemilu.org#23979,"AIR BAKOMAN, PULAU PANGGUNG, TANGGAMUS, LAMPUNG",6,111,93,204
https://kawalpemilu.org#23979,"AIR BAKOMAN, PULAU PANGGUNG, TANGGAMUS, LAMPUNG",7,69,125,194
https://kawalpemilu.org#23980,"SUMBER MULYA, PULAU PANGGUNG, TANGGAMUS, LAMPUNG",1,123,92,215
https://kawalpemilu.org#23980,"SUMBER MULYA, PULAU PANGGUNG, TANGGAMUS, LAMPUNG",2,101,73,174
https://kawalpemilu.org#23980,"SUMBER MULYA, PULAU PANGGUNG, TANGGAMUS, LAMPUNG",3,64,23,87
https://kawalpemilu.org#23980,"SUMBER MULYA, PULAU PANGGUNG, TANGGAMUS, LAMPUNG",4,154,28,182
https://kawalpemilu.org#23980,"SUMBER MULYA, PULAU PANGGUNG, TANGGAMUS, LAMPUNG",5,79,97,176
https://kawalpemilu.org#23981,"SINDANG MARGA, PULAU PANGGUNG, TANGGAMUS, LAMPUNG",1,83,86,169
https://kawalpemilu.org#23981,"SINDANG MARGA, PULAU PANGGUNG, TANGGAMUS, LAMPUNG",2,91,112,203
https://kawalpemilu.org#23981,"SINDANG MARGA, PULAU PANGGUNG, TANGGAMUS, LAMPUNG",3,68,91,159
https://kawalpemilu.org#23981,"SINDANG MARGA, PULAU PANGGUNG, TANGGAMUS, LAMPUNG",4,87,105,192
https://kawalpemilu.org#23982,"TALANG JAWA, PULAU PANGGUNG, TANGGAMUS, LAMPUNG",1,34,148,182
https://kawalpemilu.org#23982,"TALANG JAWA, PULAU PANGGUNG, TANGGAMUS, LAMPUNG",2,82,125,207
https://kawalpemilu.org#23982,"TALANG JAWA, PULAU PANGGUNG, TANGGAMUS, LAMPUNG",3,105,2,107
https://kawalpemilu.org#23982,"TALANG JAWA, PULAU PANGGUNG, TANGGAMUS, LAMPUNG",4,46,98,144
https://kawalpemilu.org#84813,"SRIMANGANTEN, PULAU PANGGUNG, TANGGAMUS, LAMPUNG",1,107,145,252
https://kawalpemilu.org#84813,"SRIMANGANTEN, PULAU PANGGUNG, TANGGAMUS, LAMPUNG",2,148,110,258
https://kawalpemilu.org#84813,"SRIMANGANTEN, PULAU PANGGUNG, TANGGAMUS, LAMPUNG",3,170,83,253
https://kawalpemilu.org#84813,"SRIMANGANTEN, PULAU PANGGUNG, TANGGAMUS, LAMPUNG",4,132,118,250
https://kawalpemilu.org#84813,"SRIMANGANTEN, PULAU PANGGUNG, TANGGAMUS, LAMPUNG",5,108,72,180
https://kawalpemilu.org#84814,"SINAR MANCAK, PULAU PANGGUNG, TANGGAMUS, LAMPUNG",1,69,73,142
https://kawalpemilu.org#84814,"SINAR MANCAK, PULAU PANGGUNG, TANGGAMUS, LAMPUNG",2,70,172,242
https://kawalpemilu.org#84814,"SINAR MANCAK, PULAU PANGGUNG, TANGGAMUS, LAMPUNG",3,61,127,188
https://kawalpemilu.org#87419,"TANJUNGGUNUNG, PULAU PANGGUNG, TANGGAMUS, LAMPUNG",1,164,62,226
https://kawalpemilu.org#87419,"TANJUNGGUNUNG, PULAU PANGGUNG, TANGGAMUS, LAMPUNG",2,136,90,226
https://kawalpemilu.org#87419,"TANJUNGGUNUNG, PULAU PANGGUNG, TANGGAMUS, LAMPUNG",3,146,67,213
https://kawalpemilu.org#23984,"KARANG BUAH, CUKUH BALAK, TANGGAMUS, LAMPUNG",1,3,79,82
https://kawalpemilu.org#23984,"KARANG BUAH, CUKUH BALAK, TANGGAMUS, LAMPUNG",2,27,62,89
https://kawalpemilu.org#23984,"KARANG BUAH, CUKUH BALAK, TANGGAMUS, LAMPUNG",3,93,41,134
https://kawalpemilu.org#23985,"SAWANG BALAK, CUKUH BALAK, TANGGAMUS, LAMPUNG",1,49,58,107
https://kawalpemilu.org#23985,"SAWANG BALAK, CUKUH BALAK, TANGGAMUS, LAMPUNG",2,75,81,156
https://kawalpemilu.org#23985,"SAWANG BALAK, CUKUH BALAK, TANGGAMUS, LAMPUNG",3,46,95,141
https://kawalpemilu.org#23986,"WAY RILAU, CUKUH BALAK, TANGGAMUS, LAMPUNG",1,71,78,149
https://kawalpemilu.org#23986,"WAY RILAU, CUKUH BALAK, TANGGAMUS, LAMPUNG",2,35,94,129
https://kawalpemilu.org#23986,"WAY RILAU, CUKUH BALAK, TANGGAMUS, LAMPUNG",3,26,101,127
https://kawalpemilu.org#23986,"WAY RILAU, CUKUH BALAK, TANGGAMUS, LAMPUNG",4,28,89,117
https://kawalpemilu.org#23986,"WAY RILAU, CUKUH BALAK, TANGGAMUS, LAMPUNG",5,17,60,77
https://kawalpemilu.org#23986,"WAY RILAU, CUKUH BALAK, TANGGAMUS, LAMPUNG",6,6,26,32
https://kawalpemilu.org#23987,"TANJUNG RAJA, CUKUH BALAK, TANGGAMUS, LAMPUNG",1,26,108,134
https://kawalpemilu.org#23987,"TANJUNG RAJA, CUKUH BALAK, TANGGAMUS, LAMPUNG",2,12,118,130
https://kawalpemilu.org#23987,"TANJUNG RAJA, CUKUH BALAK, TANGGAMUS, LAMPUNG",3,54,13,67
https://kawalpemilu.org#23987,"TANJUNG RAJA, CUKUH BALAK, TANGGAMUS, LAMPUNG",4,47,10,10
https://kawalpemilu.org#23988,"TENGOR, CUKUH BALAK, TANGGAMUS, LAMPUNG",1,152,52,206
https://kawalpemilu.org#23988,"TENGOR, CUKUH BALAK, TANGGAMUS, LAMPUNG",2,114,49,163
https://kawalpemilu.org#23988,"TENGOR, CUKUH BALAK, TANGGAMUS, LAMPUNG",3,53,20,73
https://kawalpemilu.org#23989,"TANJUNG JATI, CUKUH BALAK, TANGGAMUS, LAMPUNG",1,13,89,102
https://kawalpemilu.org#23989,"TANJUNG JATI, CUKUH BALAK, TANGGAMUS, LAMPUNG",2,21,59,80
https://kawalpemilu.org#23990,"KEJADIAN LOM, CUKUH BALAK, TANGGAMUS, LAMPUNG",1,22,134,156
https://kawalpemilu.org#23990,"KEJADIAN LOM, CUKUH BALAK, TANGGAMUS, LAMPUNG",2,40,128,168
https://kawalpemilu.org#23990,"KEJADIAN LOM, CUKUH BALAK, TANGGAMUS, LAMPUNG",3,47,12,59
https://kawalpemilu.org#23990,"KEJADIAN LOM, CUKUH BALAK, TANGGAMUS, LAMPUNG",4,44,12,56
https://kawalpemilu.org#23991,"SUKARAJA, CUKUH BALAK, TANGGAMUS, LAMPUNG",1,12,68,80
https://kawalpemilu.org#23991,"SUKARAJA, CUKUH BALAK, TANGGAMUS, LAMPUNG",2,45,53,98
https://kawalpemilu.org#23991,"SUKARAJA, CUKUH BALAK, TANGGAMUS, LAMPUNG",3,87,24,111
https://kawalpemilu.org#23992,"BANJAR NEGERI, CUKUH BALAK, TANGGAMUS, LAMPUNG",1,32,159,191
https://kawalpemilu.org#23992,"BANJAR NEGERI, CUKUH BALAK, TANGGAMUS, LAMPUNG",2,147,55,202
https://kawalpemilu.org#23992,"BANJAR NEGERI, CUKUH BALAK, TANGGAMUS, LAMPUNG",3,55,37,92
https://kawalpemilu.org#23992,"BANJAR NEGERI, CUKUH BALAK, TANGGAMUS, LAMPUNG",4,135,32,167
https://kawalpemilu.org#23992,"BANJAR NEGERI, CUKUH BALAK, TANGGAMUS, LAMPUNG",5,109,74,183
https://kawalpemilu.org#23992,"BANJAR NEGERI, CUKUH BALAK, TANGGAMUS, LAMPUNG",6,68,10,78
https://kawalpemilu.org#23993,"GEDUNG, CUKUH BALAK, TANGGAMUS, LAMPUNG",1,20,110,130
https://kawalpemilu.org#23993,"GEDUNG, CUKUH BALAK, TANGGAMUS, LAMPUNG",2,20,87,107
https://kawalpemilu.org#23993,"GEDUNG, CUKUH BALAK, TANGGAMUS, LAMPUNG",3,68,17,85
https://kawalpemilu.org#23994,"SUKAPADANG, CUKUH BALAK, TANGGAMUS, LAMPUNG",1,19,90,109
https://kawalpemilu.org#23994,"SUKAPADANG, CUKUH BALAK, TANGGAMUS, LAMPUNG",2,29,74,103
https://kawalpemilu.org#23994,"SUKAPADANG, CUKUH BALAK, TANGGAMUS, LAMPUNG",3,96,28,124
https://kawalpemilu.org#23994,"SUKAPADANG, CUKUH BALAK, TANGGAMUS, LAMPUNG",4,111,40,151
https://kawalpemilu.org#23995,"KACAMARGA, CUKUH BALAK, TANGGAMUS, LAMPUNG",1,102,57,159
https://kawalpemilu.org#23995,"KACAMARGA, CUKUH BALAK, TANGGAMUS, LAMPUNG",2,139,66,205
https://kawalpemilu.org#23995,"KACAMARGA, CUKUH BALAK, TANGGAMUS, LAMPUNG",3,88,46,134
https://kawalpemilu.org#23995,"KACAMARGA, CUKUH BALAK, TANGGAMUS, LAMPUNG",4,155,42,197
https://kawalpemilu.org#23995,"KACAMARGA, CUKUH BALAK, TANGGAMUS, LAMPUNG",5,123,70,193
https://kawalpemilu.org#23995,"KACAMARGA, CUKUH BALAK, TANGGAMUS, LAMPUNG",6,141,17,158
https://kawalpemilu.org#23995,"KACAMARGA, CUKUH BALAK, TANGGAMUS, LAMPUNG",7,149,23,172
https://kawalpemilu.org#23995,"KACAMARGA, CUKUH BALAK, TANGGAMUS, LAMPUNG",8,127,29,156
https://kawalpemilu.org#23995,"KACAMARGA, CUKUH BALAK, TANGGAMUS, LAMPUNG",9,61,18,79
https://kawalpemilu.org#23996,"PAMPANGAN, CUKUH BALAK, TANGGAMUS, LAMPUNG",1,69,139,208
https://kawalpemilu.org#23996,"PAMPANGAN, CUKUH BALAK, TANGGAMUS, LAMPUNG",2,17,158,175
https://kawalpemilu.org#23996,"PAMPANGAN, CUKUH BALAK, TANGGAMUS, LAMPUNG",3,129,48,177
https://kawalpemilu.org#23997,"BANJAR MANIS, CUKUH BALAK, TANGGAMUS, LAMPUNG",1,56,112,168
https://kawalpemilu.org#23997,"BANJAR MANIS, CUKUH BALAK, TANGGAMUS, LAMPUNG",2,31,156,187
https://kawalpemilu.org#23997,"BANJAR MANIS, CUKUH BALAK, TANGGAMUS, LAMPUNG",3,82,96,178
https://kawalpemilu.org#23997,"BANJAR MANIS, CUKUH BALAK, TANGGAMUS, LAMPUNG",4,72,44,116
https://kawalpemilu.org#23998,"TANJUNG BETUAH, CUKUH BALAK, TANGGAMUS, LAMPUNG",1,27,151,178
https://kawalpemilu.org#23998,"TANJUNG BETUAH, CUKUH BALAK, TANGGAMUS, LAMPUNG",2,32,166,198
https://kawalpemilu.org#23998,"TANJUNG BETUAH, CUKUH BALAK, TANGGAMUS, LAMPUNG",3,54,72,126
https://kawalpemilu.org#23998,"TANJUNG BETUAH, CUKUH BALAK, TANGGAMUS, LAMPUNG",4,45,38,83
https://kawalpemilu.org#23998,"TANJUNG BETUAH, CUKUH BALAK, TANGGAMUS, LAMPUNG",5,31,81,112
https://kawalpemilu.org#23999,"PUTIH DOH, CUKUH BALAK, TANGGAMUS, LAMPUNG",1,72,121,193
https://kawalpemilu.org#23999,"PUTIH DOH, CUKUH BALAK, TANGGAMUS, LAMPUNG",2,100,82,182
https://kawalpemilu.org#23999,"PUTIH DOH, CUKUH BALAK, TANGGAMUS, LAMPUNG",3,64,125,189
https://kawalpemilu.org#23999,"PUTIH DOH, CUKUH BALAK, TANGGAMUS, LAMPUNG",4,50,151,201
https://kawalpemilu.org#23999,"PUTIH DOH, CUKUH BALAK, TANGGAMUS, LAMPUNG",5,47,111,158
https://kawalpemilu.org#23999,"PUTIH DOH, CUKUH BALAK, TANGGAMUS, LAMPUNG",6,38,138,176
https://kawalpemilu.org#23999,"PUTIH DOH, CUKUH BALAK, TANGGAMUS, LAMPUNG",7,30,145,175
https://kawalpemilu.org#23999,"PUTIH DOH, CUKUH BALAK, TANGGAMUS, LAMPUNG",8,53,30,83
https://kawalpemilu.org#23999,"PUTIH DOH, CUKUH BALAK, TANGGAMUS, LAMPUNG",9,59,28,87
https://kawalpemilu.org#24000,"PEKONDOH, CUKUH BALAK, TANGGAMUS, LAMPUNG",1,31,155,186
https://kawalpemilu.org#24000,"PEKONDOH, CUKUH BALAK, TANGGAMUS, LAMPUNG",2,48,103,151
https://kawalpemilu.org#24000,"PEKONDOH, CUKUH BALAK, TANGGAMUS, LAMPUNG",3,27,121,148
https://kawalpemilu.org#24000,"PEKONDOH, CUKUH BALAK, TANGGAMUS, LAMPUNG",4,101,88,189
https://kawalpemilu.org#24000,"PEKONDOH, CUKUH BALAK, TANGGAMUS, LAMPUNG",5,83,52,135
https://kawalpemilu.org#24000,"PEKONDOH, CUKUH BALAK, TANGGAMUS, LAMPUNG",6,89,35,124
https://kawalpemilu.org#24000,"PEKONDOH, CUKUH BALAK, TANGGAMUS, LAMPUNG",7,41,89,130
https://kawalpemilu.org#24001,"KUBULANGKA, CUKUH BALAK, TANGGAMUS, LAMPUNG",1,133,58,191
https://kawalpemilu.org#24001,"KUBULANGKA, CUKUH BALAK, TANGGAMUS, LAMPUNG",2,105,74,179
https://kawalpemilu.org#24001,"KUBULANGKA, CUKUH BALAK, TANGGAMUS, LAMPUNG",3,65,30,95
https://kawalpemilu.org#24001,"KUBULANGKA, CUKUH BALAK, TANGGAMUS, LAMPUNG",4,157,51,208
https://kawalpemilu.org#24001,"KUBULANGKA, CUKUH BALAK, TANGGAMUS, LAMPUNG",5,52,27,79
https://kawalpemilu.org#84815,"KUTA KAKHANG, CUKUH BALAK, TANGGAMUS, LAMPUNG",1,47,99,146
https://kawalpemilu.org#84815,"KUTA KAKHANG, CUKUH BALAK, TANGGAMUS, LAMPUNG",2,30,91,121
https://kawalpemilu.org#91309,"SUKABANJAR, CUKUH BALAK, TANGGAMUS, LAMPUNG",1,61,73,134
https://kawalpemilu.org#91309,"SUKABANJAR, CUKUH BALAK, TANGGAMUS, LAMPUNG",2,62,55,117
https://kawalpemilu.org#24003,"RANTAU TIJANG, PUGUNG, TANGGAMUS, LAMPUNG",1,67,101,168
https://kawalpemilu.org#24003,"RANTAU TIJANG, PUGUNG, TANGGAMUS, LAMPUNG",2,60,145,205
https://kawalpemilu.org#24003,"RANTAU TIJANG, PUGUNG, TANGGAMUS, LAMPUNG",3,45,158,203
https://kawalpemilu.org#24003,"RANTAU TIJANG, PUGUNG, TANGGAMUS, LAMPUNG",4,53,112,165
https://kawalpemilu.org#24003,"RANTAU TIJANG, PUGUNG, TANGGAMUS, LAMPUNG",5,76,155,231
https://kawalpemilu.org#24003,"RANTAU TIJANG, PUGUNG, TANGGAMUS, LAMPUNG",6,44,144,188
https://kawalpemilu.org#24003,"RANTAU TIJANG, PUGUNG, TANGGAMUS, LAMPUNG",7,42,135,177
https://kawalpemilu.org#24003,"RANTAU TIJANG, PUGUNG, TANGGAMUS, LAMPUNG",8,59,110,169
https://kawalpemilu.org#24003,"RANTAU TIJANG, PUGUNG, TANGGAMUS, LAMPUNG",9,98,88,186
https://kawalpemilu.org#24003,"RANTAU TIJANG, PUGUNG, TANGGAMUS, LAMPUNG",10,184,43,227
https://kawalpemilu.org#24004,"TIUH MEMON, PUGUNG, TANGGAMUS, LAMPUNG",1,41,153,194
https://kawalpemilu.org#24004,"TIUH MEMON, PUGUNG, TANGGAMUS, LAMPUNG",2,25,110,135
https://kawalpemilu.org#24004,"TIUH MEMON, PUGUNG, TANGGAMUS, LAMPUNG",3,56,97,153
https://kawalpemilu.org#24004,"TIUH MEMON, PUGUNG, TANGGAMUS, LAMPUNG",4,127,86,213
https://kawalpemilu.org#24004,"TIUH MEMON, PUGUNG, TANGGAMUS, LAMPUNG",5,98,73,171
https://kawalpemilu.org#24004,"TIUH MEMON, PUGUNG, TANGGAMUS, LAMPUNG",6,59,138,197
https://kawalpemilu.org#24004,"TIUH MEMON, PUGUNG, TANGGAMUS, LAMPUNG",7,45,124,169
https://kawalpemilu.org#24004,"TIUH MEMON, PUGUNG, TANGGAMUS, LAMPUNG",8,29,116,145
https://kawalpemilu.org#24004,"TIUH MEMON, PUGUNG, TANGGAMUS, LAMPUNG",9,30,159,189
https://kawalpemilu.org#24004,"TIUH MEMON, PUGUNG, TANGGAMUS, LAMPUNG",10,33,175,208
https://kawalpemilu.org#24004,"TIUH MEMON, PUGUNG, TANGGAMUS, LAMPUNG",11,15,110,125
https://kawalpemilu.org#24004,"TIUH MEMON, PUGUNG, TANGGAMUS, LAMPUNG",12,58,82,140
https://kawalpemilu.org#24004,"TIUH MEMON, PUGUNG, TANGGAMUS, LAMPUNG",13,90,72,162
https://kawalpemilu.org#24004,"TIUH MEMON, PUGUNG, TANGGAMUS, LAMPUNG",14,32,57,89
https://kawalpemilu.org#24004,"TIUH MEMON, PUGUNG, TANGGAMUS, LAMPUNG",15,16,99,115
https://kawalpemilu.org#24005,"BANJAR AGUNG UDIK, PUGUNG, TANGGAMUS, LAMPUNG",1,41,188,229
https://kawalpemilu.org#24005,"BANJAR AGUNG UDIK, PUGUNG, TANGGAMUS, LAMPUNG",2,44,178,222
https://kawalpemilu.org#24005,"BANJAR AGUNG UDIK, PUGUNG, TANGGAMUS, LAMPUNG",3,57,126,183
https://kawalpemilu.org#24005,"BANJAR AGUNG UDIK, PUGUNG, TANGGAMUS, LAMPUNG",4,111,141,252
https://kawalpemilu.org#24005,"BANJAR AGUNG UDIK, PUGUNG, TANGGAMUS, LAMPUNG",5,108,60,168
https://kawalpemilu.org#24005,"BANJAR AGUNG UDIK, PUGUNG, TANGGAMUS, LAMPUNG",6,98,107,205
https://kawalpemilu.org#24005,"BANJAR AGUNG UDIK, PUGUNG, TANGGAMUS, LAMPUNG",7,127,127,254
https://kawalpemilu.org#24005,"BANJAR AGUNG UDIK, PUGUNG, TANGGAMUS, LAMPUNG",8,157,61,218
https://kawalpemilu.org#24005,"BANJAR AGUNG UDIK, PUGUNG, TANGGAMUS, LAMPUNG",9,51,114,165
https://kawalpemilu.org#24006,"TANJUNG HERAN, PUGUNG, TANGGAMUS, LAMPUNG",1,31,189,220
https://kawalpemilu.org#24006,"TANJUNG HERAN, PUGUNG, TANGGAMUS, LAMPUNG",2,23,156,179
https://kawalpemilu.org#24006,"TANJUNG HERAN, PUGUNG, TANGGAMUS, LAMPUNG",3,88,62,150
https://kawalpemilu.org#24006,"TANJUNG HERAN, PUGUNG, TANGGAMUS, LAMPUNG",4,120,41,161
https://kawalpemilu.org#24006,"TANJUNG HERAN, PUGUNG, TANGGAMUS, LAMPUNG",5,43,152,195
https://kawalpemilu.org#24006,"TANJUNG HERAN, PUGUNG, TANGGAMUS, LAMPUNG",6,113,116,229
https://kawalpemilu.org#24006,"TANJUNG HERAN, PUGUNG, TANGGAMUS, LAMPUNG",7,48,185,233
https://kawalpemilu.org#24006,"TANJUNG HERAN, PUGUNG, TANGGAMUS, LAMPUNG",8,92,94,186
https://kawalpemilu.org#24006,"TANJUNG HERAN, PUGUNG, TANGGAMUS, LAMPUNG",9,44,143,187
https://kawalpemilu.org#24006,"TANJUNG HERAN, PUGUNG, TANGGAMUS, LAMPUNG",10,37,183,220
https://kawalpemilu.org#24006,"TANJUNG HERAN, PUGUNG, TANGGAMUS, LAMPUNG",11,17,55,72
https://kawalpemilu.org#24006,"TANJUNG HERAN, PUGUNG, TANGGAMUS, LAMPUNG",12,68,92,160
https://kawalpemilu.org#24006,"TANJUNG HERAN, PUGUNG, TANGGAMUS, LAMPUNG",13,30,140,170
https://kawalpemilu.org#24007,"SUMANDA, PUGUNG, TANGGAMUS, LAMPUNG",1,36,159,195
https://kawalpemilu.org#24007,"SUMANDA, PUGUNG, TANGGAMUS, LAMPUNG",2,65,130,195
https://kawalpemilu.org#24007,"SUMANDA, PUGUNG, TANGGAMUS, LAMPUNG",3,49,166,215
https://kawalpemilu.org#24007,"SUMANDA, PUGUNG, TANGGAMUS, LAMPUNG",4,34,88,122
https://kawalpemilu.org#24007,"SUMANDA, PUGUNG, TANGGAMUS, LAMPUNG",5,99,105,204
https://kawalpemilu.org#24007,"SUMANDA, PUGUNG, TANGGAMUS, LAMPUNG",6,63,86,149
https://kawalpemilu.org#24007,"SUMANDA, PUGUNG, TANGGAMUS, LAMPUNG",7,30,127,157
https://kawalpemilu.org#24007,"SUMANDA, PUGUNG, TANGGAMUS, LAMPUNG",8,31,77,108
https://kawalpemilu.org#24008,"CAMPANG WAY HANDAK, PUGUNG, TANGGAMUS, LAMPUNG",1,76,100,176
https://kawalpemilu.org#24008,"CAMPANG WAY HANDAK, PUGUNG, TANGGAMUS, LAMPUNG",2,79,166,245
https://kawalpemilu.org#24008,"CAMPANG WAY HANDAK, PUGUNG, TANGGAMUS, LAMPUNG",3,154,60,214
https://kawalpemilu.org#24008,"CAMPANG WAY HANDAK, PUGUNG, TANGGAMUS, LAMPUNG",4,143,42,185
https://kawalpemilu.org#24008,"CAMPANG WAY HANDAK, PUGUNG, TANGGAMUS, LAMPUNG",5,55,93,148
https://kawalpemilu.org#24008,"CAMPANG WAY HANDAK, PUGUNG, TANGGAMUS, LAMPUNG",6,80,51,131
https://kawalpemilu.org#24009,"TAMAN SARI, PUGUNG, TANGGAMUS, LAMPUNG",1,141,70,211
https://kawalpemilu.org#24009,"TAMAN SARI, PUGUNG, TANGGAMUS, LAMPUNG",2,83,88,171
https://kawalpemilu.org#24009,"TAMAN SARI, PUGUNG, TANGGAMUS, LAMPUNG",3,63,133,196
https://kawalpemilu.org#24009,"TAMAN SARI, PUGUNG, TANGGAMUS, LAMPUNG",4,111,125,236
https://kawalpemilu.org#24009,"TAMAN SARI, PUGUNG, TANGGAMUS, LAMPUNG",5,194,59,253
https://kawalpemilu.org#24009,"TAMAN SARI, PUGUNG, TANGGAMUS, LAMPUNG",6,156,81,237
https://kawalpemilu.org#24009,"TAMAN SARI, PUGUNG, TANGGAMUS, LAMPUNG",7,130,107,237
https://kawalpemilu.org#24009,"TAMAN SARI, PUGUNG, TANGGAMUS, LAMPUNG",9,100,37,137
https://kawalpemilu.org#24009,"TAMAN SARI, PUGUNG, TANGGAMUS, LAMPUNG",10,127,134,261
https://kawalpemilu.org#24010,"SUKAJADI, PUGUNG, TANGGAMUS, LAMPUNG",1,11,166,177
https://kawalpemilu.org#24010,"SUKAJADI, PUGUNG, TANGGAMUS, LAMPUNG",2,33,120,153
https://kawalpemilu.org#24011,"BINJAI WANGI, PUGUNG, TANGGAMUS, LAMPUNG",1,43,109,152
https://kawalpemilu.org#24011,"BINJAI WANGI, PUGUNG, TANGGAMUS, LAMPUNG",2,28,93,121
https://kawalpemilu.org#24012,"TANJUNG KEMALA, PUGUNG, TANGGAMUS, LAMPUNG",1,41,121,162
https://kawalpemilu.org#24012,"TANJUNG KEMALA, PUGUNG, TANGGAMUS, LAMPUNG",2,56,126,182
https://kawalpemilu.org#24012,"TANJUNG KEMALA, PUGUNG, TANGGAMUS, LAMPUNG",3,44,100,144
https://kawalpemilu.org#24012,"TANJUNG KEMALA, PUGUNG, TANGGAMUS, LAMPUNG",4,61,130,191
https://kawalpemilu.org#24012,"TANJUNG KEMALA, PUGUNG, TANGGAMUS, LAMPUNG",5,34,146,180
https://kawalpemilu.org#24012,"TANJUNG KEMALA, PUGUNG, TANGGAMUS, LAMPUNG",6,81,114,195
https://kawalpemilu.org#24012,"TANJUNG KEMALA, PUGUNG, TANGGAMUS, LAMPUNG",7,89,56,145
https://kawalpemilu.org#24012,"TANJUNG KEMALA, PUGUNG, TANGGAMUS, LAMPUNG",8,82,115,197
https://kawalpemilu.org#24012,"TANJUNG KEMALA, PUGUNG, TANGGAMUS, LAMPUNG",9,115,113,228
https://kawalpemilu.org#24012,"TANJUNG KEMALA, PUGUNG, TANGGAMUS, LAMPUNG",10,189,51,240
https://kawalpemilu.org#24012,"TANJUNG KEMALA, PUGUNG, TANGGAMUS, LAMPUNG",11,96,57,153
https://kawalpemilu.org#24013,"TANJUNG AGUNG, PUGUNG, TANGGAMUS, LAMPUNG",1,12,177,189
https://kawalpemilu.org#24013,"TANJUNG AGUNG, PUGUNG, TANGGAMUS, LAMPUNG",2,82,105,187
https://kawalpemilu.org#24013,"TANJUNG AGUNG, PUGUNG, TANGGAMUS, LAMPUNG",4,63,53,116
https://kawalpemilu.org#24013,"TANJUNG AGUNG, PUGUNG, TANGGAMUS, LAMPUNG",5,23,146,169
https://kawalpemilu.org#24013,"TANJUNG AGUNG, PUGUNG, TANGGAMUS, LAMPUNG",7,89,124,4
https://kawalpemilu.org#24013,"TANJUNG AGUNG, PUGUNG, TANGGAMUS, LAMPUNG",8,89,124,213
https://kawalpemilu.org#24013,"TANJUNG AGUNG, PUGUNG, TANGGAMUS, LAMPUNG",9,80,80,160
https://kawalpemilu.org#24013,"TANJUNG AGUNG, PUGUNG, TANGGAMUS, LAMPUNG",10,33,95,128
https://kawalpemilu.org#24013,"TANJUNG AGUNG, PUGUNG, TANGGAMUS, LAMPUNG",11,69,96,165
https://kawalpemilu.org#24013,"TANJUNG AGUNG, PUGUNG, TANGGAMUS, LAMPUNG",12,64,50,114
https://kawalpemilu.org#24013,"TANJUNG AGUNG, PUGUNG, TANGGAMUS, LAMPUNG",13,67,59,126
https://kawalpemilu.org#24014,"BABAKAN, PUGUNG, TANGGAMUS, LAMPUNG",1,22,167,189
https://kawalpemilu.org#24014,"BABAKAN, PUGUNG, TANGGAMUS, LAMPUNG",2,30,142,172
https://kawalpemilu.org#24014,"BABAKAN, PUGUNG, TANGGAMUS, LAMPUNG",3,89,81,170
https://kawalpemilu.org#24014,"BABAKAN, PUGUNG, TANGGAMUS, LAMPUNG",4,23,113,136
https://kawalpemilu.org#24015,"NEGERI RATU, PUGUNG, TANGGAMUS, LAMPUNG",1,39,101,140
https://kawalpemilu.org#24016,"SINAR AGUNG, PUGUNG, TANGGAMUS, LAMPUNG",1,47,133,180
https://kawalpemilu.org#24017,"TANGKIT SERDANG, PUGUNG, TANGGAMUS, LAMPUNG",1,85,118,203
https://kawalpemilu.org#24017,"TANGKIT SERDANG, PUGUNG, TANGGAMUS, LAMPUNG",2,84,92,176
https://kawalpemilu.org#24017,"TANGKIT SERDANG, PUGUNG, TANGGAMUS, LAMPUNG",3,66,77,143
https://kawalpemilu.org#24017,"TANGKIT SERDANG, PUGUNG, TANGGAMUS, LAMPUNG",4,67,48,115
https://kawalpemilu.org#24017,"TANGKIT SERDANG, PUGUNG, TANGGAMUS, LAMPUNG",5,45,88,133
https://kawalpemilu.org#24017,"TANGKIT SERDANG, PUGUNG, TANGGAMUS, LAMPUNG",6,87,65,152
https://kawalpemilu.org#24017,"TANGKIT SERDANG, PUGUNG, TANGGAMUS, LAMPUNG",7,102,118,220
https://kawalpemilu.org#24017,"TANGKIT SERDANG, PUGUNG, TANGGAMUS, LAMPUNG",8,34,115,149
https://kawalpemilu.org#24017,"TANGKIT SERDANG, PUGUNG, TANGGAMUS, LAMPUNG",9,68,50,118
https://kawalpemilu.org#24017,"TANGKIT SERDANG, PUGUNG, TANGGAMUS, LAMPUNG",10,24,110,134
https://kawalpemilu.org#24017,"TANGKIT SERDANG, PUGUNG, TANGGAMUS, LAMPUNG",11,88,70,158
https://kawalpemilu.org#24017,"TANGKIT SERDANG, PUGUNG, TANGGAMUS, LAMPUNG",12,52,111,163
https://kawalpemilu.org#24017,"TANGKIT SERDANG, PUGUNG, TANGGAMUS, LAMPUNG",13,70,103,173
https://kawalpemilu.org#24018,"GUNUNG KASIH, PUGUNG, TANGGAMUS, LAMPUNG",1,17,98,115
https://kawalpemilu.org#24018,"GUNUNG KASIH, PUGUNG, TANGGAMUS, LAMPUNG",2,26,133,159
https://kawalpemilu.org#24018,"GUNUNG KASIH, PUGUNG, TANGGAMUS, LAMPUNG",3,56,62,118
https://kawalpemilu.org#24018,"GUNUNG KASIH, PUGUNG, TANGGAMUS, LAMPUNG",4,44,39,83
https://kawalpemilu.org#24018,"GUNUNG KASIH, PUGUNG, TANGGAMUS, LAMPUNG",5,55,32,87
https://kawalpemilu.org#24018,"GUNUNG KASIH, PUGUNG, TANGGAMUS, LAMPUNG",6,49,87,136
https://kawalpemilu.org#24018,"GUNUNG KASIH, PUGUNG, TANGGAMUS, LAMPUNG",7,53,67,120
https://kawalpemilu.org#24019,"WAY JAHA, PUGUNG, TANGGAMUS, LAMPUNG",1,56,129,185
https://kawalpemilu.org#24019,"WAY JAHA, PUGUNG, TANGGAMUS, LAMPUNG",2,84,105,189
https://kawalpemilu.org#24019,"WAY JAHA, PUGUNG, TANGGAMUS, LAMPUNG",3,70,98,168
https://kawalpemilu.org#24019,"WAY JAHA, PUGUNG, TANGGAMUS, LAMPUNG",4,73,89,162
https://kawalpemilu.org#24019,"WAY JAHA, PUGUNG, TANGGAMUS, LAMPUNG",5,72,108,180
https://kawalpemilu.org#24019,"WAY JAHA, PUGUNG, TANGGAMUS, LAMPUNG",6,119,77,196
https://kawalpemilu.org#24019,"WAY JAHA, PUGUNG, TANGGAMUS, LAMPUNG",7,92,148,240
https://kawalpemilu.org#24020,"BANJAR AGUNG ILIR, PUGUNG, TANGGAMUS, LAMPUNG",1,55,132,187
https://kawalpemilu.org#24020,"BANJAR AGUNG ILIR, PUGUNG, TANGGAMUS, LAMPUNG",2,31,174,205
https://kawalpemilu.org#24020,"BANJAR AGUNG ILIR, PUGUNG, TANGGAMUS, LAMPUNG",3,120,82,202
https://kawalpemilu.org#24020,"BANJAR AGUNG ILIR, PUGUNG, TANGGAMUS, LAMPUNG",4,44,120,164
https://kawalpemilu.org#24020,"BANJAR AGUNG ILIR, PUGUNG, TANGGAMUS, LAMPUNG",5,107,72,179
https://kawalpemilu.org#24021,"GADING, PUGUNG, TANGGAMUS, LAMPUNG",1,164,36,2
https://kawalpemilu.org#24021,"GADING, PUGUNG, TANGGAMUS, LAMPUNG",2,105,83,188
https://kawalpemilu.org#24021,"GADING, PUGUNG, TANGGAMUS, LAMPUNG",3,101,97,198
https://kawalpemilu.org#24021,"GADING, PUGUNG, TANGGAMUS, LAMPUNG",4,56,134,190
https://kawalpemilu.org#24021,"GADING, PUGUNG, TANGGAMUS, LAMPUNG",5,60,59,119
https://kawalpemilu.org#24022,"WAY PRING, PUGUNG, TANGGAMUS, LAMPUNG",1,118,78,196
https://kawalpemilu.org#24022,"WAY PRING, PUGUNG, TANGGAMUS, LAMPUNG",2,111,55,166
https://kawalpemilu.org#24022,"WAY PRING, PUGUNG, TANGGAMUS, LAMPUNG",3,121,76,197
https://kawalpemilu.org#24022,"WAY PRING, PUGUNG, TANGGAMUS, LAMPUNG",4,122,101,223
https://kawalpemilu.org#24022,"WAY PRING, PUGUNG, TANGGAMUS, LAMPUNG",5,48,71,119
https://kawalpemilu.org#24022,"WAY PRING, PUGUNG, TANGGAMUS, LAMPUNG",6,83,59,142
https://kawalpemilu.org#24023,"PUNGKUT, PUGUNG, TANGGAMUS, LAMPUNG",1,37,175,212
https://kawalpemilu.org#24023,"PUNGKUT, PUGUNG, TANGGAMUS, LAMPUNG",2,45,146,191
https://kawalpemilu.org#24023,"PUNGKUT, PUGUNG, TANGGAMUS, LAMPUNG",3,54,137,191
https://kawalpemilu.org#24023,"PUNGKUT, PUGUNG, TANGGAMUS, LAMPUNG",4,78,117,195
https://kawalpemilu.org#24023,"PUNGKUT, PUGUNG, TANGGAMUS, LAMPUNG",5,112,85,197
https://kawalpemilu.org#24023,"PUNGKUT, PUGUNG, TANGGAMUS, LAMPUNG",6,69,156,225
https://kawalpemilu.org#24024,"GUNUNG TIGA, PUGUNG, TANGGAMUS, LAMPUNG",1,24,151,175
https://kawalpemilu.org#24024,"GUNUNG TIGA, PUGUNG, TANGGAMUS, LAMPUNG",2,29,90,119
https://kawalpemilu.org#24024,"GUNUNG TIGA, PUGUNG, TANGGAMUS, LAMPUNG",3,22,135,157
https://kawalpemilu.org#24025,"WAY MANAK, PUGUNG, TANGGAMUS, LAMPUNG",1,81,91,172
https://kawalpemilu.org#24025,"WAY MANAK, PUGUNG, TANGGAMUS, LAMPUNG",2,120,71,191
https://kawalpemilu.org#24025,"WAY MANAK, PUGUNG, TANGGAMUS, LAMPUNG",3,92,88,180
https://kawalpemilu.org#24025,"WAY MANAK, PUGUNG, TANGGAMUS, LAMPUNG",4,128,51,179
https://kawalpemilu.org#24025,"WAY MANAK, PUGUNG, TANGGAMUS, LAMPUNG",5,73,87,160
https://kawalpemilu.org#24025,"WAY MANAK, PUGUNG, TANGGAMUS, LAMPUNG",6,107,73,180
https://kawalpemilu.org#24025,"WAY MANAK, PUGUNG, TANGGAMUS, LAMPUNG",7,142,75,217
https://kawalpemilu.org#24026,"SUKA MAJU, PUGUNG, TANGGAMUS, LAMPUNG",1,63,124,187
https://kawalpemilu.org#24026,"SUKA MAJU, PUGUNG, TANGGAMUS, LAMPUNG",2,63,137,200
https://kawalpemilu.org#24026,"SUKA MAJU, PUGUNG, TANGGAMUS, LAMPUNG",3,114,86,200
https://kawalpemilu.org#24026,"SUKA MAJU, PUGUNG, TANGGAMUS, LAMPUNG",4,41,93,134
https://kawalpemilu.org#24026,"SUKA MAJU, PUGUNG, TANGGAMUS, LAMPUNG",5,49,144,193
https://kawalpemilu.org#24026,"SUKA MAJU, PUGUNG, TANGGAMUS, LAMPUNG",6,91,35,126
https://kawalpemilu.org#24027,"SUKA MULYA, PUGUNG, TANGGAMUS, LAMPUNG",1,20,154,174
https://kawalpemilu.org#24027,"SUKA MULYA, PUGUNG, TANGGAMUS, LAMPUNG",2,21,148,169
https://kawalpemilu.org#24027,"SUKA MULYA, PUGUNG, TANGGAMUS, LAMPUNG",3,54,138,192
https://kawalpemilu.org#24027,"SUKA MULYA, PUGUNG, TANGGAMUS, LAMPUNG",4,47,115,162
https://kawalpemilu.org#24027,"SUKA MULYA, PUGUNG, TANGGAMUS, LAMPUNG",5,57,139,196
https://kawalpemilu.org#24027,"SUKA MULYA, PUGUNG, TANGGAMUS, LAMPUNG",6,50,120,170
https://kawalpemilu.org#24028,"KAYUHUBI, PUGUNG, TANGGAMUS, LAMPUNG",1,70,122,192
https://kawalpemilu.org#24028,"KAYUHUBI, PUGUNG, TANGGAMUS, LAMPUNG",2,43,65,108
https://kawalpemilu.org#24028,"KAYUHUBI, PUGUNG, TANGGAMUS, LAMPUNG",3,57,113,170
https://kawalpemilu.org#24028,"KAYUHUBI, PUGUNG, TANGGAMUS, LAMPUNG",4,37,143,180
https://kawalpemilu.org#24028,"KAYUHUBI, PUGUNG, TANGGAMUS, LAMPUNG",5,21,83,104
https://kawalpemilu.org#24028,"KAYUHUBI, PUGUNG, TANGGAMUS, LAMPUNG",6,33,53,86
https://kawalpemilu.org#84816,"TALANG LEBAR, PUGUNG, TANGGAMUS, LAMPUNG",1,118,113,231
https://kawalpemilu.org#84816,"TALANG LEBAR, PUGUNG, TANGGAMUS, LAMPUNG",2,121,141,262
https://kawalpemilu.org#24030,"TUGU PAPAK, SEMAKA, TANGGAMUS, LAMPUNG",1,55,114,169
https://kawalpemilu.org#24030,"TUGU PAPAK, SEMAKA, TANGGAMUS, LAMPUNG",2,75,156,231
https://kawalpemilu.org#24030,"TUGU PAPAK, SEMAKA, TANGGAMUS, LAMPUNG",3,117,90,207
https://kawalpemilu.org#24030,"TUGU PAPAK, SEMAKA, TANGGAMUS, LAMPUNG",4,144,75,219
https://kawalpemilu.org#24030,"TUGU PAPAK, SEMAKA, TANGGAMUS, LAMPUNG",5,70,100,170
https://kawalpemilu.org#24031,"KACAPURA, SEMAKA, TANGGAMUS, LAMPUNG",1,66,103,169
https://kawalpemilu.org#24031,"KACAPURA, SEMAKA, TANGGAMUS, LAMPUNG",2,114,50,164
https://kawalpemilu.org#24031,"KACAPURA, SEMAKA, TANGGAMUS, LAMPUNG",3,83,100,183
https://kawalpemilu.org#24031,"KACAPURA, SEMAKA, TANGGAMUS, LAMPUNG",4,99,83,182
https://kawalpemilu.org#24031,"KACAPURA, SEMAKA, TANGGAMUS, LAMPUNG",5,129,69,198
https://kawalpemilu.org#24032,"SUKARAJA, SEMAKA, TANGGAMUS, LAMPUNG",1,85,175,260
https://kawalpemilu.org#24032,"SUKARAJA, SEMAKA, TANGGAMUS, LAMPUNG",2,93,125,218
https://kawalpemilu.org#24032,"SUKARAJA, SEMAKA, TANGGAMUS, LAMPUNG",3,139,92,231
https://kawalpemilu.org#24032,"SUKARAJA, SEMAKA, TANGGAMUS, LAMPUNG",4,171,75,246
https://kawalpemilu.org#24032,"SUKARAJA, SEMAKA, TANGGAMUS, LAMPUNG",5,139,86,225
https://kawalpemilu.org#24032,"SUKARAJA, SEMAKA, TANGGAMUS, LAMPUNG",6,167,74,241
https://kawalpemilu.org#24032,"SUKARAJA, SEMAKA, TANGGAMUS, LAMPUNG",7,162,110,272
https://kawalpemilu.org#24032,"SUKARAJA, SEMAKA, TANGGAMUS, LAMPUNG",8,103,74,177
https://kawalpemilu.org#24032,"SUKARAJA, SEMAKA, TANGGAMUS, LAMPUNG",9,100,31,131
https://kawalpemilu.org#24032,"SUKARAJA, SEMAKA, TANGGAMUS, LAMPUNG",10,30,17,47
https://kawalpemilu.org#24033,"BANGUN REJO, SEMAKA, TANGGAMUS, LAMPUNG",1,54,123,177
https://kawalpemilu.org#24033,"BANGUN REJO, SEMAKA, TANGGAMUS, LAMPUNG",2,51,130,181
https://kawalpemilu.org#24033,"BANGUN REJO, SEMAKA, TANGGAMUS, LAMPUNG",3,110,71,181
https://kawalpemilu.org#24033,"BANGUN REJO, SEMAKA, TANGGAMUS, LAMPUNG",4,113,93,206
https://kawalpemilu.org#24034,"TUGU REJO, SEMAKA, TANGGAMUS, LAMPUNG",1,113,68,181
https://kawalpemilu.org#24034,"TUGU REJO, SEMAKA, TANGGAMUS, LAMPUNG",3,82,29,111
https://kawalpemilu.org#24035,"SIDODADI, SEMAKA, TANGGAMUS, LAMPUNG",1,110,63,173
https://kawalpemilu.org#24035,"SIDODADI, SEMAKA, TANGGAMUS, LAMPUNG",2,120,89,209
https://kawalpemilu.org#24035,"SIDODADI, SEMAKA, TANGGAMUS, LAMPUNG",3,171,40,211
https://kawalpemilu.org#24035,"SIDODADI, SEMAKA, TANGGAMUS, LAMPUNG",4,106,41,147
https://kawalpemilu.org#24036,"GARUT, SEMAKA, TANGGAMUS, LAMPUNG",1,23,139,162
https://kawalpemilu.org#24036,"GARUT, SEMAKA, TANGGAMUS, LAMPUNG",2,73,77,150
https://kawalpemilu.org#24036,"GARUT, SEMAKA, TANGGAMUS, LAMPUNG",3,71,39,110
https://kawalpemilu.org#24037,"KARANG REJO, SEMAKA, TANGGAMUS, LAMPUNG",1,143,50,193
https://kawalpemilu.org#24037,"KARANG REJO, SEMAKA, TANGGAMUS, LAMPUNG",2,143,51,194
https://kawalpemilu.org#24037,"KARANG REJO, SEMAKA, TANGGAMUS, LAMPUNG",3,143,42,185
https://kawalpemilu.org#24037,"KARANG REJO, SEMAKA, TANGGAMUS, LAMPUNG",4,120,38,158
https://kawalpemilu.org#24037,"KARANG REJO, SEMAKA, TANGGAMUS, LAMPUNG",5,128,57,185
https://kawalpemilu.org#24038,"KANOMAN, SEMAKA, TANGGAMUS, LAMPUNG",1,96,115,211
https://kawalpemilu.org#24038,"KANOMAN, SEMAKA, TANGGAMUS, LAMPUNG",2,41,127,168
https://kawalpemilu.org#24038,"KANOMAN, SEMAKA, TANGGAMUS, LAMPUNG",3,88,75,163
https://kawalpemilu.org#24038,"KANOMAN, SEMAKA, TANGGAMUS, LAMPUNG",4,99,94,193
https://kawalpemilu.org#24038,"KANOMAN, SEMAKA, TANGGAMUS, LAMPUNG",5,109,107,216
https://kawalpemilu.org#24038,"KANOMAN, SEMAKA, TANGGAMUS, LAMPUNG",6,58,61,119
https://kawalpemilu.org#24039,"SUDIMORO, SEMAKA, TANGGAMUS, LAMPUNG",1,109,119,228
https://kawalpemilu.org#24039,"SUDIMORO, SEMAKA, TANGGAMUS, LAMPUNG",2,117,120,237
https://kawalpemilu.org#24039,"SUDIMORO, SEMAKA, TANGGAMUS, LAMPUNG",3,117,93,210
https://kawalpemilu.org#24039,"SUDIMORO, SEMAKA, TANGGAMUS, LAMPUNG",4,121,55,176
https://kawalpemilu.org#24039,"SUDIMORO, SEMAKA, TANGGAMUS, LAMPUNG",5,134,79,213
https://kawalpemilu.org#24039,"SUDIMORO, SEMAKA, TANGGAMUS, LAMPUNG",6,130,94,224
https://kawalpemilu.org#24039,"SUDIMORO, SEMAKA, TANGGAMUS, LAMPUNG",7,119,98,217
https://kawalpemilu.org#24040,"SUDIMORO BANGUN, SEMAKA, TANGGAMUS, LAMPUNG",1,151,82,233
https://kawalpemilu.org#24040,"SUDIMORO BANGUN, SEMAKA, TANGGAMUS, LAMPUNG",2,143,108,251
https://kawalpemilu.org#24040,"SUDIMORO BANGUN, SEMAKA, TANGGAMUS, LAMPUNG",3,130,94,224
https://kawalpemilu.org#24040,"SUDIMORO BANGUN, SEMAKA, TANGGAMUS, LAMPUNG",4,160,79,239
https://kawalpemilu.org#24040,"SUDIMORO BANGUN, SEMAKA, TANGGAMUS, LAMPUNG",5,164,48,212
https://kawalpemilu.org#24041,"SRI PURNOMO, SEMAKA, TANGGAMUS, LAMPUNG",1,151,69,220
https://kawalpemilu.org#24041,"SRI PURNOMO, SEMAKA, TANGGAMUS, LAMPUNG",2,159,49,208
https://kawalpemilu.org#24041,"SRI PURNOMO, SEMAKA, TANGGAMUS, LAMPUNG",3,181,55,236
https://kawalpemilu.org#24041,"SRI PURNOMO, SEMAKA, TANGGAMUS, LAMPUNG",4,155,50,205
https://kawalpemilu.org#24041,"SRI PURNOMO, SEMAKA, TANGGAMUS, LAMPUNG",5,135,58,193
https://kawalpemilu.org#24041,"SRI PURNOMO, SEMAKA, TANGGAMUS, LAMPUNG",6,49,175,224
https://kawalpemilu.org#24042,"SRI KUNCORO, SEMAKA, TANGGAMUS, LAMPUNG",1,123,97,220
https://kawalpemilu.org#24042,"SRI KUNCORO, SEMAKA, TANGGAMUS, LAMPUNG",2,93,115,208
https://kawalpemilu.org#24042,"SRI KUNCORO, SEMAKA, TANGGAMUS, LAMPUNG",3,128,89,217
https://kawalpemilu.org#24042,"SRI KUNCORO, SEMAKA, TANGGAMUS, LAMPUNG",4,145,67,212
https://kawalpemilu.org#24042,"SRI KUNCORO, SEMAKA, TANGGAMUS, LAMPUNG",5,110,119,229
https://kawalpemilu.org#24042,"SRI KUNCORO, SEMAKA, TANGGAMUS, LAMPUNG",6,91,86,177
https://kawalpemilu.org#24042,"SRI KUNCORO, SEMAKA, TANGGAMUS, LAMPUNG",7,113,90,203
https://kawalpemilu.org#24043,"SIDOMULYO, SEMAKA, TANGGAMUS, LAMPUNG",1,110,69,179
https://kawalpemilu.org#24043,"SIDOMULYO, SEMAKA, TANGGAMUS, LAMPUNG",2,158,67,225
https://kawalpemilu.org#24043,"SIDOMULYO, SEMAKA, TANGGAMUS, LAMPUNG",3,173,74,247
https://kawalpemilu.org#24043,"SIDOMULYO, SEMAKA, TANGGAMUS, LAMPUNG",4,40,15,55
https://kawalpemilu.org#24043,"SIDOMULYO, SEMAKA, TANGGAMUS, LAMPUNG",5,68,15,83
https://kawalpemilu.org#24043,"SIDOMULYO, SEMAKA, TANGGAMUS, LAMPUNG",6,28,16,48
https://kawalpemilu.org#24044,"KARANG AGUNG, SEMAKA, TANGGAMUS, LAMPUNG",1,44,153,197
https://kawalpemilu.org#24044,"KARANG AGUNG, SEMAKA, TANGGAMUS, LAMPUNG",2,33,131,164
https://kawalpemilu.org#24044,"KARANG AGUNG, SEMAKA, TANGGAMUS, LAMPUNG",3,36,90,126
https://kawalpemilu.org#24044,"KARANG AGUNG, SEMAKA, TANGGAMUS, LAMPUNG",4,108,86,194
https://kawalpemilu.org#24044,"KARANG AGUNG, SEMAKA, TANGGAMUS, LAMPUNG",5,22,44,66
https://kawalpemilu.org#24045,"TULUNG ASAHAN, SEMAKA, TANGGAMUS, LAMPUNG",1,72,97,169
https://kawalpemilu.org#24045,"TULUNG ASAHAN, SEMAKA, TANGGAMUS, LAMPUNG",2,74,92,166
https://kawalpemilu.org#24045,"TULUNG ASAHAN, SEMAKA, TANGGAMUS, LAMPUNG",3,98,106,204
https://kawalpemilu.org#24046,"SRI KATON, SEMAKA, TANGGAMUS, LAMPUNG",1,125,50,175
https://kawalpemilu.org#24046,"SRI KATON, SEMAKA, TANGGAMUS, LAMPUNG",2,122,82,204
https://kawalpemilu.org#24046,"SRI KATON, SEMAKA, TANGGAMUS, LAMPUNG",3,148,54,202
https://kawalpemilu.org#24046,"SRI KATON, SEMAKA, TANGGAMUS, LAMPUNG",4,134,61,195
https://kawalpemilu.org#24046,"SRI KATON, SEMAKA, TANGGAMUS, LAMPUNG",5,141,72,213
https://kawalpemilu.org#24046,"SRI KATON, SEMAKA, TANGGAMUS, LAMPUNG",6,129,50,179
https://kawalpemilu.org#24046,"SRI KATON, SEMAKA, TANGGAMUS, LAMPUNG",7,138,66,204
https://kawalpemilu.org#24046,"SRI KATON, SEMAKA, TANGGAMUS, LAMPUNG",8,135,62,197
https://kawalpemilu.org#24047,"PARDAWARAS, SEMAKA, TANGGAMUS, LAMPUNG",1,63,97,160
https://kawalpemilu.org#24047,"PARDAWARAS, SEMAKA, TANGGAMUS, LAMPUNG",2,79,114,193
https://kawalpemilu.org#24047,"PARDAWARAS, SEMAKA, TANGGAMUS, LAMPUNG",3,35,148,183
https://kawalpemilu.org#24047,"PARDAWARAS, SEMAKA, TANGGAMUS, LAMPUNG",4,43,142,185
https://kawalpemilu.org#24047,"PARDAWARAS, SEMAKA, TANGGAMUS, LAMPUNG",5,59,113,172
https://kawalpemilu.org#24048,"SEDAYU, SEMAKA, TANGGAMUS, LAMPUNG",1,126,88,214
https://kawalpemilu.org#24048,"SEDAYU, SEMAKA, TANGGAMUS, LAMPUNG",2,141,101,242
https://kawalpemilu.org#24048,"SEDAYU, SEMAKA, TANGGAMUS, LAMPUNG",3,158,74,232
https://kawalpemilu.org#24048,"SEDAYU, SEMAKA, TANGGAMUS, LAMPUNG",4,158,78,236
https://kawalpemilu.org#24048,"SEDAYU, SEMAKA, TANGGAMUS, LAMPUNG",5,141,81,222
https://kawalpemilu.org#24048,"SEDAYU, SEMAKA, TANGGAMUS, LAMPUNG",6,99,45,144
https://kawalpemilu.org#24048,"SEDAYU, SEMAKA, TANGGAMUS, LAMPUNG",7,166,19,185
https://kawalpemilu.org#24049,"WAY KERAP, SEMAKA, TANGGAMUS, LAMPUNG",1,28,123,151
https://kawalpemilu.org#24049,"WAY KERAP, SEMAKA, TANGGAMUS, LAMPUNG",2,35,175,210
https://kawalpemilu.org#24049,"WAY KERAP, SEMAKA, TANGGAMUS, LAMPUNG",3,21,128,149
https://kawalpemilu.org#24049,"WAY KERAP, SEMAKA, TANGGAMUS, LAMPUNG",4,32,160,192
https://kawalpemilu.org#24049,"WAY KERAP, SEMAKA, TANGGAMUS, LAMPUNG",5,45,132,177
https://kawalpemilu.org#24049,"WAY KERAP, SEMAKA, TANGGAMUS, LAMPUNG",6,62,65,127
https://kawalpemilu.org#87421,"SUKAJAYA, SEMAKA, TANGGAMUS, LAMPUNG",2,164,45,209
https://kawalpemilu.org#87421,"SUKAJAYA, SEMAKA, TANGGAMUS, LAMPUNG",3,37,117,154
https://kawalpemilu.org#87421,"SUKAJAYA, SEMAKA, TANGGAMUS, LAMPUNG",4,49,42,91
https://kawalpemilu.org#91310,"MARGOMULYO, SEMAKA, TANGGAMUS, LAMPUNG",1,129,66,195
https://kawalpemilu.org#91310,"MARGOMULYO, SEMAKA, TANGGAMUS, LAMPUNG",2,129,135,264
https://kawalpemilu.org#24051,"KEBUMEN, SUMBER REJO, TANGGAMUS, LAMPUNG",1,151,76,227
https://kawalpemilu.org#24051,"KEBUMEN, SUMBER REJO, TANGGAMUS, LAMPUNG",2,123,98,221
https://kawalpemilu.org#24051,"KEBUMEN, SUMBER REJO, TANGGAMUS, LAMPUNG",3,158,73,231
https://kawalpemilu.org#24051,"KEBUMEN, SUMBER REJO, TANGGAMUS, LAMPUNG",4,117,102,219
https://kawalpemilu.org#24051,"KEBUMEN, SUMBER REJO, TANGGAMUS, LAMPUNG",5,134,97,231
https://kawalpemilu.org#24052,"SIDOMULYO, SUMBER REJO, TANGGAMUS, LAMPUNG",1,138,85,223
https://kawalpemilu.org#24052,"SIDOMULYO, SUMBER REJO, TANGGAMUS, LAMPUNG",2,124,95,219
https://kawalpemilu.org#24052,"SIDOMULYO, SUMBER REJO, TANGGAMUS, LAMPUNG",3,123,73,196
https://kawalpemilu.org#24052,"SIDOMULYO, SUMBER REJO, TANGGAMUS, LAMPUNG",4,128,85,213
https://kawalpemilu.org#24052,"SIDOMULYO, SUMBER REJO, TANGGAMUS, LAMPUNG",5,82,107,189
https://kawalpemilu.org#24052,"SIDOMULYO, SUMBER REJO, TANGGAMUS, LAMPUNG",6,156,65,221
https://kawalpemilu.org#24052,"SIDOMULYO, SUMBER REJO, TANGGAMUS, LAMPUNG",7,119,78,197
https://kawalpemilu.org#24053,"SUMBER REJO, SUMBER REJO, TANGGAMUS, LAMPUNG",1,98,97,195
https://kawalpemilu.org#24053,"SUMBER REJO, SUMBER REJO, TANGGAMUS, LAMPUNG",2,98,71,169
https://kawalpemilu.org#24053,"SUMBER REJO, SUMBER REJO, TANGGAMUS, LAMPUNG",3,122,65,187
https://kawalpemilu.org#24053,"SUMBER REJO, SUMBER REJO, TANGGAMUS, LAMPUNG",4,126,63,189
https://kawalpemilu.org#24053,"SUMBER REJO, SUMBER REJO, TANGGAMUS, LAMPUNG",5,161,76,237
https://kawalpemilu.org#24053,"SUMBER REJO, SUMBER REJO, TANGGAMUS, LAMPUNG",6,110,73,183
https://kawalpemilu.org#24053,"SUMBER REJO, SUMBER REJO, TANGGAMUS, LAMPUNG",7,151,69,220
https://kawalpemilu.org#24054,"TEGAL BINANGUN, SUMBER REJO, TANGGAMUS, LAMPUNG",1,157,41,198
https://kawalpemilu.org#24054,"TEGAL BINANGUN, SUMBER REJO, TANGGAMUS, LAMPUNG",2,143,42,185
https://kawalpemilu.org#24054,"TEGAL BINANGUN, SUMBER REJO, TANGGAMUS, LAMPUNG",3,130,75,205
https://kawalpemilu.org#24054,"TEGAL BINANGUN, SUMBER REJO, TANGGAMUS, LAMPUNG",4,126,63,189
https://kawalpemilu.org#24054,"TEGAL BINANGUN, SUMBER REJO, TANGGAMUS, LAMPUNG",5,120,85,205
https://kawalpemilu.org#24055,"ARGOPENI, SUMBER REJO, TANGGAMUS, LAMPUNG",1,194,32,226
https://kawalpemilu.org#24055,"ARGOPENI, SUMBER REJO, TANGGAMUS, LAMPUNG",2,144,37,181
https://kawalpemilu.org#24055,"ARGOPENI, SUMBER REJO, TANGGAMUS, LAMPUNG",3,215,33,248
https://kawalpemilu.org#24055,"ARGOPENI, SUMBER REJO, TANGGAMUS, LAMPUNG",4,171,46,217
https://kawalpemilu.org#24055,"ARGOPENI, SUMBER REJO, TANGGAMUS, LAMPUNG",5,124,67,191
https://kawalpemilu.org#24055,"ARGOPENI, SUMBER REJO, TANGGAMUS, LAMPUNG",6,84,103,187
https://kawalpemilu.org#24055,"ARGOPENI, SUMBER REJO, TANGGAMUS, LAMPUNG",7,144,46,190
https://kawalpemilu.org#24055,"ARGOPENI, SUMBER REJO, TANGGAMUS, LAMPUNG",8,149,42,191
https://kawalpemilu.org#24055,"ARGOPENI, SUMBER REJO, TANGGAMUS, LAMPUNG",9,114,90,204
https://kawalpemilu.org#24056,"MARGODADI, SUMBER REJO, TANGGAMUS, LAMPUNG",1,212,32,244
https://kawalpemilu.org#24056,"MARGODADI, SUMBER REJO, TANGGAMUS, LAMPUNG",2,225,25,250
https://kawalpemilu.org#24056,"MARGODADI, SUMBER REJO, TANGGAMUS, LAMPUNG",3,201,44,245
https://kawalpemilu.org#24056,"MARGODADI, SUMBER REJO, TANGGAMUS, LAMPUNG",4,193,43,236
https://kawalpemilu.org#24056,"MARGODADI, SUMBER REJO, TANGGAMUS, LAMPUNG",5,189,62,251
https://kawalpemilu.org#24056,"MARGODADI, SUMBER REJO, TANGGAMUS, LAMPUNG",6,164,23,187
https://kawalpemilu.org#24056,"MARGODADI, SUMBER REJO, TANGGAMUS, LAMPUNG",7,153,75,228
https://kawalpemilu.org#24057,"MARGOYOSO, SUMBER REJO, TANGGAMUS, LAMPUNG",1,213,48,261
https://kawalpemilu.org#24057,"MARGOYOSO, SUMBER REJO, TANGGAMUS, LAMPUNG",2,200,45,245
https://kawalpemilu.org#24057,"MARGOYOSO, SUMBER REJO, TANGGAMUS, LAMPUNG",3,182,48,230
https://kawalpemilu.org#24057,"MARGOYOSO, SUMBER REJO, TANGGAMUS, LAMPUNG",4,160,78,238
https://kawalpemilu.org#24057,"MARGOYOSO, SUMBER REJO, TANGGAMUS, LAMPUNG",5,121,93,214
https://kawalpemilu.org#24057,"MARGOYOSO, SUMBER REJO, TANGGAMUS, LAMPUNG",6,116,69,185
https://kawalpemilu.org#24057,"MARGOYOSO, SUMBER REJO, TANGGAMUS, LAMPUNG",7,156,47,203
https://kawalpemilu.org#24057,"MARGOYOSO, SUMBER REJO, TANGGAMUS, LAMPUNG",8,150,38,188
https://kawalpemilu.org#24057,"MARGOYOSO, SUMBER REJO, TANGGAMUS, LAMPUNG",9,121,71,192
https://kawalpemilu.org#24057,"MARGOYOSO, SUMBER REJO, TANGGAMUS, LAMPUNG",10,164,60,224
https://kawalpemilu.org#24057,"MARGOYOSO, SUMBER REJO, TANGGAMUS, LAMPUNG",11,206,37,243
https://kawalpemilu.org#24057,"MARGOYOSO, SUMBER REJO, TANGGAMUS, LAMPUNG",12,228,30,258
https://kawalpemilu.org#24057,"MARGOYOSO, SUMBER REJO, TANGGAMUS, LAMPUNG",13,204,34,238
https://kawalpemilu.org#24057,"MARGOYOSO, SUMBER REJO, TANGGAMUS, LAMPUNG",14,124,90,214
https://kawalpemilu.org#24057,"MARGOYOSO, SUMBER REJO, TANGGAMUS, LAMPUNG",15,126,90,216
https://kawalpemilu.org#24058,"DADAPAN, SUMBER REJO, TANGGAMUS, LAMPUNG",1,181,61,242
https://kawalpemilu.org#24058,"DADAPAN, SUMBER REJO, TANGGAMUS, LAMPUNG",2,210,39,249
https://kawalpemilu.org#24058,"DADAPAN, SUMBER REJO, TANGGAMUS, LAMPUNG",3,197,40,237
https://kawalpemilu.org#24058,"DADAPAN, SUMBER REJO, TANGGAMUS, LAMPUNG",4,205,35,240
https://kawalpemilu.org#24058,"DADAPAN, SUMBER REJO, TANGGAMUS, LAMPUNG",5,140,33,173
https://kawalpemilu.org#24058,"DADAPAN, SUMBER REJO, TANGGAMUS, LAMPUNG",6,151,24,175
https://kawalpemilu.org#24058,"DADAPAN, SUMBER REJO, TANGGAMUS, LAMPUNG",7,132,51,183
https://kawalpemilu.org#24058,"DADAPAN, SUMBER REJO, TANGGAMUS, LAMPUNG",8,150,29,179
https://kawalpemilu.org#24058,"DADAPAN, SUMBER REJO, TANGGAMUS, LAMPUNG",9,210,45,255
https://kawalpemilu.org#24058,"DADAPAN, SUMBER REJO, TANGGAMUS, LAMPUNG",10,205,36,241
https://kawalpemilu.org#24058,"DADAPAN, SUMBER REJO, TANGGAMUS, LAMPUNG",11,161,25,186
https://kawalpemilu.org#24058,"DADAPAN, SUMBER REJO, TANGGAMUS, LAMPUNG",12,145,34,179
https://kawalpemilu.org#24058,"DADAPAN, SUMBER REJO, TANGGAMUS, LAMPUNG",13,140,34,174
https://kawalpemilu.org#24058,"DADAPAN, SUMBER REJO, TANGGAMUS, LAMPUNG",14,152,32,184
https://kawalpemilu.org#24059,"SIMPANG KANAN, SUMBER REJO, TANGGAMUS, LAMPUNG",1,166,82,248
https://kawalpemilu.org#24059,"SIMPANG KANAN, SUMBER REJO, TANGGAMUS, LAMPUNG",2,180,62,242
https://kawalpemilu.org#24059,"SIMPANG KANAN, SUMBER REJO, TANGGAMUS, LAMPUNG",3,227,39,266
https://kawalpemilu.org#24059,"SIMPANG KANAN, SUMBER REJO, TANGGAMUS, LAMPUNG",4,192,55,247
https://kawalpemilu.org#24059,"SIMPANG KANAN, SUMBER REJO, TANGGAMUS, LAMPUNG",5,170,57,227
https://kawalpemilu.org#24059,"SIMPANG KANAN, SUMBER REJO, TANGGAMUS, LAMPUNG",6,169,65,234
https://kawalpemilu.org#24059,"SIMPANG KANAN, SUMBER REJO, TANGGAMUS, LAMPUNG",7,163,52,215
https://kawalpemilu.org#24059,"SIMPANG KANAN, SUMBER REJO, TANGGAMUS, LAMPUNG",8,211,36,247
https://kawalpemilu.org#24060,"WONOHARJO, SUMBER REJO, TANGGAMUS, LAMPUNG",1,184,46,230
https://kawalpemilu.org#24060,"WONOHARJO, SUMBER REJO, TANGGAMUS, LAMPUNG",2,183,55,238
https://kawalpemilu.org#24060,"WONOHARJO, SUMBER REJO, TANGGAMUS, LAMPUNG",3,178,34,212
https://kawalpemilu.org#24060,"WONOHARJO, SUMBER REJO, TANGGAMUS, LAMPUNG",4,150,45,195
https://kawalpemilu.org#24060,"WONOHARJO, SUMBER REJO, TANGGAMUS, LAMPUNG",5,135,64,199
https://kawalpemilu.org#24060,"WONOHARJO, SUMBER REJO, TANGGAMUS, LAMPUNG",6,111,100,211
https://kawalpemilu.org#24061,"SUMBER MULYO, SUMBER REJO, TANGGAMUS, LAMPUNG",1,127,83,210
https://kawalpemilu.org#24061,"SUMBER MULYO, SUMBER REJO, TANGGAMUS, LAMPUNG",2,184,35,219
https://kawalpemilu.org#24061,"SUMBER MULYO, SUMBER REJO, TANGGAMUS, LAMPUNG",3,184,32,216
https://kawalpemilu.org#24061,"SUMBER MULYO, SUMBER REJO, TANGGAMUS, LAMPUNG",4,110,125,235
https://kawalpemilu.org#24061,"SUMBER MULYO, SUMBER REJO, TANGGAMUS, LAMPUNG",5,161,76,237
https://kawalpemilu.org#24062,"ARGOMULYO, SUMBER REJO, TANGGAMUS, LAMPUNG",1,154,48,202
https://kawalpemilu.org#24062,"ARGOMULYO, SUMBER REJO, TANGGAMUS, LAMPUNG",2,159,81,240
https://kawalpemilu.org#24062,"ARGOMULYO, SUMBER REJO, TANGGAMUS, LAMPUNG",3,150,83,233
https://kawalpemilu.org#24062,"ARGOMULYO, SUMBER REJO, TANGGAMUS, LAMPUNG",4,126,66,192
https://kawalpemilu.org#24062,"ARGOMULYO, SUMBER REJO, TANGGAMUS, LAMPUNG",5,161,65,226
https://kawalpemilu.org#24062,"ARGOMULYO, SUMBER REJO, TANGGAMUS, LAMPUNG",6,126,64,190
https://kawalpemilu.org#24063,"SIDOREJO, SUMBER REJO, TANGGAMUS, LAMPUNG",1,139,47,186
https://kawalpemilu.org#24063,"SIDOREJO, SUMBER REJO, TANGGAMUS, LAMPUNG",2,135,38,173
https://kawalpemilu.org#24063,"SIDOREJO, SUMBER REJO, TANGGAMUS, LAMPUNG",3,133,38,171
https://kawalpemilu.org#24063,"SIDOREJO, SUMBER REJO, TANGGAMUS, LAMPUNG",4,130,47,177
https://kawalpemilu.org#24063,"SIDOREJO, SUMBER REJO, TANGGAMUS, LAMPUNG",5,102,87,189
https://kawalpemilu.org#24063,"SIDOREJO, SUMBER REJO, TANGGAMUS, LAMPUNG",6,123,76,199
https://kawalpemilu.org#24063,"SIDOREJO, SUMBER REJO, TANGGAMUS, LAMPUNG",7,92,110,202
https://kawalpemilu.org#24063,"SIDOREJO, SUMBER REJO, TANGGAMUS, LAMPUNG",8,138,55,193
https://kawalpemilu.org#24065,"DATARAJAN, ULU BELU, TANGGAMUS, LAMPUNG",1,196,50,246
https://kawalpemilu.org#24065,"DATARAJAN, ULU BELU, TANGGAMUS, LAMPUNG",2,213,43,256
https://kawalpemilu.org#24065,"DATARAJAN, ULU BELU, TANGGAMUS, LAMPUNG",3,185,59,244
https://kawalpemilu.org#24065,"DATARAJAN, ULU BELU, TANGGAMUS, LAMPUNG",4,211,37,248
https://kawalpemilu.org#24065,"DATARAJAN, ULU BELU, TANGGAMUS, LAMPUNG",5,183,63,246
https://kawalpemilu.org#24065,"DATARAJAN, ULU BELU, TANGGAMUS, LAMPUNG",6,211,38,249
https://kawalpemilu.org#24065,"DATARAJAN, ULU BELU, TANGGAMUS, LAMPUNG",7,208,38,246
https://kawalpemilu.org#24065,"DATARAJAN, ULU BELU, TANGGAMUS, LAMPUNG",8,202,49,251
https://kawalpemilu.org#24065,"DATARAJAN, ULU BELU, TANGGAMUS, LAMPUNG",9,96,46,142
https://kawalpemilu.org#24065,"DATARAJAN, ULU BELU, TANGGAMUS, LAMPUNG",10,92,34,126
https://kawalpemilu.org#24065,"DATARAJAN, ULU BELU, TANGGAMUS, LAMPUNG",11,167,36,203
https://kawalpemilu.org#24066,"GUNUNG TIGA, ULU BELU, TANGGAMUS, LAMPUNG",1,25,173,198
https://kawalpemilu.org#24066,"GUNUNG TIGA, ULU BELU, TANGGAMUS, LAMPUNG",2,12,182,194
https://kawalpemilu.org#24066,"GUNUNG TIGA, ULU BELU, TANGGAMUS, LAMPUNG",3,16,196,212
https://kawalpemilu.org#24066,"GUNUNG TIGA, ULU BELU, TANGGAMUS, LAMPUNG",4,31,175,206
https://kawalpemilu.org#24066,"GUNUNG TIGA, ULU BELU, TANGGAMUS, LAMPUNG",5,36,153,189
https://kawalpemilu.org#24066,"GUNUNG TIGA, ULU BELU, TANGGAMUS, LAMPUNG",6,21,154,175
https://kawalpemilu.org#24066,"GUNUNG TIGA, ULU BELU, TANGGAMUS, LAMPUNG",7,43,165,208
https://kawalpemilu.org#24066,"GUNUNG TIGA, ULU BELU, TANGGAMUS, LAMPUNG",8,16,194,210
https://kawalpemilu.org#24066,"GUNUNG TIGA, ULU BELU, TANGGAMUS, LAMPUNG",9,18,154,172
https://kawalpemilu.org#24067,"KARANG REJO, ULU BELU, TANGGAMUS, LAMPUNG",1,186,62,248
https://kawalpemilu.org#24067,"KARANG REJO, ULU BELU, TANGGAMUS, LAMPUNG",2,200,38,238
https://kawalpemilu.org#24067,"KARANG REJO, ULU BELU, TANGGAMUS, LAMPUNG",3,175,35,210
https://kawalpemilu.org#24067,"KARANG REJO, ULU BELU, TANGGAMUS, LAMPUNG",4,219,22,241
https://kawalpemilu.org#24067,"KARANG REJO, ULU BELU, TANGGAMUS, LAMPUNG",5,217,18,235
https://kawalpemilu.org#24067,"KARANG REJO, ULU BELU, TANGGAMUS, LAMPUNG",6,173,26,199
https://kawalpemilu.org#24067,"KARANG REJO, ULU BELU, TANGGAMUS, LAMPUNG",7,161,10,171
https://kawalpemilu.org#24067,"KARANG REJO, ULU BELU, TANGGAMUS, LAMPUNG",8,207,16,223
https://kawalpemilu.org#24067,"KARANG REJO, ULU BELU, TANGGAMUS, LAMPUNG",9,98,25,123
https://kawalpemilu.org#24068,"PAGAR ALAM ULU BELU, ULU BELU, TANGGAMUS, LAMPUNG",1,30,221,251
https://kawalpemilu.org#24068,"PAGAR ALAM ULU BELU, ULU BELU, TANGGAMUS, LAMPUNG",2,29,163,192
https://kawalpemilu.org#24068,"PAGAR ALAM ULU BELU, ULU BELU, TANGGAMUS, LAMPUNG",3,22,217,239
https://kawalpemilu.org#24068,"PAGAR ALAM ULU BELU, ULU BELU, TANGGAMUS, LAMPUNG",4,32,203,235
https://kawalpemilu.org#24068,"PAGAR ALAM ULU BELU, ULU BELU, TANGGAMUS, LAMPUNG",5,81,77,158
https://kawalpemilu.org#24068,"PAGAR ALAM ULU BELU, ULU BELU, TANGGAMUS, LAMPUNG",6,121,40,161
https://kawalpemilu.org#24068,"PAGAR ALAM ULU BELU, ULU BELU, TANGGAMUS, LAMPUNG",7,20,86,106
https://kawalpemilu.org#24069,"MUARA DUA ULU BELU, ULU BELU, TANGGAMUS, LAMPUNG",1,24,151,175
https://kawalpemilu.org#24069,"MUARA DUA ULU BELU, ULU BELU, TANGGAMUS, LAMPUNG",2,33,153,186
https://kawalpemilu.org#24069,"MUARA DUA ULU BELU, ULU BELU, TANGGAMUS, LAMPUNG",3,55,141,196
https://kawalpemilu.org#24069,"MUARA DUA ULU BELU, ULU BELU, TANGGAMUS, LAMPUNG",4,46,109,155
https://kawalpemilu.org#24070,"NGARIP, ULU BELU, TANGGAMUS, LAMPUNG",1,208,42,250
https://kawalpemilu.org#24070,"NGARIP, ULU BELU, TANGGAMUS, LAMPUNG",2,123,73,196
https://kawalpemilu.org#24070,"NGARIP, ULU BELU, TANGGAMUS, LAMPUNG",3,135,105,240
https://kawalpemilu.org#24070,"NGARIP, ULU BELU, TANGGAMUS, LAMPUNG",4,146,61,207
https://kawalpemilu.org#24070,"NGARIP, ULU BELU, TANGGAMUS, LAMPUNG",5,138,96,234
https://kawalpemilu.org#24070,"NGARIP, ULU BELU, TANGGAMUS, LAMPUNG",7,199,56,255
https://kawalpemilu.org#24070,"NGARIP, ULU BELU, TANGGAMUS, LAMPUNG",8,195,30,225
https://kawalpemilu.org#24070,"NGARIP, ULU BELU, TANGGAMUS, LAMPUNG",9,224,32,256
https://kawalpemilu.org#24070,"NGARIP, ULU BELU, TANGGAMUS, LAMPUNG",10,203,30,233
https://kawalpemilu.org#24070,"NGARIP, ULU BELU, TANGGAMUS, LAMPUNG",11,212,26,238
https://kawalpemilu.org#24070,"NGARIP, ULU BELU, TANGGAMUS, LAMPUNG",12,213,27,240
https://kawalpemilu.org#24070,"NGARIP, ULU BELU, TANGGAMUS, LAMPUNG",13,213,21,234
https://kawalpemilu.org#24070,"NGARIP, ULU BELU, TANGGAMUS, LAMPUNG",14,233,15,248
https://kawalpemilu.org#24070,"NGARIP, ULU BELU, TANGGAMUS, LAMPUNG",15,105,95,200
https://kawalpemilu.org#24070,"NGARIP, ULU BELU, TANGGAMUS, LAMPUNG",16,152,18,170
https://kawalpemilu.org#24071,"PENANTIAN ULU BELU, ULU BELU, TANGGAMUS, LAMPUNG",1,176,43,219
https://kawalpemilu.org#24071,"PENANTIAN ULU BELU, ULU BELU, TANGGAMUS, LAMPUNG",2,193,56,249
https://kawalpemilu.org#24071,"PENANTIAN ULU BELU, ULU BELU, TANGGAMUS, LAMPUNG",3,197,10,207
https://kawalpemilu.org#24071,"PENANTIAN ULU BELU, ULU BELU, TANGGAMUS, LAMPUNG",4,246,13,259
https://kawalpemilu.org#24071,"PENANTIAN ULU BELU, ULU BELU, TANGGAMUS, LAMPUNG",5,207,20,227
https://kawalpemilu.org#24071,"PENANTIAN ULU BELU, ULU BELU, TANGGAMUS, LAMPUNG",6,215,31,246
https://kawalpemilu.org#24071,"PENANTIAN ULU BELU, ULU BELU, TANGGAMUS, LAMPUNG",7,222,36,258
https://kawalpemilu.org#24072,"GUNUNG SARI, ULU BELU, TANGGAMUS, LAMPUNG",1,165,51,216
https://kawalpemilu.org#24072,"GUNUNG SARI, ULU BELU, TANGGAMUS, LAMPUNG",2,219,29,248
https://kawalpemilu.org#24072,"GUNUNG SARI, ULU BELU, TANGGAMUS, LAMPUNG",3,170,61,231
https://kawalpemilu.org#24072,"GUNUNG SARI, ULU BELU, TANGGAMUS, LAMPUNG",4,173,35,208
https://kawalpemilu.org#24072,"GUNUNG SARI, ULU BELU, TANGGAMUS, LAMPUNG",5,165,51,216
https://kawalpemilu.org#24072,"GUNUNG SARI, ULU BELU, TANGGAMUS, LAMPUNG",6,129,60,189
https://kawalpemilu.org#24072,"GUNUNG SARI, ULU BELU, TANGGAMUS, LAMPUNG",7,157,62,219
https://kawalpemilu.org#24072,"GUNUNG SARI, ULU BELU, TANGGAMUS, LAMPUNG",8,190,27,217
https://kawalpemilu.org#24072,"GUNUNG SARI, ULU BELU, TANGGAMUS, LAMPUNG",9,181,50,231
https://kawalpemilu.org#24072,"GUNUNG SARI, ULU BELU, TANGGAMUS, LAMPUNG",10,152,57,209
https://kawalpemilu.org#24072,"GUNUNG SARI, ULU BELU, TANGGAMUS, LAMPUNG",11,104,47,151
https://kawalpemilu.org#24072,"GUNUNG SARI, ULU BELU, TANGGAMUS, LAMPUNG",12,138,71,209
https://kawalpemilu.org#24073,"ULU SEMONG, ULU BELU, TANGGAMUS, LAMPUNG",1,88,64,152
https://kawalpemilu.org#24073,"ULU SEMONG, ULU BELU, TANGGAMUS, LAMPUNG",2,105,91,196
https://kawalpemilu.org#24073,"ULU SEMONG, ULU BELU, TANGGAMUS, LAMPUNG",3,85,101,186
https://kawalpemilu.org#24073,"ULU SEMONG, ULU BELU, TANGGAMUS, LAMPUNG",4,86,93,179
https://kawalpemilu.org#24073,"ULU SEMONG, ULU BELU, TANGGAMUS, LAMPUNG",5,175,93,268
https://kawalpemilu.org#24073,"ULU SEMONG, ULU BELU, TANGGAMUS, LAMPUNG",6,109,47,156
https://kawalpemilu.org#24073,"ULU SEMONG, ULU BELU, TANGGAMUS, LAMPUNG",7,95,71,166
https://kawalpemilu.org#24073,"ULU SEMONG, ULU BELU, TANGGAMUS, LAMPUNG",8,136,20,156
https://kawalpemilu.org#24073,"ULU SEMONG, ULU BELU, TANGGAMUS, LAMPUNG",9,117,8,125
https://kawalpemilu.org#24073,"ULU SEMONG, ULU BELU, TANGGAMUS, LAMPUNG",10,78,87,165
https://kawalpemilu.org#24074,"SIRNA GALIH, ULU BELU, TANGGAMUS, LAMPUNG",1,141,112,253
https://kawalpemilu.org#24074,"SIRNA GALIH, ULU BELU, TANGGAMUS, LAMPUNG",2,104,139,243
https://kawalpemilu.org#24074,"SIRNA GALIH, ULU BELU, TANGGAMUS, LAMPUNG",3,175,58,233
https://kawalpemilu.org#24074,"SIRNA GALIH, ULU BELU, TANGGAMUS, LAMPUNG",4,196,15,211
https://kawalpemilu.org#24074,"SIRNA GALIH, ULU BELU, TANGGAMUS, LAMPUNG",5,134,44,178
https://kawalpemilu.org#24074,"SIRNA GALIH, ULU BELU, TANGGAMUS, LAMPUNG",6,135,58,193
https://kawalpemilu.org#24074,"SIRNA GALIH, ULU BELU, TANGGAMUS, LAMPUNG",7,163,8,171
https://kawalpemilu.org#24074,"SIRNA GALIH, ULU BELU, TANGGAMUS, LAMPUNG",8,195,20,215
https://kawalpemilu.org#24074,"SIRNA GALIH, ULU BELU, TANGGAMUS, LAMPUNG",9,134,8,142
https://kawalpemilu.org#24075,"REJO SARI, ULU BELU, TANGGAMUS, LAMPUNG",1,215,19,234
https://kawalpemilu.org#24075,"REJO SARI, ULU BELU, TANGGAMUS, LAMPUNG",2,199,26,225
https://kawalpemilu.org#24075,"REJO SARI, ULU BELU, TANGGAMUS, LAMPUNG",3,191,26,217
https://kawalpemilu.org#24075,"REJO SARI, ULU BELU, TANGGAMUS, LAMPUNG",4,169,13,182
https://kawalpemilu.org#24075,"REJO SARI, ULU BELU, TANGGAMUS, LAMPUNG",6,188,11,199
https://kawalpemilu.org#24075,"REJO SARI, ULU BELU, TANGGAMUS, LAMPUNG",7,86,48,134
https://kawalpemilu.org#24076,"SUKA MAJU, ULU BELU, TANGGAMUS, LAMPUNG",1,38,208,246
https://kawalpemilu.org#24076,"SUKA MAJU, ULU BELU, TANGGAMUS, LAMPUNG",2,143,82,225
https://kawalpemilu.org#24076,"SUKA MAJU, ULU BELU, TANGGAMUS, LAMPUNG",3,218,8,226
https://kawalpemilu.org#24076,"SUKA MAJU, ULU BELU, TANGGAMUS, LAMPUNG",4,126,16,142
https://kawalpemilu.org#24076,"SUKA MAJU, ULU BELU, TANGGAMUS, LAMPUNG",5,149,54,203
https://kawalpemilu.org#24076,"SUKA MAJU, ULU BELU, TANGGAMUS, LAMPUNG",6,95,20,115
https://kawalpemilu.org#24077,"TANJUNG BARU, ULU BELU, TANGGAMUS, LAMPUNG",1,200,17,217
https://kawalpemilu.org#24077,"TANJUNG BARU, ULU BELU, TANGGAMUS, LAMPUNG",2,133,59,192
https://kawalpemilu.org#24077,"TANJUNG BARU, ULU BELU, TANGGAMUS, LAMPUNG",3,106,155,261
https://kawalpemilu.org#24077,"TANJUNG BARU, ULU BELU, TANGGAMUS, LAMPUNG",4,144,11,155
https://kawalpemilu.org#24077,"TANJUNG BARU, ULU BELU, TANGGAMUS, LAMPUNG",5,101,38,139
https://kawalpemilu.org#24077,"TANJUNG BARU, ULU BELU, TANGGAMUS, LAMPUNG",6,166,14,180
https://kawalpemilu.org#24078,"SINAR BANTEN, ULU BELU, TANGGAMUS, LAMPUNG",1,96,62,158
https://kawalpemilu.org#24078,"SINAR BANTEN, ULU BELU, TANGGAMUS, LAMPUNG",2,154,46,200
https://kawalpemilu.org#24078,"SINAR BANTEN, ULU BELU, TANGGAMUS, LAMPUNG",3,193,46,239
https://kawalpemilu.org#24078,"SINAR BANTEN, ULU BELU, TANGGAMUS, LAMPUNG",4,141,65,206
https://kawalpemilu.org#24078,"SINAR BANTEN, ULU BELU, TANGGAMUS, LAMPUNG",5,163,42,205
https://kawalpemilu.org#24078,"SINAR BANTEN, ULU BELU, TANGGAMUS, LAMPUNG",6,89,16,105
https://kawalpemilu.org#24079,"AIR ABANG, ULU BELU, TANGGAMUS, LAMPUNG",1,156,53,209
https://kawalpemilu.org#24079,"AIR ABANG, ULU BELU, TANGGAMUS, LAMPUNG",2,184,20,204
https://kawalpemilu.org#24079,"AIR ABANG, ULU BELU, TANGGAMUS, LAMPUNG",3,188,18,206
https://kawalpemilu.org#24079,"AIR ABANG, ULU BELU, TANGGAMUS, LAMPUNG",4,153,42,195
https://kawalpemilu.org#24079,"AIR ABANG, ULU BELU, TANGGAMUS, LAMPUNG",5,215,11,226
https://kawalpemilu.org#24079,"AIR ABANG, ULU BELU, TANGGAMUS, LAMPUNG",6,141,49,190
https://kawalpemilu.org#24079,"AIR ABANG, ULU BELU, TANGGAMUS, LAMPUNG",7,67,16,83
https://kawalpemilu.org#84817,"PETAY KAYU, ULU BELU, TANGGAMUS, LAMPUNG",1,117,64,181
https://kawalpemilu.org#84817,"PETAY KAYU, ULU BELU, TANGGAMUS, LAMPUNG",2,70,147,217
https://kawalpemilu.org#84817,"PETAY KAYU, ULU BELU, TANGGAMUS, LAMPUNG",3,104,99,203
https://kawalpemilu.org#84817,"PETAY KAYU, ULU BELU, TANGGAMUS, LAMPUNG",4,146,40,186
https://kawalpemilu.org#24081,"TAMPANG TUA, PEMATANG SAWA, TANGGAMUS, LAMPUNG",1,71,82,153
https://kawalpemilu.org#24081,"TAMPANG TUA, PEMATANG SAWA, TANGGAMUS, LAMPUNG",2,101,71,172
https://kawalpemilu.org#24081,"TAMPANG TUA, PEMATANG SAWA, TANGGAMUS, LAMPUNG",3,139,38,177
https://kawalpemilu.org#24081,"TAMPANG TUA, PEMATANG SAWA, TANGGAMUS, LAMPUNG",4,48,42,90
https://kawalpemilu.org#24082,"KAUR GADING, PEMATANG SAWA, TANGGAMUS, LAMPUNG",1,98,55,153
https://kawalpemilu.org#24082,"KAUR GADING, PEMATANG SAWA, TANGGAMUS, LAMPUNG",2,56,73,129
https://kawalpemilu.org#24082,"KAUR GADING, PEMATANG SAWA, TANGGAMUS, LAMPUNG",3,101,57,158
https://kawalpemilu.org#24082,"KAUR GADING, PEMATANG SAWA, TANGGAMUS, LAMPUNG",4,64,50,114
https://kawalpemilu.org#24083,"TIROM, PEMATANG SAWA, TANGGAMUS, LAMPUNG",1,57,78,135
https://kawalpemilu.org#24083,"TIROM, PEMATANG SAWA, TANGGAMUS, LAMPUNG",2,105,27,132
https://kawalpemilu.org#24083,"TIROM, PEMATANG SAWA, TANGGAMUS, LAMPUNG",3,162,39,201
https://kawalpemilu.org#24083,"TIROM, PEMATANG SAWA, TANGGAMUS, LAMPUNG",4,97,70,167
https://kawalpemilu.org#24083,"TIROM, PEMATANG SAWA, TANGGAMUS, LAMPUNG",5,47,38,85
https://kawalpemilu.org#24083,"TIROM, PEMATANG SAWA, TANGGAMUS, LAMPUNG",6,52,15,67
https://kawalpemilu.org#24083,"TIROM, PEMATANG SAWA, TANGGAMUS, LAMPUNG",7,41,49,90
https://kawalpemilu.org#24084,"WAY NIPAH, PEMATANG SAWA, TANGGAMUS, LAMPUNG",1,86,120,206
https://kawalpemilu.org#24084,"WAY NIPAH, PEMATANG SAWA, TANGGAMUS, LAMPUNG",2,69,96,165
https://kawalpemilu.org#24084,"WAY NIPAH, PEMATANG SAWA, TANGGAMUS, LAMPUNG",3,75,38,113
https://kawalpemilu.org#24084,"WAY NIPAH, PEMATANG SAWA, TANGGAMUS, LAMPUNG",4,86,16,102
https://kawalpemilu.org#24084,"WAY NIPAH, PEMATANG SAWA, TANGGAMUS, LAMPUNG",5,85,20,105
https://kawalpemilu.org#24084,"WAY NIPAH, PEMATANG SAWA, TANGGAMUS, LAMPUNG",6,79,27,106
https://kawalpemilu.org#24084,"WAY NIPAH, PEMATANG SAWA, TANGGAMUS, LAMPUNG",7,42,106,148
https://kawalpemilu.org#24085,"GURING, PEMATANG SAWA, TANGGAMUS, LAMPUNG",1,29,113,142
https://kawalpemilu.org#24085,"GURING, PEMATANG SAWA, TANGGAMUS, LAMPUNG",2,104,105,209
https://kawalpemilu.org#24085,"GURING, PEMATANG SAWA, TANGGAMUS, LAMPUNG",3,79,33,112
https://kawalpemilu.org#24085,"GURING, PEMATANG SAWA, TANGGAMUS, LAMPUNG",4,48,124,172
https://kawalpemilu.org#24086,"BETUNG, PEMATANG SAWA, TANGGAMUS, LAMPUNG",1,53,168,221
https://kawalpemilu.org#24086,"BETUNG, PEMATANG SAWA, TANGGAMUS, LAMPUNG",2,25,141,166
https://kawalpemilu.org#24086,"BETUNG, PEMATANG SAWA, TANGGAMUS, LAMPUNG",3,105,41,146
https://kawalpemilu.org#24086,"BETUNG, PEMATANG SAWA, TANGGAMUS, LAMPUNG",4,160,53,213
https://kawalpemilu.org#24086,"BETUNG, PEMATANG SAWA, TANGGAMUS, LAMPUNG",5,25,153,178
https://kawalpemilu.org#24086,"BETUNG, PEMATANG SAWA, TANGGAMUS, LAMPUNG",6,65,41,106
https://kawalpemilu.org#24087,"TANJUNGAN, PEMATANG SAWA, TANGGAMUS, LAMPUNG",1,105,79,184
https://kawalpemilu.org#24087,"TANJUNGAN, PEMATANG SAWA, TANGGAMUS, LAMPUNG",2,85,107,192
https://kawalpemilu.org#24087,"TANJUNGAN, PEMATANG SAWA, TANGGAMUS, LAMPUNG",3,55,110,165
https://kawalpemilu.org#24087,"TANJUNGAN, PEMATANG SAWA, TANGGAMUS, LAMPUNG",4,97,90,187
https://kawalpemilu.org#24087,"TANJUNGAN, PEMATANG SAWA, TANGGAMUS, LAMPUNG",5,145,57,202
https://kawalpemilu.org#24087,"TANJUNGAN, PEMATANG SAWA, TANGGAMUS, LAMPUNG",6,31,33,64
https://kawalpemilu.org#24088,"TELUK BRAK, PEMATANG SAWA, TANGGAMUS, LAMPUNG",1,98,52,150
https://kawalpemilu.org#24088,"TELUK BRAK, PEMATANG SAWA, TANGGAMUS, LAMPUNG",2,116,47,163
https://kawalpemilu.org#24088,"TELUK BRAK, PEMATANG SAWA, TANGGAMUS, LAMPUNG",3,70,30,100
https://kawalpemilu.org#24088,"TELUK BRAK, PEMATANG SAWA, TANGGAMUS, LAMPUNG",4,53,10,63
https://kawalpemilu.org#24088,"TELUK BRAK, PEMATANG SAWA, TANGGAMUS, LAMPUNG",5,29,0,29
https://kawalpemilu.org#24088,"TELUK BRAK, PEMATANG SAWA, TANGGAMUS, LAMPUNG",6,78,17,95
https://kawalpemilu.org#24089,"KARANG BRAK, PEMATANG SAWA, TANGGAMUS, LAMPUNG",1,79,52,131
https://kawalpemilu.org#24089,"KARANG BRAK, PEMATANG SAWA, TANGGAMUS, LAMPUNG",2,94,9,103
https://kawalpemilu.org#24089,"KARANG BRAK, PEMATANG SAWA, TANGGAMUS, LAMPUNG",3,83,39,122
https://kawalpemilu.org#24089,"KARANG BRAK, PEMATANG SAWA, TANGGAMUS, LAMPUNG",4,153,16,169
https://kawalpemilu.org#24090,"PESANGUAN, PEMATANG SAWA, TANGGAMUS, LAMPUNG",2,132,25,157
https://kawalpemilu.org#24091,"WAY ASAHAN, PEMATANG SAWA, TANGGAMUS, LAMPUNG",1,107,73,180
https://kawalpemilu.org#24091,"WAY ASAHAN, PEMATANG SAWA, TANGGAMUS, LAMPUNG",2,113,33,146
https://kawalpemilu.org#24091,"WAY ASAHAN, PEMATANG SAWA, TANGGAMUS, LAMPUNG",3,56,35,91
https://kawalpemilu.org#24092,"TAMPANG MUDA, PEMATANG SAWA, TANGGAMUS, LAMPUNG",1,20,108,128
https://kawalpemilu.org#24092,"TAMPANG MUDA, PEMATANG SAWA, TANGGAMUS, LAMPUNG",2,104,28,132
https://kawalpemilu.org#24092,"TAMPANG MUDA, PEMATANG SAWA, TANGGAMUS, LAMPUNG",3,111,12,123
https://kawalpemilu.org#24092,"TAMPANG MUDA, PEMATANG SAWA, TANGGAMUS, LAMPUNG",4,109,71,180
https://kawalpemilu.org#24092,"TAMPANG MUDA, PEMATANG SAWA, TANGGAMUS, LAMPUNG",5,11,76,87
https://kawalpemilu.org#24093,"KAMPUNG BARU, PEMATANG SAWA, TANGGAMUS, LAMPUNG",1,77,54,131
https://kawalpemilu.org#24093,"KAMPUNG BARU, PEMATANG SAWA, TANGGAMUS, LAMPUNG",2,72,67,139
https://kawalpemilu.org#24093,"KAMPUNG BARU, PEMATANG SAWA, TANGGAMUS, LAMPUNG",3,76,49,125
https://kawalpemilu.org#24093,"KAMPUNG BARU, PEMATANG SAWA, TANGGAMUS, LAMPUNG",4,72,41,113
https://kawalpemilu.org#84818,"MARTANDA, PEMATANG SAWA, TANGGAMUS, LAMPUNG",1,136,28,164
https://kawalpemilu.org#84818,"MARTANDA, PEMATANG SAWA, TANGGAMUS, LAMPUNG",2,96,83,179
https://kawalpemilu.org#84818,"MARTANDA, PEMATANG SAWA, TANGGAMUS, LAMPUNG",3,99,38,137
https://kawalpemilu.org#84818,"MARTANDA, PEMATANG SAWA, TANGGAMUS, LAMPUNG",4,128,24,152
https://kawalpemilu.org#24095,"NEGERI KELUMBAYAN, KLUMBAYAN, TANGGAMUS, LAMPUNG",1,75,78,153
https://kawalpemilu.org#24095,"NEGERI KELUMBAYAN, KLUMBAYAN, TANGGAMUS, LAMPUNG",2,36,49,85
https://kawalpemilu.org#24095,"NEGERI KELUMBAYAN, KLUMBAYAN, TANGGAMUS, LAMPUNG",3,62,37,99
https://kawalpemilu.org#24095,"NEGERI KELUMBAYAN, KLUMBAYAN, TANGGAMUS, LAMPUNG",4,58,10,68
https://kawalpemilu.org#24095,"NEGERI KELUMBAYAN, KLUMBAYAN, TANGGAMUS, LAMPUNG",5,58,2,60
https://kawalpemilu.org#24095,"NEGERI KELUMBAYAN, KLUMBAYAN, TANGGAMUS, LAMPUNG",6,96,12,108
https://kawalpemilu.org#24095,"NEGERI KELUMBAYAN, KLUMBAYAN, TANGGAMUS, LAMPUNG",7,151,13,164
https://kawalpemilu.org#24096,"PEKON SUSUK, KLUMBAYAN, TANGGAMUS, LAMPUNG",1,21,139,160
https://kawalpemilu.org#24096,"PEKON SUSUK, KLUMBAYAN, TANGGAMUS, LAMPUNG",2,19,123,142
https://kawalpemilu.org#24096,"PEKON SUSUK, KLUMBAYAN, TANGGAMUS, LAMPUNG",3,23,82,105
https://kawalpemilu.org#24097,"NAPAL, KLUMBAYAN, TANGGAMUS, LAMPUNG",1,24,142,166
https://kawalpemilu.org#24097,"NAPAL, KLUMBAYAN, TANGGAMUS, LAMPUNG",2,17,138,155
https://kawalpemilu.org#24097,"NAPAL, KLUMBAYAN, TANGGAMUS, LAMPUNG",3,23,124,147
https://kawalpemilu.org#24097,"NAPAL, KLUMBAYAN, TANGGAMUS, LAMPUNG",4,34,96,130
https://kawalpemilu.org#24097,"NAPAL, KLUMBAYAN, TANGGAMUS, LAMPUNG",5,13,80,93
https://kawalpemilu.org#24098,"PEKON UNGGAK, KLUMBAYAN, TANGGAMUS, LAMPUNG",1,28,90,118
https://kawalpemilu.org#24098,"PEKON UNGGAK, KLUMBAYAN, TANGGAMUS, LAMPUNG",2,12,83,95
https://kawalpemilu.org#24098,"PEKON UNGGAK, KLUMBAYAN, TANGGAMUS, LAMPUNG",3,11,85,96
https://kawalpemilu.org#24098,"PEKON UNGGAK, KLUMBAYAN, TANGGAMUS, LAMPUNG",4,19,130,149
https://kawalpemilu.org#24099,"PENYANDINGAN, KLUMBAYAN, TANGGAMUS, LAMPUNG",1,21,111,132
https://kawalpemilu.org#24099,"PENYANDINGAN, KLUMBAYAN, TANGGAMUS, LAMPUNG",2,14,84,98
https://kawalpemilu.org#24099,"PENYANDINGAN, KLUMBAYAN, TANGGAMUS, LAMPUNG",3,92,26,118
https://kawalpemilu.org#24099,"PENYANDINGAN, KLUMBAYAN, TANGGAMUS, LAMPUNG",4,130,86,216
https://kawalpemilu.org#24099,"PENYANDINGAN, KLUMBAYAN, TANGGAMUS, LAMPUNG",5,14,104,118
https://kawalpemilu.org#24099,"PENYANDINGAN, KLUMBAYAN, TANGGAMUS, LAMPUNG",6,22,85,107
https://kawalpemilu.org#24099,"PENYANDINGAN, KLUMBAYAN, TANGGAMUS, LAMPUNG",7,116,81,197
https://kawalpemilu.org#24099,"PENYANDINGAN, KLUMBAYAN, TANGGAMUS, LAMPUNG",8,53,53,106
https://kawalpemilu.org#24099,"PENYANDINGAN, KLUMBAYAN, TANGGAMUS, LAMPUNG",9,80,6,86
https://kawalpemilu.org#24099,"PENYANDINGAN, KLUMBAYAN, TANGGAMUS, LAMPUNG",10,91,21,112
https://kawalpemilu.org#24099,"PENYANDINGAN, KLUMBAYAN, TANGGAMUS, LAMPUNG",11,159,28,187
https://kawalpemilu.org#24099,"PENYANDINGAN, KLUMBAYAN, TANGGAMUS, LAMPUNG",12,82,1,83
https://kawalpemilu.org#24100,"PAKU, KLUMBAYAN, TANGGAMUS, LAMPUNG",1,56,74,130
https://kawalpemilu.org#24100,"PAKU, KLUMBAYAN, TANGGAMUS, LAMPUNG",2,10,108,118
https://kawalpemilu.org#24100,"PAKU, KLUMBAYAN, TANGGAMUS, LAMPUNG",3,44,64,108
https://kawalpemilu.org#24100,"PAKU, KLUMBAYAN, TANGGAMUS, LAMPUNG",4,53,80,133
https://kawalpemilu.org#24101,"UMBAR, KLUMBAYAN, TANGGAMUS, LAMPUNG",1,9,76,85
https://kawalpemilu.org#24101,"UMBAR, KLUMBAYAN, TANGGAMUS, LAMPUNG",2,15,104,119
https://kawalpemilu.org#24101,"UMBAR, KLUMBAYAN, TANGGAMUS, LAMPUNG",3,19,91,110
https://kawalpemilu.org#24101,"UMBAR, KLUMBAYAN, TANGGAMUS, LAMPUNG",4,19,43,62
https://kawalpemilu.org#24101,"UMBAR, KLUMBAYAN, TANGGAMUS, LAMPUNG",5,56,131,187
https://kawalpemilu.org#24101,"UMBAR, KLUMBAYAN, TANGGAMUS, LAMPUNG",6,129,54,183
https://kawalpemilu.org#24101,"UMBAR, KLUMBAYAN, TANGGAMUS, LAMPUNG",7,43,47,90
https://kawalpemilu.org#24101,"UMBAR, KLUMBAYAN, TANGGAMUS, LAMPUNG",8,110,29,139
https://kawalpemilu.org#24102,"KILUAN NEGERI, KLUMBAYAN, TANGGAMUS, LAMPUNG",1,93,99,192
https://kawalpemilu.org#24102,"KILUAN NEGERI, KLUMBAYAN, TANGGAMUS, LAMPUNG",2,138,27,165
https://kawalpemilu.org#24102,"KILUAN NEGERI, KLUMBAYAN, TANGGAMUS, LAMPUNG",3,162,47,209
https://kawalpemilu.org#24102,"KILUAN NEGERI, KLUMBAYAN, TANGGAMUS, LAMPUNG",4,136,62,198
https://kawalpemilu.org#24102,"KILUAN NEGERI, KLUMBAYAN, TANGGAMUS, LAMPUNG",5,14,7,21
https://kawalpemilu.org#24104,"BELU, KOTA AGUNG BARAT, TANGGAMUS, LAMPUNG",1,43,103,146
https://kawalpemilu.org#24104,"BELU, KOTA AGUNG BARAT, TANGGAMUS, LAMPUNG",2,23,109,132
https://kawalpemilu.org#24104,"BELU, KOTA AGUNG BARAT, TANGGAMUS, LAMPUNG",3,33,111,144
https://kawalpemilu.org#24104,"BELU, KOTA AGUNG BARAT, TANGGAMUS, LAMPUNG",4,29,83,112
https://kawalpemilu.org#24104,"BELU, KOTA AGUNG BARAT, TANGGAMUS, LAMPUNG",5,9,101,110
https://kawalpemilu.org#24105,"NEGARA BATIN, KOTA AGUNG BARAT, TANGGAMUS, LAMPUNG",1,49,182,231
https://kawalpemilu.org#24105,"NEGARA BATIN, KOTA AGUNG BARAT, TANGGAMUS, LAMPUNG",2,76,90,166
https://kawalpemilu.org#24105,"NEGARA BATIN, KOTA AGUNG BARAT, TANGGAMUS, LAMPUNG",3,47,145,192
https://kawalpemilu.org#24105,"NEGARA BATIN, KOTA AGUNG BARAT, TANGGAMUS, LAMPUNG",4,24,147,171
https://kawalpemilu.org#24105,"NEGARA BATIN, KOTA AGUNG BARAT, TANGGAMUS, LAMPUNG",5,20,72,92
https://kawalpemilu.org#24105,"NEGARA BATIN, KOTA AGUNG BARAT, TANGGAMUS, LAMPUNG",6,27,114,141
https://kawalpemilu.org#24105,"NEGARA BATIN, KOTA AGUNG BARAT, TANGGAMUS, LAMPUNG",7,31,113,144
https://kawalpemilu.org#24105,"NEGARA BATIN, KOTA AGUNG BARAT, TANGGAMUS, LAMPUNG",8,31,112,143
https://kawalpemilu.org#24106,"BANJARMASIN, KOTA AGUNG BARAT, TANGGAMUS, LAMPUNG",1,24,103,127
https://kawalpemilu.org#24106,"BANJARMASIN, KOTA AGUNG BARAT, TANGGAMUS, LAMPUNG",2,4,95,99
https://kawalpemilu.org#24106,"BANJARMASIN, KOTA AGUNG BARAT, TANGGAMUS, LAMPUNG",3,45,125,170
https://kawalpemilu.org#24106,"BANJARMASIN, KOTA AGUNG BARAT, TANGGAMUS, LAMPUNG",4,26,118,144
https://kawalpemilu.org#24106,"BANJARMASIN, KOTA AGUNG BARAT, TANGGAMUS, LAMPUNG",5,11,178,198
https://kawalpemilu.org#24106,"BANJARMASIN, KOTA AGUNG BARAT, TANGGAMUS, LAMPUNG",6,16,114,130
https://kawalpemilu.org#24106,"BANJARMASIN, KOTA AGUNG BARAT, TANGGAMUS, LAMPUNG",7,28,89,117
https://kawalpemilu.org#24106,"BANJARMASIN, KOTA AGUNG BARAT, TANGGAMUS, LAMPUNG",8,26,129,155
https://kawalpemilu.org#24107,"KANYANGAN, KOTA AGUNG BARAT, TANGGAMUS, LAMPUNG",1,50,135,185
https://kawalpemilu.org#24107,"KANYANGAN, KOTA AGUNG BARAT, TANGGAMUS, LAMPUNG",2,58,110,168
https://kawalpemilu.org#24107,"KANYANGAN, KOTA AGUNG BARAT, TANGGAMUS, LAMPUNG",3,35,201,236
https://kawalpemilu.org#24107,"KANYANGAN, KOTA AGUNG BARAT, TANGGAMUS, LAMPUNG",4,20,118,138
https://kawalpemilu.org#24107,"KANYANGAN, KOTA AGUNG BARAT, TANGGAMUS, LAMPUNG",5,36,96,132
https://kawalpemilu.org#24108,"KANDANG BESI, KOTA AGUNG BARAT, TANGGAMUS, LAMPUNG",1,12,116,128
https://kawalpemilu.org#24108,"KANDANG BESI, KOTA AGUNG BARAT, TANGGAMUS, LAMPUNG",2,10,94,104
https://kawalpemilu.org#24108,"KANDANG BESI, KOTA AGUNG BARAT, TANGGAMUS, LAMPUNG",3,3,95,98
https://kawalpemilu.org#24108,"KANDANG BESI, KOTA AGUNG BARAT, TANGGAMUS, LAMPUNG",4,17,96,113
https://kawalpemilu.org#24108,"KANDANG BESI, KOTA AGUNG BARAT, TANGGAMUS, LAMPUNG",5,14,96,110
https://kawalpemilu.org#24108,"KANDANG BESI, KOTA AGUNG BARAT, TANGGAMUS, LAMPUNG",6,15,148,163
https://kawalpemilu.org#24108,"KANDANG BESI, KOTA AGUNG BARAT, TANGGAMUS, LAMPUNG",7,13,69,82
https://kawalpemilu.org#24108,"KANDANG BESI, KOTA AGUNG BARAT, TANGGAMUS, LAMPUNG",8,8,71,79
https://kawalpemilu.org#24108,"KANDANG BESI, KOTA AGUNG BARAT, TANGGAMUS, LAMPUNG",9,8,95,103
https://kawalpemilu.org#24108,"KANDANG BESI, KOTA AGUNG BARAT, TANGGAMUS, LAMPUNG",10,12,109,121
https://kawalpemilu.org#24108,"KANDANG BESI, KOTA AGUNG BARAT, TANGGAMUS, LAMPUNG",11,14,83,97
https://kawalpemilu.org#24109,"TEBA BUNUK, KOTA AGUNG BARAT, TANGGAMUS, LAMPUNG",1,74,120,194
https://kawalpemilu.org#24109,"TEBA BUNUK, KOTA AGUNG BARAT, TANGGAMUS, LAMPUNG",2,29,92,121
https://kawalpemilu.org#24109,"TEBA BUNUK, KOTA AGUNG BARAT, TANGGAMUS, LAMPUNG",3,52,122,174
https://kawalpemilu.org#24109,"TEBA BUNUK, KOTA AGUNG BARAT, TANGGAMUS, LAMPUNG",4,16,39,55
https://kawalpemilu.org#24110,"WAY GELANG, KOTA AGUNG BARAT, TANGGAMUS, LAMPUNG",1,46,126,172
https://kawalpemilu.org#24110,"WAY GELANG, KOTA AGUNG BARAT, TANGGAMUS, LAMPUNG",2,88,99,1
https://kawalpemilu.org#24110,"WAY GELANG, KOTA AGUNG BARAT, TANGGAMUS, LAMPUNG",3,42,46,88
https://kawalpemilu.org#24110,"WAY GELANG, KOTA AGUNG BARAT, TANGGAMUS, LAMPUNG",4,78,58,136
https://kawalpemilu.org#24110,"WAY GELANG, KOTA AGUNG BARAT, TANGGAMUS, LAMPUNG",5,68,76,134
https://kawalpemilu.org#24110,"WAY GELANG, KOTA AGUNG BARAT, TANGGAMUS, LAMPUNG",6,41,83,124
https://kawalpemilu.org#24110,"WAY GELANG, KOTA AGUNG BARAT, TANGGAMUS, LAMPUNG",7,59,76,135
https://kawalpemilu.org#24111,"TALAGENING, KOTA AGUNG BARAT, TANGGAMUS, LAMPUNG",1,28,125,153
https://kawalpemilu.org#24111,"TALAGENING, KOTA AGUNG BARAT, TANGGAMUS, LAMPUNG",2,73,91,164
https://kawalpemilu.org#24111,"TALAGENING, KOTA AGUNG BARAT, TANGGAMUS, LAMPUNG",3,115,71,186
https://kawalpemilu.org#24111,"TALAGENING, KOTA AGUNG BARAT, TANGGAMUS, LAMPUNG",4,26,79,105
https://kawalpemilu.org#24111,"TALAGENING, KOTA AGUNG BARAT, TANGGAMUS, LAMPUNG",5,60,100,160
https://kawalpemilu.org#24111,"TALAGENING, KOTA AGUNG BARAT, TANGGAMUS, LAMPUNG",6,47,92,139
https://kawalpemilu.org#24112,"GEDUNG JAMBU, KOTA AGUNG BARAT, TANGGAMUS, LAMPUNG",1,33,114,147
https://kawalpemilu.org#24112,"GEDUNG JAMBU, KOTA AGUNG BARAT, TANGGAMUS, LAMPUNG",2,34,111,145
https://kawalpemilu.org#24112,"GEDUNG JAMBU, KOTA AGUNG BARAT, TANGGAMUS, LAMPUNG",3,38,66,104
https://kawalpemilu.org#24113,"MAJA, KOTA AGUNG BARAT, TANGGAMUS, LAMPUNG",1,29,124,153
https://kawalpemilu.org#24113,"MAJA, KOTA AGUNG BARAT, TANGGAMUS, LAMPUNG",2,18,85,103
https://kawalpemilu.org#24114,"PULAU BENAWANG, KOTA AGUNG BARAT, TANGGAMUS, LAMPUNG",1,24,68,92
https://kawalpemilu.org#24114,"PULAU BENAWANG, KOTA AGUNG BARAT, TANGGAMUS, LAMPUNG",2,80,128,208
https://kawalpemilu.org#24114,"PULAU BENAWANG, KOTA AGUNG BARAT, TANGGAMUS, LAMPUNG",3,36,86,122
https://kawalpemilu.org#24115,"PAYUNG, KOTA AGUNG BARAT, TANGGAMUS, LAMPUNG",1,34,209,243
https://kawalpemilu.org#24115,"PAYUNG, KOTA AGUNG BARAT, TANGGAMUS, LAMPUNG",2,55,75,130
https://kawalpemilu.org#24115,"PAYUNG, KOTA AGUNG BARAT, TANGGAMUS, LAMPUNG",3,23,145,168
https://kawalpemilu.org#24115,"PAYUNG, KOTA AGUNG BARAT, TANGGAMUS, LAMPUNG",4,30,119,149
https://kawalpemilu.org#24115,"PAYUNG, KOTA AGUNG BARAT, TANGGAMUS, LAMPUNG",5,49,31,80
https://kawalpemilu.org#24116,"KESUGIHAN, KOTA AGUNG BARAT, TANGGAMUS, LAMPUNG",1,28,120,148
https://kawalpemilu.org#24116,"KESUGIHAN, KOTA AGUNG BARAT, TANGGAMUS, LAMPUNG",2,42,126,168
https://kawalpemilu.org#24117,"PEJAJARAN, KOTA AGUNG BARAT, TANGGAMUS, LAMPUNG",1,40,93,133
https://kawalpemilu.org#24117,"PEJAJARAN, KOTA AGUNG BARAT, TANGGAMUS, LAMPUNG",2,31,124,155
https://kawalpemilu.org#24117,"PEJAJARAN, KOTA AGUNG BARAT, TANGGAMUS, LAMPUNG",3,44,104,148
https://kawalpemilu.org#24117,"PEJAJARAN, KOTA AGUNG BARAT, TANGGAMUS, LAMPUNG",4,27,89,116
https://kawalpemilu.org#24118,"KALI MIRING, KOTA AGUNG BARAT, TANGGAMUS, LAMPUNG",1,46,177,223
https://kawalpemilu.org#24118,"KALI MIRING, KOTA AGUNG BARAT, TANGGAMUS, LAMPUNG",2,78,92,170
https://kawalpemilu.org#24118,"KALI MIRING, KOTA AGUNG BARAT, TANGGAMUS, LAMPUNG",3,82,92,174
https://kawalpemilu.org#24118,"KALI MIRING, KOTA AGUNG BARAT, TANGGAMUS, LAMPUNG",4,66,90,156
https://kawalpemilu.org#24118,"KALI MIRING, KOTA AGUNG BARAT, TANGGAMUS, LAMPUNG",5,60,93,2
https://kawalpemilu.org#24119,"TANJUNG AGUNG, KOTA AGUNG BARAT, TANGGAMUS, LAMPUNG",1,80,152,232
https://kawalpemilu.org#24119,"TANJUNG AGUNG, KOTA AGUNG BARAT, TANGGAMUS, LAMPUNG",2,105,117,222
https://kawalpemilu.org#24119,"TANJUNG AGUNG, KOTA AGUNG BARAT, TANGGAMUS, LAMPUNG",3,157,76,233
https://kawalpemilu.org#24121,"BATU KERAMAT, KOTA AGUNG TIMUR, TANGGAMUS, LAMPUNG",1,107,62,169
https://kawalpemilu.org#24121,"BATU KERAMAT, KOTA AGUNG TIMUR, TANGGAMUS, LAMPUNG",2,97,71,168
https://kawalpemilu.org#24121,"BATU KERAMAT, KOTA AGUNG TIMUR, TANGGAMUS, LAMPUNG",3,127,41,168
https://kawalpemilu.org#24121,"BATU KERAMAT, KOTA AGUNG TIMUR, TANGGAMUS, LAMPUNG",4,85,77,162
https://kawalpemilu.org#24121,"BATU KERAMAT, KOTA AGUNG TIMUR, TANGGAMUS, LAMPUNG",5,174,0,174
https://kawalpemilu.org#24122,"KAMPUNG BARU, KOTA AGUNG TIMUR, TANGGAMUS, LAMPUNG",1,72,122,194
https://kawalpemilu.org#24122,"KAMPUNG BARU, KOTA AGUNG TIMUR, TANGGAMUS, LAMPUNG",2,51,157,208
https://kawalpemilu.org#24122,"KAMPUNG BARU, KOTA AGUNG TIMUR, TANGGAMUS, LAMPUNG",3,60,98,158
https://kawalpemilu.org#24122,"KAMPUNG BARU, KOTA AGUNG TIMUR, TANGGAMUS, LAMPUNG",4,35,153,188
https://kawalpemilu.org#24122,"KAMPUNG BARU, KOTA AGUNG TIMUR, TANGGAMUS, LAMPUNG",5,60,79,139
https://kawalpemilu.org#24122,"KAMPUNG BARU, KOTA AGUNG TIMUR, TANGGAMUS, LAMPUNG",6,107,93,200
https://kawalpemilu.org#24122,"KAMPUNG BARU, KOTA AGUNG TIMUR, TANGGAMUS, LAMPUNG",7,85,66,151
https://kawalpemilu.org#24122,"KAMPUNG BARU, KOTA AGUNG TIMUR, TANGGAMUS, LAMPUNG",8,95,99,194
https://kawalpemilu.org#24122,"KAMPUNG BARU, KOTA AGUNG TIMUR, TANGGAMUS, LAMPUNG",9,32,122,154
https://kawalpemilu.org#24123,"UMBUL BUAH, KOTA AGUNG TIMUR, TANGGAMUS, LAMPUNG",1,43,116,159
https://kawalpemilu.org#24123,"UMBUL BUAH, KOTA AGUNG TIMUR, TANGGAMUS, LAMPUNG",2,23,91,114
https://kawalpemilu.org#24123,"UMBUL BUAH, KOTA AGUNG TIMUR, TANGGAMUS, LAMPUNG",3,78,72,150
https://kawalpemilu.org#24123,"UMBUL BUAH, KOTA AGUNG TIMUR, TANGGAMUS, LAMPUNG",4,23,124,147
https://kawalpemilu.org#24123,"UMBUL BUAH, KOTA AGUNG TIMUR, TANGGAMUS, LAMPUNG",5,27,82,109
https://kawalpemilu.org#24123,"UMBUL BUAH, KOTA AGUNG TIMUR, TANGGAMUS, LAMPUNG",6,80,63,143
https://kawalpemilu.org#24124,"MENGGALA, KOTA AGUNG TIMUR, TANGGAMUS, LAMPUNG",1,47,145,192
https://kawalpemilu.org#24124,"MENGGALA, KOTA AGUNG TIMUR, TANGGAMUS, LAMPUNG",2,53,106,159
https://kawalpemilu.org#24124,"MENGGALA, KOTA AGUNG TIMUR, TANGGAMUS, LAMPUNG",3,57,139,196
https://kawalpemilu.org#24125,"MULANG MAYA, KOTA AGUNG TIMUR, TANGGAMUS, LAMPUNG",1,57,78,135
https://kawalpemilu.org#24125,"MULANG MAYA, KOTA AGUNG TIMUR, TANGGAMUS, LAMPUNG",2,32,87,119
https://kawalpemilu.org#24125,"MULANG MAYA, KOTA AGUNG TIMUR, TANGGAMUS, LAMPUNG",3,35,113,148
https://kawalpemilu.org#24125,"MULANG MAYA, KOTA AGUNG TIMUR, TANGGAMUS, LAMPUNG",4,27,128,155
https://kawalpemilu.org#24125,"MULANG MAYA, KOTA AGUNG TIMUR, TANGGAMUS, LAMPUNG",5,31,150,181
https://kawalpemilu.org#24125,"MULANG MAYA, KOTA AGUNG TIMUR, TANGGAMUS, LAMPUNG",6,23,66,89
https://kawalpemilu.org#24126,"SUKA BANJAR, KOTA AGUNG TIMUR, TANGGAMUS, LAMPUNG",1,58,130,188
https://kawalpemilu.org#24126,"SUKA BANJAR, KOTA AGUNG TIMUR, TANGGAMUS, LAMPUNG",2,92,83,175
https://kawalpemilu.org#24126,"SUKA BANJAR, KOTA AGUNG TIMUR, TANGGAMUS, LAMPUNG",3,80,119,199
https://kawalpemilu.org#24126,"SUKA BANJAR, KOTA AGUNG TIMUR, TANGGAMUS, LAMPUNG",4,81,51,132
https://kawalpemilu.org#24126,"SUKA BANJAR, KOTA AGUNG TIMUR, TANGGAMUS, LAMPUNG",5,58,48,106
https://kawalpemilu.org#24126,"SUKA BANJAR, KOTA AGUNG TIMUR, TANGGAMUS, LAMPUNG",6,65,39,104
https://kawalpemilu.org#24126,"SUKA BANJAR, KOTA AGUNG TIMUR, TANGGAMUS, LAMPUNG",7,48,46,94
https://kawalpemilu.org#24127,"TANJUNG ANOM, KOTA AGUNG TIMUR, TANGGAMUS, LAMPUNG",1,113,98,211
https://kawalpemilu.org#24127,"TANJUNG ANOM, KOTA AGUNG TIMUR, TANGGAMUS, LAMPUNG",2,121,86,207
https://kawalpemilu.org#24127,"TANJUNG ANOM, KOTA AGUNG TIMUR, TANGGAMUS, LAMPUNG",3,145,70,215
https://kawalpemilu.org#24127,"TANJUNG ANOM, KOTA AGUNG TIMUR, TANGGAMUS, LAMPUNG",4,159,43,202
https://kawalpemilu.org#24127,"TANJUNG ANOM, KOTA AGUNG TIMUR, TANGGAMUS, LAMPUNG",5,122,112,234
https://kawalpemilu.org#24127,"TANJUNG ANOM, KOTA AGUNG TIMUR, TANGGAMUS, LAMPUNG",6,88,111,199
https://kawalpemilu.org#24127,"TANJUNG ANOM, KOTA AGUNG TIMUR, TANGGAMUS, LAMPUNG",7,97,78,175
https://kawalpemilu.org#24127,"TANJUNG ANOM, KOTA AGUNG TIMUR, TANGGAMUS, LAMPUNG",8,114,64,178
https://kawalpemilu.org#24128,"KAGUNGAN, KOTA AGUNG TIMUR, TANGGAMUS, LAMPUNG",1,41,83,124
https://kawalpemilu.org#24128,"KAGUNGAN, KOTA AGUNG TIMUR, TANGGAMUS, LAMPUNG",2,47,116,163
https://kawalpemilu.org#24128,"KAGUNGAN, KOTA AGUNG TIMUR, TANGGAMUS, LAMPUNG",3,63,152,215
https://kawalpemilu.org#24128,"KAGUNGAN, KOTA AGUNG TIMUR, TANGGAMUS, LAMPUNG",4,25,75,100
https://kawalpemilu.org#24128,"KAGUNGAN, KOTA AGUNG TIMUR, TANGGAMUS, LAMPUNG",5,44,93,137
https://kawalpemilu.org#24128,"KAGUNGAN, KOTA AGUNG TIMUR, TANGGAMUS, LAMPUNG",6,90,101,191
https://kawalpemilu.org#24128,"KAGUNGAN, KOTA AGUNG TIMUR, TANGGAMUS, LAMPUNG",7,88,155,243
https://kawalpemilu.org#24128,"KAGUNGAN, KOTA AGUNG TIMUR, TANGGAMUS, LAMPUNG",8,45,106,151
https://kawalpemilu.org#24128,"KAGUNGAN, KOTA AGUNG TIMUR, TANGGAMUS, LAMPUNG",9,26,105,131
https://kawalpemilu.org#24128,"KAGUNGAN, KOTA AGUNG TIMUR, TANGGAMUS, LAMPUNG",10,30,87,117
https://kawalpemilu.org#24129,"KARTA, KOTA AGUNG TIMUR, TANGGAMUS, LAMPUNG",1,50,71,121
https://kawalpemilu.org#24129,"KARTA, KOTA AGUNG TIMUR, TANGGAMUS, LAMPUNG",2,50,78,128
https://kawalpemilu.org#24129,"KARTA, KOTA AGUNG TIMUR, TANGGAMUS, LAMPUNG",3,63,104,167
https://kawalpemilu.org#24129,"KARTA, KOTA AGUNG TIMUR, TANGGAMUS, LAMPUNG",4,39,81,120
https://kawalpemilu.org#24129,"KARTA, KOTA AGUNG TIMUR, TANGGAMUS, LAMPUNG",5,45,74,119
https://kawalpemilu.org#24129,"KARTA, KOTA AGUNG TIMUR, TANGGAMUS, LAMPUNG",6,94,50,144
https://kawalpemilu.org#24130,"TEBA, KOTA AGUNG TIMUR, TANGGAMUS, LAMPUNG",1,37,109,146
https://kawalpemilu.org#24130,"TEBA, KOTA AGUNG TIMUR, TANGGAMUS, LAMPUNG",2,49,123,172
https://kawalpemilu.org#24130,"TEBA, KOTA AGUNG TIMUR, TANGGAMUS, LAMPUNG",3,46,125,171
https://kawalpemilu.org#24131,"TALANG REJO, KOTA AGUNG TIMUR, TANGGAMUS, LAMPUNG",1,120,117,237
https://kawalpemilu.org#24131,"TALANG REJO, KOTA AGUNG TIMUR, TANGGAMUS, LAMPUNG",2,112,109,221
https://kawalpemilu.org#24131,"TALANG REJO, KOTA AGUNG TIMUR, TANGGAMUS, LAMPUNG",3,124,32,156
https://kawalpemilu.org#24131,"TALANG REJO, KOTA AGUNG TIMUR, TANGGAMUS, LAMPUNG",4,133,42,175
https://kawalpemilu.org#84819,"TANJUNG JATI, KOTA AGUNG TIMUR, TANGGAMUS, LAMPUNG",1,45,130,175
https://kawalpemilu.org#84819,"TANJUNG JATI, KOTA AGUNG TIMUR, TANGGAMUS, LAMPUNG",2,67,94,161
https://kawalpemilu.org#84819,"TANJUNG JATI, KOTA AGUNG TIMUR, TANGGAMUS, LAMPUNG",3,69,89,158
https://kawalpemilu.org#84819,"TANJUNG JATI, KOTA AGUNG TIMUR, TANGGAMUS, LAMPUNG",4,106,78,184
https://kawalpemilu.org#84819,"TANJUNG JATI, KOTA AGUNG TIMUR, TANGGAMUS, LAMPUNG",5,71,85,156
https://kawalpemilu.org#24133,"BANJAR MANIS, GISTING, TANGGAMUS, LAMPUNG",1,86,126,212
https://kawalpemilu.org#24133,"BANJAR MANIS, GISTING, TANGGAMUS, LAMPUNG",2,43,170,213
https://kawalpemilu.org#24133,"BANJAR MANIS, GISTING, TANGGAMUS, LAMPUNG",3,22,125,147
https://kawalpemilu.org#24133,"BANJAR MANIS, GISTING, TANGGAMUS, LAMPUNG",4,97,72,169
https://kawalpemilu.org#24133,"BANJAR MANIS, GISTING, TANGGAMUS, LAMPUNG",5,105,61,166
https://kawalpemilu.org#24133,"BANJAR MANIS, GISTING, TANGGAMUS, LAMPUNG",6,63,97,160
https://kawalpemilu.org#24133,"BANJAR MANIS, GISTING, TANGGAMUS, LAMPUNG",7,12,70,82
https://kawalpemilu.org#24133,"BANJAR MANIS, GISTING, TANGGAMUS, LAMPUNG",8,37,87,124
https://kawalpemilu.org#24134,"CAMPANG, GISTING, TANGGAMUS, LAMPUNG",1,153,85,238
https://kawalpemilu.org#24134,"CAMPANG, GISTING, TANGGAMUS, LAMPUNG",2,166,75,241
https://kawalpemilu.org#24134,"CAMPANG, GISTING, TANGGAMUS, LAMPUNG",3,135,61,196
https://kawalpemilu.org#24134,"CAMPANG, GISTING, TANGGAMUS, LAMPUNG",4,137,85,222
https://kawalpemilu.org#24134,"CAMPANG, GISTING, TANGGAMUS, LAMPUNG",5,161,69,230
https://kawalpemilu.org#24134,"CAMPANG, GISTING, TANGGAMUS, LAMPUNG",6,123,90,213
https://kawalpemilu.org#24134,"CAMPANG, GISTING, TANGGAMUS, LAMPUNG",7,75,80,155
https://kawalpemilu.org#24134,"CAMPANG, GISTING, TANGGAMUS, LAMPUNG",8,63,69,132
https://kawalpemilu.org#24134,"CAMPANG, GISTING, TANGGAMUS, LAMPUNG",9,59,75,134
https://kawalpemilu.org#24134,"CAMPANG, GISTING, TANGGAMUS, LAMPUNG",10,136,92,228
https://kawalpemilu.org#24134,"CAMPANG, GISTING, TANGGAMUS, LAMPUNG",11,102,78,180
https://kawalpemilu.org#24134,"CAMPANG, GISTING, TANGGAMUS, LAMPUNG",12,87,62,149
https://kawalpemilu.org#24135,"KUTA DALOM, GISTING, TANGGAMUS, LAMPUNG",1,32,157,189
https://kawalpemilu.org#24135,"KUTA DALOM, GISTING, TANGGAMUS, LAMPUNG",2,61,148,209
https://kawalpemilu.org#24135,"KUTA DALOM, GISTING, TANGGAMUS, LAMPUNG",3,48,124,172
https://kawalpemilu.org#24135,"KUTA DALOM, GISTING, TANGGAMUS, LAMPUNG",4,79,72,151
https://kawalpemilu.org#24135,"KUTA DALOM, GISTING, TANGGAMUS, LAMPUNG",5,117,87,204
https://kawalpemilu.org#24135,"KUTA DALOM, GISTING, TANGGAMUS, LAMPUNG",6,144,74,218
https://kawalpemilu.org#24135,"KUTA DALOM, GISTING, TANGGAMUS, LAMPUNG",7,162,53,215
https://kawalpemilu.org#24135,"KUTA DALOM, GISTING, TANGGAMUS, LAMPUNG",8,66,69,135
https://kawalpemilu.org#24135,"KUTA DALOM, GISTING, TANGGAMUS, LAMPUNG",9,96,110,206
https://kawalpemilu.org#24135,"KUTA DALOM, GISTING, TANGGAMUS, LAMPUNG",10,35,83,118
https://kawalpemilu.org#24135,"KUTA DALOM, GISTING, TANGGAMUS, LAMPUNG",11,134,47,181
https://kawalpemilu.org#24135,"KUTA DALOM, GISTING, TANGGAMUS, LAMPUNG",12,56,73,129
https://kawalpemilu.org#24136,"PURWODADI, GISTING, TANGGAMUS, LAMPUNG",1,107,53,160
https://kawalpemilu.org#24136,"PURWODADI, GISTING, TANGGAMUS, LAMPUNG",2,99,73,172
https://kawalpemilu.org#24136,"PURWODADI, GISTING, TANGGAMUS, LAMPUNG",3,64,103,167
https://kawalpemilu.org#24136,"PURWODADI, GISTING, TANGGAMUS, LAMPUNG",4,96,115,211
https://kawalpemilu.org#24136,"PURWODADI, GISTING, TANGGAMUS, LAMPUNG",5,104,79,183
https://kawalpemilu.org#24136,"PURWODADI, GISTING, TANGGAMUS, LAMPUNG",6,148,66,214
https://kawalpemilu.org#24136,"PURWODADI, GISTING, TANGGAMUS, LAMPUNG",7,99,120,219
https://kawalpemilu.org#24136,"PURWODADI, GISTING, TANGGAMUS, LAMPUNG",8,61,106,167
https://kawalpemilu.org#24136,"PURWODADI, GISTING, TANGGAMUS, LAMPUNG",9,56,64,120
https://kawalpemilu.org#24136,"PURWODADI, GISTING, TANGGAMUS, LAMPUNG",10,69,95,164
https://kawalpemilu.org#24136,"PURWODADI, GISTING, TANGGAMUS, LAMPUNG",11,57,95,152
https://kawalpemilu.org#24136,"PURWODADI, GISTING, TANGGAMUS, LAMPUNG",12,87,94,181
https://kawalpemilu.org#24136,"PURWODADI, GISTING, TANGGAMUS, LAMPUNG",13,53,84,137
https://kawalpemilu.org#24136,"PURWODADI, GISTING, TANGGAMUS, LAMPUNG",14,39,107,146
https://kawalpemilu.org#24136,"PURWODADI, GISTING, TANGGAMUS, LAMPUNG",15,86,95,181
https://kawalpemilu.org#24136,"PURWODADI, GISTING, TANGGAMUS, LAMPUNG",16,61,76,137
https://kawalpemilu.org#24136,"PURWODADI, GISTING, TANGGAMUS, LAMPUNG",17,81,101,182
https://kawalpemilu.org#24136,"PURWODADI, GISTING, TANGGAMUS, LAMPUNG",18,88,67,155
https://kawalpemilu.org#24136,"PURWODADI, GISTING, TANGGAMUS, LAMPUNG",19,63,88,151
https://kawalpemilu.org#24136,"PURWODADI, GISTING, TANGGAMUS, LAMPUNG",20,86,49,135
https://kawalpemilu.org#24136,"PURWODADI, GISTING, TANGGAMUS, LAMPUNG",21,74,62,136
https://kawalpemilu.org#24136,"PURWODADI, GISTING, TANGGAMUS, LAMPUNG",22,69,75,144
https://kawalpemilu.org#24136,"PURWODADI, GISTING, TANGGAMUS, LAMPUNG",23,73,89,162
https://kawalpemilu.org#24136,"PURWODADI, GISTING, TANGGAMUS, LAMPUNG",24,64,77,141
https://kawalpemilu.org#24137,"GISTING BAWAH, GISTING, TANGGAMUS, LAMPUNG",1,125,75,200
https://kawalpemilu.org#24137,"GISTING BAWAH, GISTING, TANGGAMUS, LAMPUNG",2,138,69,207
https://kawalpemilu.org#24137,"GISTING BAWAH, GISTING, TANGGAMUS, LAMPUNG",3,106,97,203
https://kawalpemilu.org#24137,"GISTING BAWAH, GISTING, TANGGAMUS, LAMPUNG",4,123,81,204
https://kawalpemilu.org#24137,"GISTING BAWAH, GISTING, TANGGAMUS, LAMPUNG",5,152,33,185
https://kawalpemilu.org#24137,"GISTING BAWAH, GISTING, TANGGAMUS, LAMPUNG",6,165,30,195
https://kawalpemilu.org#24137,"GISTING BAWAH, GISTING, TANGGAMUS, LAMPUNG",7,74,16,90
https://kawalpemilu.org#24137,"GISTING BAWAH, GISTING, TANGGAMUS, LAMPUNG",8,141,45,186
https://kawalpemilu.org#24137,"GISTING BAWAH, GISTING, TANGGAMUS, LAMPUNG",9,128,73,201
https://kawalpemilu.org#24137,"GISTING BAWAH, GISTING, TANGGAMUS, LAMPUNG",10,112,104,216
https://kawalpemilu.org#24137,"GISTING BAWAH, GISTING, TANGGAMUS, LAMPUNG",11,85,126,211
https://kawalpemilu.org#24137,"GISTING BAWAH, GISTING, TANGGAMUS, LAMPUNG",12,75,155,230
https://kawalpemilu.org#24137,"GISTING BAWAH, GISTING, TANGGAMUS, LAMPUNG",13,102,124,226
https://kawalpemilu.org#24137,"GISTING BAWAH, GISTING, TANGGAMUS, LAMPUNG",14,154,85,239
https://kawalpemilu.org#24137,"GISTING BAWAH, GISTING, TANGGAMUS, LAMPUNG",15,97,60,157
https://kawalpemilu.org#24137,"GISTING BAWAH, GISTING, TANGGAMUS, LAMPUNG",16,106,87,193
https://kawalpemilu.org#24137,"GISTING BAWAH, GISTING, TANGGAMUS, LAMPUNG",17,100,52,152
https://kawalpemilu.org#24137,"GISTING BAWAH, GISTING, TANGGAMUS, LAMPUNG",18,92,58,150
https://kawalpemilu.org#24137,"GISTING BAWAH, GISTING, TANGGAMUS, LAMPUNG",19,78,15,93
https://kawalpemilu.org#24137,"GISTING BAWAH, GISTING, TANGGAMUS, LAMPUNG",20,77,55,132
https://kawalpemilu.org#24137,"GISTING BAWAH, GISTING, TANGGAMUS, LAMPUNG",21,76,51,127
https://kawalpemilu.org#24137,"GISTING BAWAH, GISTING, TANGGAMUS, LAMPUNG",22,57,74,131
https://kawalpemilu.org#24137,"GISTING BAWAH, GISTING, TANGGAMUS, LAMPUNG",23,82,102,184
https://kawalpemilu.org#24137,"GISTING BAWAH, GISTING, TANGGAMUS, LAMPUNG",24,93,47,140
https://kawalpemilu.org#24138,"GISTING ATAS, GISTING, TANGGAMUS, LAMPUNG",1,130,81,211
https://kawalpemilu.org#24138,"GISTING ATAS, GISTING, TANGGAMUS, LAMPUNG",2,142,72,214
https://kawalpemilu.org#24138,"GISTING ATAS, GISTING, TANGGAMUS, LAMPUNG",3,109,67,176
https://kawalpemilu.org#24138,"GISTING ATAS, GISTING, TANGGAMUS, LAMPUNG",4,178,80,258
https://kawalpemilu.org#24138,"GISTING ATAS, GISTING, TANGGAMUS, LAMPUNG",5,175,79,254
https://kawalpemilu.org#24138,"GISTING ATAS, GISTING, TANGGAMUS, LAMPUNG",6,111,53,164
https://kawalpemilu.org#24138,"GISTING ATAS, GISTING, TANGGAMUS, LAMPUNG",7,138,83,221
https://kawalpemilu.org#24138,"GISTING ATAS, GISTING, TANGGAMUS, LAMPUNG",8,142,67,209
https://kawalpemilu.org#24138,"GISTING ATAS, GISTING, TANGGAMUS, LAMPUNG",9,103,71,174
https://kawalpemilu.org#24138,"GISTING ATAS, GISTING, TANGGAMUS, LAMPUNG",10,134,74,208
https://kawalpemilu.org#24138,"GISTING ATAS, GISTING, TANGGAMUS, LAMPUNG",11,152,67,219
https://kawalpemilu.org#24138,"GISTING ATAS, GISTING, TANGGAMUS, LAMPUNG",12,142,33,175
https://kawalpemilu.org#24138,"GISTING ATAS, GISTING, TANGGAMUS, LAMPUNG",13,150,48,198
https://kawalpemilu.org#24138,"GISTING ATAS, GISTING, TANGGAMUS, LAMPUNG",14,201,61,262
https://kawalpemilu.org#24138,"GISTING ATAS, GISTING, TANGGAMUS, LAMPUNG",15,156,26,182
https://kawalpemilu.org#24138,"GISTING ATAS, GISTING, TANGGAMUS, LAMPUNG",16,103,30,133
https://kawalpemilu.org#24138,"GISTING ATAS, GISTING, TANGGAMUS, LAMPUNG",17,158,58,216
https://kawalpemilu.org#24138,"GISTING ATAS, GISTING, TANGGAMUS, LAMPUNG",18,150,56,206
https://kawalpemilu.org#24138,"GISTING ATAS, GISTING, TANGGAMUS, LAMPUNG",19,157,28,185
https://kawalpemilu.org#24138,"GISTING ATAS, GISTING, TANGGAMUS, LAMPUNG",20,127,51,178
https://kawalpemilu.org#24138,"GISTING ATAS, GISTING, TANGGAMUS, LAMPUNG",21,138,67,205
https://kawalpemilu.org#24138,"GISTING ATAS, GISTING, TANGGAMUS, LAMPUNG",22,81,39,120
https://kawalpemilu.org#24138,"GISTING ATAS, GISTING, TANGGAMUS, LAMPUNG",23,78,39,117
https://kawalpemilu.org#24138,"GISTING ATAS, GISTING, TANGGAMUS, LAMPUNG",24,64,19,87
https://kawalpemilu.org#24138,"GISTING ATAS, GISTING, TANGGAMUS, LAMPUNG",25,58,33,91
https://kawalpemilu.org#24139,"SIDOKATON, GISTING, TANGGAMUS, LAMPUNG",1,154,46,200
https://kawalpemilu.org#24139,"SIDOKATON, GISTING, TANGGAMUS, LAMPUNG",2,205,35,240
https://kawalpemilu.org#24139,"SIDOKATON, GISTING, TANGGAMUS, LAMPUNG",3,160,66,226
https://kawalpemilu.org#24139,"SIDOKATON, GISTING, TANGGAMUS, LAMPUNG",4,126,86,212
https://kawalpemilu.org#24140,"LANDBAW, GISTING, TANGGAMUS, LAMPUNG",1,101,53,154
https://kawalpemilu.org#24140,"LANDBAW, GISTING, TANGGAMUS, LAMPUNG",2,89,81,170
https://kawalpemilu.org#24140,"LANDBAW, GISTING, TANGGAMUS, LAMPUNG",3,118,68,186
https://kawalpemilu.org#24140,"LANDBAW, GISTING, TANGGAMUS, LAMPUNG",4,157,48,205
https://kawalpemilu.org#24140,"LANDBAW, GISTING, TANGGAMUS, LAMPUNG",5,99,59,158
https://kawalpemilu.org#24140,"LANDBAW, GISTING, TANGGAMUS, LAMPUNG",6,90,45,135
https://kawalpemilu.org#24140,"LANDBAW, GISTING, TANGGAMUS, LAMPUNG",7,137,53,190
https://kawalpemilu.org#24140,"LANDBAW, GISTING, TANGGAMUS, LAMPUNG",8,120,32,152
https://kawalpemilu.org#24140,"LANDBAW, GISTING, TANGGAMUS, LAMPUNG",9,92,54,146
https://kawalpemilu.org#24140,"LANDBAW, GISTING, TANGGAMUS, LAMPUNG",10,101,48,149
https://kawalpemilu.org#24140,"LANDBAW, GISTING, TANGGAMUS, LAMPUNG",11,147,60,207
https://kawalpemilu.org#24140,"LANDBAW, GISTING, TANGGAMUS, LAMPUNG",12,73,58,131
https://kawalpemilu.org#24140,"LANDBAW, GISTING, TANGGAMUS, LAMPUNG",13,82,38,120
https://kawalpemilu.org#24140,"LANDBAW, GISTING, TANGGAMUS, LAMPUNG",14,121,52,173
https://kawalpemilu.org#84820,"GISTING PERMAI, GISTING, TANGGAMUS, LAMPUNG",1,124,75,199
https://kawalpemilu.org#84820,"GISTING PERMAI, GISTING, TANGGAMUS, LAMPUNG",2,126,53,179
https://kawalpemilu.org#84820,"GISTING PERMAI, GISTING, TANGGAMUS, LAMPUNG",3,107,61,168
https://kawalpemilu.org#84820,"GISTING PERMAI, GISTING, TANGGAMUS, LAMPUNG",4,122,56,178
https://kawalpemilu.org#84820,"GISTING PERMAI, GISTING, TANGGAMUS, LAMPUNG",5,129,71,200
https://kawalpemilu.org#84820,"GISTING PERMAI, GISTING, TANGGAMUS, LAMPUNG",6,112,88,200
https://kawalpemilu.org#84820,"GISTING PERMAI, GISTING, TANGGAMUS, LAMPUNG",7,170,37,207
https://kawalpemilu.org#84820,"GISTING PERMAI, GISTING, TANGGAMUS, LAMPUNG",8,151,51,202
https://kawalpemilu.org#84820,"GISTING PERMAI, GISTING, TANGGAMUS, LAMPUNG",9,113,46,159
https://kawalpemilu.org#84820,"GISTING PERMAI, GISTING, TANGGAMUS, LAMPUNG",10,81,28,109
https://kawalpemilu.org#84820,"GISTING PERMAI, GISTING, TANGGAMUS, LAMPUNG",11,130,47,177
https://kawalpemilu.org#84820,"GISTING PERMAI, GISTING, TANGGAMUS, LAMPUNG",12,117,87,204
https://kawalpemilu.org#84820,"GISTING PERMAI, GISTING, TANGGAMUS, LAMPUNG",13,134,87,221
https://kawalpemilu.org#84820,"GISTING PERMAI, GISTING, TANGGAMUS, LAMPUNG",14,117,34,151
https://kawalpemilu.org#24142,"BANJAR NEGERI, GUNUNG ALIP, TANGGAMUS, LAMPUNG",1,30,171,201
https://kawalpemilu.org#24142,"BANJAR NEGERI, GUNUNG ALIP, TANGGAMUS, LAMPUNG",2,53,164,217
https://kawalpemilu.org#24142,"BANJAR NEGERI, GUNUNG ALIP, TANGGAMUS, LAMPUNG",3,47,132,179
https://kawalpemilu.org#24142,"BANJAR NEGERI, GUNUNG ALIP, TANGGAMUS, LAMPUNG",4,40,156,196
https://kawalpemilu.org#24142,"BANJAR NEGERI, GUNUNG ALIP, TANGGAMUS, LAMPUNG",5,48,135,183
https://kawalpemilu.org#24142,"BANJAR NEGERI, GUNUNG ALIP, TANGGAMUS, LAMPUNG",6,40,119,159
https://kawalpemilu.org#24142,"BANJAR NEGERI, GUNUNG ALIP, TANGGAMUS, LAMPUNG",7,42,167,209
https://kawalpemilu.org#24142,"BANJAR NEGERI, GUNUNG ALIP, TANGGAMUS, LAMPUNG",8,52,179,231
https://kawalpemilu.org#24142,"BANJAR NEGERI, GUNUNG ALIP, TANGGAMUS, LAMPUNG",9,53,78,132
https://kawalpemilu.org#24142,"BANJAR NEGERI, GUNUNG ALIP, TANGGAMUS, LAMPUNG",10,27,137,164
https://kawalpemilu.org#24142,"BANJAR NEGERI, GUNUNG ALIP, TANGGAMUS, LAMPUNG",11,52,64,116
https://kawalpemilu.org#24143,"SUKARAJA, GUNUNG ALIP, TANGGAMUS, LAMPUNG",1,30,140,170
https://kawalpemilu.org#24143,"SUKARAJA, GUNUNG ALIP, TANGGAMUS, LAMPUNG",2,41,115,156
https://kawalpemilu.org#24143,"SUKARAJA, GUNUNG ALIP, TANGGAMUS, LAMPUNG",3,58,108,166
https://kawalpemilu.org#24143,"SUKARAJA, GUNUNG ALIP, TANGGAMUS, LAMPUNG",4,67,110,177
https://kawalpemilu.org#24143,"SUKARAJA, GUNUNG ALIP, TANGGAMUS, LAMPUNG",5,42,162,204
https://kawalpemilu.org#24144,"BANJAR AGUNG, GUNUNG ALIP, TANGGAMUS, LAMPUNG",1,31,128,159
https://kawalpemilu.org#24144,"BANJAR AGUNG, GUNUNG ALIP, TANGGAMUS, LAMPUNG",2,25,112,137
https://kawalpemilu.org#24145,"KEDALOMAN, GUNUNG ALIP, TANGGAMUS, LAMPUNG",1,50,119,169
https://kawalpemilu.org#24145,"KEDALOMAN, GUNUNG ALIP, TANGGAMUS, LAMPUNG",2,35,138,173
https://kawalpemilu.org#24145,"KEDALOMAN, GUNUNG ALIP, TANGGAMUS, LAMPUNG",3,26,107,133
https://kawalpemilu.org#24145,"KEDALOMAN, GUNUNG ALIP, TANGGAMUS, LAMPUNG",4,13,197,210
https://kawalpemilu.org#24145,"KEDALOMAN, GUNUNG ALIP, TANGGAMUS, LAMPUNG",5,43,110,153
https://kawalpemilu.org#24145,"KEDALOMAN, GUNUNG ALIP, TANGGAMUS, LAMPUNG",6,59,86,145
https://kawalpemilu.org#24145,"KEDALOMAN, GUNUNG ALIP, TANGGAMUS, LAMPUNG",7,72,123,195
https://kawalpemilu.org#24145,"KEDALOMAN, GUNUNG ALIP, TANGGAMUS, LAMPUNG",8,101,145,246
https://kawalpemilu.org#24145,"KEDALOMAN, GUNUNG ALIP, TANGGAMUS, LAMPUNG",9,36,128,164
https://kawalpemilu.org#24145,"KEDALOMAN, GUNUNG ALIP, TANGGAMUS, LAMPUNG",10,72,82,154
https://kawalpemilu.org#24145,"KEDALOMAN, GUNUNG ALIP, TANGGAMUS, LAMPUNG",11,57,63,120
https://kawalpemilu.org#24146,"SUKABANJAR, GUNUNG ALIP, TANGGAMUS, LAMPUNG",1,85,136,221
https://kawalpemilu.org#24146,"SUKABANJAR, GUNUNG ALIP, TANGGAMUS, LAMPUNG",2,55,122,177
https://kawalpemilu.org#24146,"SUKABANJAR, GUNUNG ALIP, TANGGAMUS, LAMPUNG",3,34,140,174
https://kawalpemilu.org#24146,"SUKABANJAR, GUNUNG ALIP, TANGGAMUS, LAMPUNG",4,23,115,138
https://kawalpemilu.org#24146,"SUKABANJAR, GUNUNG ALIP, TANGGAMUS, LAMPUNG",5,16,149,165
https://kawalpemilu.org#24147,"SUKAMERNAH, GUNUNG ALIP, TANGGAMUS, LAMPUNG",1,16,160,176
https://kawalpemilu.org#24147,"SUKAMERNAH, GUNUNG ALIP, TANGGAMUS, LAMPUNG",2,18,149,167
https://kawalpemilu.org#24147,"SUKAMERNAH, GUNUNG ALIP, TANGGAMUS, LAMPUNG",3,41,180,221
https://kawalpemilu.org#24147,"SUKAMERNAH, GUNUNG ALIP, TANGGAMUS, LAMPUNG",4,41,145,186
https://kawalpemilu.org#24147,"SUKAMERNAH, GUNUNG ALIP, TANGGAMUS, LAMPUNG",5,45,109,154
https://kawalpemilu.org#24147,"SUKAMERNAH, GUNUNG ALIP, TANGGAMUS, LAMPUNG",6,12,134,146
https://kawalpemilu.org#24148,"CIHERANG, GUNUNG ALIP, TANGGAMUS, LAMPUNG",1,26,167,193
https://kawalpemilu.org#24148,"CIHERANG, GUNUNG ALIP, TANGGAMUS, LAMPUNG",2,19,168,187
https://kawalpemilu.org#24148,"CIHERANG, GUNUNG ALIP, TANGGAMUS, LAMPUNG",3,17,169,186
https://kawalpemilu.org#24148,"CIHERANG, GUNUNG ALIP, TANGGAMUS, LAMPUNG",4,54,122,176
https://kawalpemilu.org#24148,"CIHERANG, GUNUNG ALIP, TANGGAMUS, LAMPUNG",5,23,157,180
https://kawalpemilu.org#24148,"CIHERANG, GUNUNG ALIP, TANGGAMUS, LAMPUNG",6,23,188,211
https://kawalpemilu.org#24149,"PARIAMAN, GUNUNG ALIP, TANGGAMUS, LAMPUNG",1,52,182,234
https://kawalpemilu.org#24149,"PARIAMAN, GUNUNG ALIP, TANGGAMUS, LAMPUNG",2,111,96,207
https://kawalpemilu.org#24149,"PARIAMAN, GUNUNG ALIP, TANGGAMUS, LAMPUNG",3,36,79,115
https://kawalpemilu.org#24150,"SUKADAMAI, GUNUNG ALIP, TANGGAMUS, LAMPUNG",1,32,148,180
https://kawalpemilu.org#24150,"SUKADAMAI, GUNUNG ALIP, TANGGAMUS, LAMPUNG",2,45,143,188
https://kawalpemilu.org#24150,"SUKADAMAI, GUNUNG ALIP, TANGGAMUS, LAMPUNG",3,81,129,210
https://kawalpemilu.org#24151,"WAY HALOM, GUNUNG ALIP, TANGGAMUS, LAMPUNG",1,91,133,224
https://kawalpemilu.org#24151,"WAY HALOM, GUNUNG ALIP, TANGGAMUS, LAMPUNG",2,48,100,148
https://kawalpemilu.org#24151,"WAY HALOM, GUNUNG ALIP, TANGGAMUS, LAMPUNG",3,24,195,219
https://kawalpemilu.org#24151,"WAY HALOM, GUNUNG ALIP, TANGGAMUS, LAMPUNG",4,39,111,150
https://kawalpemilu.org#24151,"WAY HALOM, GUNUNG ALIP, TANGGAMUS, LAMPUNG",5,43,37,80
https://kawalpemilu.org#24152,"PENANGGUNGAN, GUNUNG ALIP, TANGGAMUS, LAMPUNG",1,43,172,215
https://kawalpemilu.org#24152,"PENANGGUNGAN, GUNUNG ALIP, TANGGAMUS, LAMPUNG",2,45,155,200
https://kawalpemilu.org#24152,"PENANGGUNGAN, GUNUNG ALIP, TANGGAMUS, LAMPUNG",3,40,125,165
https://kawalpemilu.org#24152,"PENANGGUNGAN, GUNUNG ALIP, TANGGAMUS, LAMPUNG",4,69,79,148
https://kawalpemilu.org#87422,"DARUSSALAM, GUNUNG ALIP, TANGGAMUS, LAMPUNG",1,35,154,189
https://kawalpemilu.org#87422,"DARUSSALAM, GUNUNG ALIP, TANGGAMUS, LAMPUNG",2,34,137,171
https://kawalpemilu.org#24154,"BADAK, LIMAU, TANGGAMUS, LAMPUNG",1,80,107,187
https://kawalpemilu.org#24154,"BADAK, LIMAU, TANGGAMUS, LAMPUNG",3,42,111,153
https://kawalpemilu.org#24154,"BADAK, LIMAU, TANGGAMUS, LAMPUNG",4,51,95,146
https://kawalpemilu.org#24154,"BADAK, LIMAU, TANGGAMUS, LAMPUNG",5,106,31,137
https://kawalpemilu.org#24155,"KURIPAN, LIMAU, TANGGAMUS, LAMPUNG",1,32,147,179
https://kawalpemilu.org#24155,"KURIPAN, LIMAU, TANGGAMUS, LAMPUNG",2,0,0,0
https://kawalpemilu.org#24155,"KURIPAN, LIMAU, TANGGAMUS, LAMPUNG",3,44,134,178
https://kawalpemilu.org#24155,"KURIPAN, LIMAU, TANGGAMUS, LAMPUNG",4,56,69,125
https://kawalpemilu.org#24155,"KURIPAN, LIMAU, TANGGAMUS, LAMPUNG",5,20,109,129
https://kawalpemilu.org#24156,"PADANG RATU, LIMAU, TANGGAMUS, LAMPUNG",1,21,105,126
https://kawalpemilu.org#24156,"PADANG RATU, LIMAU, TANGGAMUS, LAMPUNG",2,67,76,143
https://kawalpemilu.org#24156,"PADANG RATU, LIMAU, TANGGAMUS, LAMPUNG",3,88,60,148
https://kawalpemilu.org#24156,"PADANG RATU, LIMAU, TANGGAMUS, LAMPUNG",4,121,62,183
https://kawalpemilu.org#24157,"TEGINENENG, LIMAU, TANGGAMUS, LAMPUNG",1,83,111,194
https://kawalpemilu.org#24157,"TEGINENENG, LIMAU, TANGGAMUS, LAMPUNG",2,62,57,119
https://kawalpemilu.org#24157,"TEGINENENG, LIMAU, TANGGAMUS, LAMPUNG",3,106,67,173
https://kawalpemilu.org#24157,"TEGINENENG, LIMAU, TANGGAMUS, LAMPUNG",4,153,33,186
https://kawalpemilu.org#24158,"KETAPANG, LIMAU, TANGGAMUS, LAMPUNG",1,86,58,144
https://kawalpemilu.org#24158,"KETAPANG, LIMAU, TANGGAMUS, LAMPUNG",2,71,113,184
https://kawalpemilu.org#24158,"KETAPANG, LIMAU, TANGGAMUS, LAMPUNG",3,78,48,126
https://kawalpemilu.org#24158,"KETAPANG, LIMAU, TANGGAMUS, LAMPUNG",4,55,36,91
https://kawalpemilu.org#24158,"KETAPANG, LIMAU, TANGGAMUS, LAMPUNG",5,26,57,83
https://kawalpemilu.org#24158,"KETAPANG, LIMAU, TANGGAMUS, LAMPUNG",6,59,70,129
https://kawalpemilu.org#24158,"KETAPANG, LIMAU, TANGGAMUS, LAMPUNG",7,85,66,151
https://kawalpemilu.org#24158,"KETAPANG, LIMAU, TANGGAMUS, LAMPUNG",8,53,25,78
https://kawalpemilu.org#24159,"BANJAR AGUNG, LIMAU, TANGGAMUS, LAMPUNG",1,40,196,236
https://kawalpemilu.org#24159,"BANJAR AGUNG, LIMAU, TANGGAMUS, LAMPUNG",2,34,143,177
https://kawalpemilu.org#24159,"BANJAR AGUNG, LIMAU, TANGGAMUS, LAMPUNG",3,46,117,163
https://kawalpemilu.org#24159,"BANJAR AGUNG, LIMAU, TANGGAMUS, LAMPUNG",4,33,100,133
https://kawalpemilu.org#24159,"BANJAR AGUNG, LIMAU, TANGGAMUS, LAMPUNG",5,94,48,142
https://kawalpemilu.org#24159,"BANJAR AGUNG, LIMAU, TANGGAMUS, LAMPUNG",6,91,30,121
https://kawalpemilu.org#24160,"PEKON AMPAI, LIMAU, TANGGAMUS, LAMPUNG",1,78,34,112
https://kawalpemilu.org#24160,"PEKON AMPAI, LIMAU, TANGGAMUS, LAMPUNG",2,72,118,190
https://kawalpemilu.org#24160,"PEKON AMPAI, LIMAU, TANGGAMUS, LAMPUNG",3,36,87,123
https://kawalpemilu.org#24160,"PEKON AMPAI, LIMAU, TANGGAMUS, LAMPUNG",4,83,84,167
https://kawalpemilu.org#24160,"PEKON AMPAI, LIMAU, TANGGAMUS, LAMPUNG",5,63,111,174
https://kawalpemilu.org#24160,"PEKON AMPAI, LIMAU, TANGGAMUS, LAMPUNG",6,110,61,171
https://kawalpemilu.org#24160,"PEKON AMPAI, LIMAU, TANGGAMUS, LAMPUNG",7,52,6,58
https://kawalpemilu.org#24160,"PEKON AMPAI, LIMAU, TANGGAMUS, LAMPUNG",8,173,69,242
https://kawalpemilu.org#24160,"PEKON AMPAI, LIMAU, TANGGAMUS, LAMPUNG",9,95,16,111
https://kawalpemilu.org#24160,"PEKON AMPAI, LIMAU, TANGGAMUS, LAMPUNG",10,116,19,135
https://kawalpemilu.org#24160,"PEKON AMPAI, LIMAU, TANGGAMUS, LAMPUNG",11,86,10,96
https://kawalpemilu.org#24160,"PEKON AMPAI, LIMAU, TANGGAMUS, LAMPUNG",12,69,30,99
https://kawalpemilu.org#24160,"PEKON AMPAI, LIMAU, TANGGAMUS, LAMPUNG",13,46,20,66
https://kawalpemilu.org#24161,"PARIAMAN, LIMAU, TANGGAMUS, LAMPUNG",1,143,79,222
https://kawalpemilu.org#24161,"PARIAMAN, LIMAU, TANGGAMUS, LAMPUNG",2,85,110,195
https://kawalpemilu.org#24161,"PARIAMAN, LIMAU, TANGGAMUS, LAMPUNG",3,72,69,141
https://kawalpemilu.org#24161,"PARIAMAN, LIMAU, TANGGAMUS, LAMPUNG",4,92,59,151
https://kawalpemilu.org#24161,"PARIAMAN, LIMAU, TANGGAMUS, LAMPUNG",5,80,68,148
https://kawalpemilu.org#24161,"PARIAMAN, LIMAU, TANGGAMUS, LAMPUNG",6,27,167,194
https://kawalpemilu.org#24161,"PARIAMAN, LIMAU, TANGGAMUS, LAMPUNG",7,110,39,149
https://kawalpemilu.org#24161,"PARIAMAN, LIMAU, TANGGAMUS, LAMPUNG",8,26,33,59
https://kawalpemilu.org#24162,"ATAR BRAK, LIMAU, TANGGAMUS, LAMPUNG",1,132,34,166
https://kawalpemilu.org#24162,"ATAR BRAK, LIMAU, TANGGAMUS, LAMPUNG",2,120,52,172
https://kawalpemilu.org#24162,"ATAR BRAK, LIMAU, TANGGAMUS, LAMPUNG",3,129,42,171
https://kawalpemilu.org#24162,"ATAR BRAK, LIMAU, TANGGAMUS, LAMPUNG",4,107,50,157
https://kawalpemilu.org#24162,"ATAR BRAK, LIMAU, TANGGAMUS, LAMPUNG",5,123,25,148
https://kawalpemilu.org#24162,"ATAR BRAK, LIMAU, TANGGAMUS, LAMPUNG",6,128,30,158
https://kawalpemilu.org#24162,"ATAR BRAK, LIMAU, TANGGAMUS, LAMPUNG",7,70,132,202
https://kawalpemilu.org#24162,"ATAR BRAK, LIMAU, TANGGAMUS, LAMPUNG",8,115,47,162
https://kawalpemilu.org#24162,"ATAR BRAK, LIMAU, TANGGAMUS, LAMPUNG",9,153,35,188
https://kawalpemilu.org#24162,"ATAR BRAK, LIMAU, TANGGAMUS, LAMPUNG",10,178,39,217
https://kawalpemilu.org#24163,"TANJUNG SIOM, LIMAU, TANGGAMUS, LAMPUNG",1,66,134,200
https://kawalpemilu.org#24163,"TANJUNG SIOM, LIMAU, TANGGAMUS, LAMPUNG",2,101,36,137
https://kawalpemilu.org#24163,"TANJUNG SIOM, LIMAU, TANGGAMUS, LAMPUNG",3,96,83,179
https://kawalpemilu.org#24163,"TANJUNG SIOM, LIMAU, TANGGAMUS, LAMPUNG",4,111,93,204
https://kawalpemilu.org#24163,"TANJUNG SIOM, LIMAU, TANGGAMUS, LAMPUNG",5,101,45,146
https://kawalpemilu.org#87423,"TANJUNGJAYA, LIMAU, TANGGAMUS, LAMPUNG",1,90,71,161
https://kawalpemilu.org#87423,"TANJUNGJAYA, LIMAU, TANGGAMUS, LAMPUNG",2,83,35,118
https://kawalpemilu.org#87423,"TANJUNGJAYA, LIMAU, TANGGAMUS, LAMPUNG",3,59,85,144
https://kawalpemilu.org#87423,"TANJUNGJAYA, LIMAU, TANGGAMUS, LAMPUNG",4,143,15,158
https://kawalpemilu.org#24165,"NEGERI AGUNG, BANDAR NEGERI SEMUONG, TANGGAMUS, LAMPUNG",1,38,136,174
https://kawalpemilu.org#24165,"NEGERI AGUNG, BANDAR NEGERI SEMUONG, TANGGAMUS, LAMPUNG",2,64,66,130
https://kawalpemilu.org#24165,"NEGERI AGUNG, BANDAR NEGERI SEMUONG, TANGGAMUS, LAMPUNG",3,99,97,196
https://kawalpemilu.org#24165,"NEGERI AGUNG, BANDAR NEGERI SEMUONG, TANGGAMUS, LAMPUNG",4,45,91,136
https://kawalpemilu.org#24166,"BANDAR SUKABUMI, BANDAR NEGERI SEMUONG, TANGGAMUS, LAMPUNG",1,46,122,168
https://kawalpemilu.org#24166,"BANDAR SUKABUMI, BANDAR NEGERI SEMUONG, TANGGAMUS, LAMPUNG",2,39,134,173
https://kawalpemilu.org#24166,"BANDAR SUKABUMI, BANDAR NEGERI SEMUONG, TANGGAMUS, LAMPUNG",3,39,130,169
https://kawalpemilu.org#24166,"BANDAR SUKABUMI, BANDAR NEGERI SEMUONG, TANGGAMUS, LAMPUNG",4,36,93,129
https://kawalpemilu.org#24166,"BANDAR SUKABUMI, BANDAR NEGERI SEMUONG, TANGGAMUS, LAMPUNG",5,47,140,187
https://kawalpemilu.org#24166,"BANDAR SUKABUMI, BANDAR NEGERI SEMUONG, TANGGAMUS, LAMPUNG",6,133,63,196
https://kawalpemilu.org#24166,"BANDAR SUKABUMI, BANDAR NEGERI SEMUONG, TANGGAMUS, LAMPUNG",7,30,39,69
https://kawalpemilu.org#24166,"BANDAR SUKABUMI, BANDAR NEGERI SEMUONG, TANGGAMUS, LAMPUNG",8,29,98,127
https://kawalpemilu.org#24166,"BANDAR SUKABUMI, BANDAR NEGERI SEMUONG, TANGGAMUS, LAMPUNG",9,29,97,126
https://kawalpemilu.org#24166,"BANDAR SUKABUMI, BANDAR NEGERI SEMUONG, TANGGAMUS, LAMPUNG",10,71,32,103
https://kawalpemilu.org#24167,"SANGGI, BANDAR NEGERI SEMUONG, TANGGAMUS, LAMPUNG",1,27,101,128
https://kawalpemilu.org#24167,"SANGGI, BANDAR NEGERI SEMUONG, TANGGAMUS, LAMPUNG",2,37,183,220
https://kawalpemilu.org#24167,"SANGGI, BANDAR NEGERI SEMUONG, TANGGAMUS, LAMPUNG",3,30,178,208
https://kawalpemilu.org#24167,"SANGGI, BANDAR NEGERI SEMUONG, TANGGAMUS, LAMPUNG",4,46,146,192
https://kawalpemilu.org#24167,"SANGGI, BANDAR NEGERI SEMUONG, TANGGAMUS, LAMPUNG",5,52,120,172
https://kawalpemilu.org#24167,"SANGGI, BANDAR NEGERI SEMUONG, TANGGAMUS, LAMPUNG",6,117,101,218
https://kawalpemilu.org#24167,"SANGGI, BANDAR NEGERI SEMUONG, TANGGAMUS, LAMPUNG",7,80,18,98
https://kawalpemilu.org#24167,"SANGGI, BANDAR NEGERI SEMUONG, TANGGAMUS, LAMPUNG",8,59,24,83
https://kawalpemilu.org#24167,"SANGGI, BANDAR NEGERI SEMUONG, TANGGAMUS, LAMPUNG",9,21,119,140
https://kawalpemilu.org#24167,"SANGGI, BANDAR NEGERI SEMUONG, TANGGAMUS, LAMPUNG",10,53,157,210
https://kawalpemilu.org#24167,"SANGGI, BANDAR NEGERI SEMUONG, TANGGAMUS, LAMPUNG",11,53,116,169
https://kawalpemilu.org#24168,"RAJABASA, BANDAR NEGERI SEMUONG, TANGGAMUS, LAMPUNG",1,33,131,164
https://kawalpemilu.org#24168,"RAJABASA, BANDAR NEGERI SEMUONG, TANGGAMUS, LAMPUNG",2,36,155,191
https://kawalpemilu.org#24168,"RAJABASA, BANDAR NEGERI SEMUONG, TANGGAMUS, LAMPUNG",3,52,128,180
https://kawalpemilu.org#24168,"RAJABASA, BANDAR NEGERI SEMUONG, TANGGAMUS, LAMPUNG",4,2,16,18
https://kawalpemilu.org#24169,"BANDING, BANDAR NEGERI SEMUONG, TANGGAMUS, LAMPUNG",1,26,160,186
https://kawalpemilu.org#24169,"BANDING, BANDAR NEGERI SEMUONG, TANGGAMUS, LAMPUNG",2,28,143,171
https://kawalpemilu.org#24169,"BANDING, BANDAR NEGERI SEMUONG, TANGGAMUS, LAMPUNG",3,30,136,9
https://kawalpemilu.org#24170,"GUNUNG DOH, BANDAR NEGERI SEMUONG, TANGGAMUS, LAMPUNG",1,27,124,151
https://kawalpemilu.org#24170,"GUNUNG DOH, BANDAR NEGERI SEMUONG, TANGGAMUS, LAMPUNG",2,26,128,154
https://kawalpemilu.org#24170,"GUNUNG DOH, BANDAR NEGERI SEMUONG, TANGGAMUS, LAMPUNG",3,46,166,212
https://kawalpemilu.org#24170,"GUNUNG DOH, BANDAR NEGERI SEMUONG, TANGGAMUS, LAMPUNG",4,21,144,165
https://kawalpemilu.org#24170,"GUNUNG DOH, BANDAR NEGERI SEMUONG, TANGGAMUS, LAMPUNG",5,37,127,164
https://kawalpemilu.org#24170,"GUNUNG DOH, BANDAR NEGERI SEMUONG, TANGGAMUS, LAMPUNG",6,35,123,158
https://kawalpemilu.org#24171,"SIMPANG BAYUR, BANDAR NEGERI SEMUONG, TANGGAMUS, LAMPUNG",1,87,101,188
https://kawalpemilu.org#24171,"SIMPANG BAYUR, BANDAR NEGERI SEMUONG, TANGGAMUS, LAMPUNG",2,37,94,131
https://kawalpemilu.org#24171,"SIMPANG BAYUR, BANDAR NEGERI SEMUONG, TANGGAMUS, LAMPUNG",3,61,23,84
https://kawalpemilu.org#24172,"ATAR LEBAR, BANDAR NEGERI SEMUONG, TANGGAMUS, LAMPUNG",1,107,29,136
https://kawalpemilu.org#24172,"ATAR LEBAR, BANDAR NEGERI SEMUONG, TANGGAMUS, LAMPUNG",2,110,33,143
https://kawalpemilu.org#24172,"ATAR LEBAR, BANDAR NEGERI SEMUONG, TANGGAMUS, LAMPUNG",3,92,30,122
https://kawalpemilu.org#24172,"ATAR LEBAR, BANDAR NEGERI SEMUONG, TANGGAMUS, LAMPUNG",4,111,24,135
https://kawalpemilu.org#24172,"ATAR LEBAR, BANDAR NEGERI SEMUONG, TANGGAMUS, LAMPUNG",5,144,9,153
https://kawalpemilu.org#24172,"ATAR LEBAR, BANDAR NEGERI SEMUONG, TANGGAMUS, LAMPUNG",6,131,14,145
https://kawalpemilu.org#24172,"ATAR LEBAR, BANDAR NEGERI SEMUONG, TANGGAMUS, LAMPUNG",7,115,17,132
https://kawalpemilu.org#24173,"SINAR BANGUN, BANDAR NEGERI SEMUONG, TANGGAMUS, LAMPUNG",1,26,140,166
https://kawalpemilu.org#24173,"SINAR BANGUN, BANDAR NEGERI SEMUONG, TANGGAMUS, LAMPUNG",2,51,113,164
https://kawalpemilu.org#24173,"SINAR BANGUN, BANDAR NEGERI SEMUONG, TANGGAMUS, LAMPUNG",3,33,107,140
https://kawalpemilu.org#24174,"SANGGI UNGGAK, BANDAR NEGERI SEMUONG, TANGGAMUS, LAMPUNG",1,20,131,151
https://kawalpemilu.org#24174,"SANGGI UNGGAK, BANDAR NEGERI SEMUONG, TANGGAMUS, LAMPUNG",2,137,93,230
https://kawalpemilu.org#87424,"TULUNG SARI, BANDAR NEGERI SEMUONG, TANGGAMUS, LAMPUNG",1,111,52,163
https://kawalpemilu.org#87424,"TULUNG SARI, BANDAR NEGERI SEMUONG, TANGGAMUS, LAMPUNG",2,84,18,102
https://kawalpemilu.org#87424,"TULUNG SARI, BANDAR NEGERI SEMUONG, TANGGAMUS, LAMPUNG",3,71,45,116
https://kawalpemilu.org#24176,"WAY HARONG, AIR NANINGAN, TANGGAMUS, LAMPUNG",1,63,134,197
https://kawalpemilu.org#24176,"WAY HARONG, AIR NANINGAN, TANGGAMUS, LAMPUNG",2,96,99,195
https://kawalpemilu.org#24176,"WAY HARONG, AIR NANINGAN, TANGGAMUS, LAMPUNG",3,137,44,181
https://kawalpemilu.org#24176,"WAY HARONG, AIR NANINGAN, TANGGAMUS, LAMPUNG",4,96,64,160
https://kawalpemilu.org#24176,"WAY HARONG, AIR NANINGAN, TANGGAMUS, LAMPUNG",5,75,77,152
https://kawalpemilu.org#24176,"WAY HARONG, AIR NANINGAN, TANGGAMUS, LAMPUNG",6,110,39,149
https://kawalpemilu.org#24176,"WAY HARONG, AIR NANINGAN, TANGGAMUS, LAMPUNG",7,37,87,124
https://kawalpemilu.org#24177,"AIR KUBANG, AIR NANINGAN, TANGGAMUS, LAMPUNG",1,79,145,224
https://kawalpemilu.org#24177,"AIR KUBANG, AIR NANINGAN, TANGGAMUS, LAMPUNG",2,73,124,197
https://kawalpemilu.org#24177,"AIR KUBANG, AIR NANINGAN, TANGGAMUS, LAMPUNG",3,79,131,210
https://kawalpemilu.org#24177,"AIR KUBANG, AIR NANINGAN, TANGGAMUS, LAMPUNG",4,61,139,200
https://kawalpemilu.org#24177,"AIR KUBANG, AIR NANINGAN, TANGGAMUS, LAMPUNG",5,85,141,226
https://kawalpemilu.org#24177,"AIR KUBANG, AIR NANINGAN, TANGGAMUS, LAMPUNG",6,93,148,241
https://kawalpemilu.org#24177,"AIR KUBANG, AIR NANINGAN, TANGGAMUS, LAMPUNG",7,113,130,243
https://kawalpemilu.org#24177,"AIR KUBANG, AIR NANINGAN, TANGGAMUS, LAMPUNG",8,184,52,236
https://kawalpemilu.org#24177,"AIR KUBANG, AIR NANINGAN, TANGGAMUS, LAMPUNG",9,164,76,240
https://kawalpemilu.org#24177,"AIR KUBANG, AIR NANINGAN, TANGGAMUS, LAMPUNG",10,78,131,209
https://kawalpemilu.org#24177,"AIR KUBANG, AIR NANINGAN, TANGGAMUS, LAMPUNG",11,111,94,205
https://kawalpemilu.org#24178,"KARANG SARI, AIR NANINGAN, TANGGAMUS, LAMPUNG",1,75,103,178
https://kawalpemilu.org#24178,"KARANG SARI, AIR NANINGAN, TANGGAMUS, LAMPUNG",2,125,140,265
https://kawalpemilu.org#24178,"KARANG SARI, AIR NANINGAN, TANGGAMUS, LAMPUNG",3,88,129,217
https://kawalpemilu.org#24178,"KARANG SARI, AIR NANINGAN, TANGGAMUS, LAMPUNG",4,60,204,264
https://kawalpemilu.org#24178,"KARANG SARI, AIR NANINGAN, TANGGAMUS, LAMPUNG",5,72,141,219
https://kawalpemilu.org#24178,"KARANG SARI, AIR NANINGAN, TANGGAMUS, LAMPUNG",6,65,90,155
https://kawalpemilu.org#24178,"KARANG SARI, AIR NANINGAN, TANGGAMUS, LAMPUNG",7,54,97,151
https://kawalpemilu.org#24179,"SIDOMULYO, AIR NANINGAN, TANGGAMUS, LAMPUNG",1,49,86,135
https://kawalpemilu.org#24179,"SIDOMULYO, AIR NANINGAN, TANGGAMUS, LAMPUNG",2,125,135,260
https://kawalpemilu.org#24179,"SIDOMULYO, AIR NANINGAN, TANGGAMUS, LAMPUNG",3,122,141,263
https://kawalpemilu.org#24179,"SIDOMULYO, AIR NANINGAN, TANGGAMUS, LAMPUNG",4,50,144,194
https://kawalpemilu.org#24179,"SIDOMULYO, AIR NANINGAN, TANGGAMUS, LAMPUNG",5,38,43,81
https://kawalpemilu.org#24179,"SIDOMULYO, AIR NANINGAN, TANGGAMUS, LAMPUNG",6,62,74,136
https://kawalpemilu.org#24179,"SIDOMULYO, AIR NANINGAN, TANGGAMUS, LAMPUNG",7,10,98,108
https://kawalpemilu.org#24179,"SIDOMULYO, AIR NANINGAN, TANGGAMUS, LAMPUNG",8,72,145,217
https://kawalpemilu.org#24180,"AIR NANINGAN, AIR NANINGAN, TANGGAMUS, LAMPUNG",1,80,90,170
https://kawalpemilu.org#24180,"AIR NANINGAN, AIR NANINGAN, TANGGAMUS, LAMPUNG",2,80,116,196
https://kawalpemilu.org#24180,"AIR NANINGAN, AIR NANINGAN, TANGGAMUS, LAMPUNG",3,93,116,209
https://kawalpemilu.org#24180,"AIR NANINGAN, AIR NANINGAN, TANGGAMUS, LAMPUNG",4,122,76,198
https://kawalpemilu.org#24180,"AIR NANINGAN, AIR NANINGAN, TANGGAMUS, LAMPUNG",5,106,81,187
https://kawalpemilu.org#24180,"AIR NANINGAN, AIR NANINGAN, TANGGAMUS, LAMPUNG",6,75,104,179
https://kawalpemilu.org#24180,"AIR NANINGAN, AIR NANINGAN, TANGGAMUS, LAMPUNG",7,67,118,185
https://kawalpemilu.org#24180,"AIR NANINGAN, AIR NANINGAN, TANGGAMUS, LAMPUNG",8,43,31,74
https://kawalpemilu.org#24180,"AIR NANINGAN, AIR NANINGAN, TANGGAMUS, LAMPUNG",9,31,120,151
https://kawalpemilu.org#24180,"AIR NANINGAN, AIR NANINGAN, TANGGAMUS, LAMPUNG",10,45,125,170
https://kawalpemilu.org#24180,"AIR NANINGAN, AIR NANINGAN, TANGGAMUS, LAMPUNG",11,96,51,147
https://kawalpemilu.org#24180,"AIR NANINGAN, AIR NANINGAN, TANGGAMUS, LAMPUNG",12,34,32,66
https://kawalpemilu.org#24180,"AIR NANINGAN, AIR NANINGAN, TANGGAMUS, LAMPUNG",13,49,26,75
https://kawalpemilu.org#24180,"AIR NANINGAN, AIR NANINGAN, TANGGAMUS, LAMPUNG",14,66,87,153
https://kawalpemilu.org#24180,"AIR NANINGAN, AIR NANINGAN, TANGGAMUS, LAMPUNG",15,75,89,164
https://kawalpemilu.org#24180,"AIR NANINGAN, AIR NANINGAN, TANGGAMUS, LAMPUNG",16,81,105,186
https://kawalpemilu.org#24181,"DATAR LEBUAY, AIR NANINGAN, TANGGAMUS, LAMPUNG",1,91,108,199
https://kawalpemilu.org#24181,"DATAR LEBUAY, AIR NANINGAN, TANGGAMUS, LAMPUNG",2,155,72,227
https://kawalpemilu.org#24181,"DATAR LEBUAY, AIR NANINGAN, TANGGAMUS, LAMPUNG",3,99,65,164
https://kawalpemilu.org#24181,"DATAR LEBUAY, AIR NANINGAN, TANGGAMUS, LAMPUNG",4,164,55,219
https://kawalpemilu.org#24181,"DATAR LEBUAY, AIR NANINGAN, TANGGAMUS, LAMPUNG",5,167,50,217
https://kawalpemilu.org#24181,"DATAR LEBUAY, AIR NANINGAN, TANGGAMUS, LAMPUNG",6,103,161,264
https://kawalpemilu.org#24181,"DATAR LEBUAY, AIR NANINGAN, TANGGAMUS, LAMPUNG",7,110,144,254
https://kawalpemilu.org#24181,"DATAR LEBUAY, AIR NANINGAN, TANGGAMUS, LAMPUNG",8,70,87,157
https://kawalpemilu.org#24181,"DATAR LEBUAY, AIR NANINGAN, TANGGAMUS, LAMPUNG",9,99,223,222
https://kawalpemilu.org#24181,"DATAR LEBUAY, AIR NANINGAN, TANGGAMUS, LAMPUNG",10,151,41,192
https://kawalpemilu.org#24181,"DATAR LEBUAY, AIR NANINGAN, TANGGAMUS, LAMPUNG",11,119,60,179
https://kawalpemilu.org#24181,"DATAR LEBUAY, AIR NANINGAN, TANGGAMUS, LAMPUNG",12,85,117,202
https://kawalpemilu.org#24181,"DATAR LEBUAY, AIR NANINGAN, TANGGAMUS, LAMPUNG",13,120,36,156
https://kawalpemilu.org#24181,"DATAR LEBUAY, AIR NANINGAN, TANGGAMUS, LAMPUNG",14,31,118,149
https://kawalpemilu.org#24181,"DATAR LEBUAY, AIR NANINGAN, TANGGAMUS, LAMPUNG",15,111,74,185
https://kawalpemilu.org#24182,"SINAR JAWA, AIR NANINGAN, TANGGAMUS, LAMPUNG",1,122,59,181
https://kawalpemilu.org#24182,"SINAR JAWA, AIR NANINGAN, TANGGAMUS, LAMPUNG",2,64,103,167
https://kawalpemilu.org#24182,"SINAR JAWA, AIR NANINGAN, TANGGAMUS, LAMPUNG",3,77,36,113
https://kawalpemilu.org#24182,"SINAR JAWA, AIR NANINGAN, TANGGAMUS, LAMPUNG",4,136,25,161
https://kawalpemilu.org#24182,"SINAR JAWA, AIR NANINGAN, TANGGAMUS, LAMPUNG",5,85,51,136
https://kawalpemilu.org#24182,"SINAR JAWA, AIR NANINGAN, TANGGAMUS, LAMPUNG",6,65,51,116
https://kawalpemilu.org#24182,"SINAR JAWA, AIR NANINGAN, TANGGAMUS, LAMPUNG",7,135,32,167
https://kawalpemilu.org#24182,"SINAR JAWA, AIR NANINGAN, TANGGAMUS, LAMPUNG",8,76,58,134
https://kawalpemilu.org#24182,"SINAR JAWA, AIR NANINGAN, TANGGAMUS, LAMPUNG",9,102,86,188
https://kawalpemilu.org#24182,"SINAR JAWA, AIR NANINGAN, TANGGAMUS, LAMPUNG",10,66,51,117
https://kawalpemilu.org#24183,"BATU TEGI, AIR NANINGAN, TANGGAMUS, LAMPUNG",1,153,83,236
https://kawalpemilu.org#24183,"BATU TEGI, AIR NANINGAN, TANGGAMUS, LAMPUNG",2,148,75,223
https://kawalpemilu.org#24183,"BATU TEGI, AIR NANINGAN, TANGGAMUS, LAMPUNG",3,69,77,146
https://kawalpemilu.org#24183,"BATU TEGI, AIR NANINGAN, TANGGAMUS, LAMPUNG",4,137,50,187
https://kawalpemilu.org#24183,"BATU TEGI, AIR NANINGAN, TANGGAMUS, LAMPUNG",5,57,28,85
https://kawalpemilu.org#24183,"BATU TEGI, AIR NANINGAN, TANGGAMUS, LAMPUNG",6,59,122,181
https://kawalpemilu.org#24183,"BATU TEGI, AIR NANINGAN, TANGGAMUS, LAMPUNG",7,120,40,160
https://kawalpemilu.org#24184,"SINAR SEKAMPUNG, AIR NANINGAN, TANGGAMUS, LAMPUNG",1,56,182,238
https://kawalpemilu.org#24184,"SINAR SEKAMPUNG, AIR NANINGAN, TANGGAMUS, LAMPUNG",2,61,63,124
https://kawalpemilu.org#24184,"SINAR SEKAMPUNG, AIR NANINGAN, TANGGAMUS, LAMPUNG",3,111,112,223
https://kawalpemilu.org#24184,"SINAR SEKAMPUNG, AIR NANINGAN, TANGGAMUS, LAMPUNG",4,34,94,128
https://kawalpemilu.org#24184,"SINAR SEKAMPUNG, AIR NANINGAN, TANGGAMUS, LAMPUNG",5,114,117,231
https://kawalpemilu.org#24184,"SINAR SEKAMPUNG, AIR NANINGAN, TANGGAMUS, LAMPUNG",6,73,128,201
https://kawalpemilu.org#24184,"SINAR SEKAMPUNG, AIR NANINGAN, TANGGAMUS, LAMPUNG",7,90,60,150
https://kawalpemilu.org#24184,"SINAR SEKAMPUNG, AIR NANINGAN, TANGGAMUS, LAMPUNG",8,158,105,263
https://kawalpemilu.org#24184,"SINAR SEKAMPUNG, AIR NANINGAN, TANGGAMUS, LAMPUNG",9,110,75,185
https://kawalpemilu.org#24184,"SINAR SEKAMPUNG, AIR NANINGAN, TANGGAMUS, LAMPUNG",10,110,117,227
https://kawalpemilu.org#87420,"MARGOMULYO, AIR NANINGAN, TANGGAMUS, LAMPUNG",1,110,128,238
https://kawalpemilu.org#87420,"MARGOMULYO, AIR NANINGAN, TANGGAMUS, LAMPUNG",2,64,150,214
https://kawalpemilu.org#87420,"MARGOMULYO, AIR NANINGAN, TANGGAMUS, LAMPUNG",3,101,49,150
https://kawalpemilu.org#87420,"MARGOMULYO, AIR NANINGAN, TANGGAMUS, LAMPUNG",4,46,99,145
https://kawalpemilu.org#24186,"SUKAMARA, BULOK, TANGGAMUS, LAMPUNG",1,12,160,172
https://kawalpemilu.org#24186,"SUKAMARA, BULOK, TANGGAMUS, LAMPUNG",2,14,165,179
https://kawalpemilu.org#24186,"SUKAMARA, BULOK, TANGGAMUS, LAMPUNG",3,84,136,220
https://kawalpemilu.org#24186,"SUKAMARA, BULOK, TANGGAMUS, LAMPUNG",4,26,188,214
https://kawalpemilu.org#24186,"SUKAMARA, BULOK, TANGGAMUS, LAMPUNG",5,104,144,248
https://kawalpemilu.org#24186,"SUKAMARA, BULOK, TANGGAMUS, LAMPUNG",6,79,61,140
https://kawalpemilu.org#24186,"SUKAMARA, BULOK, TANGGAMUS, LAMPUNG",7,0,0,0
https://kawalpemilu.org#24186,"SUKAMARA, BULOK, TANGGAMUS, LAMPUNG",8,43,98,142
https://kawalpemilu.org#24186,"SUKAMARA, BULOK, TANGGAMUS, LAMPUNG",9,65,32,97
https://kawalpemilu.org#24187,"SUKANEGARA, BULOK, TANGGAMUS, LAMPUNG",1,23,148,171
https://kawalpemilu.org#24187,"SUKANEGARA, BULOK, TANGGAMUS, LAMPUNG",2,76,137,213
https://kawalpemilu.org#24187,"SUKANEGARA, BULOK, TANGGAMUS, LAMPUNG",3,95,105,200
https://kawalpemilu.org#24187,"SUKANEGARA, BULOK, TANGGAMUS, LAMPUNG",4,87,17,104
https://kawalpemilu.org#24187,"SUKANEGARA, BULOK, TANGGAMUS, LAMPUNG",5,47,57,104
https://kawalpemilu.org#24188,"BANJARMASIN, BULOK, TANGGAMUS, LAMPUNG",1,64,95,159
https://kawalpemilu.org#24188,"BANJARMASIN, BULOK, TANGGAMUS, LAMPUNG",2,72,104,176
https://kawalpemilu.org#24188,"BANJARMASIN, BULOK, TANGGAMUS, LAMPUNG",3,67,97,164
https://kawalpemilu.org#24188,"BANJARMASIN, BULOK, TANGGAMUS, LAMPUNG",4,107,45,152
https://kawalpemilu.org#24188,"BANJARMASIN, BULOK, TANGGAMUS, LAMPUNG",5,161,19,180
https://kawalpemilu.org#24188,"BANJARMASIN, BULOK, TANGGAMUS, LAMPUNG",6,51,78,129
https://kawalpemilu.org#24188,"BANJARMASIN, BULOK, TANGGAMUS, LAMPUNG",7,114,24,138
https://kawalpemilu.org#24188,"BANJARMASIN, BULOK, TANGGAMUS, LAMPUNG",8,100,34,134
https://kawalpemilu.org#24189,"SUKA AGUNG BARAT, BULOK, TANGGAMUS, LAMPUNG",1,81,42,123
https://kawalpemilu.org#24189,"SUKA AGUNG BARAT, BULOK, TANGGAMUS, LAMPUNG",2,63,82,12
https://kawalpemilu.org#24189,"SUKA AGUNG BARAT, BULOK, TANGGAMUS, LAMPUNG",3,86,85,171
https://kawalpemilu.org#24189,"SUKA AGUNG BARAT, BULOK, TANGGAMUS, LAMPUNG",4,105,29,134
https://kawalpemilu.org#24189,"SUKA AGUNG BARAT, BULOK, TANGGAMUS, LAMPUNG",5,142,39,181
https://kawalpemilu.org#24189,"SUKA AGUNG BARAT, BULOK, TANGGAMUS, LAMPUNG",6,78,26,104
https://kawalpemilu.org#24189,"SUKA AGUNG BARAT, BULOK, TANGGAMUS, LAMPUNG",7,78,26,104
https://kawalpemilu.org#24190,"SUKA AGUNG, BULOK, TANGGAMUS, LAMPUNG",1,33,167,200
https://kawalpemilu.org#24190,"SUKA AGUNG, BULOK, TANGGAMUS, LAMPUNG",2,48,137,185
https://kawalpemilu.org#24190,"SUKA AGUNG, BULOK, TANGGAMUS, LAMPUNG",3,33,133,166
https://kawalpemilu.org#24190,"SUKA AGUNG, BULOK, TANGGAMUS, LAMPUNG",4,84,108,192
https://kawalpemilu.org#24190,"SUKA AGUNG, BULOK, TANGGAMUS, LAMPUNG",5,61,111,172
https://kawalpemilu.org#24190,"SUKA AGUNG, BULOK, TANGGAMUS, LAMPUNG",6,26,109,135
https://kawalpemilu.org#24190,"SUKA AGUNG, BULOK, TANGGAMUS, LAMPUNG",7,74,90,164
https://kawalpemilu.org#24190,"SUKA AGUNG, BULOK, TANGGAMUS, LAMPUNG",8,112,95,207
https://kawalpemilu.org#24190,"SUKA AGUNG, BULOK, TANGGAMUS, LAMPUNG",9,118,19,137
https://kawalpemilu.org#24190,"SUKA AGUNG, BULOK, TANGGAMUS, LAMPUNG",10,32,151,183
https://kawalpemilu.org#24190,"SUKA AGUNG, BULOK, TANGGAMUS, LAMPUNG",11,85,105,190
https://kawalpemilu.org#24190,"SUKA AGUNG, BULOK, TANGGAMUS, LAMPUNG",12,77,128,205
https://kawalpemilu.org#24190,"SUKA AGUNG, BULOK, TANGGAMUS, LAMPUNG",13,15,92,107
https://kawalpemilu.org#24190,"SUKA AGUNG, BULOK, TANGGAMUS, LAMPUNG",14,131,29,160
https://kawalpemilu.org#24191,"GUNUNG TERANG, BULOK, TANGGAMUS, LAMPUNG",1,44,148,192
https://kawalpemilu.org#24191,"GUNUNG TERANG, BULOK, TANGGAMUS, LAMPUNG",2,81,95,176
https://kawalpemilu.org#24191,"GUNUNG TERANG, BULOK, TANGGAMUS, LAMPUNG",3,44,91,135
https://kawalpemilu.org#24191,"GUNUNG TERANG, BULOK, TANGGAMUS, LAMPUNG",4,118,53,171
https://kawalpemilu.org#24191,"GUNUNG TERANG, BULOK, TANGGAMUS, LAMPUNG",5,122,27,149
https://kawalpemilu.org#24191,"GUNUNG TERANG, BULOK, TANGGAMUS, LAMPUNG",6,43,23,66
https://kawalpemilu.org#24191,"GUNUNG TERANG, BULOK, TANGGAMUS, LAMPUNG",7,87,61,148
https://kawalpemilu.org#24191,"GUNUNG TERANG, BULOK, TANGGAMUS, LAMPUNG",8,60,94,154
https://kawalpemilu.org#24192,"NAPAL, BULOK, TANGGAMUS, LAMPUNG",1,125,134,259
https://kawalpemilu.org#24192,"NAPAL, BULOK, TANGGAMUS, LAMPUNG",2,46,65,111
https://kawalpemilu.org#24192,"NAPAL, BULOK, TANGGAMUS, LAMPUNG",3,95,114,209
https://kawalpemilu.org#24192,"NAPAL, BULOK, TANGGAMUS, LAMPUNG",4,133,116,249
https://kawalpemilu.org#24192,"NAPAL, BULOK, TANGGAMUS, LAMPUNG",5,42,186,228
https://kawalpemilu.org#24192,"NAPAL, BULOK, TANGGAMUS, LAMPUNG",6,84,126,210
https://kawalpemilu.org#24192,"NAPAL, BULOK, TANGGAMUS, LAMPUNG",7,38,119,157
https://kawalpemilu.org#24192,"NAPAL, BULOK, TANGGAMUS, LAMPUNG",8,80,52,132
https://kawalpemilu.org#24192,"NAPAL, BULOK, TANGGAMUS, LAMPUNG",9,65,39,104
https://kawalpemilu.org#24193,"SINAR PETIR, BULOK, TANGGAMUS, LAMPUNG",1,79,63,142
https://kawalpemilu.org#24193,"SINAR PETIR, BULOK, TANGGAMUS, LAMPUNG",2,129,72,201
https://kawalpemilu.org#24193,"SINAR PETIR, BULOK, TANGGAMUS, LAMPUNG",3,52,79,131
https://kawalpemilu.org#24193,"SINAR PETIR, BULOK, TANGGAMUS, LAMPUNG",4,101,168,269
https://kawalpemilu.org#24193,"SINAR PETIR, BULOK, TANGGAMUS, LAMPUNG",5,133,79,212
https://kawalpemilu.org#24193,"SINAR PETIR, BULOK, TANGGAMUS, LAMPUNG",6,71,82,153
https://kawalpemilu.org#24193,"SINAR PETIR, BULOK, TANGGAMUS, LAMPUNG",7,90,77,167
https://kawalpemilu.org#24194,"PEMATANG NEBAK, BULOK, TANGGAMUS, LAMPUNG",1,151,88,239
https://kawalpemilu.org#24194,"PEMATANG NEBAK, BULOK, TANGGAMUS, LAMPUNG",2,138,103,241
https://kawalpemilu.org#24194,"PEMATANG NEBAK, BULOK, TANGGAMUS, LAMPUNG",3,119,42,161
https://kawalpemilu.org#24194,"PEMATANG NEBAK, BULOK, TANGGAMUS, LAMPUNG",4,140,99,239
https://kawalpemilu.org#24194,"PEMATANG NEBAK, BULOK, TANGGAMUS, LAMPUNG",5,74,49,123
https://kawalpemilu.org#24194,"PEMATANG NEBAK, BULOK, TANGGAMUS, LAMPUNG",6,159,26,185
https://kawalpemilu.org#87425,"TANJUNGSARI, BULOK, TANGGAMUS, LAMPUNG",1,96,153,249
https://kawalpemilu.org#87425,"TANJUNGSARI, BULOK, TANGGAMUS, LAMPUNG",2,81,132,213
https://kawalpemilu.org#24196,"LENGKUKAI, KLUMBAYAN BARAT, TANGGAMUS, LAMPUNG",1,125,52,177
https://kawalpemilu.org#24196,"LENGKUKAI, KLUMBAYAN BARAT, TANGGAMUS, LAMPUNG",2,154,58,212
https://kawalpemilu.org#24196,"LENGKUKAI, KLUMBAYAN BARAT, TANGGAMUS, LAMPUNG",3,100,69,169
https://kawalpemilu.org#24196,"LENGKUKAI, KLUMBAYAN BARAT, TANGGAMUS, LAMPUNG",4,107,70,177
https://kawalpemilu.org#24196,"LENGKUKAI, KLUMBAYAN BARAT, TANGGAMUS, LAMPUNG",5,50,61,111
https://kawalpemilu.org#24196,"LENGKUKAI, KLUMBAYAN BARAT, TANGGAMUS, LAMPUNG",6,144,43,187
https://kawalpemilu.org#24196,"LENGKUKAI, KLUMBAYAN BARAT, TANGGAMUS, LAMPUNG",7,118,52,170
https://kawalpemilu.org#24196,"LENGKUKAI, KLUMBAYAN BARAT, TANGGAMUS, LAMPUNG",8,122,23,145
https://kawalpemilu.org#24196,"LENGKUKAI, KLUMBAYAN BARAT, TANGGAMUS, LAMPUNG",9,163,50,213
https://kawalpemilu.org#24196,"LENGKUKAI, KLUMBAYAN BARAT, TANGGAMUS, LAMPUNG",10,156,34,190
https://kawalpemilu.org#24196,"LENGKUKAI, KLUMBAYAN BARAT, TANGGAMUS, LAMPUNG",11,126,106,232
https://kawalpemilu.org#24196,"LENGKUKAI, KLUMBAYAN BARAT, TANGGAMUS, LAMPUNG",12,32,29,61
https://kawalpemilu.org#24196,"LENGKUKAI, KLUMBAYAN BARAT, TANGGAMUS, LAMPUNG",13,113,70,183
https://kawalpemilu.org#24196,"LENGKUKAI, KLUMBAYAN BARAT, TANGGAMUS, LAMPUNG",14,57,55,112
https://kawalpemilu.org#24196,"LENGKUKAI, KLUMBAYAN BARAT, TANGGAMUS, LAMPUNG",15,135,20,155
https://kawalpemilu.org#24197,"SIDOHARJO, KLUMBAYAN BARAT, TANGGAMUS, LAMPUNG",1,144,62,206
https://kawalpemilu.org#24197,"SIDOHARJO, KLUMBAYAN BARAT, TANGGAMUS, LAMPUNG",2,127,84,211
https://kawalpemilu.org#24197,"SIDOHARJO, KLUMBAYAN BARAT, TANGGAMUS, LAMPUNG",3,128,76,204
https://kawalpemilu.org#24197,"SIDOHARJO, KLUMBAYAN BARAT, TANGGAMUS, LAMPUNG",4,70,88,158
https://kawalpemilu.org#24197,"SIDOHARJO, KLUMBAYAN BARAT, TANGGAMUS, LAMPUNG",5,62,86,148
https://kawalpemilu.org#24197,"SIDOHARJO, KLUMBAYAN BARAT, TANGGAMUS, LAMPUNG",6,81,15,96
https://kawalpemilu.org#24197,"SIDOHARJO, KLUMBAYAN BARAT, TANGGAMUS, LAMPUNG",7,98,58,156
https://kawalpemilu.org#24198,"MERBAU, KLUMBAYAN BARAT, TANGGAMUS, LAMPUNG",1,116,107,223
https://kawalpemilu.org#24198,"MERBAU, KLUMBAYAN BARAT, TANGGAMUS, LAMPUNG",2,70,75,145
https://kawalpemilu.org#24198,"MERBAU, KLUMBAYAN BARAT, TANGGAMUS, LAMPUNG",3,163,33,196
https://kawalpemilu.org#24198,"MERBAU, KLUMBAYAN BARAT, TANGGAMUS, LAMPUNG",4,68,22,90
https://kawalpemilu.org#24198,"MERBAU, KLUMBAYAN BARAT, TANGGAMUS, LAMPUNG",5,114,78,192
https://kawalpemilu.org#24198,"MERBAU, KLUMBAYAN BARAT, TANGGAMUS, LAMPUNG",6,81,53,134
https://kawalpemilu.org#24199,"BATU PATAH, KLUMBAYAN BARAT, TANGGAMUS, LAMPUNG",1,138,33,171
https://kawalpemilu.org#24199,"BATU PATAH, KLUMBAYAN BARAT, TANGGAMUS, LAMPUNG",2,104,65,169
https://kawalpemilu.org#24199,"BATU PATAH, KLUMBAYAN BARAT, TANGGAMUS, LAMPUNG",3,120,71,191
https://kawalpemilu.org#24199,"BATU PATAH, KLUMBAYAN BARAT, TANGGAMUS, LAMPUNG",4,165,34,199
https://kawalpemilu.org#24200,"PURWOSARI, KLUMBAYAN BARAT, TANGGAMUS, LAMPUNG",1,101,81,182
https://kawalpemilu.org#24200,"PURWOSARI, KLUMBAYAN BARAT, TANGGAMUS, LAMPUNG",2,49,65,114
https://kawalpemilu.org#24200,"PURWOSARI, KLUMBAYAN BARAT, TANGGAMUS, LAMPUNG",3,54,58,112
https://kawalpemilu.org#24200,"PURWOSARI, KLUMBAYAN BARAT, TANGGAMUS, LAMPUNG",4,60,75,135
https://kawalpemilu.org#24200,"PURWOSARI, KLUMBAYAN BARAT, TANGGAMUS, LAMPUNG",5,32,100,132
https://kawalpemilu.org#24200,"PURWOSARI, KLUMBAYAN BARAT, TANGGAMUS, LAMPUNG",6,72,152,224
https://kawalpemilu.org#24201,"MARGA MULYA, KLUMBAYAN BARAT, TANGGAMUS, LAMPUNG",1,103,71,174
https://kawalpemilu.org#24201,"MARGA MULYA, KLUMBAYAN BARAT, TANGGAMUS, LAMPUNG",2,72,63,135
https://kawalpemilu.org#24201,"MARGA MULYA, KLUMBAYAN BARAT, TANGGAMUS, LAMPUNG",3,153,62,215
https://kawalpemilu.org#24201,"MARGA MULYA, KLUMBAYAN BARAT, TANGGAMUS, LAMPUNG",4,71,69,140
https://kawalpemilu.org#24204,"SUKADANA, SUKADANA, LAMPUNG TIMUR, LAMPUNG",1,24,151,175
https://kawalpemilu.org#24204,"SUKADANA, SUKADANA, LAMPUNG TIMUR, LAMPUNG",2,20,108,128
https://kawalpemilu.org#24204,"SUKADANA, SUKADANA, LAMPUNG TIMUR, LAMPUNG",3,21,138,159
https://kawalpemilu.org#24204,"SUKADANA, SUKADANA, LAMPUNG TIMUR, LAMPUNG",4,23,122,145
https://kawalpemilu.org#24204,"SUKADANA, SUKADANA, LAMPUNG TIMUR, LAMPUNG",5,32,118,150
https://kawalpemilu.org#24204,"SUKADANA, SUKADANA, LAMPUNG TIMUR, LAMPUNG",6,107,56,163
https://kawalpemilu.org#24204,"SUKADANA, SUKADANA, LAMPUNG TIMUR, LAMPUNG",7,95,57,152
https://kawalpemilu.org#24204,"SUKADANA, SUKADANA, LAMPUNG TIMUR, LAMPUNG",8,20,114,134
https://kawalpemilu.org#24204,"SUKADANA, SUKADANA, LAMPUNG TIMUR, LAMPUNG",9,29,116,145
https://kawalpemilu.org#24204,"SUKADANA, SUKADANA, LAMPUNG TIMUR, LAMPUNG",10,95,68,163
https://kawalpemilu.org#24204,"SUKADANA, SUKADANA, LAMPUNG TIMUR, LAMPUNG",11,90,61,151
https://kawalpemilu.org#24204,"SUKADANA, SUKADANA, LAMPUNG TIMUR, LAMPUNG",12,93,71,164
https://kawalpemilu.org#24204,"SUKADANA, SUKADANA, LAMPUNG TIMUR, LAMPUNG",13,61,68,129
https://kawalpemilu.org#24204,"SUKADANA, SUKADANA, LAMPUNG TIMUR, LAMPUNG",14,73,123,196
https://kawalpemilu.org#24204,"SUKADANA, SUKADANA, LAMPUNG TIMUR, LAMPUNG",15,98,73,171
https://kawalpemilu.org#24204,"SUKADANA, SUKADANA, LAMPUNG TIMUR, LAMPUNG",16,78,65,143
https://kawalpemilu.org#24204,"SUKADANA, SUKADANA, LAMPUNG TIMUR, LAMPUNG",17,49,65,114
https://kawalpemilu.org#24204,"SUKADANA, SUKADANA, LAMPUNG TIMUR, LAMPUNG",18,21,51,72
https://kawalpemilu.org#24204,"SUKADANA, SUKADANA, LAMPUNG TIMUR, LAMPUNG",19,11,63,74
https://kawalpemilu.org#24205,"PAKUAN AJI, SUKADANA, LAMPUNG TIMUR, LAMPUNG",1,104,117,221
https://kawalpemilu.org#24205,"PAKUAN AJI, SUKADANA, LAMPUNG TIMUR, LAMPUNG",2,133,54,187
https://kawalpemilu.org#24205,"PAKUAN AJI, SUKADANA, LAMPUNG TIMUR, LAMPUNG",3,153,41,194
https://kawalpemilu.org#24205,"PAKUAN AJI, SUKADANA, LAMPUNG TIMUR, LAMPUNG",4,146,35,181
https://kawalpemilu.org#24205,"PAKUAN AJI, SUKADANA, LAMPUNG TIMUR, LAMPUNG",5,145,40,185
https://kawalpemilu.org#24205,"PAKUAN AJI, SUKADANA, LAMPUNG TIMUR, LAMPUNG",6,120,37,157
https://kawalpemilu.org#24205,"PAKUAN AJI, SUKADANA, LAMPUNG TIMUR, LAMPUNG",7,109,60,169
https://kawalpemilu.org#24205,"PAKUAN AJI, SUKADANA, LAMPUNG TIMUR, LAMPUNG",8,124,67,191
https://kawalpemilu.org#24205,"PAKUAN AJI, SUKADANA, LAMPUNG TIMUR, LAMPUNG",9,122,53,175
https://kawalpemilu.org#24205,"PAKUAN AJI, SUKADANA, LAMPUNG TIMUR, LAMPUNG",10,140,58,198
https://kawalpemilu.org#24205,"PAKUAN AJI, SUKADANA, LAMPUNG TIMUR, LAMPUNG",11,128,50,178
https://kawalpemilu.org#24205,"PAKUAN AJI, SUKADANA, LAMPUNG TIMUR, LAMPUNG",12,93,55,148
https://kawalpemilu.org#24205,"PAKUAN AJI, SUKADANA, LAMPUNG TIMUR, LAMPUNG",13,114,41,155
https://kawalpemilu.org#24205,"PAKUAN AJI, SUKADANA, LAMPUNG TIMUR, LAMPUNG",14,138,20,158
https://kawalpemilu.org#24205,"PAKUAN AJI, SUKADANA, LAMPUNG TIMUR, LAMPUNG",15,122,76,198
https://kawalpemilu.org#24205,"PAKUAN AJI, SUKADANA, LAMPUNG TIMUR, LAMPUNG",16,123,54,177
https://kawalpemilu.org#24205,"PAKUAN AJI, SUKADANA, LAMPUNG TIMUR, LAMPUNG",17,135,63,198
https://kawalpemilu.org#24205,"PAKUAN AJI, SUKADANA, LAMPUNG TIMUR, LAMPUNG",18,121,120,241
https://kawalpemilu.org#24205,"PAKUAN AJI, SUKADANA, LAMPUNG TIMUR, LAMPUNG",19,106,55,161
https://kawalpemilu.org#24205,"PAKUAN AJI, SUKADANA, LAMPUNG TIMUR, LAMPUNG",21,57,75,132
https://kawalpemilu.org#24205,"PAKUAN AJI, SUKADANA, LAMPUNG TIMUR, LAMPUNG",22,76,71,147
https://kawalpemilu.org#24205,"PAKUAN AJI, SUKADANA, LAMPUNG TIMUR, LAMPUNG",23,68,90,158
https://kawalpemilu.org#24205,"PAKUAN AJI, SUKADANA, LAMPUNG TIMUR, LAMPUNG",24,32,121,153
https://kawalpemilu.org#24205,"PAKUAN AJI, SUKADANA, LAMPUNG TIMUR, LAMPUNG",25,121,50,171
https://kawalpemilu.org#24205,"PAKUAN AJI, SUKADANA, LAMPUNG TIMUR, LAMPUNG",26,101,33,134
https://kawalpemilu.org#24205,"PAKUAN AJI, SUKADANA, LAMPUNG TIMUR, LAMPUNG",27,101,53,154
https://kawalpemilu.org#24205,"PAKUAN AJI, SUKADANA, LAMPUNG TIMUR, LAMPUNG",28,18,92,110
https://kawalpemilu.org#24205,"PAKUAN AJI, SUKADANA, LAMPUNG TIMUR, LAMPUNG",29,91,32,123
https://kawalpemilu.org#24205,"PAKUAN AJI, SUKADANA, LAMPUNG TIMUR, LAMPUNG",30,115,42,157
https://kawalpemilu.org#24205,"PAKUAN AJI, SUKADANA, LAMPUNG TIMUR, LAMPUNG",31,116,37,153
https://kawalpemilu.org#24206,"BUMI NABUNG UDIK, SUKADANA, LAMPUNG TIMUR, LAMPUNG",1,82,153,235
https://kawalpemilu.org#24206,"BUMI NABUNG UDIK, SUKADANA, LAMPUNG TIMUR, LAMPUNG",2,157,64,221
https://kawalpemilu.org#24206,"BUMI NABUNG UDIK, SUKADANA, LAMPUNG TIMUR, LAMPUNG",3,56,81,137
https://kawalpemilu.org#24206,"BUMI NABUNG UDIK, SUKADANA, LAMPUNG TIMUR, LAMPUNG",4,78,95,173
https://kawalpemilu.org#24207,"RAJABASA BATANGHARI, SUKADANA, LAMPUNG TIMUR, LAMPUNG",1,38,111,149
https://kawalpemilu.org#24207,"RAJABASA BATANGHARI, SUKADANA, LAMPUNG TIMUR, LAMPUNG",2,114,54,168
https://kawalpemilu.org#24207,"RAJABASA BATANGHARI, SUKADANA, LAMPUNG TIMUR, LAMPUNG",3,58,27,85
https://kawalpemilu.org#24207,"RAJABASA BATANGHARI, SUKADANA, LAMPUNG TIMUR, LAMPUNG",4,0,0,0
https://kawalpemilu.org#24207,"RAJABASA BATANGHARI, SUKADANA, LAMPUNG TIMUR, LAMPUNG",5,125,43,168
https://kawalpemilu.org#24208,"NEGARA NABUNG, SUKADANA, LAMPUNG TIMUR, LAMPUNG",1,55,177,232
https://kawalpemilu.org#24208,"NEGARA NABUNG, SUKADANA, LAMPUNG TIMUR, LAMPUNG",2,91,125,216
https://kawalpemilu.org#24208,"NEGARA NABUNG, SUKADANA, LAMPUNG TIMUR, LAMPUNG",3,29,139,168
https://kawalpemilu.org#24208,"NEGARA NABUNG, SUKADANA, LAMPUNG TIMUR, LAMPUNG",4,42,114,156
https://kawalpemilu.org#24208,"NEGARA NABUNG, SUKADANA, LAMPUNG TIMUR, LAMPUNG",5,30,120,150
https://kawalpemilu.org#24208,"NEGARA NABUNG, SUKADANA, LAMPUNG TIMUR, LAMPUNG",6,136,36,172
https://kawalpemilu.org#24208,"NEGARA NABUNG, SUKADANA, LAMPUNG TIMUR, LAMPUNG",7,171,10,181
https://kawalpemilu.org#24208,"NEGARA NABUNG, SUKADANA, LAMPUNG TIMUR, LAMPUNG",8,111,86,197
https://kawalpemilu.org#24208,"NEGARA NABUNG, SUKADANA, LAMPUNG TIMUR, LAMPUNG",9,136,53,189
https://kawalpemilu.org#24208,"NEGARA NABUNG, SUKADANA, LAMPUNG TIMUR, LAMPUNG",10,141,48,189
https://kawalpemilu.org#24208,"NEGARA NABUNG, SUKADANA, LAMPUNG TIMUR, LAMPUNG",11,137,57,194
https://kawalpemilu.org#24209,"TERBANGGI MARGA, SUKADANA, LAMPUNG TIMUR, LAMPUNG",1,39,142,181
https://kawalpemilu.org#24209,"TERBANGGI MARGA, SUKADANA, LAMPUNG TIMUR, LAMPUNG",2,27,126,153
https://kawalpemilu.org#24209,"TERBANGGI MARGA, SUKADANA, LAMPUNG TIMUR, LAMPUNG",4,118,80,198
https://kawalpemilu.org#24209,"TERBANGGI MARGA, SUKADANA, LAMPUNG TIMUR, LAMPUNG",5,137,56,193
https://kawalpemilu.org#24209,"TERBANGGI MARGA, SUKADANA, LAMPUNG TIMUR, LAMPUNG",6,122,83,205
https://kawalpemilu.org#24210,"MATARAM MARGA, SUKADANA, LAMPUNG TIMUR, LAMPUNG",1,11,148,159
https://kawalpemilu.org#24210,"MATARAM MARGA, SUKADANA, LAMPUNG TIMUR, LAMPUNG",2,31,135,166
https://kawalpemilu.org#24210,"MATARAM MARGA, SUKADANA, LAMPUNG TIMUR, LAMPUNG",3,37,122,159
https://kawalpemilu.org#24210,"MATARAM MARGA, SUKADANA, LAMPUNG TIMUR, LAMPUNG",4,86,165,251
https://kawalpemilu.org#24210,"MATARAM MARGA, SUKADANA, LAMPUNG TIMUR, LAMPUNG",5,91,73,164
https://kawalpemilu.org#24210,"MATARAM MARGA, SUKADANA, LAMPUNG TIMUR, LAMPUNG",6,124,41,165
https://kawalpemilu.org#24210,"MATARAM MARGA, SUKADANA, LAMPUNG TIMUR, LAMPUNG",7,112,47,159
https://kawalpemilu.org#24210,"MATARAM MARGA, SUKADANA, LAMPUNG TIMUR, LAMPUNG",8,89,27,116
https://kawalpemilu.org#24210,"MATARAM MARGA, SUKADANA, LAMPUNG TIMUR, LAMPUNG",9,80,54,134
https://kawalpemilu.org#24210,"MATARAM MARGA, SUKADANA, LAMPUNG TIMUR, LAMPUNG",10,58,81,139
https://kawalpemilu.org#24211,"SUKADANA PASAR, SUKADANA, LAMPUNG TIMUR, LAMPUNG",1,93,101,194
https://kawalpemilu.org#24211,"SUKADANA PASAR, SUKADANA, LAMPUNG TIMUR, LAMPUNG",2,100,97,197
https://kawalpemilu.org#24211,"SUKADANA PASAR, SUKADANA, LAMPUNG TIMUR, LAMPUNG",3,116,57,173
https://kawalpemilu.org#24211,"SUKADANA PASAR, SUKADANA, LAMPUNG TIMUR, LAMPUNG",4,135,36,171
https://kawalpemilu.org#24211,"SUKADANA PASAR, SUKADANA, LAMPUNG TIMUR, LAMPUNG",5,60,69,129
https://kawalpemilu.org#24211,"SUKADANA PASAR, SUKADANA, LAMPUNG TIMUR, LAMPUNG",6,41,153,194
https://kawalpemilu.org#24211,"SUKADANA PASAR, SUKADANA, LAMPUNG TIMUR, LAMPUNG",7,110,124,234
https://kawalpemilu.org#24211,"SUKADANA PASAR, SUKADANA, LAMPUNG TIMUR, LAMPUNG",8,70,73,143
https://kawalpemilu.org#24211,"SUKADANA PASAR, SUKADANA, LAMPUNG TIMUR, LAMPUNG",9,79,56,135
https://kawalpemilu.org#24211,"SUKADANA PASAR, SUKADANA, LAMPUNG TIMUR, LAMPUNG",10,68,158,226
https://kawalpemilu.org#24211,"SUKADANA PASAR, SUKADANA, LAMPUNG TIMUR, LAMPUNG",11,64,165,229
https://kawalpemilu.org#24211,"SUKADANA PASAR, SUKADANA, LAMPUNG TIMUR, LAMPUNG",12,51,101,152
https://kawalpemilu.org#24211,"SUKADANA PASAR, SUKADANA, LAMPUNG TIMUR, LAMPUNG",13,51,98,149
https://kawalpemilu.org#24211,"SUKADANA PASAR, SUKADANA, LAMPUNG TIMUR, LAMPUNG",14,38,131,169
https://kawalpemilu.org#24211,"SUKADANA PASAR, SUKADANA, LAMPUNG TIMUR, LAMPUNG",15,65,143,208
https://kawalpemilu.org#24211,"SUKADANA PASAR, SUKADANA, LAMPUNG TIMUR, LAMPUNG",16,53,85,138
https://kawalpemilu.org#24211,"SUKADANA PASAR, SUKADANA, LAMPUNG TIMUR, LAMPUNG",17,77,72,149
https://kawalpemilu.org#24211,"SUKADANA PASAR, SUKADANA, LAMPUNG TIMUR, LAMPUNG",18,62,177,239
https://kawalpemilu.org#24211,"SUKADANA PASAR, SUKADANA, LAMPUNG TIMUR, LAMPUNG",19,85,129,214
https://kawalpemilu.org#24211,"SUKADANA PASAR, SUKADANA, LAMPUNG TIMUR, LAMPUNG",20,115,44,159
https://kawalpemilu.org#24211,"SUKADANA PASAR, SUKADANA, LAMPUNG TIMUR, LAMPUNG",21,112,24,136
https://kawalpemilu.org#24211,"SUKADANA PASAR, SUKADANA, LAMPUNG TIMUR, LAMPUNG",22,103,63,166
https://kawalpemilu.org#24211,"SUKADANA PASAR, SUKADANA, LAMPUNG TIMUR, LAMPUNG",23,111,52,163
https://kawalpemilu.org#24211,"SUKADANA PASAR, SUKADANA, LAMPUNG TIMUR, LAMPUNG",24,86,78,164
https://kawalpemilu.org#24211,"SUKADANA PASAR, SUKADANA, LAMPUNG TIMUR, LAMPUNG",25,80,56,136
https://kawalpemilu.org#24212,"SURABAYA UDIK, SUKADANA, LAMPUNG TIMUR, LAMPUNG",2,33,124,157
https://kawalpemilu.org#24212,"SURABAYA UDIK, SUKADANA, LAMPUNG TIMUR, LAMPUNG",3,148,44,192
https://kawalpemilu.org#24212,"SURABAYA UDIK, SUKADANA, LAMPUNG TIMUR, LAMPUNG",4,154,14,168
https://kawalpemilu.org#24212,"SURABAYA UDIK, SUKADANA, LAMPUNG TIMUR, LAMPUNG",5,128,9,137
https://kawalpemilu.org#24212,"SURABAYA UDIK, SUKADANA, LAMPUNG TIMUR, LAMPUNG",6,168,43,211
https://kawalpemilu.org#24212,"SURABAYA UDIK, SUKADANA, LAMPUNG TIMUR, LAMPUNG",7,129,51,180
https://kawalpemilu.org#24212,"SURABAYA UDIK, SUKADANA, LAMPUNG TIMUR, LAMPUNG",8,106,29,135
https://kawalpemilu.org#24212,"SURABAYA UDIK, SUKADANA, LAMPUNG TIMUR, LAMPUNG",9,128,37,165
https://kawalpemilu.org#24212,"SURABAYA UDIK, SUKADANA, LAMPUNG TIMUR, LAMPUNG",10,154,45,199
https://kawalpemilu.org#24212,"SURABAYA UDIK, SUKADANA, LAMPUNG TIMUR, LAMPUNG",11,141,28,169
https://kawalpemilu.org#24213,"RANTAU JAYA UDIK, SUKADANA, LAMPUNG TIMUR, LAMPUNG",1,28,100,128
https://kawalpemilu.org#24213,"RANTAU JAYA UDIK, SUKADANA, LAMPUNG TIMUR, LAMPUNG",2,49,107,156
https://kawalpemilu.org#24213,"RANTAU JAYA UDIK, SUKADANA, LAMPUNG TIMUR, LAMPUNG",3,96,36,132
https://kawalpemilu.org#24213,"RANTAU JAYA UDIK, SUKADANA, LAMPUNG TIMUR, LAMPUNG",4,91,41,132
https://kawalpemilu.org#24213,"RANTAU JAYA UDIK, SUKADANA, LAMPUNG TIMUR, LAMPUNG",5,142,56,198
https://kawalpemilu.org#24213,"RANTAU JAYA UDIK, SUKADANA, LAMPUNG TIMUR, LAMPUNG",6,117,58,175
https://kawalpemilu.org#24213,"RANTAU JAYA UDIK, SUKADANA, LAMPUNG TIMUR, LAMPUNG",7,134,30,164
https://kawalpemilu.org#24214,"MUARAJAYA, SUKADANA, LAMPUNG TIMUR, LAMPUNG",2,99,77,176
https://kawalpemilu.org#24214,"MUARAJAYA, SUKADANA, LAMPUNG TIMUR, LAMPUNG",3,170,43,213
https://kawalpemilu.org#24214,"MUARAJAYA, SUKADANA, LAMPUNG TIMUR, LAMPUNG",4,165,51,216
https://kawalpemilu.org#24214,"MUARAJAYA, SUKADANA, LAMPUNG TIMUR, LAMPUNG",5,106,102,208
https://kawalpemilu.org#24214,"MUARAJAYA, SUKADANA, LAMPUNG TIMUR, LAMPUNG",7,138,36,174
https://kawalpemilu.org#24214,"MUARAJAYA, SUKADANA, LAMPUNG TIMUR, LAMPUNG",8,145,51,196
https://kawalpemilu.org#24214,"MUARAJAYA, SUKADANA, LAMPUNG TIMUR, LAMPUNG",9,187,45,232
https://kawalpemilu.org#24214,"MUARAJAYA, SUKADANA, LAMPUNG TIMUR, LAMPUNG",10,170,44,214
https://kawalpemilu.org#24214,"MUARAJAYA, SUKADANA, LAMPUNG TIMUR, LAMPUNG",11,151,88,239
https://kawalpemilu.org#24214,"MUARAJAYA, SUKADANA, LAMPUNG TIMUR, LAMPUNG",12,168,78,246
https://kawalpemilu.org#24215,"SUKADANA ILIR, SUKADANA, LAMPUNG TIMUR, LAMPUNG",1,85,66,151
https://kawalpemilu.org#24215,"SUKADANA ILIR, SUKADANA, LAMPUNG TIMUR, LAMPUNG",2,73,104,177
https://kawalpemilu.org#24215,"SUKADANA ILIR, SUKADANA, LAMPUNG TIMUR, LAMPUNG",3,73,68,141
https://kawalpemilu.org#24215,"SUKADANA ILIR, SUKADANA, LAMPUNG TIMUR, LAMPUNG",4,138,59,197
https://kawalpemilu.org#24215,"SUKADANA ILIR, SUKADANA, LAMPUNG TIMUR, LAMPUNG",5,144,60,204
https://kawalpemilu.org#24215,"SUKADANA ILIR, SUKADANA, LAMPUNG TIMUR, LAMPUNG",6,150,53,203
https://kawalpemilu.org#24215,"SUKADANA ILIR, SUKADANA, LAMPUNG TIMUR, LAMPUNG",7,131,63,194
https://kawalpemilu.org#24215,"SUKADANA ILIR, SUKADANA, LAMPUNG TIMUR, LAMPUNG",8,112,74,186
https://kawalpemilu.org#24215,"SUKADANA ILIR, SUKADANA, LAMPUNG TIMUR, LAMPUNG",9,138,76,214
https://kawalpemilu.org#24215,"SUKADANA ILIR, SUKADANA, LAMPUNG TIMUR, LAMPUNG",10,145,77,222
https://kawalpemilu.org#24215,"SUKADANA ILIR, SUKADANA, LAMPUNG TIMUR, LAMPUNG",11,126,43,169
https://kawalpemilu.org#24215,"SUKADANA ILIR, SUKADANA, LAMPUNG TIMUR, LAMPUNG",12,114,63,177
https://kawalpemilu.org#24215,"SUKADANA ILIR, SUKADANA, LAMPUNG TIMUR, LAMPUNG",13,91,54,145
https://kawalpemilu.org#24215,"SUKADANA ILIR, SUKADANA, LAMPUNG TIMUR, LAMPUNG",14,104,52,156
https://kawalpemilu.org#24215,"SUKADANA ILIR, SUKADANA, LAMPUNG TIMUR, LAMPUNG",15,98,29,127
https://kawalpemilu.org#24215,"SUKADANA ILIR, SUKADANA, LAMPUNG TIMUR, LAMPUNG",16,101,34,135
https://kawalpemilu.org#24215,"SUKADANA ILIR, SUKADANA, LAMPUNG TIMUR, LAMPUNG",17,96,65,161
https://kawalpemilu.org#24215,"SUKADANA ILIR, SUKADANA, LAMPUNG TIMUR, LAMPUNG",18,117,57,174
https://kawalpemilu.org#24215,"SUKADANA ILIR, SUKADANA, LAMPUNG TIMUR, LAMPUNG",19,92,39,131
https://kawalpemilu.org#24215,"SUKADANA ILIR, SUKADANA, LAMPUNG TIMUR, LAMPUNG",20,88,36,124
https://kawalpemilu.org#24216,"BUMI AYU, SUKADANA, LAMPUNG TIMUR, LAMPUNG",1,151,51,202
https://kawalpemilu.org#24216,"BUMI AYU, SUKADANA, LAMPUNG TIMUR, LAMPUNG",2,149,35,184
https://kawalpemilu.org#24216,"BUMI AYU, SUKADANA, LAMPUNG TIMUR, LAMPUNG",3,105,87,192
https://kawalpemilu.org#24216,"BUMI AYU, SUKADANA, LAMPUNG TIMUR, LAMPUNG",4,98,90,188
https://kawalpemilu.org#24216,"BUMI AYU, SUKADANA, LAMPUNG TIMUR, LAMPUNG",5,103,73,176
https://kawalpemilu.org#24216,"BUMI AYU, SUKADANA, LAMPUNG TIMUR, LAMPUNG",6,118,53,171
https://kawalpemilu.org#24216,"BUMI AYU, SUKADANA, LAMPUNG TIMUR, LAMPUNG",7,104,41,145
https://kawalpemilu.org#24216,"BUMI AYU, SUKADANA, LAMPUNG TIMUR, LAMPUNG",8,132,53,185
https://kawalpemilu.org#24216,"BUMI AYU, SUKADANA, LAMPUNG TIMUR, LAMPUNG",9,142,36,178
https://kawalpemilu.org#24216,"BUMI AYU, SUKADANA, LAMPUNG TIMUR, LAMPUNG",10,87,12,99
https://kawalpemilu.org#24217,"SUKADANA TIMUR, SUKADANA, LAMPUNG TIMUR, LAMPUNG",1,173,71,244
https://kawalpemilu.org#24217,"SUKADANA TIMUR, SUKADANA, LAMPUNG TIMUR, LAMPUNG",2,161,47,208
https://kawalpemilu.org#24217,"SUKADANA TIMUR, SUKADANA, LAMPUNG TIMUR, LAMPUNG",3,109,103,212
https://kawalpemilu.org#24217,"SUKADANA TIMUR, SUKADANA, LAMPUNG TIMUR, LAMPUNG",4,118,69,187
https://kawalpemilu.org#24217,"SUKADANA TIMUR, SUKADANA, LAMPUNG TIMUR, LAMPUNG",5,109,56,165
https://kawalpemilu.org#24217,"SUKADANA TIMUR, SUKADANA, LAMPUNG TIMUR, LAMPUNG",6,133,31,164
https://kawalpemilu.org#24217,"SUKADANA TIMUR, SUKADANA, LAMPUNG TIMUR, LAMPUNG",7,118,26,144
https://kawalpemilu.org#24217,"SUKADANA TIMUR, SUKADANA, LAMPUNG TIMUR, LAMPUNG",8,131,57,188
https://kawalpemilu.org#24217,"SUKADANA TIMUR, SUKADANA, LAMPUNG TIMUR, LAMPUNG",9,105,44,149
https://kawalpemilu.org#24217,"SUKADANA TIMUR, SUKADANA, LAMPUNG TIMUR, LAMPUNG",10,85,65,150
https://kawalpemilu.org#24218,"RANTAU JAYA UDIK II, SUKADANA, LAMPUNG TIMUR, LAMPUNG",1,138,16,154
https://kawalpemilu.org#24218,"RANTAU JAYA UDIK II, SUKADANA, LAMPUNG TIMUR, LAMPUNG",2,122,31,153
https://kawalpemilu.org#24218,"RANTAU JAYA UDIK II, SUKADANA, LAMPUNG TIMUR, LAMPUNG",3,203,46,249
https://kawalpemilu.org#24218,"RANTAU JAYA UDIK II, SUKADANA, LAMPUNG TIMUR, LAMPUNG",4,208,49,257
https://kawalpemilu.org#24218,"RANTAU JAYA UDIK II, SUKADANA, LAMPUNG TIMUR, LAMPUNG",5,193,57,250
https://kawalpemilu.org#24218,"RANTAU JAYA UDIK II, SUKADANA, LAMPUNG TIMUR, LAMPUNG",6,167,52,219
https://kawalpemilu.org#24218,"RANTAU JAYA UDIK II, SUKADANA, LAMPUNG TIMUR, LAMPUNG",7,163,44,207
https://kawalpemilu.org#24218,"RANTAU JAYA UDIK II, SUKADANA, LAMPUNG TIMUR, LAMPUNG",8,171,27,198
https://kawalpemilu.org#24218,"RANTAU JAYA UDIK II, SUKADANA, LAMPUNG TIMUR, LAMPUNG",9,150,21,171
https://kawalpemilu.org#24218,"RANTAU JAYA UDIK II, SUKADANA, LAMPUNG TIMUR, LAMPUNG",10,156,26,182
https://kawalpemilu.org#24218,"RANTAU JAYA UDIK II, SUKADANA, LAMPUNG TIMUR, LAMPUNG",11,122,37,159
https://kawalpemilu.org#24218,"RANTAU JAYA UDIK II, SUKADANA, LAMPUNG TIMUR, LAMPUNG",12,118,23,141
https://kawalpemilu.org#24218,"RANTAU JAYA UDIK II, SUKADANA, LAMPUNG TIMUR, LAMPUNG",13,110,28,138
https://kawalpemilu.org#24218,"RANTAU JAYA UDIK II, SUKADANA, LAMPUNG TIMUR, LAMPUNG",14,95,35,130
https://kawalpemilu.org#24218,"RANTAU JAYA UDIK II, SUKADANA, LAMPUNG TIMUR, LAMPUNG",15,158,24,182
https://kawalpemilu.org#24218,"RANTAU JAYA UDIK II, SUKADANA, LAMPUNG TIMUR, LAMPUNG",16,156,20,176
https://kawalpemilu.org#24219,"PUTRA AJI II, SUKADANA, LAMPUNG TIMUR, LAMPUNG",1,44,120,164
https://kawalpemilu.org#24219,"PUTRA AJI II, SUKADANA, LAMPUNG TIMUR, LAMPUNG",2,108,67,175
https://kawalpemilu.org#24219,"PUTRA AJI II, SUKADANA, LAMPUNG TIMUR, LAMPUNG",3,73,70,143
https://kawalpemilu.org#24219,"PUTRA AJI II, SUKADANA, LAMPUNG TIMUR, LAMPUNG",4,46,91,137
https://kawalpemilu.org#24220,"PUTRA AJI I, SUKADANA, LAMPUNG TIMUR, LAMPUNG",1,112,71,183
https://kawalpemilu.org#24220,"PUTRA AJI I, SUKADANA, LAMPUNG TIMUR, LAMPUNG",2,104,72,176
https://kawalpemilu.org#24220,"PUTRA AJI I, SUKADANA, LAMPUNG TIMUR, LAMPUNG",3,113,70,183
https://kawalpemilu.org#24220,"PUTRA AJI I, SUKADANA, LAMPUNG TIMUR, LAMPUNG",4,97,66,163
https://kawalpemilu.org#24220,"PUTRA AJI I, SUKADANA, LAMPUNG TIMUR, LAMPUNG",5,156,26,182
https://kawalpemilu.org#24220,"PUTRA AJI I, SUKADANA, LAMPUNG TIMUR, LAMPUNG",6,143,35,178
https://kawalpemilu.org#24220,"PUTRA AJI I, SUKADANA, LAMPUNG TIMUR, LAMPUNG",7,133,44,177
https://kawalpemilu.org#88034,"SUKADANA SELATAN, SUKADANA, LAMPUNG TIMUR, LAMPUNG",1,162,45,207
https://kawalpemilu.org#88034,"SUKADANA SELATAN, SUKADANA, LAMPUNG TIMUR, LAMPUNG",2,179,17,196
https://kawalpemilu.org#88034,"SUKADANA SELATAN, SUKADANA, LAMPUNG TIMUR, LAMPUNG",3,113,52,165
https://kawalpemilu.org#88034,"SUKADANA SELATAN, SUKADANA, LAMPUNG TIMUR, LAMPUNG",4,88,33,121
https://kawalpemilu.org#88034,"SUKADANA SELATAN, SUKADANA, LAMPUNG TIMUR, LAMPUNG",5,35,44,79
https://kawalpemilu.org#88034,"SUKADANA SELATAN, SUKADANA, LAMPUNG TIMUR, LAMPUNG",6,84,42,126
https://kawalpemilu.org#88035,"SUKADANA JAYA, SUKADANA, LAMPUNG TIMUR, LAMPUNG",1,30,111,141
https://kawalpemilu.org#88035,"SUKADANA JAYA, SUKADANA, LAMPUNG TIMUR, LAMPUNG",2,38,67,97
https://kawalpemilu.org#88035,"SUKADANA JAYA, SUKADANA, LAMPUNG TIMUR, LAMPUNG",3,82,66,148
https://kawalpemilu.org#88035,"SUKADANA JAYA, SUKADANA, LAMPUNG TIMUR, LAMPUNG",4,52,60,112
https://kawalpemilu.org#88035,"SUKADANA JAYA, SUKADANA, LAMPUNG TIMUR, LAMPUNG",5,95,31,126
https://kawalpemilu.org#88035,"SUKADANA JAYA, SUKADANA, LAMPUNG TIMUR, LAMPUNG",6,121,19,140
https://kawalpemilu.org#88035,"SUKADANA JAYA, SUKADANA, LAMPUNG TIMUR, LAMPUNG",7,113,27,140
https://kawalpemilu.org#88035,"SUKADANA JAYA, SUKADANA, LAMPUNG TIMUR, LAMPUNG",8,41,52,93
https://kawalpemilu.org#88035,"SUKADANA JAYA, SUKADANA, LAMPUNG TIMUR, LAMPUNG",9,50,63,113
https://kawalpemilu.org#88035,"SUKADANA JAYA, SUKADANA, LAMPUNG TIMUR, LAMPUNG",10,79,100,179
https://kawalpemilu.org#88035,"SUKADANA JAYA, SUKADANA, LAMPUNG TIMUR, LAMPUNG",11,95,39,134
https://kawalpemilu.org#88035,"SUKADANA JAYA, SUKADANA, LAMPUNG TIMUR, LAMPUNG",12,90,18,108
https://kawalpemilu.org#88035,"SUKADANA JAYA, SUKADANA, LAMPUNG TIMUR, LAMPUNG",13,129,27,156
https://kawalpemilu.org#88035,"SUKADANA JAYA, SUKADANA, LAMPUNG TIMUR, LAMPUNG",14,61,30,91
https://kawalpemilu.org#88035,"SUKADANA JAYA, SUKADANA, LAMPUNG TIMUR, LAMPUNG",15,113,15,128
https://kawalpemilu.org#88036,"SUKADANA TENGAH, SUKADANA, LAMPUNG TIMUR, LAMPUNG",1,32,48,80
https://kawalpemilu.org#88036,"SUKADANA TENGAH, SUKADANA, LAMPUNG TIMUR, LAMPUNG",2,40,42,82
https://kawalpemilu.org#88036,"SUKADANA TENGAH, SUKADANA, LAMPUNG TIMUR, LAMPUNG",3,55,122,177
https://kawalpemilu.org#88036,"SUKADANA TENGAH, SUKADANA, LAMPUNG TIMUR, LAMPUNG",4,19,48,67
https://kawalpemilu.org#88036,"SUKADANA TENGAH, SUKADANA, LAMPUNG TIMUR, LAMPUNG",5,133,58,191
https://kawalpemilu.org#88036,"SUKADANA TENGAH, SUKADANA, LAMPUNG TIMUR, LAMPUNG",6,43,97,140
https://kawalpemilu.org#88036,"SUKADANA TENGAH, SUKADANA, LAMPUNG TIMUR, LAMPUNG",7,107,19,126
https://kawalpemilu.org#88036,"SUKADANA TENGAH, SUKADANA, LAMPUNG TIMUR, LAMPUNG",8,101,33,134
https://kawalpemilu.org#88036,"SUKADANA TENGAH, SUKADANA, LAMPUNG TIMUR, LAMPUNG",9,84,20,104
https://kawalpemilu.org#88036,"SUKADANA TENGAH, SUKADANA, LAMPUNG TIMUR, LAMPUNG",10,110,43,153
https://kawalpemilu.org#88036,"SUKADANA TENGAH, SUKADANA, LAMPUNG TIMUR, LAMPUNG",12,89,76,165
https://kawalpemilu.org#88036,"SUKADANA TENGAH, SUKADANA, LAMPUNG TIMUR, LAMPUNG",13,137,17,154
https://kawalpemilu.org#88036,"SUKADANA TENGAH, SUKADANA, LAMPUNG TIMUR, LAMPUNG",14,144,34,178
https://kawalpemilu.org#88036,"SUKADANA TENGAH, SUKADANA, LAMPUNG TIMUR, LAMPUNG",15,144,29,173
https://kawalpemilu.org#24222,"LABUHAN MARINGGAI, LABUHAN MARINGGAI, LAMPUNG TIMUR, LAMPUNG",1,142,82,224
https://kawalpemilu.org#24222,"LABUHAN MARINGGAI, LABUHAN MARINGGAI, LAMPUNG TIMUR, LAMPUNG",2,103,81,184
https://kawalpemilu.org#24222,"LABUHAN MARINGGAI, LABUHAN MARINGGAI, LAMPUNG TIMUR, LAMPUNG",3,78,52,130
https://kawalpemilu.org#24222,"LABUHAN MARINGGAI, LABUHAN MARINGGAI, LAMPUNG TIMUR, LAMPUNG",4,104,65,169
https://kawalpemilu.org#24222,"LABUHAN MARINGGAI, LABUHAN MARINGGAI, LAMPUNG TIMUR, LAMPUNG",5,97,69,166
https://kawalpemilu.org#24222,"LABUHAN MARINGGAI, LABUHAN MARINGGAI, LAMPUNG TIMUR, LAMPUNG",6,96,116,212
https://kawalpemilu.org#24222,"LABUHAN MARINGGAI, LABUHAN MARINGGAI, LAMPUNG TIMUR, LAMPUNG",7,93,39,132
https://kawalpemilu.org#24222,"LABUHAN MARINGGAI, LABUHAN MARINGGAI, LAMPUNG TIMUR, LAMPUNG",8,122,136,258
https://kawalpemilu.org#24222,"LABUHAN MARINGGAI, LABUHAN MARINGGAI, LAMPUNG TIMUR, LAMPUNG",9,57,76,133
https://kawalpemilu.org#24222,"LABUHAN MARINGGAI, LABUHAN MARINGGAI, LAMPUNG TIMUR, LAMPUNG",10,89,109,198
https://kawalpemilu.org#24222,"LABUHAN MARINGGAI, LABUHAN MARINGGAI, LAMPUNG TIMUR, LAMPUNG",11,53,55,108
https://kawalpemilu.org#24222,"LABUHAN MARINGGAI, LABUHAN MARINGGAI, LAMPUNG TIMUR, LAMPUNG",12,75,80,155
https://kawalpemilu.org#24222,"LABUHAN MARINGGAI, LABUHAN MARINGGAI, LAMPUNG TIMUR, LAMPUNG",13,76,72,148
https://kawalpemilu.org#24222,"LABUHAN MARINGGAI, LABUHAN MARINGGAI, LAMPUNG TIMUR, LAMPUNG",14,139,81,220
https://kawalpemilu.org#24222,"LABUHAN MARINGGAI, LABUHAN MARINGGAI, LAMPUNG TIMUR, LAMPUNG",15,137,88,225
https://kawalpemilu.org#24222,"LABUHAN MARINGGAI, LABUHAN MARINGGAI, LAMPUNG TIMUR, LAMPUNG",16,83,113,196
https://kawalpemilu.org#24222,"LABUHAN MARINGGAI, LABUHAN MARINGGAI, LAMPUNG TIMUR, LAMPUNG",17,103,115,218
https://kawalpemilu.org#24222,"LABUHAN MARINGGAI, LABUHAN MARINGGAI, LAMPUNG TIMUR, LAMPUNG",18,118,53,171
https://kawalpemilu.org#24222,"LABUHAN MARINGGAI, LABUHAN MARINGGAI, LAMPUNG TIMUR, LAMPUNG",19,116,71,187
https://kawalpemilu.org#24222,"LABUHAN MARINGGAI, LABUHAN MARINGGAI, LAMPUNG TIMUR, LAMPUNG",20,105,49,154
https://kawalpemilu.org#24222,"LABUHAN MARINGGAI, LABUHAN MARINGGAI, LAMPUNG TIMUR, LAMPUNG",21,166,39,205
https://kawalpemilu.org#24222,"LABUHAN MARINGGAI, LABUHAN MARINGGAI, LAMPUNG TIMUR, LAMPUNG",22,113,34,147
https://kawalpemilu.org#24222,"LABUHAN MARINGGAI, LABUHAN MARINGGAI, LAMPUNG TIMUR, LAMPUNG",23,134,25,159
https://kawalpemilu.org#24222,"LABUHAN MARINGGAI, LABUHAN MARINGGAI, LAMPUNG TIMUR, LAMPUNG",24,82,73,155
https://kawalpemilu.org#24222,"LABUHAN MARINGGAI, LABUHAN MARINGGAI, LAMPUNG TIMUR, LAMPUNG",25,69,125,194
https://kawalpemilu.org#24222,"LABUHAN MARINGGAI, LABUHAN MARINGGAI, LAMPUNG TIMUR, LAMPUNG",26,82,76,158
https://kawalpemilu.org#24222,"LABUHAN MARINGGAI, LABUHAN MARINGGAI, LAMPUNG TIMUR, LAMPUNG",27,65,71,136
https://kawalpemilu.org#24222,"LABUHAN MARINGGAI, LABUHAN MARINGGAI, LAMPUNG TIMUR, LAMPUNG",28,125,32,157
https://kawalpemilu.org#24222,"LABUHAN MARINGGAI, LABUHAN MARINGGAI, LAMPUNG TIMUR, LAMPUNG",29,112,33,145
https://kawalpemilu.org#24222,"LABUHAN MARINGGAI, LABUHAN MARINGGAI, LAMPUNG TIMUR, LAMPUNG",30,189,26,215
https://kawalpemilu.org#24222,"LABUHAN MARINGGAI, LABUHAN MARINGGAI, LAMPUNG TIMUR, LAMPUNG",31,117,85,202
https://kawalpemilu.org#24222,"LABUHAN MARINGGAI, LABUHAN MARINGGAI, LAMPUNG TIMUR, LAMPUNG",32,156,39,195
https://kawalpemilu.org#24222,"LABUHAN MARINGGAI, LABUHAN MARINGGAI, LAMPUNG TIMUR, LAMPUNG",33,119,76,195
https://kawalpemilu.org#24222,"LABUHAN MARINGGAI, LABUHAN MARINGGAI, LAMPUNG TIMUR, LAMPUNG",34,121,145,266
https://kawalpemilu.org#24223,"MUARA GADING MAS, LABUHAN MARINGGAI, LAMPUNG TIMUR, LAMPUNG",1,26,75,101
https://kawalpemilu.org#24223,"MUARA GADING MAS, LABUHAN MARINGGAI, LAMPUNG TIMUR, LAMPUNG",2,52,74,126
https://kawalpemilu.org#24223,"MUARA GADING MAS, LABUHAN MARINGGAI, LAMPUNG TIMUR, LAMPUNG",3,82,61,143
https://kawalpemilu.org#24223,"MUARA GADING MAS, LABUHAN MARINGGAI, LAMPUNG TIMUR, LAMPUNG",4,70,117,187
https://kawalpemilu.org#24223,"MUARA GADING MAS, LABUHAN MARINGGAI, LAMPUNG TIMUR, LAMPUNG",5,108,60,168
https://kawalpemilu.org#24223,"MUARA GADING MAS, LABUHAN MARINGGAI, LAMPUNG TIMUR, LAMPUNG",6,53,148,201
https://kawalpemilu.org#24223,"MUARA GADING MAS, LABUHAN MARINGGAI, LAMPUNG TIMUR, LAMPUNG",7,67,86,153
https://kawalpemilu.org#24223,"MUARA GADING MAS, LABUHAN MARINGGAI, LAMPUNG TIMUR, LAMPUNG",8,107,49,156
https://kawalpemilu.org#24223,"MUARA GADING MAS, LABUHAN MARINGGAI, LAMPUNG TIMUR, LAMPUNG",9,76,77,153
https://kawalpemilu.org#24223,"MUARA GADING MAS, LABUHAN MARINGGAI, LAMPUNG TIMUR, LAMPUNG",10,94,49,143
https://kawalpemilu.org#24223,"MUARA GADING MAS, LABUHAN MARINGGAI, LAMPUNG TIMUR, LAMPUNG",11,161,9,170
https://kawalpemilu.org#24223,"MUARA GADING MAS, LABUHAN MARINGGAI, LAMPUNG TIMUR, LAMPUNG",12,194,15,209
https://kawalpemilu.org#24223,"MUARA GADING MAS, LABUHAN MARINGGAI, LAMPUNG TIMUR, LAMPUNG",13,89,38,127
https://kawalpemilu.org#24223,"MUARA GADING MAS, LABUHAN MARINGGAI, LAMPUNG TIMUR, LAMPUNG",14,63,31,94
https://kawalpemilu.org#24223,"MUARA GADING MAS, LABUHAN MARINGGAI, LAMPUNG TIMUR, LAMPUNG",15,129,57,186
https://kawalpemilu.org#24223,"MUARA GADING MAS, LABUHAN MARINGGAI, LAMPUNG TIMUR, LAMPUNG",16,144,27,171
https://kawalpemilu.org#24223,"MUARA GADING MAS, LABUHAN MARINGGAI, LAMPUNG TIMUR, LAMPUNG",17,178,36,214
https://kawalpemilu.org#24223,"MUARA GADING MAS, LABUHAN MARINGGAI, LAMPUNG TIMUR, LAMPUNG",18,145,7,152
https://kawalpemilu.org#24223,"MUARA GADING MAS, LABUHAN MARINGGAI, LAMPUNG TIMUR, LAMPUNG",19,129,37,166
https://kawalpemilu.org#24223,"MUARA GADING MAS, LABUHAN MARINGGAI, LAMPUNG TIMUR, LAMPUNG",20,163,65,228
https://kawalpemilu.org#24223,"MUARA GADING MAS, LABUHAN MARINGGAI, LAMPUNG TIMUR, LAMPUNG",21,110,35,145
https://kawalpemilu.org#24223,"MUARA GADING MAS, LABUHAN MARINGGAI, LAMPUNG TIMUR, LAMPUNG",22,108,46,154
https://kawalpemilu.org#24223,"MUARA GADING MAS, LABUHAN MARINGGAI, LAMPUNG TIMUR, LAMPUNG",23,91,65,156
https://kawalpemilu.org#24223,"MUARA GADING MAS, LABUHAN MARINGGAI, LAMPUNG TIMUR, LAMPUNG",24,151,45,196
https://kawalpemilu.org#24223,"MUARA GADING MAS, LABUHAN MARINGGAI, LAMPUNG TIMUR, LAMPUNG",25,149,66,215
https://kawalpemilu.org#24223,"MUARA GADING MAS, LABUHAN MARINGGAI, LAMPUNG TIMUR, LAMPUNG",26,128,15,143
https://kawalpemilu.org#24223,"MUARA GADING MAS, LABUHAN MARINGGAI, LAMPUNG TIMUR, LAMPUNG",27,157,21,178
https://kawalpemilu.org#24223,"MUARA GADING MAS, LABUHAN MARINGGAI, LAMPUNG TIMUR, LAMPUNG",28,186,36,222
https://kawalpemilu.org#24223,"MUARA GADING MAS, LABUHAN MARINGGAI, LAMPUNG TIMUR, LAMPUNG",29,152,39,191
https://kawalpemilu.org#24223,"MUARA GADING MAS, LABUHAN MARINGGAI, LAMPUNG TIMUR, LAMPUNG",30,144,35,179
https://kawalpemilu.org#24223,"MUARA GADING MAS, LABUHAN MARINGGAI, LAMPUNG TIMUR, LAMPUNG",31,110,23,132
https://kawalpemilu.org#24223,"MUARA GADING MAS, LABUHAN MARINGGAI, LAMPUNG TIMUR, LAMPUNG",32,79,27,106
https://kawalpemilu.org#24224,"SRIMINOSARI, LABUHAN MARINGGAI, LAMPUNG TIMUR, LAMPUNG",1,153,43,196
https://kawalpemilu.org#24224,"SRIMINOSARI, LABUHAN MARINGGAI, LAMPUNG TIMUR, LAMPUNG",2,160,40,200
https://kawalpemilu.org#24224,"SRIMINOSARI, LABUHAN MARINGGAI, LAMPUNG TIMUR, LAMPUNG",3,95,39,134
https://kawalpemilu.org#24224,"SRIMINOSARI, LABUHAN MARINGGAI, LAMPUNG TIMUR, LAMPUNG",4,145,46,191
https://kawalpemilu.org#24224,"SRIMINOSARI, LABUHAN MARINGGAI, LAMPUNG TIMUR, LAMPUNG",5,139,27,166
https://kawalpemilu.org#24224,"SRIMINOSARI, LABUHAN MARINGGAI, LAMPUNG TIMUR, LAMPUNG",6,98,42,140
https://kawalpemilu.org#24224,"SRIMINOSARI, LABUHAN MARINGGAI, LAMPUNG TIMUR, LAMPUNG",7,135,41,176
https://kawalpemilu.org#24224,"SRIMINOSARI, LABUHAN MARINGGAI, LAMPUNG TIMUR, LAMPUNG",8,131,69,200
https://kawalpemilu.org#24224,"SRIMINOSARI, LABUHAN MARINGGAI, LAMPUNG TIMUR, LAMPUNG",9,109,48,157
https://kawalpemilu.org#24224,"SRIMINOSARI, LABUHAN MARINGGAI, LAMPUNG TIMUR, LAMPUNG",10,132,56,188
https://kawalpemilu.org#24224,"SRIMINOSARI, LABUHAN MARINGGAI, LAMPUNG TIMUR, LAMPUNG",11,148,52,200
https://kawalpemilu.org#24224,"SRIMINOSARI, LABUHAN MARINGGAI, LAMPUNG TIMUR, LAMPUNG",12,135,43,178
https://kawalpemilu.org#24224,"SRIMINOSARI, LABUHAN MARINGGAI, LAMPUNG TIMUR, LAMPUNG",13,148,48,196
https://kawalpemilu.org#24224,"SRIMINOSARI, LABUHAN MARINGGAI, LAMPUNG TIMUR, LAMPUNG",14,164,53,217
https://kawalpemilu.org#24224,"SRIMINOSARI, LABUHAN MARINGGAI, LAMPUNG TIMUR, LAMPUNG",15,150,55,205
https://kawalpemilu.org#24224,"SRIMINOSARI, LABUHAN MARINGGAI, LAMPUNG TIMUR, LAMPUNG",16,159,62,221
https://kawalpemilu.org#24224,"SRIMINOSARI, LABUHAN MARINGGAI, LAMPUNG TIMUR, LAMPUNG",17,113,47,160
https://kawalpemilu.org#24224,"SRIMINOSARI, LABUHAN MARINGGAI, LAMPUNG TIMUR, LAMPUNG",18,98,58,156
https://kawalpemilu.org#24224,"SRIMINOSARI, LABUHAN MARINGGAI, LAMPUNG TIMUR, LAMPUNG",19,140,57,197
https://kawalpemilu.org#24224,"SRIMINOSARI, LABUHAN MARINGGAI, LAMPUNG TIMUR, LAMPUNG",20,107,29,136
https://kawalpemilu.org#24224,"SRIMINOSARI, LABUHAN MARINGGAI, LAMPUNG TIMUR, LAMPUNG",21,90,12,102
https://kawalpemilu.org#24225,"BANDAR NEGERI, LABUHAN MARINGGAI, LAMPUNG TIMUR, LAMPUNG",1,127,73,200
https://kawalpemilu.org#24225,"BANDAR NEGERI, LABUHAN MARINGGAI, LAMPUNG TIMUR, LAMPUNG",2,131,70,201
https://kawalpemilu.org#24225,"BANDAR NEGERI, LABUHAN MARINGGAI, LAMPUNG TIMUR, LAMPUNG",3,151,36,187
https://kawalpemilu.org#24225,"BANDAR NEGERI, LABUHAN MARINGGAI, LAMPUNG TIMUR, LAMPUNG",4,190,57,247
https://kawalpemilu.org#24225,"BANDAR NEGERI, LABUHAN MARINGGAI, LAMPUNG TIMUR, LAMPUNG",5,160,26,186
https://kawalpemilu.org#24225,"BANDAR NEGERI, LABUHAN MARINGGAI, LAMPUNG TIMUR, LAMPUNG",6,151,46,197
https://kawalpemilu.org#24225,"BANDAR NEGERI, LABUHAN MARINGGAI, LAMPUNG TIMUR, LAMPUNG",7,126,86,212
https://kawalpemilu.org#24225,"BANDAR NEGERI, LABUHAN MARINGGAI, LAMPUNG TIMUR, LAMPUNG",8,141,41,182
https://kawalpemilu.org#24225,"BANDAR NEGERI, LABUHAN MARINGGAI, LAMPUNG TIMUR, LAMPUNG",9,206,33,239
https://kawalpemilu.org#24225,"BANDAR NEGERI, LABUHAN MARINGGAI, LAMPUNG TIMUR, LAMPUNG",10,144,40,184
https://kawalpemilu.org#24225,"BANDAR NEGERI, LABUHAN MARINGGAI, LAMPUNG TIMUR, LAMPUNG",11,155,44,199
https://kawalpemilu.org#24225,"BANDAR NEGERI, LABUHAN MARINGGAI, LAMPUNG TIMUR, LAMPUNG",12,154,31,185
https://kawalpemilu.org#24226,"KARYA MAKMUR, LABUHAN MARINGGAI, LAMPUNG TIMUR, LAMPUNG",1,85,40,125
https://kawalpemilu.org#24226,"KARYA MAKMUR, LABUHAN MARINGGAI, LAMPUNG TIMUR, LAMPUNG",2,126,21,147
https://kawalpemilu.org#24226,"KARYA MAKMUR, LABUHAN MARINGGAI, LAMPUNG TIMUR, LAMPUNG",3,176,53,229
https://kawalpemilu.org#24226,"KARYA MAKMUR, LABUHAN MARINGGAI, LAMPUNG TIMUR, LAMPUNG",4,162,22,184
https://kawalpemilu.org#24226,"KARYA MAKMUR, LABUHAN MARINGGAI, LAMPUNG TIMUR, LAMPUNG",5,128,25,153
https://kawalpemilu.org#24226,"KARYA MAKMUR, LABUHAN MARINGGAI, LAMPUNG TIMUR, LAMPUNG",6,126,16,142
https://kawalpemilu.org#24226,"KARYA MAKMUR, LABUHAN MARINGGAI, LAMPUNG TIMUR, LAMPUNG",7,123,28,151
https://kawalpemilu.org#24226,"KARYA MAKMUR, LABUHAN MARINGGAI, LAMPUNG TIMUR, LAMPUNG",8,149,25,174
https://kawalpemilu.org#24226,"KARYA MAKMUR, LABUHAN MARINGGAI, LAMPUNG TIMUR, LAMPUNG",9,168,23,191
https://kawalpemilu.org#24227,"KARYA TANI, LABUHAN MARINGGAI, LAMPUNG TIMUR, LAMPUNG",1,134,21,155
https://kawalpemilu.org#24227,"KARYA TANI, LABUHAN MARINGGAI, LAMPUNG TIMUR, LAMPUNG",2,123,23,146
https://kawalpemilu.org#24227,"KARYA TANI, LABUHAN MARINGGAI, LAMPUNG TIMUR, LAMPUNG",3,126,32,158
https://kawalpemilu.org#24227,"KARYA TANI, LABUHAN MARINGGAI, LAMPUNG TIMUR, LAMPUNG",4,152,36,188
https://kawalpemilu.org#24227,"KARYA TANI, LABUHAN MARINGGAI, LAMPUNG TIMUR, LAMPUNG",5,137,30,167
https://kawalpemilu.org#24227,"KARYA TANI, LABUHAN MARINGGAI, LAMPUNG TIMUR, LAMPUNG",6,75,17,92
https://kawalpemilu.org#24227,"KARYA TANI, LABUHAN MARINGGAI, LAMPUNG TIMUR, LAMPUNG",7,121,33,154
https://kawalpemilu.org#24227,"KARYA TANI, LABUHAN MARINGGAI, LAMPUNG TIMUR, LAMPUNG",8,141,23,164
https://kawalpemilu.org#24227,"KARYA TANI, LABUHAN MARINGGAI, LAMPUNG TIMUR, LAMPUNG",9,158,28,186
https://kawalpemilu.org#24227,"KARYA TANI, LABUHAN MARINGGAI, LAMPUNG TIMUR, LAMPUNG",10,152,29,181
https://kawalpemilu.org#24227,"KARYA TANI, LABUHAN MARINGGAI, LAMPUNG TIMUR, LAMPUNG",11,140,24,164
https://kawalpemilu.org#24227,"KARYA TANI, LABUHAN MARINGGAI, LAMPUNG TIMUR, LAMPUNG",12,110,75,185
https://kawalpemilu.org#24227,"KARYA TANI, LABUHAN MARINGGAI, LAMPUNG TIMUR, LAMPUNG",13,112,52,164
https://kawalpemilu.org#24227,"KARYA TANI, LABUHAN MARINGGAI, LAMPUNG TIMUR, LAMPUNG",14,106,37,143
https://kawalpemilu.org#24227,"KARYA TANI, LABUHAN MARINGGAI, LAMPUNG TIMUR, LAMPUNG",15,121,54,175
https://kawalpemilu.org#24227,"KARYA TANI, LABUHAN MARINGGAI, LAMPUNG TIMUR, LAMPUNG",16,92,24,116
https://kawalpemilu.org#24227,"KARYA TANI, LABUHAN MARINGGAI, LAMPUNG TIMUR, LAMPUNG",17,85,12,97
https://kawalpemilu.org#24227,"KARYA TANI, LABUHAN MARINGGAI, LAMPUNG TIMUR, LAMPUNG",18,109,22,131
https://kawalpemilu.org#24227,"KARYA TANI, LABUHAN MARINGGAI, LAMPUNG TIMUR, LAMPUNG",19,97,5,102
https://kawalpemilu.org#24227,"KARYA TANI, LABUHAN MARINGGAI, LAMPUNG TIMUR, LAMPUNG",20,92,5,97
https://kawalpemilu.org#24227,"KARYA TANI, LABUHAN MARINGGAI, LAMPUNG TIMUR, LAMPUNG",21,76,13,89
https://kawalpemilu.org#24227,"KARYA TANI, LABUHAN MARINGGAI, LAMPUNG TIMUR, LAMPUNG",22,103,27,130
https://kawalpemilu.org#24228,"MARGA SARI, LABUHAN MARINGGAI, LAMPUNG TIMUR, LAMPUNG",1,104,27,131
https://kawalpemilu.org#24228,"MARGA SARI, LABUHAN MARINGGAI, LAMPUNG TIMUR, LAMPUNG",2,129,43,172
https://kawalpemilu.org#24228,"MARGA SARI, LABUHAN MARINGGAI, LAMPUNG TIMUR, LAMPUNG",3,100,41,141
https://kawalpemilu.org#24228,"MARGA SARI, LABUHAN MARINGGAI, LAMPUNG TIMUR, LAMPUNG",4,106,37,143
https://kawalpemilu.org#24228,"MARGA SARI, LABUHAN MARINGGAI, LAMPUNG TIMUR, LAMPUNG",5,134,64,198
https://kawalpemilu.org#24228,"MARGA SARI, LABUHAN MARINGGAI, LAMPUNG TIMUR, LAMPUNG",6,93,43,136
https://kawalpemilu.org#24228,"MARGA SARI, LABUHAN MARINGGAI, LAMPUNG TIMUR, LAMPUNG",7,113,38,151
https://kawalpemilu.org#24228,"MARGA SARI, LABUHAN MARINGGAI, LAMPUNG TIMUR, LAMPUNG",8,150,67,217
https://kawalpemilu.org#24228,"MARGA SARI, LABUHAN MARINGGAI, LAMPUNG TIMUR, LAMPUNG",9,161,54,215
https://kawalpemilu.org#24228,"MARGA SARI, LABUHAN MARINGGAI, LAMPUNG TIMUR, LAMPUNG",10,124,68,192
https://kawalpemilu.org#24228,"MARGA SARI, LABUHAN MARINGGAI, LAMPUNG TIMUR, LAMPUNG",11,85,57,142
https://kawalpemilu.org#24228,"MARGA SARI, LABUHAN MARINGGAI, LAMPUNG TIMUR, LAMPUNG",12,83,62,145
https://kawalpemilu.org#24228,"MARGA SARI, LABUHAN MARINGGAI, LAMPUNG TIMUR, LAMPUNG",13,104,68,172
https://kawalpemilu.org#24228,"MARGA SARI, LABUHAN MARINGGAI, LAMPUNG TIMUR, LAMPUNG",14,48,129,177
https://kawalpemilu.org#24228,"MARGA SARI, LABUHAN MARINGGAI, LAMPUNG TIMUR, LAMPUNG",15,68,96,164
https://kawalpemilu.org#24228,"MARGA SARI, LABUHAN MARINGGAI, LAMPUNG TIMUR, LAMPUNG",16,180,75,255
https://kawalpemilu.org#24228,"MARGA SARI, LABUHAN MARINGGAI, LAMPUNG TIMUR, LAMPUNG",17,187,64,251
https://kawalpemilu.org#24228,"MARGA SARI, LABUHAN MARINGGAI, LAMPUNG TIMUR, LAMPUNG",18,106,96,202
https://kawalpemilu.org#24228,"MARGA SARI, LABUHAN MARINGGAI, LAMPUNG TIMUR, LAMPUNG",19,154,42,196
https://kawalpemilu.org#24228,"MARGA SARI, LABUHAN MARINGGAI, LAMPUNG TIMUR, LAMPUNG",20,145,51,196
https://kawalpemilu.org#24228,"MARGA SARI, LABUHAN MARINGGAI, LAMPUNG TIMUR, LAMPUNG",21,140,36,176
https://kawalpemilu.org#24229,"SUKORAHAYU, LABUHAN MARINGGAI, LAMPUNG TIMUR, LAMPUNG",1,126,81,207
https://kawalpemilu.org#24229,"SUKORAHAYU, LABUHAN MARINGGAI, LAMPUNG TIMUR, LAMPUNG",2,132,52,184
https://kawalpemilu.org#24229,"SUKORAHAYU, LABUHAN MARINGGAI, LAMPUNG TIMUR, LAMPUNG",3,85,20,105
https://kawalpemilu.org#24229,"SUKORAHAYU, LABUHAN MARINGGAI, LAMPUNG TIMUR, LAMPUNG",4,95,46,141
https://kawalpemilu.org#24229,"SUKORAHAYU, LABUHAN MARINGGAI, LAMPUNG TIMUR, LAMPUNG",5,171,73,244
https://kawalpemilu.org#24229,"SUKORAHAYU, LABUHAN MARINGGAI, LAMPUNG TIMUR, LAMPUNG",6,66,24,90
https://kawalpemilu.org#24229,"SUKORAHAYU, LABUHAN MARINGGAI, LAMPUNG TIMUR, LAMPUNG",7,153,25,178
https://kawalpemilu.org#24229,"SUKORAHAYU, LABUHAN MARINGGAI, LAMPUNG TIMUR, LAMPUNG",8,157,65,222
https://kawalpemilu.org#24229,"SUKORAHAYU, LABUHAN MARINGGAI, LAMPUNG TIMUR, LAMPUNG",9,109,90,199
https://kawalpemilu.org#24230,"SRIGADING, LABUHAN MARINGGAI, LAMPUNG TIMUR, LAMPUNG",1,125,56,181
https://kawalpemilu.org#24230,"SRIGADING, LABUHAN MARINGGAI, LAMPUNG TIMUR, LAMPUNG",3,87,70,157
https://kawalpemilu.org#24230,"SRIGADING, LABUHAN MARINGGAI, LAMPUNG TIMUR, LAMPUNG",4,99,69,168
https://kawalpemilu.org#24230,"SRIGADING, LABUHAN MARINGGAI, LAMPUNG TIMUR, LAMPUNG",5,155,31,186
https://kawalpemilu.org#24230,"SRIGADING, LABUHAN MARINGGAI, LAMPUNG TIMUR, LAMPUNG",6,116,61,177
https://kawalpemilu.org#24230,"SRIGADING, LABUHAN MARINGGAI, LAMPUNG TIMUR, LAMPUNG",7,161,44,205
https://kawalpemilu.org#24230,"SRIGADING, LABUHAN MARINGGAI, LAMPUNG TIMUR, LAMPUNG",8,132,57,189
https://kawalpemilu.org#24230,"SRIGADING, LABUHAN MARINGGAI, LAMPUNG TIMUR, LAMPUNG",9,122,63,185
https://kawalpemilu.org#24230,"SRIGADING, LABUHAN MARINGGAI, LAMPUNG TIMUR, LAMPUNG",10,144,48,192
https://kawalpemilu.org#24230,"SRIGADING, LABUHAN MARINGGAI, LAMPUNG TIMUR, LAMPUNG",11,138,45,183
https://kawalpemilu.org#24230,"SRIGADING, LABUHAN MARINGGAI, LAMPUNG TIMUR, LAMPUNG",12,117,40,157
https://kawalpemilu.org#24230,"SRIGADING, LABUHAN MARINGGAI, LAMPUNG TIMUR, LAMPUNG",13,99,40,139
https://kawalpemilu.org#24230,"SRIGADING, LABUHAN MARINGGAI, LAMPUNG TIMUR, LAMPUNG",14,169,39,208
https://kawalpemilu.org#24230,"SRIGADING, LABUHAN MARINGGAI, LAMPUNG TIMUR, LAMPUNG",15,159,41,200
https://kawalpemilu.org#24230,"SRIGADING, LABUHAN MARINGGAI, LAMPUNG TIMUR, LAMPUNG",16,65,24,89
https://kawalpemilu.org#24230,"SRIGADING, LABUHAN MARINGGAI, LAMPUNG TIMUR, LAMPUNG",17,95,53,148
https://kawalpemilu.org#24230,"SRIGADING, LABUHAN MARINGGAI, LAMPUNG TIMUR, LAMPUNG",18,86,64,150
https://kawalpemilu.org#24230,"SRIGADING, LABUHAN MARINGGAI, LAMPUNG TIMUR, LAMPUNG",19,120,64,184
https://kawalpemilu.org#24230,"SRIGADING, LABUHAN MARINGGAI, LAMPUNG TIMUR, LAMPUNG",20,130,40,170
https://kawalpemilu.org#24230,"SRIGADING, LABUHAN MARINGGAI, LAMPUNG TIMUR, LAMPUNG",21,99,41,140
https://kawalpemilu.org#24230,"SRIGADING, LABUHAN MARINGGAI, LAMPUNG TIMUR, LAMPUNG",22,113,64,177
https://kawalpemilu.org#24230,"SRIGADING, LABUHAN MARINGGAI, LAMPUNG TIMUR, LAMPUNG",23,129,70,199
https://kawalpemilu.org#24230,"SRIGADING, LABUHAN MARINGGAI, LAMPUNG TIMUR, LAMPUNG",24,117,58,175
https://kawalpemilu.org#24231,"KARANG ANYAR, LABUHAN MARINGGAI, LAMPUNG TIMUR, LAMPUNG",1,129,45,174
https://kawalpemilu.org#24231,"KARANG ANYAR, LABUHAN MARINGGAI, LAMPUNG TIMUR, LAMPUNG",2,124,65,189
https://kawalpemilu.org#24231,"KARANG ANYAR, LABUHAN MARINGGAI, LAMPUNG TIMUR, LAMPUNG",3,97,81,178
https://kawalpemilu.org#24231,"KARANG ANYAR, LABUHAN MARINGGAI, LAMPUNG TIMUR, LAMPUNG",4,103,94,197
https://kawalpemilu.org#24231,"KARANG ANYAR, LABUHAN MARINGGAI, LAMPUNG TIMUR, LAMPUNG",5,128,44,172
https://kawalpemilu.org#24231,"KARANG ANYAR, LABUHAN MARINGGAI, LAMPUNG TIMUR, LAMPUNG",6,117,59,176
https://kawalpemilu.org#24231,"KARANG ANYAR, LABUHAN MARINGGAI, LAMPUNG TIMUR, LAMPUNG",7,117,70,187
https://kawalpemilu.org#24231,"KARANG ANYAR, LABUHAN MARINGGAI, LAMPUNG TIMUR, LAMPUNG",8,127,44,171
https://kawalpemilu.org#24231,"KARANG ANYAR, LABUHAN MARINGGAI, LAMPUNG TIMUR, LAMPUNG",9,129,35,164
https://kawalpemilu.org#24231,"KARANG ANYAR, LABUHAN MARINGGAI, LAMPUNG TIMUR, LAMPUNG",10,125,41,166
https://kawalpemilu.org#24231,"KARANG ANYAR, LABUHAN MARINGGAI, LAMPUNG TIMUR, LAMPUNG",11,132,61,193
https://kawalpemilu.org#24231,"KARANG ANYAR, LABUHAN MARINGGAI, LAMPUNG TIMUR, LAMPUNG",12,136,62,198
https://kawalpemilu.org#24231,"KARANG ANYAR, LABUHAN MARINGGAI, LAMPUNG TIMUR, LAMPUNG",13,142,38,162
https://kawalpemilu.org#24231,"KARANG ANYAR, LABUHAN MARINGGAI, LAMPUNG TIMUR, LAMPUNG",14,123,60,183
https://kawalpemilu.org#24231,"KARANG ANYAR, LABUHAN MARINGGAI, LAMPUNG TIMUR, LAMPUNG",15,128,47,175
https://kawalpemilu.org#24231,"KARANG ANYAR, LABUHAN MARINGGAI, LAMPUNG TIMUR, LAMPUNG",16,164,31,195
https://kawalpemilu.org#24231,"KARANG ANYAR, LABUHAN MARINGGAI, LAMPUNG TIMUR, LAMPUNG",17,132,25,157
https://kawalpemilu.org#24231,"KARANG ANYAR, LABUHAN MARINGGAI, LAMPUNG TIMUR, LAMPUNG",18,122,18,140
https://kawalpemilu.org#24231,"KARANG ANYAR, LABUHAN MARINGGAI, LAMPUNG TIMUR, LAMPUNG",19,142,21,163
https://kawalpemilu.org#24231,"KARANG ANYAR, LABUHAN MARINGGAI, LAMPUNG TIMUR, LAMPUNG",20,138,31,169
https://kawalpemilu.org#24231,"KARANG ANYAR, LABUHAN MARINGGAI, LAMPUNG TIMUR, LAMPUNG",21,117,37,154
https://kawalpemilu.org#24231,"KARANG ANYAR, LABUHAN MARINGGAI, LAMPUNG TIMUR, LAMPUNG",22,125,43,168
https://kawalpemilu.org#24231,"KARANG ANYAR, LABUHAN MARINGGAI, LAMPUNG TIMUR, LAMPUNG",23,144,46,190
https://kawalpemilu.org#24231,"KARANG ANYAR, LABUHAN MARINGGAI, LAMPUNG TIMUR, LAMPUNG",24,123,44,167
https://kawalpemilu.org#24231,"KARANG ANYAR, LABUHAN MARINGGAI, LAMPUNG TIMUR, LAMPUNG",25,157,23,180
https://kawalpemilu.org#24232,"MARINGGAI, LABUHAN MARINGGAI, LAMPUNG TIMUR, LAMPUNG",1,38,76,114
https://kawalpemilu.org#24232,"MARINGGAI, LABUHAN MARINGGAI, LAMPUNG TIMUR, LAMPUNG",2,29,85,114
https://kawalpemilu.org#24232,"MARINGGAI, LABUHAN MARINGGAI, LAMPUNG TIMUR, LAMPUNG",3,52,128,180
https://kawalpemilu.org#24232,"MARINGGAI, LABUHAN MARINGGAI, LAMPUNG TIMUR, LAMPUNG",4,54,105,159
https://kawalpemilu.org#24232,"MARINGGAI, LABUHAN MARINGGAI, LAMPUNG TIMUR, LAMPUNG",5,46,106,152
https://kawalpemilu.org#24232,"MARINGGAI, LABUHAN MARINGGAI, LAMPUNG TIMUR, LAMPUNG",6,121,57,178
https://kawalpemilu.org#24232,"MARINGGAI, LABUHAN MARINGGAI, LAMPUNG TIMUR, LAMPUNG",7,150,18,168
https://kawalpemilu.org#24232,"MARINGGAI, LABUHAN MARINGGAI, LAMPUNG TIMUR, LAMPUNG",8,153,23,176
https://kawalpemilu.org#24232,"MARINGGAI, LABUHAN MARINGGAI, LAMPUNG TIMUR, LAMPUNG",9,75,56,131
https://kawalpemilu.org#24232,"MARINGGAI, LABUHAN MARINGGAI, LAMPUNG TIMUR, LAMPUNG",10,62,61,123
https://kawalpemilu.org#24232,"MARINGGAI, LABUHAN MARINGGAI, LAMPUNG TIMUR, LAMPUNG",11,64,93,157
https://kawalpemilu.org#24232,"MARINGGAI, LABUHAN MARINGGAI, LAMPUNG TIMUR, LAMPUNG",12,92,147,239
https://kawalpemilu.org#24232,"MARINGGAI, LABUHAN MARINGGAI, LAMPUNG TIMUR, LAMPUNG",13,56,150,206
https://kawalpemilu.org#24232,"MARINGGAI, LABUHAN MARINGGAI, LAMPUNG TIMUR, LAMPUNG",14,73,91,164
https://kawalpemilu.org#24234,"NEGARA BATIN, JABUNG, LAMPUNG TIMUR, LAMPUNG",1,71,108,179
https://kawalpemilu.org#24234,"NEGARA BATIN, JABUNG, LAMPUNG TIMUR, LAMPUNG",2,65,103,168
https://kawalpemilu.org#24234,"NEGARA BATIN, JABUNG, LAMPUNG TIMUR, LAMPUNG",3,59,149,208
https://kawalpemilu.org#24234,"NEGARA BATIN, JABUNG, LAMPUNG TIMUR, LAMPUNG",4,61,132,193
https://kawalpemilu.org#24234,"NEGARA BATIN, JABUNG, LAMPUNG TIMUR, LAMPUNG",5,45,129,174
https://kawalpemilu.org#24234,"NEGARA BATIN, JABUNG, LAMPUNG TIMUR, LAMPUNG",6,19,75,94
https://kawalpemilu.org#24234,"NEGARA BATIN, JABUNG, LAMPUNG TIMUR, LAMPUNG",7,23,119,142
https://kawalpemilu.org#24234,"NEGARA BATIN, JABUNG, LAMPUNG TIMUR, LAMPUNG",8,62,148,210
https://kawalpemilu.org#24234,"NEGARA BATIN, JABUNG, LAMPUNG TIMUR, LAMPUNG",9,76,177,253
https://kawalpemilu.org#24234,"NEGARA BATIN, JABUNG, LAMPUNG TIMUR, LAMPUNG",10,47,120,167
https://kawalpemilu.org#24234,"NEGARA BATIN, JABUNG, LAMPUNG TIMUR, LAMPUNG",11,43,136,179
https://kawalpemilu.org#24234,"NEGARA BATIN, JABUNG, LAMPUNG TIMUR, LAMPUNG",12,67,77,144
https://kawalpemilu.org#24234,"NEGARA BATIN, JABUNG, LAMPUNG TIMUR, LAMPUNG",13,105,49,154
https://kawalpemilu.org#24234,"NEGARA BATIN, JABUNG, LAMPUNG TIMUR, LAMPUNG",14,99,53,152
https://kawalpemilu.org#24234,"NEGARA BATIN, JABUNG, LAMPUNG TIMUR, LAMPUNG",15,75,85,160
https://kawalpemilu.org#24234,"NEGARA BATIN, JABUNG, LAMPUNG TIMUR, LAMPUNG",16,52,85,137
https://kawalpemilu.org#24234,"NEGARA BATIN, JABUNG, LAMPUNG TIMUR, LAMPUNG",17,58,82,140
https://kawalpemilu.org#24234,"NEGARA BATIN, JABUNG, LAMPUNG TIMUR, LAMPUNG",18,34,54,88
https://kawalpemilu.org#24234,"NEGARA BATIN, JABUNG, LAMPUNG TIMUR, LAMPUNG",19,31,80,111
https://kawalpemilu.org#24234,"NEGARA BATIN, JABUNG, LAMPUNG TIMUR, LAMPUNG",20,47,86,133
https://kawalpemilu.org#24234,"NEGARA BATIN, JABUNG, LAMPUNG TIMUR, LAMPUNG",21,45,62,107
https://kawalpemilu.org#24235,"ASAHAN, JABUNG, LAMPUNG TIMUR, LAMPUNG",1,13,169,182
https://kawalpemilu.org#24235,"ASAHAN, JABUNG, LAMPUNG TIMUR, LAMPUNG",3,24,150,174
https://kawalpemilu.org#24235,"ASAHAN, JABUNG, LAMPUNG TIMUR, LAMPUNG",4,55,165,220
https://kawalpemilu.org#24235,"ASAHAN, JABUNG, LAMPUNG TIMUR, LAMPUNG",5,41,168,209
https://kawalpemilu.org#24235,"ASAHAN, JABUNG, LAMPUNG TIMUR, LAMPUNG",6,135,60,195
https://kawalpemilu.org#24235,"ASAHAN, JABUNG, LAMPUNG TIMUR, LAMPUNG",7,155,57,212
https://kawalpemilu.org#24235,"ASAHAN, JABUNG, LAMPUNG TIMUR, LAMPUNG",8,110,68,178
https://kawalpemilu.org#24235,"ASAHAN, JABUNG, LAMPUNG TIMUR, LAMPUNG",9,140,45,185
https://kawalpemilu.org#24235,"ASAHAN, JABUNG, LAMPUNG TIMUR, LAMPUNG",10,163,42,205
https://kawalpemilu.org#24235,"ASAHAN, JABUNG, LAMPUNG TIMUR, LAMPUNG",11,102,13,115
https://kawalpemilu.org#24235,"ASAHAN, JABUNG, LAMPUNG TIMUR, LAMPUNG",12,183,15,198
https://kawalpemilu.org#24235,"ASAHAN, JABUNG, LAMPUNG TIMUR, LAMPUNG",13,198,12,210
https://kawalpemilu.org#24236,"ADIREJO, JABUNG, LAMPUNG TIMUR, LAMPUNG",1,93,49,142
https://kawalpemilu.org#24236,"ADIREJO, JABUNG, LAMPUNG TIMUR, LAMPUNG",2,97,49,146
https://kawalpemilu.org#24236,"ADIREJO, JABUNG, LAMPUNG TIMUR, LAMPUNG",4,132,62,194
https://kawalpemilu.org#24236,"ADIREJO, JABUNG, LAMPUNG TIMUR, LAMPUNG",5,106,29,135
https://kawalpemilu.org#24236,"ADIREJO, JABUNG, LAMPUNG TIMUR, LAMPUNG",6,124,26,150
https://kawalpemilu.org#24236,"ADIREJO, JABUNG, LAMPUNG TIMUR, LAMPUNG",7,142,19,161
https://kawalpemilu.org#24236,"ADIREJO, JABUNG, LAMPUNG TIMUR, LAMPUNG",8,144,50,194
https://kawalpemilu.org#24236,"ADIREJO, JABUNG, LAMPUNG TIMUR, LAMPUNG",9,177,62,239
https://kawalpemilu.org#24236,"ADIREJO, JABUNG, LAMPUNG TIMUR, LAMPUNG",10,100,37,137
https://kawalpemilu.org#24236,"ADIREJO, JABUNG, LAMPUNG TIMUR, LAMPUNG",11,144,131,175
https://kawalpemilu.org#24236,"ADIREJO, JABUNG, LAMPUNG TIMUR, LAMPUNG",12,138,48,186
https://kawalpemilu.org#24237,"GUNUNG MEKAR, JABUNG, LAMPUNG TIMUR, LAMPUNG",1,96,46,142
https://kawalpemilu.org#24237,"GUNUNG MEKAR, JABUNG, LAMPUNG TIMUR, LAMPUNG",2,117,38,155
https://kawalpemilu.org#24237,"GUNUNG MEKAR, JABUNG, LAMPUNG TIMUR, LAMPUNG",3,135,30,165
https://kawalpemilu.org#24237,"GUNUNG MEKAR, JABUNG, LAMPUNG TIMUR, LAMPUNG",4,87,23,110
https://kawalpemilu.org#24237,"GUNUNG MEKAR, JABUNG, LAMPUNG TIMUR, LAMPUNG",5,101,41,142
https://kawalpemilu.org#24237,"GUNUNG MEKAR, JABUNG, LAMPUNG TIMUR, LAMPUNG",6,142,37,179
https://kawalpemilu.org#24237,"GUNUNG MEKAR, JABUNG, LAMPUNG TIMUR, LAMPUNG",7,113,41,154
https://kawalpemilu.org#24237,"GUNUNG MEKAR, JABUNG, LAMPUNG TIMUR, LAMPUNG",8,108,62,170
https://kawalpemilu.org#24237,"GUNUNG MEKAR, JABUNG, LAMPUNG TIMUR, LAMPUNG",9,157,47,204
https://kawalpemilu.org#24237,"GUNUNG MEKAR, JABUNG, LAMPUNG TIMUR, LAMPUNG",10,110,23,133
https://kawalpemilu.org#24237,"GUNUNG MEKAR, JABUNG, LAMPUNG TIMUR, LAMPUNG",11,122,25,147
https://kawalpemilu.org#24237,"GUNUNG MEKAR, JABUNG, LAMPUNG TIMUR, LAMPUNG",12,152,33,185
https://kawalpemilu.org#24238,"GUNUNG SUGIH KECIL, JABUNG, LAMPUNG TIMUR, LAMPUNG",1,34,105,139
https://kawalpemilu.org#24238,"GUNUNG SUGIH KECIL, JABUNG, LAMPUNG TIMUR, LAMPUNG",2,38,48,86
https://kawalpemilu.org#24238,"GUNUNG SUGIH KECIL, JABUNG, LAMPUNG TIMUR, LAMPUNG",3,99,49,148
https://kawalpemilu.org#24238,"GUNUNG SUGIH KECIL, JABUNG, LAMPUNG TIMUR, LAMPUNG",4,85,35,120
https://kawalpemilu.org#24238,"GUNUNG SUGIH KECIL, JABUNG, LAMPUNG TIMUR, LAMPUNG",5,88,63,151
https://kawalpemilu.org#24238,"GUNUNG SUGIH KECIL, JABUNG, LAMPUNG TIMUR, LAMPUNG",6,67,48,115
https://kawalpemilu.org#24238,"GUNUNG SUGIH KECIL, JABUNG, LAMPUNG TIMUR, LAMPUNG",7,86,40,126
https://kawalpemilu.org#24238,"GUNUNG SUGIH KECIL, JABUNG, LAMPUNG TIMUR, LAMPUNG",8,72,31,103
https://kawalpemilu.org#24239,"PEMATANG TAHALO, JABUNG, LAMPUNG TIMUR, LAMPUNG",1,138,33,171
https://kawalpemilu.org#24239,"PEMATANG TAHALO, JABUNG, LAMPUNG TIMUR, LAMPUNG",2,194,20,214
https://kawalpemilu.org#24239,"PEMATANG TAHALO, JABUNG, LAMPUNG TIMUR, LAMPUNG",3,142,22,164
https://kawalpemilu.org#24239,"PEMATANG TAHALO, JABUNG, LAMPUNG TIMUR, LAMPUNG",4,150,16,166
https://kawalpemilu.org#24239,"PEMATANG TAHALO, JABUNG, LAMPUNG TIMUR, LAMPUNG",5,183,40,223
https://kawalpemilu.org#24239,"PEMATANG TAHALO, JABUNG, LAMPUNG TIMUR, LAMPUNG",6,213,39,252
https://kawalpemilu.org#24239,"PEMATANG TAHALO, JABUNG, LAMPUNG TIMUR, LAMPUNG",7,195,25,220
https://kawalpemilu.org#24239,"PEMATANG TAHALO, JABUNG, LAMPUNG TIMUR, LAMPUNG",8,178,17,195
https://kawalpemilu.org#24239,"PEMATANG TAHALO, JABUNG, LAMPUNG TIMUR, LAMPUNG",9,189,19,208
https://kawalpemilu.org#24239,"PEMATANG TAHALO, JABUNG, LAMPUNG TIMUR, LAMPUNG",10,229,14,243
https://kawalpemilu.org#24239,"PEMATANG TAHALO, JABUNG, LAMPUNG TIMUR, LAMPUNG",11,149,10,159
https://kawalpemilu.org#24239,"PEMATANG TAHALO, JABUNG, LAMPUNG TIMUR, LAMPUNG",12,142,8,150
https://kawalpemilu.org#24239,"PEMATANG TAHALO, JABUNG, LAMPUNG TIMUR, LAMPUNG",13,153,5,158
https://kawalpemilu.org#24239,"PEMATANG TAHALO, JABUNG, LAMPUNG TIMUR, LAMPUNG",15,188,3,191
https://kawalpemilu.org#24239,"PEMATANG TAHALO, JABUNG, LAMPUNG TIMUR, LAMPUNG",17,198,9,207
https://kawalpemilu.org#24240,"JABUNG, JABUNG, LAMPUNG TIMUR, LAMPUNG",1,33,124,157
https://kawalpemilu.org#24240,"JABUNG, JABUNG, LAMPUNG TIMUR, LAMPUNG",2,43,107,150
https://kawalpemilu.org#24240,"JABUNG, JABUNG, LAMPUNG TIMUR, LAMPUNG",3,29,117,146
https://kawalpemilu.org#24240,"JABUNG, JABUNG, LAMPUNG TIMUR, LAMPUNG",4,23,71,94
https://kawalpemilu.org#24240,"JABUNG, JABUNG, LAMPUNG TIMUR, LAMPUNG",5,70,91,161
https://kawalpemilu.org#24240,"JABUNG, JABUNG, LAMPUNG TIMUR, LAMPUNG",7,66,5,71
https://kawalpemilu.org#24240,"JABUNG, JABUNG, LAMPUNG TIMUR, LAMPUNG",8,24,117,141
https://kawalpemilu.org#24240,"JABUNG, JABUNG, LAMPUNG TIMUR, LAMPUNG",9,42,156,198
https://kawalpemilu.org#24240,"JABUNG, JABUNG, LAMPUNG TIMUR, LAMPUNG",10,38,103,141
https://kawalpemilu.org#24240,"JABUNG, JABUNG, LAMPUNG TIMUR, LAMPUNG",11,31,109,140
https://kawalpemilu.org#24240,"JABUNG, JABUNG, LAMPUNG TIMUR, LAMPUNG",12,38,148,186
https://kawalpemilu.org#24240,"JABUNG, JABUNG, LAMPUNG TIMUR, LAMPUNG",13,71,105,176
https://kawalpemilu.org#24240,"JABUNG, JABUNG, LAMPUNG TIMUR, LAMPUNG",14,86,95,181
https://kawalpemilu.org#24240,"JABUNG, JABUNG, LAMPUNG TIMUR, LAMPUNG",15,62,34,96
https://kawalpemilu.org#24240,"JABUNG, JABUNG, LAMPUNG TIMUR, LAMPUNG",16,62,48,110
https://kawalpemilu.org#24240,"JABUNG, JABUNG, LAMPUNG TIMUR, LAMPUNG",17,67,80,147
https://kawalpemilu.org#24240,"JABUNG, JABUNG, LAMPUNG TIMUR, LAMPUNG",18,80,74,154
https://kawalpemilu.org#24240,"JABUNG, JABUNG, LAMPUNG TIMUR, LAMPUNG",19,122,26,148
https://kawalpemilu.org#24240,"JABUNG, JABUNG, LAMPUNG TIMUR, LAMPUNG",20,123,27,150
https://kawalpemilu.org#24240,"JABUNG, JABUNG, LAMPUNG TIMUR, LAMPUNG",21,129,16,145
https://kawalpemilu.org#24240,"JABUNG, JABUNG, LAMPUNG TIMUR, LAMPUNG",22,127,39,166
https://kawalpemilu.org#24240,"JABUNG, JABUNG, LAMPUNG TIMUR, LAMPUNG",23,99,48,147
https://kawalpemilu.org#24240,"JABUNG, JABUNG, LAMPUNG TIMUR, LAMPUNG",24,62,45,107
https://kawalpemilu.org#24241,"NEGARA SAKA, JABUNG, LAMPUNG TIMUR, LAMPUNG",1,45,83,128
https://kawalpemilu.org#24241,"NEGARA SAKA, JABUNG, LAMPUNG TIMUR, LAMPUNG",2,51,100,151
https://kawalpemilu.org#24241,"NEGARA SAKA, JABUNG, LAMPUNG TIMUR, LAMPUNG",3,53,107,160
https://kawalpemilu.org#24241,"NEGARA SAKA, JABUNG, LAMPUNG TIMUR, LAMPUNG",4,43,110,153
https://kawalpemilu.org#24241,"NEGARA SAKA, JABUNG, LAMPUNG TIMUR, LAMPUNG",5,33,50,83
https://kawalpemilu.org#24242,"BETENG SARI, JABUNG, LAMPUNG TIMUR, LAMPUNG",1,124,51,175
https://kawalpemilu.org#24242,"BETENG SARI, JABUNG, LAMPUNG TIMUR, LAMPUNG",2,116,17,133
https://kawalpemilu.org#24242,"BETENG SARI, JABUNG, LAMPUNG TIMUR, LAMPUNG",3,112,23,135
https://kawalpemilu.org#24242,"BETENG SARI, JABUNG, LAMPUNG TIMUR, LAMPUNG",4,134,24,158
https://kawalpemilu.org#24242,"BETENG SARI, JABUNG, LAMPUNG TIMUR, LAMPUNG",5,129,35,164
https://kawalpemilu.org#24242,"BETENG SARI, JABUNG, LAMPUNG TIMUR, LAMPUNG",6,124,21,145
https://kawalpemilu.org#24242,"BETENG SARI, JABUNG, LAMPUNG TIMUR, LAMPUNG",7,138,27,165
https://kawalpemilu.org#24242,"BETENG SARI, JABUNG, LAMPUNG TIMUR, LAMPUNG",8,185,17,202
https://kawalpemilu.org#24242,"BETENG SARI, JABUNG, LAMPUNG TIMUR, LAMPUNG",9,160,27,187
https://kawalpemilu.org#24242,"BETENG SARI, JABUNG, LAMPUNG TIMUR, LAMPUNG",10,174,22,196
https://kawalpemilu.org#24243,"BELIMBING SARI, JABUNG, LAMPUNG TIMUR, LAMPUNG",1,180,28,208
https://kawalpemilu.org#24243,"BELIMBING SARI, JABUNG, LAMPUNG TIMUR, LAMPUNG",3,155,24,179
https://kawalpemilu.org#24243,"BELIMBING SARI, JABUNG, LAMPUNG TIMUR, LAMPUNG",4,142,48,190
https://kawalpemilu.org#24243,"BELIMBING SARI, JABUNG, LAMPUNG TIMUR, LAMPUNG",5,163,36,199
https://kawalpemilu.org#24243,"BELIMBING SARI, JABUNG, LAMPUNG TIMUR, LAMPUNG",6,158,28,186
https://kawalpemilu.org#24243,"BELIMBING SARI, JABUNG, LAMPUNG TIMUR, LAMPUNG",7,172,21,193
https://kawalpemilu.org#24244,"MEKAR JAYA, JABUNG, LAMPUNG TIMUR, LAMPUNG",1,187,12,199
https://kawalpemilu.org#24244,"MEKAR JAYA, JABUNG, LAMPUNG TIMUR, LAMPUNG",2,140,21,161
https://kawalpemilu.org#24244,"MEKAR JAYA, JABUNG, LAMPUNG TIMUR, LAMPUNG",3,121,15,136
https://kawalpemilu.org#24244,"MEKAR JAYA, JABUNG, LAMPUNG TIMUR, LAMPUNG",4,57,33,90
https://kawalpemilu.org#24244,"MEKAR JAYA, JABUNG, LAMPUNG TIMUR, LAMPUNG",5,139,22,161
https://kawalpemilu.org#24244,"MEKAR JAYA, JABUNG, LAMPUNG TIMUR, LAMPUNG",6,157,22,179
https://kawalpemilu.org#24244,"MEKAR JAYA, JABUNG, LAMPUNG TIMUR, LAMPUNG",7,77,23,100
https://kawalpemilu.org#24245,"MUMBANG JAYA, JABUNG, LAMPUNG TIMUR, LAMPUNG",1,157,51,208
https://kawalpemilu.org#24245,"MUMBANG JAYA, JABUNG, LAMPUNG TIMUR, LAMPUNG",2,87,68,155
https://kawalpemilu.org#24245,"MUMBANG JAYA, JABUNG, LAMPUNG TIMUR, LAMPUNG",3,108,69,177
https://kawalpemilu.org#24245,"MUMBANG JAYA, JABUNG, LAMPUNG TIMUR, LAMPUNG",4,146,56,202
https://kawalpemilu.org#24245,"MUMBANG JAYA, JABUNG, LAMPUNG TIMUR, LAMPUNG",5,139,38,177
https://kawalpemilu.org#24245,"MUMBANG JAYA, JABUNG, LAMPUNG TIMUR, LAMPUNG",6,213,38,251
https://kawalpemilu.org#24245,"MUMBANG JAYA, JABUNG, LAMPUNG TIMUR, LAMPUNG",8,106,25,131
https://kawalpemilu.org#24245,"MUMBANG JAYA, JABUNG, LAMPUNG TIMUR, LAMPUNG",9,118,14,132
https://kawalpemilu.org#24245,"MUMBANG JAYA, JABUNG, LAMPUNG TIMUR, LAMPUNG",10,147,12,159
https://kawalpemilu.org#24246,"SAMBIREJO, JABUNG, LAMPUNG TIMUR, LAMPUNG",1,168,20,188
https://kawalpemilu.org#24246,"SAMBIREJO, JABUNG, LAMPUNG TIMUR, LAMPUNG",2,122,37,159
https://kawalpemilu.org#24246,"SAMBIREJO, JABUNG, LAMPUNG TIMUR, LAMPUNG",3,141,31,172
https://kawalpemilu.org#24246,"SAMBIREJO, JABUNG, LAMPUNG TIMUR, LAMPUNG",4,120,41,161
https://kawalpemilu.org#24246,"SAMBIREJO, JABUNG, LAMPUNG TIMUR, LAMPUNG",5,178,24,202
https://kawalpemilu.org#24246,"SAMBIREJO, JABUNG, LAMPUNG TIMUR, LAMPUNG",6,166,17,185
https://kawalpemilu.org#24246,"SAMBIREJO, JABUNG, LAMPUNG TIMUR, LAMPUNG",7,135,51,186
https://kawalpemilu.org#24246,"SAMBIREJO, JABUNG, LAMPUNG TIMUR, LAMPUNG",8,175,23,198
https://kawalpemilu.org#24247,"ADI LUHUR, JABUNG, LAMPUNG TIMUR, LAMPUNG",1,162,10,172
https://kawalpemilu.org#24247,"ADI LUHUR, JABUNG, LAMPUNG TIMUR, LAMPUNG",2,162,9,171
https://kawalpemilu.org#24247,"ADI LUHUR, JABUNG, LAMPUNG TIMUR, LAMPUNG",3,134,11,145
https://kawalpemilu.org#24247,"ADI LUHUR, JABUNG, LAMPUNG TIMUR, LAMPUNG",4,133,14,147
https://kawalpemilu.org#24247,"ADI LUHUR, JABUNG, LAMPUNG TIMUR, LAMPUNG",5,131,15,146
https://kawalpemilu.org#24247,"ADI LUHUR, JABUNG, LAMPUNG TIMUR, LAMPUNG",6,160,13,173
https://kawalpemilu.org#24247,"ADI LUHUR, JABUNG, LAMPUNG TIMUR, LAMPUNG",7,153,14,167
https://kawalpemilu.org#24247,"ADI LUHUR, JABUNG, LAMPUNG TIMUR, LAMPUNG",8,149,23,172
https://kawalpemilu.org#24247,"ADI LUHUR, JABUNG, LAMPUNG TIMUR, LAMPUNG",9,164,12,176
https://kawalpemilu.org#24247,"ADI LUHUR, JABUNG, LAMPUNG TIMUR, LAMPUNG",10,109,8,117
https://kawalpemilu.org#24247,"ADI LUHUR, JABUNG, LAMPUNG TIMUR, LAMPUNG",11,138,13,151
https://kawalpemilu.org#24247,"ADI LUHUR, JABUNG, LAMPUNG TIMUR, LAMPUNG",12,99,6,105
https://kawalpemilu.org#24247,"ADI LUHUR, JABUNG, LAMPUNG TIMUR, LAMPUNG",13,105,19,124
https://kawalpemilu.org#24247,"ADI LUHUR, JABUNG, LAMPUNG TIMUR, LAMPUNG",14,121,21,142
https://kawalpemilu.org#24247,"ADI LUHUR, JABUNG, LAMPUNG TIMUR, LAMPUNG",15,126,11,137
https://kawalpemilu.org#24248,"TANJUNG SARI, JABUNG, LAMPUNG TIMUR, LAMPUNG",1,189,51,240
https://kawalpemilu.org#24248,"TANJUNG SARI, JABUNG, LAMPUNG TIMUR, LAMPUNG",2,207,31,238
https://kawalpemilu.org#24248,"TANJUNG SARI, JABUNG, LAMPUNG TIMUR, LAMPUNG",3,134,19,153
https://kawalpemilu.org#24248,"TANJUNG SARI, JABUNG, LAMPUNG TIMUR, LAMPUNG",4,150,37,187
https://kawalpemilu.org#24248,"TANJUNG SARI, JABUNG, LAMPUNG TIMUR, LAMPUNG",5,157,17,174
https://kawalpemilu.org#24250,"PEKALONGAN, PEKALONGAN, LAMPUNG TIMUR, LAMPUNG",1,137,68,205
https://kawalpemilu.org#24250,"PEKALONGAN, PEKALONGAN, LAMPUNG TIMUR, LAMPUNG",2,111,80,191
https://kawalpemilu.org#24250,"PEKALONGAN, PEKALONGAN, LAMPUNG TIMUR, LAMPUNG",3,69,61,130
https://kawalpemilu.org#24250,"PEKALONGAN, PEKALONGAN, LAMPUNG TIMUR, LAMPUNG",4,85,62,147
https://kawalpemilu.org#24250,"PEKALONGAN, PEKALONGAN, LAMPUNG TIMUR, LAMPUNG",5,76,30,106
https://kawalpemilu.org#24250,"PEKALONGAN, PEKALONGAN, LAMPUNG TIMUR, LAMPUNG",6,112,119,231
https://kawalpemilu.org#24250,"PEKALONGAN, PEKALONGAN, LAMPUNG TIMUR, LAMPUNG",7,121,52,173
https://kawalpemilu.org#24250,"PEKALONGAN, PEKALONGAN, LAMPUNG TIMUR, LAMPUNG",8,175,48,223
https://kawalpemilu.org#24250,"PEKALONGAN, PEKALONGAN, LAMPUNG TIMUR, LAMPUNG",9,169,58,227
https://kawalpemilu.org#24250,"PEKALONGAN, PEKALONGAN, LAMPUNG TIMUR, LAMPUNG",10,94,55,149
https://kawalpemilu.org#24250,"PEKALONGAN, PEKALONGAN, LAMPUNG TIMUR, LAMPUNG",11,88,54,142
https://kawalpemilu.org#24250,"PEKALONGAN, PEKALONGAN, LAMPUNG TIMUR, LAMPUNG",12,68,63,131
https://kawalpemilu.org#24250,"PEKALONGAN, PEKALONGAN, LAMPUNG TIMUR, LAMPUNG",13,108,40,148
https://kawalpemilu.org#24250,"PEKALONGAN, PEKALONGAN, LAMPUNG TIMUR, LAMPUNG",14,96,90,186
https://kawalpemilu.org#24250,"PEKALONGAN, PEKALONGAN, LAMPUNG TIMUR, LAMPUNG",15,112,65,177
https://kawalpemilu.org#24251,"ADI REJO, PEKALONGAN, LAMPUNG TIMUR, LAMPUNG",1,137,77,214
https://kawalpemilu.org#24251,"ADI REJO, PEKALONGAN, LAMPUNG TIMUR, LAMPUNG",2,112,70,182
https://kawalpemilu.org#24251,"ADI REJO, PEKALONGAN, LAMPUNG TIMUR, LAMPUNG",3,149,57,206
https://kawalpemilu.org#24251,"ADI REJO, PEKALONGAN, LAMPUNG TIMUR, LAMPUNG",4,92,57,149
https://kawalpemilu.org#24251,"ADI REJO, PEKALONGAN, LAMPUNG TIMUR, LAMPUNG",5,83,49,132
https://kawalpemilu.org#24251,"ADI REJO, PEKALONGAN, LAMPUNG TIMUR, LAMPUNG",6,111,49,160
https://kawalpemilu.org#24251,"ADI REJO, PEKALONGAN, LAMPUNG TIMUR, LAMPUNG",7,142,87,229
https://kawalpemilu.org#24251,"ADI REJO, PEKALONGAN, LAMPUNG TIMUR, LAMPUNG",8,146,77,223
https://kawalpemilu.org#24251,"ADI REJO, PEKALONGAN, LAMPUNG TIMUR, LAMPUNG",10,84,75,159
https://kawalpemilu.org#24251,"ADI REJO, PEKALONGAN, LAMPUNG TIMUR, LAMPUNG",11,109,60,169
https://kawalpemilu.org#24251,"ADI REJO, PEKALONGAN, LAMPUNG TIMUR, LAMPUNG",12,84,82,166
https://kawalpemilu.org#24251,"ADI REJO, PEKALONGAN, LAMPUNG TIMUR, LAMPUNG",13,113,69,182
https://kawalpemilu.org#24251,"ADI REJO, PEKALONGAN, LAMPUNG TIMUR, LAMPUNG",14,129,94,223
https://kawalpemilu.org#24251,"ADI REJO, PEKALONGAN, LAMPUNG TIMUR, LAMPUNG",15,165,61,226
https://kawalpemilu.org#24252,"SIDODADI, PEKALONGAN, LAMPUNG TIMUR, LAMPUNG",1,0,0,0
https://kawalpemilu.org#24252,"SIDODADI, PEKALONGAN, LAMPUNG TIMUR, LAMPUNG",2,0,0,0
https://kawalpemilu.org#24252,"SIDODADI, PEKALONGAN, LAMPUNG TIMUR, LAMPUNG",3,0,0,0
https://kawalpemilu.org#24252,"SIDODADI, PEKALONGAN, LAMPUNG TIMUR, LAMPUNG",4,153,62,215
https://kawalpemilu.org#24252,"SIDODADI, PEKALONGAN, LAMPUNG TIMUR, LAMPUNG",5,104,62,166
https://kawalpemilu.org#24252,"SIDODADI, PEKALONGAN, LAMPUNG TIMUR, LAMPUNG",6,80,56,136
https://kawalpemilu.org#24252,"SIDODADI, PEKALONGAN, LAMPUNG TIMUR, LAMPUNG",7,0,0,0
https://kawalpemilu.org#24252,"SIDODADI, PEKALONGAN, LAMPUNG TIMUR, LAMPUNG",8,0,0,0
https://kawalpemilu.org#24252,"SIDODADI, PEKALONGAN, LAMPUNG TIMUR, LAMPUNG",9,121,77,198
https://kawalpemilu.org#24252,"SIDODADI, PEKALONGAN, LAMPUNG TIMUR, LAMPUNG",10,0,0,0
https://kawalpemilu.org#24252,"SIDODADI, PEKALONGAN, LAMPUNG TIMUR, LAMPUNG",11,0,0,0
https://kawalpemilu.org#24252,"SIDODADI, PEKALONGAN, LAMPUNG TIMUR, LAMPUNG",12,97,72,169
https://kawalpemilu.org#24252,"SIDODADI, PEKALONGAN, LAMPUNG TIMUR, LAMPUNG",13,80,80,160
https://kawalpemilu.org#24252,"SIDODADI, PEKALONGAN, LAMPUNG TIMUR, LAMPUNG",16,191,34,225
https://kawalpemilu.org#24252,"SIDODADI, PEKALONGAN, LAMPUNG TIMUR, LAMPUNG",18,0,0,0
https://kawalpemilu.org#24252,"SIDODADI, PEKALONGAN, LAMPUNG TIMUR, LAMPUNG",19,158,35,193
https://kawalpemilu.org#24252,"SIDODADI, PEKALONGAN, LAMPUNG TIMUR, LAMPUNG",20,131,25,156
https://kawalpemilu.org#24253,"GONDANG REJO, PEKALONGAN, LAMPUNG TIMUR, LAMPUNG",1,86,54,140
https://kawalpemilu.org#24253,"GONDANG REJO, PEKALONGAN, LAMPUNG TIMUR, LAMPUNG",2,86,57,143
https://kawalpemilu.org#24253,"GONDANG REJO, PEKALONGAN, LAMPUNG TIMUR, LAMPUNG",3,102,41,143
https://kawalpemilu.org#24253,"GONDANG REJO, PEKALONGAN, LAMPUNG TIMUR, LAMPUNG",4,104,34,138
https://kawalpemilu.org#24253,"GONDANG REJO, PEKALONGAN, LAMPUNG TIMUR, LAMPUNG",5,133,49,182
https://kawalpemilu.org#24253,"GONDANG REJO, PEKALONGAN, LAMPUNG TIMUR, LAMPUNG",6,134,30,164
https://kawalpemilu.org#24253,"GONDANG REJO, PEKALONGAN, LAMPUNG TIMUR, LAMPUNG",7,167,17,184
https://kawalpemilu.org#24253,"GONDANG REJO, PEKALONGAN, LAMPUNG TIMUR, LAMPUNG",8,155,47,202
https://kawalpemilu.org#24253,"GONDANG REJO, PEKALONGAN, LAMPUNG TIMUR, LAMPUNG",9,179,34,213
https://kawalpemilu.org#24253,"GONDANG REJO, PEKALONGAN, LAMPUNG TIMUR, LAMPUNG",10,184,30,214
https://kawalpemilu.org#24253,"GONDANG REJO, PEKALONGAN, LAMPUNG TIMUR, LAMPUNG",11,129,21,150
https://kawalpemilu.org#24253,"GONDANG REJO, PEKALONGAN, LAMPUNG TIMUR, LAMPUNG",12,143,21,164
https://kawalpemilu.org#24253,"GONDANG REJO, PEKALONGAN, LAMPUNG TIMUR, LAMPUNG",13,157,28,185
https://kawalpemilu.org#24253,"GONDANG REJO, PEKALONGAN, LAMPUNG TIMUR, LAMPUNG",14,170,21,191
https://kawalpemilu.org#24253,"GONDANG REJO, PEKALONGAN, LAMPUNG TIMUR, LAMPUNG",15,122,46,168
https://kawalpemilu.org#24253,"GONDANG REJO, PEKALONGAN, LAMPUNG TIMUR, LAMPUNG",16,90,100,190
https://kawalpemilu.org#24253,"GONDANG REJO, PEKALONGAN, LAMPUNG TIMUR, LAMPUNG",17,104,80,184
https://kawalpemilu.org#24253,"GONDANG REJO, PEKALONGAN, LAMPUNG TIMUR, LAMPUNG",18,89,93,182
https://kawalpemilu.org#24253,"GONDANG REJO, PEKALONGAN, LAMPUNG TIMUR, LAMPUNG",19,86,106,192
https://kawalpemilu.org#24253,"GONDANG REJO, PEKALONGAN, LAMPUNG TIMUR, LAMPUNG",20,80,85,165
https://kawalpemilu.org#24253,"GONDANG REJO, PEKALONGAN, LAMPUNG TIMUR, LAMPUNG",21,147,67,214
https://kawalpemilu.org#24253,"GONDANG REJO, PEKALONGAN, LAMPUNG TIMUR, LAMPUNG",22,189,36,225
https://kawalpemilu.org#24253,"GONDANG REJO, PEKALONGAN, LAMPUNG TIMUR, LAMPUNG",23,117,43,160
https://kawalpemilu.org#24253,"GONDANG REJO, PEKALONGAN, LAMPUNG TIMUR, LAMPUNG",24,123,41,164
https://kawalpemilu.org#24253,"GONDANG REJO, PEKALONGAN, LAMPUNG TIMUR, LAMPUNG",25,110,68,178
https://kawalpemilu.org#24254,"SIRAMAN, PEKALONGAN, LAMPUNG TIMUR, LAMPUNG",1,138,52,190
https://kawalpemilu.org#24254,"SIRAMAN, PEKALONGAN, LAMPUNG TIMUR, LAMPUNG",2,110,46,156
https://kawalpemilu.org#24254,"SIRAMAN, PEKALONGAN, LAMPUNG TIMUR, LAMPUNG",3,127,51,178
https://kawalpemilu.org#24254,"SIRAMAN, PEKALONGAN, LAMPUNG TIMUR, LAMPUNG",4,111,115,226
https://kawalpemilu.org#24254,"SIRAMAN, PEKALONGAN, LAMPUNG TIMUR, LAMPUNG",5,100,76,176
https://kawalpemilu.org#24254,"SIRAMAN, PEKALONGAN, LAMPUNG TIMUR, LAMPUNG",6,116,68,184
https://kawalpemilu.org#24254,"SIRAMAN, PEKALONGAN, LAMPUNG TIMUR, LAMPUNG",7,139,79,218
https://kawalpemilu.org#24254,"SIRAMAN, PEKALONGAN, LAMPUNG TIMUR, LAMPUNG",8,85,95,180
https://kawalpemilu.org#24254,"SIRAMAN, PEKALONGAN, LAMPUNG TIMUR, LAMPUNG",12,125,85,210
https://kawalpemilu.org#24254,"SIRAMAN, PEKALONGAN, LAMPUNG TIMUR, LAMPUNG",13,102,95,197
https://kawalpemilu.org#24255,"TULUS REJO, PEKALONGAN, LAMPUNG TIMUR, LAMPUNG",1,145,61,206
https://kawalpemilu.org#24255,"TULUS REJO, PEKALONGAN, LAMPUNG TIMUR, LAMPUNG",2,139,63,202
https://kawalpemilu.org#24255,"TULUS REJO, PEKALONGAN, LAMPUNG TIMUR, LAMPUNG",3,144,69,213
https://kawalpemilu.org#24255,"TULUS REJO, PEKALONGAN, LAMPUNG TIMUR, LAMPUNG",4,143,66,209
https://kawalpemilu.org#24255,"TULUS REJO, PEKALONGAN, LAMPUNG TIMUR, LAMPUNG",5,99,90,189
https://kawalpemilu.org#24255,"TULUS REJO, PEKALONGAN, LAMPUNG TIMUR, LAMPUNG",6,148,77,225
https://kawalpemilu.org#24255,"TULUS REJO, PEKALONGAN, LAMPUNG TIMUR, LAMPUNG",7,109,78,187
https://kawalpemilu.org#24255,"TULUS REJO, PEKALONGAN, LAMPUNG TIMUR, LAMPUNG",8,81,106,187
https://kawalpemilu.org#24255,"TULUS REJO, PEKALONGAN, LAMPUNG TIMUR, LAMPUNG",9,99,71,170
https://kawalpemilu.org#24256,"JOJOG, PEKALONGAN, LAMPUNG TIMUR, LAMPUNG",1,115,71,186
https://kawalpemilu.org#24256,"JOJOG, PEKALONGAN, LAMPUNG TIMUR, LAMPUNG",2,117,53,170
https://kawalpemilu.org#24256,"JOJOG, PEKALONGAN, LAMPUNG TIMUR, LAMPUNG",3,142,62,204
https://kawalpemilu.org#24256,"JOJOG, PEKALONGAN, LAMPUNG TIMUR, LAMPUNG",4,60,137,197
https://kawalpemilu.org#24256,"JOJOG, PEKALONGAN, LAMPUNG TIMUR, LAMPUNG",5,94,70,164
https://kawalpemilu.org#24256,"JOJOG, PEKALONGAN, LAMPUNG TIMUR, LAMPUNG",6,111,62,173
https://kawalpemilu.org#24256,"JOJOG, PEKALONGAN, LAMPUNG TIMUR, LAMPUNG",7,146,65,211
https://kawalpemilu.org#24256,"JOJOG, PEKALONGAN, LAMPUNG TIMUR, LAMPUNG",8,153,66,219
https://kawalpemilu.org#24256,"JOJOG, PEKALONGAN, LAMPUNG TIMUR, LAMPUNG",9,167,96,263
https://kawalpemilu.org#24256,"JOJOG, PEKALONGAN, LAMPUNG TIMUR, LAMPUNG",10,182,57,239
https://kawalpemilu.org#24256,"JOJOG, PEKALONGAN, LAMPUNG TIMUR, LAMPUNG",11,136,71,207
https://kawalpemilu.org#24256,"JOJOG, PEKALONGAN, LAMPUNG TIMUR, LAMPUNG",12,132,80,212
https://kawalpemilu.org#24256,"JOJOG, PEKALONGAN, LAMPUNG TIMUR, LAMPUNG",13,155,46,201
https://kawalpemilu.org#24256,"JOJOG, PEKALONGAN, LAMPUNG TIMUR, LAMPUNG",14,193,31,224
https://kawalpemilu.org#24256,"JOJOG, PEKALONGAN, LAMPUNG TIMUR, LAMPUNG",15,168,23,191
https://kawalpemilu.org#24256,"JOJOG, PEKALONGAN, LAMPUNG TIMUR, LAMPUNG",16,173,13,186
https://kawalpemilu.org#24257,"GANTI WARNO, PEKALONGAN, LAMPUNG TIMUR, LAMPUNG",1,115,73,188
https://kawalpemilu.org#24257,"GANTI WARNO, PEKALONGAN, LAMPUNG TIMUR, LAMPUNG",2,112,52,164
https://kawalpemilu.org#24257,"GANTI WARNO, PEKALONGAN, LAMPUNG TIMUR, LAMPUNG",3,127,40,167
https://kawalpemilu.org#24257,"GANTI WARNO, PEKALONGAN, LAMPUNG TIMUR, LAMPUNG",4,139,41,180
https://kawalpemilu.org#24257,"GANTI WARNO, PEKALONGAN, LAMPUNG TIMUR, LAMPUNG",5,128,41,169
https://kawalpemilu.org#24257,"GANTI WARNO, PEKALONGAN, LAMPUNG TIMUR, LAMPUNG",6,112,42,154
https://kawalpemilu.org#24257,"GANTI WARNO, PEKALONGAN, LAMPUNG TIMUR, LAMPUNG",7,85,55,140
https://kawalpemilu.org#24257,"GANTI WARNO, PEKALONGAN, LAMPUNG TIMUR, LAMPUNG",8,80,55,135
https://kawalpemilu.org#24257,"GANTI WARNO, PEKALONGAN, LAMPUNG TIMUR, LAMPUNG",9,84,81,165
https://kawalpemilu.org#24257,"GANTI WARNO, PEKALONGAN, LAMPUNG TIMUR, LAMPUNG",11,153,54,207
https://kawalpemilu.org#24257,"GANTI WARNO, PEKALONGAN, LAMPUNG TIMUR, LAMPUNG",12,152,48,200
https://kawalpemilu.org#24257,"GANTI WARNO, PEKALONGAN, LAMPUNG TIMUR, LAMPUNG",13,117,16,133
https://kawalpemilu.org#24258,"KALI BENING, PEKALONGAN, LAMPUNG TIMUR, LAMPUNG",1,132,71,203
https://kawalpemilu.org#24258,"KALI BENING, PEKALONGAN, LAMPUNG TIMUR, LAMPUNG",2,100,66,166
https://kawalpemilu.org#24258,"KALI BENING, PEKALONGAN, LAMPUNG TIMUR, LAMPUNG",3,117,67,184
https://kawalpemilu.org#24258,"KALI BENING, PEKALONGAN, LAMPUNG TIMUR, LAMPUNG",4,112,65,177
https://kawalpemilu.org#24258,"KALI BENING, PEKALONGAN, LAMPUNG TIMUR, LAMPUNG",5,89,99,188
https://kawalpemilu.org#24258,"KALI BENING, PEKALONGAN, LAMPUNG TIMUR, LAMPUNG",7,70,86,156
https://kawalpemilu.org#24258,"KALI BENING, PEKALONGAN, LAMPUNG TIMUR, LAMPUNG",8,91,78,169
https://kawalpemilu.org#24259,"WONOSARI, PEKALONGAN, LAMPUNG TIMUR, LAMPUNG",1,106,84,190
https://kawalpemilu.org#24259,"WONOSARI, PEKALONGAN, LAMPUNG TIMUR, LAMPUNG",2,125,86,211
https://kawalpemilu.org#24259,"WONOSARI, PEKALONGAN, LAMPUNG TIMUR, LAMPUNG",3,89,148,237
https://kawalpemilu.org#24259,"WONOSARI, PEKALONGAN, LAMPUNG TIMUR, LAMPUNG",4,137,105,242
https://kawalpemilu.org#24259,"WONOSARI, PEKALONGAN, LAMPUNG TIMUR, LAMPUNG",5,130,101,231
https://kawalpemilu.org#24259,"WONOSARI, PEKALONGAN, LAMPUNG TIMUR, LAMPUNG",6,86,130,216
https://kawalpemilu.org#24259,"WONOSARI, PEKALONGAN, LAMPUNG TIMUR, LAMPUNG",7,72,98,170
https://kawalpemilu.org#24259,"WONOSARI, PEKALONGAN, LAMPUNG TIMUR, LAMPUNG",8,90,77,167
https://kawalpemilu.org#24259,"WONOSARI, PEKALONGAN, LAMPUNG TIMUR, LAMPUNG",9,97,70,167
https://kawalpemilu.org#24259,"WONOSARI, PEKALONGAN, LAMPUNG TIMUR, LAMPUNG",10,115,62,177
https://kawalpemilu.org#24259,"WONOSARI, PEKALONGAN, LAMPUNG TIMUR, LAMPUNG",11,76,97,173
https://kawalpemilu.org#88039,"GANTIMULYO, PEKALONGAN, LAMPUNG TIMUR, LAMPUNG",1,109,94,203
https://kawalpemilu.org#88039,"GANTIMULYO, PEKALONGAN, LAMPUNG TIMUR, LAMPUNG",2,127,55,182
https://kawalpemilu.org#88039,"GANTIMULYO, PEKALONGAN, LAMPUNG TIMUR, LAMPUNG",3,167,47,214
https://kawalpemilu.org#88039,"GANTIMULYO, PEKALONGAN, LAMPUNG TIMUR, LAMPUNG",4,166,57,223
https://kawalpemilu.org#88039,"GANTIMULYO, PEKALONGAN, LAMPUNG TIMUR, LAMPUNG",5,147,64,211
https://kawalpemilu.org#88039,"GANTIMULYO, PEKALONGAN, LAMPUNG TIMUR, LAMPUNG",6,72,134,206
https://kawalpemilu.org#88039,"GANTIMULYO, PEKALONGAN, LAMPUNG TIMUR, LAMPUNG",7,172,76,248
https://kawalpemilu.org#88040,"ADIJAYA, PEKALONGAN, LAMPUNG TIMUR, LAMPUNG",1,123,49,172
https://kawalpemilu.org#88040,"ADIJAYA, PEKALONGAN, LAMPUNG TIMUR, LAMPUNG",6,95,52,147
https://kawalpemilu.org#88040,"ADIJAYA, PEKALONGAN, LAMPUNG TIMUR, LAMPUNG",7,146,25,171
https://kawalpemilu.org#88040,"ADIJAYA, PEKALONGAN, LAMPUNG TIMUR, LAMPUNG",8,146,55,201
https://kawalpemilu.org#88040,"ADIJAYA, PEKALONGAN, LAMPUNG TIMUR, LAMPUNG",9,97,86,183
https://kawalpemilu.org#88040,"ADIJAYA, PEKALONGAN, LAMPUNG TIMUR, LAMPUNG",10,183,74,257
https://kawalpemilu.org#24261,"SUMBERGEDE, SEKAMPUNG, LAMPUNG TIMUR, LAMPUNG",1,92,74,166
https://kawalpemilu.org#24261,"SUMBERGEDE, SEKAMPUNG, LAMPUNG TIMUR, LAMPUNG",2,142,35,177
https://kawalpemilu.org#24261,"SUMBERGEDE, SEKAMPUNG, LAMPUNG TIMUR, LAMPUNG",3,131,31,162
https://kawalpemilu.org#24261,"SUMBERGEDE, SEKAMPUNG, LAMPUNG TIMUR, LAMPUNG",4,117,48,165
https://kawalpemilu.org#24261,"SUMBERGEDE, SEKAMPUNG, LAMPUNG TIMUR, LAMPUNG",5,130,81,211
https://kawalpemilu.org#24261,"SUMBERGEDE, SEKAMPUNG, LAMPUNG TIMUR, LAMPUNG",6,81,28,109
https://kawalpemilu.org#24261,"SUMBERGEDE, SEKAMPUNG, LAMPUNG TIMUR, LAMPUNG",7,99,83,182
https://kawalpemilu.org#24261,"SUMBERGEDE, SEKAMPUNG, LAMPUNG TIMUR, LAMPUNG",8,97,83,180
https://kawalpemilu.org#24261,"SUMBERGEDE, SEKAMPUNG, LAMPUNG TIMUR, LAMPUNG",9,115,65,180
https://kawalpemilu.org#24261,"SUMBERGEDE, SEKAMPUNG, LAMPUNG TIMUR, LAMPUNG",10,173,55,228
https://kawalpemilu.org#24261,"SUMBERGEDE, SEKAMPUNG, LAMPUNG TIMUR, LAMPUNG",11,73,116,189
https://kawalpemilu.org#24261,"SUMBERGEDE, SEKAMPUNG, LAMPUNG TIMUR, LAMPUNG",12,60,104,164
https://kawalpemilu.org#24261,"SUMBERGEDE, SEKAMPUNG, LAMPUNG TIMUR, LAMPUNG",13,49,72,121
https://kawalpemilu.org#24261,"SUMBERGEDE, SEKAMPUNG, LAMPUNG TIMUR, LAMPUNG",14,59,84,143
https://kawalpemilu.org#24261,"SUMBERGEDE, SEKAMPUNG, LAMPUNG TIMUR, LAMPUNG",15,107,73,180
https://kawalpemilu.org#24261,"SUMBERGEDE, SEKAMPUNG, LAMPUNG TIMUR, LAMPUNG",16,111,57,168
https://kawalpemilu.org#24261,"SUMBERGEDE, SEKAMPUNG, LAMPUNG TIMUR, LAMPUNG",17,113,42,155
https://kawalpemilu.org#24261,"SUMBERGEDE, SEKAMPUNG, LAMPUNG TIMUR, LAMPUNG",18,118,54,172
https://kawalpemilu.org#24261,"SUMBERGEDE, SEKAMPUNG, LAMPUNG TIMUR, LAMPUNG",19,166,36,202
https://kawalpemilu.org#24261,"SUMBERGEDE, SEKAMPUNG, LAMPUNG TIMUR, LAMPUNG",20,122,20,142
https://kawalpemilu.org#24261,"SUMBERGEDE, SEKAMPUNG, LAMPUNG TIMUR, LAMPUNG",21,106,23,129
https://kawalpemilu.org#24261,"SUMBERGEDE, SEKAMPUNG, LAMPUNG TIMUR, LAMPUNG",22,98,42,140
https://kawalpemilu.org#24261,"SUMBERGEDE, SEKAMPUNG, LAMPUNG TIMUR, LAMPUNG",23,86,38,124
https://kawalpemilu.org#24261,"SUMBERGEDE, SEKAMPUNG, LAMPUNG TIMUR, LAMPUNG",24,118,37,155
https://kawalpemilu.org#24261,"SUMBERGEDE, SEKAMPUNG, LAMPUNG TIMUR, LAMPUNG",25,112,19,131
https://kawalpemilu.org#24261,"SUMBERGEDE, SEKAMPUNG, LAMPUNG TIMUR, LAMPUNG",26,123,45,168
https://kawalpemilu.org#24261,"SUMBERGEDE, SEKAMPUNG, LAMPUNG TIMUR, LAMPUNG",27,93,48,141
https://kawalpemilu.org#24261,"SUMBERGEDE, SEKAMPUNG, LAMPUNG TIMUR, LAMPUNG",28,120,105,225
https://kawalpemilu.org#24261,"SUMBERGEDE, SEKAMPUNG, LAMPUNG TIMUR, LAMPUNG",29,137,97,234
https://kawalpemilu.org#24262,"SIDOMUKTI, SEKAMPUNG, LAMPUNG TIMUR, LAMPUNG",1,150,48,198
https://kawalpemilu.org#24262,"SIDOMUKTI, SEKAMPUNG, LAMPUNG TIMUR, LAMPUNG",2,148,41,189
https://kawalpemilu.org#24262,"SIDOMUKTI, SEKAMPUNG, LAMPUNG TIMUR, LAMPUNG",3,144,22,166
https://kawalpemilu.org#24262,"SIDOMUKTI, SEKAMPUNG, LAMPUNG TIMUR, LAMPUNG",4,164,34,198
https://kawalpemilu.org#24262,"SIDOMUKTI, SEKAMPUNG, LAMPUNG TIMUR, LAMPUNG",5,143,47,190
https://kawalpemilu.org#24262,"SIDOMUKTI, SEKAMPUNG, LAMPUNG TIMUR, LAMPUNG",6,157,35,192
https://kawalpemilu.org#24262,"SIDOMUKTI, SEKAMPUNG, LAMPUNG TIMUR, LAMPUNG",7,164,26,190
https://kawalpemilu.org#24262,"SIDOMUKTI, SEKAMPUNG, LAMPUNG TIMUR, LAMPUNG",8,169,29,198
https://kawalpemilu.org#24262,"SIDOMUKTI, SEKAMPUNG, LAMPUNG TIMUR, LAMPUNG",9,167,26,193
https://kawalpemilu.org#24263,"SIDOMULYO, SEKAMPUNG, LAMPUNG TIMUR, LAMPUNG",1,137,66,203
https://kawalpemilu.org#24263,"SIDOMULYO, SEKAMPUNG, LAMPUNG TIMUR, LAMPUNG",2,100,42,142
https://kawalpemilu.org#24263,"SIDOMULYO, SEKAMPUNG, LAMPUNG TIMUR, LAMPUNG",3,127,77,204
https://kawalpemilu.org#24263,"SIDOMULYO, SEKAMPUNG, LAMPUNG TIMUR, LAMPUNG",4,136,41,177
https://kawalpemilu.org#24263,"SIDOMULYO, SEKAMPUNG, LAMPUNG TIMUR, LAMPUNG",5,173,34,207
https://kawalpemilu.org#24263,"SIDOMULYO, SEKAMPUNG, LAMPUNG TIMUR, LAMPUNG",6,186,35,221
https://kawalpemilu.org#24263,"SIDOMULYO, SEKAMPUNG, LAMPUNG TIMUR, LAMPUNG",7,194,19,213
https://kawalpemilu.org#24263,"SIDOMULYO, SEKAMPUNG, LAMPUNG TIMUR, LAMPUNG",8,194,27,221
https://kawalpemilu.org#24263,"SIDOMULYO, SEKAMPUNG, LAMPUNG TIMUR, LAMPUNG",9,127,18,145
https://kawalpemilu.org#24263,"SIDOMULYO, SEKAMPUNG, LAMPUNG TIMUR, LAMPUNG",10,120,25,145
https://kawalpemilu.org#24263,"SIDOMULYO, SEKAMPUNG, LAMPUNG TIMUR, LAMPUNG",11,158,9,167
https://kawalpemilu.org#24264,"TRIMULYO, SEKAMPUNG, LAMPUNG TIMUR, LAMPUNG",1,126,23,149
https://kawalpemilu.org#24264,"TRIMULYO, SEKAMPUNG, LAMPUNG TIMUR, LAMPUNG",2,123,54,177
https://kawalpemilu.org#24264,"TRIMULYO, SEKAMPUNG, LAMPUNG TIMUR, LAMPUNG",4,192,44,236
https://kawalpemilu.org#24264,"TRIMULYO, SEKAMPUNG, LAMPUNG TIMUR, LAMPUNG",5,163,50,213
https://kawalpemilu.org#24264,"TRIMULYO, SEKAMPUNG, LAMPUNG TIMUR, LAMPUNG",6,128,59,187
https://kawalpemilu.org#24264,"TRIMULYO, SEKAMPUNG, LAMPUNG TIMUR, LAMPUNG",7,203,21,224
https://kawalpemilu.org#24264,"TRIMULYO, SEKAMPUNG, LAMPUNG TIMUR, LAMPUNG",8,180,30,210
https://kawalpemilu.org#24264,"TRIMULYO, SEKAMPUNG, LAMPUNG TIMUR, LAMPUNG",9,172,31,203
https://kawalpemilu.org#24264,"TRIMULYO, SEKAMPUNG, LAMPUNG TIMUR, LAMPUNG",10,134,27,161
https://kawalpemilu.org#24264,"TRIMULYO, SEKAMPUNG, LAMPUNG TIMUR, LAMPUNG",11,134,29,163
https://kawalpemilu.org#24264,"TRIMULYO, SEKAMPUNG, LAMPUNG TIMUR, LAMPUNG",12,125,23,148
https://kawalpemilu.org#24265,"GIRI KARTO, SEKAMPUNG, LAMPUNG TIMUR, LAMPUNG",1,113,65,178
https://kawalpemilu.org#24265,"GIRI KARTO, SEKAMPUNG, LAMPUNG TIMUR, LAMPUNG",2,155,42,197
https://kawalpemilu.org#24265,"GIRI KARTO, SEKAMPUNG, LAMPUNG TIMUR, LAMPUNG",3,157,15,172
https://kawalpemilu.org#24265,"GIRI KARTO, SEKAMPUNG, LAMPUNG TIMUR, LAMPUNG",4,131,25,156
https://kawalpemilu.org#24265,"GIRI KARTO, SEKAMPUNG, LAMPUNG TIMUR, LAMPUNG",5,126,50,176
https://kawalpemilu.org#24265,"GIRI KARTO, SEKAMPUNG, LAMPUNG TIMUR, LAMPUNG",6,120,46,166
https://kawalpemilu.org#24265,"GIRI KARTO, SEKAMPUNG, LAMPUNG TIMUR, LAMPUNG",8,154,57,211
https://kawalpemilu.org#24265,"GIRI KARTO, SEKAMPUNG, LAMPUNG TIMUR, LAMPUNG",9,140,44,184
https://kawalpemilu.org#24265,"GIRI KARTO, SEKAMPUNG, LAMPUNG TIMUR, LAMPUNG",10,175,29,204
https://kawalpemilu.org#24266,"HARGO MULYO, SEKAMPUNG, LAMPUNG TIMUR, LAMPUNG",1,136,74,210
https://kawalpemilu.org#24266,"HARGO MULYO, SEKAMPUNG, LAMPUNG TIMUR, LAMPUNG",2,143,61,204
https://kawalpemilu.org#24266,"HARGO MULYO, SEKAMPUNG, LAMPUNG TIMUR, LAMPUNG",3,111,68,179
https://kawalpemilu.org#24266,"HARGO MULYO, SEKAMPUNG, LAMPUNG TIMUR, LAMPUNG",4,121,68,189
https://kawalpemilu.org#24266,"HARGO MULYO, SEKAMPUNG, LAMPUNG TIMUR, LAMPUNG",5,120,87,207
https://kawalpemilu.org#24266,"HARGO MULYO, SEKAMPUNG, LAMPUNG TIMUR, LAMPUNG",7,115,65,180
https://kawalpemilu.org#24266,"HARGO MULYO, SEKAMPUNG, LAMPUNG TIMUR, LAMPUNG",8,82,73,155
https://kawalpemilu.org#24266,"HARGO MULYO, SEKAMPUNG, LAMPUNG TIMUR, LAMPUNG",9,77,55,132
https://kawalpemilu.org#24266,"HARGO MULYO, SEKAMPUNG, LAMPUNG TIMUR, LAMPUNG",10,87,55,142
https://kawalpemilu.org#24266,"HARGO MULYO, SEKAMPUNG, LAMPUNG TIMUR, LAMPUNG",11,94,76,170
https://kawalpemilu.org#24266,"HARGO MULYO, SEKAMPUNG, LAMPUNG TIMUR, LAMPUNG",12,89,103,192
https://kawalpemilu.org#24266,"HARGO MULYO, SEKAMPUNG, LAMPUNG TIMUR, LAMPUNG",13,135,43,178
https://kawalpemilu.org#24266,"HARGO MULYO, SEKAMPUNG, LAMPUNG TIMUR, LAMPUNG",14,122,28,150
https://kawalpemilu.org#24266,"HARGO MULYO, SEKAMPUNG, LAMPUNG TIMUR, LAMPUNG",15,109,49,158
https://kawalpemilu.org#24266,"HARGO MULYO, SEKAMPUNG, LAMPUNG TIMUR, LAMPUNG",16,103,33,136
https://kawalpemilu.org#24266,"HARGO MULYO, SEKAMPUNG, LAMPUNG TIMUR, LAMPUNG",17,95,58,153
https://kawalpemilu.org#24266,"HARGO MULYO, SEKAMPUNG, LAMPUNG TIMUR, LAMPUNG",18,108,54,162
https://kawalpemilu.org#24266,"HARGO MULYO, SEKAMPUNG, LAMPUNG TIMUR, LAMPUNG",19,97,59,156
https://kawalpemilu.org#24266,"HARGO MULYO, SEKAMPUNG, LAMPUNG TIMUR, LAMPUNG",20,135,49,184
https://kawalpemilu.org#24266,"HARGO MULYO, SEKAMPUNG, LAMPUNG TIMUR, LAMPUNG",21,126,45,171
https://kawalpemilu.org#24266,"HARGO MULYO, SEKAMPUNG, LAMPUNG TIMUR, LAMPUNG",22,131,26,157
https://kawalpemilu.org#24266,"HARGO MULYO, SEKAMPUNG, LAMPUNG TIMUR, LAMPUNG",23,115,37,152
https://kawalpemilu.org#24266,"HARGO MULYO, SEKAMPUNG, LAMPUNG TIMUR, LAMPUNG",24,129,44,173
https://kawalpemilu.org#24266,"HARGO MULYO, SEKAMPUNG, LAMPUNG TIMUR, LAMPUNG",25,149,31,180
https://kawalpemilu.org#24267,"WONO KARTO, SEKAMPUNG, LAMPUNG TIMUR, LAMPUNG",1,124,62,186
https://kawalpemilu.org#24267,"WONO KARTO, SEKAMPUNG, LAMPUNG TIMUR, LAMPUNG",2,141,63,204
https://kawalpemilu.org#24267,"WONO KARTO, SEKAMPUNG, LAMPUNG TIMUR, LAMPUNG",3,108,26,134
https://kawalpemilu.org#24267,"WONO KARTO, SEKAMPUNG, LAMPUNG TIMUR, LAMPUNG",4,105,75,180
https://kawalpemilu.org#24267,"WONO KARTO, SEKAMPUNG, LAMPUNG TIMUR, LAMPUNG",5,131,43,174
https://kawalpemilu.org#24267,"WONO KARTO, SEKAMPUNG, LAMPUNG TIMUR, LAMPUNG",6,128,84,212
https://kawalpemilu.org#24267,"WONO KARTO, SEKAMPUNG, LAMPUNG TIMUR, LAMPUNG",7,119,113,232
https://kawalpemilu.org#24267,"WONO KARTO, SEKAMPUNG, LAMPUNG TIMUR, LAMPUNG",9,167,48,215
https://kawalpemilu.org#24267,"WONO KARTO, SEKAMPUNG, LAMPUNG TIMUR, LAMPUNG",10,140,39,179
https://kawalpemilu.org#24268,"SUKOHARJO, SEKAMPUNG, LAMPUNG TIMUR, LAMPUNG",1,110,36,146
https://kawalpemilu.org#24268,"SUKOHARJO, SEKAMPUNG, LAMPUNG TIMUR, LAMPUNG",2,127,44,171
https://kawalpemilu.org#24268,"SUKOHARJO, SEKAMPUNG, LAMPUNG TIMUR, LAMPUNG",3,95,27,122
https://kawalpemilu.org#24268,"SUKOHARJO, SEKAMPUNG, LAMPUNG TIMUR, LAMPUNG",4,85,33,118
https://kawalpemilu.org#24268,"SUKOHARJO, SEKAMPUNG, LAMPUNG TIMUR, LAMPUNG",5,109,9,118
https://kawalpemilu.org#24268,"SUKOHARJO, SEKAMPUNG, LAMPUNG TIMUR, LAMPUNG",6,94,30,124
https://kawalpemilu.org#24268,"SUKOHARJO, SEKAMPUNG, LAMPUNG TIMUR, LAMPUNG",7,125,58,183
https://kawalpemilu.org#24268,"SUKOHARJO, SEKAMPUNG, LAMPUNG TIMUR, LAMPUNG",8,102,70,172
https://kawalpemilu.org#24268,"SUKOHARJO, SEKAMPUNG, LAMPUNG TIMUR, LAMPUNG",9,107,95,202
https://kawalpemilu.org#24268,"SUKOHARJO, SEKAMPUNG, LAMPUNG TIMUR, LAMPUNG",10,147,51,198
https://kawalpemilu.org#24268,"SUKOHARJO, SEKAMPUNG, LAMPUNG TIMUR, LAMPUNG",11,179,57,236
https://kawalpemilu.org#24268,"SUKOHARJO, SEKAMPUNG, LAMPUNG TIMUR, LAMPUNG",12,175,36,211
https://kawalpemilu.org#24268,"SUKOHARJO, SEKAMPUNG, LAMPUNG TIMUR, LAMPUNG",13,147,41,188
https://kawalpemilu.org#24268,"SUKOHARJO, SEKAMPUNG, LAMPUNG TIMUR, LAMPUNG",14,151,31,182
https://kawalpemilu.org#24269,"GIRIKLOPOMULYO, SEKAMPUNG, LAMPUNG TIMUR, LAMPUNG",1,64,89,153
https://kawalpemilu.org#24269,"GIRIKLOPOMULYO, SEKAMPUNG, LAMPUNG TIMUR, LAMPUNG",2,107,89,196
https://kawalpemilu.org#24269,"GIRIKLOPOMULYO, SEKAMPUNG, LAMPUNG TIMUR, LAMPUNG",3,118,91,209
https://kawalpemilu.org#24269,"GIRIKLOPOMULYO, SEKAMPUNG, LAMPUNG TIMUR, LAMPUNG",4,100,48,148
https://kawalpemilu.org#24269,"GIRIKLOPOMULYO, SEKAMPUNG, LAMPUNG TIMUR, LAMPUNG",5,113,28,141
https://kawalpemilu.org#24269,"GIRIKLOPOMULYO, SEKAMPUNG, LAMPUNG TIMUR, LAMPUNG",6,141,46,187
https://kawalpemilu.org#24269,"GIRIKLOPOMULYO, SEKAMPUNG, LAMPUNG TIMUR, LAMPUNG",7,143,56,199
https://kawalpemilu.org#24269,"GIRIKLOPOMULYO, SEKAMPUNG, LAMPUNG TIMUR, LAMPUNG",8,134,53,187
https://kawalpemilu.org#24269,"GIRIKLOPOMULYO, SEKAMPUNG, LAMPUNG TIMUR, LAMPUNG",9,134,53,187
https://kawalpemilu.org#24269,"GIRIKLOPOMULYO, SEKAMPUNG, LAMPUNG TIMUR, LAMPUNG",10,139,36,175
https://kawalpemilu.org#24269,"GIRIKLOPOMULYO, SEKAMPUNG, LAMPUNG TIMUR, LAMPUNG",11,103,24,127
https://kawalpemilu.org#24269,"GIRIKLOPOMULYO, SEKAMPUNG, LAMPUNG TIMUR, LAMPUNG",12,116,37,153
https://kawalpemilu.org#24269,"GIRIKLOPOMULYO, SEKAMPUNG, LAMPUNG TIMUR, LAMPUNG",13,139,41,180
https://kawalpemilu.org#24269,"GIRIKLOPOMULYO, SEKAMPUNG, LAMPUNG TIMUR, LAMPUNG",14,118,65,183
https://kawalpemilu.org#24269,"GIRIKLOPOMULYO, SEKAMPUNG, LAMPUNG TIMUR, LAMPUNG",15,127,22,149
https://kawalpemilu.org#24269,"GIRIKLOPOMULYO, SEKAMPUNG, LAMPUNG TIMUR, LAMPUNG",16,129,31,160
https://kawalpemilu.org#24269,"GIRIKLOPOMULYO, SEKAMPUNG, LAMPUNG TIMUR, LAMPUNG",17,130,21,151
https://kawalpemilu.org#24269,"GIRIKLOPOMULYO, SEKAMPUNG, LAMPUNG TIMUR, LAMPUNG",18,158,36,194
https://kawalpemilu.org#24269,"GIRIKLOPOMULYO, SEKAMPUNG, LAMPUNG TIMUR, LAMPUNG",19,160,25,185
https://kawalpemilu.org#24270,"SIDODADI, SEKAMPUNG, LAMPUNG TIMUR, LAMPUNG",1,155,54,209
https://kawalpemilu.org#24270,"SIDODADI, SEKAMPUNG, LAMPUNG TIMUR, LAMPUNG",2,149,56,205
https://kawalpemilu.org#24270,"SIDODADI, SEKAMPUNG, LAMPUNG TIMUR, LAMPUNG",3,148,31,179
https://kawalpemilu.org#24270,"SIDODADI, SEKAMPUNG, LAMPUNG TIMUR, LAMPUNG",4,125,56,181
https://kawalpemilu.org#24270,"SIDODADI, SEKAMPUNG, LAMPUNG TIMUR, LAMPUNG",5,142,91,233
https://kawalpemilu.org#24270,"SIDODADI, SEKAMPUNG, LAMPUNG TIMUR, LAMPUNG",6,160,51,211
https://kawalpemilu.org#24270,"SIDODADI, SEKAMPUNG, LAMPUNG TIMUR, LAMPUNG",7,101,78,179
https://kawalpemilu.org#24270,"SIDODADI, SEKAMPUNG, LAMPUNG TIMUR, LAMPUNG",8,97,86,183
https://kawalpemilu.org#24270,"SIDODADI, SEKAMPUNG, LAMPUNG TIMUR, LAMPUNG",9,104,73,177
https://kawalpemilu.org#24270,"SIDODADI, SEKAMPUNG, LAMPUNG TIMUR, LAMPUNG",10,123,30,153
https://kawalpemilu.org#24270,"SIDODADI, SEKAMPUNG, LAMPUNG TIMUR, LAMPUNG",11,110,33,143
https://kawalpemilu.org#24270,"SIDODADI, SEKAMPUNG, LAMPUNG TIMUR, LAMPUNG",12,126,39,165
https://kawalpemilu.org#24270,"SIDODADI, SEKAMPUNG, LAMPUNG TIMUR, LAMPUNG",13,138,56,194
https://kawalpemilu.org#24271,"SAMBIKARTO, SEKAMPUNG, LAMPUNG TIMUR, LAMPUNG",1,134,76,210
https://kawalpemilu.org#24271,"SAMBIKARTO, SEKAMPUNG, LAMPUNG TIMUR, LAMPUNG",2,127,61,188
https://kawalpemilu.org#24271,"SAMBIKARTO, SEKAMPUNG, LAMPUNG TIMUR, LAMPUNG",3,145,44,189
https://kawalpemilu.org#24271,"SAMBIKARTO, SEKAMPUNG, LAMPUNG TIMUR, LAMPUNG",5,123,65,188
https://kawalpemilu.org#24271,"SAMBIKARTO, SEKAMPUNG, LAMPUNG TIMUR, LAMPUNG",6,100,59,159
https://kawalpemilu.org#24271,"SAMBIKARTO, SEKAMPUNG, LAMPUNG TIMUR, LAMPUNG",7,113,56,169
https://kawalpemilu.org#24271,"SAMBIKARTO, SEKAMPUNG, LAMPUNG TIMUR, LAMPUNG",8,121,45,166
https://kawalpemilu.org#24271,"SAMBIKARTO, SEKAMPUNG, LAMPUNG TIMUR, LAMPUNG",9,124,62,186
https://kawalpemilu.org#24271,"SAMBIKARTO, SEKAMPUNG, LAMPUNG TIMUR, LAMPUNG",10,161,51,212
https://kawalpemilu.org#24271,"SAMBIKARTO, SEKAMPUNG, LAMPUNG TIMUR, LAMPUNG",11,147,65,212
https://kawalpemilu.org#24271,"SAMBIKARTO, SEKAMPUNG, LAMPUNG TIMUR, LAMPUNG",12,77,36,113
https://kawalpemilu.org#24271,"SAMBIKARTO, SEKAMPUNG, LAMPUNG TIMUR, LAMPUNG",13,124,46,170
https://kawalpemilu.org#24272,"SUMBERSARI, SEKAMPUNG, LAMPUNG TIMUR, LAMPUNG",2,153,30,183
https://kawalpemilu.org#24272,"SUMBERSARI, SEKAMPUNG, LAMPUNG TIMUR, LAMPUNG",3,180,15,195
https://kawalpemilu.org#24272,"SUMBERSARI, SEKAMPUNG, LAMPUNG TIMUR, LAMPUNG",4,152,21,173
https://kawalpemilu.org#24272,"SUMBERSARI, SEKAMPUNG, LAMPUNG TIMUR, LAMPUNG",5,128,18,146
https://kawalpemilu.org#24272,"SUMBERSARI, SEKAMPUNG, LAMPUNG TIMUR, LAMPUNG",6,134,11,145
https://kawalpemilu.org#24272,"SUMBERSARI, SEKAMPUNG, LAMPUNG TIMUR, LAMPUNG",7,173,34,207
https://kawalpemilu.org#24272,"SUMBERSARI, SEKAMPUNG, LAMPUNG TIMUR, LAMPUNG",8,190,37,227
https://kawalpemilu.org#24272,"SUMBERSARI, SEKAMPUNG, LAMPUNG TIMUR, LAMPUNG",9,95,19,114
https://kawalpemilu.org#24272,"SUMBERSARI, SEKAMPUNG, LAMPUNG TIMUR, LAMPUNG",10,133,33,166
https://kawalpemilu.org#24272,"SUMBERSARI, SEKAMPUNG, LAMPUNG TIMUR, LAMPUNG",11,99,38,137
https://kawalpemilu.org#24272,"SUMBERSARI, SEKAMPUNG, LAMPUNG TIMUR, LAMPUNG",12,95,27,122
https://kawalpemilu.org#24273,"KARYA MUKTI, SEKAMPUNG, LAMPUNG TIMUR, LAMPUNG",1,161,54,215
https://kawalpemilu.org#24273,"KARYA MUKTI, SEKAMPUNG, LAMPUNG TIMUR, LAMPUNG",2,145,35,180
https://kawalpemilu.org#24273,"KARYA MUKTI, SEKAMPUNG, LAMPUNG TIMUR, LAMPUNG",3,121,30,151
https://kawalpemilu.org#24273,"KARYA MUKTI, SEKAMPUNG, LAMPUNG TIMUR, LAMPUNG",4,140,39,179
https://kawalpemilu.org#24273,"KARYA MUKTI, SEKAMPUNG, LAMPUNG TIMUR, LAMPUNG",5,115,31,146
https://kawalpemilu.org#24273,"KARYA MUKTI, SEKAMPUNG, LAMPUNG TIMUR, LAMPUNG",6,165,43,208
https://kawalpemilu.org#24273,"KARYA MUKTI, SEKAMPUNG, LAMPUNG TIMUR, LAMPUNG",7,107,24,131
https://kawalpemilu.org#24273,"KARYA MUKTI, SEKAMPUNG, LAMPUNG TIMUR, LAMPUNG",8,153,25,178
https://kawalpemilu.org#24273,"KARYA MUKTI, SEKAMPUNG, LAMPUNG TIMUR, LAMPUNG",9,127,31,158
https://kawalpemilu.org#24273,"KARYA MUKTI, SEKAMPUNG, LAMPUNG TIMUR, LAMPUNG",10,183,42,225
https://kawalpemilu.org#24274,"MEKAR MULYA, SEKAMPUNG, LAMPUNG TIMUR, LAMPUNG",1,154,14,168
https://kawalpemilu.org#24274,"MEKAR MULYA, SEKAMPUNG, LAMPUNG TIMUR, LAMPUNG",2,170,20,190
https://kawalpemilu.org#24274,"MEKAR MULYA, SEKAMPUNG, LAMPUNG TIMUR, LAMPUNG",3,151,43,194
https://kawalpemilu.org#24274,"MEKAR MULYA, SEKAMPUNG, LAMPUNG TIMUR, LAMPUNG",4,163,20,183
https://kawalpemilu.org#24274,"MEKAR MULYA, SEKAMPUNG, LAMPUNG TIMUR, LAMPUNG",5,183,21,204
https://kawalpemilu.org#24274,"MEKAR MULYA, SEKAMPUNG, LAMPUNG TIMUR, LAMPUNG",6,163,19,182
https://kawalpemilu.org#24275,"MEKAR SARI, SEKAMPUNG, LAMPUNG TIMUR, LAMPUNG",1,178,24,202
https://kawalpemilu.org#24275,"MEKAR SARI, SEKAMPUNG, LAMPUNG TIMUR, LAMPUNG",2,150,35,185
https://kawalpemilu.org#24275,"MEKAR SARI, SEKAMPUNG, LAMPUNG TIMUR, LAMPUNG",3,128,38,166
https://kawalpemilu.org#24275,"MEKAR SARI, SEKAMPUNG, LAMPUNG TIMUR, LAMPUNG",4,139,31,170
https://kawalpemilu.org#24275,"MEKAR SARI, SEKAMPUNG, LAMPUNG TIMUR, LAMPUNG",5,119,88,207
https://kawalpemilu.org#24275,"MEKAR SARI, SEKAMPUNG, LAMPUNG TIMUR, LAMPUNG",6,121,90,211
https://kawalpemilu.org#24275,"MEKAR SARI, SEKAMPUNG, LAMPUNG TIMUR, LAMPUNG",7,158,65,223
https://kawalpemilu.org#24275,"MEKAR SARI, SEKAMPUNG, LAMPUNG TIMUR, LAMPUNG",8,151,73,224
https://kawalpemilu.org#24276,"MEKAR MUKTI, SEKAMPUNG, LAMPUNG TIMUR, LAMPUNG",1,120,22,142
https://kawalpemilu.org#24276,"MEKAR MUKTI, SEKAMPUNG, LAMPUNG TIMUR, LAMPUNG",2,131,26,157
https://kawalpemilu.org#24276,"MEKAR MUKTI, SEKAMPUNG, LAMPUNG TIMUR, LAMPUNG",3,133,39,172
https://kawalpemilu.org#24276,"MEKAR MUKTI, SEKAMPUNG, LAMPUNG TIMUR, LAMPUNG",4,157,23,180
https://kawalpemilu.org#24276,"MEKAR MUKTI, SEKAMPUNG, LAMPUNG TIMUR, LAMPUNG",5,142,44,186
https://kawalpemilu.org#24276,"MEKAR MUKTI, SEKAMPUNG, LAMPUNG TIMUR, LAMPUNG",6,125,10,135
https://kawalpemilu.org#24276,"MEKAR MUKTI, SEKAMPUNG, LAMPUNG TIMUR, LAMPUNG",7,99,31,130
https://kawalpemilu.org#24276,"MEKAR MUKTI, SEKAMPUNG, LAMPUNG TIMUR, LAMPUNG",8,144,29,173
https://kawalpemilu.org#24277,"JADI MULYO, SEKAMPUNG, LAMPUNG TIMUR, LAMPUNG",1,99,109,208
https://kawalpemilu.org#24277,"JADI MULYO, SEKAMPUNG, LAMPUNG TIMUR, LAMPUNG",2,91,68,159
https://kawalpemilu.org#24277,"JADI MULYO, SEKAMPUNG, LAMPUNG TIMUR, LAMPUNG",3,85,101,186
https://kawalpemilu.org#24277,"JADI MULYO, SEKAMPUNG, LAMPUNG TIMUR, LAMPUNG",4,77,109,186
https://kawalpemilu.org#24277,"JADI MULYO, SEKAMPUNG, LAMPUNG TIMUR, LAMPUNG",5,112,83,195
https://kawalpemilu.org#24277,"JADI MULYO, SEKAMPUNG, LAMPUNG TIMUR, LAMPUNG",6,152,65,217
https://kawalpemilu.org#24279,"BANARJOYO, BATANGHARI, LAMPUNG TIMUR, LAMPUNG",1,125,98,233
https://kawalpemilu.org#24279,"BANARJOYO, BATANGHARI, LAMPUNG TIMUR, LAMPUNG",2,149,73,222
https://kawalpemilu.org#24279,"BANARJOYO, BATANGHARI, LAMPUNG TIMUR, LAMPUNG",3,105,97,202
https://kawalpemilu.org#24279,"BANARJOYO, BATANGHARI, LAMPUNG TIMUR, LAMPUNG",4,114,74,188
https://kawalpemilu.org#24279,"BANARJOYO, BATANGHARI, LAMPUNG TIMUR, LAMPUNG",5,152,61,213
https://kawalpemilu.org#24279,"BANARJOYO, BATANGHARI, LAMPUNG TIMUR, LAMPUNG",6,122,94,216
https://kawalpemilu.org#24279,"BANARJOYO, BATANGHARI, LAMPUNG TIMUR, LAMPUNG",7,115,56,171
https://kawalpemilu.org#24279,"BANARJOYO, BATANGHARI, LAMPUNG TIMUR, LAMPUNG",8,89,81,170
https://kawalpemilu.org#24279,"BANARJOYO, BATANGHARI, LAMPUNG TIMUR, LAMPUNG",9,85,102,187
https://kawalpemilu.org#24279,"BANARJOYO, BATANGHARI, LAMPUNG TIMUR, LAMPUNG",10,119,61,180
https://kawalpemilu.org#24279,"BANARJOYO, BATANGHARI, LAMPUNG TIMUR, LAMPUNG",11,116,66,182
https://kawalpemilu.org#24279,"BANARJOYO, BATANGHARI, LAMPUNG TIMUR, LAMPUNG",12,140,42,182
https://kawalpemilu.org#24280,"BUANA SAKTI, BATANGHARI, LAMPUNG TIMUR, LAMPUNG",1,180,37,217
https://kawalpemilu.org#24280,"BUANA SAKTI, BATANGHARI, LAMPUNG TIMUR, LAMPUNG",2,155,19,174
https://kawalpemilu.org#24280,"BUANA SAKTI, BATANGHARI, LAMPUNG TIMUR, LAMPUNG",3,137,33,170
https://kawalpemilu.org#24280,"BUANA SAKTI, BATANGHARI, LAMPUNG TIMUR, LAMPUNG",4,152,26,178
https://kawalpemilu.org#24280,"BUANA SAKTI, BATANGHARI, LAMPUNG TIMUR, LAMPUNG",5,132,66,198
https://kawalpemilu.org#24280,"BUANA SAKTI, BATANGHARI, LAMPUNG TIMUR, LAMPUNG",6,158,27,185
https://kawalpemilu.org#24280,"BUANA SAKTI, BATANGHARI, LAMPUNG TIMUR, LAMPUNG",7,166,46,212
https://kawalpemilu.org#24280,"BUANA SAKTI, BATANGHARI, LAMPUNG TIMUR, LAMPUNG",8,193,65,258
https://kawalpemilu.org#24281,"BALE KENCONO, BATANGHARI, LAMPUNG TIMUR, LAMPUNG",1,116,39,155
https://kawalpemilu.org#24281,"BALE KENCONO, BATANGHARI, LAMPUNG TIMUR, LAMPUNG",2,115,44,159
https://kawalpemilu.org#24281,"BALE KENCONO, BATANGHARI, LAMPUNG TIMUR, LAMPUNG",4,130,47,177
https://kawalpemilu.org#24281,"BALE KENCONO, BATANGHARI, LAMPUNG TIMUR, LAMPUNG",8,132,57,189
https://kawalpemilu.org#24282,"REJO AGUNG, BATANGHARI, LAMPUNG TIMUR, LAMPUNG",1,135,52,187
https://kawalpemilu.org#24282,"REJO AGUNG, BATANGHARI, LAMPUNG TIMUR, LAMPUNG",2,140,42,182
https://kawalpemilu.org#24282,"REJO AGUNG, BATANGHARI, LAMPUNG TIMUR, LAMPUNG",3,98,67,165
https://kawalpemilu.org#24282,"REJO AGUNG, BATANGHARI, LAMPUNG TIMUR, LAMPUNG",4,149,37,186
https://kawalpemilu.org#24282,"REJO AGUNG, BATANGHARI, LAMPUNG TIMUR, LAMPUNG",5,163,37,200
https://kawalpemilu.org#24282,"REJO AGUNG, BATANGHARI, LAMPUNG TIMUR, LAMPUNG",6,135,39,174
https://kawalpemilu.org#24282,"REJO AGUNG, BATANGHARI, LAMPUNG TIMUR, LAMPUNG",7,110,43,153
https://kawalpemilu.org#24282,"REJO AGUNG, BATANGHARI, LAMPUNG TIMUR, LAMPUNG",8,131,76,207
https://kawalpemilu.org#24283,"ADI WARNO, BATANGHARI, LAMPUNG TIMUR, LAMPUNG",1,127,64,191
https://kawalpemilu.org#24283,"ADI WARNO, BATANGHARI, LAMPUNG TIMUR, LAMPUNG",2,145,80,225
https://kawalpemilu.org#24283,"ADI WARNO, BATANGHARI, LAMPUNG TIMUR, LAMPUNG",3,120,69,189
https://kawalpemilu.org#24283,"ADI WARNO, BATANGHARI, LAMPUNG TIMUR, LAMPUNG",4,113,95,208
https://kawalpemilu.org#24283,"ADI WARNO, BATANGHARI, LAMPUNG TIMUR, LAMPUNG",5,115,104,219
https://kawalpemilu.org#24283,"ADI WARNO, BATANGHARI, LAMPUNG TIMUR, LAMPUNG",6,85,113,198
https://kawalpemilu.org#24283,"ADI WARNO, BATANGHARI, LAMPUNG TIMUR, LAMPUNG",7,72,86,158
https://kawalpemilu.org#24283,"ADI WARNO, BATANGHARI, LAMPUNG TIMUR, LAMPUNG",8,73,91,164
https://kawalpemilu.org#24283,"ADI WARNO, BATANGHARI, LAMPUNG TIMUR, LAMPUNG",9,93,101,194
https://kawalpemilu.org#24284,"TELOGO REJO, BATANGHARI, LAMPUNG TIMUR, LAMPUNG",1,145,53,198
https://kawalpemilu.org#24284,"TELOGO REJO, BATANGHARI, LAMPUNG TIMUR, LAMPUNG",2,123,57,180
https://kawalpemilu.org#24284,"TELOGO REJO, BATANGHARI, LAMPUNG TIMUR, LAMPUNG",3,163,97,260
https://kawalpemilu.org#24284,"TELOGO REJO, BATANGHARI, LAMPUNG TIMUR, LAMPUNG",4,130,112,242
https://kawalpemilu.org#24284,"TELOGO REJO, BATANGHARI, LAMPUNG TIMUR, LAMPUNG",5,90,85,175
https://kawalpemilu.org#24284,"TELOGO REJO, BATANGHARI, LAMPUNG TIMUR, LAMPUNG",6,98,67,165
https://kawalpemilu.org#24284,"TELOGO REJO, BATANGHARI, LAMPUNG TIMUR, LAMPUNG",7,61,87,148
https://kawalpemilu.org#24285,"NAMPI REJO, BATANGHARI, LAMPUNG TIMUR, LAMPUNG",1,75,134,209
https://kawalpemilu.org#24285,"NAMPI REJO, BATANGHARI, LAMPUNG TIMUR, LAMPUNG",2,104,112,216
https://kawalpemilu.org#24285,"NAMPI REJO, BATANGHARI, LAMPUNG TIMUR, LAMPUNG",3,82,110,192
https://kawalpemilu.org#24285,"NAMPI REJO, BATANGHARI, LAMPUNG TIMUR, LAMPUNG",4,98,109,207
https://kawalpemilu.org#24285,"NAMPI REJO, BATANGHARI, LAMPUNG TIMUR, LAMPUNG",5,77,84,161
https://kawalpemilu.org#24285,"NAMPI REJO, BATANGHARI, LAMPUNG TIMUR, LAMPUNG",6,103,65,168
https://kawalpemilu.org#24285,"NAMPI REJO, BATANGHARI, LAMPUNG TIMUR, LAMPUNG",7,112,80,192
https://kawalpemilu.org#24285,"NAMPI REJO, BATANGHARI, LAMPUNG TIMUR, LAMPUNG",8,99,104,203
https://kawalpemilu.org#24285,"NAMPI REJO, BATANGHARI, LAMPUNG TIMUR, LAMPUNG",9,78,139,217
https://kawalpemilu.org#24285,"NAMPI REJO, BATANGHARI, LAMPUNG TIMUR, LAMPUNG",10,98,133,231
https://kawalpemilu.org#24286,"SUMBER REJO, BATANGHARI, LAMPUNG TIMUR, LAMPUNG",1,72,134,206
https://kawalpemilu.org#24286,"SUMBER REJO, BATANGHARI, LAMPUNG TIMUR, LAMPUNG",2,82,158,240
https://kawalpemilu.org#24286,"SUMBER REJO, BATANGHARI, LAMPUNG TIMUR, LAMPUNG",3,99,110,209
https://kawalpemilu.org#24286,"SUMBER REJO, BATANGHARI, LAMPUNG TIMUR, LAMPUNG",4,114,57,171
https://kawalpemilu.org#24286,"SUMBER REJO, BATANGHARI, LAMPUNG TIMUR, LAMPUNG",5,105,105,210
https://kawalpemilu.org#24286,"SUMBER REJO, BATANGHARI, LAMPUNG TIMUR, LAMPUNG",6,116,70,186
https://kawalpemilu.org#24286,"SUMBER REJO, BATANGHARI, LAMPUNG TIMUR, LAMPUNG",7,100,85,185
https://kawalpemilu.org#24286,"SUMBER REJO, BATANGHARI, LAMPUNG TIMUR, LAMPUNG",8,102,77,179
https://kawalpemilu.org#24286,"SUMBER REJO, BATANGHARI, LAMPUNG TIMUR, LAMPUNG",9,157,83,240
https://kawalpemilu.org#24286,"SUMBER REJO, BATANGHARI, LAMPUNG TIMUR, LAMPUNG",10,101,46,147
https://kawalpemilu.org#24286,"SUMBER REJO, BATANGHARI, LAMPUNG TIMUR, LAMPUNG",11,118,102,220
https://kawalpemilu.org#24286,"SUMBER REJO, BATANGHARI, LAMPUNG TIMUR, LAMPUNG",12,128,67,195
https://kawalpemilu.org#24287,"BANJAR REJO, BATANGHARI, LAMPUNG TIMUR, LAMPUNG",1,106,70,176
https://kawalpemilu.org#24287,"BANJAR REJO, BATANGHARI, LAMPUNG TIMUR, LAMPUNG",2,109,81,190
https://kawalpemilu.org#24287,"BANJAR REJO, BATANGHARI, LAMPUNG TIMUR, LAMPUNG",3,113,81,194
https://kawalpemilu.org#24287,"BANJAR REJO, BATANGHARI, LAMPUNG TIMUR, LAMPUNG",4,115,56,171
https://kawalpemilu.org#24287,"BANJAR REJO, BATANGHARI, LAMPUNG TIMUR, LAMPUNG",5,131,86,217
https://kawalpemilu.org#24287,"BANJAR REJO, BATANGHARI, LAMPUNG TIMUR, LAMPUNG",6,132,83,215
https://kawalpemilu.org#24287,"BANJAR REJO, BATANGHARI, LAMPUNG TIMUR, LAMPUNG",7,73,141,214
https://kawalpemilu.org#24287,"BANJAR REJO, BATANGHARI, LAMPUNG TIMUR, LAMPUNG",8,46,87,133
https://kawalpemilu.org#24287,"BANJAR REJO, BATANGHARI, LAMPUNG TIMUR, LAMPUNG",9,132,89,221
https://kawalpemilu.org#24287,"BANJAR REJO, BATANGHARI, LAMPUNG TIMUR, LAMPUNG",10,68,151,219
https://kawalpemilu.org#24287,"BANJAR REJO, BATANGHARI, LAMPUNG TIMUR, LAMPUNG",11,80,74,154
https://kawalpemilu.org#24287,"BANJAR REJO, BATANGHARI, LAMPUNG TIMUR, LAMPUNG",12,118,77,195
https://kawalpemilu.org#24287,"BANJAR REJO, BATANGHARI, LAMPUNG TIMUR, LAMPUNG",13,114,91,205
https://kawalpemilu.org#24287,"BANJAR REJO, BATANGHARI, LAMPUNG TIMUR, LAMPUNG",14,77,85,162
https://kawalpemilu.org#24287,"BANJAR REJO, BATANGHARI, LAMPUNG TIMUR, LAMPUNG",15,119,89,208
https://kawalpemilu.org#24287,"BANJAR REJO, BATANGHARI, LAMPUNG TIMUR, LAMPUNG",16,120,80,200
https://kawalpemilu.org#24287,"BANJAR REJO, BATANGHARI, LAMPUNG TIMUR, LAMPUNG",17,135,70,205
https://kawalpemilu.org#24287,"BANJAR REJO, BATANGHARI, LAMPUNG TIMUR, LAMPUNG",18,130,66,196
https://kawalpemilu.org#24287,"BANJAR REJO, BATANGHARI, LAMPUNG TIMUR, LAMPUNG",19,107,94,201
https://kawalpemilu.org#24287,"BANJAR REJO, BATANGHARI, LAMPUNG TIMUR, LAMPUNG",20,105,104,209
https://kawalpemilu.org#24287,"BANJAR REJO, BATANGHARI, LAMPUNG TIMUR, LAMPUNG",21,162,68,230
https://kawalpemilu.org#24287,"BANJAR REJO, BATANGHARI, LAMPUNG TIMUR, LAMPUNG",22,122,81,203
https://kawalpemilu.org#24287,"BANJAR REJO, BATANGHARI, LAMPUNG TIMUR, LAMPUNG",23,128,104,232
https://kawalpemilu.org#24288,"BALE REJO, BATANGHARI, LAMPUNG TIMUR, LAMPUNG",1,128,46,174
https://kawalpemilu.org#24288,"BALE REJO, BATANGHARI, LAMPUNG TIMUR, LAMPUNG",2,105,46,151
https://kawalpemilu.org#24288,"BALE REJO, BATANGHARI, LAMPUNG TIMUR, LAMPUNG",3,121,48,169
https://kawalpemilu.org#24288,"BALE REJO, BATANGHARI, LAMPUNG TIMUR, LAMPUNG",4,141,34,175
https://kawalpemilu.org#24288,"BALE REJO, BATANGHARI, LAMPUNG TIMUR, LAMPUNG",5,151,39,190
https://kawalpemilu.org#24288,"BALE REJO, BATANGHARI, LAMPUNG TIMUR, LAMPUNG",6,163,66,229
https://kawalpemilu.org#24288,"BALE REJO, BATANGHARI, LAMPUNG TIMUR, LAMPUNG",7,177,45,222
https://kawalpemilu.org#24288,"BALE REJO, BATANGHARI, LAMPUNG TIMUR, LAMPUNG",8,146,65,211
https://kawalpemilu.org#24288,"BALE REJO, BATANGHARI, LAMPUNG TIMUR, LAMPUNG",9,162,45,207
https://kawalpemilu.org#24288,"BALE REJO, BATANGHARI, LAMPUNG TIMUR, LAMPUNG",10,201,37,238
https://kawalpemilu.org#24288,"BALE REJO, BATANGHARI, LAMPUNG TIMUR, LAMPUNG",11,153,35,188
https://kawalpemilu.org#24289,"BATANG HARJO, BATANGHARI, LAMPUNG TIMUR, LAMPUNG",1,65,50,115
https://kawalpemilu.org#24289,"BATANG HARJO, BATANGHARI, LAMPUNG TIMUR, LAMPUNG",2,110,59,169
https://kawalpemilu.org#24289,"BATANG HARJO, BATANGHARI, LAMPUNG TIMUR, LAMPUNG",3,136,85,221
https://kawalpemilu.org#24289,"BATANG HARJO, BATANGHARI, LAMPUNG TIMUR, LAMPUNG",4,102,53,155
https://kawalpemilu.org#24289,"BATANG HARJO, BATANGHARI, LAMPUNG TIMUR, LAMPUNG",5,157,55,212
https://kawalpemilu.org#24289,"BATANG HARJO, BATANGHARI, LAMPUNG TIMUR, LAMPUNG",6,162,16,178
https://kawalpemilu.org#24289,"BATANG HARJO, BATANGHARI, LAMPUNG TIMUR, LAMPUNG",7,92,36,128
https://kawalpemilu.org#24289,"BATANG HARJO, BATANGHARI, LAMPUNG TIMUR, LAMPUNG",8,123,77,200
https://kawalpemilu.org#24289,"BATANG HARJO, BATANGHARI, LAMPUNG TIMUR, LAMPUNG",9,110,32,142
https://kawalpemilu.org#24289,"BATANG HARJO, BATANGHARI, LAMPUNG TIMUR, LAMPUNG",10,134,39,173
https://kawalpemilu.org#24289,"BATANG HARJO, BATANGHARI, LAMPUNG TIMUR, LAMPUNG",11,78,95,173
https://kawalpemilu.org#24289,"BATANG HARJO, BATANGHARI, LAMPUNG TIMUR, LAMPUNG",12,113,67,180
https://kawalpemilu.org#24289,"BATANG HARJO, BATANGHARI, LAMPUNG TIMUR, LAMPUNG",13,136,50,186
https://kawalpemilu.org#24289,"BATANG HARJO, BATANGHARI, LAMPUNG TIMUR, LAMPUNG",14,118,48,166
https://kawalpemilu.org#24289,"BATANG HARJO, BATANGHARI, LAMPUNG TIMUR, LAMPUNG",15,166,47,213
https://kawalpemilu.org#24289,"BATANG HARJO, BATANGHARI, LAMPUNG TIMUR, LAMPUNG",16,157,32,189
https://kawalpemilu.org#24290,"BUMI HARJO, BATANGHARI, LAMPUNG TIMUR, LAMPUNG",1,95,80,175
https://kawalpemilu.org#24290,"BUMI HARJO, BATANGHARI, LAMPUNG TIMUR, LAMPUNG",2,79,89,168
https://kawalpemilu.org#24290,"BUMI HARJO, BATANGHARI, LAMPUNG TIMUR, LAMPUNG",3,90,68,158
https://kawalpemilu.org#24290,"BUMI HARJO, BATANGHARI, LAMPUNG TIMUR, LAMPUNG",4,149,96,245
https://kawalpemilu.org#24290,"BUMI HARJO, BATANGHARI, LAMPUNG TIMUR, LAMPUNG",5,119,106,225
https://kawalpemilu.org#24290,"BUMI HARJO, BATANGHARI, LAMPUNG TIMUR, LAMPUNG",6,99,39,138
https://kawalpemilu.org#24290,"BUMI HARJO, BATANGHARI, LAMPUNG TIMUR, LAMPUNG",7,137,43,180
https://kawalpemilu.org#24290,"BUMI HARJO, BATANGHARI, LAMPUNG TIMUR, LAMPUNG",8,146,35,181
https://kawalpemilu.org#24290,"BUMI HARJO, BATANGHARI, LAMPUNG TIMUR, LAMPUNG",9,123,55,178
https://kawalpemilu.org#24290,"BUMI HARJO, BATANGHARI, LAMPUNG TIMUR, LAMPUNG",10,140,50,190
https://kawalpemilu.org#24290,"BUMI HARJO, BATANGHARI, LAMPUNG TIMUR, LAMPUNG",11,155,42,197
https://kawalpemilu.org#24290,"BUMI HARJO, BATANGHARI, LAMPUNG TIMUR, LAMPUNG",12,142,32,174
https://kawalpemilu.org#24290,"BUMI HARJO, BATANGHARI, LAMPUNG TIMUR, LAMPUNG",13,89,64,153
https://kawalpemilu.org#24290,"BUMI HARJO, BATANGHARI, LAMPUNG TIMUR, LAMPUNG",14,123,40,163
https://kawalpemilu.org#24290,"BUMI HARJO, BATANGHARI, LAMPUNG TIMUR, LAMPUNG",15,136,40,176
https://kawalpemilu.org#24290,"BUMI HARJO, BATANGHARI, LAMPUNG TIMUR, LAMPUNG",16,128,54,182
https://kawalpemilu.org#24290,"BUMI HARJO, BATANGHARI, LAMPUNG TIMUR, LAMPUNG",17,102,66,173
https://kawalpemilu.org#24290,"BUMI HARJO, BATANGHARI, LAMPUNG TIMUR, LAMPUNG",18,106,64,170
https://kawalpemilu.org#24290,"BUMI HARJO, BATANGHARI, LAMPUNG TIMUR, LAMPUNG",19,137,36,173
https://kawalpemilu.org#24291,"BUMI MAS, BATANGHARI, LAMPUNG TIMUR, LAMPUNG",1,125,74,199
https://kawalpemilu.org#24291,"BUMI MAS, BATANGHARI, LAMPUNG TIMUR, LAMPUNG",2,139,71,210
https://kawalpemilu.org#24291,"BUMI MAS, BATANGHARI, LAMPUNG TIMUR, LAMPUNG",3,174,53,227
https://kawalpemilu.org#24291,"BUMI MAS, BATANGHARI, LAMPUNG TIMUR, LAMPUNG",4,153,85,238
https://kawalpemilu.org#24291,"BUMI MAS, BATANGHARI, LAMPUNG TIMUR, LAMPUNG",5,154,79,233
https://kawalpemilu.org#24291,"BUMI MAS, BATANGHARI, LAMPUNG TIMUR, LAMPUNG",6,142,78,220
https://kawalpemilu.org#24291,"BUMI MAS, BATANGHARI, LAMPUNG TIMUR, LAMPUNG",7,165,43,211
https://kawalpemilu.org#24292,"SELOREJO, BATANGHARI, LAMPUNG TIMUR, LAMPUNG",1,130,50,180
https://kawalpemilu.org#24292,"SELOREJO, BATANGHARI, LAMPUNG TIMUR, LAMPUNG",2,62,118,180
https://kawalpemilu.org#24292,"SELOREJO, BATANGHARI, LAMPUNG TIMUR, LAMPUNG",3,74,55,0
https://kawalpemilu.org#24292,"SELOREJO, BATANGHARI, LAMPUNG TIMUR, LAMPUNG",4,73,52,125
https://kawalpemilu.org#24292,"SELOREJO, BATANGHARI, LAMPUNG TIMUR, LAMPUNG",5,118,31,149
https://kawalpemilu.org#24292,"SELOREJO, BATANGHARI, LAMPUNG TIMUR, LAMPUNG",6,118,8,126
https://kawalpemilu.org#24292,"SELOREJO, BATANGHARI, LAMPUNG TIMUR, LAMPUNG",7,100,84,184
https://kawalpemilu.org#24292,"SELOREJO, BATANGHARI, LAMPUNG TIMUR, LAMPUNG",8,100,77,177
https://kawalpemilu.org#24292,"SELOREJO, BATANGHARI, LAMPUNG TIMUR, LAMPUNG",9,130,45,175
https://kawalpemilu.org#24292,"SELOREJO, BATANGHARI, LAMPUNG TIMUR, LAMPUNG",10,165,51,216
https://kawalpemilu.org#24292,"SELOREJO, BATANGHARI, LAMPUNG TIMUR, LAMPUNG",11,169,33,202
https://kawalpemilu.org#24293,"SRI BASUKI, BATANGHARI, LAMPUNG TIMUR, LAMPUNG",1,153,41,194
https://kawalpemilu.org#24293,"SRI BASUKI, BATANGHARI, LAMPUNG TIMUR, LAMPUNG",2,130,64,194
https://kawalpemilu.org#24293,"SRI BASUKI, BATANGHARI, LAMPUNG TIMUR, LAMPUNG",3,163,38,201
https://kawalpemilu.org#24293,"SRI BASUKI, BATANGHARI, LAMPUNG TIMUR, LAMPUNG",4,142,55,197
https://kawalpemilu.org#24293,"SRI BASUKI, BATANGHARI, LAMPUNG TIMUR, LAMPUNG",5,142,55,197
https://kawalpemilu.org#24293,"SRI BASUKI, BATANGHARI, LAMPUNG TIMUR, LAMPUNG",6,151,44,195
https://kawalpemilu.org#24293,"SRI BASUKI, BATANGHARI, LAMPUNG TIMUR, LAMPUNG",7,143,145,188
https://kawalpemilu.org#24294,"SUMBER AGUNG, BATANGHARI, LAMPUNG TIMUR, LAMPUNG",1,195,39,234
https://kawalpemilu.org#24294,"SUMBER AGUNG, BATANGHARI, LAMPUNG TIMUR, LAMPUNG",2,166,47,213
https://kawalpemilu.org#24294,"SUMBER AGUNG, BATANGHARI, LAMPUNG TIMUR, LAMPUNG",3,127,40,167
https://kawalpemilu.org#24294,"SUMBER AGUNG, BATANGHARI, LAMPUNG TIMUR, LAMPUNG",4,137,21,158
https://kawalpemilu.org#24294,"SUMBER AGUNG, BATANGHARI, LAMPUNG TIMUR, LAMPUNG",5,134,40,174
https://kawalpemilu.org#24294,"SUMBER AGUNG, BATANGHARI, LAMPUNG TIMUR, LAMPUNG",6,153,60,213
https://kawalpemilu.org#24294,"SUMBER AGUNG, BATANGHARI, LAMPUNG TIMUR, LAMPUNG",7,188,30,218
https://kawalpemilu.org#24295,"PURWODADI MEKAR, BATANGHARI, LAMPUNG TIMUR, LAMPUNG",1,148,15,163
https://kawalpemilu.org#24295,"PURWODADI MEKAR, BATANGHARI, LAMPUNG TIMUR, LAMPUNG",2,169,20,189
https://kawalpemilu.org#24295,"PURWODADI MEKAR, BATANGHARI, LAMPUNG TIMUR, LAMPUNG",3,145,20,165
https://kawalpemilu.org#24295,"PURWODADI MEKAR, BATANGHARI, LAMPUNG TIMUR, LAMPUNG",4,196,40,236
https://kawalpemilu.org#24295,"PURWODADI MEKAR, BATANGHARI, LAMPUNG TIMUR, LAMPUNG",5,172,26,198
https://kawalpemilu.org#24295,"PURWODADI MEKAR, BATANGHARI, LAMPUNG TIMUR, LAMPUNG",6,187,39,226
https://kawalpemilu.org#24297,"BRAJA SAKTI, WAY JEPARA, LAMPUNG TIMUR, LAMPUNG",1,94,58,152
https://kawalpemilu.org#24297,"BRAJA SAKTI, WAY JEPARA, LAMPUNG TIMUR, LAMPUNG",2,87,59,146
https://kawalpemilu.org#24297,"BRAJA SAKTI, WAY JEPARA, LAMPUNG TIMUR, LAMPUNG",4,88,34,122
https://kawalpemilu.org#24297,"BRAJA SAKTI, WAY JEPARA, LAMPUNG TIMUR, LAMPUNG",5,104,64,168
https://kawalpemilu.org#24297,"BRAJA SAKTI, WAY JEPARA, LAMPUNG TIMUR, LAMPUNG",6,97,57,154
https://kawalpemilu.org#24297,"BRAJA SAKTI, WAY JEPARA, LAMPUNG TIMUR, LAMPUNG",7,120,44,164
https://kawalpemilu.org#24297,"BRAJA SAKTI, WAY JEPARA, LAMPUNG TIMUR, LAMPUNG",8,108,51,159
https://kawalpemilu.org#24297,"BRAJA SAKTI, WAY JEPARA, LAMPUNG TIMUR, LAMPUNG",9,125,64,189
https://kawalpemilu.org#24297,"BRAJA SAKTI, WAY JEPARA, LAMPUNG TIMUR, LAMPUNG",10,106,59,165
https://kawalpemilu.org#24297,"BRAJA SAKTI, WAY JEPARA, LAMPUNG TIMUR, LAMPUNG",11,100,114,214
https://kawalpemilu.org#24297,"BRAJA SAKTI, WAY JEPARA, LAMPUNG TIMUR, LAMPUNG",12,105,79,184
https://kawalpemilu.org#24297,"BRAJA SAKTI, WAY JEPARA, LAMPUNG TIMUR, LAMPUNG",13,102,58,160
https://kawalpemilu.org#24297,"BRAJA SAKTI, WAY JEPARA, LAMPUNG TIMUR, LAMPUNG",14,138,42,180
https://kawalpemilu.org#24297,"BRAJA SAKTI, WAY JEPARA, LAMPUNG TIMUR, LAMPUNG",15,145,39,184
https://kawalpemilu.org#24297,"BRAJA SAKTI, WAY JEPARA, LAMPUNG TIMUR, LAMPUNG",16,142,55,197
https://kawalpemilu.org#24297,"BRAJA SAKTI, WAY JEPARA, LAMPUNG TIMUR, LAMPUNG",17,119,66,185
https://kawalpemilu.org#24297,"BRAJA SAKTI, WAY JEPARA, LAMPUNG TIMUR, LAMPUNG",18,163,55,218
https://kawalpemilu.org#24297,"BRAJA SAKTI, WAY JEPARA, LAMPUNG TIMUR, LAMPUNG",19,153,35,188
https://kawalpemilu.org#24297,"BRAJA SAKTI, WAY JEPARA, LAMPUNG TIMUR, LAMPUNG",20,143,56,199
https://kawalpemilu.org#24297,"BRAJA SAKTI, WAY JEPARA, LAMPUNG TIMUR, LAMPUNG",22,191,32,223
https://kawalpemilu.org#24298,"BRAJA FAJAR, WAY JEPARA, LAMPUNG TIMUR, LAMPUNG",1,115,17,132
https://kawalpemilu.org#24298,"BRAJA FAJAR, WAY JEPARA, LAMPUNG TIMUR, LAMPUNG",2,147,25,172
https://kawalpemilu.org#24298,"BRAJA FAJAR, WAY JEPARA, LAMPUNG TIMUR, LAMPUNG",3,125,52,177
https://kawalpemilu.org#24298,"BRAJA FAJAR, WAY JEPARA, LAMPUNG TIMUR, LAMPUNG",4,178,46,224
https://kawalpemilu.org#24298,"BRAJA FAJAR, WAY JEPARA, LAMPUNG TIMUR, LAMPUNG",5,155,55,210
https://kawalpemilu.org#24298,"BRAJA FAJAR, WAY JEPARA, LAMPUNG TIMUR, LAMPUNG",6,236,16,252
https://kawalpemilu.org#24299,"BRAJA EMAS, WAY JEPARA, LAMPUNG TIMUR, LAMPUNG",1,161,15,176
https://kawalpemilu.org#24299,"BRAJA EMAS, WAY JEPARA, LAMPUNG TIMUR, LAMPUNG",3,104,65,169
https://kawalpemilu.org#24299,"BRAJA EMAS, WAY JEPARA, LAMPUNG TIMUR, LAMPUNG",4,49,131,180
https://kawalpemilu.org#24299,"BRAJA EMAS, WAY JEPARA, LAMPUNG TIMUR, LAMPUNG",5,50,44,94
https://kawalpemilu.org#24299,"BRAJA EMAS, WAY JEPARA, LAMPUNG TIMUR, LAMPUNG",6,110,32,142
https://kawalpemilu.org#24299,"BRAJA EMAS, WAY JEPARA, LAMPUNG TIMUR, LAMPUNG",7,160,16,176
https://kawalpemilu.org#24299,"BRAJA EMAS, WAY JEPARA, LAMPUNG TIMUR, LAMPUNG",8,197,12,209
https://kawalpemilu.org#24300,"BRAJA DEWA, WAY JEPARA, LAMPUNG TIMUR, LAMPUNG",1,108,55,163
https://kawalpemilu.org#24300,"BRAJA DEWA, WAY JEPARA, LAMPUNG TIMUR, LAMPUNG",2,113,18,131
https://kawalpemilu.org#24300,"BRAJA DEWA, WAY JEPARA, LAMPUNG TIMUR, LAMPUNG",3,144,22,166
https://kawalpemilu.org#24300,"BRAJA DEWA, WAY JEPARA, LAMPUNG TIMUR, LAMPUNG",4,143,6,149
https://kawalpemilu.org#24300,"BRAJA DEWA, WAY JEPARA, LAMPUNG TIMUR, LAMPUNG",5,219,21,240
https://kawalpemilu.org#24300,"BRAJA DEWA, WAY JEPARA, LAMPUNG TIMUR, LAMPUNG",6,175,28,203
https://kawalpemilu.org#24301,"BRAJA CAKA, WAY JEPARA, LAMPUNG TIMUR, LAMPUNG",1,68,145,213
https://kawalpemilu.org#24301,"BRAJA CAKA, WAY JEPARA, LAMPUNG TIMUR, LAMPUNG",2,94,113,207
https://kawalpemilu.org#24301,"BRAJA CAKA, WAY JEPARA, LAMPUNG TIMUR, LAMPUNG",3,53,81,134
https://kawalpemilu.org#24301,"BRAJA CAKA, WAY JEPARA, LAMPUNG TIMUR, LAMPUNG",4,98,45,143
https://kawalpemilu.org#24301,"BRAJA CAKA, WAY JEPARA, LAMPUNG TIMUR, LAMPUNG",5,69,58,127
https://kawalpemilu.org#24301,"BRAJA CAKA, WAY JEPARA, LAMPUNG TIMUR, LAMPUNG",6,123,7,130
https://kawalpemilu.org#24301,"BRAJA CAKA, WAY JEPARA, LAMPUNG TIMUR, LAMPUNG",7,158,54,212
https://kawalpemilu.org#24301,"BRAJA CAKA, WAY JEPARA, LAMPUNG TIMUR, LAMPUNG",8,174,34,208
https://kawalpemilu.org#24301,"BRAJA CAKA, WAY JEPARA, LAMPUNG TIMUR, LAMPUNG",9,122,86,208
https://kawalpemilu.org#24302,"SRIWANGI, WAY JEPARA, LAMPUNG TIMUR, LAMPUNG",1,107,31,138
https://kawalpemilu.org#24302,"SRIWANGI, WAY JEPARA, LAMPUNG TIMUR, LAMPUNG",2,138,38,176
https://kawalpemilu.org#24302,"SRIWANGI, WAY JEPARA, LAMPUNG TIMUR, LAMPUNG",3,145,21,166
https://kawalpemilu.org#24302,"SRIWANGI, WAY JEPARA, LAMPUNG TIMUR, LAMPUNG",4,120,69,189
https://kawalpemilu.org#24303,"JEPARA, WAY JEPARA, LAMPUNG TIMUR, LAMPUNG",1,45,176,221
https://kawalpemilu.org#24303,"JEPARA, WAY JEPARA, LAMPUNG TIMUR, LAMPUNG",2,28,140,168
https://kawalpemilu.org#24303,"JEPARA, WAY JEPARA, LAMPUNG TIMUR, LAMPUNG",3,104,21,125
https://kawalpemilu.org#24303,"JEPARA, WAY JEPARA, LAMPUNG TIMUR, LAMPUNG",4,121,44,165
https://kawalpemilu.org#24303,"JEPARA, WAY JEPARA, LAMPUNG TIMUR, LAMPUNG",5,144,39,183
https://kawalpemilu.org#24303,"JEPARA, WAY JEPARA, LAMPUNG TIMUR, LAMPUNG",6,146,36,182
https://kawalpemilu.org#24303,"JEPARA, WAY JEPARA, LAMPUNG TIMUR, LAMPUNG",7,142,38,180
https://kawalpemilu.org#24303,"JEPARA, WAY JEPARA, LAMPUNG TIMUR, LAMPUNG",8,120,30,150
https://kawalpemilu.org#24303,"JEPARA, WAY JEPARA, LAMPUNG TIMUR, LAMPUNG",9,131,29,160
https://kawalpemilu.org#24303,"JEPARA, WAY JEPARA, LAMPUNG TIMUR, LAMPUNG",10,88,4,92
https://kawalpemilu.org#24303,"JEPARA, WAY JEPARA, LAMPUNG TIMUR, LAMPUNG",11,107,12,119
https://kawalpemilu.org#24303,"JEPARA, WAY JEPARA, LAMPUNG TIMUR, LAMPUNG",12,117,24,141
https://kawalpemilu.org#24303,"JEPARA, WAY JEPARA, LAMPUNG TIMUR, LAMPUNG",13,107,25,132
https://kawalpemilu.org#24303,"JEPARA, WAY JEPARA, LAMPUNG TIMUR, LAMPUNG",14,95,19,114
https://kawalpemilu.org#24303,"JEPARA, WAY JEPARA, LAMPUNG TIMUR, LAMPUNG",15,137,18,155
https://kawalpemilu.org#24303,"JEPARA, WAY JEPARA, LAMPUNG TIMUR, LAMPUNG",16,154,24,178
https://kawalpemilu.org#24303,"JEPARA, WAY JEPARA, LAMPUNG TIMUR, LAMPUNG",17,144,29,173
https://kawalpemilu.org#24303,"JEPARA, WAY JEPARA, LAMPUNG TIMUR, LAMPUNG",18,141,11,152
https://kawalpemilu.org#24304,"SRI REJOSARI, WAY JEPARA, LAMPUNG TIMUR, LAMPUNG",1,162,55,217
https://kawalpemilu.org#24304,"SRI REJOSARI, WAY JEPARA, LAMPUNG TIMUR, LAMPUNG",2,147,27,174
https://kawalpemilu.org#24304,"SRI REJOSARI, WAY JEPARA, LAMPUNG TIMUR, LAMPUNG",3,112,57,169
https://kawalpemilu.org#24304,"SRI REJOSARI, WAY JEPARA, LAMPUNG TIMUR, LAMPUNG",4,123,33,156
https://kawalpemilu.org#24304,"SRI REJOSARI, WAY JEPARA, LAMPUNG TIMUR, LAMPUNG",5,142,30,172
https://kawalpemilu.org#24304,"SRI REJOSARI, WAY JEPARA, LAMPUNG TIMUR, LAMPUNG",6,142,35,177
https://kawalpemilu.org#24304,"SRI REJOSARI, WAY JEPARA, LAMPUNG TIMUR, LAMPUNG",7,149,40,189
https://kawalpemilu.org#24304,"SRI REJOSARI, WAY JEPARA, LAMPUNG TIMUR, LAMPUNG",8,127,49,176
https://kawalpemilu.org#24304,"SRI REJOSARI, WAY JEPARA, LAMPUNG TIMUR, LAMPUNG",9,166,8,174
https://kawalpemilu.org#24305,"SUMBER REJO, WAY JEPARA, LAMPUNG TIMUR, LAMPUNG",1,116,87,203
https://kawalpemilu.org#24305,"SUMBER REJO, WAY JEPARA, LAMPUNG TIMUR, LAMPUNG",2,120,38,158
https://kawalpemilu.org#24305,"SUMBER REJO, WAY JEPARA, LAMPUNG TIMUR, LAMPUNG",3,128,46,174
https://kawalpemilu.org#24305,"SUMBER REJO, WAY JEPARA, LAMPUNG TIMUR, LAMPUNG",4,141,53,194
https://kawalpemilu.org#24305,"SUMBER REJO, WAY JEPARA, LAMPUNG TIMUR, LAMPUNG",5,143,37,180
https://kawalpemilu.org#24305,"SUMBER REJO, WAY JEPARA, LAMPUNG TIMUR, LAMPUNG",6,140,27,167
https://kawalpemilu.org#24305,"SUMBER REJO, WAY JEPARA, LAMPUNG TIMUR, LAMPUNG",7,136,26,162
https://kawalpemilu.org#24305,"SUMBER REJO, WAY JEPARA, LAMPUNG TIMUR, LAMPUNG",8,155,21,176
https://kawalpemilu.org#24305,"SUMBER REJO, WAY JEPARA, LAMPUNG TIMUR, LAMPUNG",9,122,40,162
https://kawalpemilu.org#24305,"SUMBER REJO, WAY JEPARA, LAMPUNG TIMUR, LAMPUNG",10,97,59,156
https://kawalpemilu.org#24305,"SUMBER REJO, WAY JEPARA, LAMPUNG TIMUR, LAMPUNG",11,110,49,159
https://kawalpemilu.org#24305,"SUMBER REJO, WAY JEPARA, LAMPUNG TIMUR, LAMPUNG",12,101,56,157
https://kawalpemilu.org#24305,"SUMBER REJO, WAY JEPARA, LAMPUNG TIMUR, LAMPUNG",13,121,47,168
https://kawalpemilu.org#24305,"SUMBER REJO, WAY JEPARA, LAMPUNG TIMUR, LAMPUNG",14,118,30,148
https://kawalpemilu.org#24305,"SUMBER REJO, WAY JEPARA, LAMPUNG TIMUR, LAMPUNG",15,158,26,184
https://kawalpemilu.org#24306,"LABUHAN RATU II, WAY JEPARA, LAMPUNG TIMUR, LAMPUNG",1,99,101,200
https://kawalpemilu.org#24306,"LABUHAN RATU II, WAY JEPARA, LAMPUNG TIMUR, LAMPUNG",2,65,71,136
https://kawalpemilu.org#24306,"LABUHAN RATU II, WAY JEPARA, LAMPUNG TIMUR, LAMPUNG",3,91,69,160
https://kawalpemilu.org#24306,"LABUHAN RATU II, WAY JEPARA, LAMPUNG TIMUR, LAMPUNG",4,85,119,204
https://kawalpemilu.org#24306,"LABUHAN RATU II, WAY JEPARA, LAMPUNG TIMUR, LAMPUNG",5,110,83,193
https://kawalpemilu.org#24306,"LABUHAN RATU II, WAY JEPARA, LAMPUNG TIMUR, LAMPUNG",6,76,72,148
https://kawalpemilu.org#24306,"LABUHAN RATU II, WAY JEPARA, LAMPUNG TIMUR, LAMPUNG",7,98,46,144
https://kawalpemilu.org#24306,"LABUHAN RATU II, WAY JEPARA, LAMPUNG TIMUR, LAMPUNG",8,82,57,139
https://kawalpemilu.org#24306,"LABUHAN RATU II, WAY JEPARA, LAMPUNG TIMUR, LAMPUNG",9,124,66,190
https://kawalpemilu.org#24306,"LABUHAN RATU II, WAY JEPARA, LAMPUNG TIMUR, LAMPUNG",10,98,44,142
https://kawalpemilu.org#24306,"LABUHAN RATU II, WAY JEPARA, LAMPUNG TIMUR, LAMPUNG",11,73,57,130
https://kawalpemilu.org#24306,"LABUHAN RATU II, WAY JEPARA, LAMPUNG TIMUR, LAMPUNG",12,96,55,151
https://kawalpemilu.org#24306,"LABUHAN RATU II, WAY JEPARA, LAMPUNG TIMUR, LAMPUNG",13,95,79,174
https://kawalpemilu.org#24306,"LABUHAN RATU II, WAY JEPARA, LAMPUNG TIMUR, LAMPUNG",14,78,30,108
https://kawalpemilu.org#24306,"LABUHAN RATU II, WAY JEPARA, LAMPUNG TIMUR, LAMPUNG",15,91,27,118
https://kawalpemilu.org#24307,"BRAJA ASRI, WAY JEPARA, LAMPUNG TIMUR, LAMPUNG",1,49,95,144
https://kawalpemilu.org#24307,"BRAJA ASRI, WAY JEPARA, LAMPUNG TIMUR, LAMPUNG",2,84,137,221
https://kawalpemilu.org#24307,"BRAJA ASRI, WAY JEPARA, LAMPUNG TIMUR, LAMPUNG",3,105,97,202
https://kawalpemilu.org#24307,"BRAJA ASRI, WAY JEPARA, LAMPUNG TIMUR, LAMPUNG",4,76,80,156
https://kawalpemilu.org#24307,"BRAJA ASRI, WAY JEPARA, LAMPUNG TIMUR, LAMPUNG",5,123,96,219
https://kawalpemilu.org#24307,"BRAJA ASRI, WAY JEPARA, LAMPUNG TIMUR, LAMPUNG",6,80,104,184
https://kawalpemilu.org#24307,"BRAJA ASRI, WAY JEPARA, LAMPUNG TIMUR, LAMPUNG",7,98,88,186
https://kawalpemilu.org#24307,"BRAJA ASRI, WAY JEPARA, LAMPUNG TIMUR, LAMPUNG",8,141,58,199
https://kawalpemilu.org#24307,"BRAJA ASRI, WAY JEPARA, LAMPUNG TIMUR, LAMPUNG",9,136,70,206
https://kawalpemilu.org#24307,"BRAJA ASRI, WAY JEPARA, LAMPUNG TIMUR, LAMPUNG",10,98,68,166
https://kawalpemilu.org#24307,"BRAJA ASRI, WAY JEPARA, LAMPUNG TIMUR, LAMPUNG",11,92,82,174
https://kawalpemilu.org#24307,"BRAJA ASRI, WAY JEPARA, LAMPUNG TIMUR, LAMPUNG",12,96,57,153
https://kawalpemilu.org#24307,"BRAJA ASRI, WAY JEPARA, LAMPUNG TIMUR, LAMPUNG",13,105,69,174
https://kawalpemilu.org#24307,"BRAJA ASRI, WAY JEPARA, LAMPUNG TIMUR, LAMPUNG",14,108,61,169
https://kawalpemilu.org#24307,"BRAJA ASRI, WAY JEPARA, LAMPUNG TIMUR, LAMPUNG",15,119,60,179
https://kawalpemilu.org#24308,"LABUHAN RATU I, WAY JEPARA, LAMPUNG TIMUR, LAMPUNG",1,134,55,189
https://kawalpemilu.org#24308,"LABUHAN RATU I, WAY JEPARA, LAMPUNG TIMUR, LAMPUNG",2,136,44,180
https://kawalpemilu.org#24308,"LABUHAN RATU I, WAY JEPARA, LAMPUNG TIMUR, LAMPUNG",3,99,92,191
https://kawalpemilu.org#24308,"LABUHAN RATU I, WAY JEPARA, LAMPUNG TIMUR, LAMPUNG",4,119,80,199
https://kawalpemilu.org#24308,"LABUHAN RATU I, WAY JEPARA, LAMPUNG TIMUR, LAMPUNG",5,104,70,174
https://kawalpemilu.org#24308,"LABUHAN RATU I, WAY JEPARA, LAMPUNG TIMUR, LAMPUNG",6,114,48,162
https://kawalpemilu.org#24308,"LABUHAN RATU I, WAY JEPARA, LAMPUNG TIMUR, LAMPUNG",7,112,42,154
https://kawalpemilu.org#24308,"LABUHAN RATU I, WAY JEPARA, LAMPUNG TIMUR, LAMPUNG",8,103,45,148
https://kawalpemilu.org#24308,"LABUHAN RATU I, WAY JEPARA, LAMPUNG TIMUR, LAMPUNG",9,116,82,198
https://kawalpemilu.org#24308,"LABUHAN RATU I, WAY JEPARA, LAMPUNG TIMUR, LAMPUNG",10,119,81,200
https://kawalpemilu.org#24308,"LABUHAN RATU I, WAY JEPARA, LAMPUNG TIMUR, LAMPUNG",11,91,64,155
https://kawalpemilu.org#24308,"LABUHAN RATU I, WAY JEPARA, LAMPUNG TIMUR, LAMPUNG",12,92,78,170
https://kawalpemilu.org#24308,"LABUHAN RATU I, WAY JEPARA, LAMPUNG TIMUR, LAMPUNG",13,50,101,151
https://kawalpemilu.org#24308,"LABUHAN RATU I, WAY JEPARA, LAMPUNG TIMUR, LAMPUNG",14,34,115,149
https://kawalpemilu.org#24308,"LABUHAN RATU I, WAY JEPARA, LAMPUNG TIMUR, LAMPUNG",15,29,61,90
https://kawalpemilu.org#24308,"LABUHAN RATU I, WAY JEPARA, LAMPUNG TIMUR, LAMPUNG",16,67,113,180
https://kawalpemilu.org#24308,"LABUHAN RATU I, WAY JEPARA, LAMPUNG TIMUR, LAMPUNG",17,96,63,159
https://kawalpemilu.org#24308,"LABUHAN RATU I, WAY JEPARA, LAMPUNG TIMUR, LAMPUNG",18,91,90,181
https://kawalpemilu.org#24308,"LABUHAN RATU I, WAY JEPARA, LAMPUNG TIMUR, LAMPUNG",19,75,67,142
https://kawalpemilu.org#24308,"LABUHAN RATU I, WAY JEPARA, LAMPUNG TIMUR, LAMPUNG",20,57,66,123
https://kawalpemilu.org#24308,"LABUHAN RATU I, WAY JEPARA, LAMPUNG TIMUR, LAMPUNG",21,138,42,180
https://kawalpemilu.org#24308,"LABUHAN RATU I, WAY JEPARA, LAMPUNG TIMUR, LAMPUNG",22,166,34,200
https://kawalpemilu.org#24308,"LABUHAN RATU I, WAY JEPARA, LAMPUNG TIMUR, LAMPUNG",23,101,21,122
https://kawalpemilu.org#24309,"SUMUR BANDUNG, WAY JEPARA, LAMPUNG TIMUR, LAMPUNG",1,157,55,212
https://kawalpemilu.org#24309,"SUMUR BANDUNG, WAY JEPARA, LAMPUNG TIMUR, LAMPUNG",2,152,24,176
https://kawalpemilu.org#24309,"SUMUR BANDUNG, WAY JEPARA, LAMPUNG TIMUR, LAMPUNG",3,71,103,174
https://kawalpemilu.org#24309,"SUMUR BANDUNG, WAY JEPARA, LAMPUNG TIMUR, LAMPUNG",4,54,62,116
https://kawalpemilu.org#24309,"SUMUR BANDUNG, WAY JEPARA, LAMPUNG TIMUR, LAMPUNG",5,67,33,100
https://kawalpemilu.org#24309,"SUMUR BANDUNG, WAY JEPARA, LAMPUNG TIMUR, LAMPUNG",6,100,20,120
https://kawalpemilu.org#24309,"SUMUR BANDUNG, WAY JEPARA, LAMPUNG TIMUR, LAMPUNG",7,121,76,197
https://kawalpemilu.org#24309,"SUMUR BANDUNG, WAY JEPARA, LAMPUNG TIMUR, LAMPUNG",8,134,21,155
https://kawalpemilu.org#24309,"SUMUR BANDUNG, WAY JEPARA, LAMPUNG TIMUR, LAMPUNG",9,117,27,144
https://kawalpemilu.org#24309,"SUMUR BANDUNG, WAY JEPARA, LAMPUNG TIMUR, LAMPUNG",10,143,24,167
https://kawalpemilu.org#24310,"SUMBER MARGA, WAY JEPARA, LAMPUNG TIMUR, LAMPUNG",1,82,37,119
https://kawalpemilu.org#24310,"SUMBER MARGA, WAY JEPARA, LAMPUNG TIMUR, LAMPUNG",2,87,32,119
https://kawalpemilu.org#24310,"SUMBER MARGA, WAY JEPARA, LAMPUNG TIMUR, LAMPUNG",3,135,27,162
https://kawalpemilu.org#24310,"SUMBER MARGA, WAY JEPARA, LAMPUNG TIMUR, LAMPUNG",4,134,50,184
https://kawalpemilu.org#24310,"SUMBER MARGA, WAY JEPARA, LAMPUNG TIMUR, LAMPUNG",5,136,33,169
https://kawalpemilu.org#24310,"SUMBER MARGA, WAY JEPARA, LAMPUNG TIMUR, LAMPUNG",6,100,14,114
https://kawalpemilu.org#24311,"LABUHAN RATU DANAU, WAY JEPARA, LAMPUNG TIMUR, LAMPUNG",1,152,59,211
https://kawalpemilu.org#24311,"LABUHAN RATU DANAU, WAY JEPARA, LAMPUNG TIMUR, LAMPUNG",2,141,11,152
https://kawalpemilu.org#24311,"LABUHAN RATU DANAU, WAY JEPARA, LAMPUNG TIMUR, LAMPUNG",3,188,23,211
https://kawalpemilu.org#24311,"LABUHAN RATU DANAU, WAY JEPARA, LAMPUNG TIMUR, LAMPUNG",4,148,32,180
https://kawalpemilu.org#88041,"LABUHAN RATU BARU, WAY JEPARA, LAMPUNG TIMUR, LAMPUNG",1,163,62,225
https://kawalpemilu.org#88041,"LABUHAN RATU BARU, WAY JEPARA, LAMPUNG TIMUR, LAMPUNG",2,161,51,212
https://kawalpemilu.org#88041,"LABUHAN RATU BARU, WAY JEPARA, LAMPUNG TIMUR, LAMPUNG",3,90,55,145
https://kawalpemilu.org#88041,"LABUHAN RATU BARU, WAY JEPARA, LAMPUNG TIMUR, LAMPUNG",5,84,81,165
https://kawalpemilu.org#88041,"LABUHAN RATU BARU, WAY JEPARA, LAMPUNG TIMUR, LAMPUNG",6,73,46,119
https://kawalpemilu.org#88041,"LABUHAN RATU BARU, WAY JEPARA, LAMPUNG TIMUR, LAMPUNG",7,88,49,137
https://kawalpemilu.org#88041,"LABUHAN RATU BARU, WAY JEPARA, LAMPUNG TIMUR, LAMPUNG",8,94,21,115
https://kawalpemilu.org#88041,"LABUHAN RATU BARU, WAY JEPARA, LAMPUNG TIMUR, LAMPUNG",9,94,51,145
https://kawalpemilu.org#88041,"LABUHAN RATU BARU, WAY JEPARA, LAMPUNG TIMUR, LAMPUNG",10,87,31,118
https://kawalpemilu.org#88041,"LABUHAN RATU BARU, WAY JEPARA, LAMPUNG TIMUR, LAMPUNG",11,78,44,122
https://kawalpemilu.org#88041,"LABUHAN RATU BARU, WAY JEPARA, LAMPUNG TIMUR, LAMPUNG",12,145,27,172
https://kawalpemilu.org#24313,"TAMAN FAJAR, PURBOLINGGO, LAMPUNG TIMUR, LAMPUNG",1,100,111,211
https://kawalpemilu.org#24313,"TAMAN FAJAR, PURBOLINGGO, LAMPUNG TIMUR, LAMPUNG",2,137,76,213
https://kawalpemilu.org#24313,"TAMAN FAJAR, PURBOLINGGO, LAMPUNG TIMUR, LAMPUNG",3,115,86,201
https://kawalpemilu.org#24313,"TAMAN FAJAR, PURBOLINGGO, LAMPUNG TIMUR, LAMPUNG",4,117,90,207
https://kawalpemilu.org#24313,"TAMAN FAJAR, PURBOLINGGO, LAMPUNG TIMUR, LAMPUNG",5,142,81,223
https://kawalpemilu.org#24313,"TAMAN FAJAR, PURBOLINGGO, LAMPUNG TIMUR, LAMPUNG",6,161,70,231
https://kawalpemilu.org#24313,"TAMAN FAJAR, PURBOLINGGO, LAMPUNG TIMUR, LAMPUNG",7,97,56,153
https://kawalpemilu.org#24313,"TAMAN FAJAR, PURBOLINGGO, LAMPUNG TIMUR, LAMPUNG",8,116,115,231
https://kawalpemilu.org#24313,"TAMAN FAJAR, PURBOLINGGO, LAMPUNG TIMUR, LAMPUNG",9,164,18,182
https://kawalpemilu.org#24313,"TAMAN FAJAR, PURBOLINGGO, LAMPUNG TIMUR, LAMPUNG",10,152,11,163
https://kawalpemilu.org#24313,"TAMAN FAJAR, PURBOLINGGO, LAMPUNG TIMUR, LAMPUNG",11,131,22,153
https://kawalpemilu.org#24313,"TAMAN FAJAR, PURBOLINGGO, LAMPUNG TIMUR, LAMPUNG",12,131,30,161
https://kawalpemilu.org#24314,"TAMAN ASRI, PURBOLINGGO, LAMPUNG TIMUR, LAMPUNG",1,119,59,178
https://kawalpemilu.org#24314,"TAMAN ASRI, PURBOLINGGO, LAMPUNG TIMUR, LAMPUNG",2,97,61,158
https://kawalpemilu.org#24314,"TAMAN ASRI, PURBOLINGGO, LAMPUNG TIMUR, LAMPUNG",3,105,53,158
https://kawalpemilu.org#24314,"TAMAN ASRI, PURBOLINGGO, LAMPUNG TIMUR, LAMPUNG",4,141,60,201
https://kawalpemilu.org#24314,"TAMAN ASRI, PURBOLINGGO, LAMPUNG TIMUR, LAMPUNG",5,134,58,192
https://kawalpemilu.org#24314,"TAMAN ASRI, PURBOLINGGO, LAMPUNG TIMUR, LAMPUNG",6,92,72,164
https://kawalpemilu.org#24314,"TAMAN ASRI, PURBOLINGGO, LAMPUNG TIMUR, LAMPUNG",7,118,52,170
https://kawalpemilu.org#24314,"TAMAN ASRI, PURBOLINGGO, LAMPUNG TIMUR, LAMPUNG",8,139,47,186
https://kawalpemilu.org#24314,"TAMAN ASRI, PURBOLINGGO, LAMPUNG TIMUR, LAMPUNG",9,128,55,183
https://kawalpemilu.org#24314,"TAMAN ASRI, PURBOLINGGO, LAMPUNG TIMUR, LAMPUNG",10,101,63,164
https://kawalpemilu.org#24314,"TAMAN ASRI, PURBOLINGGO, LAMPUNG TIMUR, LAMPUNG",11,62,86,148
https://kawalpemilu.org#24314,"TAMAN ASRI, PURBOLINGGO, LAMPUNG TIMUR, LAMPUNG",12,88,70,158
https://kawalpemilu.org#24314,"TAMAN ASRI, PURBOLINGGO, LAMPUNG TIMUR, LAMPUNG",13,95,73,168
https://kawalpemilu.org#24315,"TAMAN BOGO, PURBOLINGGO, LAMPUNG TIMUR, LAMPUNG",1,169,55,224
https://kawalpemilu.org#24315,"TAMAN BOGO, PURBOLINGGO, LAMPUNG TIMUR, LAMPUNG",2,153,66,219
https://kawalpemilu.org#24315,"TAMAN BOGO, PURBOLINGGO, LAMPUNG TIMUR, LAMPUNG",3,95,109,204
https://kawalpemilu.org#24315,"TAMAN BOGO, PURBOLINGGO, LAMPUNG TIMUR, LAMPUNG",4,123,83,206
https://kawalpemilu.org#24315,"TAMAN BOGO, PURBOLINGGO, LAMPUNG TIMUR, LAMPUNG",5,108,99,207
https://kawalpemilu.org#24315,"TAMAN BOGO, PURBOLINGGO, LAMPUNG TIMUR, LAMPUNG",6,98,99,197
https://kawalpemilu.org#24315,"TAMAN BOGO, PURBOLINGGO, LAMPUNG TIMUR, LAMPUNG",7,91,73,164
https://kawalpemilu.org#24315,"TAMAN BOGO, PURBOLINGGO, LAMPUNG TIMUR, LAMPUNG",8,98,79,177
https://kawalpemilu.org#24315,"TAMAN BOGO, PURBOLINGGO, LAMPUNG TIMUR, LAMPUNG",9,124,113,237
https://kawalpemilu.org#24315,"TAMAN BOGO, PURBOLINGGO, LAMPUNG TIMUR, LAMPUNG",10,118,100,218
https://kawalpemilu.org#24315,"TAMAN BOGO, PURBOLINGGO, LAMPUNG TIMUR, LAMPUNG",11,94,52,146
https://kawalpemilu.org#24315,"TAMAN BOGO, PURBOLINGGO, LAMPUNG TIMUR, LAMPUNG",12,134,64,198
https://kawalpemilu.org#24315,"TAMAN BOGO, PURBOLINGGO, LAMPUNG TIMUR, LAMPUNG",13,126,51,177
https://kawalpemilu.org#24315,"TAMAN BOGO, PURBOLINGGO, LAMPUNG TIMUR, LAMPUNG",14,166,52,218
https://kawalpemilu.org#24316,"TAMBAH DADI, PURBOLINGGO, LAMPUNG TIMUR, LAMPUNG",1,115,78,193
https://kawalpemilu.org#24316,"TAMBAH DADI, PURBOLINGGO, LAMPUNG TIMUR, LAMPUNG",2,108,52,160
https://kawalpemilu.org#24316,"TAMBAH DADI, PURBOLINGGO, LAMPUNG TIMUR, LAMPUNG",3,119,52,171
https://kawalpemilu.org#24316,"TAMBAH DADI, PURBOLINGGO, LAMPUNG TIMUR, LAMPUNG",4,78,69,147
https://kawalpemilu.org#24316,"TAMBAH DADI, PURBOLINGGO, LAMPUNG TIMUR, LAMPUNG",5,65,93,158
https://kawalpemilu.org#24316,"TAMBAH DADI, PURBOLINGGO, LAMPUNG TIMUR, LAMPUNG",6,116,77,193
https://kawalpemilu.org#24316,"TAMBAH DADI, PURBOLINGGO, LAMPUNG TIMUR, LAMPUNG",7,128,70,198
https://kawalpemilu.org#24316,"TAMBAH DADI, PURBOLINGGO, LAMPUNG TIMUR, LAMPUNG",8,155,56,211
https://kawalpemilu.org#24316,"TAMBAH DADI, PURBOLINGGO, LAMPUNG TIMUR, LAMPUNG",9,168,24,192
https://kawalpemilu.org#24316,"TAMBAH DADI, PURBOLINGGO, LAMPUNG TIMUR, LAMPUNG",10,120,47,167
https://kawalpemilu.org#24316,"TAMBAH DADI, PURBOLINGGO, LAMPUNG TIMUR, LAMPUNG",11,159,60,219
https://kawalpemilu.org#24316,"TAMBAH DADI, PURBOLINGGO, LAMPUNG TIMUR, LAMPUNG",12,152,17,169
https://kawalpemilu.org#24317,"TAMAN CARI, PURBOLINGGO, LAMPUNG TIMUR, LAMPUNG",1,93,81,174
https://kawalpemilu.org#24317,"TAMAN CARI, PURBOLINGGO, LAMPUNG TIMUR, LAMPUNG",2,96,68,164
https://kawalpemilu.org#24317,"TAMAN CARI, PURBOLINGGO, LAMPUNG TIMUR, LAMPUNG",3,135,61,196
https://kawalpemilu.org#24317,"TAMAN CARI, PURBOLINGGO, LAMPUNG TIMUR, LAMPUNG",4,110,119,229
https://kawalpemilu.org#24317,"TAMAN CARI, PURBOLINGGO, LAMPUNG TIMUR, LAMPUNG",5,119,97,216
https://kawalpemilu.org#24317,"TAMAN CARI, PURBOLINGGO, LAMPUNG TIMUR, LAMPUNG",6,101,72,173
https://kawalpemilu.org#24317,"TAMAN CARI, PURBOLINGGO, LAMPUNG TIMUR, LAMPUNG",7,56,120,176
https://kawalpemilu.org#24317,"TAMAN CARI, PURBOLINGGO, LAMPUNG TIMUR, LAMPUNG",8,72,129,201
https://kawalpemilu.org#24317,"TAMAN CARI, PURBOLINGGO, LAMPUNG TIMUR, LAMPUNG",9,129,67,196
https://kawalpemilu.org#24317,"TAMAN CARI, PURBOLINGGO, LAMPUNG TIMUR, LAMPUNG",10,140,93,233
https://kawalpemilu.org#24317,"TAMAN CARI, PURBOLINGGO, LAMPUNG TIMUR, LAMPUNG",11,138,82,220
https://kawalpemilu.org#24317,"TAMAN CARI, PURBOLINGGO, LAMPUNG TIMUR, LAMPUNG",12,140,86,226
https://kawalpemilu.org#24317,"TAMAN CARI, PURBOLINGGO, LAMPUNG TIMUR, LAMPUNG",13,131,106,237
https://kawalpemilu.org#24318,"TAMAN ENDAH, PURBOLINGGO, LAMPUNG TIMUR, LAMPUNG",1,153,78,231
https://kawalpemilu.org#24318,"TAMAN ENDAH, PURBOLINGGO, LAMPUNG TIMUR, LAMPUNG",2,125,103,228
https://kawalpemilu.org#24318,"TAMAN ENDAH, PURBOLINGGO, LAMPUNG TIMUR, LAMPUNG",3,127,86,213
https://kawalpemilu.org#24318,"TAMAN ENDAH, PURBOLINGGO, LAMPUNG TIMUR, LAMPUNG",4,130,75,205
https://kawalpemilu.org#24318,"TAMAN ENDAH, PURBOLINGGO, LAMPUNG TIMUR, LAMPUNG",5,97,110,207
https://kawalpemilu.org#24318,"TAMAN ENDAH, PURBOLINGGO, LAMPUNG TIMUR, LAMPUNG",6,94,80,174
https://kawalpemilu.org#24318,"TAMAN ENDAH, PURBOLINGGO, LAMPUNG TIMUR, LAMPUNG",7,99,55,154
https://kawalpemilu.org#24318,"TAMAN ENDAH, PURBOLINGGO, LAMPUNG TIMUR, LAMPUNG",8,105,73,178
https://kawalpemilu.org#24318,"TAMAN ENDAH, PURBOLINGGO, LAMPUNG TIMUR, LAMPUNG",10,131,23,154
https://kawalpemilu.org#24319,"TEGAL GONDO, PURBOLINGGO, LAMPUNG TIMUR, LAMPUNG",1,94,112,206
https://kawalpemilu.org#24319,"TEGAL GONDO, PURBOLINGGO, LAMPUNG TIMUR, LAMPUNG",2,130,72,202
https://kawalpemilu.org#24319,"TEGAL GONDO, PURBOLINGGO, LAMPUNG TIMUR, LAMPUNG",3,133,70,203
https://kawalpemilu.org#24319,"TEGAL GONDO, PURBOLINGGO, LAMPUNG TIMUR, LAMPUNG",4,119,81,200
https://kawalpemilu.org#24319,"TEGAL GONDO, PURBOLINGGO, LAMPUNG TIMUR, LAMPUNG",5,175,48,223
https://kawalpemilu.org#24319,"TEGAL GONDO, PURBOLINGGO, LAMPUNG TIMUR, LAMPUNG",6,162,81,243
https://kawalpemilu.org#24320,"TOTO HARJO, PURBOLINGGO, LAMPUNG TIMUR, LAMPUNG",1,146,51,197
https://kawalpemilu.org#24320,"TOTO HARJO, PURBOLINGGO, LAMPUNG TIMUR, LAMPUNG",2,132,56,188
https://kawalpemilu.org#24320,"TOTO HARJO, PURBOLINGGO, LAMPUNG TIMUR, LAMPUNG",3,119,64,183
https://kawalpemilu.org#24320,"TOTO HARJO, PURBOLINGGO, LAMPUNG TIMUR, LAMPUNG",4,113,87,200
https://kawalpemilu.org#24320,"TOTO HARJO, PURBOLINGGO, LAMPUNG TIMUR, LAMPUNG",5,75,90,165
https://kawalpemilu.org#24320,"TOTO HARJO, PURBOLINGGO, LAMPUNG TIMUR, LAMPUNG",6,90,86,176
https://kawalpemilu.org#24320,"TOTO HARJO, PURBOLINGGO, LAMPUNG TIMUR, LAMPUNG",7,169,57,226
https://kawalpemilu.org#24320,"TOTO HARJO, PURBOLINGGO, LAMPUNG TIMUR, LAMPUNG",8,133,64,197
https://kawalpemilu.org#24320,"TOTO HARJO, PURBOLINGGO, LAMPUNG TIMUR, LAMPUNG",9,90,64,154
https://kawalpemilu.org#24320,"TOTO HARJO, PURBOLINGGO, LAMPUNG TIMUR, LAMPUNG",10,106,51,157
https://kawalpemilu.org#24320,"TOTO HARJO, PURBOLINGGO, LAMPUNG TIMUR, LAMPUNG",11,112,45,157
https://kawalpemilu.org#24320,"TOTO HARJO, PURBOLINGGO, LAMPUNG TIMUR, LAMPUNG",12,91,55,146
https://kawalpemilu.org#24320,"TOTO HARJO, PURBOLINGGO, LAMPUNG TIMUR, LAMPUNG",13,63,92,155
https://kawalpemilu.org#24320,"TOTO HARJO, PURBOLINGGO, LAMPUNG TIMUR, LAMPUNG",14,86,75,161
https://kawalpemilu.org#24321,"TANJUNG INTEN, PURBOLINGGO, LAMPUNG TIMUR, LAMPUNG",1,102,60,162
https://kawalpemilu.org#24321,"TANJUNG INTEN, PURBOLINGGO, LAMPUNG TIMUR, LAMPUNG",2,84,95,179
https://kawalpemilu.org#24321,"TANJUNG INTEN, PURBOLINGGO, LAMPUNG TIMUR, LAMPUNG",4,0,0,0
https://kawalpemilu.org#24321,"TANJUNG INTEN, PURBOLINGGO, LAMPUNG TIMUR, LAMPUNG",5,85,93,178
https://kawalpemilu.org#24321,"TANJUNG INTEN, PURBOLINGGO, LAMPUNG TIMUR, LAMPUNG",8,114,104,218
https://kawalpemilu.org#24321,"TANJUNG INTEN, PURBOLINGGO, LAMPUNG TIMUR, LAMPUNG",13,98,69,167
https://kawalpemilu.org#24321,"TANJUNG INTEN, PURBOLINGGO, LAMPUNG TIMUR, LAMPUNG",14,119,84,203
https://kawalpemilu.org#24321,"TANJUNG INTEN, PURBOLINGGO, LAMPUNG TIMUR, LAMPUNG",15,98,75,173
https://kawalpemilu.org#24321,"TANJUNG INTEN, PURBOLINGGO, LAMPUNG TIMUR, LAMPUNG",16,113,48,161
https://kawalpemilu.org#24322,"TEGAL YOSO, PURBOLINGGO, LAMPUNG TIMUR, LAMPUNG",1,78,106,184
https://kawalpemilu.org#24322,"TEGAL YOSO, PURBOLINGGO, LAMPUNG TIMUR, LAMPUNG",2,93,89,182
https://kawalpemilu.org#24322,"TEGAL YOSO, PURBOLINGGO, LAMPUNG TIMUR, LAMPUNG",3,127,67,194
https://kawalpemilu.org#24322,"TEGAL YOSO, PURBOLINGGO, LAMPUNG TIMUR, LAMPUNG",4,115,74,189
https://kawalpemilu.org#24322,"TEGAL YOSO, PURBOLINGGO, LAMPUNG TIMUR, LAMPUNG",5,82,64,146
https://kawalpemilu.org#24322,"TEGAL YOSO, PURBOLINGGO, LAMPUNG TIMUR, LAMPUNG",6,102,40,142
https://kawalpemilu.org#24322,"TEGAL YOSO, PURBOLINGGO, LAMPUNG TIMUR, LAMPUNG",7,135,25,160
https://kawalpemilu.org#24322,"TEGAL YOSO, PURBOLINGGO, LAMPUNG TIMUR, LAMPUNG",8,148,26,175
https://kawalpemilu.org#24322,"TEGAL YOSO, PURBOLINGGO, LAMPUNG TIMUR, LAMPUNG",9,132,35,167
https://kawalpemilu.org#24322,"TEGAL YOSO, PURBOLINGGO, LAMPUNG TIMUR, LAMPUNG",10,191,25,216
https://kawalpemilu.org#24322,"TEGAL YOSO, PURBOLINGGO, LAMPUNG TIMUR, LAMPUNG",11,195,25,220
https://kawalpemilu.org#24323,"TAMBAH LUHUR, PURBOLINGGO, LAMPUNG TIMUR, LAMPUNG",1,64,169,233
https://kawalpemilu.org#24323,"TAMBAH LUHUR, PURBOLINGGO, LAMPUNG TIMUR, LAMPUNG",2,120,96,216
https://kawalpemilu.org#24323,"TAMBAH LUHUR, PURBOLINGGO, LAMPUNG TIMUR, LAMPUNG",3,108,86,194
https://kawalpemilu.org#24323,"TAMBAH LUHUR, PURBOLINGGO, LAMPUNG TIMUR, LAMPUNG",4,102,96,198
https://kawalpemilu.org#24323,"TAMBAH LUHUR, PURBOLINGGO, LAMPUNG TIMUR, LAMPUNG",5,46,97,143
https://kawalpemilu.org#24323,"TAMBAH LUHUR, PURBOLINGGO, LAMPUNG TIMUR, LAMPUNG",6,65,93,158
https://kawalpemilu.org#24323,"TAMBAH LUHUR, PURBOLINGGO, LAMPUNG TIMUR, LAMPUNG",7,54,116,170
https://kawalpemilu.org#24324,"TANJUNG KESUMO, PURBOLINGGO, LAMPUNG TIMUR, LAMPUNG",1,91,50,141
https://kawalpemilu.org#24324,"TANJUNG KESUMO, PURBOLINGGO, LAMPUNG TIMUR, LAMPUNG",2,103,73,176
https://kawalpemilu.org#24324,"TANJUNG KESUMO, PURBOLINGGO, LAMPUNG TIMUR, LAMPUNG",3,131,60,191
https://kawalpemilu.org#24324,"TANJUNG KESUMO, PURBOLINGGO, LAMPUNG TIMUR, LAMPUNG",5,93,92,185
https://kawalpemilu.org#24324,"TANJUNG KESUMO, PURBOLINGGO, LAMPUNG TIMUR, LAMPUNG",6,154,62,216
https://kawalpemilu.org#24324,"TANJUNG KESUMO, PURBOLINGGO, LAMPUNG TIMUR, LAMPUNG",7,110,59,169
https://kawalpemilu.org#24324,"TANJUNG KESUMO, PURBOLINGGO, LAMPUNG TIMUR, LAMPUNG",8,108,88,196
https://kawalpemilu.org#24324,"TANJUNG KESUMO, PURBOLINGGO, LAMPUNG TIMUR, LAMPUNG",9,110,81,191
https://kawalpemilu.org#24324,"TANJUNG KESUMO, PURBOLINGGO, LAMPUNG TIMUR, LAMPUNG",10,125,88,213
https://kawalpemilu.org#24324,"TANJUNG KESUMO, PURBOLINGGO, LAMPUNG TIMUR, LAMPUNG",11,135,106,241
https://kawalpemilu.org#24324,"TANJUNG KESUMO, PURBOLINGGO, LAMPUNG TIMUR, LAMPUNG",12,116,55,177
https://kawalpemilu.org#24324,"TANJUNG KESUMO, PURBOLINGGO, LAMPUNG TIMUR, LAMPUNG",13,117,68,185
https://kawalpemilu.org#24326,"KOTA RAMAN, RAMAN UTARA, LAMPUNG TIMUR, LAMPUNG",1,159,80,239
https://kawalpemilu.org#24326,"KOTA RAMAN, RAMAN UTARA, LAMPUNG TIMUR, LAMPUNG",2,130,68,198
https://kawalpemilu.org#24326,"KOTA RAMAN, RAMAN UTARA, LAMPUNG TIMUR, LAMPUNG",3,76,73,149
https://kawalpemilu.org#24326,"KOTA RAMAN, RAMAN UTARA, LAMPUNG TIMUR, LAMPUNG",4,128,63,191
https://kawalpemilu.org#24326,"KOTA RAMAN, RAMAN UTARA, LAMPUNG TIMUR, LAMPUNG",5,77,57,134
https://kawalpemilu.org#24326,"KOTA RAMAN, RAMAN UTARA, LAMPUNG TIMUR, LAMPUNG",6,84,46,130
https://kawalpemilu.org#24326,"KOTA RAMAN, RAMAN UTARA, LAMPUNG TIMUR, LAMPUNG",7,88,82,170
https://kawalpemilu.org#24326,"KOTA RAMAN, RAMAN UTARA, LAMPUNG TIMUR, LAMPUNG",8,56,52,108
https://kawalpemilu.org#24327,"RAMAN AJI, RAMAN UTARA, LAMPUNG TIMUR, LAMPUNG",1,166,86,252
https://kawalpemilu.org#24327,"RAMAN AJI, RAMAN UTARA, LAMPUNG TIMUR, LAMPUNG",2,153,71,224
https://kawalpemilu.org#24327,"RAMAN AJI, RAMAN UTARA, LAMPUNG TIMUR, LAMPUNG",3,131,72,203
https://kawalpemilu.org#24327,"RAMAN AJI, RAMAN UTARA, LAMPUNG TIMUR, LAMPUNG",4,128,62,190
https://kawalpemilu.org#24327,"RAMAN AJI, RAMAN UTARA, LAMPUNG TIMUR, LAMPUNG",5,160,67,227
https://kawalpemilu.org#24327,"RAMAN AJI, RAMAN UTARA, LAMPUNG TIMUR, LAMPUNG",6,110,95,205
https://kawalpemilu.org#24327,"RAMAN AJI, RAMAN UTARA, LAMPUNG TIMUR, LAMPUNG",7,130,79,209
https://kawalpemilu.org#24327,"RAMAN AJI, RAMAN UTARA, LAMPUNG TIMUR, LAMPUNG",8,90,62,152
https://kawalpemilu.org#24327,"RAMAN AJI, RAMAN UTARA, LAMPUNG TIMUR, LAMPUNG",9,113,25,138
https://kawalpemilu.org#24327,"RAMAN AJI, RAMAN UTARA, LAMPUNG TIMUR, LAMPUNG",10,105,34,139
https://kawalpemilu.org#24327,"RAMAN AJI, RAMAN UTARA, LAMPUNG TIMUR, LAMPUNG",11,112,23,135
https://kawalpemilu.org#24327,"RAMAN AJI, RAMAN UTARA, LAMPUNG TIMUR, LAMPUNG",12,98,62,160
https://kawalpemilu.org#24327,"RAMAN AJI, RAMAN UTARA, LAMPUNG TIMUR, LAMPUNG",13,107,75,182
https://kawalpemilu.org#24327,"RAMAN AJI, RAMAN UTARA, LAMPUNG TIMUR, LAMPUNG",14,113,66,179
https://kawalpemilu.org#24327,"RAMAN AJI, RAMAN UTARA, LAMPUNG TIMUR, LAMPUNG",15,115,83,198
https://kawalpemilu.org#24327,"RAMAN AJI, RAMAN UTARA, LAMPUNG TIMUR, LAMPUNG",16,180,48,228
https://kawalpemilu.org#24327,"RAMAN AJI, RAMAN UTARA, LAMPUNG TIMUR, LAMPUNG",17,175,62,237
https://kawalpemilu.org#24327,"RAMAN AJI, RAMAN UTARA, LAMPUNG TIMUR, LAMPUNG",18,181,65,246
https://kawalpemilu.org#24327,"RAMAN AJI, RAMAN UTARA, LAMPUNG TIMUR, LAMPUNG",19,173,74,247
https://kawalpemilu.org#24328,"RUKTI SEDYO, RAMAN UTARA, LAMPUNG TIMUR, LAMPUNG",1,142,65,207
https://kawalpemilu.org#24328,"RUKTI SEDYO, RAMAN UTARA, LAMPUNG TIMUR, LAMPUNG",2,117,51,168
https://kawalpemilu.org#24328,"RUKTI SEDYO, RAMAN UTARA, LAMPUNG TIMUR, LAMPUNG",3,194,60,254
https://kawalpemilu.org#24328,"RUKTI SEDYO, RAMAN UTARA, LAMPUNG TIMUR, LAMPUNG",4,166,88,254
https://kawalpemilu.org#24328,"RUKTI SEDYO, RAMAN UTARA, LAMPUNG TIMUR, LAMPUNG",5,173,79,252
https://kawalpemilu.org#24328,"RUKTI SEDYO, RAMAN UTARA, LAMPUNG TIMUR, LAMPUNG",6,167,80,247
https://kawalpemilu.org#24328,"RUKTI SEDYO, RAMAN UTARA, LAMPUNG TIMUR, LAMPUNG",7,95,72,167
https://kawalpemilu.org#24328,"RUKTI SEDYO, RAMAN UTARA, LAMPUNG TIMUR, LAMPUNG",8,91,27,118
https://kawalpemilu.org#24328,"RUKTI SEDYO, RAMAN UTARA, LAMPUNG TIMUR, LAMPUNG",9,53,82,135
https://kawalpemilu.org#24328,"RUKTI SEDYO, RAMAN UTARA, LAMPUNG TIMUR, LAMPUNG",10,94,36,130
https://kawalpemilu.org#24329,"RATNA DAYA, RAMAN UTARA, LAMPUNG TIMUR, LAMPUNG",1,128,62,190
https://kawalpemilu.org#24329,"RATNA DAYA, RAMAN UTARA, LAMPUNG TIMUR, LAMPUNG",2,117,125,242
https://kawalpemilu.org#24329,"RATNA DAYA, RAMAN UTARA, LAMPUNG TIMUR, LAMPUNG",3,97,138,235
https://kawalpemilu.org#24329,"RATNA DAYA, RAMAN UTARA, LAMPUNG TIMUR, LAMPUNG",4,111,110,221
https://kawalpemilu.org#24329,"RATNA DAYA, RAMAN UTARA, LAMPUNG TIMUR, LAMPUNG",5,101,74,175
https://kawalpemilu.org#24329,"RATNA DAYA, RAMAN UTARA, LAMPUNG TIMUR, LAMPUNG",6,113,85,198
https://kawalpemilu.org#24329,"RATNA DAYA, RAMAN UTARA, LAMPUNG TIMUR, LAMPUNG",7,112,41,153
https://kawalpemilu.org#24329,"RATNA DAYA, RAMAN UTARA, LAMPUNG TIMUR, LAMPUNG",8,87,80,167
https://kawalpemilu.org#24329,"RATNA DAYA, RAMAN UTARA, LAMPUNG TIMUR, LAMPUNG",9,120,92,212
https://kawalpemilu.org#24329,"RATNA DAYA, RAMAN UTARA, LAMPUNG TIMUR, LAMPUNG",10,142,73,215
https://kawalpemilu.org#24329,"RATNA DAYA, RAMAN UTARA, LAMPUNG TIMUR, LAMPUNG",11,106,76,182
https://kawalpemilu.org#24329,"RATNA DAYA, RAMAN UTARA, LAMPUNG TIMUR, LAMPUNG",12,154,66,220
https://kawalpemilu.org#24330,"REJO BINANGUN, RAMAN UTARA, LAMPUNG TIMUR, LAMPUNG",1,132,81,213
https://kawalpemilu.org#24330,"REJO BINANGUN, RAMAN UTARA, LAMPUNG TIMUR, LAMPUNG",2,125,104,229
https://kawalpemilu.org#24330,"REJO BINANGUN, RAMAN UTARA, LAMPUNG TIMUR, LAMPUNG",3,146,85,231
https://kawalpemilu.org#24330,"REJO BINANGUN, RAMAN UTARA, LAMPUNG TIMUR, LAMPUNG",4,132,94,226
https://kawalpemilu.org#24330,"REJO BINANGUN, RAMAN UTARA, LAMPUNG TIMUR, LAMPUNG",5,148,56,204
https://kawalpemilu.org#24330,"REJO BINANGUN, RAMAN UTARA, LAMPUNG TIMUR, LAMPUNG",6,183,33,216
https://kawalpemilu.org#24330,"REJO BINANGUN, RAMAN UTARA, LAMPUNG TIMUR, LAMPUNG",7,163,35,198
https://kawalpemilu.org#24330,"REJO BINANGUN, RAMAN UTARA, LAMPUNG TIMUR, LAMPUNG",8,185,10,195
https://kawalpemilu.org#24330,"REJO BINANGUN, RAMAN UTARA, LAMPUNG TIMUR, LAMPUNG",9,143,35,178
https://kawalpemilu.org#24330,"REJO BINANGUN, RAMAN UTARA, LAMPUNG TIMUR, LAMPUNG",10,146,18,164
https://kawalpemilu.org#24330,"REJO BINANGUN, RAMAN UTARA, LAMPUNG TIMUR, LAMPUNG",11,176,17,193
https://kawalpemilu.org#24330,"REJO BINANGUN, RAMAN UTARA, LAMPUNG TIMUR, LAMPUNG",12,117,81,198
https://kawalpemilu.org#24330,"REJO BINANGUN, RAMAN UTARA, LAMPUNG TIMUR, LAMPUNG",13,179,39,218
https://kawalpemilu.org#24331,"RANTAU FAJAR, RAMAN UTARA, LAMPUNG TIMUR, LAMPUNG",1,126,17,143
https://kawalpemilu.org#24331,"RANTAU FAJAR, RAMAN UTARA, LAMPUNG TIMUR, LAMPUNG",2,110,23,133
https://kawalpemilu.org#24331,"RANTAU FAJAR, RAMAN UTARA, LAMPUNG TIMUR, LAMPUNG",3,126,35,161
https://kawalpemilu.org#24331,"RANTAU FAJAR, RAMAN UTARA, LAMPUNG TIMUR, LAMPUNG",4,117,64,181
https://kawalpemilu.org#24331,"RANTAU FAJAR, RAMAN UTARA, LAMPUNG TIMUR, LAMPUNG",5,117,27,144
https://kawalpemilu.org#24331,"RANTAU FAJAR, RAMAN UTARA, LAMPUNG TIMUR, LAMPUNG",6,151,43,194
https://kawalpemilu.org#24331,"RANTAU FAJAR, RAMAN UTARA, LAMPUNG TIMUR, LAMPUNG",7,163,37,200
https://kawalpemilu.org#24331,"RANTAU FAJAR, RAMAN UTARA, LAMPUNG TIMUR, LAMPUNG",8,95,17,112
https://kawalpemilu.org#24331,"RANTAU FAJAR, RAMAN UTARA, LAMPUNG TIMUR, LAMPUNG",9,130,41,171
https://kawalpemilu.org#24331,"RANTAU FAJAR, RAMAN UTARA, LAMPUNG TIMUR, LAMPUNG",10,112,108,220
https://kawalpemilu.org#24331,"RANTAU FAJAR, RAMAN UTARA, LAMPUNG TIMUR, LAMPUNG",11,182,46,228
https://kawalpemilu.org#24331,"RANTAU FAJAR, RAMAN UTARA, LAMPUNG TIMUR, LAMPUNG",12,177,62,239
https://kawalpemilu.org#24332,"RAMAN ENDRA, RAMAN UTARA, LAMPUNG TIMUR, LAMPUNG",1,112,92,204
https://kawalpemilu.org#24332,"RAMAN ENDRA, RAMAN UTARA, LAMPUNG TIMUR, LAMPUNG",2,127,43,170
https://kawalpemilu.org#24332,"RAMAN ENDRA, RAMAN UTARA, LAMPUNG TIMUR, LAMPUNG",3,89,90,179
https://kawalpemilu.org#24332,"RAMAN ENDRA, RAMAN UTARA, LAMPUNG TIMUR, LAMPUNG",4,167,64,231
https://kawalpemilu.org#24332,"RAMAN ENDRA, RAMAN UTARA, LAMPUNG TIMUR, LAMPUNG",5,125,96,121
https://kawalpemilu.org#24332,"RAMAN ENDRA, RAMAN UTARA, LAMPUNG TIMUR, LAMPUNG",6,110,53,163
https://kawalpemilu.org#24332,"RAMAN ENDRA, RAMAN UTARA, LAMPUNG TIMUR, LAMPUNG",7,127,28,155
https://kawalpemilu.org#24332,"RAMAN ENDRA, RAMAN UTARA, LAMPUNG TIMUR, LAMPUNG",8,128,55,183
https://kawalpemilu.org#24332,"RAMAN ENDRA, RAMAN UTARA, LAMPUNG TIMUR, LAMPUNG",9,130,68,198
https://kawalpemilu.org#24332,"RAMAN ENDRA, RAMAN UTARA, LAMPUNG TIMUR, LAMPUNG",10,153,57,210
https://kawalpemilu.org#24333,"RAMAN FAJAR, RAMAN UTARA, LAMPUNG TIMUR, LAMPUNG",1,146,16,162
https://kawalpemilu.org#24333,"RAMAN FAJAR, RAMAN UTARA, LAMPUNG TIMUR, LAMPUNG",2,146,32,178
https://kawalpemilu.org#24333,"RAMAN FAJAR, RAMAN UTARA, LAMPUNG TIMUR, LAMPUNG",3,154,29,183
https://kawalpemilu.org#24333,"RAMAN FAJAR, RAMAN UTARA, LAMPUNG TIMUR, LAMPUNG",4,158,39,197
https://kawalpemilu.org#24333,"RAMAN FAJAR, RAMAN UTARA, LAMPUNG TIMUR, LAMPUNG",5,162,33,195
https://kawalpemilu.org#24333,"RAMAN FAJAR, RAMAN UTARA, LAMPUNG TIMUR, LAMPUNG",6,178,25,203
https://kawalpemilu.org#24333,"RAMAN FAJAR, RAMAN UTARA, LAMPUNG TIMUR, LAMPUNG",7,147,63,210
https://kawalpemilu.org#24333,"RAMAN FAJAR, RAMAN UTARA, LAMPUNG TIMUR, LAMPUNG",8,114,118,232
https://kawalpemilu.org#24333,"RAMAN FAJAR, RAMAN UTARA, LAMPUNG TIMUR, LAMPUNG",9,140,74,214
https://kawalpemilu.org#24333,"RAMAN FAJAR, RAMAN UTARA, LAMPUNG TIMUR, LAMPUNG",10,137,60,197
https://kawalpemilu.org#24334,"RESTU RAHAYU, RAMAN UTARA, LAMPUNG TIMUR, LAMPUNG",1,147,13,160
https://kawalpemilu.org#24334,"RESTU RAHAYU, RAMAN UTARA, LAMPUNG TIMUR, LAMPUNG",2,130,12,142
https://kawalpemilu.org#24334,"RESTU RAHAYU, RAMAN UTARA, LAMPUNG TIMUR, LAMPUNG",3,149,10,159
https://kawalpemilu.org#24334,"RESTU RAHAYU, RAMAN UTARA, LAMPUNG TIMUR, LAMPUNG",4,114,22,136
https://kawalpemilu.org#24334,"RESTU RAHAYU, RAMAN UTARA, LAMPUNG TIMUR, LAMPUNG",5,167,20,187
https://kawalpemilu.org#24334,"RESTU RAHAYU, RAMAN UTARA, LAMPUNG TIMUR, LAMPUNG",6,193,11,204
https://kawalpemilu.org#24335,"REJO KATON, RAMAN UTARA, LAMPUNG TIMUR, LAMPUNG",1,108,74,182
https://kawalpemilu.org#24335,"REJO KATON, RAMAN UTARA, LAMPUNG TIMUR, LAMPUNG",2,159,45,204
https://kawalpemilu.org#24335,"REJO KATON, RAMAN UTARA, LAMPUNG TIMUR, LAMPUNG",3,133,63,196
https://kawalpemilu.org#24335,"REJO KATON, RAMAN UTARA, LAMPUNG TIMUR, LAMPUNG",4,142,45,187
https://kawalpemilu.org#24335,"REJO KATON, RAMAN UTARA, LAMPUNG TIMUR, LAMPUNG",5,113,74,187
https://kawalpemilu.org#24335,"REJO KATON, RAMAN UTARA, LAMPUNG TIMUR, LAMPUNG",6,140,53,193
https://kawalpemilu.org#24335,"REJO KATON, RAMAN UTARA, LAMPUNG TIMUR, LAMPUNG",7,146,59,205
https://kawalpemilu.org#24335,"REJO KATON, RAMAN UTARA, LAMPUNG TIMUR, LAMPUNG",8,135,55,190
https://kawalpemilu.org#24335,"REJO KATON, RAMAN UTARA, LAMPUNG TIMUR, LAMPUNG",9,109,35,144
https://kawalpemilu.org#24335,"REJO KATON, RAMAN UTARA, LAMPUNG TIMUR, LAMPUNG",10,71,66,137
https://kawalpemilu.org#24335,"REJO KATON, RAMAN UTARA, LAMPUNG TIMUR, LAMPUNG",11,159,58,217
https://kawalpemilu.org#24335,"REJO KATON, RAMAN UTARA, LAMPUNG TIMUR, LAMPUNG",12,171,63,234
https://kawalpemilu.org#24336,"RAMA PUJA, RAMAN UTARA, LAMPUNG TIMUR, LAMPUNG",1,151,19,170
https://kawalpemilu.org#24336,"RAMA PUJA, RAMAN UTARA, LAMPUNG TIMUR, LAMPUNG",2,148,16,164
https://kawalpemilu.org#24336,"RAMA PUJA, RAMAN UTARA, LAMPUNG TIMUR, LAMPUNG",3,162,18,180
https://kawalpemilu.org#24336,"RAMA PUJA, RAMAN UTARA, LAMPUNG TIMUR, LAMPUNG",4,161,30,191
https://kawalpemilu.org#24336,"RAMA PUJA, RAMAN UTARA, LAMPUNG TIMUR, LAMPUNG",5,166,37,203
https://kawalpemilu.org#24336,"RAMA PUJA, RAMAN UTARA, LAMPUNG TIMUR, LAMPUNG",6,188,15,203
https://kawalpemilu.org#24336,"RAMA PUJA, RAMAN UTARA, LAMPUNG TIMUR, LAMPUNG",7,135,48,183
https://kawalpemilu.org#24336,"RAMA PUJA, RAMAN UTARA, LAMPUNG TIMUR, LAMPUNG",8,180,49,229
https://kawalpemilu.org#24336,"RAMA PUJA, RAMAN UTARA, LAMPUNG TIMUR, LAMPUNG",9,141,48,189
https://kawalpemilu.org#24336,"RAMA PUJA, RAMAN UTARA, LAMPUNG TIMUR, LAMPUNG",10,161,45,206
https://kawalpemilu.org#24336,"RAMA PUJA, RAMAN UTARA, LAMPUNG TIMUR, LAMPUNG",11,125,29,154
https://kawalpemilu.org#24336,"RAMA PUJA, RAMAN UTARA, LAMPUNG TIMUR, LAMPUNG",12,100,70,170
https://kawalpemilu.org#24336,"RAMA PUJA, RAMAN UTARA, LAMPUNG TIMUR, LAMPUNG",13,98,65,163
https://kawalpemilu.org#24336,"RAMA PUJA, RAMAN UTARA, LAMPUNG TIMUR, LAMPUNG",14,119,53,172
https://kawalpemilu.org#24338,"KIBANG, METRO KIBANG, LAMPUNG TIMUR, LAMPUNG",1,53,70,123
https://kawalpemilu.org#24338,"KIBANG, METRO KIBANG, LAMPUNG TIMUR, LAMPUNG",2,126,37,163
https://kawalpemilu.org#24338,"KIBANG, METRO KIBANG, LAMPUNG TIMUR, LAMPUNG",3,121,65,186
https://kawalpemilu.org#24338,"KIBANG, METRO KIBANG, LAMPUNG TIMUR, LAMPUNG",4,92,74,166
https://kawalpemilu.org#24338,"KIBANG, METRO KIBANG, LAMPUNG TIMUR, LAMPUNG",5,122,51,173
https://kawalpemilu.org#24338,"KIBANG, METRO KIBANG, LAMPUNG TIMUR, LAMPUNG",6,151,22,173
https://kawalpemilu.org#24338,"KIBANG, METRO KIBANG, LAMPUNG TIMUR, LAMPUNG",7,114,42,156
https://kawalpemilu.org#24338,"KIBANG, METRO KIBANG, LAMPUNG TIMUR, LAMPUNG",8,73,92,165
https://kawalpemilu.org#24338,"KIBANG, METRO KIBANG, LAMPUNG TIMUR, LAMPUNG",9,109,61,170
https://kawalpemilu.org#24338,"KIBANG, METRO KIBANG, LAMPUNG TIMUR, LAMPUNG",10,138,57,195
https://kawalpemilu.org#24338,"KIBANG, METRO KIBANG, LAMPUNG TIMUR, LAMPUNG",11,104,84,187
https://kawalpemilu.org#24338,"KIBANG, METRO KIBANG, LAMPUNG TIMUR, LAMPUNG",12,112,27,139
https://kawalpemilu.org#24338,"KIBANG, METRO KIBANG, LAMPUNG TIMUR, LAMPUNG",13,181,30,211
https://kawalpemilu.org#24338,"KIBANG, METRO KIBANG, LAMPUNG TIMUR, LAMPUNG",14,86,38,124
https://kawalpemilu.org#24339,"MARGA JAYA, METRO KIBANG, LAMPUNG TIMUR, LAMPUNG",1,156,59,215
https://kawalpemilu.org#24339,"MARGA JAYA, METRO KIBANG, LAMPUNG TIMUR, LAMPUNG",2,157,46,203
https://kawalpemilu.org#24339,"MARGA JAYA, METRO KIBANG, LAMPUNG TIMUR, LAMPUNG",3,166,48,214
https://kawalpemilu.org#24339,"MARGA JAYA, METRO KIBANG, LAMPUNG TIMUR, LAMPUNG",4,149,30,179
https://kawalpemilu.org#24339,"MARGA JAYA, METRO KIBANG, LAMPUNG TIMUR, LAMPUNG",5,174,35,209
https://kawalpemilu.org#24339,"MARGA JAYA, METRO KIBANG, LAMPUNG TIMUR, LAMPUNG",6,120,44,164
https://kawalpemilu.org#24339,"MARGA JAYA, METRO KIBANG, LAMPUNG TIMUR, LAMPUNG",7,136,49,185
https://kawalpemilu.org#24339,"MARGA JAYA, METRO KIBANG, LAMPUNG TIMUR, LAMPUNG",8,113,31,144
https://kawalpemilu.org#24339,"MARGA JAYA, METRO KIBANG, LAMPUNG TIMUR, LAMPUNG",9,169,37,206
https://kawalpemilu.org#24339,"MARGA JAYA, METRO KIBANG, LAMPUNG TIMUR, LAMPUNG",10,176,11,187
https://kawalpemilu.org#24339,"MARGA JAYA, METRO KIBANG, LAMPUNG TIMUR, LAMPUNG",11,178,50,228
https://kawalpemilu.org#24339,"MARGA JAYA, METRO KIBANG, LAMPUNG TIMUR, LAMPUNG",12,116,40,156
https://kawalpemilu.org#24340,"MARGO TOTO, METRO KIBANG, LAMPUNG TIMUR, LAMPUNG",1,141,32,173
https://kawalpemilu.org#24340,"MARGO TOTO, METRO KIBANG, LAMPUNG TIMUR, LAMPUNG",2,155,53,208
https://kawalpemilu.org#24340,"MARGO TOTO, METRO KIBANG, LAMPUNG TIMUR, LAMPUNG",3,141,65,206
https://kawalpemilu.org#24340,"MARGO TOTO, METRO KIBANG, LAMPUNG TIMUR, LAMPUNG",4,147,62,209
https://kawalpemilu.org#24340,"MARGO TOTO, METRO KIBANG, LAMPUNG TIMUR, LAMPUNG",5,134,24,158
https://kawalpemilu.org#24340,"MARGO TOTO, METRO KIBANG, LAMPUNG TIMUR, LAMPUNG",6,163,32,195
https://kawalpemilu.org#24340,"MARGO TOTO, METRO KIBANG, LAMPUNG TIMUR, LAMPUNG",7,189,20,209
https://kawalpemilu.org#24340,"MARGO TOTO, METRO KIBANG, LAMPUNG TIMUR, LAMPUNG",8,145,12,157
https://kawalpemilu.org#24340,"MARGO TOTO, METRO KIBANG, LAMPUNG TIMUR, LAMPUNG",9,171,14,185
https://kawalpemilu.org#24340,"MARGO TOTO, METRO KIBANG, LAMPUNG TIMUR, LAMPUNG",10,184,35,219
https://kawalpemilu.org#24340,"MARGO TOTO, METRO KIBANG, LAMPUNG TIMUR, LAMPUNG",11,145,35,180
https://kawalpemilu.org#24340,"MARGO TOTO, METRO KIBANG, LAMPUNG TIMUR, LAMPUNG",12,127,39,166
https://kawalpemilu.org#24340,"MARGO TOTO, METRO KIBANG, LAMPUNG TIMUR, LAMPUNG",13,100,8,108
https://kawalpemilu.org#24340,"MARGO TOTO, METRO KIBANG, LAMPUNG TIMUR, LAMPUNG",14,183,44,227
https://kawalpemilu.org#24340,"MARGO TOTO, METRO KIBANG, LAMPUNG TIMUR, LAMPUNG",15,167,60,227
https://kawalpemilu.org#24340,"MARGO TOTO, METRO KIBANG, LAMPUNG TIMUR, LAMPUNG",16,90,28,118
https://kawalpemilu.org#24340,"MARGO TOTO, METRO KIBANG, LAMPUNG TIMUR, LAMPUNG",17,138,50,188
https://kawalpemilu.org#24340,"MARGO TOTO, METRO KIBANG, LAMPUNG TIMUR, LAMPUNG",18,175,21,196
https://kawalpemilu.org#24340,"MARGO TOTO, METRO KIBANG, LAMPUNG TIMUR, LAMPUNG",19,116,5,121
https://kawalpemilu.org#24340,"MARGO TOTO, METRO KIBANG, LAMPUNG TIMUR, LAMPUNG",20,166,24,190
https://kawalpemilu.org#24340,"MARGO TOTO, METRO KIBANG, LAMPUNG TIMUR, LAMPUNG",21,183,14,197
https://kawalpemilu.org#24340,"MARGO TOTO, METRO KIBANG, LAMPUNG TIMUR, LAMPUNG",22,124,33,157
https://kawalpemilu.org#24341,"PURBOSEMBODO, METRO KIBANG, LAMPUNG TIMUR, LAMPUNG",1,146,24,170
https://kawalpemilu.org#24341,"PURBOSEMBODO, METRO KIBANG, LAMPUNG TIMUR, LAMPUNG",2,162,60,222
https://kawalpemilu.org#24341,"PURBOSEMBODO, METRO KIBANG, LAMPUNG TIMUR, LAMPUNG",3,124,45,169
https://kawalpemilu.org#24341,"PURBOSEMBODO, METRO KIBANG, LAMPUNG TIMUR, LAMPUNG",4,121,28,149
https://kawalpemilu.org#24341,"PURBOSEMBODO, METRO KIBANG, LAMPUNG TIMUR, LAMPUNG",5,123,35,158
https://kawalpemilu.org#24341,"PURBOSEMBODO, METRO KIBANG, LAMPUNG TIMUR, LAMPUNG",6,152,40,192
https://kawalpemilu.org#24341,"PURBOSEMBODO, METRO KIBANG, LAMPUNG TIMUR, LAMPUNG",7,134,37,171
https://kawalpemilu.org#24341,"PURBOSEMBODO, METRO KIBANG, LAMPUNG TIMUR, LAMPUNG",8,113,35,148
https://kawalpemilu.org#24342,"SUMBER AGUNG, METRO KIBANG, LAMPUNG TIMUR, LAMPUNG",1,139,46,185
https://kawalpemilu.org#24342,"SUMBER AGUNG, METRO KIBANG, LAMPUNG TIMUR, LAMPUNG",2,113,41,154
https://kawalpemilu.org#24342,"SUMBER AGUNG, METRO KIBANG, LAMPUNG TIMUR, LAMPUNG",3,140,27,167
https://kawalpemilu.org#24342,"SUMBER AGUNG, METRO KIBANG, LAMPUNG TIMUR, LAMPUNG",4,134,37,171
https://kawalpemilu.org#24342,"SUMBER AGUNG, METRO KIBANG, LAMPUNG TIMUR, LAMPUNG",5,133,36,169
https://kawalpemilu.org#24342,"SUMBER AGUNG, METRO KIBANG, LAMPUNG TIMUR, LAMPUNG",6,140,18,158
https://kawalpemilu.org#24342,"SUMBER AGUNG, METRO KIBANG, LAMPUNG TIMUR, LAMPUNG",7,105,70,175
https://kawalpemilu.org#24342,"SUMBER AGUNG, METRO KIBANG, LAMPUNG TIMUR, LAMPUNG",8,109,63,172
https://kawalpemilu.org#24343,"MARGASARI, METRO KIBANG, LAMPUNG TIMUR, LAMPUNG",1,130,26,156
https://kawalpemilu.org#24343,"MARGASARI, METRO KIBANG, LAMPUNG TIMUR, LAMPUNG",2,87,26,113
https://kawalpemilu.org#24343,"MARGASARI, METRO KIBANG, LAMPUNG TIMUR, LAMPUNG",3,126,40,166
https://kawalpemilu.org#24343,"MARGASARI, METRO KIBANG, LAMPUNG TIMUR, LAMPUNG",4,153,13,166
https://kawalpemilu.org#24343,"MARGASARI, METRO KIBANG, LAMPUNG TIMUR, LAMPUNG",5,131,27,158
https://kawalpemilu.org#24343,"MARGASARI, METRO KIBANG, LAMPUNG TIMUR, LAMPUNG",6,125,33,158
https://kawalpemilu.org#24343,"MARGASARI, METRO KIBANG, LAMPUNG TIMUR, LAMPUNG",7,135,15,150
https://kawalpemilu.org#24343,"MARGASARI, METRO KIBANG, LAMPUNG TIMUR, LAMPUNG",8,129,18,147
https://kawalpemilu.org#24343,"MARGASARI, METRO KIBANG, LAMPUNG TIMUR, LAMPUNG",9,138,27,165
https://kawalpemilu.org#24344,"JAYA ASRI, METRO KIBANG, LAMPUNG TIMUR, LAMPUNG",1,156,47,203
https://kawalpemilu.org#24344,"JAYA ASRI, METRO KIBANG, LAMPUNG TIMUR, LAMPUNG",2,148,57,205
https://kawalpemilu.org#24344,"JAYA ASRI, METRO KIBANG, LAMPUNG TIMUR, LAMPUNG",3,134,49,183
https://kawalpemilu.org#24344,"JAYA ASRI, METRO KIBANG, LAMPUNG TIMUR, LAMPUNG",4,110,30,140
https://kawalpemilu.org#24344,"JAYA ASRI, METRO KIBANG, LAMPUNG TIMUR, LAMPUNG",5,179,42,221
https://kawalpemilu.org#24344,"JAYA ASRI, METRO KIBANG, LAMPUNG TIMUR, LAMPUNG",6,152,29,181
https://kawalpemilu.org#24344,"JAYA ASRI, METRO KIBANG, LAMPUNG TIMUR, LAMPUNG",7,134,24,158
https://kawalpemilu.org#24344,"JAYA ASRI, METRO KIBANG, LAMPUNG TIMUR, LAMPUNG",8,129,23,152
https://kawalpemilu.org#24346,"TANJUNG HARAPAN, MARGA TIGA, LAMPUNG TIMUR, LAMPUNG",1,147,71,218
https://kawalpemilu.org#24346,"TANJUNG HARAPAN, MARGA TIGA, LAMPUNG TIMUR, LAMPUNG",2,132,73,205
https://kawalpemilu.org#24346,"TANJUNG HARAPAN, MARGA TIGA, LAMPUNG TIMUR, LAMPUNG",3,75,48,123
https://kawalpemilu.org#24346,"TANJUNG HARAPAN, MARGA TIGA, LAMPUNG TIMUR, LAMPUNG",4,109,44,153
https://kawalpemilu.org#24346,"TANJUNG HARAPAN, MARGA TIGA, LAMPUNG TIMUR, LAMPUNG",5,66,109,175
https://kawalpemilu.org#24346,"TANJUNG HARAPAN, MARGA TIGA, LAMPUNG TIMUR, LAMPUNG",6,58,86,144
https://kawalpemilu.org#24346,"TANJUNG HARAPAN, MARGA TIGA, LAMPUNG TIMUR, LAMPUNG",7,54,174,228
https://kawalpemilu.org#24346,"TANJUNG HARAPAN, MARGA TIGA, LAMPUNG TIMUR, LAMPUNG",8,83,109,192
https://kawalpemilu.org#24346,"TANJUNG HARAPAN, MARGA TIGA, LAMPUNG TIMUR, LAMPUNG",9,55,79,134
https://kawalpemilu.org#24346,"TANJUNG HARAPAN, MARGA TIGA, LAMPUNG TIMUR, LAMPUNG",10,89,74,163
https://kawalpemilu.org#24346,"TANJUNG HARAPAN, MARGA TIGA, LAMPUNG TIMUR, LAMPUNG",11,150,97,247
https://kawalpemilu.org#24346,"TANJUNG HARAPAN, MARGA TIGA, LAMPUNG TIMUR, LAMPUNG",12,83,91,174
https://kawalpemilu.org#24346,"TANJUNG HARAPAN, MARGA TIGA, LAMPUNG TIMUR, LAMPUNG",13,82,45,127
https://kawalpemilu.org#24346,"TANJUNG HARAPAN, MARGA TIGA, LAMPUNG TIMUR, LAMPUNG",14,103,69,172
https://kawalpemilu.org#24347,"NEGERI TUA, MARGA TIGA, LAMPUNG TIMUR, LAMPUNG",1,57,213,270
https://kawalpemilu.org#24347,"NEGERI TUA, MARGA TIGA, LAMPUNG TIMUR, LAMPUNG",3,81,94,175
https://kawalpemilu.org#24347,"NEGERI TUA, MARGA TIGA, LAMPUNG TIMUR, LAMPUNG",4,89,72,161
https://kawalpemilu.org#24348,"NEGERI KATON, MARGA TIGA, LAMPUNG TIMUR, LAMPUNG",1,100,104,204
https://kawalpemilu.org#24348,"NEGERI KATON, MARGA TIGA, LAMPUNG TIMUR, LAMPUNG",5,134,62,196
https://kawalpemilu.org#24348,"NEGERI KATON, MARGA TIGA, LAMPUNG TIMUR, LAMPUNG",9,133,32,165
https://kawalpemilu.org#24348,"NEGERI KATON, MARGA TIGA, LAMPUNG TIMUR, LAMPUNG",10,111,37,148
https://kawalpemilu.org#24348,"NEGERI KATON, MARGA TIGA, LAMPUNG TIMUR, LAMPUNG",11,101,40,141
https://kawalpemilu.org#24348,"NEGERI KATON, MARGA TIGA, LAMPUNG TIMUR, LAMPUNG",12,198,15,213
https://kawalpemilu.org#24348,"NEGERI KATON, MARGA TIGA, LAMPUNG TIMUR, LAMPUNG",13,163,12,175
https://kawalpemilu.org#24348,"NEGERI KATON, MARGA TIGA, LAMPUNG TIMUR, LAMPUNG",14,102,26,128
https://kawalpemilu.org#24348,"NEGERI KATON, MARGA TIGA, LAMPUNG TIMUR, LAMPUNG",15,154,24,178
https://kawalpemilu.org#24348,"NEGERI KATON, MARGA TIGA, LAMPUNG TIMUR, LAMPUNG",16,167,12,179
https://kawalpemilu.org#24348,"NEGERI KATON, MARGA TIGA, LAMPUNG TIMUR, LAMPUNG",17,191,14,205
https://kawalpemilu.org#24348,"NEGERI KATON, MARGA TIGA, LAMPUNG TIMUR, LAMPUNG",18,193,24,217
https://kawalpemilu.org#24349,"NEGERI AGUNG, MARGA TIGA, LAMPUNG TIMUR, LAMPUNG",1,62,54,116
https://kawalpemilu.org#24349,"NEGERI AGUNG, MARGA TIGA, LAMPUNG TIMUR, LAMPUNG",2,45,74,119
https://kawalpemilu.org#24349,"NEGERI AGUNG, MARGA TIGA, LAMPUNG TIMUR, LAMPUNG",3,70,64,134
https://kawalpemilu.org#24349,"NEGERI AGUNG, MARGA TIGA, LAMPUNG TIMUR, LAMPUNG",4,101,57,158
https://kawalpemilu.org#24349,"NEGERI AGUNG, MARGA TIGA, LAMPUNG TIMUR, LAMPUNG",5,85,51,136
https://kawalpemilu.org#24349,"NEGERI AGUNG, MARGA TIGA, LAMPUNG TIMUR, LAMPUNG",6,68,65,133
https://kawalpemilu.org#24350,"NEGERI JEMANTEN, MARGA TIGA, LAMPUNG TIMUR, LAMPUNG",1,158,50,208
https://kawalpemilu.org#24350,"NEGERI JEMANTEN, MARGA TIGA, LAMPUNG TIMUR, LAMPUNG",2,135,62,197
https://kawalpemilu.org#24350,"NEGERI JEMANTEN, MARGA TIGA, LAMPUNG TIMUR, LAMPUNG",3,142,42,184
https://kawalpemilu.org#24350,"NEGERI JEMANTEN, MARGA TIGA, LAMPUNG TIMUR, LAMPUNG",4,109,62,171
https://kawalpemilu.org#24350,"NEGERI JEMANTEN, MARGA TIGA, LAMPUNG TIMUR, LAMPUNG",5,100,54,154
https://kawalpemilu.org#24350,"NEGERI JEMANTEN, MARGA TIGA, LAMPUNG TIMUR, LAMPUNG",6,121,59,180
https://kawalpemilu.org#24350,"NEGERI JEMANTEN, MARGA TIGA, LAMPUNG TIMUR, LAMPUNG",7,128,38,166
https://kawalpemilu.org#24350,"NEGERI JEMANTEN, MARGA TIGA, LAMPUNG TIMUR, LAMPUNG",8,96,63,159
https://kawalpemilu.org#24350,"NEGERI JEMANTEN, MARGA TIGA, LAMPUNG TIMUR, LAMPUNG",9,119,36,155
https://kawalpemilu.org#24350,"NEGERI JEMANTEN, MARGA TIGA, LAMPUNG TIMUR, LAMPUNG",10,149,19,168
https://kawalpemilu.org#24350,"NEGERI JEMANTEN, MARGA TIGA, LAMPUNG TIMUR, LAMPUNG",11,129,57,186
https://kawalpemilu.org#24351,"SUKARAJA TIGA, MARGA TIGA, LAMPUNG TIMUR, LAMPUNG",1,147,51,198
https://kawalpemilu.org#24351,"SUKARAJA TIGA, MARGA TIGA, LAMPUNG TIMUR, LAMPUNG",2,95,51,146
https://kawalpemilu.org#24351,"SUKARAJA TIGA, MARGA TIGA, LAMPUNG TIMUR, LAMPUNG",3,106,53,159
https://kawalpemilu.org#24351,"SUKARAJA TIGA, MARGA TIGA, LAMPUNG TIMUR, LAMPUNG",4,136,52,188
https://kawalpemilu.org#24351,"SUKARAJA TIGA, MARGA TIGA, LAMPUNG TIMUR, LAMPUNG",5,150,37,187
https://kawalpemilu.org#24351,"SUKARAJA TIGA, MARGA TIGA, LAMPUNG TIMUR, LAMPUNG",6,65,23,88
https://kawalpemilu.org#24351,"SUKARAJA TIGA, MARGA TIGA, LAMPUNG TIMUR, LAMPUNG",7,105,110,215
https://kawalpemilu.org#24351,"SUKARAJA TIGA, MARGA TIGA, LAMPUNG TIMUR, LAMPUNG",8,161,8,169
https://kawalpemilu.org#24351,"SUKARAJA TIGA, MARGA TIGA, LAMPUNG TIMUR, LAMPUNG",9,156,39,195
https://kawalpemilu.org#24351,"SUKARAJA TIGA, MARGA TIGA, LAMPUNG TIMUR, LAMPUNG",10,111,17,128
https://kawalpemilu.org#24351,"SUKARAJA TIGA, MARGA TIGA, LAMPUNG TIMUR, LAMPUNG",11,110,55,165
https://kawalpemilu.org#24351,"SUKARAJA TIGA, MARGA TIGA, LAMPUNG TIMUR, LAMPUNG",12,176,49,225
https://kawalpemilu.org#24351,"SUKARAJA TIGA, MARGA TIGA, LAMPUNG TIMUR, LAMPUNG",13,165,45,210
https://kawalpemilu.org#24351,"SUKARAJA TIGA, MARGA TIGA, LAMPUNG TIMUR, LAMPUNG",14,133,10,143
https://kawalpemilu.org#24351,"SUKARAJA TIGA, MARGA TIGA, LAMPUNG TIMUR, LAMPUNG",15,93,15,108
https://kawalpemilu.org#24351,"SUKARAJA TIGA, MARGA TIGA, LAMPUNG TIMUR, LAMPUNG",16,115,13,128
https://kawalpemilu.org#24351,"SUKARAJA TIGA, MARGA TIGA, LAMPUNG TIMUR, LAMPUNG",17,123,31,154
https://kawalpemilu.org#24351,"SUKARAJA TIGA, MARGA TIGA, LAMPUNG TIMUR, LAMPUNG",18,77,22,99
https://kawalpemilu.org#24352,"GEDUNG WANI, MARGA TIGA, LAMPUNG TIMUR, LAMPUNG",1,122,3,125
https://kawalpemilu.org#24352,"GEDUNG WANI, MARGA TIGA, LAMPUNG TIMUR, LAMPUNG",2,113,4,117
https://kawalpemilu.org#24352,"GEDUNG WANI, MARGA TIGA, LAMPUNG TIMUR, LAMPUNG",3,48,152,200
https://kawalpemilu.org#24352,"GEDUNG WANI, MARGA TIGA, LAMPUNG TIMUR, LAMPUNG",4,55,98,153
https://kawalpemilu.org#24352,"GEDUNG WANI, MARGA TIGA, LAMPUNG TIMUR, LAMPUNG",5,73,76,149
https://kawalpemilu.org#24352,"GEDUNG WANI, MARGA TIGA, LAMPUNG TIMUR, LAMPUNG",7,78,66,144
https://kawalpemilu.org#24352,"GEDUNG WANI, MARGA TIGA, LAMPUNG TIMUR, LAMPUNG",8,192,12,204
https://kawalpemilu.org#24352,"GEDUNG WANI, MARGA TIGA, LAMPUNG TIMUR, LAMPUNG",9,84,8,92
https://kawalpemilu.org#24352,"GEDUNG WANI, MARGA TIGA, LAMPUNG TIMUR, LAMPUNG",11,124,19,143
https://kawalpemilu.org#24352,"GEDUNG WANI, MARGA TIGA, LAMPUNG TIMUR, LAMPUNG",15,103,43,145
https://kawalpemilu.org#24352,"GEDUNG WANI, MARGA TIGA, LAMPUNG TIMUR, LAMPUNG",19,91,86,177
https://kawalpemilu.org#24352,"GEDUNG WANI, MARGA TIGA, LAMPUNG TIMUR, LAMPUNG",20,78,72,150
https://kawalpemilu.org#24352,"GEDUNG WANI, MARGA TIGA, LAMPUNG TIMUR, LAMPUNG",21,212,19,231
https://kawalpemilu.org#24353,"JAYA GUNA, MARGA TIGA, LAMPUNG TIMUR, LAMPUNG",1,114,23,137
https://kawalpemilu.org#24353,"JAYA GUNA, MARGA TIGA, LAMPUNG TIMUR, LAMPUNG",2,102,43,145
https://kawalpemilu.org#24353,"JAYA GUNA, MARGA TIGA, LAMPUNG TIMUR, LAMPUNG",3,134,16,150
https://kawalpemilu.org#24353,"JAYA GUNA, MARGA TIGA, LAMPUNG TIMUR, LAMPUNG",4,158,19,177
https://kawalpemilu.org#24353,"JAYA GUNA, MARGA TIGA, LAMPUNG TIMUR, LAMPUNG",5,103,14,117
https://kawalpemilu.org#24353,"JAYA GUNA, MARGA TIGA, LAMPUNG TIMUR, LAMPUNG",6,110,12,122
https://kawalpemilu.org#24354,"SUKADANA BARU, MARGA TIGA, LAMPUNG TIMUR, LAMPUNG",1,105,81,186
https://kawalpemilu.org#24354,"SUKADANA BARU, MARGA TIGA, LAMPUNG TIMUR, LAMPUNG",2,118,73,191
https://kawalpemilu.org#24354,"SUKADANA BARU, MARGA TIGA, LAMPUNG TIMUR, LAMPUNG",3,111,60,171
https://kawalpemilu.org#24354,"SUKADANA BARU, MARGA TIGA, LAMPUNG TIMUR, LAMPUNG",4,109,98,207
https://kawalpemilu.org#24354,"SUKADANA BARU, MARGA TIGA, LAMPUNG TIMUR, LAMPUNG",5,88,94,182
https://kawalpemilu.org#24354,"SUKADANA BARU, MARGA TIGA, LAMPUNG TIMUR, LAMPUNG",6,132,38,170
https://kawalpemilu.org#24354,"SUKADANA BARU, MARGA TIGA, LAMPUNG TIMUR, LAMPUNG",7,121,60,181
https://kawalpemilu.org#24354,"SUKADANA BARU, MARGA TIGA, LAMPUNG TIMUR, LAMPUNG",8,137,52,189
https://kawalpemilu.org#24354,"SUKADANA BARU, MARGA TIGA, LAMPUNG TIMUR, LAMPUNG",9,97,67,164
https://kawalpemilu.org#24354,"SUKADANA BARU, MARGA TIGA, LAMPUNG TIMUR, LAMPUNG",10,83,69,152
https://kawalpemilu.org#24354,"SUKADANA BARU, MARGA TIGA, LAMPUNG TIMUR, LAMPUNG",11,110,66,176
https://kawalpemilu.org#24354,"SUKADANA BARU, MARGA TIGA, LAMPUNG TIMUR, LAMPUNG",12,111,60,171
https://kawalpemilu.org#24354,"SUKADANA BARU, MARGA TIGA, LAMPUNG TIMUR, LAMPUNG",13,26,136,162
https://kawalpemilu.org#24354,"SUKADANA BARU, MARGA TIGA, LAMPUNG TIMUR, LAMPUNG",14,39,126,165
https://kawalpemilu.org#24354,"SUKADANA BARU, MARGA TIGA, LAMPUNG TIMUR, LAMPUNG",15,29,133,162
https://kawalpemilu.org#24354,"SUKADANA BARU, MARGA TIGA, LAMPUNG TIMUR, LAMPUNG",16,27,144,171
https://kawalpemilu.org#24355,"NABANG BARU, MARGA TIGA, LAMPUNG TIMUR, LAMPUNG",1,119,53,172
https://kawalpemilu.org#24355,"NABANG BARU, MARGA TIGA, LAMPUNG TIMUR, LAMPUNG",2,112,48,160
https://kawalpemilu.org#24355,"NABANG BARU, MARGA TIGA, LAMPUNG TIMUR, LAMPUNG",4,104,88,192
https://kawalpemilu.org#24355,"NABANG BARU, MARGA TIGA, LAMPUNG TIMUR, LAMPUNG",5,0,0,0
https://kawalpemilu.org#24355,"NABANG BARU, MARGA TIGA, LAMPUNG TIMUR, LAMPUNG",6,69,98,167
https://kawalpemilu.org#24355,"NABANG BARU, MARGA TIGA, LAMPUNG TIMUR, LAMPUNG",11,51,100,151
https://kawalpemilu.org#24356,"SURYA MATARAM, MARGA TIGA, LAMPUNG TIMUR, LAMPUNG",1,152,19,171
https://kawalpemilu.org#24356,"SURYA MATARAM, MARGA TIGA, LAMPUNG TIMUR, LAMPUNG",3,111,37,148
https://kawalpemilu.org#24356,"SURYA MATARAM, MARGA TIGA, LAMPUNG TIMUR, LAMPUNG",4,179,52,231
https://kawalpemilu.org#24356,"SURYA MATARAM, MARGA TIGA, LAMPUNG TIMUR, LAMPUNG",6,158,37,195
https://kawalpemilu.org#24356,"SURYA MATARAM, MARGA TIGA, LAMPUNG TIMUR, LAMPUNG",7,157,24,181
https://kawalpemilu.org#24356,"SURYA MATARAM, MARGA TIGA, LAMPUNG TIMUR, LAMPUNG",8,138,65,203
https://kawalpemilu.org#24356,"SURYA MATARAM, MARGA TIGA, LAMPUNG TIMUR, LAMPUNG",9,133,29,162
https://kawalpemilu.org#24356,"SURYA MATARAM, MARGA TIGA, LAMPUNG TIMUR, LAMPUNG",10,143,36,179
https://kawalpemilu.org#24356,"SURYA MATARAM, MARGA TIGA, LAMPUNG TIMUR, LAMPUNG",11,139,35,174
https://kawalpemilu.org#24356,"SURYA MATARAM, MARGA TIGA, LAMPUNG TIMUR, LAMPUNG",12,138,41,179
https://kawalpemilu.org#24356,"SURYA MATARAM, MARGA TIGA, LAMPUNG TIMUR, LAMPUNG",13,111,47,158
https://kawalpemilu.org#24356,"SURYA MATARAM, MARGA TIGA, LAMPUNG TIMUR, LAMPUNG",14,95,74,169
https://kawalpemilu.org#24356,"SURYA MATARAM, MARGA TIGA, LAMPUNG TIMUR, LAMPUNG",15,133,40,173
https://kawalpemilu.org#24357,"GEDUNG WANI TIMUR, MARGA TIGA, LAMPUNG TIMUR, LAMPUNG",1,98,50,148
https://kawalpemilu.org#24357,"GEDUNG WANI TIMUR, MARGA TIGA, LAMPUNG TIMUR, LAMPUNG",2,107,49,156
https://kawalpemilu.org#24357,"GEDUNG WANI TIMUR, MARGA TIGA, LAMPUNG TIMUR, LAMPUNG",3,122,34,156
https://kawalpemilu.org#24357,"GEDUNG WANI TIMUR, MARGA TIGA, LAMPUNG TIMUR, LAMPUNG",4,94,54,148
https://kawalpemilu.org#24357,"GEDUNG WANI TIMUR, MARGA TIGA, LAMPUNG TIMUR, LAMPUNG",5,103,46,149
https://kawalpemilu.org#24357,"GEDUNG WANI TIMUR, MARGA TIGA, LAMPUNG TIMUR, LAMPUNG",6,93,55,148
https://kawalpemilu.org#24357,"GEDUNG WANI TIMUR, MARGA TIGA, LAMPUNG TIMUR, LAMPUNG",7,132,62,194
https://kawalpemilu.org#24357,"GEDUNG WANI TIMUR, MARGA TIGA, LAMPUNG TIMUR, LAMPUNG",8,100,67,167
https://kawalpemilu.org#24357,"GEDUNG WANI TIMUR, MARGA TIGA, LAMPUNG TIMUR, LAMPUNG",9,118,56,174
https://kawalpemilu.org#24358,"TRISINAR, MARGA TIGA, LAMPUNG TIMUR, LAMPUNG",1,135,9,144
https://kawalpemilu.org#24358,"TRISINAR, MARGA TIGA, LAMPUNG TIMUR, LAMPUNG",2,133,20,153
https://kawalpemilu.org#24358,"TRISINAR, MARGA TIGA, LAMPUNG TIMUR, LAMPUNG",3,154,23,177
https://kawalpemilu.org#24358,"TRISINAR, MARGA TIGA, LAMPUNG TIMUR, LAMPUNG",4,144,5,149
https://kawalpemilu.org#24358,"TRISINAR, MARGA TIGA, LAMPUNG TIMUR, LAMPUNG",5,165,17,182
https://kawalpemilu.org#24358,"TRISINAR, MARGA TIGA, LAMPUNG TIMUR, LAMPUNG",6,178,7,185
https://kawalpemilu.org#24358,"TRISINAR, MARGA TIGA, LAMPUNG TIMUR, LAMPUNG",7,131,11,142
https://kawalpemilu.org#24358,"TRISINAR, MARGA TIGA, LAMPUNG TIMUR, LAMPUNG",8,108,8,116
https://kawalpemilu.org#24360,"PUGUNG RAHARJO, SEKAMPUNG UDIK, LAMPUNG TIMUR, LAMPUNG",1,103,35,138
https://kawalpemilu.org#24360,"PUGUNG RAHARJO, SEKAMPUNG UDIK, LAMPUNG TIMUR, LAMPUNG",2,155,28,183
https://kawalpemilu.org#24360,"PUGUNG RAHARJO, SEKAMPUNG UDIK, LAMPUNG TIMUR, LAMPUNG",3,100,25,125
https://kawalpemilu.org#24360,"PUGUNG RAHARJO, SEKAMPUNG UDIK, LAMPUNG TIMUR, LAMPUNG",4,169,31,200
https://kawalpemilu.org#24360,"PUGUNG RAHARJO, SEKAMPUNG UDIK, LAMPUNG TIMUR, LAMPUNG",5,161,34,195
https://kawalpemilu.org#24360,"PUGUNG RAHARJO, SEKAMPUNG UDIK, LAMPUNG TIMUR, LAMPUNG",6,170,43,213
https://kawalpemilu.org#24360,"PUGUNG RAHARJO, SEKAMPUNG UDIK, LAMPUNG TIMUR, LAMPUNG",7,143,26,169
https://kawalpemilu.org#24360,"PUGUNG RAHARJO, SEKAMPUNG UDIK, LAMPUNG TIMUR, LAMPUNG",8,140,35,175
https://kawalpemilu.org#24360,"PUGUNG RAHARJO, SEKAMPUNG UDIK, LAMPUNG TIMUR, LAMPUNG",9,124,28,152
https://kawalpemilu.org#24360,"PUGUNG RAHARJO, SEKAMPUNG UDIK, LAMPUNG TIMUR, LAMPUNG",10,146,44,190
https://kawalpemilu.org#24360,"PUGUNG RAHARJO, SEKAMPUNG UDIK, LAMPUNG TIMUR, LAMPUNG",11,159,29,188
https://kawalpemilu.org#24360,"PUGUNG RAHARJO, SEKAMPUNG UDIK, LAMPUNG TIMUR, LAMPUNG",12,136,34,170
https://kawalpemilu.org#24360,"PUGUNG RAHARJO, SEKAMPUNG UDIK, LAMPUNG TIMUR, LAMPUNG",13,105,67,172
https://kawalpemilu.org#24360,"PUGUNG RAHARJO, SEKAMPUNG UDIK, LAMPUNG TIMUR, LAMPUNG",14,171,37,208
https://kawalpemilu.org#24360,"PUGUNG RAHARJO, SEKAMPUNG UDIK, LAMPUNG TIMUR, LAMPUNG",15,127,50,177
https://kawalpemilu.org#24360,"PUGUNG RAHARJO, SEKAMPUNG UDIK, LAMPUNG TIMUR, LAMPUNG",16,122,44,166
https://kawalpemilu.org#24360,"PUGUNG RAHARJO, SEKAMPUNG UDIK, LAMPUNG TIMUR, LAMPUNG",17,140,23,163
https://kawalpemilu.org#24360,"PUGUNG RAHARJO, SEKAMPUNG UDIK, LAMPUNG TIMUR, LAMPUNG",18,115,49,164
https://kawalpemilu.org#24360,"PUGUNG RAHARJO, SEKAMPUNG UDIK, LAMPUNG TIMUR, LAMPUNG",19,106,48,154
https://kawalpemilu.org#24360,"PUGUNG RAHARJO, SEKAMPUNG UDIK, LAMPUNG TIMUR, LAMPUNG",20,137,45,182
https://kawalpemilu.org#24360,"PUGUNG RAHARJO, SEKAMPUNG UDIK, LAMPUNG TIMUR, LAMPUNG",21,191,38,229
https://kawalpemilu.org#24360,"PUGUNG RAHARJO, SEKAMPUNG UDIK, LAMPUNG TIMUR, LAMPUNG",22,169,47,216
https://kawalpemilu.org#24360,"PUGUNG RAHARJO, SEKAMPUNG UDIK, LAMPUNG TIMUR, LAMPUNG",23,188,17,205
https://kawalpemilu.org#24360,"PUGUNG RAHARJO, SEKAMPUNG UDIK, LAMPUNG TIMUR, LAMPUNG",24,130,45,175
https://kawalpemilu.org#24360,"PUGUNG RAHARJO, SEKAMPUNG UDIK, LAMPUNG TIMUR, LAMPUNG",25,144,57,201
https://kawalpemilu.org#24361,"MENGANDUNG SARI, SEKAMPUNG UDIK, LAMPUNG TIMUR, LAMPUNG",1,188,24,212
https://kawalpemilu.org#24361,"MENGANDUNG SARI, SEKAMPUNG UDIK, LAMPUNG TIMUR, LAMPUNG",2,175,33,208
https://kawalpemilu.org#24361,"MENGANDUNG SARI, SEKAMPUNG UDIK, LAMPUNG TIMUR, LAMPUNG",3,150,47,197
https://kawalpemilu.org#24361,"MENGANDUNG SARI, SEKAMPUNG UDIK, LAMPUNG TIMUR, LAMPUNG",4,178,49,227
https://kawalpemilu.org#24361,"MENGANDUNG SARI, SEKAMPUNG UDIK, LAMPUNG TIMUR, LAMPUNG",5,112,81,193
https://kawalpemilu.org#24361,"MENGANDUNG SARI, SEKAMPUNG UDIK, LAMPUNG TIMUR, LAMPUNG",6,88,78,166
https://kawalpemilu.org#24361,"MENGANDUNG SARI, SEKAMPUNG UDIK, LAMPUNG TIMUR, LAMPUNG",7,29,120,149
https://kawalpemilu.org#24361,"MENGANDUNG SARI, SEKAMPUNG UDIK, LAMPUNG TIMUR, LAMPUNG",8,93,67,160
https://kawalpemilu.org#24361,"MENGANDUNG SARI, SEKAMPUNG UDIK, LAMPUNG TIMUR, LAMPUNG",9,105,62,167
https://kawalpemilu.org#24361,"MENGANDUNG SARI, SEKAMPUNG UDIK, LAMPUNG TIMUR, LAMPUNG",10,125,46,171
https://kawalpemilu.org#24361,"MENGANDUNG SARI, SEKAMPUNG UDIK, LAMPUNG TIMUR, LAMPUNG",11,149,63,212
https://kawalpemilu.org#24361,"MENGANDUNG SARI, SEKAMPUNG UDIK, LAMPUNG TIMUR, LAMPUNG",12,135,75,210
https://kawalpemilu.org#24361,"MENGANDUNG SARI, SEKAMPUNG UDIK, LAMPUNG TIMUR, LAMPUNG",13,118,85,203
https://kawalpemilu.org#24362,"TOBA, SEKAMPUNG UDIK, LAMPUNG TIMUR, LAMPUNG",1,28,87,115
https://kawalpemilu.org#24362,"TOBA, SEKAMPUNG UDIK, LAMPUNG TIMUR, LAMPUNG",2,35,106,141
https://kawalpemilu.org#24362,"TOBA, SEKAMPUNG UDIK, LAMPUNG TIMUR, LAMPUNG",3,30,109,139
https://kawalpemilu.org#24362,"TOBA, SEKAMPUNG UDIK, LAMPUNG TIMUR, LAMPUNG",4,138,48,186
https://kawalpemilu.org#24362,"TOBA, SEKAMPUNG UDIK, LAMPUNG TIMUR, LAMPUNG",5,169,41,210
https://kawalpemilu.org#24362,"TOBA, SEKAMPUNG UDIK, LAMPUNG TIMUR, LAMPUNG",6,151,34,185
https://kawalpemilu.org#24362,"TOBA, SEKAMPUNG UDIK, LAMPUNG TIMUR, LAMPUNG",7,176,31,207
https://kawalpemilu.org#24363,"BANJAR AGUNG, SEKAMPUNG UDIK, LAMPUNG TIMUR, LAMPUNG",1,129,43,172
https://kawalpemilu.org#24363,"BANJAR AGUNG, SEKAMPUNG UDIK, LAMPUNG TIMUR, LAMPUNG",2,184,38,222
https://kawalpemilu.org#24363,"BANJAR AGUNG, SEKAMPUNG UDIK, LAMPUNG TIMUR, LAMPUNG",3,111,61,172
https://kawalpemilu.org#24363,"BANJAR AGUNG, SEKAMPUNG UDIK, LAMPUNG TIMUR, LAMPUNG",4,98,62,160
https://kawalpemilu.org#24363,"BANJAR AGUNG, SEKAMPUNG UDIK, LAMPUNG TIMUR, LAMPUNG",5,202,20,222
https://kawalpemilu.org#24363,"BANJAR AGUNG, SEKAMPUNG UDIK, LAMPUNG TIMUR, LAMPUNG",6,143,61,204
https://kawalpemilu.org#24363,"BANJAR AGUNG, SEKAMPUNG UDIK, LAMPUNG TIMUR, LAMPUNG",7,212,29,241
https://kawalpemilu.org#24363,"BANJAR AGUNG, SEKAMPUNG UDIK, LAMPUNG TIMUR, LAMPUNG",8,174,50,224
https://kawalpemilu.org#24363,"BANJAR AGUNG, SEKAMPUNG UDIK, LAMPUNG TIMUR, LAMPUNG",9,194,27,221
https://kawalpemilu.org#24363,"BANJAR AGUNG, SEKAMPUNG UDIK, LAMPUNG TIMUR, LAMPUNG",10,177,25,202
https://kawalpemilu.org#24364,"BOJONG, SEKAMPUNG UDIK, LAMPUNG TIMUR, LAMPUNG",1,48,108,156
https://kawalpemilu.org#24364,"BOJONG, SEKAMPUNG UDIK, LAMPUNG TIMUR, LAMPUNG",2,110,10,120
https://kawalpemilu.org#24364,"BOJONG, SEKAMPUNG UDIK, LAMPUNG TIMUR, LAMPUNG",3,36,88,124
https://kawalpemilu.org#24364,"BOJONG, SEKAMPUNG UDIK, LAMPUNG TIMUR, LAMPUNG",4,40,73,113
https://kawalpemilu.org#24364,"BOJONG, SEKAMPUNG UDIK, LAMPUNG TIMUR, LAMPUNG",5,46,84,130
https://kawalpemilu.org#24364,"BOJONG, SEKAMPUNG UDIK, LAMPUNG TIMUR, LAMPUNG",6,51,90,141
https://kawalpemilu.org#24364,"BOJONG, SEKAMPUNG UDIK, LAMPUNG TIMUR, LAMPUNG",7,106,65,171
https://kawalpemilu.org#24364,"BOJONG, SEKAMPUNG UDIK, LAMPUNG TIMUR, LAMPUNG",8,156,20,176
https://kawalpemilu.org#24364,"BOJONG, SEKAMPUNG UDIK, LAMPUNG TIMUR, LAMPUNG",9,129,40,169
https://kawalpemilu.org#24364,"BOJONG, SEKAMPUNG UDIK, LAMPUNG TIMUR, LAMPUNG",10,70,74,144
https://kawalpemilu.org#24364,"BOJONG, SEKAMPUNG UDIK, LAMPUNG TIMUR, LAMPUNG",11,154,36,190
https://kawalpemilu.org#24364,"BOJONG, SEKAMPUNG UDIK, LAMPUNG TIMUR, LAMPUNG",12,120,17,137
https://kawalpemilu.org#24364,"BOJONG, SEKAMPUNG UDIK, LAMPUNG TIMUR, LAMPUNG",13,141,3,144
https://kawalpemilu.org#24365,"GUNUNG AGUNG, SEKAMPUNG UDIK, LAMPUNG TIMUR, LAMPUNG",1,158,20,178
https://kawalpemilu.org#24365,"GUNUNG AGUNG, SEKAMPUNG UDIK, LAMPUNG TIMUR, LAMPUNG",2,129,49,178
https://kawalpemilu.org#24365,"GUNUNG AGUNG, SEKAMPUNG UDIK, LAMPUNG TIMUR, LAMPUNG",3,157,28,185
https://kawalpemilu.org#24365,"GUNUNG AGUNG, SEKAMPUNG UDIK, LAMPUNG TIMUR, LAMPUNG",4,157,20,177
https://kawalpemilu.org#24365,"GUNUNG AGUNG, SEKAMPUNG UDIK, LAMPUNG TIMUR, LAMPUNG",5,106,37,143
https://kawalpemilu.org#24365,"GUNUNG AGUNG, SEKAMPUNG UDIK, LAMPUNG TIMUR, LAMPUNG",6,104,41,145
https://kawalpemilu.org#24365,"GUNUNG AGUNG, SEKAMPUNG UDIK, LAMPUNG TIMUR, LAMPUNG",7,84,54,138
https://kawalpemilu.org#24365,"GUNUNG AGUNG, SEKAMPUNG UDIK, LAMPUNG TIMUR, LAMPUNG",8,109,43,152
https://kawalpemilu.org#24365,"GUNUNG AGUNG, SEKAMPUNG UDIK, LAMPUNG TIMUR, LAMPUNG",9,134,40,174
https://kawalpemilu.org#24365,"GUNUNG AGUNG, SEKAMPUNG UDIK, LAMPUNG TIMUR, LAMPUNG",10,142,51,193
https://kawalpemilu.org#24365,"GUNUNG AGUNG, SEKAMPUNG UDIK, LAMPUNG TIMUR, LAMPUNG",11,157,30,187
https://kawalpemilu.org#24365,"GUNUNG AGUNG, SEKAMPUNG UDIK, LAMPUNG TIMUR, LAMPUNG",12,146,12,158
https://kawalpemilu.org#24365,"GUNUNG AGUNG, SEKAMPUNG UDIK, LAMPUNG TIMUR, LAMPUNG",13,180,14,194
https://kawalpemilu.org#24365,"GUNUNG AGUNG, SEKAMPUNG UDIK, LAMPUNG TIMUR, LAMPUNG",14,118,14,132
https://kawalpemilu.org#24365,"GUNUNG AGUNG, SEKAMPUNG UDIK, LAMPUNG TIMUR, LAMPUNG",15,134,14,148
https://kawalpemilu.org#24366,"SINDANG ANOM, SEKAMPUNG UDIK, LAMPUNG TIMUR, LAMPUNG",1,141,35,176
https://kawalpemilu.org#24366,"SINDANG ANOM, SEKAMPUNG UDIK, LAMPUNG TIMUR, LAMPUNG",2,151,43,194
https://kawalpemilu.org#24366,"SINDANG ANOM, SEKAMPUNG UDIK, LAMPUNG TIMUR, LAMPUNG",3,121,75,196
https://kawalpemilu.org#24366,"SINDANG ANOM, SEKAMPUNG UDIK, LAMPUNG TIMUR, LAMPUNG",4,130,52,182
https://kawalpemilu.org#24366,"SINDANG ANOM, SEKAMPUNG UDIK, LAMPUNG TIMUR, LAMPUNG",5,112,64,176
https://kawalpemilu.org#24366,"SINDANG ANOM, SEKAMPUNG UDIK, LAMPUNG TIMUR, LAMPUNG",6,111,67,178
https://kawalpemilu.org#24366,"SINDANG ANOM, SEKAMPUNG UDIK, LAMPUNG TIMUR, LAMPUNG",7,69,78,147
https://kawalpemilu.org#24366,"SINDANG ANOM, SEKAMPUNG UDIK, LAMPUNG TIMUR, LAMPUNG",8,84,58,142
https://kawalpemilu.org#24366,"SINDANG ANOM, SEKAMPUNG UDIK, LAMPUNG TIMUR, LAMPUNG",9,153,41,194
https://kawalpemilu.org#24366,"SINDANG ANOM, SEKAMPUNG UDIK, LAMPUNG TIMUR, LAMPUNG",10,102,41,143
https://kawalpemilu.org#24366,"SINDANG ANOM, SEKAMPUNG UDIK, LAMPUNG TIMUR, LAMPUNG",11,67,106,173
https://kawalpemilu.org#24366,"SINDANG ANOM, SEKAMPUNG UDIK, LAMPUNG TIMUR, LAMPUNG",12,107,45,152
https://kawalpemilu.org#24366,"SINDANG ANOM, SEKAMPUNG UDIK, LAMPUNG TIMUR, LAMPUNG",13,117,73,190
https://kawalpemilu.org#24366,"SINDANG ANOM, SEKAMPUNG UDIK, LAMPUNG TIMUR, LAMPUNG",14,125,78,203
https://kawalpemilu.org#24366,"SINDANG ANOM, SEKAMPUNG UDIK, LAMPUNG TIMUR, LAMPUNG",15,170,27,197
https://kawalpemilu.org#24366,"SINDANG ANOM, SEKAMPUNG UDIK, LAMPUNG TIMUR, LAMPUNG",16,151,21,172
https://kawalpemilu.org#24366,"SINDANG ANOM, SEKAMPUNG UDIK, LAMPUNG TIMUR, LAMPUNG",17,155,29,184
https://kawalpemilu.org#24366,"SINDANG ANOM, SEKAMPUNG UDIK, LAMPUNG TIMUR, LAMPUNG",18,204,44,248
https://kawalpemilu.org#24366,"SINDANG ANOM, SEKAMPUNG UDIK, LAMPUNG TIMUR, LAMPUNG",19,191,38,229
https://kawalpemilu.org#24366,"SINDANG ANOM, SEKAMPUNG UDIK, LAMPUNG TIMUR, LAMPUNG",20,147,37,184
https://kawalpemilu.org#24366,"SINDANG ANOM, SEKAMPUNG UDIK, LAMPUNG TIMUR, LAMPUNG",21,172,18,190
https://kawalpemilu.org#24367,"BAUH GUNUNG SARI, SEKAMPUNG UDIK, LAMPUNG TIMUR, LAMPUNG",1,112,56,168
https://kawalpemilu.org#24367,"BAUH GUNUNG SARI, SEKAMPUNG UDIK, LAMPUNG TIMUR, LAMPUNG",2,173,37,210
https://kawalpemilu.org#24367,"BAUH GUNUNG SARI, SEKAMPUNG UDIK, LAMPUNG TIMUR, LAMPUNG",3,180,74,254
https://kawalpemilu.org#24367,"BAUH GUNUNG SARI, SEKAMPUNG UDIK, LAMPUNG TIMUR, LAMPUNG",4,162,55,217
https://kawalpemilu.org#24367,"BAUH GUNUNG SARI, SEKAMPUNG UDIK, LAMPUNG TIMUR, LAMPUNG",5,143,69,212
https://kawalpemilu.org#24367,"BAUH GUNUNG SARI, SEKAMPUNG UDIK, LAMPUNG TIMUR, LAMPUNG",6,143,42,185
https://kawalpemilu.org#24367,"BAUH GUNUNG SARI, SEKAMPUNG UDIK, LAMPUNG TIMUR, LAMPUNG",7,136,15,151
https://kawalpemilu.org#24367,"BAUH GUNUNG SARI, SEKAMPUNG UDIK, LAMPUNG TIMUR, LAMPUNG",8,176,25,201
https://kawalpemilu.org#24367,"BAUH GUNUNG SARI, SEKAMPUNG UDIK, LAMPUNG TIMUR, LAMPUNG",9,170,20,190
https://kawalpemilu.org#24367,"BAUH GUNUNG SARI, SEKAMPUNG UDIK, LAMPUNG TIMUR, LAMPUNG",10,110,32,142
https://kawalpemilu.org#24367,"BAUH GUNUNG SARI, SEKAMPUNG UDIK, LAMPUNG TIMUR, LAMPUNG",11,146,20,166
https://kawalpemilu.org#24367,"BAUH GUNUNG SARI, SEKAMPUNG UDIK, LAMPUNG TIMUR, LAMPUNG",12,128,31,159
https://kawalpemilu.org#24367,"BAUH GUNUNG SARI, SEKAMPUNG UDIK, LAMPUNG TIMUR, LAMPUNG",13,184,37,221
https://kawalpemilu.org#24367,"BAUH GUNUNG SARI, SEKAMPUNG UDIK, LAMPUNG TIMUR, LAMPUNG",14,176,34,210
https://kawalpemilu.org#24368,"GUNUNG PASIR JAYA, SEKAMPUNG UDIK, LAMPUNG TIMUR, LAMPUNG",1,166,24,190
https://kawalpemilu.org#24368,"GUNUNG PASIR JAYA, SEKAMPUNG UDIK, LAMPUNG TIMUR, LAMPUNG",2,185,8,193
https://kawalpemilu.org#24368,"GUNUNG PASIR JAYA, SEKAMPUNG UDIK, LAMPUNG TIMUR, LAMPUNG",3,121,4,125
https://kawalpemilu.org#24368,"GUNUNG PASIR JAYA, SEKAMPUNG UDIK, LAMPUNG TIMUR, LAMPUNG",4,148,14,162
https://kawalpemilu.org#24368,"GUNUNG PASIR JAYA, SEKAMPUNG UDIK, LAMPUNG TIMUR, LAMPUNG",5,159,12,171
https://kawalpemilu.org#24368,"GUNUNG PASIR JAYA, SEKAMPUNG UDIK, LAMPUNG TIMUR, LAMPUNG",6,154,8,162
https://kawalpemilu.org#24368,"GUNUNG PASIR JAYA, SEKAMPUNG UDIK, LAMPUNG TIMUR, LAMPUNG",7,128,28,156
https://kawalpemilu.org#24368,"GUNUNG PASIR JAYA, SEKAMPUNG UDIK, LAMPUNG TIMUR, LAMPUNG",8,94,30,124
https://kawalpemilu.org#24368,"GUNUNG PASIR JAYA, SEKAMPUNG UDIK, LAMPUNG TIMUR, LAMPUNG",9,88,43,131
https://kawalpemilu.org#24368,"GUNUNG PASIR JAYA, SEKAMPUNG UDIK, LAMPUNG TIMUR, LAMPUNG",10,119,55,174
https://kawalpemilu.org#24368,"GUNUNG PASIR JAYA, SEKAMPUNG UDIK, LAMPUNG TIMUR, LAMPUNG",11,147,39,186
https://kawalpemilu.org#24368,"GUNUNG PASIR JAYA, SEKAMPUNG UDIK, LAMPUNG TIMUR, LAMPUNG",12,136,44,180
https://kawalpemilu.org#24368,"GUNUNG PASIR JAYA, SEKAMPUNG UDIK, LAMPUNG TIMUR, LAMPUNG",13,77,14,91
https://kawalpemilu.org#24368,"GUNUNG PASIR JAYA, SEKAMPUNG UDIK, LAMPUNG TIMUR, LAMPUNG",14,65,30,95
https://kawalpemilu.org#24368,"GUNUNG PASIR JAYA, SEKAMPUNG UDIK, LAMPUNG TIMUR, LAMPUNG",15,127,29,156
https://kawalpemilu.org#24368,"GUNUNG PASIR JAYA, SEKAMPUNG UDIK, LAMPUNG TIMUR, LAMPUNG",16,120,22,142
https://kawalpemilu.org#24368,"GUNUNG PASIR JAYA, SEKAMPUNG UDIK, LAMPUNG TIMUR, LAMPUNG",17,119,16,135
https://kawalpemilu.org#24368,"GUNUNG PASIR JAYA, SEKAMPUNG UDIK, LAMPUNG TIMUR, LAMPUNG",18,114,15,129
https://kawalpemilu.org#24368,"GUNUNG PASIR JAYA, SEKAMPUNG UDIK, LAMPUNG TIMUR, LAMPUNG",19,159,36,195
https://kawalpemilu.org#24368,"GUNUNG PASIR JAYA, SEKAMPUNG UDIK, LAMPUNG TIMUR, LAMPUNG",20,125,32,157
https://kawalpemilu.org#24369,"GUNUNG SUGIH BESAR, SEKAMPUNG UDIK, LAMPUNG TIMUR, LAMPUNG",1,57,99,156
https://kawalpemilu.org#24369,"GUNUNG SUGIH BESAR, SEKAMPUNG UDIK, LAMPUNG TIMUR, LAMPUNG",2,63,116,179
https://kawalpemilu.org#24369,"GUNUNG SUGIH BESAR, SEKAMPUNG UDIK, LAMPUNG TIMUR, LAMPUNG",3,43,93,136
https://kawalpemilu.org#24369,"GUNUNG SUGIH BESAR, SEKAMPUNG UDIK, LAMPUNG TIMUR, LAMPUNG",4,44,96,140
https://kawalpemilu.org#24369,"GUNUNG SUGIH BESAR, SEKAMPUNG UDIK, LAMPUNG TIMUR, LAMPUNG",5,45,78,123
https://kawalpemilu.org#24369,"GUNUNG SUGIH BESAR, SEKAMPUNG UDIK, LAMPUNG TIMUR, LAMPUNG",6,23,91,114
https://kawalpemilu.org#24369,"GUNUNG SUGIH BESAR, SEKAMPUNG UDIK, LAMPUNG TIMUR, LAMPUNG",7,28,117,145
https://kawalpemilu.org#24369,"GUNUNG SUGIH BESAR, SEKAMPUNG UDIK, LAMPUNG TIMUR, LAMPUNG",8,23,108,131
https://kawalpemilu.org#24369,"GUNUNG SUGIH BESAR, SEKAMPUNG UDIK, LAMPUNG TIMUR, LAMPUNG",9,27,112,139
https://kawalpemilu.org#24369,"GUNUNG SUGIH BESAR, SEKAMPUNG UDIK, LAMPUNG TIMUR, LAMPUNG",10,55,81,136
https://kawalpemilu.org#24369,"GUNUNG SUGIH BESAR, SEKAMPUNG UDIK, LAMPUNG TIMUR, LAMPUNG",11,93,122,215
https://kawalpemilu.org#24369,"GUNUNG SUGIH BESAR, SEKAMPUNG UDIK, LAMPUNG TIMUR, LAMPUNG",12,54,95,149
https://kawalpemilu.org#24369,"GUNUNG SUGIH BESAR, SEKAMPUNG UDIK, LAMPUNG TIMUR, LAMPUNG",13,60,58,118
https://kawalpemilu.org#24369,"GUNUNG SUGIH BESAR, SEKAMPUNG UDIK, LAMPUNG TIMUR, LAMPUNG",14,103,48,151
https://kawalpemilu.org#24369,"GUNUNG SUGIH BESAR, SEKAMPUNG UDIK, LAMPUNG TIMUR, LAMPUNG",15,126,52,178
https://kawalpemilu.org#24369,"GUNUNG SUGIH BESAR, SEKAMPUNG UDIK, LAMPUNG TIMUR, LAMPUNG",16,121,78,199
https://kawalpemilu.org#24369,"GUNUNG SUGIH BESAR, SEKAMPUNG UDIK, LAMPUNG TIMUR, LAMPUNG",17,92,101,193
https://kawalpemilu.org#24369,"GUNUNG SUGIH BESAR, SEKAMPUNG UDIK, LAMPUNG TIMUR, LAMPUNG",18,114,19,133
https://kawalpemilu.org#24369,"GUNUNG SUGIH BESAR, SEKAMPUNG UDIK, LAMPUNG TIMUR, LAMPUNG",19,179,26,205
https://kawalpemilu.org#24370,"SIDOREJO, SEKAMPUNG UDIK, LAMPUNG TIMUR, LAMPUNG",1,158,3,161
https://kawalpemilu.org#24370,"SIDOREJO, SEKAMPUNG UDIK, LAMPUNG TIMUR, LAMPUNG",2,165,10,175
https://kawalpemilu.org#24370,"SIDOREJO, SEKAMPUNG UDIK, LAMPUNG TIMUR, LAMPUNG",3,212,9,221
https://kawalpemilu.org#24370,"SIDOREJO, SEKAMPUNG UDIK, LAMPUNG TIMUR, LAMPUNG",4,151,42,193
https://kawalpemilu.org#24370,"SIDOREJO, SEKAMPUNG UDIK, LAMPUNG TIMUR, LAMPUNG",5,146,73,219
https://kawalpemilu.org#24370,"SIDOREJO, SEKAMPUNG UDIK, LAMPUNG TIMUR, LAMPUNG",6,201,8,209
https://kawalpemilu.org#24370,"SIDOREJO, SEKAMPUNG UDIK, LAMPUNG TIMUR, LAMPUNG",7,187,13,200
https://kawalpemilu.org#24370,"SIDOREJO, SEKAMPUNG UDIK, LAMPUNG TIMUR, LAMPUNG",8,165,16,181
https://kawalpemilu.org#24370,"SIDOREJO, SEKAMPUNG UDIK, LAMPUNG TIMUR, LAMPUNG",9,198,23,221
https://kawalpemilu.org#24370,"SIDOREJO, SEKAMPUNG UDIK, LAMPUNG TIMUR, LAMPUNG",10,136,10,146
https://kawalpemilu.org#24370,"SIDOREJO, SEKAMPUNG UDIK, LAMPUNG TIMUR, LAMPUNG",11,195,12,207
https://kawalpemilu.org#24370,"SIDOREJO, SEKAMPUNG UDIK, LAMPUNG TIMUR, LAMPUNG",12,186,10,196
https://kawalpemilu.org#24370,"SIDOREJO, SEKAMPUNG UDIK, LAMPUNG TIMUR, LAMPUNG",13,204,34,238
https://kawalpemilu.org#24370,"SIDOREJO, SEKAMPUNG UDIK, LAMPUNG TIMUR, LAMPUNG",14,112,34,146
https://kawalpemilu.org#24370,"SIDOREJO, SEKAMPUNG UDIK, LAMPUNG TIMUR, LAMPUNG",15,168,32,200
https://kawalpemilu.org#24370,"SIDOREJO, SEKAMPUNG UDIK, LAMPUNG TIMUR, LAMPUNG",16,87,13,100
https://kawalpemilu.org#24370,"SIDOREJO, SEKAMPUNG UDIK, LAMPUNG TIMUR, LAMPUNG",17,172,21,193
https://kawalpemilu.org#24370,"SIDOREJO, SEKAMPUNG UDIK, LAMPUNG TIMUR, LAMPUNG",18,154,5,159
https://kawalpemilu.org#24370,"SIDOREJO, SEKAMPUNG UDIK, LAMPUNG TIMUR, LAMPUNG",19,196,18,214
https://kawalpemilu.org#24370,"SIDOREJO, SEKAMPUNG UDIK, LAMPUNG TIMUR, LAMPUNG",20,175,37,212
https://kawalpemilu.org#24370,"SIDOREJO, SEKAMPUNG UDIK, LAMPUNG TIMUR, LAMPUNG",21,133,44,177
https://kawalpemilu.org#24370,"SIDOREJO, SEKAMPUNG UDIK, LAMPUNG TIMUR, LAMPUNG",22,183,12,195
https://kawalpemilu.org#24370,"SIDOREJO, SEKAMPUNG UDIK, LAMPUNG TIMUR, LAMPUNG",23,197,10,207
https://kawalpemilu.org#24370,"SIDOREJO, SEKAMPUNG UDIK, LAMPUNG TIMUR, LAMPUNG",24,132,6,138
https://kawalpemilu.org#24370,"SIDOREJO, SEKAMPUNG UDIK, LAMPUNG TIMUR, LAMPUNG",25,200,16,216
https://kawalpemilu.org#24370,"SIDOREJO, SEKAMPUNG UDIK, LAMPUNG TIMUR, LAMPUNG",26,147,5,152
https://kawalpemilu.org#24370,"SIDOREJO, SEKAMPUNG UDIK, LAMPUNG TIMUR, LAMPUNG",27,167,4,171
https://kawalpemilu.org#24370,"SIDOREJO, SEKAMPUNG UDIK, LAMPUNG TIMUR, LAMPUNG",28,151,15,166
https://kawalpemilu.org#24370,"SIDOREJO, SEKAMPUNG UDIK, LAMPUNG TIMUR, LAMPUNG",29,140,11,151
https://kawalpemilu.org#24370,"SIDOREJO, SEKAMPUNG UDIK, LAMPUNG TIMUR, LAMPUNG",30,176,21,197
https://kawalpemilu.org#24370,"SIDOREJO, SEKAMPUNG UDIK, LAMPUNG TIMUR, LAMPUNG",31,165,13,178
https://kawalpemilu.org#24370,"SIDOREJO, SEKAMPUNG UDIK, LAMPUNG TIMUR, LAMPUNG",32,228,3,231
https://kawalpemilu.org#24370,"SIDOREJO, SEKAMPUNG UDIK, LAMPUNG TIMUR, LAMPUNG",33,124,1,125
https://kawalpemilu.org#24370,"SIDOREJO, SEKAMPUNG UDIK, LAMPUNG TIMUR, LAMPUNG",34,191,9,200
https://kawalpemilu.org#24370,"SIDOREJO, SEKAMPUNG UDIK, LAMPUNG TIMUR, LAMPUNG",35,114,3,117
https://kawalpemilu.org#24370,"SIDOREJO, SEKAMPUNG UDIK, LAMPUNG TIMUR, LAMPUNG",36,167,8,175
https://kawalpemilu.org#24370,"SIDOREJO, SEKAMPUNG UDIK, LAMPUNG TIMUR, LAMPUNG",37,168,1,169
https://kawalpemilu.org#24371,"BRAWIJAYA, SEKAMPUNG UDIK, LAMPUNG TIMUR, LAMPUNG",1,163,10,173
https://kawalpemilu.org#24371,"BRAWIJAYA, SEKAMPUNG UDIK, LAMPUNG TIMUR, LAMPUNG",2,164,6,170
https://kawalpemilu.org#24371,"BRAWIJAYA, SEKAMPUNG UDIK, LAMPUNG TIMUR, LAMPUNG",3,192,14,206
https://kawalpemilu.org#24371,"BRAWIJAYA, SEKAMPUNG UDIK, LAMPUNG TIMUR, LAMPUNG",4,242,4,246
https://kawalpemilu.org#24371,"BRAWIJAYA, SEKAMPUNG UDIK, LAMPUNG TIMUR, LAMPUNG",5,195,1,196
https://kawalpemilu.org#24371,"BRAWIJAYA, SEKAMPUNG UDIK, LAMPUNG TIMUR, LAMPUNG",6,165,22,187
https://kawalpemilu.org#24371,"BRAWIJAYA, SEKAMPUNG UDIK, LAMPUNG TIMUR, LAMPUNG",7,184,16,200
https://kawalpemilu.org#24371,"BRAWIJAYA, SEKAMPUNG UDIK, LAMPUNG TIMUR, LAMPUNG",8,165,17,182
https://kawalpemilu.org#24371,"BRAWIJAYA, SEKAMPUNG UDIK, LAMPUNG TIMUR, LAMPUNG",9,179,23,202
https://kawalpemilu.org#24371,"BRAWIJAYA, SEKAMPUNG UDIK, LAMPUNG TIMUR, LAMPUNG",10,200,12,212
https://kawalpemilu.org#24371,"BRAWIJAYA, SEKAMPUNG UDIK, LAMPUNG TIMUR, LAMPUNG",11,101,12,113
https://kawalpemilu.org#24371,"BRAWIJAYA, SEKAMPUNG UDIK, LAMPUNG TIMUR, LAMPUNG",12,132,19,151
https://kawalpemilu.org#24371,"BRAWIJAYA, SEKAMPUNG UDIK, LAMPUNG TIMUR, LAMPUNG",13,152,3,155
https://kawalpemilu.org#24371,"BRAWIJAYA, SEKAMPUNG UDIK, LAMPUNG TIMUR, LAMPUNG",14,149,0,149
https://kawalpemilu.org#24371,"BRAWIJAYA, SEKAMPUNG UDIK, LAMPUNG TIMUR, LAMPUNG",15,182,0,182
https://kawalpemilu.org#24371,"BRAWIJAYA, SEKAMPUNG UDIK, LAMPUNG TIMUR, LAMPUNG",16,188,14,202
https://kawalpemilu.org#24371,"BRAWIJAYA, SEKAMPUNG UDIK, LAMPUNG TIMUR, LAMPUNG",17,203,13,216
https://kawalpemilu.org#24371,"BRAWIJAYA, SEKAMPUNG UDIK, LAMPUNG TIMUR, LAMPUNG",18,203,3,206
https://kawalpemilu.org#24372,"GUNUNG MULYO, SEKAMPUNG UDIK, LAMPUNG TIMUR, LAMPUNG",1,136,18,154
https://kawalpemilu.org#24372,"GUNUNG MULYO, SEKAMPUNG UDIK, LAMPUNG TIMUR, LAMPUNG",2,147,44,191
https://kawalpemilu.org#24372,"GUNUNG MULYO, SEKAMPUNG UDIK, LAMPUNG TIMUR, LAMPUNG",3,103,6,109
https://kawalpemilu.org#24373,"BUMI MULYO, SEKAMPUNG UDIK, LAMPUNG TIMUR, LAMPUNG",1,163,42,205
https://kawalpemilu.org#24373,"BUMI MULYO, SEKAMPUNG UDIK, LAMPUNG TIMUR, LAMPUNG",3,167,37,204
https://kawalpemilu.org#24373,"BUMI MULYO, SEKAMPUNG UDIK, LAMPUNG TIMUR, LAMPUNG",4,186,29,215
https://kawalpemilu.org#24373,"BUMI MULYO, SEKAMPUNG UDIK, LAMPUNG TIMUR, LAMPUNG",5,175,35,210
https://kawalpemilu.org#24373,"BUMI MULYO, SEKAMPUNG UDIK, LAMPUNG TIMUR, LAMPUNG",6,146,27,173
https://kawalpemilu.org#24373,"BUMI MULYO, SEKAMPUNG UDIK, LAMPUNG TIMUR, LAMPUNG",7,131,80,211
https://kawalpemilu.org#24373,"BUMI MULYO, SEKAMPUNG UDIK, LAMPUNG TIMUR, LAMPUNG",8,85,54,139
https://kawalpemilu.org#24373,"BUMI MULYO, SEKAMPUNG UDIK, LAMPUNG TIMUR, LAMPUNG",9,96,43,139
https://kawalpemilu.org#24374,"PURWO KENCONO, SEKAMPUNG UDIK, LAMPUNG TIMUR, LAMPUNG",1,167,17,184
https://kawalpemilu.org#24374,"PURWO KENCONO, SEKAMPUNG UDIK, LAMPUNG TIMUR, LAMPUNG",2,163,1,164
https://kawalpemilu.org#24374,"PURWO KENCONO, SEKAMPUNG UDIK, LAMPUNG TIMUR, LAMPUNG",3,141,13,154
https://kawalpemilu.org#24374,"PURWO KENCONO, SEKAMPUNG UDIK, LAMPUNG TIMUR, LAMPUNG",4,160,7,167
https://kawalpemilu.org#24374,"PURWO KENCONO, SEKAMPUNG UDIK, LAMPUNG TIMUR, LAMPUNG",5,174,14,188
https://kawalpemilu.org#24374,"PURWO KENCONO, SEKAMPUNG UDIK, LAMPUNG TIMUR, LAMPUNG",6,126,17,143
https://kawalpemilu.org#24374,"PURWO KENCONO, SEKAMPUNG UDIK, LAMPUNG TIMUR, LAMPUNG",7,143,9,152
https://kawalpemilu.org#24374,"PURWO KENCONO, SEKAMPUNG UDIK, LAMPUNG TIMUR, LAMPUNG",8,155,8,163
https://kawalpemilu.org#24374,"PURWO KENCONO, SEKAMPUNG UDIK, LAMPUNG TIMUR, LAMPUNG",9,175,21,196
https://kawalpemilu.org#24374,"PURWO KENCONO, SEKAMPUNG UDIK, LAMPUNG TIMUR, LAMPUNG",10,171,8,179
https://kawalpemilu.org#24374,"PURWO KENCONO, SEKAMPUNG UDIK, LAMPUNG TIMUR, LAMPUNG",11,161,13,174
https://kawalpemilu.org#24374,"PURWO KENCONO, SEKAMPUNG UDIK, LAMPUNG TIMUR, LAMPUNG",12,218,10,228
https://kawalpemilu.org#24374,"PURWO KENCONO, SEKAMPUNG UDIK, LAMPUNG TIMUR, LAMPUNG",13,133,2,135
https://kawalpemilu.org#24374,"PURWO KENCONO, SEKAMPUNG UDIK, LAMPUNG TIMUR, LAMPUNG",14,188,5,193
https://kawalpemilu.org#24374,"PURWO KENCONO, SEKAMPUNG UDIK, LAMPUNG TIMUR, LAMPUNG",15,226,3,229
https://kawalpemilu.org#24376,"SUKARAJA NUBAN, BATANGHARI NUBAN, LAMPUNG TIMUR, LAMPUNG",1,43,193,236
https://kawalpemilu.org#24376,"SUKARAJA NUBAN, BATANGHARI NUBAN, LAMPUNG TIMUR, LAMPUNG",2,78,113,191
https://kawalpemilu.org#24376,"SUKARAJA NUBAN, BATANGHARI NUBAN, LAMPUNG TIMUR, LAMPUNG",4,138,35,173
https://kawalpemilu.org#24376,"SUKARAJA NUBAN, BATANGHARI NUBAN, LAMPUNG TIMUR, LAMPUNG",9,35,148,183
https://kawalpemilu.org#24376,"SUKARAJA NUBAN, BATANGHARI NUBAN, LAMPUNG TIMUR, LAMPUNG",12,134,87,221
https://kawalpemilu.org#24377,"PURWOSARI, BATANGHARI NUBAN, LAMPUNG TIMUR, LAMPUNG",3,161,47,208
https://kawalpemilu.org#24377,"PURWOSARI, BATANGHARI NUBAN, LAMPUNG TIMUR, LAMPUNG",4,118,37,155
https://kawalpemilu.org#24377,"PURWOSARI, BATANGHARI NUBAN, LAMPUNG TIMUR, LAMPUNG",5,47,109,156
https://kawalpemilu.org#24377,"PURWOSARI, BATANGHARI NUBAN, LAMPUNG TIMUR, LAMPUNG",6,119,24,143
https://kawalpemilu.org#24377,"PURWOSARI, BATANGHARI NUBAN, LAMPUNG TIMUR, LAMPUNG",7,111,23,134
https://kawalpemilu.org#24377,"PURWOSARI, BATANGHARI NUBAN, LAMPUNG TIMUR, LAMPUNG",8,62,80,142
https://kawalpemilu.org#24377,"PURWOSARI, BATANGHARI NUBAN, LAMPUNG TIMUR, LAMPUNG",9,90,64,154
https://kawalpemilu.org#24377,"PURWOSARI, BATANGHARI NUBAN, LAMPUNG TIMUR, LAMPUNG",10,47,115,162
https://kawalpemilu.org#24377,"PURWOSARI, BATANGHARI NUBAN, LAMPUNG TIMUR, LAMPUNG",12,126,44,170
https://kawalpemilu.org#24377,"PURWOSARI, BATANGHARI NUBAN, LAMPUNG TIMUR, LAMPUNG",13,108,43,151
https://kawalpemilu.org#24377,"PURWOSARI, BATANGHARI NUBAN, LAMPUNG TIMUR, LAMPUNG",14,71,78,149
https://kawalpemilu.org#24377,"PURWOSARI, BATANGHARI NUBAN, LAMPUNG TIMUR, LAMPUNG",15,69,84,153
https://kawalpemilu.org#24377,"PURWOSARI, BATANGHARI NUBAN, LAMPUNG TIMUR, LAMPUNG",16,106,50,156
https://kawalpemilu.org#24377,"PURWOSARI, BATANGHARI NUBAN, LAMPUNG TIMUR, LAMPUNG",17,132,83,215
https://kawalpemilu.org#24377,"PURWOSARI, BATANGHARI NUBAN, LAMPUNG TIMUR, LAMPUNG",18,147,89,236
https://kawalpemilu.org#24378,"TULUNG BALAK, BATANGHARI NUBAN, LAMPUNG TIMUR, LAMPUNG",1,85,63,148
https://kawalpemilu.org#24378,"TULUNG BALAK, BATANGHARI NUBAN, LAMPUNG TIMUR, LAMPUNG",2,116,35,151
https://kawalpemilu.org#24378,"TULUNG BALAK, BATANGHARI NUBAN, LAMPUNG TIMUR, LAMPUNG",3,115,62,177
https://kawalpemilu.org#24378,"TULUNG BALAK, BATANGHARI NUBAN, LAMPUNG TIMUR, LAMPUNG",4,116,42,158
https://kawalpemilu.org#24378,"TULUNG BALAK, BATANGHARI NUBAN, LAMPUNG TIMUR, LAMPUNG",5,161,71,232
https://kawalpemilu.org#24378,"TULUNG BALAK, BATANGHARI NUBAN, LAMPUNG TIMUR, LAMPUNG",6,137,79,216
https://kawalpemilu.org#24378,"TULUNG BALAK, BATANGHARI NUBAN, LAMPUNG TIMUR, LAMPUNG",7,151,57,208
https://kawalpemilu.org#24378,"TULUNG BALAK, BATANGHARI NUBAN, LAMPUNG TIMUR, LAMPUNG",8,174,33,207
https://kawalpemilu.org#24378,"TULUNG BALAK, BATANGHARI NUBAN, LAMPUNG TIMUR, LAMPUNG",9,143,68,211
https://kawalpemilu.org#24378,"TULUNG BALAK, BATANGHARI NUBAN, LAMPUNG TIMUR, LAMPUNG",10,147,81,228
https://kawalpemilu.org#24379,"KEDATON, BATANGHARI NUBAN, LAMPUNG TIMUR, LAMPUNG",1,20,174,194
https://kawalpemilu.org#24379,"KEDATON, BATANGHARI NUBAN, LAMPUNG TIMUR, LAMPUNG",2,28,159,187
https://kawalpemilu.org#24379,"KEDATON, BATANGHARI NUBAN, LAMPUNG TIMUR, LAMPUNG",3,173,25,198
https://kawalpemilu.org#24379,"KEDATON, BATANGHARI NUBAN, LAMPUNG TIMUR, LAMPUNG",4,152,43,195
https://kawalpemilu.org#24379,"KEDATON, BATANGHARI NUBAN, LAMPUNG TIMUR, LAMPUNG",5,153,62,215
https://kawalpemilu.org#24379,"KEDATON, BATANGHARI NUBAN, LAMPUNG TIMUR, LAMPUNG",6,143,47,190
https://kawalpemilu.org#24379,"KEDATON, BATANGHARI NUBAN, LAMPUNG TIMUR, LAMPUNG",7,145,44,189
https://kawalpemilu.org#24379,"KEDATON, BATANGHARI NUBAN, LAMPUNG TIMUR, LAMPUNG",8,182,46,228
https://kawalpemilu.org#24379,"KEDATON, BATANGHARI NUBAN, LAMPUNG TIMUR, LAMPUNG",9,160,52,212
https://kawalpemilu.org#24379,"KEDATON, BATANGHARI NUBAN, LAMPUNG TIMUR, LAMPUNG",10,129,83,212
https://kawalpemilu.org#24379,"KEDATON, BATANGHARI NUBAN, LAMPUNG TIMUR, LAMPUNG",11,128,37,165
https://kawalpemilu.org#24379,"KEDATON, BATANGHARI NUBAN, LAMPUNG TIMUR, LAMPUNG",12,134,46,180
https://kawalpemilu.org#24379,"KEDATON, BATANGHARI NUBAN, LAMPUNG TIMUR, LAMPUNG",13,118,62,180
https://kawalpemilu.org#24379,"KEDATON, BATANGHARI NUBAN, LAMPUNG TIMUR, LAMPUNG",14,139,44,183
https://kawalpemilu.org#24380,"KEDATON I, BATANGHARI NUBAN, LAMPUNG TIMUR, LAMPUNG",1,83,83,166
https://kawalpemilu.org#24380,"KEDATON I, BATANGHARI NUBAN, LAMPUNG TIMUR, LAMPUNG",2,85,81,166
https://kawalpemilu.org#24380,"KEDATON I, BATANGHARI NUBAN, LAMPUNG TIMUR, LAMPUNG",3,98,81,179
https://kawalpemilu.org#24380,"KEDATON I, BATANGHARI NUBAN, LAMPUNG TIMUR, LAMPUNG",4,102,62,164
https://kawalpemilu.org#24380,"KEDATON I, BATANGHARI NUBAN, LAMPUNG TIMUR, LAMPUNG",5,134,55,189
https://kawalpemilu.org#24380,"KEDATON I, BATANGHARI NUBAN, LAMPUNG TIMUR, LAMPUNG",6,115,72,187
https://kawalpemilu.org#24380,"KEDATON I, BATANGHARI NUBAN, LAMPUNG TIMUR, LAMPUNG",7,121,56,177
https://kawalpemilu.org#24380,"KEDATON I, BATANGHARI NUBAN, LAMPUNG TIMUR, LAMPUNG",8,94,83,177
https://kawalpemilu.org#24380,"KEDATON I, BATANGHARI NUBAN, LAMPUNG TIMUR, LAMPUNG",9,113,61,174
https://kawalpemilu.org#24380,"KEDATON I, BATANGHARI NUBAN, LAMPUNG TIMUR, LAMPUNG",10,93,78,171
https://kawalpemilu.org#24381,"KEDATON II, BATANGHARI NUBAN, LAMPUNG TIMUR, LAMPUNG",6,143,72,215
https://kawalpemilu.org#24381,"KEDATON II, BATANGHARI NUBAN, LAMPUNG TIMUR, LAMPUNG",7,98,94,192
https://kawalpemilu.org#24381,"KEDATON II, BATANGHARI NUBAN, LAMPUNG TIMUR, LAMPUNG",8,114,89,203
https://kawalpemilu.org#24382,"TRISNO MULYO, BATANGHARI NUBAN, LAMPUNG TIMUR, LAMPUNG",1,89,87,176
https://kawalpemilu.org#24382,"TRISNO MULYO, BATANGHARI NUBAN, LAMPUNG TIMUR, LAMPUNG",2,102,66,168
https://kawalpemilu.org#24382,"TRISNO MULYO, BATANGHARI NUBAN, LAMPUNG TIMUR, LAMPUNG",3,86,84,170
https://kawalpemilu.org#24382,"TRISNO MULYO, BATANGHARI NUBAN, LAMPUNG TIMUR, LAMPUNG",5,101,71,172
https://kawalpemilu.org#24382,"TRISNO MULYO, BATANGHARI NUBAN, LAMPUNG TIMUR, LAMPUNG",6,86,83,169
https://kawalpemilu.org#24382,"TRISNO MULYO, BATANGHARI NUBAN, LAMPUNG TIMUR, LAMPUNG",7,67,83,150
https://kawalpemilu.org#24382,"TRISNO MULYO, BATANGHARI NUBAN, LAMPUNG TIMUR, LAMPUNG",8,92,62,154
https://kawalpemilu.org#24382,"TRISNO MULYO, BATANGHARI NUBAN, LAMPUNG TIMUR, LAMPUNG",9,69,120,189
https://kawalpemilu.org#24382,"TRISNO MULYO, BATANGHARI NUBAN, LAMPUNG TIMUR, LAMPUNG",10,60,102,162
https://kawalpemilu.org#24383,"CEMPAKA NUBAN, BATANGHARI NUBAN, LAMPUNG TIMUR, LAMPUNG",1,124,57,181
https://kawalpemilu.org#24383,"CEMPAKA NUBAN, BATANGHARI NUBAN, LAMPUNG TIMUR, LAMPUNG",2,118,61,179
https://kawalpemilu.org#24383,"CEMPAKA NUBAN, BATANGHARI NUBAN, LAMPUNG TIMUR, LAMPUNG",3,95,75,170
https://kawalpemilu.org#24383,"CEMPAKA NUBAN, BATANGHARI NUBAN, LAMPUNG TIMUR, LAMPUNG",4,98,61,159
https://kawalpemilu.org#24383,"CEMPAKA NUBAN, BATANGHARI NUBAN, LAMPUNG TIMUR, LAMPUNG",5,99,72,171
https://kawalpemilu.org#24383,"CEMPAKA NUBAN, BATANGHARI NUBAN, LAMPUNG TIMUR, LAMPUNG",6,104,62,166
https://kawalpemilu.org#24383,"CEMPAKA NUBAN, BATANGHARI NUBAN, LAMPUNG TIMUR, LAMPUNG",7,85,39,124
https://kawalpemilu.org#24383,"CEMPAKA NUBAN, BATANGHARI NUBAN, LAMPUNG TIMUR, LAMPUNG",8,91,45,136
https://kawalpemilu.org#24383,"CEMPAKA NUBAN, BATANGHARI NUBAN, LAMPUNG TIMUR, LAMPUNG",9,115,61,176
https://kawalpemilu.org#24383,"CEMPAKA NUBAN, BATANGHARI NUBAN, LAMPUNG TIMUR, LAMPUNG",10,100,61,161
https://kawalpemilu.org#24383,"CEMPAKA NUBAN, BATANGHARI NUBAN, LAMPUNG TIMUR, LAMPUNG",11,128,62,190
https://kawalpemilu.org#24383,"CEMPAKA NUBAN, BATANGHARI NUBAN, LAMPUNG TIMUR, LAMPUNG",12,68,67,135
https://kawalpemilu.org#24383,"CEMPAKA NUBAN, BATANGHARI NUBAN, LAMPUNG TIMUR, LAMPUNG",13,70,78,148
https://kawalpemilu.org#24384,"GEDUNG DALEM, BATANGHARI NUBAN, LAMPUNG TIMUR, LAMPUNG",1,29,165,194
https://kawalpemilu.org#24384,"GEDUNG DALEM, BATANGHARI NUBAN, LAMPUNG TIMUR, LAMPUNG",2,51,153,204
https://kawalpemilu.org#24384,"GEDUNG DALEM, BATANGHARI NUBAN, LAMPUNG TIMUR, LAMPUNG",3,36,96,132
https://kawalpemilu.org#24384,"GEDUNG DALEM, BATANGHARI NUBAN, LAMPUNG TIMUR, LAMPUNG",4,38,76,114
https://kawalpemilu.org#24384,"GEDUNG DALEM, BATANGHARI NUBAN, LAMPUNG TIMUR, LAMPUNG",5,117,78,195
https://kawalpemilu.org#24384,"GEDUNG DALEM, BATANGHARI NUBAN, LAMPUNG TIMUR, LAMPUNG",6,90,84,174
https://kawalpemilu.org#24384,"GEDUNG DALEM, BATANGHARI NUBAN, LAMPUNG TIMUR, LAMPUNG",7,150,54,204
https://kawalpemilu.org#24384,"GEDUNG DALEM, BATANGHARI NUBAN, LAMPUNG TIMUR, LAMPUNG",8,131,94,225
https://kawalpemilu.org#24385,"BUMI JAWA, BATANGHARI NUBAN, LAMPUNG TIMUR, LAMPUNG",1,24,129,153
https://kawalpemilu.org#24385,"BUMI JAWA, BATANGHARI NUBAN, LAMPUNG TIMUR, LAMPUNG",2,53,97,150
https://kawalpemilu.org#24385,"BUMI JAWA, BATANGHARI NUBAN, LAMPUNG TIMUR, LAMPUNG",4,40,100,140
https://kawalpemilu.org#24385,"BUMI JAWA, BATANGHARI NUBAN, LAMPUNG TIMUR, LAMPUNG",5,104,73,177
https://kawalpemilu.org#24385,"BUMI JAWA, BATANGHARI NUBAN, LAMPUNG TIMUR, LAMPUNG",6,78,80,158
https://kawalpemilu.org#24385,"BUMI JAWA, BATANGHARI NUBAN, LAMPUNG TIMUR, LAMPUNG",7,86,92,178
https://kawalpemilu.org#24385,"BUMI JAWA, BATANGHARI NUBAN, LAMPUNG TIMUR, LAMPUNG",8,95,96,191
https://kawalpemilu.org#24385,"BUMI JAWA, BATANGHARI NUBAN, LAMPUNG TIMUR, LAMPUNG",9,130,69,199
https://kawalpemilu.org#24385,"BUMI JAWA, BATANGHARI NUBAN, LAMPUNG TIMUR, LAMPUNG",10,93,80,173
https://kawalpemilu.org#24385,"BUMI JAWA, BATANGHARI NUBAN, LAMPUNG TIMUR, LAMPUNG",11,129,64,193
https://kawalpemilu.org#24385,"BUMI JAWA, BATANGHARI NUBAN, LAMPUNG TIMUR, LAMPUNG",12,144,79,223
https://kawalpemilu.org#24385,"BUMI JAWA, BATANGHARI NUBAN, LAMPUNG TIMUR, LAMPUNG",13,147,45,192
https://kawalpemilu.org#24385,"BUMI JAWA, BATANGHARI NUBAN, LAMPUNG TIMUR, LAMPUNG",15,152,33,185
https://kawalpemilu.org#24385,"BUMI JAWA, BATANGHARI NUBAN, LAMPUNG TIMUR, LAMPUNG",16,127,46,173
https://kawalpemilu.org#24385,"BUMI JAWA, BATANGHARI NUBAN, LAMPUNG TIMUR, LAMPUNG",17,140,38,178
https://kawalpemilu.org#24385,"BUMI JAWA, BATANGHARI NUBAN, LAMPUNG TIMUR, LAMPUNG",18,124,50,174
https://kawalpemilu.org#24386,"GUNUNG TIGA, BATANGHARI NUBAN, LAMPUNG TIMUR, LAMPUNG",1,20,192,212
https://kawalpemilu.org#24386,"GUNUNG TIGA, BATANGHARI NUBAN, LAMPUNG TIMUR, LAMPUNG",3,14,110,124
https://kawalpemilu.org#24386,"GUNUNG TIGA, BATANGHARI NUBAN, LAMPUNG TIMUR, LAMPUNG",4,111,77,188
https://kawalpemilu.org#24386,"GUNUNG TIGA, BATANGHARI NUBAN, LAMPUNG TIMUR, LAMPUNG",5,35,115,150
https://kawalpemilu.org#24386,"GUNUNG TIGA, BATANGHARI NUBAN, LAMPUNG TIMUR, LAMPUNG",7,197,27,224
https://kawalpemilu.org#24386,"GUNUNG TIGA, BATANGHARI NUBAN, LAMPUNG TIMUR, LAMPUNG",8,188,12,200
https://kawalpemilu.org#24386,"GUNUNG TIGA, BATANGHARI NUBAN, LAMPUNG TIMUR, LAMPUNG",9,128,22,150
https://kawalpemilu.org#24386,"GUNUNG TIGA, BATANGHARI NUBAN, LAMPUNG TIMUR, LAMPUNG",10,134,19,153
https://kawalpemilu.org#24387,"NEGARA RATU, BATANGHARI NUBAN, LAMPUNG TIMUR, LAMPUNG",1,52,112,164
https://kawalpemilu.org#24387,"NEGARA RATU, BATANGHARI NUBAN, LAMPUNG TIMUR, LAMPUNG",2,67,72,139
https://kawalpemilu.org#24387,"NEGARA RATU, BATANGHARI NUBAN, LAMPUNG TIMUR, LAMPUNG",4,46,73,119
https://kawalpemilu.org#24387,"NEGARA RATU, BATANGHARI NUBAN, LAMPUNG TIMUR, LAMPUNG",5,133,56,189
https://kawalpemilu.org#24387,"NEGARA RATU, BATANGHARI NUBAN, LAMPUNG TIMUR, LAMPUNG",6,136,61,197
https://kawalpemilu.org#24387,"NEGARA RATU, BATANGHARI NUBAN, LAMPUNG TIMUR, LAMPUNG",7,179,45,224
https://kawalpemilu.org#24387,"NEGARA RATU, BATANGHARI NUBAN, LAMPUNG TIMUR, LAMPUNG",8,187,45,232
https://kawalpemilu.org#24387,"NEGARA RATU, BATANGHARI NUBAN, LAMPUNG TIMUR, LAMPUNG",9,128,59,187
https://kawalpemilu.org#24387,"NEGARA RATU, BATANGHARI NUBAN, LAMPUNG TIMUR, LAMPUNG",10,157,31,188
https://kawalpemilu.org#24387,"NEGARA RATU, BATANGHARI NUBAN, LAMPUNG TIMUR, LAMPUNG",11,92,107,199
https://kawalpemilu.org#24387,"NEGARA RATU, BATANGHARI NUBAN, LAMPUNG TIMUR, LAMPUNG",12,104,86,190
https://kawalpemilu.org#24388,"SUKACARI, BATANGHARI NUBAN, LAMPUNG TIMUR, LAMPUNG",1,29,105,134
https://kawalpemilu.org#24388,"SUKACARI, BATANGHARI NUBAN, LAMPUNG TIMUR, LAMPUNG",2,29,82,111
https://kawalpemilu.org#24388,"SUKACARI, BATANGHARI NUBAN, LAMPUNG TIMUR, LAMPUNG",3,130,47,177
https://kawalpemilu.org#24388,"SUKACARI, BATANGHARI NUBAN, LAMPUNG TIMUR, LAMPUNG",4,137,35,172
https://kawalpemilu.org#24388,"SUKACARI, BATANGHARI NUBAN, LAMPUNG TIMUR, LAMPUNG",5,48,135,183
https://kawalpemilu.org#24388,"SUKACARI, BATANGHARI NUBAN, LAMPUNG TIMUR, LAMPUNG",6,66,69,135
https://kawalpemilu.org#24388,"SUKACARI, BATANGHARI NUBAN, LAMPUNG TIMUR, LAMPUNG",7,127,38,165
https://kawalpemilu.org#24388,"SUKACARI, BATANGHARI NUBAN, LAMPUNG TIMUR, LAMPUNG",8,111,46,157
https://kawalpemilu.org#24390,"DONO MULYO, BUMI AGUNG, LAMPUNG TIMUR, LAMPUNG",1,124,78,202
https://kawalpemilu.org#24390,"DONO MULYO, BUMI AGUNG, LAMPUNG TIMUR, LAMPUNG",2,170,44,214
https://kawalpemilu.org#24390,"DONO MULYO, BUMI AGUNG, LAMPUNG TIMUR, LAMPUNG",3,147,33,180
https://kawalpemilu.org#24390,"DONO MULYO, BUMI AGUNG, LAMPUNG TIMUR, LAMPUNG",4,161,22,183
https://kawalpemilu.org#24390,"DONO MULYO, BUMI AGUNG, LAMPUNG TIMUR, LAMPUNG",5,168,24,192
https://kawalpemilu.org#24390,"DONO MULYO, BUMI AGUNG, LAMPUNG TIMUR, LAMPUNG",6,180,35,215
https://kawalpemilu.org#24390,"DONO MULYO, BUMI AGUNG, LAMPUNG TIMUR, LAMPUNG",7,150,33,183
https://kawalpemilu.org#24390,"DONO MULYO, BUMI AGUNG, LAMPUNG TIMUR, LAMPUNG",8,154,34,188
https://kawalpemilu.org#24390,"DONO MULYO, BUMI AGUNG, LAMPUNG TIMUR, LAMPUNG",9,139,43,182
https://kawalpemilu.org#24390,"DONO MULYO, BUMI AGUNG, LAMPUNG TIMUR, LAMPUNG",10,156,31,187
https://kawalpemilu.org#24390,"DONO MULYO, BUMI AGUNG, LAMPUNG TIMUR, LAMPUNG",11,168,38,206
https://kawalpemilu.org#24390,"DONO MULYO, BUMI AGUNG, LAMPUNG TIMUR, LAMPUNG",12,130,12,142
https://kawalpemilu.org#24390,"DONO MULYO, BUMI AGUNG, LAMPUNG TIMUR, LAMPUNG",13,80,44,124
https://kawalpemilu.org#24390,"DONO MULYO, BUMI AGUNG, LAMPUNG TIMUR, LAMPUNG",14,123,35,158
https://kawalpemilu.org#24390,"DONO MULYO, BUMI AGUNG, LAMPUNG TIMUR, LAMPUNG",15,111,52,163
https://kawalpemilu.org#24391,"NYAMPIR, BUMI AGUNG, LAMPUNG TIMUR, LAMPUNG",1,25,199,224
https://kawalpemilu.org#24391,"NYAMPIR, BUMI AGUNG, LAMPUNG TIMUR, LAMPUNG",2,138,50,188
https://kawalpemilu.org#24391,"NYAMPIR, BUMI AGUNG, LAMPUNG TIMUR, LAMPUNG",3,142,41,183
https://kawalpemilu.org#24391,"NYAMPIR, BUMI AGUNG, LAMPUNG TIMUR, LAMPUNG",4,154,42,196
https://kawalpemilu.org#24391,"NYAMPIR, BUMI AGUNG, LAMPUNG TIMUR, LAMPUNG",5,164,33,197
https://kawalpemilu.org#24392,"BUMI TINGGI, BUMI AGUNG, LAMPUNG TIMUR, LAMPUNG",1,35,113,148
https://kawalpemilu.org#24392,"BUMI TINGGI, BUMI AGUNG, LAMPUNG TIMUR, LAMPUNG",2,43,100,143
https://kawalpemilu.org#24392,"BUMI TINGGI, BUMI AGUNG, LAMPUNG TIMUR, LAMPUNG",3,78,72,150
https://kawalpemilu.org#24392,"BUMI TINGGI, BUMI AGUNG, LAMPUNG TIMUR, LAMPUNG",4,101,36,137
https://kawalpemilu.org#24392,"BUMI TINGGI, BUMI AGUNG, LAMPUNG TIMUR, LAMPUNG",5,93,40,133
https://kawalpemilu.org#24392,"BUMI TINGGI, BUMI AGUNG, LAMPUNG TIMUR, LAMPUNG",6,106,115,221
https://kawalpemilu.org#24392,"BUMI TINGGI, BUMI AGUNG, LAMPUNG TIMUR, LAMPUNG",7,94,34,128
https://kawalpemilu.org#24392,"BUMI TINGGI, BUMI AGUNG, LAMPUNG TIMUR, LAMPUNG",8,169,47,216
https://kawalpemilu.org#24392,"BUMI TINGGI, BUMI AGUNG, LAMPUNG TIMUR, LAMPUNG",9,113,35,148
https://kawalpemilu.org#24392,"BUMI TINGGI, BUMI AGUNG, LAMPUNG TIMUR, LAMPUNG",10,128,56,184
https://kawalpemilu.org#24393,"LEHAN, BUMI AGUNG, LAMPUNG TIMUR, LAMPUNG",1,77,92,169
https://kawalpemilu.org#24393,"LEHAN, BUMI AGUNG, LAMPUNG TIMUR, LAMPUNG",2,44,107,151
https://kawalpemilu.org#24393,"LEHAN, BUMI AGUNG, LAMPUNG TIMUR, LAMPUNG",3,82,84,166
https://kawalpemilu.org#24393,"LEHAN, BUMI AGUNG, LAMPUNG TIMUR, LAMPUNG",4,121,23,144
https://kawalpemilu.org#24393,"LEHAN, BUMI AGUNG, LAMPUNG TIMUR, LAMPUNG",5,104,52,156
https://kawalpemilu.org#24393,"LEHAN, BUMI AGUNG, LAMPUNG TIMUR, LAMPUNG",6,89,40,129
https://kawalpemilu.org#24393,"LEHAN, BUMI AGUNG, LAMPUNG TIMUR, LAMPUNG",7,88,45,133
https://kawalpemilu.org#24393,"LEHAN, BUMI AGUNG, LAMPUNG TIMUR, LAMPUNG",8,98,47,145
https://kawalpemilu.org#24393,"LEHAN, BUMI AGUNG, LAMPUNG TIMUR, LAMPUNG",9,105,41,146
https://kawalpemilu.org#24393,"LEHAN, BUMI AGUNG, LAMPUNG TIMUR, LAMPUNG",10,131,34,165
https://kawalpemilu.org#24393,"LEHAN, BUMI AGUNG, LAMPUNG TIMUR, LAMPUNG",11,141,33,174
https://kawalpemilu.org#24393,"LEHAN, BUMI AGUNG, LAMPUNG TIMUR, LAMPUNG",12,173,36,209
https://kawalpemilu.org#24393,"LEHAN, BUMI AGUNG, LAMPUNG TIMUR, LAMPUNG",13,121,26,147
https://kawalpemilu.org#24394,"MARGA MULYA, BUMI AGUNG, LAMPUNG TIMUR, LAMPUNG",1,109,41,150
https://kawalpemilu.org#24394,"MARGA MULYA, BUMI AGUNG, LAMPUNG TIMUR, LAMPUNG",2,115,34,149
https://kawalpemilu.org#24394,"MARGA MULYA, BUMI AGUNG, LAMPUNG TIMUR, LAMPUNG",3,133,57,190
https://kawalpemilu.org#24394,"MARGA MULYA, BUMI AGUNG, LAMPUNG TIMUR, LAMPUNG",4,177,26,203
https://kawalpemilu.org#24394,"MARGA MULYA, BUMI AGUNG, LAMPUNG TIMUR, LAMPUNG",5,148,36,184
https://kawalpemilu.org#24394,"MARGA MULYA, BUMI AGUNG, LAMPUNG TIMUR, LAMPUNG",6,163,55,218
https://kawalpemilu.org#24394,"MARGA MULYA, BUMI AGUNG, LAMPUNG TIMUR, LAMPUNG",7,111,28,139
https://kawalpemilu.org#24394,"MARGA MULYA, BUMI AGUNG, LAMPUNG TIMUR, LAMPUNG",8,75,33,108
https://kawalpemilu.org#24394,"MARGA MULYA, BUMI AGUNG, LAMPUNG TIMUR, LAMPUNG",9,138,93,231
https://kawalpemilu.org#24395,"CATUR SWAKO, BUMI AGUNG, LAMPUNG TIMUR, LAMPUNG",1,90,72,162
https://kawalpemilu.org#24395,"CATUR SWAKO, BUMI AGUNG, LAMPUNG TIMUR, LAMPUNG",2,114,89,203
https://kawalpemilu.org#24395,"CATUR SWAKO, BUMI AGUNG, LAMPUNG TIMUR, LAMPUNG",3,130,76,206
https://kawalpemilu.org#24395,"CATUR SWAKO, BUMI AGUNG, LAMPUNG TIMUR, LAMPUNG",4,112,26,138
https://kawalpemilu.org#24395,"CATUR SWAKO, BUMI AGUNG, LAMPUNG TIMUR, LAMPUNG",5,133,45,178
https://kawalpemilu.org#24395,"CATUR SWAKO, BUMI AGUNG, LAMPUNG TIMUR, LAMPUNG",6,116,38,154
https://kawalpemilu.org#24395,"CATUR SWAKO, BUMI AGUNG, LAMPUNG TIMUR, LAMPUNG",7,215,25,240
https://kawalpemilu.org#88042,"MULYO ASRI, BUMI AGUNG, LAMPUNG TIMUR, LAMPUNG",1,118,30,148
https://kawalpemilu.org#88042,"MULYO ASRI, BUMI AGUNG, LAMPUNG TIMUR, LAMPUNG",2,97,38,135
https://kawalpemilu.org#88042,"MULYO ASRI, BUMI AGUNG, LAMPUNG TIMUR, LAMPUNG",3,113,57,170
https://kawalpemilu.org#88042,"MULYO ASRI, BUMI AGUNG, LAMPUNG TIMUR, LAMPUNG",4,131,76,207
https://kawalpemilu.org#88042,"MULYO ASRI, BUMI AGUNG, LAMPUNG TIMUR, LAMPUNG",6,99,35,134
https://kawalpemilu.org#88042,"MULYO ASRI, BUMI AGUNG, LAMPUNG TIMUR, LAMPUNG",7,120,94,214
https://kawalpemilu.org#24397,"SRIBHAWONO, BANDAR SRIBHAWONO, LAMPUNG TIMUR, LAMPUNG",1,142,69,211
https://kawalpemilu.org#24397,"SRIBHAWONO, BANDAR SRIBHAWONO, LAMPUNG TIMUR, LAMPUNG",2,132,65,197
https://kawalpemilu.org#24397,"SRIBHAWONO, BANDAR SRIBHAWONO, LAMPUNG TIMUR, LAMPUNG",3,145,79,224
https://kawalpemilu.org#24397,"SRIBHAWONO, BANDAR SRIBHAWONO, LAMPUNG TIMUR, LAMPUNG",4,161,54,215
https://kawalpemilu.org#24397,"SRIBHAWONO, BANDAR SRIBHAWONO, LAMPUNG TIMUR, LAMPUNG",5,175,58,233
https://kawalpemilu.org#24397,"SRIBHAWONO, BANDAR SRIBHAWONO, LAMPUNG TIMUR, LAMPUNG",6,155,68,223
https://kawalpemilu.org#24397,"SRIBHAWONO, BANDAR SRIBHAWONO, LAMPUNG TIMUR, LAMPUNG",7,116,71,187
https://kawalpemilu.org#24397,"SRIBHAWONO, BANDAR SRIBHAWONO, LAMPUNG TIMUR, LAMPUNG",8,131,66,197
https://kawalpemilu.org#24397,"SRIBHAWONO, BANDAR SRIBHAWONO, LAMPUNG TIMUR, LAMPUNG",9,115,77,192
https://kawalpemilu.org#24397,"SRIBHAWONO, BANDAR SRIBHAWONO, LAMPUNG TIMUR, LAMPUNG",10,133,55,188
https://kawalpemilu.org#24397,"SRIBHAWONO, BANDAR SRIBHAWONO, LAMPUNG TIMUR, LAMPUNG",11,117,55,172
https://kawalpemilu.org#24397,"SRIBHAWONO, BANDAR SRIBHAWONO, LAMPUNG TIMUR, LAMPUNG",12,163,42,205
https://kawalpemilu.org#24397,"SRIBHAWONO, BANDAR SRIBHAWONO, LAMPUNG TIMUR, LAMPUNG",13,163,55,218
https://kawalpemilu.org#24397,"SRIBHAWONO, BANDAR SRIBHAWONO, LAMPUNG TIMUR, LAMPUNG",14,131,41,172
https://kawalpemilu.org#24397,"SRIBHAWONO, BANDAR SRIBHAWONO, LAMPUNG TIMUR, LAMPUNG",15,108,71,179
https://kawalpemilu.org#24397,"SRIBHAWONO, BANDAR SRIBHAWONO, LAMPUNG TIMUR, LAMPUNG",16,110,54,164
https://kawalpemilu.org#24397,"SRIBHAWONO, BANDAR SRIBHAWONO, LAMPUNG TIMUR, LAMPUNG",17,116,83,199
https://kawalpemilu.org#24397,"SRIBHAWONO, BANDAR SRIBHAWONO, LAMPUNG TIMUR, LAMPUNG",18,127,63,190
https://kawalpemilu.org#24397,"SRIBHAWONO, BANDAR SRIBHAWONO, LAMPUNG TIMUR, LAMPUNG",19,179,35,214
https://kawalpemilu.org#24397,"SRIBHAWONO, BANDAR SRIBHAWONO, LAMPUNG TIMUR, LAMPUNG",20,173,36,209
https://kawalpemilu.org#24397,"SRIBHAWONO, BANDAR SRIBHAWONO, LAMPUNG TIMUR, LAMPUNG",21,150,32,182
https://kawalpemilu.org#24397,"SRIBHAWONO, BANDAR SRIBHAWONO, LAMPUNG TIMUR, LAMPUNG",22,128,77,205
https://kawalpemilu.org#24397,"SRIBHAWONO, BANDAR SRIBHAWONO, LAMPUNG TIMUR, LAMPUNG",23,119,80,199
https://kawalpemilu.org#24397,"SRIBHAWONO, BANDAR SRIBHAWONO, LAMPUNG TIMUR, LAMPUNG",24,99,75,174
https://kawalpemilu.org#24397,"SRIBHAWONO, BANDAR SRIBHAWONO, LAMPUNG TIMUR, LAMPUNG",25,93,82,175
https://kawalpemilu.org#24397,"SRIBHAWONO, BANDAR SRIBHAWONO, LAMPUNG TIMUR, LAMPUNG",26,110,57,167
https://kawalpemilu.org#24397,"SRIBHAWONO, BANDAR SRIBHAWONO, LAMPUNG TIMUR, LAMPUNG",27,126,60,186
https://kawalpemilu.org#24398,"SADAR SRIWIJAYA, BANDAR SRIBHAWONO, LAMPUNG TIMUR, LAMPUNG",1,180,24,204
https://kawalpemilu.org#24398,"SADAR SRIWIJAYA, BANDAR SRIBHAWONO, LAMPUNG TIMUR, LAMPUNG",2,187,29,216
https://kawalpemilu.org#24398,"SADAR SRIWIJAYA, BANDAR SRIBHAWONO, LAMPUNG TIMUR, LAMPUNG",3,146,12,158
https://kawalpemilu.org#24398,"SADAR SRIWIJAYA, BANDAR SRIBHAWONO, LAMPUNG TIMUR, LAMPUNG",4,139,25,164
https://kawalpemilu.org#24398,"SADAR SRIWIJAYA, BANDAR SRIBHAWONO, LAMPUNG TIMUR, LAMPUNG",5,0,0,0
https://kawalpemilu.org#24398,"SADAR SRIWIJAYA, BANDAR SRIBHAWONO, LAMPUNG TIMUR, LAMPUNG",7,177,35,212
https://kawalpemilu.org#24398,"SADAR SRIWIJAYA, BANDAR SRIBHAWONO, LAMPUNG TIMUR, LAMPUNG",9,118,28,146
https://kawalpemilu.org#24398,"SADAR SRIWIJAYA, BANDAR SRIBHAWONO, LAMPUNG TIMUR, LAMPUNG",10,135,21,156
https://kawalpemilu.org#24398,"SADAR SRIWIJAYA, BANDAR SRIBHAWONO, LAMPUNG TIMUR, LAMPUNG",11,131,15,146
https://kawalpemilu.org#24398,"SADAR SRIWIJAYA, BANDAR SRIBHAWONO, LAMPUNG TIMUR, LAMPUNG",12,163,20,183
https://kawalpemilu.org#24398,"SADAR SRIWIJAYA, BANDAR SRIBHAWONO, LAMPUNG TIMUR, LAMPUNG",13,136,23,159
https://kawalpemilu.org#24398,"SADAR SRIWIJAYA, BANDAR SRIBHAWONO, LAMPUNG TIMUR, LAMPUNG",14,142,1,143
https://kawalpemilu.org#24398,"SADAR SRIWIJAYA, BANDAR SRIBHAWONO, LAMPUNG TIMUR, LAMPUNG",15,118,2,120
https://kawalpemilu.org#24398,"SADAR SRIWIJAYA, BANDAR SRIBHAWONO, LAMPUNG TIMUR, LAMPUNG",16,165,5,170
https://kawalpemilu.org#24398,"SADAR SRIWIJAYA, BANDAR SRIBHAWONO, LAMPUNG TIMUR, LAMPUNG",17,149,5,154
https://kawalpemilu.org#24398,"SADAR SRIWIJAYA, BANDAR SRIBHAWONO, LAMPUNG TIMUR, LAMPUNG",18,139,10,149
https://kawalpemilu.org#24398,"SADAR SRIWIJAYA, BANDAR SRIBHAWONO, LAMPUNG TIMUR, LAMPUNG",19,129,4,133
https://kawalpemilu.org#24398,"SADAR SRIWIJAYA, BANDAR SRIBHAWONO, LAMPUNG TIMUR, LAMPUNG",20,126,3,129
https://kawalpemilu.org#24398,"SADAR SRIWIJAYA, BANDAR SRIBHAWONO, LAMPUNG TIMUR, LAMPUNG",21,214,11,225
https://kawalpemilu.org#24398,"SADAR SRIWIJAYA, BANDAR SRIBHAWONO, LAMPUNG TIMUR, LAMPUNG",22,203,36,239
https://kawalpemilu.org#24398,"SADAR SRIWIJAYA, BANDAR SRIBHAWONO, LAMPUNG TIMUR, LAMPUNG",23,155,9,164
https://kawalpemilu.org#24398,"SADAR SRIWIJAYA, BANDAR SRIBHAWONO, LAMPUNG TIMUR, LAMPUNG",24,132,5,137
https://kawalpemilu.org#24399,"SRIMENANTI, BANDAR SRIBHAWONO, LAMPUNG TIMUR, LAMPUNG",1,129,81,210
https://kawalpemilu.org#24399,"SRIMENANTI, BANDAR SRIBHAWONO, LAMPUNG TIMUR, LAMPUNG",2,100,68,168
https://kawalpemilu.org#24399,"SRIMENANTI, BANDAR SRIBHAWONO, LAMPUNG TIMUR, LAMPUNG",3,149,85,234
https://kawalpemilu.org#24399,"SRIMENANTI, BANDAR SRIBHAWONO, LAMPUNG TIMUR, LAMPUNG",4,139,58,197
https://kawalpemilu.org#24399,"SRIMENANTI, BANDAR SRIBHAWONO, LAMPUNG TIMUR, LAMPUNG",5,135,80,215
https://kawalpemilu.org#24399,"SRIMENANTI, BANDAR SRIBHAWONO, LAMPUNG TIMUR, LAMPUNG",6,113,78,191
https://kawalpemilu.org#24399,"SRIMENANTI, BANDAR SRIBHAWONO, LAMPUNG TIMUR, LAMPUNG",7,133,28,161
https://kawalpemilu.org#24399,"SRIMENANTI, BANDAR SRIBHAWONO, LAMPUNG TIMUR, LAMPUNG",8,131,66,197
https://kawalpemilu.org#24399,"SRIMENANTI, BANDAR SRIBHAWONO, LAMPUNG TIMUR, LAMPUNG",9,112,40,152
https://kawalpemilu.org#24399,"SRIMENANTI, BANDAR SRIBHAWONO, LAMPUNG TIMUR, LAMPUNG",10,153,60,213
https://kawalpemilu.org#24399,"SRIMENANTI, BANDAR SRIBHAWONO, LAMPUNG TIMUR, LAMPUNG",11,149,56,205
https://kawalpemilu.org#24399,"SRIMENANTI, BANDAR SRIBHAWONO, LAMPUNG TIMUR, LAMPUNG",12,89,45,134
https://kawalpemilu.org#24399,"SRIMENANTI, BANDAR SRIBHAWONO, LAMPUNG TIMUR, LAMPUNG",13,61,55,116
https://kawalpemilu.org#24399,"SRIMENANTI, BANDAR SRIBHAWONO, LAMPUNG TIMUR, LAMPUNG",14,85,80,165
https://kawalpemilu.org#24399,"SRIMENANTI, BANDAR SRIBHAWONO, LAMPUNG TIMUR, LAMPUNG",15,128,65,193
https://kawalpemilu.org#24399,"SRIMENANTI, BANDAR SRIBHAWONO, LAMPUNG TIMUR, LAMPUNG",16,108,45,153
https://kawalpemilu.org#24399,"SRIMENANTI, BANDAR SRIBHAWONO, LAMPUNG TIMUR, LAMPUNG",17,154,40,194
https://kawalpemilu.org#24400,"SRIPENDOWO, BANDAR SRIBHAWONO, LAMPUNG TIMUR, LAMPUNG",1,213,50,263
https://kawalpemilu.org#24400,"SRIPENDOWO, BANDAR SRIBHAWONO, LAMPUNG TIMUR, LAMPUNG",2,158,32,190
https://kawalpemilu.org#24400,"SRIPENDOWO, BANDAR SRIBHAWONO, LAMPUNG TIMUR, LAMPUNG",3,147,43,190
https://kawalpemilu.org#24400,"SRIPENDOWO, BANDAR SRIBHAWONO, LAMPUNG TIMUR, LAMPUNG",4,186,36,222
https://kawalpemilu.org#24400,"SRIPENDOWO, BANDAR SRIBHAWONO, LAMPUNG TIMUR, LAMPUNG",5,191,22,213
https://kawalpemilu.org#24400,"SRIPENDOWO, BANDAR SRIBHAWONO, LAMPUNG TIMUR, LAMPUNG",6,209,29,238
https://kawalpemilu.org#24400,"SRIPENDOWO, BANDAR SRIBHAWONO, LAMPUNG TIMUR, LAMPUNG",7,188,35,223
https://kawalpemilu.org#24400,"SRIPENDOWO, BANDAR SRIBHAWONO, LAMPUNG TIMUR, LAMPUNG",8,167,33,200
https://kawalpemilu.org#24400,"SRIPENDOWO, BANDAR SRIBHAWONO, LAMPUNG TIMUR, LAMPUNG",9,227,14,241
https://kawalpemilu.org#24400,"SRIPENDOWO, BANDAR SRIBHAWONO, LAMPUNG TIMUR, LAMPUNG",10,190,18,208
https://kawalpemilu.org#24400,"SRIPENDOWO, BANDAR SRIBHAWONO, LAMPUNG TIMUR, LAMPUNG",11,137,40,177
https://kawalpemilu.org#24400,"SRIPENDOWO, BANDAR SRIBHAWONO, LAMPUNG TIMUR, LAMPUNG",12,141,32,173
https://kawalpemilu.org#24400,"SRIPENDOWO, BANDAR SRIBHAWONO, LAMPUNG TIMUR, LAMPUNG",13,156,41,197
https://kawalpemilu.org#24400,"SRIPENDOWO, BANDAR SRIBHAWONO, LAMPUNG TIMUR, LAMPUNG",14,135,15,150
https://kawalpemilu.org#24400,"SRIPENDOWO, BANDAR SRIBHAWONO, LAMPUNG TIMUR, LAMPUNG",15,120,36,156
https://kawalpemilu.org#24400,"SRIPENDOWO, BANDAR SRIBHAWONO, LAMPUNG TIMUR, LAMPUNG",16,114,42,156
https://kawalpemilu.org#24401,"WARINGIN JAYA, BANDAR SRIBHAWONO, LAMPUNG TIMUR, LAMPUNG",1,152,45,197
https://kawalpemilu.org#24401,"WARINGIN JAYA, BANDAR SRIBHAWONO, LAMPUNG TIMUR, LAMPUNG",2,136,34,170
https://kawalpemilu.org#24401,"WARINGIN JAYA, BANDAR SRIBHAWONO, LAMPUNG TIMUR, LAMPUNG",3,162,34,196
https://kawalpemilu.org#24401,"WARINGIN JAYA, BANDAR SRIBHAWONO, LAMPUNG TIMUR, LAMPUNG",4,143,49,192
https://kawalpemilu.org#24401,"WARINGIN JAYA, BANDAR SRIBHAWONO, LAMPUNG TIMUR, LAMPUNG",5,141,30,171
https://kawalpemilu.org#24401,"WARINGIN JAYA, BANDAR SRIBHAWONO, LAMPUNG TIMUR, LAMPUNG",7,167,31,198
https://kawalpemilu.org#24402,"BANDAR AGUNG, BANDAR SRIBHAWONO, LAMPUNG TIMUR, LAMPUNG",1,133,31,164
https://kawalpemilu.org#24402,"BANDAR AGUNG, BANDAR SRIBHAWONO, LAMPUNG TIMUR, LAMPUNG",2,154,21,175
https://kawalpemilu.org#24402,"BANDAR AGUNG, BANDAR SRIBHAWONO, LAMPUNG TIMUR, LAMPUNG",3,150,20,170
https://kawalpemilu.org#24402,"BANDAR AGUNG, BANDAR SRIBHAWONO, LAMPUNG TIMUR, LAMPUNG",4,163,19,182
https://kawalpemilu.org#24402,"BANDAR AGUNG, BANDAR SRIBHAWONO, LAMPUNG TIMUR, LAMPUNG",5,151,18,169
https://kawalpemilu.org#24402,"BANDAR AGUNG, BANDAR SRIBHAWONO, LAMPUNG TIMUR, LAMPUNG",6,158,16,174
https://kawalpemilu.org#24402,"BANDAR AGUNG, BANDAR SRIBHAWONO, LAMPUNG TIMUR, LAMPUNG",7,117,15,135
https://kawalpemilu.org#24402,"BANDAR AGUNG, BANDAR SRIBHAWONO, LAMPUNG TIMUR, LAMPUNG",8,111,4,115
https://kawalpemilu.org#24402,"BANDAR AGUNG, BANDAR SRIBHAWONO, LAMPUNG TIMUR, LAMPUNG",9,168,20,188
https://kawalpemilu.org#24402,"BANDAR AGUNG, BANDAR SRIBHAWONO, LAMPUNG TIMUR, LAMPUNG",10,131,18,149
https://kawalpemilu.org#24402,"BANDAR AGUNG, BANDAR SRIBHAWONO, LAMPUNG TIMUR, LAMPUNG",11,154,23,177
https://kawalpemilu.org#24402,"BANDAR AGUNG, BANDAR SRIBHAWONO, LAMPUNG TIMUR, LAMPUNG",12,146,30,176
https://kawalpemilu.org#24402,"BANDAR AGUNG, BANDAR SRIBHAWONO, LAMPUNG TIMUR, LAMPUNG",13,166,17,183
https://kawalpemilu.org#24402,"BANDAR AGUNG, BANDAR SRIBHAWONO, LAMPUNG TIMUR, LAMPUNG",14,114,21,135
https://kawalpemilu.org#24402,"BANDAR AGUNG, BANDAR SRIBHAWONO, LAMPUNG TIMUR, LAMPUNG",15,168,16,184
https://kawalpemilu.org#24402,"BANDAR AGUNG, BANDAR SRIBHAWONO, LAMPUNG TIMUR, LAMPUNG",16,148,14,162
https://kawalpemilu.org#24402,"BANDAR AGUNG, BANDAR SRIBHAWONO, LAMPUNG TIMUR, LAMPUNG",17,135,20,155
https://kawalpemilu.org#24402,"BANDAR AGUNG, BANDAR SRIBHAWONO, LAMPUNG TIMUR, LAMPUNG",18,133,24,157
https://kawalpemilu.org#24402,"BANDAR AGUNG, BANDAR SRIBHAWONO, LAMPUNG TIMUR, LAMPUNG",19,147,14,161
https://kawalpemilu.org#24402,"BANDAR AGUNG, BANDAR SRIBHAWONO, LAMPUNG TIMUR, LAMPUNG",20,146,11,157
https://kawalpemilu.org#24402,"BANDAR AGUNG, BANDAR SRIBHAWONO, LAMPUNG TIMUR, LAMPUNG",21,142,22,164
https://kawalpemilu.org#24402,"BANDAR AGUNG, BANDAR SRIBHAWONO, LAMPUNG TIMUR, LAMPUNG",22,155,8,163
https://kawalpemilu.org#24402,"BANDAR AGUNG, BANDAR SRIBHAWONO, LAMPUNG TIMUR, LAMPUNG",23,146,18,164
https://kawalpemilu.org#24402,"BANDAR AGUNG, BANDAR SRIBHAWONO, LAMPUNG TIMUR, LAMPUNG",24,141,15,156
https://kawalpemilu.org#24402,"BANDAR AGUNG, BANDAR SRIBHAWONO, LAMPUNG TIMUR, LAMPUNG",25,144,20,164
https://kawalpemilu.org#24402,"BANDAR AGUNG, BANDAR SRIBHAWONO, LAMPUNG TIMUR, LAMPUNG",26,150,13,163
https://kawalpemilu.org#24402,"BANDAR AGUNG, BANDAR SRIBHAWONO, LAMPUNG TIMUR, LAMPUNG",27,141,14,155
https://kawalpemilu.org#24402,"BANDAR AGUNG, BANDAR SRIBHAWONO, LAMPUNG TIMUR, LAMPUNG",28,95,21,116
https://kawalpemilu.org#24402,"BANDAR AGUNG, BANDAR SRIBHAWONO, LAMPUNG TIMUR, LAMPUNG",29,96,22,118
https://kawalpemilu.org#24402,"BANDAR AGUNG, BANDAR SRIBHAWONO, LAMPUNG TIMUR, LAMPUNG",30,169,28,197
https://kawalpemilu.org#24402,"BANDAR AGUNG, BANDAR SRIBHAWONO, LAMPUNG TIMUR, LAMPUNG",31,163,23,186
https://kawalpemilu.org#24402,"BANDAR AGUNG, BANDAR SRIBHAWONO, LAMPUNG TIMUR, LAMPUNG",32,140,18,158
https://kawalpemilu.org#24402,"BANDAR AGUNG, BANDAR SRIBHAWONO, LAMPUNG TIMUR, LAMPUNG",33,193,16,209
https://kawalpemilu.org#24402,"BANDAR AGUNG, BANDAR SRIBHAWONO, LAMPUNG TIMUR, LAMPUNG",34,190,20,210
https://kawalpemilu.org#24402,"BANDAR AGUNG, BANDAR SRIBHAWONO, LAMPUNG TIMUR, LAMPUNG",35,150,23,173
https://kawalpemilu.org#24402,"BANDAR AGUNG, BANDAR SRIBHAWONO, LAMPUNG TIMUR, LAMPUNG",36,171,32,203
https://kawalpemilu.org#24402,"BANDAR AGUNG, BANDAR SRIBHAWONO, LAMPUNG TIMUR, LAMPUNG",37,140,33,173
https://kawalpemilu.org#24402,"BANDAR AGUNG, BANDAR SRIBHAWONO, LAMPUNG TIMUR, LAMPUNG",38,143,32,175
https://kawalpemilu.org#24402,"BANDAR AGUNG, BANDAR SRIBHAWONO, LAMPUNG TIMUR, LAMPUNG",39,162,16,178
https://kawalpemilu.org#24402,"BANDAR AGUNG, BANDAR SRIBHAWONO, LAMPUNG TIMUR, LAMPUNG",40,129,13,142
https://kawalpemilu.org#24402,"BANDAR AGUNG, BANDAR SRIBHAWONO, LAMPUNG TIMUR, LAMPUNG",41,145,9,154
https://kawalpemilu.org#24402,"BANDAR AGUNG, BANDAR SRIBHAWONO, LAMPUNG TIMUR, LAMPUNG",42,152,20,172
https://kawalpemilu.org#24402,"BANDAR AGUNG, BANDAR SRIBHAWONO, LAMPUNG TIMUR, LAMPUNG",43,199,12,211
https://kawalpemilu.org#24402,"BANDAR AGUNG, BANDAR SRIBHAWONO, LAMPUNG TIMUR, LAMPUNG",44,136,6,142
https://kawalpemilu.org#24402,"BANDAR AGUNG, BANDAR SRIBHAWONO, LAMPUNG TIMUR, LAMPUNG",45,141,8,149
https://kawalpemilu.org#24402,"BANDAR AGUNG, BANDAR SRIBHAWONO, LAMPUNG TIMUR, LAMPUNG",46,190,12,202
https://kawalpemilu.org#24402,"BANDAR AGUNG, BANDAR SRIBHAWONO, LAMPUNG TIMUR, LAMPUNG",47,163,6,169
https://kawalpemilu.org#24402,"BANDAR AGUNG, BANDAR SRIBHAWONO, LAMPUNG TIMUR, LAMPUNG",48,143,30,173
https://kawalpemilu.org#24402,"BANDAR AGUNG, BANDAR SRIBHAWONO, LAMPUNG TIMUR, LAMPUNG",49,233,15,248
https://kawalpemilu.org#24402,"BANDAR AGUNG, BANDAR SRIBHAWONO, LAMPUNG TIMUR, LAMPUNG",50,136,18,154
https://kawalpemilu.org#24402,"BANDAR AGUNG, BANDAR SRIBHAWONO, LAMPUNG TIMUR, LAMPUNG",51,129,26,155
https://kawalpemilu.org#24402,"BANDAR AGUNG, BANDAR SRIBHAWONO, LAMPUNG TIMUR, LAMPUNG",52,148,13,161
https://kawalpemilu.org#24402,"BANDAR AGUNG, BANDAR SRIBHAWONO, LAMPUNG TIMUR, LAMPUNG",53,131,24,155
https://kawalpemilu.org#24402,"BANDAR AGUNG, BANDAR SRIBHAWONO, LAMPUNG TIMUR, LAMPUNG",54,133,10,143
https://kawalpemilu.org#24402,"BANDAR AGUNG, BANDAR SRIBHAWONO, LAMPUNG TIMUR, LAMPUNG",55,147,11,158
https://kawalpemilu.org#24403,"MEKAR JAYA, BANDAR SRIBHAWONO, LAMPUNG TIMUR, LAMPUNG",1,0,0,0
https://kawalpemilu.org#24403,"MEKAR JAYA, BANDAR SRIBHAWONO, LAMPUNG TIMUR, LAMPUNG",2,0,0,0
https://kawalpemilu.org#24403,"MEKAR JAYA, BANDAR SRIBHAWONO, LAMPUNG TIMUR, LAMPUNG",3,0,0,0
https://kawalpemilu.org#24403,"MEKAR JAYA, BANDAR SRIBHAWONO, LAMPUNG TIMUR, LAMPUNG",4,0,0,0
https://kawalpemilu.org#24403,"MEKAR JAYA, BANDAR SRIBHAWONO, LAMPUNG TIMUR, LAMPUNG",6,173,13,186
https://kawalpemilu.org#24403,"MEKAR JAYA, BANDAR SRIBHAWONO, LAMPUNG TIMUR, LAMPUNG",7,166,16,182
https://kawalpemilu.org#24403,"MEKAR JAYA, BANDAR SRIBHAWONO, LAMPUNG TIMUR, LAMPUNG",8,138,25,163
https://kawalpemilu.org#24405,"MATARAM BARU, MATARAM BARU, LAMPUNG TIMUR, LAMPUNG",1,91,33,124
https://kawalpemilu.org#24405,"MATARAM BARU, MATARAM BARU, LAMPUNG TIMUR, LAMPUNG",2,0,0,0
https://kawalpemilu.org#24405,"MATARAM BARU, MATARAM BARU, LAMPUNG TIMUR, LAMPUNG",3,54,100,154
https://kawalpemilu.org#24405,"MATARAM BARU, MATARAM BARU, LAMPUNG TIMUR, LAMPUNG",4,57,115,172
https://kawalpemilu.org#24405,"MATARAM BARU, MATARAM BARU, LAMPUNG TIMUR, LAMPUNG",5,198,34,232
https://kawalpemilu.org#24405,"MATARAM BARU, MATARAM BARU, LAMPUNG TIMUR, LAMPUNG",6,153,38,191
https://kawalpemilu.org#24405,"MATARAM BARU, MATARAM BARU, LAMPUNG TIMUR, LAMPUNG",7,109,74,183
https://kawalpemilu.org#24405,"MATARAM BARU, MATARAM BARU, LAMPUNG TIMUR, LAMPUNG",8,147,29,176
https://kawalpemilu.org#24405,"MATARAM BARU, MATARAM BARU, LAMPUNG TIMUR, LAMPUNG",9,156,22,178
https://kawalpemilu.org#24405,"MATARAM BARU, MATARAM BARU, LAMPUNG TIMUR, LAMPUNG",10,135,36,171
https://kawalpemilu.org#24405,"MATARAM BARU, MATARAM BARU, LAMPUNG TIMUR, LAMPUNG",11,73,79,152
https://kawalpemilu.org#24405,"MATARAM BARU, MATARAM BARU, LAMPUNG TIMUR, LAMPUNG",12,106,50,156
https://kawalpemilu.org#24405,"MATARAM BARU, MATARAM BARU, LAMPUNG TIMUR, LAMPUNG",13,102,101,203
https://kawalpemilu.org#24405,"MATARAM BARU, MATARAM BARU, LAMPUNG TIMUR, LAMPUNG",14,139,41,180
https://kawalpemilu.org#24405,"MATARAM BARU, MATARAM BARU, LAMPUNG TIMUR, LAMPUNG",15,63,61,124
https://kawalpemilu.org#24405,"MATARAM BARU, MATARAM BARU, LAMPUNG TIMUR, LAMPUNG",16,61,72,133
https://kawalpemilu.org#24405,"MATARAM BARU, MATARAM BARU, LAMPUNG TIMUR, LAMPUNG",17,112,68,180
https://kawalpemilu.org#24405,"MATARAM BARU, MATARAM BARU, LAMPUNG TIMUR, LAMPUNG",18,88,81,169
https://kawalpemilu.org#24405,"MATARAM BARU, MATARAM BARU, LAMPUNG TIMUR, LAMPUNG",19,83,80,163
https://kawalpemilu.org#24405,"MATARAM BARU, MATARAM BARU, LAMPUNG TIMUR, LAMPUNG",20,69,74,143
https://kawalpemilu.org#24405,"MATARAM BARU, MATARAM BARU, LAMPUNG TIMUR, LAMPUNG",21,164,58,222
https://kawalpemilu.org#24405,"MATARAM BARU, MATARAM BARU, LAMPUNG TIMUR, LAMPUNG",22,139,56,195
https://kawalpemilu.org#24405,"MATARAM BARU, MATARAM BARU, LAMPUNG TIMUR, LAMPUNG",23,89,77,166
https://kawalpemilu.org#24405,"MATARAM BARU, MATARAM BARU, LAMPUNG TIMUR, LAMPUNG",24,68,83,151
https://kawalpemilu.org#24405,"MATARAM BARU, MATARAM BARU, LAMPUNG TIMUR, LAMPUNG",25,63,63,126
https://kawalpemilu.org#24405,"MATARAM BARU, MATARAM BARU, LAMPUNG TIMUR, LAMPUNG",26,75,39,114
https://kawalpemilu.org#24405,"MATARAM BARU, MATARAM BARU, LAMPUNG TIMUR, LAMPUNG",27,114,49,163
https://kawalpemilu.org#24405,"MATARAM BARU, MATARAM BARU, LAMPUNG TIMUR, LAMPUNG",28,108,49,157
https://kawalpemilu.org#24405,"MATARAM BARU, MATARAM BARU, LAMPUNG TIMUR, LAMPUNG",29,123,47,170
https://kawalpemilu.org#24406,"RAJABASA BARU, MATARAM BARU, LAMPUNG TIMUR, LAMPUNG",1,95,106,201
https://kawalpemilu.org#24406,"RAJABASA BARU, MATARAM BARU, LAMPUNG TIMUR, LAMPUNG",2,147,58,205
https://kawalpemilu.org#24406,"RAJABASA BARU, MATARAM BARU, LAMPUNG TIMUR, LAMPUNG",3,168,27,195
https://kawalpemilu.org#24406,"RAJABASA BARU, MATARAM BARU, LAMPUNG TIMUR, LAMPUNG",4,182,19,201
https://kawalpemilu.org#24406,"RAJABASA BARU, MATARAM BARU, LAMPUNG TIMUR, LAMPUNG",5,127,13,140
https://kawalpemilu.org#24406,"RAJABASA BARU, MATARAM BARU, LAMPUNG TIMUR, LAMPUNG",6,98,49,147
https://kawalpemilu.org#24406,"RAJABASA BARU, MATARAM BARU, LAMPUNG TIMUR, LAMPUNG",7,141,21,162
https://kawalpemilu.org#24406,"RAJABASA BARU, MATARAM BARU, LAMPUNG TIMUR, LAMPUNG",8,119,17,136
https://kawalpemilu.org#24406,"RAJABASA BARU, MATARAM BARU, LAMPUNG TIMUR, LAMPUNG",9,147,17,164
https://kawalpemilu.org#24406,"RAJABASA BARU, MATARAM BARU, LAMPUNG TIMUR, LAMPUNG",10,127,28,155
https://kawalpemilu.org#24406,"RAJABASA BARU, MATARAM BARU, LAMPUNG TIMUR, LAMPUNG",11,150,24,174
https://kawalpemilu.org#24406,"RAJABASA BARU, MATARAM BARU, LAMPUNG TIMUR, LAMPUNG",12,144,25,169
https://kawalpemilu.org#24406,"RAJABASA BARU, MATARAM BARU, LAMPUNG TIMUR, LAMPUNG",13,124,14,138
https://kawalpemilu.org#24406,"RAJABASA BARU, MATARAM BARU, LAMPUNG TIMUR, LAMPUNG",14,120,8,128
https://kawalpemilu.org#24407,"TELUK DALEM, MATARAM BARU, LAMPUNG TIMUR, LAMPUNG",1,38,118,156
https://kawalpemilu.org#24407,"TELUK DALEM, MATARAM BARU, LAMPUNG TIMUR, LAMPUNG",2,97,49,146
https://kawalpemilu.org#24407,"TELUK DALEM, MATARAM BARU, LAMPUNG TIMUR, LAMPUNG",3,101,29,130
https://kawalpemilu.org#24407,"TELUK DALEM, MATARAM BARU, LAMPUNG TIMUR, LAMPUNG",5,182,31,213
https://kawalpemilu.org#24407,"TELUK DALEM, MATARAM BARU, LAMPUNG TIMUR, LAMPUNG",6,115,45,160
https://kawalpemilu.org#24407,"TELUK DALEM, MATARAM BARU, LAMPUNG TIMUR, LAMPUNG",7,105,22,127
https://kawalpemilu.org#24407,"TELUK DALEM, MATARAM BARU, LAMPUNG TIMUR, LAMPUNG",8,57,63,120
https://kawalpemilu.org#24407,"TELUK DALEM, MATARAM BARU, LAMPUNG TIMUR, LAMPUNG",9,81,38,119
https://kawalpemilu.org#24407,"TELUK DALEM, MATARAM BARU, LAMPUNG TIMUR, LAMPUNG",10,71,46,117
https://kawalpemilu.org#24407,"TELUK DALEM, MATARAM BARU, LAMPUNG TIMUR, LAMPUNG",11,75,60,135
https://kawalpemilu.org#24407,"TELUK DALEM, MATARAM BARU, LAMPUNG TIMUR, LAMPUNG",12,149,25,174
https://kawalpemilu.org#24407,"TELUK DALEM, MATARAM BARU, LAMPUNG TIMUR, LAMPUNG",13,113,72,185
https://kawalpemilu.org#24407,"TELUK DALEM, MATARAM BARU, LAMPUNG TIMUR, LAMPUNG",14,147,33,180
https://kawalpemilu.org#24407,"TELUK DALEM, MATARAM BARU, LAMPUNG TIMUR, LAMPUNG",15,182,35,217
https://kawalpemilu.org#24407,"TELUK DALEM, MATARAM BARU, LAMPUNG TIMUR, LAMPUNG",16,134,19,153
https://kawalpemilu.org#24407,"TELUK DALEM, MATARAM BARU, LAMPUNG TIMUR, LAMPUNG",17,141,31,172
https://kawalpemilu.org#24408,"WAY ARENG, MATARAM BARU, LAMPUNG TIMUR, LAMPUNG",1,213,7,220
https://kawalpemilu.org#24408,"WAY ARENG, MATARAM BARU, LAMPUNG TIMUR, LAMPUNG",2,188,31,219
https://kawalpemilu.org#24408,"WAY ARENG, MATARAM BARU, LAMPUNG TIMUR, LAMPUNG",3,162,44,206
https://kawalpemilu.org#24408,"WAY ARENG, MATARAM BARU, LAMPUNG TIMUR, LAMPUNG",4,158,53,211
https://kawalpemilu.org#24408,"WAY ARENG, MATARAM BARU, LAMPUNG TIMUR, LAMPUNG",5,160,11,171
https://kawalpemilu.org#24408,"WAY ARENG, MATARAM BARU, LAMPUNG TIMUR, LAMPUNG",6,181,24,205
https://kawalpemilu.org#24409,"TULUNG PASIK, MATARAM BARU, LAMPUNG TIMUR, LAMPUNG",1,70,99,169
https://kawalpemilu.org#24409,"TULUNG PASIK, MATARAM BARU, LAMPUNG TIMUR, LAMPUNG",2,72,77,149
https://kawalpemilu.org#24409,"TULUNG PASIK, MATARAM BARU, LAMPUNG TIMUR, LAMPUNG",3,80,89,169
https://kawalpemilu.org#24409,"TULUNG PASIK, MATARAM BARU, LAMPUNG TIMUR, LAMPUNG",4,116,43,159
https://kawalpemilu.org#24409,"TULUNG PASIK, MATARAM BARU, LAMPUNG TIMUR, LAMPUNG",5,115,41,156
https://kawalpemilu.org#24409,"TULUNG PASIK, MATARAM BARU, LAMPUNG TIMUR, LAMPUNG",6,125,40,165
https://kawalpemilu.org#24409,"TULUNG PASIK, MATARAM BARU, LAMPUNG TIMUR, LAMPUNG",7,112,28,140
https://kawalpemilu.org#24409,"TULUNG PASIK, MATARAM BARU, LAMPUNG TIMUR, LAMPUNG",8,75,35,110
https://kawalpemilu.org#24409,"TULUNG PASIK, MATARAM BARU, LAMPUNG TIMUR, LAMPUNG",9,76,85,161
https://kawalpemilu.org#24409,"TULUNG PASIK, MATARAM BARU, LAMPUNG TIMUR, LAMPUNG",10,132,44,176
https://kawalpemilu.org#24409,"TULUNG PASIK, MATARAM BARU, LAMPUNG TIMUR, LAMPUNG",11,106,47,153
https://kawalpemilu.org#24410,"MANDALA SARI, MATARAM BARU, LAMPUNG TIMUR, LAMPUNG",1,115,42,157
https://kawalpemilu.org#24410,"MANDALA SARI, MATARAM BARU, LAMPUNG TIMUR, LAMPUNG",2,140,29,169
https://kawalpemilu.org#24410,"MANDALA SARI, MATARAM BARU, LAMPUNG TIMUR, LAMPUNG",3,131,16,147
https://kawalpemilu.org#24410,"MANDALA SARI, MATARAM BARU, LAMPUNG TIMUR, LAMPUNG",4,153,27,180
https://kawalpemilu.org#24410,"MANDALA SARI, MATARAM BARU, LAMPUNG TIMUR, LAMPUNG",5,140,20,160
https://kawalpemilu.org#24410,"MANDALA SARI, MATARAM BARU, LAMPUNG TIMUR, LAMPUNG",6,166,39,205
https://kawalpemilu.org#24410,"MANDALA SARI, MATARAM BARU, LAMPUNG TIMUR, LAMPUNG",7,147,41,188
https://kawalpemilu.org#24410,"MANDALA SARI, MATARAM BARU, LAMPUNG TIMUR, LAMPUNG",8,115,17,132
https://kawalpemilu.org#24411,"KEBON DAMAR, MATARAM BARU, LAMPUNG TIMUR, LAMPUNG",1,148,13,161
https://kawalpemilu.org#24411,"KEBON DAMAR, MATARAM BARU, LAMPUNG TIMUR, LAMPUNG",2,116,42,158
https://kawalpemilu.org#24411,"KEBON DAMAR, MATARAM BARU, LAMPUNG TIMUR, LAMPUNG",3,107,29,136
https://kawalpemilu.org#24411,"KEBON DAMAR, MATARAM BARU, LAMPUNG TIMUR, LAMPUNG",4,91,27,118
https://kawalpemilu.org#24411,"KEBON DAMAR, MATARAM BARU, LAMPUNG TIMUR, LAMPUNG",5,161,32,193
https://kawalpemilu.org#24411,"KEBON DAMAR, MATARAM BARU, LAMPUNG TIMUR, LAMPUNG",6,121,29,150
https://kawalpemilu.org#24411,"KEBON DAMAR, MATARAM BARU, LAMPUNG TIMUR, LAMPUNG",7,174,25,199
https://kawalpemilu.org#24411,"KEBON DAMAR, MATARAM BARU, LAMPUNG TIMUR, LAMPUNG",8,141,25,166
https://kawalpemilu.org#24411,"KEBON DAMAR, MATARAM BARU, LAMPUNG TIMUR, LAMPUNG",9,159,20,179
https://kawalpemilu.org#24411,"KEBON DAMAR, MATARAM BARU, LAMPUNG TIMUR, LAMPUNG",10,144,13,157
https://kawalpemilu.org#24413,"WANA, MELINTING, LAMPUNG TIMUR, LAMPUNG",1,32,123,155
https://kawalpemilu.org#24413,"WANA, MELINTING, LAMPUNG TIMUR, LAMPUNG",2,34,72,106
https://kawalpemilu.org#24413,"WANA, MELINTING, LAMPUNG TIMUR, LAMPUNG",3,35,89,124
https://kawalpemilu.org#24413,"WANA, MELINTING, LAMPUNG TIMUR, LAMPUNG",4,56,82,138
https://kawalpemilu.org#24413,"WANA, MELINTING, LAMPUNG TIMUR, LAMPUNG",5,52,94,146
https://kawalpemilu.org#24413,"WANA, MELINTING, LAMPUNG TIMUR, LAMPUNG",6,69,92,161
https://kawalpemilu.org#24413,"WANA, MELINTING, LAMPUNG TIMUR, LAMPUNG",7,33,116,149
https://kawalpemilu.org#24413,"WANA, MELINTING, LAMPUNG TIMUR, LAMPUNG",8,46,135,181
https://kawalpemilu.org#24413,"WANA, MELINTING, LAMPUNG TIMUR, LAMPUNG",9,26,164,190
https://kawalpemilu.org#24413,"WANA, MELINTING, LAMPUNG TIMUR, LAMPUNG",10,171,26,197
https://kawalpemilu.org#24413,"WANA, MELINTING, LAMPUNG TIMUR, LAMPUNG",11,176,45,221
https://kawalpemilu.org#24413,"WANA, MELINTING, LAMPUNG TIMUR, LAMPUNG",12,155,42,197
https://kawalpemilu.org#24413,"WANA, MELINTING, LAMPUNG TIMUR, LAMPUNG",13,113,56,169
https://kawalpemilu.org#24413,"WANA, MELINTING, LAMPUNG TIMUR, LAMPUNG",14,128,78,206
https://kawalpemilu.org#24413,"WANA, MELINTING, LAMPUNG TIMUR, LAMPUNG",15,98,85,183
https://kawalpemilu.org#24413,"WANA, MELINTING, LAMPUNG TIMUR, LAMPUNG",16,48,170,218
https://kawalpemilu.org#24413,"WANA, MELINTING, LAMPUNG TIMUR, LAMPUNG",17,55,142,197
https://kawalpemilu.org#24413,"WANA, MELINTING, LAMPUNG TIMUR, LAMPUNG",18,111,32,143
https://kawalpemilu.org#24413,"WANA, MELINTING, LAMPUNG TIMUR, LAMPUNG",19,75,42,117
https://kawalpemilu.org#24413,"WANA, MELINTING, LAMPUNG TIMUR, LAMPUNG",20,40,111,151
https://kawalpemilu.org#24413,"WANA, MELINTING, LAMPUNG TIMUR, LAMPUNG",21,18,95,113
https://kawalpemilu.org#24413,"WANA, MELINTING, LAMPUNG TIMUR, LAMPUNG",22,38,134,172
https://kawalpemilu.org#24413,"WANA, MELINTING, LAMPUNG TIMUR, LAMPUNG",23,154,35,189
https://kawalpemilu.org#24413,"WANA, MELINTING, LAMPUNG TIMUR, LAMPUNG",24,155,28,183
https://kawalpemilu.org#24413,"WANA, MELINTING, LAMPUNG TIMUR, LAMPUNG",25,163,9,172
https://kawalpemilu.org#24413,"WANA, MELINTING, LAMPUNG TIMUR, LAMPUNG",27,202,24,226
https://kawalpemilu.org#24413,"WANA, MELINTING, LAMPUNG TIMUR, LAMPUNG",28,135,47,182
https://kawalpemilu.org#24413,"WANA, MELINTING, LAMPUNG TIMUR, LAMPUNG",29,177,9,186
https://kawalpemilu.org#24413,"WANA, MELINTING, LAMPUNG TIMUR, LAMPUNG",30,76,27,103
https://kawalpemilu.org#24413,"WANA, MELINTING, LAMPUNG TIMUR, LAMPUNG",31,84,74,158
https://kawalpemilu.org#24414,"TANJUNG AJI, MELINTING, LAMPUNG TIMUR, LAMPUNG",1,107,98,205
https://kawalpemilu.org#24414,"TANJUNG AJI, MELINTING, LAMPUNG TIMUR, LAMPUNG",2,88,98,186
https://kawalpemilu.org#24414,"TANJUNG AJI, MELINTING, LAMPUNG TIMUR, LAMPUNG",3,76,118,194
https://kawalpemilu.org#24414,"TANJUNG AJI, MELINTING, LAMPUNG TIMUR, LAMPUNG",4,78,85,163
https://kawalpemilu.org#24414,"TANJUNG AJI, MELINTING, LAMPUNG TIMUR, LAMPUNG",5,83,115,198
https://kawalpemilu.org#24414,"TANJUNG AJI, MELINTING, LAMPUNG TIMUR, LAMPUNG",6,148,39,187
https://kawalpemilu.org#24414,"TANJUNG AJI, MELINTING, LAMPUNG TIMUR, LAMPUNG",7,113,98,211
https://kawalpemilu.org#24414,"TANJUNG AJI, MELINTING, LAMPUNG TIMUR, LAMPUNG",8,77,61,138
https://kawalpemilu.org#24414,"TANJUNG AJI, MELINTING, LAMPUNG TIMUR, LAMPUNG",9,39,51,90
https://kawalpemilu.org#24414,"TANJUNG AJI, MELINTING, LAMPUNG TIMUR, LAMPUNG",10,74,85,159
https://kawalpemilu.org#24414,"TANJUNG AJI, MELINTING, LAMPUNG TIMUR, LAMPUNG",11,75,113,188
https://kawalpemilu.org#24414,"TANJUNG AJI, MELINTING, LAMPUNG TIMUR, LAMPUNG",12,132,21,153
https://kawalpemilu.org#24414,"TANJUNG AJI, MELINTING, LAMPUNG TIMUR, LAMPUNG",13,164,20,184
https://kawalpemilu.org#24415,"TEBING, MELINTING, LAMPUNG TIMUR, LAMPUNG",1,39,159,198
https://kawalpemilu.org#24415,"TEBING, MELINTING, LAMPUNG TIMUR, LAMPUNG",2,30,113,143
https://kawalpemilu.org#24415,"TEBING, MELINTING, LAMPUNG TIMUR, LAMPUNG",3,30,152,182
https://kawalpemilu.org#24415,"TEBING, MELINTING, LAMPUNG TIMUR, LAMPUNG",4,82,111,193
https://kawalpemilu.org#24415,"TEBING, MELINTING, LAMPUNG TIMUR, LAMPUNG",5,36,114,150
https://kawalpemilu.org#24415,"TEBING, MELINTING, LAMPUNG TIMUR, LAMPUNG",6,35,104,139
https://kawalpemilu.org#24415,"TEBING, MELINTING, LAMPUNG TIMUR, LAMPUNG",7,58,92,150
https://kawalpemilu.org#24415,"TEBING, MELINTING, LAMPUNG TIMUR, LAMPUNG",8,38,86,124
https://kawalpemilu.org#24415,"TEBING, MELINTING, LAMPUNG TIMUR, LAMPUNG",9,108,39,147
https://kawalpemilu.org#24415,"TEBING, MELINTING, LAMPUNG TIMUR, LAMPUNG",10,91,60,151
https://kawalpemilu.org#24415,"TEBING, MELINTING, LAMPUNG TIMUR, LAMPUNG",11,78,51,129
https://kawalpemilu.org#24415,"TEBING, MELINTING, LAMPUNG TIMUR, LAMPUNG",12,100,39,139
https://kawalpemilu.org#24416,"SIDO MAKMUR, MELINTING, LAMPUNG TIMUR, LAMPUNG",1,182,30,212
https://kawalpemilu.org#24416,"SIDO MAKMUR, MELINTING, LAMPUNG TIMUR, LAMPUNG",2,161,55,216
https://kawalpemilu.org#24416,"SIDO MAKMUR, MELINTING, LAMPUNG TIMUR, LAMPUNG",3,151,54,205
https://kawalpemilu.org#24416,"SIDO MAKMUR, MELINTING, LAMPUNG TIMUR, LAMPUNG",4,120,49,169
https://kawalpemilu.org#24416,"SIDO MAKMUR, MELINTING, LAMPUNG TIMUR, LAMPUNG",5,101,58,159
https://kawalpemilu.org#24416,"SIDO MAKMUR, MELINTING, LAMPUNG TIMUR, LAMPUNG",6,96,60,156
https://kawalpemilu.org#24416,"SIDO MAKMUR, MELINTING, LAMPUNG TIMUR, LAMPUNG",7,101,64,165
https://kawalpemilu.org#24416,"SIDO MAKMUR, MELINTING, LAMPUNG TIMUR, LAMPUNG",8,101,81,182
https://kawalpemilu.org#24416,"SIDO MAKMUR, MELINTING, LAMPUNG TIMUR, LAMPUNG",9,147,75,0
https://kawalpemilu.org#24416,"SIDO MAKMUR, MELINTING, LAMPUNG TIMUR, LAMPUNG",10,154,18,172
https://kawalpemilu.org#24416,"SIDO MAKMUR, MELINTING, LAMPUNG TIMUR, LAMPUNG",11,165,20,185
https://kawalpemilu.org#24416,"SIDO MAKMUR, MELINTING, LAMPUNG TIMUR, LAMPUNG",12,139,10,149
https://kawalpemilu.org#24417,"ITIK RENDAY, MELINTING, LAMPUNG TIMUR, LAMPUNG",1,191,21,212
https://kawalpemilu.org#24417,"ITIK RENDAY, MELINTING, LAMPUNG TIMUR, LAMPUNG",2,171,33,204
https://kawalpemilu.org#24417,"ITIK RENDAY, MELINTING, LAMPUNG TIMUR, LAMPUNG",3,108,40,148
https://kawalpemilu.org#24417,"ITIK RENDAY, MELINTING, LAMPUNG TIMUR, LAMPUNG",4,127,27,154
https://kawalpemilu.org#24417,"ITIK RENDAY, MELINTING, LAMPUNG TIMUR, LAMPUNG",5,108,17,125
https://kawalpemilu.org#24417,"ITIK RENDAY, MELINTING, LAMPUNG TIMUR, LAMPUNG",6,145,10,155
https://kawalpemilu.org#24417,"ITIK RENDAY, MELINTING, LAMPUNG TIMUR, LAMPUNG",7,136,12,148
https://kawalpemilu.org#24417,"ITIK RENDAY, MELINTING, LAMPUNG TIMUR, LAMPUNG",8,112,15,127
https://kawalpemilu.org#24417,"ITIK RENDAY, MELINTING, LAMPUNG TIMUR, LAMPUNG",9,81,52,133
https://kawalpemilu.org#24417,"ITIK RENDAY, MELINTING, LAMPUNG TIMUR, LAMPUNG",10,0,0,0
https://kawalpemilu.org#24418,"SUMBER HADI, MELINTING, LAMPUNG TIMUR, LAMPUNG",1,166,38,204
https://kawalpemilu.org#24418,"SUMBER HADI, MELINTING, LAMPUNG TIMUR, LAMPUNG",2,134,62,196
https://kawalpemilu.org#24418,"SUMBER HADI, MELINTING, LAMPUNG TIMUR, LAMPUNG",3,150,12,162
https://kawalpemilu.org#24418,"SUMBER HADI, MELINTING, LAMPUNG TIMUR, LAMPUNG",4,125,43,168
https://kawalpemilu.org#24418,"SUMBER HADI, MELINTING, LAMPUNG TIMUR, LAMPUNG",5,166,41,207
https://kawalpemilu.org#24418,"SUMBER HADI, MELINTING, LAMPUNG TIMUR, LAMPUNG",6,112,56,168
https://kawalpemilu.org#24418,"SUMBER HADI, MELINTING, LAMPUNG TIMUR, LAMPUNG",7,130,35,165
https://kawalpemilu.org#24418,"SUMBER HADI, MELINTING, LAMPUNG TIMUR, LAMPUNG",8,163,24,187
https://kawalpemilu.org#24418,"SUMBER HADI, MELINTING, LAMPUNG TIMUR, LAMPUNG",9,172,39,211
https://kawalpemilu.org#24418,"SUMBER HADI, MELINTING, LAMPUNG TIMUR, LAMPUNG",10,190,41,231
https://kawalpemilu.org#24418,"SUMBER HADI, MELINTING, LAMPUNG TIMUR, LAMPUNG",11,142,15,157
https://kawalpemilu.org#24418,"SUMBER HADI, MELINTING, LAMPUNG TIMUR, LAMPUNG",12,174,41,215
https://kawalpemilu.org#24420,"NEGERI AGUNG, GUNUNG PELINDUNG, LAMPUNG TIMUR, LAMPUNG",1,32,148,180
https://kawalpemilu.org#24420,"NEGERI AGUNG, GUNUNG PELINDUNG, LAMPUNG TIMUR, LAMPUNG",2,30,123,153
https://kawalpemilu.org#24420,"NEGERI AGUNG, GUNUNG PELINDUNG, LAMPUNG TIMUR, LAMPUNG",3,26,172,198
https://kawalpemilu.org#24420,"NEGERI AGUNG, GUNUNG PELINDUNG, LAMPUNG TIMUR, LAMPUNG",4,22,134,156
https://kawalpemilu.org#24420,"NEGERI AGUNG, GUNUNG PELINDUNG, LAMPUNG TIMUR, LAMPUNG",5,98,84,182
https://kawalpemilu.org#24420,"NEGERI AGUNG, GUNUNG PELINDUNG, LAMPUNG TIMUR, LAMPUNG",6,104,11,115
https://kawalpemilu.org#24420,"NEGERI AGUNG, GUNUNG PELINDUNG, LAMPUNG TIMUR, LAMPUNG",7,107,17,124
https://kawalpemilu.org#24420,"NEGERI AGUNG, GUNUNG PELINDUNG, LAMPUNG TIMUR, LAMPUNG",8,154,18,172
https://kawalpemilu.org#24420,"NEGERI AGUNG, GUNUNG PELINDUNG, LAMPUNG TIMUR, LAMPUNG",9,133,17,150
https://kawalpemilu.org#24420,"NEGERI AGUNG, GUNUNG PELINDUNG, LAMPUNG TIMUR, LAMPUNG",10,80,12,92
https://kawalpemilu.org#24420,"NEGERI AGUNG, GUNUNG PELINDUNG, LAMPUNG TIMUR, LAMPUNG",11,174,17,191
https://kawalpemilu.org#24420,"NEGERI AGUNG, GUNUNG PELINDUNG, LAMPUNG TIMUR, LAMPUNG",12,162,30,192
https://kawalpemilu.org#24420,"NEGERI AGUNG, GUNUNG PELINDUNG, LAMPUNG TIMUR, LAMPUNG",13,140,49,189
https://kawalpemilu.org#24420,"NEGERI AGUNG, GUNUNG PELINDUNG, LAMPUNG TIMUR, LAMPUNG",14,134,44,178
https://kawalpemilu.org#24420,"NEGERI AGUNG, GUNUNG PELINDUNG, LAMPUNG TIMUR, LAMPUNG",15,98,60,158
https://kawalpemilu.org#24420,"NEGERI AGUNG, GUNUNG PELINDUNG, LAMPUNG TIMUR, LAMPUNG",16,131,54,185
https://kawalpemilu.org#24420,"NEGERI AGUNG, GUNUNG PELINDUNG, LAMPUNG TIMUR, LAMPUNG",17,106,34,140
https://kawalpemilu.org#24421,"PEMPEN, GUNUNG PELINDUNG, LAMPUNG TIMUR, LAMPUNG",1,55,107,162
https://kawalpemilu.org#24421,"PEMPEN, GUNUNG PELINDUNG, LAMPUNG TIMUR, LAMPUNG",2,35,95,130
https://kawalpemilu.org#24421,"PEMPEN, GUNUNG PELINDUNG, LAMPUNG TIMUR, LAMPUNG",3,63,111,174
https://kawalpemilu.org#24421,"PEMPEN, GUNUNG PELINDUNG, LAMPUNG TIMUR, LAMPUNG",4,57,100,157
https://kawalpemilu.org#24421,"PEMPEN, GUNUNG PELINDUNG, LAMPUNG TIMUR, LAMPUNG",5,40,84,124
https://kawalpemilu.org#24421,"PEMPEN, GUNUNG PELINDUNG, LAMPUNG TIMUR, LAMPUNG",6,62,65,127
https://kawalpemilu.org#24421,"PEMPEN, GUNUNG PELINDUNG, LAMPUNG TIMUR, LAMPUNG",7,125,76,201
https://kawalpemilu.org#24421,"PEMPEN, GUNUNG PELINDUNG, LAMPUNG TIMUR, LAMPUNG",8,93,69,162
https://kawalpemilu.org#24421,"PEMPEN, GUNUNG PELINDUNG, LAMPUNG TIMUR, LAMPUNG",9,88,27,115
https://kawalpemilu.org#24421,"PEMPEN, GUNUNG PELINDUNG, LAMPUNG TIMUR, LAMPUNG",10,60,82,142
https://kawalpemilu.org#24421,"PEMPEN, GUNUNG PELINDUNG, LAMPUNG TIMUR, LAMPUNG",11,46,73,119
https://kawalpemilu.org#24422,"WAY MILI, GUNUNG PELINDUNG, LAMPUNG TIMUR, LAMPUNG",1,136,24,160
https://kawalpemilu.org#24422,"WAY MILI, GUNUNG PELINDUNG, LAMPUNG TIMUR, LAMPUNG",2,165,14,179
https://kawalpemilu.org#24422,"WAY MILI, GUNUNG PELINDUNG, LAMPUNG TIMUR, LAMPUNG",3,179,47,226
https://kawalpemilu.org#24422,"WAY MILI, GUNUNG PELINDUNG, LAMPUNG TIMUR, LAMPUNG",5,91,47,138
https://kawalpemilu.org#24422,"WAY MILI, GUNUNG PELINDUNG, LAMPUNG TIMUR, LAMPUNG",6,132,4,136
https://kawalpemilu.org#24422,"WAY MILI, GUNUNG PELINDUNG, LAMPUNG TIMUR, LAMPUNG",7,97,53,150
https://kawalpemilu.org#24422,"WAY MILI, GUNUNG PELINDUNG, LAMPUNG TIMUR, LAMPUNG",8,121,37,158
https://kawalpemilu.org#24422,"WAY MILI, GUNUNG PELINDUNG, LAMPUNG TIMUR, LAMPUNG",9,122,28,150
https://kawalpemilu.org#24422,"WAY MILI, GUNUNG PELINDUNG, LAMPUNG TIMUR, LAMPUNG",10,131,14,145
https://kawalpemilu.org#24423,"PELINDUNG JAYA, GUNUNG PELINDUNG, LAMPUNG TIMUR, LAMPUNG",2,52,50,102
https://kawalpemilu.org#24423,"PELINDUNG JAYA, GUNUNG PELINDUNG, LAMPUNG TIMUR, LAMPUNG",3,108,28,137
https://kawalpemilu.org#24423,"PELINDUNG JAYA, GUNUNG PELINDUNG, LAMPUNG TIMUR, LAMPUNG",4,103,19,122
https://kawalpemilu.org#24423,"PELINDUNG JAYA, GUNUNG PELINDUNG, LAMPUNG TIMUR, LAMPUNG",5,144,14,158
https://kawalpemilu.org#24423,"PELINDUNG JAYA, GUNUNG PELINDUNG, LAMPUNG TIMUR, LAMPUNG",6,110,33,143
https://kawalpemilu.org#24423,"PELINDUNG JAYA, GUNUNG PELINDUNG, LAMPUNG TIMUR, LAMPUNG",7,90,73,163
https://kawalpemilu.org#24423,"PELINDUNG JAYA, GUNUNG PELINDUNG, LAMPUNG TIMUR, LAMPUNG",8,43,81,124
https://kawalpemilu.org#24423,"PELINDUNG JAYA, GUNUNG PELINDUNG, LAMPUNG TIMUR, LAMPUNG",9,78,59,137
https://kawalpemilu.org#24423,"PELINDUNG JAYA, GUNUNG PELINDUNG, LAMPUNG TIMUR, LAMPUNG",10,86,42,128
https://kawalpemilu.org#24423,"PELINDUNG JAYA, GUNUNG PELINDUNG, LAMPUNG TIMUR, LAMPUNG",11,109,32,141
https://kawalpemilu.org#24423,"PELINDUNG JAYA, GUNUNG PELINDUNG, LAMPUNG TIMUR, LAMPUNG",12,90,49,139
https://kawalpemilu.org#24423,"PELINDUNG JAYA, GUNUNG PELINDUNG, LAMPUNG TIMUR, LAMPUNG",13,92,9,101
https://kawalpemilu.org#24423,"PELINDUNG JAYA, GUNUNG PELINDUNG, LAMPUNG TIMUR, LAMPUNG",14,109,22,131
https://kawalpemilu.org#24423,"PELINDUNG JAYA, GUNUNG PELINDUNG, LAMPUNG TIMUR, LAMPUNG",15,95,21,116
https://kawalpemilu.org#24423,"PELINDUNG JAYA, GUNUNG PELINDUNG, LAMPUNG TIMUR, LAMPUNG",16,121,17,138
https://kawalpemilu.org#24423,"PELINDUNG JAYA, GUNUNG PELINDUNG, LAMPUNG TIMUR, LAMPUNG",17,172,4,176
https://kawalpemilu.org#24423,"PELINDUNG JAYA, GUNUNG PELINDUNG, LAMPUNG TIMUR, LAMPUNG",18,140,15,155
https://kawalpemilu.org#24423,"PELINDUNG JAYA, GUNUNG PELINDUNG, LAMPUNG TIMUR, LAMPUNG",19,128,23,151
https://kawalpemilu.org#24423,"PELINDUNG JAYA, GUNUNG PELINDUNG, LAMPUNG TIMUR, LAMPUNG",20,139,12,151
https://kawalpemilu.org#24423,"PELINDUNG JAYA, GUNUNG PELINDUNG, LAMPUNG TIMUR, LAMPUNG",21,130,19,149
https://kawalpemilu.org#24424,"NIBUNG, GUNUNG PELINDUNG, LAMPUNG TIMUR, LAMPUNG",1,99,26,125
https://kawalpemilu.org#24424,"NIBUNG, GUNUNG PELINDUNG, LAMPUNG TIMUR, LAMPUNG",2,78,37,115
https://kawalpemilu.org#24424,"NIBUNG, GUNUNG PELINDUNG, LAMPUNG TIMUR, LAMPUNG",3,24,100,124
https://kawalpemilu.org#24424,"NIBUNG, GUNUNG PELINDUNG, LAMPUNG TIMUR, LAMPUNG",4,38,89,127
https://kawalpemilu.org#24424,"NIBUNG, GUNUNG PELINDUNG, LAMPUNG TIMUR, LAMPUNG",5,65,93,158
https://kawalpemilu.org#24424,"NIBUNG, GUNUNG PELINDUNG, LAMPUNG TIMUR, LAMPUNG",6,70,93,163
https://kawalpemilu.org#24424,"NIBUNG, GUNUNG PELINDUNG, LAMPUNG TIMUR, LAMPUNG",7,79,89,164
https://kawalpemilu.org#24424,"NIBUNG, GUNUNG PELINDUNG, LAMPUNG TIMUR, LAMPUNG",8,144,50,194
https://kawalpemilu.org#24424,"NIBUNG, GUNUNG PELINDUNG, LAMPUNG TIMUR, LAMPUNG",11,159,45,204
https://kawalpemilu.org#24424,"NIBUNG, GUNUNG PELINDUNG, LAMPUNG TIMUR, LAMPUNG",12,153,32,185
https://kawalpemilu.org#24424,"NIBUNG, GUNUNG PELINDUNG, LAMPUNG TIMUR, LAMPUNG",13,137,18,155
https://kawalpemilu.org#24424,"NIBUNG, GUNUNG PELINDUNG, LAMPUNG TIMUR, LAMPUNG",15,125,11,136
https://kawalpemilu.org#24424,"NIBUNG, GUNUNG PELINDUNG, LAMPUNG TIMUR, LAMPUNG",16,102,50,152
https://kawalpemilu.org#24424,"NIBUNG, GUNUNG PELINDUNG, LAMPUNG TIMUR, LAMPUNG",17,106,32,138
https://kawalpemilu.org#24424,"NIBUNG, GUNUNG PELINDUNG, LAMPUNG TIMUR, LAMPUNG",18,110,26,136
https://kawalpemilu.org#24424,"NIBUNG, GUNUNG PELINDUNG, LAMPUNG TIMUR, LAMPUNG",19,125,18,143
https://kawalpemilu.org#24426,"PASIR SAKTI, PASIR SAKTI, LAMPUNG TIMUR, LAMPUNG",1,146,54,200
https://kawalpemilu.org#24426,"PASIR SAKTI, PASIR SAKTI, LAMPUNG TIMUR, LAMPUNG",2,146,49,195
https://kawalpemilu.org#24426,"PASIR SAKTI, PASIR SAKTI, LAMPUNG TIMUR, LAMPUNG",3,135,49,184
https://kawalpemilu.org#24426,"PASIR SAKTI, PASIR SAKTI, LAMPUNG TIMUR, LAMPUNG",4,135,44,179
https://kawalpemilu.org#24426,"PASIR SAKTI, PASIR SAKTI, LAMPUNG TIMUR, LAMPUNG",5,142,30,172
https://kawalpemilu.org#24426,"PASIR SAKTI, PASIR SAKTI, LAMPUNG TIMUR, LAMPUNG",6,181,28,209
https://kawalpemilu.org#24426,"PASIR SAKTI, PASIR SAKTI, LAMPUNG TIMUR, LAMPUNG",7,125,18,143
https://kawalpemilu.org#24426,"PASIR SAKTI, PASIR SAKTI, LAMPUNG TIMUR, LAMPUNG",8,130,23,153
https://kawalpemilu.org#24426,"PASIR SAKTI, PASIR SAKTI, LAMPUNG TIMUR, LAMPUNG",9,181,24,205
https://kawalpemilu.org#24426,"PASIR SAKTI, PASIR SAKTI, LAMPUNG TIMUR, LAMPUNG",10,171,51,222
https://kawalpemilu.org#24426,"PASIR SAKTI, PASIR SAKTI, LAMPUNG TIMUR, LAMPUNG",11,71,17,88
https://kawalpemilu.org#24426,"PASIR SAKTI, PASIR SAKTI, LAMPUNG TIMUR, LAMPUNG",12,153,25,178
https://kawalpemilu.org#24426,"PASIR SAKTI, PASIR SAKTI, LAMPUNG TIMUR, LAMPUNG",13,202,4,206
https://kawalpemilu.org#24426,"PASIR SAKTI, PASIR SAKTI, LAMPUNG TIMUR, LAMPUNG",14,177,10,187
https://kawalpemilu.org#24426,"PASIR SAKTI, PASIR SAKTI, LAMPUNG TIMUR, LAMPUNG",15,101,22,123
https://kawalpemilu.org#24426,"PASIR SAKTI, PASIR SAKTI, LAMPUNG TIMUR, LAMPUNG",16,122,11,133
https://kawalpemilu.org#24426,"PASIR SAKTI, PASIR SAKTI, LAMPUNG TIMUR, LAMPUNG",17,84,20,104
https://kawalpemilu.org#24426,"PASIR SAKTI, PASIR SAKTI, LAMPUNG TIMUR, LAMPUNG",18,145,23,168
https://kawalpemilu.org#24426,"PASIR SAKTI, PASIR SAKTI, LAMPUNG TIMUR, LAMPUNG",19,160,13,173
https://kawalpemilu.org#24426,"PASIR SAKTI, PASIR SAKTI, LAMPUNG TIMUR, LAMPUNG",20,84,20,104
https://kawalpemilu.org#24427,"MULYO SARI, PASIR SAKTI, LAMPUNG TIMUR, LAMPUNG",1,116,43,159
https://kawalpemilu.org#24427,"MULYO SARI, PASIR SAKTI, LAMPUNG TIMUR, LAMPUNG",2,155,40,195
https://kawalpemilu.org#24427,"MULYO SARI, PASIR SAKTI, LAMPUNG TIMUR, LAMPUNG",3,147,38,186
https://kawalpemilu.org#24427,"MULYO SARI, PASIR SAKTI, LAMPUNG TIMUR, LAMPUNG",4,155,31,186
https://kawalpemilu.org#24427,"MULYO SARI, PASIR SAKTI, LAMPUNG TIMUR, LAMPUNG",5,202,47,249
https://kawalpemilu.org#24427,"MULYO SARI, PASIR SAKTI, LAMPUNG TIMUR, LAMPUNG",6,144,17,161
https://kawalpemilu.org#24427,"MULYO SARI, PASIR SAKTI, LAMPUNG TIMUR, LAMPUNG",7,166,16,182
https://kawalpemilu.org#24427,"MULYO SARI, PASIR SAKTI, LAMPUNG TIMUR, LAMPUNG",8,184,33,217
https://kawalpemilu.org#24427,"MULYO SARI, PASIR SAKTI, LAMPUNG TIMUR, LAMPUNG",9,160,22,182
https://kawalpemilu.org#24427,"MULYO SARI, PASIR SAKTI, LAMPUNG TIMUR, LAMPUNG",10,133,47,180
https://kawalpemilu.org#24427,"MULYO SARI, PASIR SAKTI, LAMPUNG TIMUR, LAMPUNG",11,168,18,186
https://kawalpemilu.org#24427,"MULYO SARI, PASIR SAKTI, LAMPUNG TIMUR, LAMPUNG",12,136,79,215
https://kawalpemilu.org#24427,"MULYO SARI, PASIR SAKTI, LAMPUNG TIMUR, LAMPUNG",13,163,28,191
https://kawalpemilu.org#24427,"MULYO SARI, PASIR SAKTI, LAMPUNG TIMUR, LAMPUNG",14,128,62,190
https://kawalpemilu.org#24427,"MULYO SARI, PASIR SAKTI, LAMPUNG TIMUR, LAMPUNG",15,164,21,185
https://kawalpemilu.org#24427,"MULYO SARI, PASIR SAKTI, LAMPUNG TIMUR, LAMPUNG",16,166,34,200
https://kawalpemilu.org#24427,"MULYO SARI, PASIR SAKTI, LAMPUNG TIMUR, LAMPUNG",17,139,24,163
https://kawalpemilu.org#24427,"MULYO SARI, PASIR SAKTI, LAMPUNG TIMUR, LAMPUNG",18,125,8,133
https://kawalpemilu.org#24427,"MULYO SARI, PASIR SAKTI, LAMPUNG TIMUR, LAMPUNG",19,216,6,222
https://kawalpemilu.org#24427,"MULYO SARI, PASIR SAKTI, LAMPUNG TIMUR, LAMPUNG",20,159,8,167
https://kawalpemilu.org#24428,"PURWO REJO, PASIR SAKTI, LAMPUNG TIMUR, LAMPUNG",1,168,38,206
https://kawalpemilu.org#24428,"PURWO REJO, PASIR SAKTI, LAMPUNG TIMUR, LAMPUNG",2,107,51,158
https://kawalpemilu.org#24428,"PURWO REJO, PASIR SAKTI, LAMPUNG TIMUR, LAMPUNG",3,123,28,151
https://kawalpemilu.org#24428,"PURWO REJO, PASIR SAKTI, LAMPUNG TIMUR, LAMPUNG",4,106,26,132
https://kawalpemilu.org#24428,"PURWO REJO, PASIR SAKTI, LAMPUNG TIMUR, LAMPUNG",5,195,40,235
https://kawalpemilu.org#24428,"PURWO REJO, PASIR SAKTI, LAMPUNG TIMUR, LAMPUNG",6,139,59,198
https://kawalpemilu.org#24428,"PURWO REJO, PASIR SAKTI, LAMPUNG TIMUR, LAMPUNG",7,92,37,129
https://kawalpemilu.org#24428,"PURWO REJO, PASIR SAKTI, LAMPUNG TIMUR, LAMPUNG",8,109,23,132
https://kawalpemilu.org#24428,"PURWO REJO, PASIR SAKTI, LAMPUNG TIMUR, LAMPUNG",9,117,19,136
https://kawalpemilu.org#24428,"PURWO REJO, PASIR SAKTI, LAMPUNG TIMUR, LAMPUNG",10,106,19,125
https://kawalpemilu.org#24428,"PURWO REJO, PASIR SAKTI, LAMPUNG TIMUR, LAMPUNG",11,68,68,136
https://kawalpemilu.org#24428,"PURWO REJO, PASIR SAKTI, LAMPUNG TIMUR, LAMPUNG",12,65,79,144
https://kawalpemilu.org#24428,"PURWO REJO, PASIR SAKTI, LAMPUNG TIMUR, LAMPUNG",13,63,49,112
https://kawalpemilu.org#24429,"REJO MULYO, PASIR SAKTI, LAMPUNG TIMUR, LAMPUNG",1,136,15,151
https://kawalpemilu.org#24429,"REJO MULYO, PASIR SAKTI, LAMPUNG TIMUR, LAMPUNG",2,148,46,194
https://kawalpemilu.org#24429,"REJO MULYO, PASIR SAKTI, LAMPUNG TIMUR, LAMPUNG",3,124,50,174
https://kawalpemilu.org#24429,"REJO MULYO, PASIR SAKTI, LAMPUNG TIMUR, LAMPUNG",4,119,67,186
https://kawalpemilu.org#24429,"REJO MULYO, PASIR SAKTI, LAMPUNG TIMUR, LAMPUNG",5,131,25,156
https://kawalpemilu.org#24429,"REJO MULYO, PASIR SAKTI, LAMPUNG TIMUR, LAMPUNG",6,164,19,183
https://kawalpemilu.org#24429,"REJO MULYO, PASIR SAKTI, LAMPUNG TIMUR, LAMPUNG",7,117,15,132
https://kawalpemilu.org#24429,"REJO MULYO, PASIR SAKTI, LAMPUNG TIMUR, LAMPUNG",8,114,11,125
https://kawalpemilu.org#24429,"REJO MULYO, PASIR SAKTI, LAMPUNG TIMUR, LAMPUNG",9,138,29,167
https://kawalpemilu.org#24429,"REJO MULYO, PASIR SAKTI, LAMPUNG TIMUR, LAMPUNG",10,85,17,102
https://kawalpemilu.org#24429,"REJO MULYO, PASIR SAKTI, LAMPUNG TIMUR, LAMPUNG",11,140,14,154
https://kawalpemilu.org#24429,"REJO MULYO, PASIR SAKTI, LAMPUNG TIMUR, LAMPUNG",12,123,10,133
https://kawalpemilu.org#24429,"REJO MULYO, PASIR SAKTI, LAMPUNG TIMUR, LAMPUNG",13,201,8,209
https://kawalpemilu.org#24429,"REJO MULYO, PASIR SAKTI, LAMPUNG TIMUR, LAMPUNG",14,142,15,157
https://kawalpemilu.org#24429,"REJO MULYO, PASIR SAKTI, LAMPUNG TIMUR, LAMPUNG",15,159,33,192
https://kawalpemilu.org#24429,"REJO MULYO, PASIR SAKTI, LAMPUNG TIMUR, LAMPUNG",16,163,15,178
https://kawalpemilu.org#24429,"REJO MULYO, PASIR SAKTI, LAMPUNG TIMUR, LAMPUNG",17,155,24,179
https://kawalpemilu.org#24429,"REJO MULYO, PASIR SAKTI, LAMPUNG TIMUR, LAMPUNG",18,130,11,141
https://kawalpemilu.org#24430,"KEDUNG RINGIN, PASIR SAKTI, LAMPUNG TIMUR, LAMPUNG",1,168,40,208
https://kawalpemilu.org#24430,"KEDUNG RINGIN, PASIR SAKTI, LAMPUNG TIMUR, LAMPUNG",2,162,33,195
https://kawalpemilu.org#24430,"KEDUNG RINGIN, PASIR SAKTI, LAMPUNG TIMUR, LAMPUNG",3,162,13,175
https://kawalpemilu.org#24430,"KEDUNG RINGIN, PASIR SAKTI, LAMPUNG TIMUR, LAMPUNG",4,172,13,185
https://kawalpemilu.org#24430,"KEDUNG RINGIN, PASIR SAKTI, LAMPUNG TIMUR, LAMPUNG",5,155,10,165
https://kawalpemilu.org#24430,"KEDUNG RINGIN, PASIR SAKTI, LAMPUNG TIMUR, LAMPUNG",6,161,19,180
https://kawalpemilu.org#24430,"KEDUNG RINGIN, PASIR SAKTI, LAMPUNG TIMUR, LAMPUNG",7,155,13,168
https://kawalpemilu.org#24430,"KEDUNG RINGIN, PASIR SAKTI, LAMPUNG TIMUR, LAMPUNG",8,174,16,190
https://kawalpemilu.org#24430,"KEDUNG RINGIN, PASIR SAKTI, LAMPUNG TIMUR, LAMPUNG",9,128,22,150
https://kawalpemilu.org#24430,"KEDUNG RINGIN, PASIR SAKTI, LAMPUNG TIMUR, LAMPUNG",10,157,14,171
https://kawalpemilu.org#24430,"KEDUNG RINGIN, PASIR SAKTI, LAMPUNG TIMUR, LAMPUNG",11,126,17,143
https://kawalpemilu.org#24430,"KEDUNG RINGIN, PASIR SAKTI, LAMPUNG TIMUR, LAMPUNG",12,128,12,140
https://kawalpemilu.org#24430,"KEDUNG RINGIN, PASIR SAKTI, LAMPUNG TIMUR, LAMPUNG",13,140,28,168
https://kawalpemilu.org#24431,"LABUHAN RATU, PASIR SAKTI, LAMPUNG TIMUR, LAMPUNG",1,123,82,205
https://kawalpemilu.org#24431,"LABUHAN RATU, PASIR SAKTI, LAMPUNG TIMUR, LAMPUNG",2,121,42,163
https://kawalpemilu.org#24431,"LABUHAN RATU, PASIR SAKTI, LAMPUNG TIMUR, LAMPUNG",3,66,33,99
https://kawalpemilu.org#24431,"LABUHAN RATU, PASIR SAKTI, LAMPUNG TIMUR, LAMPUNG",4,79,27,106
https://kawalpemilu.org#24431,"LABUHAN RATU, PASIR SAKTI, LAMPUNG TIMUR, LAMPUNG",5,123,38,161
https://kawalpemilu.org#24431,"LABUHAN RATU, PASIR SAKTI, LAMPUNG TIMUR, LAMPUNG",6,136,36,172
https://kawalpemilu.org#24431,"LABUHAN RATU, PASIR SAKTI, LAMPUNG TIMUR, LAMPUNG",7,109,27,136
https://kawalpemilu.org#24431,"LABUHAN RATU, PASIR SAKTI, LAMPUNG TIMUR, LAMPUNG",8,104,22,126
https://kawalpemilu.org#24431,"LABUHAN RATU, PASIR SAKTI, LAMPUNG TIMUR, LAMPUNG",9,150,35,185
https://kawalpemilu.org#24431,"LABUHAN RATU, PASIR SAKTI, LAMPUNG TIMUR, LAMPUNG",10,153,29,182
https://kawalpemilu.org#24431,"LABUHAN RATU, PASIR SAKTI, LAMPUNG TIMUR, LAMPUNG",11,134,25,159
https://kawalpemilu.org#24431,"LABUHAN RATU, PASIR SAKTI, LAMPUNG TIMUR, LAMPUNG",12,148,30,178
https://kawalpemilu.org#24431,"LABUHAN RATU, PASIR SAKTI, LAMPUNG TIMUR, LAMPUNG",13,118,21,139
https://kawalpemilu.org#24431,"LABUHAN RATU, PASIR SAKTI, LAMPUNG TIMUR, LAMPUNG",14,90,13,103
https://kawalpemilu.org#24431,"LABUHAN RATU, PASIR SAKTI, LAMPUNG TIMUR, LAMPUNG",15,120,18,138
https://kawalpemilu.org#24431,"LABUHAN RATU, PASIR SAKTI, LAMPUNG TIMUR, LAMPUNG",16,114,26,140
https://kawalpemilu.org#24431,"LABUHAN RATU, PASIR SAKTI, LAMPUNG TIMUR, LAMPUNG",17,67,52,119
https://kawalpemilu.org#24431,"LABUHAN RATU, PASIR SAKTI, LAMPUNG TIMUR, LAMPUNG",18,57,79,136
https://kawalpemilu.org#24432,"SUMUR KUCING, PASIR SAKTI, LAMPUNG TIMUR, LAMPUNG",1,33,113,146
https://kawalpemilu.org#24432,"SUMUR KUCING, PASIR SAKTI, LAMPUNG TIMUR, LAMPUNG",2,68,59,127
https://kawalpemilu.org#24432,"SUMUR KUCING, PASIR SAKTI, LAMPUNG TIMUR, LAMPUNG",3,157,26,183
https://kawalpemilu.org#24432,"SUMUR KUCING, PASIR SAKTI, LAMPUNG TIMUR, LAMPUNG",4,181,20,201
https://kawalpemilu.org#24432,"SUMUR KUCING, PASIR SAKTI, LAMPUNG TIMUR, LAMPUNG",5,218,14,232
https://kawalpemilu.org#24432,"SUMUR KUCING, PASIR SAKTI, LAMPUNG TIMUR, LAMPUNG",6,166,20,186
https://kawalpemilu.org#24432,"SUMUR KUCING, PASIR SAKTI, LAMPUNG TIMUR, LAMPUNG",7,143,8,151
https://kawalpemilu.org#24432,"SUMUR KUCING, PASIR SAKTI, LAMPUNG TIMUR, LAMPUNG",8,114,14,128
https://kawalpemilu.org#24432,"SUMUR KUCING, PASIR SAKTI, LAMPUNG TIMUR, LAMPUNG",9,138,14,152
https://kawalpemilu.org#24432,"SUMUR KUCING, PASIR SAKTI, LAMPUNG TIMUR, LAMPUNG",10,75,10,85
https://kawalpemilu.org#24432,"SUMUR KUCING, PASIR SAKTI, LAMPUNG TIMUR, LAMPUNG",11,186,22,208
https://kawalpemilu.org#24432,"SUMUR KUCING, PASIR SAKTI, LAMPUNG TIMUR, LAMPUNG",12,171,15,186
https://kawalpemilu.org#24432,"SUMUR KUCING, PASIR SAKTI, LAMPUNG TIMUR, LAMPUNG",13,103,18,121
https://kawalpemilu.org#24432,"SUMUR KUCING, PASIR SAKTI, LAMPUNG TIMUR, LAMPUNG",14,100,9,109
https://kawalpemilu.org#24432,"SUMUR KUCING, PASIR SAKTI, LAMPUNG TIMUR, LAMPUNG",15,114,3,117
https://kawalpemilu.org#24432,"SUMUR KUCING, PASIR SAKTI, LAMPUNG TIMUR, LAMPUNG",16,37,18,55
https://kawalpemilu.org#24433,"MEKAR SARI, PASIR SAKTI, LAMPUNG TIMUR, LAMPUNG",1,132,9,141
https://kawalpemilu.org#24433,"MEKAR SARI, PASIR SAKTI, LAMPUNG TIMUR, LAMPUNG",2,124,14,138
https://kawalpemilu.org#24433,"MEKAR SARI, PASIR SAKTI, LAMPUNG TIMUR, LAMPUNG",4,128,15,143
https://kawalpemilu.org#24433,"MEKAR SARI, PASIR SAKTI, LAMPUNG TIMUR, LAMPUNG",5,145,24,169
https://kawalpemilu.org#24433,"MEKAR SARI, PASIR SAKTI, LAMPUNG TIMUR, LAMPUNG",6,128,39,167
https://kawalpemilu.org#24433,"MEKAR SARI, PASIR SAKTI, LAMPUNG TIMUR, LAMPUNG",7,105,16,121
https://kawalpemilu.org#24433,"MEKAR SARI, PASIR SAKTI, LAMPUNG TIMUR, LAMPUNG",9,86,21,107
https://kawalpemilu.org#24433,"MEKAR SARI, PASIR SAKTI, LAMPUNG TIMUR, LAMPUNG",10,79,36,115
https://kawalpemilu.org#24433,"MEKAR SARI, PASIR SAKTI, LAMPUNG TIMUR, LAMPUNG",11,151,26,177
https://kawalpemilu.org#24435,"SUMBER REJO, WAWAY KARYA, LAMPUNG TIMUR, LAMPUNG",1,142,45,187
https://kawalpemilu.org#24435,"SUMBER REJO, WAWAY KARYA, LAMPUNG TIMUR, LAMPUNG",2,86,110,196
https://kawalpemilu.org#24435,"SUMBER REJO, WAWAY KARYA, LAMPUNG TIMUR, LAMPUNG",3,100,73,173
https://kawalpemilu.org#24435,"SUMBER REJO, WAWAY KARYA, LAMPUNG TIMUR, LAMPUNG",4,130,67,197
https://kawalpemilu.org#24435,"SUMBER REJO, WAWAY KARYA, LAMPUNG TIMUR, LAMPUNG",5,150,57,207
https://kawalpemilu.org#24435,"SUMBER REJO, WAWAY KARYA, LAMPUNG TIMUR, LAMPUNG",6,139,56,195
https://kawalpemilu.org#24435,"SUMBER REJO, WAWAY KARYA, LAMPUNG TIMUR, LAMPUNG",7,171,39,210
https://kawalpemilu.org#24435,"SUMBER REJO, WAWAY KARYA, LAMPUNG TIMUR, LAMPUNG",8,79,53,132
https://kawalpemilu.org#24435,"SUMBER REJO, WAWAY KARYA, LAMPUNG TIMUR, LAMPUNG",9,133,19,152
https://kawalpemilu.org#24435,"SUMBER REJO, WAWAY KARYA, LAMPUNG TIMUR, LAMPUNG",10,125,26,151
https://kawalpemilu.org#24435,"SUMBER REJO, WAWAY KARYA, LAMPUNG TIMUR, LAMPUNG",11,108,50,158
https://kawalpemilu.org#24435,"SUMBER REJO, WAWAY KARYA, LAMPUNG TIMUR, LAMPUNG",12,127,50,177
https://kawalpemilu.org#24435,"SUMBER REJO, WAWAY KARYA, LAMPUNG TIMUR, LAMPUNG",13,129,12,141
https://kawalpemilu.org#24435,"SUMBER REJO, WAWAY KARYA, LAMPUNG TIMUR, LAMPUNG",14,115,30,145
https://kawalpemilu.org#24436,"NGESTI KARYA, WAWAY KARYA, LAMPUNG TIMUR, LAMPUNG",1,85,103,188
https://kawalpemilu.org#24436,"NGESTI KARYA, WAWAY KARYA, LAMPUNG TIMUR, LAMPUNG",2,166,30,196
https://kawalpemilu.org#24436,"NGESTI KARYA, WAWAY KARYA, LAMPUNG TIMUR, LAMPUNG",3,85,94,179
https://kawalpemilu.org#24436,"NGESTI KARYA, WAWAY KARYA, LAMPUNG TIMUR, LAMPUNG",4,101,30,131
https://kawalpemilu.org#24436,"NGESTI KARYA, WAWAY KARYA, LAMPUNG TIMUR, LAMPUNG",5,122,41,163
https://kawalpemilu.org#24436,"NGESTI KARYA, WAWAY KARYA, LAMPUNG TIMUR, LAMPUNG",6,144,25,169
https://kawalpemilu.org#24436,"NGESTI KARYA, WAWAY KARYA, LAMPUNG TIMUR, LAMPUNG",7,127,47,174
https://kawalpemilu.org#24436,"NGESTI KARYA, WAWAY KARYA, LAMPUNG TIMUR, LAMPUNG",8,144,42,186
https://kawalpemilu.org#24436,"NGESTI KARYA, WAWAY KARYA, LAMPUNG TIMUR, LAMPUNG",9,195,30,195
https://kawalpemilu.org#24436,"NGESTI KARYA, WAWAY KARYA, LAMPUNG TIMUR, LAMPUNG",10,145,47,192
https://kawalpemilu.org#24436,"NGESTI KARYA, WAWAY KARYA, LAMPUNG TIMUR, LAMPUNG",11,153,31,184
https://kawalpemilu.org#24436,"NGESTI KARYA, WAWAY KARYA, LAMPUNG TIMUR, LAMPUNG",12,120,39,159
https://kawalpemilu.org#24436,"NGESTI KARYA, WAWAY KARYA, LAMPUNG TIMUR, LAMPUNG",13,124,46,170
https://kawalpemilu.org#24437,"TRI TUNGGAL, WAWAY KARYA, LAMPUNG TIMUR, LAMPUNG",1,184,9,193
https://kawalpemilu.org#24437,"TRI TUNGGAL, WAWAY KARYA, LAMPUNG TIMUR, LAMPUNG",2,173,27,200
https://kawalpemilu.org#24437,"TRI TUNGGAL, WAWAY KARYA, LAMPUNG TIMUR, LAMPUNG",3,182,37,219
https://kawalpemilu.org#24437,"TRI TUNGGAL, WAWAY KARYA, LAMPUNG TIMUR, LAMPUNG",4,103,20,123
https://kawalpemilu.org#24437,"TRI TUNGGAL, WAWAY KARYA, LAMPUNG TIMUR, LAMPUNG",6,161,28,189
https://kawalpemilu.org#24437,"TRI TUNGGAL, WAWAY KARYA, LAMPUNG TIMUR, LAMPUNG",7,143,30,173
https://kawalpemilu.org#24437,"TRI TUNGGAL, WAWAY KARYA, LAMPUNG TIMUR, LAMPUNG",8,95,6,101
https://kawalpemilu.org#24438,"SIDO RAHAYU, WAWAY KARYA, LAMPUNG TIMUR, LAMPUNG",1,168,29,197
https://kawalpemilu.org#24438,"SIDO RAHAYU, WAWAY KARYA, LAMPUNG TIMUR, LAMPUNG",2,111,52,163
https://kawalpemilu.org#24438,"SIDO RAHAYU, WAWAY KARYA, LAMPUNG TIMUR, LAMPUNG",3,169,48,217
https://kawalpemilu.org#24438,"SIDO RAHAYU, WAWAY KARYA, LAMPUNG TIMUR, LAMPUNG",4,119,36,155
https://kawalpemilu.org#24438,"SIDO RAHAYU, WAWAY KARYA, LAMPUNG TIMUR, LAMPUNG",5,136,27,163
https://kawalpemilu.org#24438,"SIDO RAHAYU, WAWAY KARYA, LAMPUNG TIMUR, LAMPUNG",6,138,39,177
https://kawalpemilu.org#24438,"SIDO RAHAYU, WAWAY KARYA, LAMPUNG TIMUR, LAMPUNG",7,178,21,199
https://kawalpemilu.org#24438,"SIDO RAHAYU, WAWAY KARYA, LAMPUNG TIMUR, LAMPUNG",8,195,11,206
https://kawalpemilu.org#24438,"SIDO RAHAYU, WAWAY KARYA, LAMPUNG TIMUR, LAMPUNG",9,176,33,209
https://kawalpemilu.org#24438,"SIDO RAHAYU, WAWAY KARYA, LAMPUNG TIMUR, LAMPUNG",10,154,41,195
https://kawalpemilu.org#24438,"SIDO RAHAYU, WAWAY KARYA, LAMPUNG TIMUR, LAMPUNG",11,170,37,207
https://kawalpemilu.org#24438,"SIDO RAHAYU, WAWAY KARYA, LAMPUNG TIMUR, LAMPUNG",12,204,12,216
https://kawalpemilu.org#24439,"JEMBRANA, WAWAY KARYA, LAMPUNG TIMUR, LAMPUNG",1,204,30,234
https://kawalpemilu.org#24439,"JEMBRANA, WAWAY KARYA, LAMPUNG TIMUR, LAMPUNG",2,156,37,193
https://kawalpemilu.org#24439,"JEMBRANA, WAWAY KARYA, LAMPUNG TIMUR, LAMPUNG",3,110,36,146
https://kawalpemilu.org#24439,"JEMBRANA, WAWAY KARYA, LAMPUNG TIMUR, LAMPUNG",4,121,41,162
https://kawalpemilu.org#24439,"JEMBRANA, WAWAY KARYA, LAMPUNG TIMUR, LAMPUNG",5,105,34,139
https://kawalpemilu.org#24439,"JEMBRANA, WAWAY KARYA, LAMPUNG TIMUR, LAMPUNG",6,178,7,185
https://kawalpemilu.org#24439,"JEMBRANA, WAWAY KARYA, LAMPUNG TIMUR, LAMPUNG",7,144,9,153
https://kawalpemilu.org#24439,"JEMBRANA, WAWAY KARYA, LAMPUNG TIMUR, LAMPUNG",8,133,22,155
https://kawalpemilu.org#24439,"JEMBRANA, WAWAY KARYA, LAMPUNG TIMUR, LAMPUNG",9,83,16,99
https://kawalpemilu.org#24439,"JEMBRANA, WAWAY KARYA, LAMPUNG TIMUR, LAMPUNG",10,113,8,121
https://kawalpemilu.org#24439,"JEMBRANA, WAWAY KARYA, LAMPUNG TIMUR, LAMPUNG",11,123,2,125
https://kawalpemilu.org#24440,"TANJUNG WANGI, WAWAY KARYA, LAMPUNG TIMUR, LAMPUNG",1,85,45,130
https://kawalpemilu.org#24440,"TANJUNG WANGI, WAWAY KARYA, LAMPUNG TIMUR, LAMPUNG",2,102,20,122
https://kawalpemilu.org#24440,"TANJUNG WANGI, WAWAY KARYA, LAMPUNG TIMUR, LAMPUNG",3,113,31,144
https://kawalpemilu.org#24440,"TANJUNG WANGI, WAWAY KARYA, LAMPUNG TIMUR, LAMPUNG",4,133,22,155
https://kawalpemilu.org#24440,"TANJUNG WANGI, WAWAY KARYA, LAMPUNG TIMUR, LAMPUNG",5,148,14,162
https://kawalpemilu.org#24440,"TANJUNG WANGI, WAWAY KARYA, LAMPUNG TIMUR, LAMPUNG",6,127,26,153
https://kawalpemilu.org#24440,"TANJUNG WANGI, WAWAY KARYA, LAMPUNG TIMUR, LAMPUNG",7,144,43,187
https://kawalpemilu.org#24440,"TANJUNG WANGI, WAWAY KARYA, LAMPUNG TIMUR, LAMPUNG",8,128,45,173
https://kawalpemilu.org#24440,"TANJUNG WANGI, WAWAY KARYA, LAMPUNG TIMUR, LAMPUNG",9,88,16,104
https://kawalpemilu.org#24440,"TANJUNG WANGI, WAWAY KARYA, LAMPUNG TIMUR, LAMPUNG",10,81,20,101
https://kawalpemilu.org#24440,"TANJUNG WANGI, WAWAY KARYA, LAMPUNG TIMUR, LAMPUNG",11,152,33,185
https://kawalpemilu.org#24440,"TANJUNG WANGI, WAWAY KARYA, LAMPUNG TIMUR, LAMPUNG",12,150,34,184
https://kawalpemilu.org#24441,"MARGA BATIN, WAWAY KARYA, LAMPUNG TIMUR, LAMPUNG",1,109,52,161
https://kawalpemilu.org#24441,"MARGA BATIN, WAWAY KARYA, LAMPUNG TIMUR, LAMPUNG",2,90,35,125
https://kawalpemilu.org#24441,"MARGA BATIN, WAWAY KARYA, LAMPUNG TIMUR, LAMPUNG",4,68,42,110
https://kawalpemilu.org#24441,"MARGA BATIN, WAWAY KARYA, LAMPUNG TIMUR, LAMPUNG",5,101,24,125
https://kawalpemilu.org#24441,"MARGA BATIN, WAWAY KARYA, LAMPUNG TIMUR, LAMPUNG",6,129,24,153
https://kawalpemilu.org#24441,"MARGA BATIN, WAWAY KARYA, LAMPUNG TIMUR, LAMPUNG",8,72,44,116
https://kawalpemilu.org#24441,"MARGA BATIN, WAWAY KARYA, LAMPUNG TIMUR, LAMPUNG",11,96,67,163
https://kawalpemilu.org#24441,"MARGA BATIN, WAWAY KARYA, LAMPUNG TIMUR, LAMPUNG",13,88,49,137
https://kawalpemilu.org#24441,"MARGA BATIN, WAWAY KARYA, LAMPUNG TIMUR, LAMPUNG",14,71,74,145
https://kawalpemilu.org#24441,"MARGA BATIN, WAWAY KARYA, LAMPUNG TIMUR, LAMPUNG",16,121,41,162
https://kawalpemilu.org#24441,"MARGA BATIN, WAWAY KARYA, LAMPUNG TIMUR, LAMPUNG",17,119,46,165
https://kawalpemilu.org#24441,"MARGA BATIN, WAWAY KARYA, LAMPUNG TIMUR, LAMPUNG",18,111,46,157
https://kawalpemilu.org#24442,"MEKAR KARYA, WAWAY KARYA, LAMPUNG TIMUR, LAMPUNG",1,127,14,141
https://kawalpemilu.org#24442,"MEKAR KARYA, WAWAY KARYA, LAMPUNG TIMUR, LAMPUNG",2,105,6,111
https://kawalpemilu.org#24442,"MEKAR KARYA, WAWAY KARYA, LAMPUNG TIMUR, LAMPUNG",3,152,24,176
https://kawalpemilu.org#24442,"MEKAR KARYA, WAWAY KARYA, LAMPUNG TIMUR, LAMPUNG",4,151,30,181
https://kawalpemilu.org#24442,"MEKAR KARYA, WAWAY KARYA, LAMPUNG TIMUR, LAMPUNG",5,169,28,197
https://kawalpemilu.org#24442,"MEKAR KARYA, WAWAY KARYA, LAMPUNG TIMUR, LAMPUNG",6,134,7,141
https://kawalpemilu.org#24442,"MEKAR KARYA, WAWAY KARYA, LAMPUNG TIMUR, LAMPUNG",8,142,7,149
https://kawalpemilu.org#24442,"MEKAR KARYA, WAWAY KARYA, LAMPUNG TIMUR, LAMPUNG",9,116,86,202
https://kawalpemilu.org#24442,"MEKAR KARYA, WAWAY KARYA, LAMPUNG TIMUR, LAMPUNG",10,117,53,170
https://kawalpemilu.org#24443,"SUMBER JAYA, WAWAY KARYA, LAMPUNG TIMUR, LAMPUNG",1,131,36,167
https://kawalpemilu.org#24443,"SUMBER JAYA, WAWAY KARYA, LAMPUNG TIMUR, LAMPUNG",2,121,49,170
https://kawalpemilu.org#24443,"SUMBER JAYA, WAWAY KARYA, LAMPUNG TIMUR, LAMPUNG",3,133,34,167
https://kawalpemilu.org#24443,"SUMBER JAYA, WAWAY KARYA, LAMPUNG TIMUR, LAMPUNG",4,165,27,192
https://kawalpemilu.org#24443,"SUMBER JAYA, WAWAY KARYA, LAMPUNG TIMUR, LAMPUNG",5,116,48,164
https://kawalpemilu.org#24443,"SUMBER JAYA, WAWAY KARYA, LAMPUNG TIMUR, LAMPUNG",6,102,57,159
https://kawalpemilu.org#24443,"SUMBER JAYA, WAWAY KARYA, LAMPUNG TIMUR, LAMPUNG",7,116,58,174
https://kawalpemilu.org#24443,"SUMBER JAYA, WAWAY KARYA, LAMPUNG TIMUR, LAMPUNG",8,119,47,166
https://kawalpemilu.org#24443,"SUMBER JAYA, WAWAY KARYA, LAMPUNG TIMUR, LAMPUNG",9,118,18,136
https://kawalpemilu.org#24443,"SUMBER JAYA, WAWAY KARYA, LAMPUNG TIMUR, LAMPUNG",10,140,44,184
https://kawalpemilu.org#24443,"SUMBER JAYA, WAWAY KARYA, LAMPUNG TIMUR, LAMPUNG",11,91,38,129
https://kawalpemilu.org#24443,"SUMBER JAYA, WAWAY KARYA, LAMPUNG TIMUR, LAMPUNG",12,121,40,161
https://kawalpemilu.org#24443,"SUMBER JAYA, WAWAY KARYA, LAMPUNG TIMUR, LAMPUNG",13,104,55,159
https://kawalpemilu.org#24444,"KARYA BASUKI, WAWAY KARYA, LAMPUNG TIMUR, LAMPUNG",1,106,34,140
https://kawalpemilu.org#24444,"KARYA BASUKI, WAWAY KARYA, LAMPUNG TIMUR, LAMPUNG",3,131,23,154
https://kawalpemilu.org#24444,"KARYA BASUKI, WAWAY KARYA, LAMPUNG TIMUR, LAMPUNG",4,133,34,167
https://kawalpemilu.org#24444,"KARYA BASUKI, WAWAY KARYA, LAMPUNG TIMUR, LAMPUNG",5,77,13,90
https://kawalpemilu.org#24444,"KARYA BASUKI, WAWAY KARYA, LAMPUNG TIMUR, LAMPUNG",6,149,21,170
https://kawalpemilu.org#24444,"KARYA BASUKI, WAWAY KARYA, LAMPUNG TIMUR, LAMPUNG",7,88,31,119
https://kawalpemilu.org#24444,"KARYA BASUKI, WAWAY KARYA, LAMPUNG TIMUR, LAMPUNG",8,107,23,130
https://kawalpemilu.org#24444,"KARYA BASUKI, WAWAY KARYA, LAMPUNG TIMUR, LAMPUNG",9,106,22,128
https://kawalpemilu.org#24444,"KARYA BASUKI, WAWAY KARYA, LAMPUNG TIMUR, LAMPUNG",10,77,35,112
https://kawalpemilu.org#24445,"KARANG ANOM, WAWAY KARYA, LAMPUNG TIMUR, LAMPUNG",1,141,34,175
https://kawalpemilu.org#24445,"KARANG ANOM, WAWAY KARYA, LAMPUNG TIMUR, LAMPUNG",2,151,34,185
https://kawalpemilu.org#24445,"KARANG ANOM, WAWAY KARYA, LAMPUNG TIMUR, LAMPUNG",3,77,22,99
https://kawalpemilu.org#24445,"KARANG ANOM, WAWAY KARYA, LAMPUNG TIMUR, LAMPUNG",4,86,22,108
https://kawalpemilu.org#24445,"KARANG ANOM, WAWAY KARYA, LAMPUNG TIMUR, LAMPUNG",5,168,28,196
https://kawalpemilu.org#24445,"KARANG ANOM, WAWAY KARYA, LAMPUNG TIMUR, LAMPUNG",6,166,24,190
https://kawalpemilu.org#24445,"KARANG ANOM, WAWAY KARYA, LAMPUNG TIMUR, LAMPUNG",7,158,18,176
https://kawalpemilu.org#24445,"KARANG ANOM, WAWAY KARYA, LAMPUNG TIMUR, LAMPUNG",8,128,49,177
https://kawalpemilu.org#24447,"LABUHAN RATU, LABUHAN RATU, LAMPUNG TIMUR, LAMPUNG",1,49,167,216
https://kawalpemilu.org#24447,"LABUHAN RATU, LABUHAN RATU, LAMPUNG TIMUR, LAMPUNG",2,81,120,201
https://kawalpemilu.org#24447,"LABUHAN RATU, LABUHAN RATU, LAMPUNG TIMUR, LAMPUNG",3,128,56,184
https://kawalpemilu.org#24447,"LABUHAN RATU, LABUHAN RATU, LAMPUNG TIMUR, LAMPUNG",4,119,22,141
https://kawalpemilu.org#24447,"LABUHAN RATU, LABUHAN RATU, LAMPUNG TIMUR, LAMPUNG",5,150,84,234
https://kawalpemilu.org#24447,"LABUHAN RATU, LABUHAN RATU, LAMPUNG TIMUR, LAMPUNG",6,144,71,215
https://kawalpemilu.org#24447,"LABUHAN RATU, LABUHAN RATU, LAMPUNG TIMUR, LAMPUNG",7,111,83,194
https://kawalpemilu.org#24447,"LABUHAN RATU, LABUHAN RATU, LAMPUNG TIMUR, LAMPUNG",8,132,76,208
https://kawalpemilu.org#24447,"LABUHAN RATU, LABUHAN RATU, LAMPUNG TIMUR, LAMPUNG",9,146,109,255
https://kawalpemilu.org#24447,"LABUHAN RATU, LABUHAN RATU, LAMPUNG TIMUR, LAMPUNG",10,156,94,250
https://kawalpemilu.org#24447,"LABUHAN RATU, LABUHAN RATU, LAMPUNG TIMUR, LAMPUNG",11,133,38,171
https://kawalpemilu.org#24447,"LABUHAN RATU, LABUHAN RATU, LAMPUNG TIMUR, LAMPUNG",12,107,63,170
https://kawalpemilu.org#24447,"LABUHAN RATU, LABUHAN RATU, LAMPUNG TIMUR, LAMPUNG",13,130,33,163
https://kawalpemilu.org#24447,"LABUHAN RATU, LABUHAN RATU, LAMPUNG TIMUR, LAMPUNG",14,64,153,217
https://kawalpemilu.org#24447,"LABUHAN RATU, LABUHAN RATU, LAMPUNG TIMUR, LAMPUNG",15,176,23,199
https://kawalpemilu.org#24447,"LABUHAN RATU, LABUHAN RATU, LAMPUNG TIMUR, LAMPUNG",16,152,28,180
https://kawalpemilu.org#24447,"LABUHAN RATU, LABUHAN RATU, LAMPUNG TIMUR, LAMPUNG",17,194,32,226
https://kawalpemilu.org#24447,"LABUHAN RATU, LABUHAN RATU, LAMPUNG TIMUR, LAMPUNG",18,201,23,224
https://kawalpemilu.org#24447,"LABUHAN RATU, LABUHAN RATU, LAMPUNG TIMUR, LAMPUNG",19,112,6,118
https://kawalpemilu.org#24447,"LABUHAN RATU, LABUHAN RATU, LAMPUNG TIMUR, LAMPUNG",20,132,13,145
https://kawalpemilu.org#24448,"LABUHAN RATU III, LABUHAN RATU, LAMPUNG TIMUR, LAMPUNG",1,127,30,157
https://kawalpemilu.org#24448,"LABUHAN RATU III, LABUHAN RATU, LAMPUNG TIMUR, LAMPUNG",2,158,27,185
https://kawalpemilu.org#24448,"LABUHAN RATU III, LABUHAN RATU, LAMPUNG TIMUR, LAMPUNG",3,88,20,108
https://kawalpemilu.org#24448,"LABUHAN RATU III, LABUHAN RATU, LAMPUNG TIMUR, LAMPUNG",5,135,18,153
https://kawalpemilu.org#24448,"LABUHAN RATU III, LABUHAN RATU, LAMPUNG TIMUR, LAMPUNG",6,155,17,172
https://kawalpemilu.org#24448,"LABUHAN RATU III, LABUHAN RATU, LAMPUNG TIMUR, LAMPUNG",10,175,14,189
https://kawalpemilu.org#24449,"LABUHAN RATU IV, LABUHAN RATU, LAMPUNG TIMUR, LAMPUNG",1,149,34,183
https://kawalpemilu.org#24449,"LABUHAN RATU IV, LABUHAN RATU, LAMPUNG TIMUR, LAMPUNG",2,148,37,185
https://kawalpemilu.org#24449,"LABUHAN RATU IV, LABUHAN RATU, LAMPUNG TIMUR, LAMPUNG",3,162,45,207
https://kawalpemilu.org#24449,"LABUHAN RATU IV, LABUHAN RATU, LAMPUNG TIMUR, LAMPUNG",4,151,39,190
https://kawalpemilu.org#24449,"LABUHAN RATU IV, LABUHAN RATU, LAMPUNG TIMUR, LAMPUNG",5,127,55,182
https://kawalpemilu.org#24449,"LABUHAN RATU IV, LABUHAN RATU, LAMPUNG TIMUR, LAMPUNG",6,122,61,183
https://kawalpemilu.org#24449,"LABUHAN RATU IV, LABUHAN RATU, LAMPUNG TIMUR, LAMPUNG",8,154,25,179
https://kawalpemilu.org#24449,"LABUHAN RATU IV, LABUHAN RATU, LAMPUNG TIMUR, LAMPUNG",9,146,32,178
https://kawalpemilu.org#24449,"LABUHAN RATU IV, LABUHAN RATU, LAMPUNG TIMUR, LAMPUNG",10,144,38,182
https://kawalpemilu.org#24449,"LABUHAN RATU IV, LABUHAN RATU, LAMPUNG TIMUR, LAMPUNG",11,201,27,228
https://kawalpemilu.org#24449,"LABUHAN RATU IV, LABUHAN RATU, LAMPUNG TIMUR, LAMPUNG",12,191,37,228
https://kawalpemilu.org#24450,"LABUHAN RATU V, LABUHAN RATU, LAMPUNG TIMUR, LAMPUNG",1,124,52,176
https://kawalpemilu.org#24450,"LABUHAN RATU V, LABUHAN RATU, LAMPUNG TIMUR, LAMPUNG",2,83,71,154
https://kawalpemilu.org#24450,"LABUHAN RATU V, LABUHAN RATU, LAMPUNG TIMUR, LAMPUNG",3,114,67,181
https://kawalpemilu.org#24450,"LABUHAN RATU V, LABUHAN RATU, LAMPUNG TIMUR, LAMPUNG",4,121,73,194
https://kawalpemilu.org#24450,"LABUHAN RATU V, LABUHAN RATU, LAMPUNG TIMUR, LAMPUNG",5,124,26,150
https://kawalpemilu.org#24450,"LABUHAN RATU V, LABUHAN RATU, LAMPUNG TIMUR, LAMPUNG",6,103,33,136
https://kawalpemilu.org#24450,"LABUHAN RATU V, LABUHAN RATU, LAMPUNG TIMUR, LAMPUNG",7,143,23,166
https://kawalpemilu.org#24450,"LABUHAN RATU V, LABUHAN RATU, LAMPUNG TIMUR, LAMPUNG",8,130,31,161
https://kawalpemilu.org#24451,"LABUHAN RATU VI, LABUHAN RATU, LAMPUNG TIMUR, LAMPUNG",1,159,16,175
https://kawalpemilu.org#24451,"LABUHAN RATU VI, LABUHAN RATU, LAMPUNG TIMUR, LAMPUNG",2,99,84,183
https://kawalpemilu.org#24451,"LABUHAN RATU VI, LABUHAN RATU, LAMPUNG TIMUR, LAMPUNG",3,97,44,141
https://kawalpemilu.org#24451,"LABUHAN RATU VI, LABUHAN RATU, LAMPUNG TIMUR, LAMPUNG",4,75,68,143
https://kawalpemilu.org#24451,"LABUHAN RATU VI, LABUHAN RATU, LAMPUNG TIMUR, LAMPUNG",5,116,51,167
https://kawalpemilu.org#24451,"LABUHAN RATU VI, LABUHAN RATU, LAMPUNG TIMUR, LAMPUNG",6,105,73,178
https://kawalpemilu.org#24451,"LABUHAN RATU VI, LABUHAN RATU, LAMPUNG TIMUR, LAMPUNG",7,143,20,163
https://kawalpemilu.org#24451,"LABUHAN RATU VI, LABUHAN RATU, LAMPUNG TIMUR, LAMPUNG",8,159,16,175
https://kawalpemilu.org#24451,"LABUHAN RATU VI, LABUHAN RATU, LAMPUNG TIMUR, LAMPUNG",9,146,16,162
https://kawalpemilu.org#24451,"LABUHAN RATU VI, LABUHAN RATU, LAMPUNG TIMUR, LAMPUNG",10,139,51,190
https://kawalpemilu.org#24451,"LABUHAN RATU VI, LABUHAN RATU, LAMPUNG TIMUR, LAMPUNG",12,144,39,183
https://kawalpemilu.org#24451,"LABUHAN RATU VI, LABUHAN RATU, LAMPUNG TIMUR, LAMPUNG",13,87,112,199
https://kawalpemilu.org#24452,"RAJABASA LAMA, LABUHAN RATU, LAMPUNG TIMUR, LAMPUNG",1,128,16,144
https://kawalpemilu.org#24452,"RAJABASA LAMA, LABUHAN RATU, LAMPUNG TIMUR, LAMPUNG",2,94,42,136
https://kawalpemilu.org#24452,"RAJABASA LAMA, LABUHAN RATU, LAMPUNG TIMUR, LAMPUNG",3,108,70,178
https://kawalpemilu.org#24452,"RAJABASA LAMA, LABUHAN RATU, LAMPUNG TIMUR, LAMPUNG",4,152,60,212
https://kawalpemilu.org#24452,"RAJABASA LAMA, LABUHAN RATU, LAMPUNG TIMUR, LAMPUNG",5,116,124,240
https://kawalpemilu.org#24452,"RAJABASA LAMA, LABUHAN RATU, LAMPUNG TIMUR, LAMPUNG",6,77,101,178
https://kawalpemilu.org#24452,"RAJABASA LAMA, LABUHAN RATU, LAMPUNG TIMUR, LAMPUNG",7,74,120,194
https://kawalpemilu.org#24452,"RAJABASA LAMA, LABUHAN RATU, LAMPUNG TIMUR, LAMPUNG",8,121,44,165
https://kawalpemilu.org#24452,"RAJABASA LAMA, LABUHAN RATU, LAMPUNG TIMUR, LAMPUNG",9,93,83,176
https://kawalpemilu.org#24452,"RAJABASA LAMA, LABUHAN RATU, LAMPUNG TIMUR, LAMPUNG",10,70,87,157
https://kawalpemilu.org#24452,"RAJABASA LAMA, LABUHAN RATU, LAMPUNG TIMUR, LAMPUNG",11,82,75,157
https://kawalpemilu.org#24452,"RAJABASA LAMA, LABUHAN RATU, LAMPUNG TIMUR, LAMPUNG",12,172,70,242
https://kawalpemilu.org#24452,"RAJABASA LAMA, LABUHAN RATU, LAMPUNG TIMUR, LAMPUNG",13,146,91,237
https://kawalpemilu.org#24452,"RAJABASA LAMA, LABUHAN RATU, LAMPUNG TIMUR, LAMPUNG",14,82,41,123
https://kawalpemilu.org#24452,"RAJABASA LAMA, LABUHAN RATU, LAMPUNG TIMUR, LAMPUNG",15,128,52,180
https://kawalpemilu.org#24452,"RAJABASA LAMA, LABUHAN RATU, LAMPUNG TIMUR, LAMPUNG",16,134,54,188
https://kawalpemilu.org#24452,"RAJABASA LAMA, LABUHAN RATU, LAMPUNG TIMUR, LAMPUNG",17,145,67,212
https://kawalpemilu.org#24452,"RAJABASA LAMA, LABUHAN RATU, LAMPUNG TIMUR, LAMPUNG",18,81,37,118
https://kawalpemilu.org#24452,"RAJABASA LAMA, LABUHAN RATU, LAMPUNG TIMUR, LAMPUNG",19,141,31,172
https://kawalpemilu.org#24452,"RAJABASA LAMA, LABUHAN RATU, LAMPUNG TIMUR, LAMPUNG",20,131,70,201
https://kawalpemilu.org#24452,"RAJABASA LAMA, LABUHAN RATU, LAMPUNG TIMUR, LAMPUNG",21,146,17,163
https://kawalpemilu.org#24452,"RAJABASA LAMA, LABUHAN RATU, LAMPUNG TIMUR, LAMPUNG",22,131,36,167
https://kawalpemilu.org#24452,"RAJABASA LAMA, LABUHAN RATU, LAMPUNG TIMUR, LAMPUNG",23,73,64,137
https://kawalpemilu.org#24452,"RAJABASA LAMA, LABUHAN RATU, LAMPUNG TIMUR, LAMPUNG",24,73,98,171
https://kawalpemilu.org#24452,"RAJABASA LAMA, LABUHAN RATU, LAMPUNG TIMUR, LAMPUNG",25,93,37,130
https://kawalpemilu.org#24452,"RAJABASA LAMA, LABUHAN RATU, LAMPUNG TIMUR, LAMPUNG",26,113,33,146
https://kawalpemilu.org#24452,"RAJABASA LAMA, LABUHAN RATU, LAMPUNG TIMUR, LAMPUNG",27,89,60,149
https://kawalpemilu.org#24452,"RAJABASA LAMA, LABUHAN RATU, LAMPUNG TIMUR, LAMPUNG",28,59,22,81
https://kawalpemilu.org#24452,"RAJABASA LAMA, LABUHAN RATU, LAMPUNG TIMUR, LAMPUNG",29,100,94,194
https://kawalpemilu.org#24452,"RAJABASA LAMA, LABUHAN RATU, LAMPUNG TIMUR, LAMPUNG",30,122,85,207
https://kawalpemilu.org#24452,"RAJABASA LAMA, LABUHAN RATU, LAMPUNG TIMUR, LAMPUNG",31,123,109,232
https://kawalpemilu.org#24452,"RAJABASA LAMA, LABUHAN RATU, LAMPUNG TIMUR, LAMPUNG",32,145,88,233
https://kawalpemilu.org#24452,"RAJABASA LAMA, LABUHAN RATU, LAMPUNG TIMUR, LAMPUNG",33,112,70,182
https://kawalpemilu.org#24452,"RAJABASA LAMA, LABUHAN RATU, LAMPUNG TIMUR, LAMPUNG",34,88,72,160
https://kawalpemilu.org#24452,"RAJABASA LAMA, LABUHAN RATU, LAMPUNG TIMUR, LAMPUNG",35,137,57,194
https://kawalpemilu.org#24452,"RAJABASA LAMA, LABUHAN RATU, LAMPUNG TIMUR, LAMPUNG",36,186,39,225
https://kawalpemilu.org#24452,"RAJABASA LAMA, LABUHAN RATU, LAMPUNG TIMUR, LAMPUNG",37,86,32,118
https://kawalpemilu.org#24452,"RAJABASA LAMA, LABUHAN RATU, LAMPUNG TIMUR, LAMPUNG",38,113,41,154
https://kawalpemilu.org#24453,"RAJABASA LAMA I, LABUHAN RATU, LAMPUNG TIMUR, LAMPUNG",1,143,98,241
https://kawalpemilu.org#24453,"RAJABASA LAMA I, LABUHAN RATU, LAMPUNG TIMUR, LAMPUNG",2,108,104,212
https://kawalpemilu.org#24453,"RAJABASA LAMA I, LABUHAN RATU, LAMPUNG TIMUR, LAMPUNG",3,102,51,153
https://kawalpemilu.org#24453,"RAJABASA LAMA I, LABUHAN RATU, LAMPUNG TIMUR, LAMPUNG",4,126,83,209
https://kawalpemilu.org#24453,"RAJABASA LAMA I, LABUHAN RATU, LAMPUNG TIMUR, LAMPUNG",5,139,85,224
https://kawalpemilu.org#24453,"RAJABASA LAMA I, LABUHAN RATU, LAMPUNG TIMUR, LAMPUNG",6,152,46,198
https://kawalpemilu.org#24453,"RAJABASA LAMA I, LABUHAN RATU, LAMPUNG TIMUR, LAMPUNG",7,72,37,109
https://kawalpemilu.org#24453,"RAJABASA LAMA I, LABUHAN RATU, LAMPUNG TIMUR, LAMPUNG",8,113,88,201
https://kawalpemilu.org#24453,"RAJABASA LAMA I, LABUHAN RATU, LAMPUNG TIMUR, LAMPUNG",9,157,61,218
https://kawalpemilu.org#24453,"RAJABASA LAMA I, LABUHAN RATU, LAMPUNG TIMUR, LAMPUNG",10,116,39,155
https://kawalpemilu.org#24453,"RAJABASA LAMA I, LABUHAN RATU, LAMPUNG TIMUR, LAMPUNG",11,94,72,166
https://kawalpemilu.org#24454,"RAJABASA LAMA II, LABUHAN RATU, LAMPUNG TIMUR, LAMPUNG",1,146,80,226
https://kawalpemilu.org#24454,"RAJABASA LAMA II, LABUHAN RATU, LAMPUNG TIMUR, LAMPUNG",2,138,74,212
https://kawalpemilu.org#24454,"RAJABASA LAMA II, LABUHAN RATU, LAMPUNG TIMUR, LAMPUNG",3,88,80,168
https://kawalpemilu.org#24454,"RAJABASA LAMA II, LABUHAN RATU, LAMPUNG TIMUR, LAMPUNG",4,91,86,177
https://kawalpemilu.org#24454,"RAJABASA LAMA II, LABUHAN RATU, LAMPUNG TIMUR, LAMPUNG",5,123,65,188
https://kawalpemilu.org#24454,"RAJABASA LAMA II, LABUHAN RATU, LAMPUNG TIMUR, LAMPUNG",6,134,60,194
https://kawalpemilu.org#24454,"RAJABASA LAMA II, LABUHAN RATU, LAMPUNG TIMUR, LAMPUNG",7,120,70,190
https://kawalpemilu.org#24454,"RAJABASA LAMA II, LABUHAN RATU, LAMPUNG TIMUR, LAMPUNG",8,139,51,190
https://kawalpemilu.org#24454,"RAJABASA LAMA II, LABUHAN RATU, LAMPUNG TIMUR, LAMPUNG",9,89,34,123
https://kawalpemilu.org#24454,"RAJABASA LAMA II, LABUHAN RATU, LAMPUNG TIMUR, LAMPUNG",10,116,29,145
https://kawalpemilu.org#24455,"LABUHAN RATU VII, LABUHAN RATU, LAMPUNG TIMUR, LAMPUNG",1,112,72,184
https://kawalpemilu.org#24455,"LABUHAN RATU VII, LABUHAN RATU, LAMPUNG TIMUR, LAMPUNG",2,149,35,184
https://kawalpemilu.org#24455,"LABUHAN RATU VII, LABUHAN RATU, LAMPUNG TIMUR, LAMPUNG",3,149,35,184
https://kawalpemilu.org#24455,"LABUHAN RATU VII, LABUHAN RATU, LAMPUNG TIMUR, LAMPUNG",4,121,21,142
https://kawalpemilu.org#24455,"LABUHAN RATU VII, LABUHAN RATU, LAMPUNG TIMUR, LAMPUNG",5,137,49,186
https://kawalpemilu.org#24455,"LABUHAN RATU VII, LABUHAN RATU, LAMPUNG TIMUR, LAMPUNG",6,151,52,203
https://kawalpemilu.org#24455,"LABUHAN RATU VII, LABUHAN RATU, LAMPUNG TIMUR, LAMPUNG",7,101,32,133
https://kawalpemilu.org#24455,"LABUHAN RATU VII, LABUHAN RATU, LAMPUNG TIMUR, LAMPUNG",8,116,37,153
https://kawalpemilu.org#24455,"LABUHAN RATU VII, LABUHAN RATU, LAMPUNG TIMUR, LAMPUNG",9,92,42,134
https://kawalpemilu.org#24455,"LABUHAN RATU VII, LABUHAN RATU, LAMPUNG TIMUR, LAMPUNG",10,124,23,147
https://kawalpemilu.org#24455,"LABUHAN RATU VII, LABUHAN RATU, LAMPUNG TIMUR, LAMPUNG",11,122,19,141
https://kawalpemilu.org#24455,"LABUHAN RATU VII, LABUHAN RATU, LAMPUNG TIMUR, LAMPUNG",12,119,29,148
https://kawalpemilu.org#24455,"LABUHAN RATU VII, LABUHAN RATU, LAMPUNG TIMUR, LAMPUNG",13,130,32,162
https://kawalpemilu.org#24455,"LABUHAN RATU VII, LABUHAN RATU, LAMPUNG TIMUR, LAMPUNG",14,139,13,152
https://kawalpemilu.org#24455,"LABUHAN RATU VII, LABUHAN RATU, LAMPUNG TIMUR, LAMPUNG",16,111,5,116
https://kawalpemilu.org#24456,"LABUHAN RATU VIII, LABUHAN RATU, LAMPUNG TIMUR, LAMPUNG",1,144,20,164
https://kawalpemilu.org#24456,"LABUHAN RATU VIII, LABUHAN RATU, LAMPUNG TIMUR, LAMPUNG",2,101,29,130
https://kawalpemilu.org#24456,"LABUHAN RATU VIII, LABUHAN RATU, LAMPUNG TIMUR, LAMPUNG",3,160,27,187
https://kawalpemilu.org#24456,"LABUHAN RATU VIII, LABUHAN RATU, LAMPUNG TIMUR, LAMPUNG",4,137,35,172
https://kawalpemilu.org#24456,"LABUHAN RATU VIII, LABUHAN RATU, LAMPUNG TIMUR, LAMPUNG",5,117,18,135
https://kawalpemilu.org#24456,"LABUHAN RATU VIII, LABUHAN RATU, LAMPUNG TIMUR, LAMPUNG",6,130,9,139
https://kawalpemilu.org#24456,"LABUHAN RATU VIII, LABUHAN RATU, LAMPUNG TIMUR, LAMPUNG",7,100,35,135
https://kawalpemilu.org#24457,"LABUHAN RATU IX, LABUHAN RATU, LAMPUNG TIMUR, LAMPUNG",1,99,70,169
https://kawalpemilu.org#24457,"LABUHAN RATU IX, LABUHAN RATU, LAMPUNG TIMUR, LAMPUNG",2,96,70,166
https://kawalpemilu.org#24457,"LABUHAN RATU IX, LABUHAN RATU, LAMPUNG TIMUR, LAMPUNG",3,130,59,189
https://kawalpemilu.org#24457,"LABUHAN RATU IX, LABUHAN RATU, LAMPUNG TIMUR, LAMPUNG",4,107,93,200
https://kawalpemilu.org#24457,"LABUHAN RATU IX, LABUHAN RATU, LAMPUNG TIMUR, LAMPUNG",5,82,55,137
https://kawalpemilu.org#24457,"LABUHAN RATU IX, LABUHAN RATU, LAMPUNG TIMUR, LAMPUNG",6,72,62,134
https://kawalpemilu.org#24459,"BRAJA HARJOSARI, BRAJA SELEBAH, LAMPUNG TIMUR, LAMPUNG",1,100,41,141
https://kawalpemilu.org#24459,"BRAJA HARJOSARI, BRAJA SELEBAH, LAMPUNG TIMUR, LAMPUNG",2,130,79,209
https://kawalpemilu.org#24459,"BRAJA HARJOSARI, BRAJA SELEBAH, LAMPUNG TIMUR, LAMPUNG",3,115,40,155
https://kawalpemilu.org#24459,"BRAJA HARJOSARI, BRAJA SELEBAH, LAMPUNG TIMUR, LAMPUNG",4,106,106,212
https://kawalpemilu.org#24459,"BRAJA HARJOSARI, BRAJA SELEBAH, LAMPUNG TIMUR, LAMPUNG",5,94,70,164
https://kawalpemilu.org#24459,"BRAJA HARJOSARI, BRAJA SELEBAH, LAMPUNG TIMUR, LAMPUNG",6,128,48,176
https://kawalpemilu.org#24459,"BRAJA HARJOSARI, BRAJA SELEBAH, LAMPUNG TIMUR, LAMPUNG",7,150,49,199
https://kawalpemilu.org#24459,"BRAJA HARJOSARI, BRAJA SELEBAH, LAMPUNG TIMUR, LAMPUNG",8,153,56,209
https://kawalpemilu.org#24459,"BRAJA HARJOSARI, BRAJA SELEBAH, LAMPUNG TIMUR, LAMPUNG",9,148,54,202
https://kawalpemilu.org#24459,"BRAJA HARJOSARI, BRAJA SELEBAH, LAMPUNG TIMUR, LAMPUNG",10,148,38,186
https://kawalpemilu.org#24459,"BRAJA HARJOSARI, BRAJA SELEBAH, LAMPUNG TIMUR, LAMPUNG",11,114,43,157
https://kawalpemilu.org#24459,"BRAJA HARJOSARI, BRAJA SELEBAH, LAMPUNG TIMUR, LAMPUNG",12,177,29,206
https://kawalpemilu.org#24459,"BRAJA HARJOSARI, BRAJA SELEBAH, LAMPUNG TIMUR, LAMPUNG",13,113,50,163
https://kawalpemilu.org#24459,"BRAJA HARJOSARI, BRAJA SELEBAH, LAMPUNG TIMUR, LAMPUNG",14,117,35,152
https://kawalpemilu.org#24459,"BRAJA HARJOSARI, BRAJA SELEBAH, LAMPUNG TIMUR, LAMPUNG",15,103,27,130
https://kawalpemilu.org#24459,"BRAJA HARJOSARI, BRAJA SELEBAH, LAMPUNG TIMUR, LAMPUNG",17,116,10,126
https://kawalpemilu.org#24459,"BRAJA HARJOSARI, BRAJA SELEBAH, LAMPUNG TIMUR, LAMPUNG",18,111,39,150
https://kawalpemilu.org#24459,"BRAJA HARJOSARI, BRAJA SELEBAH, LAMPUNG TIMUR, LAMPUNG",19,75,52,127
https://kawalpemilu.org#24459,"BRAJA HARJOSARI, BRAJA SELEBAH, LAMPUNG TIMUR, LAMPUNG",20,91,29,120
https://kawalpemilu.org#24460,"BRAJA GEMILANG, BRAJA SELEBAH, LAMPUNG TIMUR, LAMPUNG",1,122,41,163
https://kawalpemilu.org#24460,"BRAJA GEMILANG, BRAJA SELEBAH, LAMPUNG TIMUR, LAMPUNG",2,109,23,132
https://kawalpemilu.org#24460,"BRAJA GEMILANG, BRAJA SELEBAH, LAMPUNG TIMUR, LAMPUNG",3,121,29,150
https://kawalpemilu.org#24460,"BRAJA GEMILANG, BRAJA SELEBAH, LAMPUNG TIMUR, LAMPUNG",4,122,15,137
https://kawalpemilu.org#24460,"BRAJA GEMILANG, BRAJA SELEBAH, LAMPUNG TIMUR, LAMPUNG",5,97,16,113
https://kawalpemilu.org#24460,"BRAJA GEMILANG, BRAJA SELEBAH, LAMPUNG TIMUR, LAMPUNG",7,113,28,141
https://kawalpemilu.org#24460,"BRAJA GEMILANG, BRAJA SELEBAH, LAMPUNG TIMUR, LAMPUNG",8,138,24,162
https://kawalpemilu.org#24460,"BRAJA GEMILANG, BRAJA SELEBAH, LAMPUNG TIMUR, LAMPUNG",9,142,25,167
https://kawalpemilu.org#24461,"BRAJA INDAH, BRAJA SELEBAH, LAMPUNG TIMUR, LAMPUNG",1,113,36,149
https://kawalpemilu.org#24461,"BRAJA INDAH, BRAJA SELEBAH, LAMPUNG TIMUR, LAMPUNG",2,126,41,167
https://kawalpemilu.org#24461,"BRAJA INDAH, BRAJA SELEBAH, LAMPUNG TIMUR, LAMPUNG",4,160,41,201
https://kawalpemilu.org#24461,"BRAJA INDAH, BRAJA SELEBAH, LAMPUNG TIMUR, LAMPUNG",5,128,67,195
https://kawalpemilu.org#24461,"BRAJA INDAH, BRAJA SELEBAH, LAMPUNG TIMUR, LAMPUNG",6,138,66,204
https://kawalpemilu.org#24461,"BRAJA INDAH, BRAJA SELEBAH, LAMPUNG TIMUR, LAMPUNG",7,138,36,174
https://kawalpemilu.org#24461,"BRAJA INDAH, BRAJA SELEBAH, LAMPUNG TIMUR, LAMPUNG",8,110,58,168
https://kawalpemilu.org#24461,"BRAJA INDAH, BRAJA SELEBAH, LAMPUNG TIMUR, LAMPUNG",9,143,35,178
https://kawalpemilu.org#24461,"BRAJA INDAH, BRAJA SELEBAH, LAMPUNG TIMUR, LAMPUNG",10,132,34,166
https://kawalpemilu.org#24461,"BRAJA INDAH, BRAJA SELEBAH, LAMPUNG TIMUR, LAMPUNG",11,107,30,137
https://kawalpemilu.org#24461,"BRAJA INDAH, BRAJA SELEBAH, LAMPUNG TIMUR, LAMPUNG",12,112,21,133
https://kawalpemilu.org#24462,"BRAJA YEKTI, BRAJA SELEBAH, LAMPUNG TIMUR, LAMPUNG",1,144,20,164
https://kawalpemilu.org#24462,"BRAJA YEKTI, BRAJA SELEBAH, LAMPUNG TIMUR, LAMPUNG",2,119,30,149
https://kawalpemilu.org#24462,"BRAJA YEKTI, BRAJA SELEBAH, LAMPUNG TIMUR, LAMPUNG",3,127,19,146
https://kawalpemilu.org#24462,"BRAJA YEKTI, BRAJA SELEBAH, LAMPUNG TIMUR, LAMPUNG",4,140,25,165
https://kawalpemilu.org#24462,"BRAJA YEKTI, BRAJA SELEBAH, LAMPUNG TIMUR, LAMPUNG",5,165,23,188
https://kawalpemilu.org#24462,"BRAJA YEKTI, BRAJA SELEBAH, LAMPUNG TIMUR, LAMPUNG",6,116,50,166
https://kawalpemilu.org#24462,"BRAJA YEKTI, BRAJA SELEBAH, LAMPUNG TIMUR, LAMPUNG",7,121,51,172
https://kawalpemilu.org#24462,"BRAJA YEKTI, BRAJA SELEBAH, LAMPUNG TIMUR, LAMPUNG",8,140,35,175
https://kawalpemilu.org#24462,"BRAJA YEKTI, BRAJA SELEBAH, LAMPUNG TIMUR, LAMPUNG",9,113,38,151
https://kawalpemilu.org#24462,"BRAJA YEKTI, BRAJA SELEBAH, LAMPUNG TIMUR, LAMPUNG",10,131,14,145
https://kawalpemilu.org#24462,"BRAJA YEKTI, BRAJA SELEBAH, LAMPUNG TIMUR, LAMPUNG",11,140,6,146
https://kawalpemilu.org#24463,"BRAJA KENCANA, BRAJA SELEBAH, LAMPUNG TIMUR, LAMPUNG",1,149,73,222
https://kawalpemilu.org#24463,"BRAJA KENCANA, BRAJA SELEBAH, LAMPUNG TIMUR, LAMPUNG",2,113,94,207
https://kawalpemilu.org#24463,"BRAJA KENCANA, BRAJA SELEBAH, LAMPUNG TIMUR, LAMPUNG",3,99,72,171
https://kawalpemilu.org#24463,"BRAJA KENCANA, BRAJA SELEBAH, LAMPUNG TIMUR, LAMPUNG",4,112,106,218
https://kawalpemilu.org#24463,"BRAJA KENCANA, BRAJA SELEBAH, LAMPUNG TIMUR, LAMPUNG",5,99,83,182
https://kawalpemilu.org#24463,"BRAJA KENCANA, BRAJA SELEBAH, LAMPUNG TIMUR, LAMPUNG",7,130,44,174
https://kawalpemilu.org#24463,"BRAJA KENCANA, BRAJA SELEBAH, LAMPUNG TIMUR, LAMPUNG",8,128,48,176
https://kawalpemilu.org#24464,"BRAJA LUHUR, BRAJA SELEBAH, LAMPUNG TIMUR, LAMPUNG",1,107,30,137
https://kawalpemilu.org#24464,"BRAJA LUHUR, BRAJA SELEBAH, LAMPUNG TIMUR, LAMPUNG",2,119,17,136
https://kawalpemilu.org#24464,"BRAJA LUHUR, BRAJA SELEBAH, LAMPUNG TIMUR, LAMPUNG",3,107,44,151
https://kawalpemilu.org#24464,"BRAJA LUHUR, BRAJA SELEBAH, LAMPUNG TIMUR, LAMPUNG",4,90,34,124
https://kawalpemilu.org#24464,"BRAJA LUHUR, BRAJA SELEBAH, LAMPUNG TIMUR, LAMPUNG",5,99,50,149
https://kawalpemilu.org#24464,"BRAJA LUHUR, BRAJA SELEBAH, LAMPUNG TIMUR, LAMPUNG",7,133,26,159
https://kawalpemilu.org#24464,"BRAJA LUHUR, BRAJA SELEBAH, LAMPUNG TIMUR, LAMPUNG",8,137,36,173
https://kawalpemilu.org#24464,"BRAJA LUHUR, BRAJA SELEBAH, LAMPUNG TIMUR, LAMPUNG",9,134,38,172
https://kawalpemilu.org#24464,"BRAJA LUHUR, BRAJA SELEBAH, LAMPUNG TIMUR, LAMPUNG",10,170,36,206
https://kawalpemilu.org#24464,"BRAJA LUHUR, BRAJA SELEBAH, LAMPUNG TIMUR, LAMPUNG",12,158,32,190
https://kawalpemilu.org#24465,"BRAJA MULYA, BRAJA SELEBAH, LAMPUNG TIMUR, LAMPUNG",1,128,20,148
https://kawalpemilu.org#24465,"BRAJA MULYA, BRAJA SELEBAH, LAMPUNG TIMUR, LAMPUNG",2,114,29,143
https://kawalpemilu.org#24465,"BRAJA MULYA, BRAJA SELEBAH, LAMPUNG TIMUR, LAMPUNG",3,116,21,137
https://kawalpemilu.org#24465,"BRAJA MULYA, BRAJA SELEBAH, LAMPUNG TIMUR, LAMPUNG",4,106,28,134
https://kawalpemilu.org#24465,"BRAJA MULYA, BRAJA SELEBAH, LAMPUNG TIMUR, LAMPUNG",5,94,33,127
https://kawalpemilu.org#24465,"BRAJA MULYA, BRAJA SELEBAH, LAMPUNG TIMUR, LAMPUNG",6,104,22,126
https://kawalpemilu.org#24467,"TAMBAH SUBUR, WAY BUNGUR, LAMPUNG TIMUR, LAMPUNG",1,179,23,202
https://kawalpemilu.org#24467,"TAMBAH SUBUR, WAY BUNGUR, LAMPUNG TIMUR, LAMPUNG",2,73,59,132
https://kawalpemilu.org#24467,"TAMBAH SUBUR, WAY BUNGUR, LAMPUNG TIMUR, LAMPUNG",3,140,39,179
https://kawalpemilu.org#24467,"TAMBAH SUBUR, WAY BUNGUR, LAMPUNG TIMUR, LAMPUNG",4,148,72,220
https://kawalpemilu.org#24467,"TAMBAH SUBUR, WAY BUNGUR, LAMPUNG TIMUR, LAMPUNG",5,126,46,172
https://kawalpemilu.org#24467,"TAMBAH SUBUR, WAY BUNGUR, LAMPUNG TIMUR, LAMPUNG",6,91,90,181
https://kawalpemilu.org#24467,"TAMBAH SUBUR, WAY BUNGUR, LAMPUNG TIMUR, LAMPUNG",7,141,50,191
https://kawalpemilu.org#24467,"TAMBAH SUBUR, WAY BUNGUR, LAMPUNG TIMUR, LAMPUNG",8,103,42,145
https://kawalpemilu.org#24467,"TAMBAH SUBUR, WAY BUNGUR, LAMPUNG TIMUR, LAMPUNG",9,113,149,262
https://kawalpemilu.org#24467,"TAMBAH SUBUR, WAY BUNGUR, LAMPUNG TIMUR, LAMPUNG",10,100,34,134
https://kawalpemilu.org#24467,"TAMBAH SUBUR, WAY BUNGUR, LAMPUNG TIMUR, LAMPUNG",11,81,59,140
https://kawalpemilu.org#24467,"TAMBAH SUBUR, WAY BUNGUR, LAMPUNG TIMUR, LAMPUNG",12,73,59,132
https://kawalpemilu.org#24467,"TAMBAH SUBUR, WAY BUNGUR, LAMPUNG TIMUR, LAMPUNG",13,98,31,129
https://kawalpemilu.org#24467,"TAMBAH SUBUR, WAY BUNGUR, LAMPUNG TIMUR, LAMPUNG",14,127,22,149
https://kawalpemilu.org#24467,"TAMBAH SUBUR, WAY BUNGUR, LAMPUNG TIMUR, LAMPUNG",15,143,51,194
https://kawalpemilu.org#24467,"TAMBAH SUBUR, WAY BUNGUR, LAMPUNG TIMUR, LAMPUNG",16,161,54,215
https://kawalpemilu.org#24468,"TANJUNG KENCONO, WAY BUNGUR, LAMPUNG TIMUR, LAMPUNG",1,166,54,220
https://kawalpemilu.org#24468,"TANJUNG KENCONO, WAY BUNGUR, LAMPUNG TIMUR, LAMPUNG",2,118,84,202
https://kawalpemilu.org#24468,"TANJUNG KENCONO, WAY BUNGUR, LAMPUNG TIMUR, LAMPUNG",3,110,85,195
https://kawalpemilu.org#24468,"TANJUNG KENCONO, WAY BUNGUR, LAMPUNG TIMUR, LAMPUNG",4,98,101,199
https://kawalpemilu.org#24468,"TANJUNG KENCONO, WAY BUNGUR, LAMPUNG TIMUR, LAMPUNG",5,118,42,160
https://kawalpemilu.org#24468,"TANJUNG KENCONO, WAY BUNGUR, LAMPUNG TIMUR, LAMPUNG",6,108,55,163
https://kawalpemilu.org#24468,"TANJUNG KENCONO, WAY BUNGUR, LAMPUNG TIMUR, LAMPUNG",8,97,125,222
https://kawalpemilu.org#24468,"TANJUNG KENCONO, WAY BUNGUR, LAMPUNG TIMUR, LAMPUNG",10,147,69,216
https://kawalpemilu.org#24469,"TANJUNG TIRTO, WAY BUNGUR, LAMPUNG TIMUR, LAMPUNG",1,105,46,151
https://kawalpemilu.org#24469,"TANJUNG TIRTO, WAY BUNGUR, LAMPUNG TIMUR, LAMPUNG",2,118,37,155
https://kawalpemilu.org#24469,"TANJUNG TIRTO, WAY BUNGUR, LAMPUNG TIMUR, LAMPUNG",3,112,36,148
https://kawalpemilu.org#24469,"TANJUNG TIRTO, WAY BUNGUR, LAMPUNG TIMUR, LAMPUNG",4,112,21,133
https://kawalpemilu.org#24469,"TANJUNG TIRTO, WAY BUNGUR, LAMPUNG TIMUR, LAMPUNG",5,84,39,123
https://kawalpemilu.org#24469,"TANJUNG TIRTO, WAY BUNGUR, LAMPUNG TIMUR, LAMPUNG",6,89,48,137
https://kawalpemilu.org#24469,"TANJUNG TIRTO, WAY BUNGUR, LAMPUNG TIMUR, LAMPUNG",7,43,114,157
https://kawalpemilu.org#24469,"TANJUNG TIRTO, WAY BUNGUR, LAMPUNG TIMUR, LAMPUNG",8,56,87,143
https://kawalpemilu.org#24469,"TANJUNG TIRTO, WAY BUNGUR, LAMPUNG TIMUR, LAMPUNG",9,75,84,159
https://kawalpemilu.org#24469,"TANJUNG TIRTO, WAY BUNGUR, LAMPUNG TIMUR, LAMPUNG",10,51,99,150
https://kawalpemilu.org#24469,"TANJUNG TIRTO, WAY BUNGUR, LAMPUNG TIMUR, LAMPUNG",11,74,80,154
https://kawalpemilu.org#24469,"TANJUNG TIRTO, WAY BUNGUR, LAMPUNG TIMUR, LAMPUNG",12,63,82,145
https://kawalpemilu.org#24470,"TOTO MULYO, WAY BUNGUR, LAMPUNG TIMUR, LAMPUNG",1,109,60,169
https://kawalpemilu.org#24470,"TOTO MULYO, WAY BUNGUR, LAMPUNG TIMUR, LAMPUNG",2,129,58,187
https://kawalpemilu.org#24470,"TOTO MULYO, WAY BUNGUR, LAMPUNG TIMUR, LAMPUNG",3,119,55,174
https://kawalpemilu.org#24470,"TOTO MULYO, WAY BUNGUR, LAMPUNG TIMUR, LAMPUNG",4,108,54,162
https://kawalpemilu.org#24470,"TOTO MULYO, WAY BUNGUR, LAMPUNG TIMUR, LAMPUNG",5,102,81,183
https://kawalpemilu.org#24470,"TOTO MULYO, WAY BUNGUR, LAMPUNG TIMUR, LAMPUNG",6,120,58,178
https://kawalpemilu.org#24470,"TOTO MULYO, WAY BUNGUR, LAMPUNG TIMUR, LAMPUNG",7,104,89,173
https://kawalpemilu.org#24470,"TOTO MULYO, WAY BUNGUR, LAMPUNG TIMUR, LAMPUNG",8,100,73,173
https://kawalpemilu.org#24471,"TOTO PROJO, WAY BUNGUR, LAMPUNG TIMUR, LAMPUNG",1,78,74,151
https://kawalpemilu.org#24471,"TOTO PROJO, WAY BUNGUR, LAMPUNG TIMUR, LAMPUNG",2,82,74,156
https://kawalpemilu.org#24471,"TOTO PROJO, WAY BUNGUR, LAMPUNG TIMUR, LAMPUNG",3,112,35,147
https://kawalpemilu.org#24471,"TOTO PROJO, WAY BUNGUR, LAMPUNG TIMUR, LAMPUNG",4,121,35,156
https://kawalpemilu.org#24471,"TOTO PROJO, WAY BUNGUR, LAMPUNG TIMUR, LAMPUNG",5,0,0,0
https://kawalpemilu.org#24471,"TOTO PROJO, WAY BUNGUR, LAMPUNG TIMUR, LAMPUNG",6,114,71,185
https://kawalpemilu.org#24471,"TOTO PROJO, WAY BUNGUR, LAMPUNG TIMUR, LAMPUNG",7,92,72,164
https://kawalpemilu.org#24471,"TOTO PROJO, WAY BUNGUR, LAMPUNG TIMUR, LAMPUNG",8,105,50,155
https://kawalpemilu.org#24472,"TAMAN NEGERI, WAY BUNGUR, LAMPUNG TIMUR, LAMPUNG",1,130,90,220
https://kawalpemilu.org#24472,"TAMAN NEGERI, WAY BUNGUR, LAMPUNG TIMUR, LAMPUNG",2,150,67,217
https://kawalpemilu.org#24472,"TAMAN NEGERI, WAY BUNGUR, LAMPUNG TIMUR, LAMPUNG",3,110,72,182
https://kawalpemilu.org#24472,"TAMAN NEGERI, WAY BUNGUR, LAMPUNG TIMUR, LAMPUNG",4,98,47,145
https://kawalpemilu.org#24472,"TAMAN NEGERI, WAY BUNGUR, LAMPUNG TIMUR, LAMPUNG",5,119,105,224
https://kawalpemilu.org#24472,"TAMAN NEGERI, WAY BUNGUR, LAMPUNG TIMUR, LAMPUNG",6,128,90,218
https://kawalpemilu.org#24472,"TAMAN NEGERI, WAY BUNGUR, LAMPUNG TIMUR, LAMPUNG",7,88,72,160
https://kawalpemilu.org#24472,"TAMAN NEGERI, WAY BUNGUR, LAMPUNG TIMUR, LAMPUNG",8,97,58,155
https://kawalpemilu.org#24472,"TAMAN NEGERI, WAY BUNGUR, LAMPUNG TIMUR, LAMPUNG",10,114,33,147
https://kawalpemilu.org#24472,"TAMAN NEGERI, WAY BUNGUR, LAMPUNG TIMUR, LAMPUNG",11,159,59,218
https://kawalpemilu.org#24472,"TAMAN NEGERI, WAY BUNGUR, LAMPUNG TIMUR, LAMPUNG",12,141,76,217
https://kawalpemilu.org#24473,"TEGAL OMBO, WAY BUNGUR, LAMPUNG TIMUR, LAMPUNG",1,138,45,183
https://kawalpemilu.org#24473,"TEGAL OMBO, WAY BUNGUR, LAMPUNG TIMUR, LAMPUNG",2,118,41,159
https://kawalpemilu.org#24473,"TEGAL OMBO, WAY BUNGUR, LAMPUNG TIMUR, LAMPUNG",3,107,60,167
https://kawalpemilu.org#24473,"TEGAL OMBO, WAY BUNGUR, LAMPUNG TIMUR, LAMPUNG",4,82,88,170
https://kawalpemilu.org#24473,"TEGAL OMBO, WAY BUNGUR, LAMPUNG TIMUR, LAMPUNG",5,105,104,209
https://kawalpemilu.org#24473,"TEGAL OMBO, WAY BUNGUR, LAMPUNG TIMUR, LAMPUNG",6,122,56,178
https://kawalpemilu.org#24473,"TEGAL OMBO, WAY BUNGUR, LAMPUNG TIMUR, LAMPUNG",7,83,78,161
https://kawalpemilu.org#24473,"TEGAL OMBO, WAY BUNGUR, LAMPUNG TIMUR, LAMPUNG",8,122,51,173
https://kawalpemilu.org#24473,"TEGAL OMBO, WAY BUNGUR, LAMPUNG TIMUR, LAMPUNG",9,128,39,167
https://kawalpemilu.org#24473,"TEGAL OMBO, WAY BUNGUR, LAMPUNG TIMUR, LAMPUNG",10,121,17,138
https://kawalpemilu.org#24474,"KALI PASIR, WAY BUNGUR, LAMPUNG TIMUR, LAMPUNG",1,168,37,205
https://kawalpemilu.org#24474,"KALI PASIR, WAY BUNGUR, LAMPUNG TIMUR, LAMPUNG",2,171,26,197
https://kawalpemilu.org#24476,"BUNGKUK, MARGA SEKAMPUNG, LAMPUNG TIMUR, LAMPUNG",1,148,41,189
https://kawalpemilu.org#24476,"BUNGKUK, MARGA SEKAMPUNG, LAMPUNG TIMUR, LAMPUNG",2,46,139,185
https://kawalpemilu.org#24476,"BUNGKUK, MARGA SEKAMPUNG, LAMPUNG TIMUR, LAMPUNG",3,37,91,128
https://kawalpemilu.org#24476,"BUNGKUK, MARGA SEKAMPUNG, LAMPUNG TIMUR, LAMPUNG",4,15,108,123
https://kawalpemilu.org#24476,"BUNGKUK, MARGA SEKAMPUNG, LAMPUNG TIMUR, LAMPUNG",5,37,92,129
https://kawalpemilu.org#24476,"BUNGKUK, MARGA SEKAMPUNG, LAMPUNG TIMUR, LAMPUNG",6,23,78,101
https://kawalpemilu.org#24476,"BUNGKUK, MARGA SEKAMPUNG, LAMPUNG TIMUR, LAMPUNG",7,31,160,191
https://kawalpemilu.org#24476,"BUNGKUK, MARGA SEKAMPUNG, LAMPUNG TIMUR, LAMPUNG",8,80,118,198
https://kawalpemilu.org#24476,"BUNGKUK, MARGA SEKAMPUNG, LAMPUNG TIMUR, LAMPUNG",9,46,109,155
https://kawalpemilu.org#24476,"BUNGKUK, MARGA SEKAMPUNG, LAMPUNG TIMUR, LAMPUNG",10,91,52,143
https://kawalpemilu.org#24476,"BUNGKUK, MARGA SEKAMPUNG, LAMPUNG TIMUR, LAMPUNG",11,80,59,139
https://kawalpemilu.org#24476,"BUNGKUK, MARGA SEKAMPUNG, LAMPUNG TIMUR, LAMPUNG",12,63,90,153
https://kawalpemilu.org#24476,"BUNGKUK, MARGA SEKAMPUNG, LAMPUNG TIMUR, LAMPUNG",13,66,125,191
https://kawalpemilu.org#24476,"BUNGKUK, MARGA SEKAMPUNG, LAMPUNG TIMUR, LAMPUNG",14,198,17,215
https://kawalpemilu.org#24476,"BUNGKUK, MARGA SEKAMPUNG, LAMPUNG TIMUR, LAMPUNG",15,187,16,203
https://kawalpemilu.org#24476,"BUNGKUK, MARGA SEKAMPUNG, LAMPUNG TIMUR, LAMPUNG",16,144,19,163
https://kawalpemilu.org#24476,"BUNGKUK, MARGA SEKAMPUNG, LAMPUNG TIMUR, LAMPUNG",17,143,23,166
https://kawalpemilu.org#24477,"BATU BADAK, MARGA SEKAMPUNG, LAMPUNG TIMUR, LAMPUNG",1,73,107,180
https://kawalpemilu.org#24477,"BATU BADAK, MARGA SEKAMPUNG, LAMPUNG TIMUR, LAMPUNG",2,69,73,142
https://kawalpemilu.org#24477,"BATU BADAK, MARGA SEKAMPUNG, LAMPUNG TIMUR, LAMPUNG",3,81,90,171
https://kawalpemilu.org#24477,"BATU BADAK, MARGA SEKAMPUNG, LAMPUNG TIMUR, LAMPUNG",4,40,58,98
https://kawalpemilu.org#24477,"BATU BADAK, MARGA SEKAMPUNG, LAMPUNG TIMUR, LAMPUNG",5,76,103,179
https://kawalpemilu.org#24477,"BATU BADAK, MARGA SEKAMPUNG, LAMPUNG TIMUR, LAMPUNG",6,59,62,121
https://kawalpemilu.org#24477,"BATU BADAK, MARGA SEKAMPUNG, LAMPUNG TIMUR, LAMPUNG",7,169,20,189
https://kawalpemilu.org#24477,"BATU BADAK, MARGA SEKAMPUNG, LAMPUNG TIMUR, LAMPUNG",8,202,11,213
https://kawalpemilu.org#24478,"PENIANGAN, MARGA SEKAMPUNG, LAMPUNG TIMUR, LAMPUNG",1,78,82,160
https://kawalpemilu.org#24478,"PENIANGAN, MARGA SEKAMPUNG, LAMPUNG TIMUR, LAMPUNG",2,50,89,139
https://kawalpemilu.org#24478,"PENIANGAN, MARGA SEKAMPUNG, LAMPUNG TIMUR, LAMPUNG",3,37,110,147
https://kawalpemilu.org#24478,"PENIANGAN, MARGA SEKAMPUNG, LAMPUNG TIMUR, LAMPUNG",4,44,125,169
https://kawalpemilu.org#24478,"PENIANGAN, MARGA SEKAMPUNG, LAMPUNG TIMUR, LAMPUNG",5,58,158,216
https://kawalpemilu.org#24478,"PENIANGAN, MARGA SEKAMPUNG, LAMPUNG TIMUR, LAMPUNG",6,61,92,153
https://kawalpemilu.org#24478,"PENIANGAN, MARGA SEKAMPUNG, LAMPUNG TIMUR, LAMPUNG",7,71,70,141
https://kawalpemilu.org#24478,"PENIANGAN, MARGA SEKAMPUNG, LAMPUNG TIMUR, LAMPUNG",8,74,88,162
https://kawalpemilu.org#24478,"PENIANGAN, MARGA SEKAMPUNG, LAMPUNG TIMUR, LAMPUNG",9,97,120,217
https://kawalpemilu.org#24478,"PENIANGAN, MARGA SEKAMPUNG, LAMPUNG TIMUR, LAMPUNG",10,136,66,202
https://kawalpemilu.org#24478,"PENIANGAN, MARGA SEKAMPUNG, LAMPUNG TIMUR, LAMPUNG",11,119,30,149
https://kawalpemilu.org#24478,"PENIANGAN, MARGA SEKAMPUNG, LAMPUNG TIMUR, LAMPUNG",12,161,23,184
https://kawalpemilu.org#24478,"PENIANGAN, MARGA SEKAMPUNG, LAMPUNG TIMUR, LAMPUNG",13,145,42,187
https://kawalpemilu.org#24479,"GUNUNG RAYA, MARGA SEKAMPUNG, LAMPUNG TIMUR, LAMPUNG",1,73,114,187
https://kawalpemilu.org#24479,"GUNUNG RAYA, MARGA SEKAMPUNG, LAMPUNG TIMUR, LAMPUNG",2,32,111,143
https://kawalpemilu.org#24479,"GUNUNG RAYA, MARGA SEKAMPUNG, LAMPUNG TIMUR, LAMPUNG",3,31,103,134
https://kawalpemilu.org#24479,"GUNUNG RAYA, MARGA SEKAMPUNG, LAMPUNG TIMUR, LAMPUNG",4,26,91,117
https://kawalpemilu.org#24479,"GUNUNG RAYA, MARGA SEKAMPUNG, LAMPUNG TIMUR, LAMPUNG",5,12,133,145
https://kawalpemilu.org#24479,"GUNUNG RAYA, MARGA SEKAMPUNG, LAMPUNG TIMUR, LAMPUNG",6,68,81,149
https://kawalpemilu.org#24479,"GUNUNG RAYA, MARGA SEKAMPUNG, LAMPUNG TIMUR, LAMPUNG",7,75,60,135
https://kawalpemilu.org#24479,"GUNUNG RAYA, MARGA SEKAMPUNG, LAMPUNG TIMUR, LAMPUNG",8,128,40,168
https://kawalpemilu.org#24479,"GUNUNG RAYA, MARGA SEKAMPUNG, LAMPUNG TIMUR, LAMPUNG",9,144,43,187
https://kawalpemilu.org#24480,"GIRI MULYO, MARGA SEKAMPUNG, LAMPUNG TIMUR, LAMPUNG",1,99,177,216
https://kawalpemilu.org#24480,"GIRI MULYO, MARGA SEKAMPUNG, LAMPUNG TIMUR, LAMPUNG",2,95,90,185
https://kawalpemilu.org#24480,"GIRI MULYO, MARGA SEKAMPUNG, LAMPUNG TIMUR, LAMPUNG",3,161,26,187
https://kawalpemilu.org#24480,"GIRI MULYO, MARGA SEKAMPUNG, LAMPUNG TIMUR, LAMPUNG",4,159,15,174
https://kawalpemilu.org#24480,"GIRI MULYO, MARGA SEKAMPUNG, LAMPUNG TIMUR, LAMPUNG",5,69,79,148
https://kawalpemilu.org#24480,"GIRI MULYO, MARGA SEKAMPUNG, LAMPUNG TIMUR, LAMPUNG",6,85,82,167
https://kawalpemilu.org#24480,"GIRI MULYO, MARGA SEKAMPUNG, LAMPUNG TIMUR, LAMPUNG",7,84,71,155
https://kawalpemilu.org#24480,"GIRI MULYO, MARGA SEKAMPUNG, LAMPUNG TIMUR, LAMPUNG",8,113,8,121
https://kawalpemilu.org#24480,"GIRI MULYO, MARGA SEKAMPUNG, LAMPUNG TIMUR, LAMPUNG",9,109,17,126
https://kawalpemilu.org#24480,"GIRI MULYO, MARGA SEKAMPUNG, LAMPUNG TIMUR, LAMPUNG",10,160,23,183
https://kawalpemilu.org#24480,"GIRI MULYO, MARGA SEKAMPUNG, LAMPUNG TIMUR, LAMPUNG",11,150,9,159
https://kawalpemilu.org#24480,"GIRI MULYO, MARGA SEKAMPUNG, LAMPUNG TIMUR, LAMPUNG",12,106,21,127
https://kawalpemilu.org#24480,"GIRI MULYO, MARGA SEKAMPUNG, LAMPUNG TIMUR, LAMPUNG",13,99,25,124
https://kawalpemilu.org#24480,"GIRI MULYO, MARGA SEKAMPUNG, LAMPUNG TIMUR, LAMPUNG",14,209,21,230
https://kawalpemilu.org#24480,"GIRI MULYO, MARGA SEKAMPUNG, LAMPUNG TIMUR, LAMPUNG",15,195,19,214
https://kawalpemilu.org#24480,"GIRI MULYO, MARGA SEKAMPUNG, LAMPUNG TIMUR, LAMPUNG",16,129,25,154
https://kawalpemilu.org#24480,"GIRI MULYO, MARGA SEKAMPUNG, LAMPUNG TIMUR, LAMPUNG",17,149,12,161
https://kawalpemilu.org#24480,"GIRI MULYO, MARGA SEKAMPUNG, LAMPUNG TIMUR, LAMPUNG",18,147,10,157
https://kawalpemilu.org#24480,"GIRI MULYO, MARGA SEKAMPUNG, LAMPUNG TIMUR, LAMPUNG",19,171,4,175
https://kawalpemilu.org#24480,"GIRI MULYO, MARGA SEKAMPUNG, LAMPUNG TIMUR, LAMPUNG",20,168,9,177
https://kawalpemilu.org#24480,"GIRI MULYO, MARGA SEKAMPUNG, LAMPUNG TIMUR, LAMPUNG",21,139,8,147
https://kawalpemilu.org#24480,"GIRI MULYO, MARGA SEKAMPUNG, LAMPUNG TIMUR, LAMPUNG",22,250,5,255
https://kawalpemilu.org#24480,"GIRI MULYO, MARGA SEKAMPUNG, LAMPUNG TIMUR, LAMPUNG",23,226,12,238
https://kawalpemilu.org#24480,"GIRI MULYO, MARGA SEKAMPUNG, LAMPUNG TIMUR, LAMPUNG",24,231,2,233
https://kawalpemilu.org#24480,"GIRI MULYO, MARGA SEKAMPUNG, LAMPUNG TIMUR, LAMPUNG",25,234,11,245
https://kawalpemilu.org#24480,"GIRI MULYO, MARGA SEKAMPUNG, LAMPUNG TIMUR, LAMPUNG",26,184,25,209
https://kawalpemilu.org#24480,"GIRI MULYO, MARGA SEKAMPUNG, LAMPUNG TIMUR, LAMPUNG",27,187,6,193
https://kawalpemilu.org#24481,"GUNUNG MAS, MARGA SEKAMPUNG, LAMPUNG TIMUR, LAMPUNG",1,210,11,221
https://kawalpemilu.org#24481,"GUNUNG MAS, MARGA SEKAMPUNG, LAMPUNG TIMUR, LAMPUNG",2,223,18,241
https://kawalpemilu.org#24481,"GUNUNG MAS, MARGA SEKAMPUNG, LAMPUNG TIMUR, LAMPUNG",3,161,11,172
https://kawalpemilu.org#24481,"GUNUNG MAS, MARGA SEKAMPUNG, LAMPUNG TIMUR, LAMPUNG",4,112,22,134
https://kawalpemilu.org#24481,"GUNUNG MAS, MARGA SEKAMPUNG, LAMPUNG TIMUR, LAMPUNG",5,157,18,175
https://kawalpemilu.org#24481,"GUNUNG MAS, MARGA SEKAMPUNG, LAMPUNG TIMUR, LAMPUNG",6,163,7,170
https://kawalpemilu.org#24481,"GUNUNG MAS, MARGA SEKAMPUNG, LAMPUNG TIMUR, LAMPUNG",7,175,6,181
https://kawalpemilu.org#24481,"GUNUNG MAS, MARGA SEKAMPUNG, LAMPUNG TIMUR, LAMPUNG",8,134,29,163
https://kawalpemilu.org#24481,"GUNUNG MAS, MARGA SEKAMPUNG, LAMPUNG TIMUR, LAMPUNG",9,157,27,184
https://kawalpemilu.org#24481,"GUNUNG MAS, MARGA SEKAMPUNG, LAMPUNG TIMUR, LAMPUNG",10,162,19,181
https://kawalpemilu.org#24482,"PURWOSARI, MARGA SEKAMPUNG, LAMPUNG TIMUR, LAMPUNG",1,202,38,240
https://kawalpemilu.org#24482,"PURWOSARI, MARGA SEKAMPUNG, LAMPUNG TIMUR, LAMPUNG",2,201,31,232
https://kawalpemilu.org#24482,"PURWOSARI, MARGA SEKAMPUNG, LAMPUNG TIMUR, LAMPUNG",3,201,19,220
https://kawalpemilu.org#24482,"PURWOSARI, MARGA SEKAMPUNG, LAMPUNG TIMUR, LAMPUNG",4,192,16,208
https://kawalpemilu.org#24482,"PURWOSARI, MARGA SEKAMPUNG, LAMPUNG TIMUR, LAMPUNG",5,211,5,216
https://kawalpemilu.org#24482,"PURWOSARI, MARGA SEKAMPUNG, LAMPUNG TIMUR, LAMPUNG",6,190,6,196
https://kawalpemilu.org#24483,"BUKIT RAYA, MARGA SEKAMPUNG, LAMPUNG TIMUR, LAMPUNG",1,171,8,179
https://kawalpemilu.org#24483,"BUKIT RAYA, MARGA SEKAMPUNG, LAMPUNG TIMUR, LAMPUNG",2,178,8,186
https://kawalpemilu.org#24483,"BUKIT RAYA, MARGA SEKAMPUNG, LAMPUNG TIMUR, LAMPUNG",3,205,15,220
https://kawalpemilu.org#24486,"BLAMBANGAN UMPU, BLAMBANGAN UMPU, WAY KANAN, LAMPUNG",1,39,233,272
https://kawalpemilu.org#24486,"BLAMBANGAN UMPU, BLAMBANGAN UMPU, WAY KANAN, LAMPUNG",2,51,166,217
https://kawalpemilu.org#24486,"BLAMBANGAN UMPU, BLAMBANGAN UMPU, WAY KANAN, LAMPUNG",3,60,142,202
https://kawalpemilu.org#24486,"BLAMBANGAN UMPU, BLAMBANGAN UMPU, WAY KANAN, LAMPUNG",4,87,149,236
https://kawalpemilu.org#24486,"BLAMBANGAN UMPU, BLAMBANGAN UMPU, WAY KANAN, LAMPUNG",5,63,178,241
https://kawalpemilu.org#24486,"BLAMBANGAN UMPU, BLAMBANGAN UMPU, WAY KANAN, LAMPUNG",6,58,123,181
https://kawalpemilu.org#24486,"BLAMBANGAN UMPU, BLAMBANGAN UMPU, WAY KANAN, LAMPUNG",7,61,110,171
https://kawalpemilu.org#24486,"BLAMBANGAN UMPU, BLAMBANGAN UMPU, WAY KANAN, LAMPUNG",8,61,153,214
https://kawalpemilu.org#24486,"BLAMBANGAN UMPU, BLAMBANGAN UMPU, WAY KANAN, LAMPUNG",9,44,158,202
https://kawalpemilu.org#24486,"BLAMBANGAN UMPU, BLAMBANGAN UMPU, WAY KANAN, LAMPUNG",10,36,194,230
https://kawalpemilu.org#24486,"BLAMBANGAN UMPU, BLAMBANGAN UMPU, WAY KANAN, LAMPUNG",11,60,182,242
https://kawalpemilu.org#24486,"BLAMBANGAN UMPU, BLAMBANGAN UMPU, WAY KANAN, LAMPUNG",12,42,124,166
https://kawalpemilu.org#24486,"BLAMBANGAN UMPU, BLAMBANGAN UMPU, WAY KANAN, LAMPUNG",13,51,74,125
https://kawalpemilu.org#24486,"BLAMBANGAN UMPU, BLAMBANGAN UMPU, WAY KANAN, LAMPUNG",14,74,215,289
https://kawalpemilu.org#24487,"RAMBANG JAYA, BLAMBANGAN UMPU, WAY KANAN, LAMPUNG",1,58,105,163
https://kawalpemilu.org#24487,"RAMBANG JAYA, BLAMBANGAN UMPU, WAY KANAN, LAMPUNG",2,81,76,157
https://kawalpemilu.org#24488,"GISTANG, BLAMBANGAN UMPU, WAY KANAN, LAMPUNG",1,102,59,161
https://kawalpemilu.org#24488,"GISTANG, BLAMBANGAN UMPU, WAY KANAN, LAMPUNG",2,23,128,151
https://kawalpemilu.org#24488,"GISTANG, BLAMBANGAN UMPU, WAY KANAN, LAMPUNG",3,57,93,150
https://kawalpemilu.org#24488,"GISTANG, BLAMBANGAN UMPU, WAY KANAN, LAMPUNG",4,57,53,110
https://kawalpemilu.org#24488,"GISTANG, BLAMBANGAN UMPU, WAY KANAN, LAMPUNG",5,19,45,64
https://kawalpemilu.org#24488,"GISTANG, BLAMBANGAN UMPU, WAY KANAN, LAMPUNG",6,115,107,222
https://kawalpemilu.org#24488,"GISTANG, BLAMBANGAN UMPU, WAY KANAN, LAMPUNG",7,82,137,219
https://kawalpemilu.org#24488,"GISTANG, BLAMBANGAN UMPU, WAY KANAN, LAMPUNG",8,71,39,110
https://kawalpemilu.org#24488,"GISTANG, BLAMBANGAN UMPU, WAY KANAN, LAMPUNG",9,51,122,173
https://kawalpemilu.org#24488,"GISTANG, BLAMBANGAN UMPU, WAY KANAN, LAMPUNG",10,92,78,170
https://kawalpemilu.org#24488,"GISTANG, BLAMBANGAN UMPU, WAY KANAN, LAMPUNG",11,75,104,179
https://kawalpemilu.org#24488,"GISTANG, BLAMBANGAN UMPU, WAY KANAN, LAMPUNG",13,127,63,190
https://kawalpemilu.org#24489,"SIDOARJO, BLAMBANGAN UMPU, WAY KANAN, LAMPUNG",1,140,54,194
https://kawalpemilu.org#24489,"SIDOARJO, BLAMBANGAN UMPU, WAY KANAN, LAMPUNG",2,92,124,216
https://kawalpemilu.org#24489,"SIDOARJO, BLAMBANGAN UMPU, WAY KANAN, LAMPUNG",3,88,138,226
https://kawalpemilu.org#24489,"SIDOARJO, BLAMBANGAN UMPU, WAY KANAN, LAMPUNG",4,96,82,178
https://kawalpemilu.org#24489,"SIDOARJO, BLAMBANGAN UMPU, WAY KANAN, LAMPUNG",5,103,90,193
https://kawalpemilu.org#24489,"SIDOARJO, BLAMBANGAN UMPU, WAY KANAN, LAMPUNG",6,106,127,233
https://kawalpemilu.org#24489,"SIDOARJO, BLAMBANGAN UMPU, WAY KANAN, LAMPUNG",7,114,97,211
https://kawalpemilu.org#24490,"BUMI RATU, BLAMBANGAN UMPU, WAY KANAN, LAMPUNG",1,83,187,270
https://kawalpemilu.org#24490,"BUMI RATU, BLAMBANGAN UMPU, WAY KANAN, LAMPUNG",2,91,137,228
https://kawalpemilu.org#24490,"BUMI RATU, BLAMBANGAN UMPU, WAY KANAN, LAMPUNG",3,73,115,188
https://kawalpemilu.org#24490,"BUMI RATU, BLAMBANGAN UMPU, WAY KANAN, LAMPUNG",4,147,103,250
https://kawalpemilu.org#24490,"BUMI RATU, BLAMBANGAN UMPU, WAY KANAN, LAMPUNG",5,95,139,234
https://kawalpemilu.org#24490,"BUMI RATU, BLAMBANGAN UMPU, WAY KANAN, LAMPUNG",6,92,122,214
https://kawalpemilu.org#24490,"BUMI RATU, BLAMBANGAN UMPU, WAY KANAN, LAMPUNG",7,92,99,191
https://kawalpemilu.org#24491,"LEMBASUNG, BLAMBANGAN UMPU, WAY KANAN, LAMPUNG",1,88,120,208
https://kawalpemilu.org#24491,"LEMBASUNG, BLAMBANGAN UMPU, WAY KANAN, LAMPUNG",2,57,147,204
https://kawalpemilu.org#24491,"LEMBASUNG, BLAMBANGAN UMPU, WAY KANAN, LAMPUNG",3,104,57,161
https://kawalpemilu.org#24491,"LEMBASUNG, BLAMBANGAN UMPU, WAY KANAN, LAMPUNG",4,79,101,180
https://kawalpemilu.org#24491,"LEMBASUNG, BLAMBANGAN UMPU, WAY KANAN, LAMPUNG",5,71,137,208
https://kawalpemilu.org#24491,"LEMBASUNG, BLAMBANGAN UMPU, WAY KANAN, LAMPUNG",6,56,101,157
https://kawalpemilu.org#24491,"LEMBASUNG, BLAMBANGAN UMPU, WAY KANAN, LAMPUNG",7,70,111,181
https://kawalpemilu.org#24491,"LEMBASUNG, BLAMBANGAN UMPU, WAY KANAN, LAMPUNG",8,90,79,169
https://kawalpemilu.org#24491,"LEMBASUNG, BLAMBANGAN UMPU, WAY KANAN, LAMPUNG",9,78,133,211
https://kawalpemilu.org#24492,"NEGERI BARU, BLAMBANGAN UMPU, WAY KANAN, LAMPUNG",1,54,125,179
https://kawalpemilu.org#24492,"NEGERI BARU, BLAMBANGAN UMPU, WAY KANAN, LAMPUNG",2,30,41,2
https://kawalpemilu.org#24492,"NEGERI BARU, BLAMBANGAN UMPU, WAY KANAN, LAMPUNG",3,82,112,194
https://kawalpemilu.org#24492,"NEGERI BARU, BLAMBANGAN UMPU, WAY KANAN, LAMPUNG",4,44,118,162
https://kawalpemilu.org#24492,"NEGERI BARU, BLAMBANGAN UMPU, WAY KANAN, LAMPUNG",5,44,182,226
https://kawalpemilu.org#24492,"NEGERI BARU, BLAMBANGAN UMPU, WAY KANAN, LAMPUNG",6,44,170,214
https://kawalpemilu.org#24492,"NEGERI BARU, BLAMBANGAN UMPU, WAY KANAN, LAMPUNG",7,59,149,208
https://kawalpemilu.org#24492,"NEGERI BARU, BLAMBANGAN UMPU, WAY KANAN, LAMPUNG",9,55,102,157
https://kawalpemilu.org#24492,"NEGERI BARU, BLAMBANGAN UMPU, WAY KANAN, LAMPUNG",10,126,120,246
https://kawalpemilu.org#24492,"NEGERI BARU, BLAMBANGAN UMPU, WAY KANAN, LAMPUNG",11,29,79,108
https://kawalpemilu.org#24492,"NEGERI BARU, BLAMBANGAN UMPU, WAY KANAN, LAMPUNG",12,75,94,169
https://kawalpemilu.org#24492,"NEGERI BARU, BLAMBANGAN UMPU, WAY KANAN, LAMPUNG",13,40,89,129
https://kawalpemilu.org#24492,"NEGERI BARU, BLAMBANGAN UMPU, WAY KANAN, LAMPUNG",14,82,128,210
https://kawalpemilu.org#24492,"NEGERI BARU, BLAMBANGAN UMPU, WAY KANAN, LAMPUNG",15,40,101,3
https://kawalpemilu.org#24492,"NEGERI BARU, BLAMBANGAN UMPU, WAY KANAN, LAMPUNG",16,20,123,143
https://kawalpemilu.org#24492,"NEGERI BARU, BLAMBANGAN UMPU, WAY KANAN, LAMPUNG",17,101,137,238
https://kawalpemilu.org#24492,"NEGERI BARU, BLAMBANGAN UMPU, WAY KANAN, LAMPUNG",18,9,72,81
https://kawalpemilu.org#24492,"NEGERI BARU, BLAMBANGAN UMPU, WAY KANAN, LAMPUNG",19,9,81,90
https://kawalpemilu.org#24492,"NEGERI BARU, BLAMBANGAN UMPU, WAY KANAN, LAMPUNG",20,33,52,85
https://kawalpemilu.org#24492,"NEGERI BARU, BLAMBANGAN UMPU, WAY KANAN, LAMPUNG",21,4,15,19
https://kawalpemilu.org#24492,"NEGERI BARU, BLAMBANGAN UMPU, WAY KANAN, LAMPUNG",22,7,47,54
https://kawalpemilu.org#24492,"NEGERI BARU, BLAMBANGAN UMPU, WAY KANAN, LAMPUNG",23,2,9,11
https://kawalpemilu.org#24493,"NEGERI BATIN, BLAMBANGAN UMPU, WAY KANAN, LAMPUNG",1,39,167,206
https://kawalpemilu.org#24493,"NEGERI BATIN, BLAMBANGAN UMPU, WAY KANAN, LAMPUNG",2,155,94,249
https://kawalpemilu.org#24493,"NEGERI BATIN, BLAMBANGAN UMPU, WAY KANAN, LAMPUNG",3,189,63,252
https://kawalpemilu.org#24493,"NEGERI BATIN, BLAMBANGAN UMPU, WAY KANAN, LAMPUNG",4,74,138,212
https://kawalpemilu.org#24493,"NEGERI BATIN, BLAMBANGAN UMPU, WAY KANAN, LAMPUNG",5,84,43,127
https://kawalpemilu.org#24493,"NEGERI BATIN, BLAMBANGAN UMPU, WAY KANAN, LAMPUNG",6,127,96,223
https://kawalpemilu.org#24493,"NEGERI BATIN, BLAMBANGAN UMPU, WAY KANAN, LAMPUNG",7,192,56,248
https://kawalpemilu.org#24493,"NEGERI BATIN, BLAMBANGAN UMPU, WAY KANAN, LAMPUNG",8,125,86,211
https://kawalpemilu.org#24493,"NEGERI BATIN, BLAMBANGAN UMPU, WAY KANAN, LAMPUNG",9,79,88,167
https://kawalpemilu.org#24493,"NEGERI BATIN, BLAMBANGAN UMPU, WAY KANAN, LAMPUNG",10,101,110,211
https://kawalpemilu.org#24493,"NEGERI BATIN, BLAMBANGAN UMPU, WAY KANAN, LAMPUNG",12,22,100,122
https://kawalpemilu.org#24493,"NEGERI BATIN, BLAMBANGAN UMPU, WAY KANAN, LAMPUNG",13,100,82,183
https://kawalpemilu.org#24493,"NEGERI BATIN, BLAMBANGAN UMPU, WAY KANAN, LAMPUNG",14,56,149,205
https://kawalpemilu.org#24493,"NEGERI BATIN, BLAMBANGAN UMPU, WAY KANAN, LAMPUNG",15,85,57,142
https://kawalpemilu.org#24494,"GUNUNG SANGKARAN, BLAMBANGAN UMPU, WAY KANAN, LAMPUNG",1,77,80,157
https://kawalpemilu.org#24494,"GUNUNG SANGKARAN, BLAMBANGAN UMPU, WAY KANAN, LAMPUNG",2,93,41,134
https://kawalpemilu.org#24494,"GUNUNG SANGKARAN, BLAMBANGAN UMPU, WAY KANAN, LAMPUNG",3,66,137,203
https://kawalpemilu.org#24494,"GUNUNG SANGKARAN, BLAMBANGAN UMPU, WAY KANAN, LAMPUNG",4,108,82,190
https://kawalpemilu.org#24494,"GUNUNG SANGKARAN, BLAMBANGAN UMPU, WAY KANAN, LAMPUNG",6,102,72,174
https://kawalpemilu.org#24494,"GUNUNG SANGKARAN, BLAMBANGAN UMPU, WAY KANAN, LAMPUNG",7,123,80,203
https://kawalpemilu.org#24494,"GUNUNG SANGKARAN, BLAMBANGAN UMPU, WAY KANAN, LAMPUNG",8,123,49,172
https://kawalpemilu.org#24494,"GUNUNG SANGKARAN, BLAMBANGAN UMPU, WAY KANAN, LAMPUNG",9,90,84,174
https://kawalpemilu.org#24494,"GUNUNG SANGKARAN, BLAMBANGAN UMPU, WAY KANAN, LAMPUNG",10,101,62,163
https://kawalpemilu.org#24494,"GUNUNG SANGKARAN, BLAMBANGAN UMPU, WAY KANAN, LAMPUNG",11,55,68,123
https://kawalpemilu.org#24494,"GUNUNG SANGKARAN, BLAMBANGAN UMPU, WAY KANAN, LAMPUNG",12,87,47,134
https://kawalpemilu.org#24494,"GUNUNG SANGKARAN, BLAMBANGAN UMPU, WAY KANAN, LAMPUNG",13,91,69,160
https://kawalpemilu.org#24495,"TANJUNG RAJA GIHAM, BLAMBANGAN UMPU, WAY KANAN, LAMPUNG",1,40,79,119
https://kawalpemilu.org#24495,"TANJUNG RAJA GIHAM, BLAMBANGAN UMPU, WAY KANAN, LAMPUNG",2,26,62,88
https://kawalpemilu.org#24495,"TANJUNG RAJA GIHAM, BLAMBANGAN UMPU, WAY KANAN, LAMPUNG",3,62,112,174
https://kawalpemilu.org#24495,"TANJUNG RAJA GIHAM, BLAMBANGAN UMPU, WAY KANAN, LAMPUNG",4,48,92,140
https://kawalpemilu.org#24495,"TANJUNG RAJA GIHAM, BLAMBANGAN UMPU, WAY KANAN, LAMPUNG",5,44,115,159
https://kawalpemilu.org#24495,"TANJUNG RAJA GIHAM, BLAMBANGAN UMPU, WAY KANAN, LAMPUNG",6,20,70,90
https://kawalpemilu.org#24495,"TANJUNG RAJA GIHAM, BLAMBANGAN UMPU, WAY KANAN, LAMPUNG",7,29,39,68
https://kawalpemilu.org#24496,"SEGARA MIDER, BLAMBANGAN UMPU, WAY KANAN, LAMPUNG",1,247,31,278
https://kawalpemilu.org#24497,"UMPU BHAKTI, BLAMBANGAN UMPU, WAY KANAN, LAMPUNG",1,57,75,132
https://kawalpemilu.org#24497,"UMPU BHAKTI, BLAMBANGAN UMPU, WAY KANAN, LAMPUNG",2,120,43,163
https://kawalpemilu.org#24497,"UMPU BHAKTI, BLAMBANGAN UMPU, WAY KANAN, LAMPUNG",3,104,67,171
https://kawalpemilu.org#24497,"UMPU BHAKTI, BLAMBANGAN UMPU, WAY KANAN, LAMPUNG",5,82,70,152
https://kawalpemilu.org#24497,"UMPU BHAKTI, BLAMBANGAN UMPU, WAY KANAN, LAMPUNG",6,90,57,147
https://kawalpemilu.org#24497,"UMPU BHAKTI, BLAMBANGAN UMPU, WAY KANAN, LAMPUNG",7,92,53,145
https://kawalpemilu.org#24497,"UMPU BHAKTI, BLAMBANGAN UMPU, WAY KANAN, LAMPUNG",8,62,76,138
https://kawalpemilu.org#24497,"UMPU BHAKTI, BLAMBANGAN UMPU, WAY KANAN, LAMPUNG",9,116,54,170
https://kawalpemilu.org#24497,"UMPU BHAKTI, BLAMBANGAN UMPU, WAY KANAN, LAMPUNG",10,110,52,162
https://kawalpemilu.org#24498,"SANGKARAN BAKTI, BLAMBANGAN UMPU, WAY KANAN, LAMPUNG",1,119,67,186
https://kawalpemilu.org#24498,"SANGKARAN BAKTI, BLAMBANGAN UMPU, WAY KANAN, LAMPUNG",2,95,72,167
https://kawalpemilu.org#24498,"SANGKARAN BAKTI, BLAMBANGAN UMPU, WAY KANAN, LAMPUNG",3,151,56,207
https://kawalpemilu.org#24498,"SANGKARAN BAKTI, BLAMBANGAN UMPU, WAY KANAN, LAMPUNG",4,129,78,207
https://kawalpemilu.org#24498,"SANGKARAN BAKTI, BLAMBANGAN UMPU, WAY KANAN, LAMPUNG",5,92,75,167
https://kawalpemilu.org#24498,"SANGKARAN BAKTI, BLAMBANGAN UMPU, WAY KANAN, LAMPUNG",6,98,84,182
https://kawalpemilu.org#24498,"SANGKARAN BAKTI, BLAMBANGAN UMPU, WAY KANAN, LAMPUNG",7,136,49,185
https://kawalpemilu.org#24499,"BUMI BARU, BLAMBANGAN UMPU, WAY KANAN, LAMPUNG",1,103,106,209
https://kawalpemilu.org#24499,"BUMI BARU, BLAMBANGAN UMPU, WAY KANAN, LAMPUNG",2,118,91,209
https://kawalpemilu.org#24499,"BUMI BARU, BLAMBANGAN UMPU, WAY KANAN, LAMPUNG",3,146,54,200
https://kawalpemilu.org#24499,"BUMI BARU, BLAMBANGAN UMPU, WAY KANAN, LAMPUNG",4,102,85,187
https://kawalpemilu.org#24499,"BUMI BARU, BLAMBANGAN UMPU, WAY KANAN, LAMPUNG",5,70,76,146
https://kawalpemilu.org#24499,"BUMI BARU, BLAMBANGAN UMPU, WAY KANAN, LAMPUNG",6,109,102,211
https://kawalpemilu.org#24499,"BUMI BARU, BLAMBANGAN UMPU, WAY KANAN, LAMPUNG",7,120,89,209
https://kawalpemilu.org#24499,"BUMI BARU, BLAMBANGAN UMPU, WAY KANAN, LAMPUNG",8,158,47,205
https://kawalpemilu.org#24499,"BUMI BARU, BLAMBANGAN UMPU, WAY KANAN, LAMPUNG",9,148,52,200
https://kawalpemilu.org#24499,"BUMI BARU, BLAMBANGAN UMPU, WAY KANAN, LAMPUNG",10,116,77,193
https://kawalpemilu.org#24499,"BUMI BARU, BLAMBANGAN UMPU, WAY KANAN, LAMPUNG",11,71,67,138
https://kawalpemilu.org#24500,"TANJUNG SARI, BLAMBANGAN UMPU, WAY KANAN, LAMPUNG",1,165,39,204
https://kawalpemilu.org#24500,"TANJUNG SARI, BLAMBANGAN UMPU, WAY KANAN, LAMPUNG",2,115,45,162
https://kawalpemilu.org#24500,"TANJUNG SARI, BLAMBANGAN UMPU, WAY KANAN, LAMPUNG",3,141,26,167
https://kawalpemilu.org#24500,"TANJUNG SARI, BLAMBANGAN UMPU, WAY KANAN, LAMPUNG",4,131,54,185
https://kawalpemilu.org#24501,"SRI REJEKI, BLAMBANGAN UMPU, WAY KANAN, LAMPUNG",1,151,56,207
https://kawalpemilu.org#24501,"SRI REJEKI, BLAMBANGAN UMPU, WAY KANAN, LAMPUNG",2,150,72,222
https://kawalpemilu.org#24501,"SRI REJEKI, BLAMBANGAN UMPU, WAY KANAN, LAMPUNG",3,108,88,196
https://kawalpemilu.org#24501,"SRI REJEKI, BLAMBANGAN UMPU, WAY KANAN, LAMPUNG",4,134,50,184
https://kawalpemilu.org#24501,"SRI REJEKI, BLAMBANGAN UMPU, WAY KANAN, LAMPUNG",5,95,45,140
https://kawalpemilu.org#24501,"SRI REJEKI, BLAMBANGAN UMPU, WAY KANAN, LAMPUNG",6,109,48,157
https://kawalpemilu.org#24502,"KARANG UMPU, BLAMBANGAN UMPU, WAY KANAN, LAMPUNG",1,97,99,196
https://kawalpemilu.org#24502,"KARANG UMPU, BLAMBANGAN UMPU, WAY KANAN, LAMPUNG",2,101,66,167
https://kawalpemilu.org#24502,"KARANG UMPU, BLAMBANGAN UMPU, WAY KANAN, LAMPUNG",4,69,28,97
https://kawalpemilu.org#24502,"KARANG UMPU, BLAMBANGAN UMPU, WAY KANAN, LAMPUNG",5,96,87,183
https://kawalpemilu.org#24502,"KARANG UMPU, BLAMBANGAN UMPU, WAY KANAN, LAMPUNG",6,88,109,197
https://kawalpemilu.org#24502,"KARANG UMPU, BLAMBANGAN UMPU, WAY KANAN, LAMPUNG",7,115,92,207
https://kawalpemilu.org#24502,"KARANG UMPU, BLAMBANGAN UMPU, WAY KANAN, LAMPUNG",8,135,89,224
https://kawalpemilu.org#24503,"UMPU KENCANA, BLAMBANGAN UMPU, WAY KANAN, LAMPUNG",1,121,57,178
https://kawalpemilu.org#24503,"UMPU KENCANA, BLAMBANGAN UMPU, WAY KANAN, LAMPUNG",2,100,138,238
https://kawalpemilu.org#24503,"UMPU KENCANA, BLAMBANGAN UMPU, WAY KANAN, LAMPUNG",3,101,95,196
https://kawalpemilu.org#24503,"UMPU KENCANA, BLAMBANGAN UMPU, WAY KANAN, LAMPUNG",4,62,195,257
https://kawalpemilu.org#24503,"UMPU KENCANA, BLAMBANGAN UMPU, WAY KANAN, LAMPUNG",5,152,73,225
https://kawalpemilu.org#24503,"UMPU KENCANA, BLAMBANGAN UMPU, WAY KANAN, LAMPUNG",6,148,45,193
https://kawalpemilu.org#24503,"UMPU KENCANA, BLAMBANGAN UMPU, WAY KANAN, LAMPUNG",7,99,123,222
https://kawalpemilu.org#24503,"UMPU KENCANA, BLAMBANGAN UMPU, WAY KANAN, LAMPUNG",8,106,118,224
https://kawalpemilu.org#24504,"SRIWIJAYA, BLAMBANGAN UMPU, WAY KANAN, LAMPUNG",1,119,126,250
https://kawalpemilu.org#24504,"SRIWIJAYA, BLAMBANGAN UMPU, WAY KANAN, LAMPUNG",2,137,43,180
https://kawalpemilu.org#24504,"SRIWIJAYA, BLAMBANGAN UMPU, WAY KANAN, LAMPUNG",3,139,53,192
https://kawalpemilu.org#24504,"SRIWIJAYA, BLAMBANGAN UMPU, WAY KANAN, LAMPUNG",4,113,95,208
https://kawalpemilu.org#24504,"SRIWIJAYA, BLAMBANGAN UMPU, WAY KANAN, LAMPUNG",5,151,26,177
https://kawalpemilu.org#24505,"BRATHA YUDHA, BLAMBANGAN UMPU, WAY KANAN, LAMPUNG",1,6,173,179
https://kawalpemilu.org#24505,"BRATHA YUDHA, BLAMBANGAN UMPU, WAY KANAN, LAMPUNG",2,48,147,195
https://kawalpemilu.org#24505,"BRATHA YUDHA, BLAMBANGAN UMPU, WAY KANAN, LAMPUNG",3,129,108,237
https://kawalpemilu.org#24505,"BRATHA YUDHA, BLAMBANGAN UMPU, WAY KANAN, LAMPUNG",4,49,129,178
https://kawalpemilu.org#24505,"BRATHA YUDHA, BLAMBANGAN UMPU, WAY KANAN, LAMPUNG",5,133,48,181
https://kawalpemilu.org#24505,"BRATHA YUDHA, BLAMBANGAN UMPU, WAY KANAN, LAMPUNG",6,95,124,219
https://kawalpemilu.org#24506,"GEDUNG BATIN, BLAMBANGAN UMPU, WAY KANAN, LAMPUNG",1,50,224,1
https://kawalpemilu.org#24506,"GEDUNG BATIN, BLAMBANGAN UMPU, WAY KANAN, LAMPUNG",2,42,179,221
https://kawalpemilu.org#24506,"GEDUNG BATIN, BLAMBANGAN UMPU, WAY KANAN, LAMPUNG",3,148,104,252
https://kawalpemilu.org#24506,"GEDUNG BATIN, BLAMBANGAN UMPU, WAY KANAN, LAMPUNG",4,144,89,233
https://kawalpemilu.org#24507,"TANJUNG RAJA SAKTI, BLAMBANGAN UMPU, WAY KANAN, LAMPUNG",1,73,103,176
https://kawalpemilu.org#24507,"TANJUNG RAJA SAKTI, BLAMBANGAN UMPU, WAY KANAN, LAMPUNG",2,99,66,165
https://kawalpemilu.org#24507,"TANJUNG RAJA SAKTI, BLAMBANGAN UMPU, WAY KANAN, LAMPUNG",3,175,19,194
https://kawalpemilu.org#24507,"TANJUNG RAJA SAKTI, BLAMBANGAN UMPU, WAY KANAN, LAMPUNG",4,88,114,202
https://kawalpemilu.org#24507,"TANJUNG RAJA SAKTI, BLAMBANGAN UMPU, WAY KANAN, LAMPUNG",5,125,71,196
https://kawalpemilu.org#24507,"TANJUNG RAJA SAKTI, BLAMBANGAN UMPU, WAY KANAN, LAMPUNG",6,80,48,128
https://kawalpemilu.org#24507,"TANJUNG RAJA SAKTI, BLAMBANGAN UMPU, WAY KANAN, LAMPUNG",7,194,19,168
https://kawalpemilu.org#24507,"TANJUNG RAJA SAKTI, BLAMBANGAN UMPU, WAY KANAN, LAMPUNG",8,157,17,174
https://kawalpemilu.org#24508,"NEGERI BUMI PUTRA, BLAMBANGAN UMPU, WAY KANAN, LAMPUNG",1,75,147,222
https://kawalpemilu.org#24508,"NEGERI BUMI PUTRA, BLAMBANGAN UMPU, WAY KANAN, LAMPUNG",2,64,20,84
https://kawalpemilu.org#24508,"NEGERI BUMI PUTRA, BLAMBANGAN UMPU, WAY KANAN, LAMPUNG",3,101,92,193
https://kawalpemilu.org#24508,"NEGERI BUMI PUTRA, BLAMBANGAN UMPU, WAY KANAN, LAMPUNG",4,84,153,237
https://kawalpemilu.org#24508,"NEGERI BUMI PUTRA, BLAMBANGAN UMPU, WAY KANAN, LAMPUNG",5,125,58,183
https://kawalpemilu.org#24508,"NEGERI BUMI PUTRA, BLAMBANGAN UMPU, WAY KANAN, LAMPUNG",6,184,33,217
https://kawalpemilu.org#24509,"PANCA NEGERI, BLAMBANGAN UMPU, WAY KANAN, LAMPUNG",1,7,221,228
https://kawalpemilu.org#24509,"PANCA NEGERI, BLAMBANGAN UMPU, WAY KANAN, LAMPUNG",2,45,125,170
https://kawalpemilu.org#24509,"PANCA NEGERI, BLAMBANGAN UMPU, WAY KANAN, LAMPUNG",3,68,165,233
https://kawalpemilu.org#24509,"PANCA NEGERI, BLAMBANGAN UMPU, WAY KANAN, LAMPUNG",4,109,45,154
https://kawalpemilu.org#24509,"PANCA NEGERI, BLAMBANGAN UMPU, WAY KANAN, LAMPUNG",5,52,82,134
https://kawalpemilu.org#24509,"PANCA NEGERI, BLAMBANGAN UMPU, WAY KANAN, LAMPUNG",6,33,57,90
https://kawalpemilu.org#24509,"PANCA NEGERI, BLAMBANGAN UMPU, WAY KANAN, LAMPUNG",7,24,67,91
https://kawalpemilu.org#24509,"PANCA NEGERI, BLAMBANGAN UMPU, WAY KANAN, LAMPUNG",8,73,41,114
https://kawalpemilu.org#87233,"GEDUNG RIANG, BLAMBANGAN UMPU, WAY KANAN, LAMPUNG",1,77,156,233
https://kawalpemilu.org#87233,"GEDUNG RIANG, BLAMBANGAN UMPU, WAY KANAN, LAMPUNG",2,31,106,137
https://kawalpemilu.org#87233,"GEDUNG RIANG, BLAMBANGAN UMPU, WAY KANAN, LAMPUNG",3,27,174,201
https://kawalpemilu.org#928924,"OJOLALI, BLAMBANGAN UMPU, WAY KANAN, LAMPUNG",1,162,43,205
https://kawalpemilu.org#928924,"OJOLALI, BLAMBANGAN UMPU, WAY KANAN, LAMPUNG",2,157,53,210
https://kawalpemilu.org#928924,"OJOLALI, BLAMBANGAN UMPU, WAY KANAN, LAMPUNG",3,128,48,176
https://kawalpemilu.org#24511,"KASUI PASAR, KASUI, WAY KANAN, LAMPUNG",1,45,111,156
https://kawalpemilu.org#24511,"KASUI PASAR, KASUI, WAY KANAN, LAMPUNG",2,42,119,161
https://kawalpemilu.org#24511,"KASUI PASAR, KASUI, WAY KANAN, LAMPUNG",3,25,112,137
https://kawalpemilu.org#24511,"KASUI PASAR, KASUI, WAY KANAN, LAMPUNG",4,41,67,108
https://kawalpemilu.org#24511,"KASUI PASAR, KASUI, WAY KANAN, LAMPUNG",5,58,134,192
https://kawalpemilu.org#24511,"KASUI PASAR, KASUI, WAY KANAN, LAMPUNG",6,56,96,152
https://kawalpemilu.org#24511,"KASUI PASAR, KASUI, WAY KANAN, LAMPUNG",7,45,116,161
https://kawalpemilu.org#24511,"KASUI PASAR, KASUI, WAY KANAN, LAMPUNG",8,71,64,135
https://kawalpemilu.org#24511,"KASUI PASAR, KASUI, WAY KANAN, LAMPUNG",9,105,111,216
https://kawalpemilu.org#24511,"KASUI PASAR, KASUI, WAY KANAN, LAMPUNG",10,45,99,144
https://kawalpemilu.org#24511,"KASUI PASAR, KASUI, WAY KANAN, LAMPUNG",11,40,72,112
https://kawalpemilu.org#24511,"KASUI PASAR, KASUI, WAY KANAN, LAMPUNG",12,25,125,150
https://kawalpemilu.org#24511,"KASUI PASAR, KASUI, WAY KANAN, LAMPUNG",13,50,113,163
https://kawalpemilu.org#24511,"KASUI PASAR, KASUI, WAY KANAN, LAMPUNG",14,69,90,159
https://kawalpemilu.org#24511,"KASUI PASAR, KASUI, WAY KANAN, LAMPUNG",15,68,83,151
https://kawalpemilu.org#24511,"KASUI PASAR, KASUI, WAY KANAN, LAMPUNG",16,109,33,142
https://kawalpemilu.org#24512,"DATAR BANCONG, KASUI, WAY KANAN, LAMPUNG",1,80,63,143
https://kawalpemilu.org#24512,"DATAR BANCONG, KASUI, WAY KANAN, LAMPUNG",2,27,186,213
https://kawalpemilu.org#24512,"DATAR BANCONG, KASUI, WAY KANAN, LAMPUNG",3,84,117,201
https://kawalpemilu.org#24512,"DATAR BANCONG, KASUI, WAY KANAN, LAMPUNG",4,42,110,152
https://kawalpemilu.org#24513,"KEDATON, KASUI, WAY KANAN, LAMPUNG",1,22,140,162
https://kawalpemilu.org#24513,"KEDATON, KASUI, WAY KANAN, LAMPUNG",2,20,158,178
https://kawalpemilu.org#24513,"KEDATON, KASUI, WAY KANAN, LAMPUNG",3,18,134,152
https://kawalpemilu.org#24513,"KEDATON, KASUI, WAY KANAN, LAMPUNG",4,15,146,161
https://kawalpemilu.org#24513,"KEDATON, KASUI, WAY KANAN, LAMPUNG",5,16,155,171
https://kawalpemilu.org#24514,"KARANG LANTANG, KASUI, WAY KANAN, LAMPUNG",1,98,138,236
https://kawalpemilu.org#24514,"KARANG LANTANG, KASUI, WAY KANAN, LAMPUNG",2,32,165,197
https://kawalpemilu.org#24514,"KARANG LANTANG, KASUI, WAY KANAN, LAMPUNG",3,21,160,181
https://kawalpemilu.org#24514,"KARANG LANTANG, KASUI, WAY KANAN, LAMPUNG",4,28,79,107
https://kawalpemilu.org#24515,"KASUI LAMA, KASUI, WAY KANAN, LAMPUNG",1,4,218,222
https://kawalpemilu.org#24515,"KASUI LAMA, KASUI, WAY KANAN, LAMPUNG",2,21,175,196
https://kawalpemilu.org#24515,"KASUI LAMA, KASUI, WAY KANAN, LAMPUNG",3,49,193,242
https://kawalpemilu.org#24515,"KASUI LAMA, KASUI, WAY KANAN, LAMPUNG",4,28,214,242
https://kawalpemilu.org#24515,"KASUI LAMA, KASUI, WAY KANAN, LAMPUNG",5,8,248,256
https://kawalpemilu.org#24515,"KASUI LAMA, KASUI, WAY KANAN, LAMPUNG",6,15,191,206
https://kawalpemilu.org#24515,"KASUI LAMA, KASUI, WAY KANAN, LAMPUNG",7,26,154,180
https://kawalpemilu.org#24516,"KAMPUNG BARU, KASUI, WAY KANAN, LAMPUNG",1,36,174,210
https://kawalpemilu.org#24516,"KAMPUNG BARU, KASUI, WAY KANAN, LAMPUNG",2,28,110,138
https://kawalpemilu.org#24516,"KAMPUNG BARU, KASUI, WAY KANAN, LAMPUNG",3,44,63,107
https://kawalpemilu.org#24516,"KAMPUNG BARU, KASUI, WAY KANAN, LAMPUNG",4,75,169,244
https://kawalpemilu.org#24517,"JUKU KEMUNING, KASUI, WAY KANAN, LAMPUNG",1,46,172,218
https://kawalpemilu.org#24517,"JUKU KEMUNING, KASUI, WAY KANAN, LAMPUNG",2,27,136,163
https://kawalpemilu.org#24517,"JUKU KEMUNING, KASUI, WAY KANAN, LAMPUNG",3,99,55,154
https://kawalpemilu.org#24518,"KOTA WAY, KASUI, WAY KANAN, LAMPUNG",1,60,145,205
https://kawalpemilu.org#24518,"KOTA WAY, KASUI, WAY KANAN, LAMPUNG",2,50,137,187
https://kawalpemilu.org#24518,"KOTA WAY, KASUI, WAY KANAN, LAMPUNG",3,96,80,176
https://kawalpemilu.org#24518,"KOTA WAY, KASUI, WAY KANAN, LAMPUNG",4,72,90,162
https://kawalpemilu.org#24518,"KOTA WAY, KASUI, WAY KANAN, LAMPUNG",5,70,79,149
https://kawalpemilu.org#24518,"KOTA WAY, KASUI, WAY KANAN, LAMPUNG",6,89,47,136
https://kawalpemilu.org#24518,"KOTA WAY, KASUI, WAY KANAN, LAMPUNG",7,94,86,180
https://kawalpemilu.org#24519,"TANJUNG KURUNG, KASUI, WAY KANAN, LAMPUNG",1,51,147,198
https://kawalpemilu.org#24519,"TANJUNG KURUNG, KASUI, WAY KANAN, LAMPUNG",2,31,181,212
https://kawalpemilu.org#24519,"TANJUNG KURUNG, KASUI, WAY KANAN, LAMPUNG",3,123,65,188
https://kawalpemilu.org#24519,"TANJUNG KURUNG, KASUI, WAY KANAN, LAMPUNG",4,161,51,212
https://kawalpemilu.org#24519,"TANJUNG KURUNG, KASUI, WAY KANAN, LAMPUNG",5,68,61,129
https://kawalpemilu.org#24519,"TANJUNG KURUNG, KASUI, WAY KANAN, LAMPUNG",6,113,84,197
https://kawalpemilu.org#24519,"TANJUNG KURUNG, KASUI, WAY KANAN, LAMPUNG",7,33,79,112
https://kawalpemilu.org#24519,"TANJUNG KURUNG, KASUI, WAY KANAN, LAMPUNG",8,21,76,97
https://kawalpemilu.org#24519,"TANJUNG KURUNG, KASUI, WAY KANAN, LAMPUNG",9,136,37,173
https://kawalpemilu.org#24519,"TANJUNG KURUNG, KASUI, WAY KANAN, LAMPUNG",10,140,38,178
https://kawalpemilu.org#24519,"TANJUNG KURUNG, KASUI, WAY KANAN, LAMPUNG",11,118,64,182
https://kawalpemilu.org#24520,"TALANG MANGGA, KASUI, WAY KANAN, LAMPUNG",2,60,115,175
https://kawalpemilu.org#24520,"TALANG MANGGA, KASUI, WAY KANAN, LAMPUNG",3,100,79,179
https://kawalpemilu.org#24520,"TALANG MANGGA, KASUI, WAY KANAN, LAMPUNG",4,176,34,210
https://kawalpemilu.org#24520,"TALANG MANGGA, KASUI, WAY KANAN, LAMPUNG",5,123,86,209
https://kawalpemilu.org#24521,"TANJUNG HARAPAN, KASUI, WAY KANAN, LAMPUNG",1,159,69,228
https://kawalpemilu.org#24521,"TANJUNG HARAPAN, KASUI, WAY KANAN, LAMPUNG",2,163,77,240
https://kawalpemilu.org#24521,"TANJUNG HARAPAN, KASUI, WAY KANAN, LAMPUNG",3,137,92,229
https://kawalpemilu.org#24521,"TANJUNG HARAPAN, KASUI, WAY KANAN, LAMPUNG",4,96,93,189
https://kawalpemilu.org#24521,"TANJUNG HARAPAN, KASUI, WAY KANAN, LAMPUNG",5,97,51,148
https://kawalpemilu.org#24522,"SINAR GADING, KASUI, WAY KANAN, LAMPUNG",1,131,85,216
https://kawalpemilu.org#24522,"SINAR GADING, KASUI, WAY KANAN, LAMPUNG",2,29,90,119
https://kawalpemilu.org#24523,"JAYA TINGGI, KASUI, WAY KANAN, LAMPUNG",1,27,145,172
https://kawalpemilu.org#24523,"JAYA TINGGI, KASUI, WAY KANAN, LAMPUNG",2,56,85,141
https://kawalpemilu.org#24523,"JAYA TINGGI, KASUI, WAY KANAN, LAMPUNG",3,94,94,188
https://kawalpemilu.org#24523,"JAYA TINGGI, KASUI, WAY KANAN, LAMPUNG",4,71,101,172
https://kawalpemilu.org#24523,"JAYA TINGGI, KASUI, WAY KANAN, LAMPUNG",5,36,132,168
https://kawalpemilu.org#24523,"JAYA TINGGI, KASUI, WAY KANAN, LAMPUNG",6,78,134,212
https://kawalpemilu.org#24523,"JAYA TINGGI, KASUI, WAY KANAN, LAMPUNG",7,48,110,158
https://kawalpemilu.org#24523,"JAYA TINGGI, KASUI, WAY KANAN, LAMPUNG",8,70,62,132
https://kawalpemilu.org#24523,"JAYA TINGGI, KASUI, WAY KANAN, LAMPUNG",9,97,112,209
https://kawalpemilu.org#24524,"SUKA JADI, KASUI, WAY KANAN, LAMPUNG",1,44,103,147
https://kawalpemilu.org#24524,"SUKA JADI, KASUI, WAY KANAN, LAMPUNG",2,86,75,161
https://kawalpemilu.org#24524,"SUKA JADI, KASUI, WAY KANAN, LAMPUNG",3,29,110,139
https://kawalpemilu.org#24525,"GELOMBANG PANJANG, KASUI, WAY KANAN, LAMPUNG",1,102,97,199
https://kawalpemilu.org#24525,"GELOMBANG PANJANG, KASUI, WAY KANAN, LAMPUNG",2,103,122,225
https://kawalpemilu.org#24526,"TANGKAS, KASUI, WAY KANAN, LAMPUNG",1,23,116,139
https://kawalpemilu.org#24526,"TANGKAS, KASUI, WAY KANAN, LAMPUNG",2,39,53,92
https://kawalpemilu.org#24527,"TANJUNG BULAN, KASUI, WAY KANAN, LAMPUNG",1,30,114,144
https://kawalpemilu.org#24527,"TANJUNG BULAN, KASUI, WAY KANAN, LAMPUNG",2,37,110,147
https://kawalpemilu.org#24527,"TANJUNG BULAN, KASUI, WAY KANAN, LAMPUNG",3,48,90,138
https://kawalpemilu.org#24527,"TANJUNG BULAN, KASUI, WAY KANAN, LAMPUNG",4,91,65,156
https://kawalpemilu.org#24527,"TANJUNG BULAN, KASUI, WAY KANAN, LAMPUNG",5,101,36,137
https://kawalpemilu.org#24527,"TANJUNG BULAN, KASUI, WAY KANAN, LAMPUNG",6,49,20,69
https://kawalpemilu.org#24528,"TANJUNGKURUNG LAMA, KASUI, WAY KANAN, LAMPUNG",1,31,130,161
https://kawalpemilu.org#24528,"TANJUNGKURUNG LAMA, KASUI, WAY KANAN, LAMPUNG",2,31,181,212
https://kawalpemilu.org#24528,"TANJUNGKURUNG LAMA, KASUI, WAY KANAN, LAMPUNG",3,77,71,148
https://kawalpemilu.org#24528,"TANJUNGKURUNG LAMA, KASUI, WAY KANAN, LAMPUNG",4,52,78,130
https://kawalpemilu.org#24528,"TANJUNGKURUNG LAMA, KASUI, WAY KANAN, LAMPUNG",5,23,135,158
https://kawalpemilu.org#24528,"TANJUNGKURUNG LAMA, KASUI, WAY KANAN, LAMPUNG",6,62,50,112
https://kawalpemilu.org#87234,"BUKITBATU, KASUI, WAY KANAN, LAMPUNG",1,56,151,207
https://kawalpemilu.org#87234,"BUKITBATU, KASUI, WAY KANAN, LAMPUNG",2,98,124,222
https://kawalpemilu.org#87234,"BUKITBATU, KASUI, WAY KANAN, LAMPUNG",3,53,128,181
https://kawalpemilu.org#87234,"BUKITBATU, KASUI, WAY KANAN, LAMPUNG",4,87,108,195
https://kawalpemilu.org#24530,"PASAR BANJIT, BANJIT, WAY KANAN, LAMPUNG",1,44,171,215
https://kawalpemilu.org#24530,"PASAR BANJIT, BANJIT, WAY KANAN, LAMPUNG",2,46,120,166
https://kawalpemilu.org#24530,"PASAR BANJIT, BANJIT, WAY KANAN, LAMPUNG",3,37,102,139
https://kawalpemilu.org#24530,"PASAR BANJIT, BANJIT, WAY KANAN, LAMPUNG",4,20,124,144
https://kawalpemilu.org#24530,"PASAR BANJIT, BANJIT, WAY KANAN, LAMPUNG",5,42,119,161
https://kawalpemilu.org#24530,"PASAR BANJIT, BANJIT, WAY KANAN, LAMPUNG",6,97,134,231
https://kawalpemilu.org#24530,"PASAR BANJIT, BANJIT, WAY KANAN, LAMPUNG",7,51,87,138
https://kawalpemilu.org#24530,"PASAR BANJIT, BANJIT, WAY KANAN, LAMPUNG",8,32,154,186
https://kawalpemilu.org#24530,"PASAR BANJIT, BANJIT, WAY KANAN, LAMPUNG",9,36,119,155
https://kawalpemilu.org#24530,"PASAR BANJIT, BANJIT, WAY KANAN, LAMPUNG",10,28,93,121
https://kawalpemilu.org#24530,"PASAR BANJIT, BANJIT, WAY KANAN, LAMPUNG",11,45,109,154
https://kawalpemilu.org#24530,"PASAR BANJIT, BANJIT, WAY KANAN, LAMPUNG",12,27,126,153
https://kawalpemilu.org#24530,"PASAR BANJIT, BANJIT, WAY KANAN, LAMPUNG",13,80,149,229
https://kawalpemilu.org#24530,"PASAR BANJIT, BANJIT, WAY KANAN, LAMPUNG",14,77,84,161
https://kawalpemilu.org#24531,"BUNGLAI, BANJIT, WAY KANAN, LAMPUNG",1,113,75,188
https://kawalpemilu.org#24531,"BUNGLAI, BANJIT, WAY KANAN, LAMPUNG",2,87,96,183
https://kawalpemilu.org#24531,"BUNGLAI, BANJIT, WAY KANAN, LAMPUNG",3,117,102,219
https://kawalpemilu.org#24531,"BUNGLAI, BANJIT, WAY KANAN, LAMPUNG",4,154,68,222
https://kawalpemilu.org#24531,"BUNGLAI, BANJIT, WAY KANAN, LAMPUNG",5,52,101,153
https://kawalpemilu.org#24531,"BUNGLAI, BANJIT, WAY KANAN, LAMPUNG",6,63,93,156
https://kawalpemilu.org#24531,"BUNGLAI, BANJIT, WAY KANAN, LAMPUNG",7,114,76,190
https://kawalpemilu.org#24531,"BUNGLAI, BANJIT, WAY KANAN, LAMPUNG",8,108,92,200
https://kawalpemilu.org#24531,"BUNGLAI, BANJIT, WAY KANAN, LAMPUNG",9,124,73,197
https://kawalpemilu.org#24531,"BUNGLAI, BANJIT, WAY KANAN, LAMPUNG",10,120,116,236
https://kawalpemilu.org#24531,"BUNGLAI, BANJIT, WAY KANAN, LAMPUNG",11,69,124,193
https://kawalpemilu.org#24531,"BUNGLAI, BANJIT, WAY KANAN, LAMPUNG",12,61,65,126
https://kawalpemilu.org#24532,"CAMPANG LAPAN, BANJIT, WAY KANAN, LAMPUNG",1,46,96,142
https://kawalpemilu.org#24532,"CAMPANG LAPAN, BANJIT, WAY KANAN, LAMPUNG",2,48,121,169
https://kawalpemilu.org#24532,"CAMPANG LAPAN, BANJIT, WAY KANAN, LAMPUNG",4,59,92,151
https://kawalpemilu.org#24532,"CAMPANG LAPAN, BANJIT, WAY KANAN, LAMPUNG",5,40,97,137
https://kawalpemilu.org#24532,"CAMPANG LAPAN, BANJIT, WAY KANAN, LAMPUNG",6,84,26,110
https://kawalpemilu.org#24533,"SUMBER BARU, BANJIT, WAY KANAN, LAMPUNG",1,58,51,109
https://kawalpemilu.org#24533,"SUMBER BARU, BANJIT, WAY KANAN, LAMPUNG",2,74,100,4
https://kawalpemilu.org#24533,"SUMBER BARU, BANJIT, WAY KANAN, LAMPUNG",3,48,73,121
https://kawalpemilu.org#24533,"SUMBER BARU, BANJIT, WAY KANAN, LAMPUNG",4,49,64,113
https://kawalpemilu.org#24533,"SUMBER BARU, BANJIT, WAY KANAN, LAMPUNG",5,97,67,164
https://kawalpemilu.org#24534,"RANTAU TEMIANG, BANJIT, WAY KANAN, LAMPUNG",1,25,159,184
https://kawalpemilu.org#24534,"RANTAU TEMIANG, BANJIT, WAY KANAN, LAMPUNG",2,23,166,189
https://kawalpemilu.org#24534,"RANTAU TEMIANG, BANJIT, WAY KANAN, LAMPUNG",3,14,180,194
https://kawalpemilu.org#24534,"RANTAU TEMIANG, BANJIT, WAY KANAN, LAMPUNG",4,103,125,228
https://kawalpemilu.org#24534,"RANTAU TEMIANG, BANJIT, WAY KANAN, LAMPUNG",5,17,152,169
https://kawalpemilu.org#24534,"RANTAU TEMIANG, BANJIT, WAY KANAN, LAMPUNG",6,22,153,175
https://kawalpemilu.org#24534,"RANTAU TEMIANG, BANJIT, WAY KANAN, LAMPUNG",7,17,179,196
https://kawalpemilu.org#24534,"RANTAU TEMIANG, BANJIT, WAY KANAN, LAMPUNG",8,109,90,199
https://kawalpemilu.org#24535,"JUKU BATU, BANJIT, WAY KANAN, LAMPUNG",1,64,140,204
https://kawalpemilu.org#24535,"JUKU BATU, BANJIT, WAY KANAN, LAMPUNG",2,39,180,219
https://kawalpemilu.org#24535,"JUKU BATU, BANJIT, WAY KANAN, LAMPUNG",3,40,138,178
https://kawalpemilu.org#24535,"JUKU BATU, BANJIT, WAY KANAN, LAMPUNG",4,30,62,92
https://kawalpemilu.org#24535,"JUKU BATU, BANJIT, WAY KANAN, LAMPUNG",5,37,67,104
https://kawalpemilu.org#24535,"JUKU BATU, BANJIT, WAY KANAN, LAMPUNG",6,113,67,180
https://kawalpemilu.org#24535,"JUKU BATU, BANJIT, WAY KANAN, LAMPUNG",7,60,114,174
https://kawalpemilu.org#24535,"JUKU BATU, BANJIT, WAY KANAN, LAMPUNG",8,28,157,185
https://kawalpemilu.org#24535,"JUKU BATU, BANJIT, WAY KANAN, LAMPUNG",9,69,104,173
https://kawalpemilu.org#24535,"JUKU BATU, BANJIT, WAY KANAN, LAMPUNG",10,40,128,168
https://kawalpemilu.org#24535,"JUKU BATU, BANJIT, WAY KANAN, LAMPUNG",11,25,77,102
https://kawalpemilu.org#24535,"JUKU BATU, BANJIT, WAY KANAN, LAMPUNG",12,137,39,176
https://kawalpemilu.org#24536,"DONO MULYO, BANJIT, WAY KANAN, LAMPUNG",1,134,84,218
https://kawalpemilu.org#24536,"DONO MULYO, BANJIT, WAY KANAN, LAMPUNG",2,137,49,186
https://kawalpemilu.org#24536,"DONO MULYO, BANJIT, WAY KANAN, LAMPUNG",3,113,49,162
https://kawalpemilu.org#24536,"DONO MULYO, BANJIT, WAY KANAN, LAMPUNG",4,161,40,201
https://kawalpemilu.org#24536,"DONO MULYO, BANJIT, WAY KANAN, LAMPUNG",5,163,53,216
https://kawalpemilu.org#24536,"DONO MULYO, BANJIT, WAY KANAN, LAMPUNG",6,150,36,186
https://kawalpemilu.org#24536,"DONO MULYO, BANJIT, WAY KANAN, LAMPUNG",7,115,42,157
https://kawalpemilu.org#24536,"DONO MULYO, BANJIT, WAY KANAN, LAMPUNG",8,137,57,194
https://kawalpemilu.org#24537,"BALI SADAR UTARA, BANJIT, WAY KANAN, LAMPUNG",1,183,32,215
https://kawalpemilu.org#24537,"BALI SADAR UTARA, BANJIT, WAY KANAN, LAMPUNG",2,193,27,220
https://kawalpemilu.org#24537,"BALI SADAR UTARA, BANJIT, WAY KANAN, LAMPUNG",3,228,7,235
https://kawalpemilu.org#24537,"BALI SADAR UTARA, BANJIT, WAY KANAN, LAMPUNG",4,148,32,180
https://kawalpemilu.org#24537,"BALI SADAR UTARA, BANJIT, WAY KANAN, LAMPUNG",5,135,77,212
https://kawalpemilu.org#24537,"BALI SADAR UTARA, BANJIT, WAY KANAN, LAMPUNG",6,228,10,238
https://kawalpemilu.org#24537,"BALI SADAR UTARA, BANJIT, WAY KANAN, LAMPUNG",7,202,26,228
https://kawalpemilu.org#24538,"BALI SADAR SELATAN, BANJIT, WAY KANAN, LAMPUNG",1,84,122,206
https://kawalpemilu.org#24538,"BALI SADAR SELATAN, BANJIT, WAY KANAN, LAMPUNG",2,170,18,188
https://kawalpemilu.org#24538,"BALI SADAR SELATAN, BANJIT, WAY KANAN, LAMPUNG",3,128,64,192
https://kawalpemilu.org#24538,"BALI SADAR SELATAN, BANJIT, WAY KANAN, LAMPUNG",4,167,29,196
https://kawalpemilu.org#24538,"BALI SADAR SELATAN, BANJIT, WAY KANAN, LAMPUNG",5,157,15,172
https://kawalpemilu.org#24538,"BALI SADAR SELATAN, BANJIT, WAY KANAN, LAMPUNG",6,154,48,202
https://kawalpemilu.org#24539,"MENANGA JAYA, BANJIT, WAY KANAN, LAMPUNG",1,184,36,220
https://kawalpemilu.org#24539,"MENANGA JAYA, BANJIT, WAY KANAN, LAMPUNG",2,155,64,219
https://kawalpemilu.org#24539,"MENANGA JAYA, BANJIT, WAY KANAN, LAMPUNG",3,134,68,202
https://kawalpemilu.org#24539,"MENANGA JAYA, BANJIT, WAY KANAN, LAMPUNG",4,129,82,211
https://kawalpemilu.org#24540,"ARGO MULYO, BANJIT, WAY KANAN, LAMPUNG",1,112,44,156
https://kawalpemilu.org#24540,"ARGO MULYO, BANJIT, WAY KANAN, LAMPUNG",2,173,56,229
https://kawalpemilu.org#24540,"ARGO MULYO, BANJIT, WAY KANAN, LAMPUNG",3,200,31,231
https://kawalpemilu.org#24540,"ARGO MULYO, BANJIT, WAY KANAN, LAMPUNG",4,167,35,202
https://kawalpemilu.org#24540,"ARGO MULYO, BANJIT, WAY KANAN, LAMPUNG",5,67,101,168
https://kawalpemilu.org#24540,"ARGO MULYO, BANJIT, WAY KANAN, LAMPUNG",6,76,136,212
https://kawalpemilu.org#24540,"ARGO MULYO, BANJIT, WAY KANAN, LAMPUNG",7,138,39,177
https://kawalpemilu.org#24540,"ARGO MULYO, BANJIT, WAY KANAN, LAMPUNG",8,109,53,162
https://kawalpemilu.org#24540,"ARGO MULYO, BANJIT, WAY KANAN, LAMPUNG",9,166,62,228
https://kawalpemilu.org#24540,"ARGO MULYO, BANJIT, WAY KANAN, LAMPUNG",10,171,32,203
https://kawalpemilu.org#24540,"ARGO MULYO, BANJIT, WAY KANAN, LAMPUNG",11,171,29,200
https://kawalpemilu.org#24540,"ARGO MULYO, BANJIT, WAY KANAN, LAMPUNG",12,133,52,185
https://kawalpemilu.org#24540,"ARGO MULYO, BANJIT, WAY KANAN, LAMPUNG",13,61,89,150
https://kawalpemilu.org#24540,"ARGO MULYO, BANJIT, WAY KANAN, LAMPUNG",14,82,107,189
https://kawalpemilu.org#24541,"RANTAU JAYA, BANJIT, WAY KANAN, LAMPUNG",1,143,36,179
https://kawalpemilu.org#24541,"RANTAU JAYA, BANJIT, WAY KANAN, LAMPUNG",2,168,30,198
https://kawalpemilu.org#24541,"RANTAU JAYA, BANJIT, WAY KANAN, LAMPUNG",3,154,22,176
https://kawalpemilu.org#24541,"RANTAU JAYA, BANJIT, WAY KANAN, LAMPUNG",4,125,53,178
https://kawalpemilu.org#24542,"REBANG TINGGI, BANJIT, WAY KANAN, LAMPUNG",1,33,207,240
https://kawalpemilu.org#24542,"REBANG TINGGI, BANJIT, WAY KANAN, LAMPUNG",2,35,167,202
https://kawalpemilu.org#24542,"REBANG TINGGI, BANJIT, WAY KANAN, LAMPUNG",3,69,128,197
https://kawalpemilu.org#24542,"REBANG TINGGI, BANJIT, WAY KANAN, LAMPUNG",4,65,99,164
https://kawalpemilu.org#24542,"REBANG TINGGI, BANJIT, WAY KANAN, LAMPUNG",5,86,193,279
https://kawalpemilu.org#24542,"REBANG TINGGI, BANJIT, WAY KANAN, LAMPUNG",6,73,164,237
https://kawalpemilu.org#24542,"REBANG TINGGI, BANJIT, WAY KANAN, LAMPUNG",7,32,162,194
https://kawalpemilu.org#24542,"REBANG TINGGI, BANJIT, WAY KANAN, LAMPUNG",8,22,189,211
https://kawalpemilu.org#24542,"REBANG TINGGI, BANJIT, WAY KANAN, LAMPUNG",9,70,104,174
https://kawalpemilu.org#24542,"REBANG TINGGI, BANJIT, WAY KANAN, LAMPUNG",10,90,71,161
https://kawalpemilu.org#24543,"SIMPANG ASAM, BANJIT, WAY KANAN, LAMPUNG",1,86,84,170
https://kawalpemilu.org#24543,"SIMPANG ASAM, BANJIT, WAY KANAN, LAMPUNG",2,90,136,226
https://kawalpemilu.org#24543,"SIMPANG ASAM, BANJIT, WAY KANAN, LAMPUNG",3,163,65,228
https://kawalpemilu.org#24543,"SIMPANG ASAM, BANJIT, WAY KANAN, LAMPUNG",4,132,72,204
https://kawalpemilu.org#24543,"SIMPANG ASAM, BANJIT, WAY KANAN, LAMPUNG",5,72,82,154
https://kawalpemilu.org#24543,"SIMPANG ASAM, BANJIT, WAY KANAN, LAMPUNG",6,169,46,215
https://kawalpemilu.org#24543,"SIMPANG ASAM, BANJIT, WAY KANAN, LAMPUNG",7,78,29,107
https://kawalpemilu.org#24543,"SIMPANG ASAM, BANJIT, WAY KANAN, LAMPUNG",8,139,56,195
https://kawalpemilu.org#24544,"BANDAR AGUNG, BANJIT, WAY KANAN, LAMPUNG",1,179,18,197
https://kawalpemilu.org#24544,"BANDAR AGUNG, BANJIT, WAY KANAN, LAMPUNG",2,185,22,207
https://kawalpemilu.org#24544,"BANDAR AGUNG, BANJIT, WAY KANAN, LAMPUNG",3,191,26,217
https://kawalpemilu.org#24544,"BANDAR AGUNG, BANJIT, WAY KANAN, LAMPUNG",4,195,33,228
https://kawalpemilu.org#24545,"KEMU, BANJIT, WAY KANAN, LAMPUNG",1,117,93,210
https://kawalpemilu.org#24545,"KEMU, BANJIT, WAY KANAN, LAMPUNG",2,96,53,149
https://kawalpemilu.org#24545,"KEMU, BANJIT, WAY KANAN, LAMPUNG",3,172,43,215
https://kawalpemilu.org#24545,"KEMU, BANJIT, WAY KANAN, LAMPUNG",4,120,38,158
https://kawalpemilu.org#24546,"MENANGA SIAMANG, BANJIT, WAY KANAN, LAMPUNG",1,30,134,164
https://kawalpemilu.org#24546,"MENANGA SIAMANG, BANJIT, WAY KANAN, LAMPUNG",2,36,95,131
https://kawalpemilu.org#24546,"MENANGA SIAMANG, BANJIT, WAY KANAN, LAMPUNG",3,65,165,230
https://kawalpemilu.org#24546,"MENANGA SIAMANG, BANJIT, WAY KANAN, LAMPUNG",4,112,91,203
https://kawalpemilu.org#24546,"MENANGA SIAMANG, BANJIT, WAY KANAN, LAMPUNG",5,69,71,140
https://kawalpemilu.org#24546,"MENANGA SIAMANG, BANJIT, WAY KANAN, LAMPUNG",6,28,121,149
https://kawalpemilu.org#24546,"MENANGA SIAMANG, BANJIT, WAY KANAN, LAMPUNG",7,20,103,123
https://kawalpemilu.org#24546,"MENANGA SIAMANG, BANJIT, WAY KANAN, LAMPUNG",8,74,124,198
https://kawalpemilu.org#24546,"MENANGA SIAMANG, BANJIT, WAY KANAN, LAMPUNG",10,60,30,90
https://kawalpemilu.org#24546,"MENANGA SIAMANG, BANJIT, WAY KANAN, LAMPUNG",11,40,71,111
https://kawalpemilu.org#24547,"NEKI, BANJIT, WAY KANAN, LAMPUNG",1,36,98,134
https://kawalpemilu.org#24547,"NEKI, BANJIT, WAY KANAN, LAMPUNG",2,62,64,126
https://kawalpemilu.org#24547,"NEKI, BANJIT, WAY KANAN, LAMPUNG",3,48,88,136
https://kawalpemilu.org#24548,"SUMBER SARI, BANJIT, WAY KANAN, LAMPUNG",1,240,29,269
https://kawalpemilu.org#24548,"SUMBER SARI, BANJIT, WAY KANAN, LAMPUNG",2,142,77,219
https://kawalpemilu.org#24548,"SUMBER SARI, BANJIT, WAY KANAN, LAMPUNG",3,97,26,123
https://kawalpemilu.org#24548,"SUMBER SARI, BANJIT, WAY KANAN, LAMPUNG",4,124,45,169
https://kawalpemilu.org#24548,"SUMBER SARI, BANJIT, WAY KANAN, LAMPUNG",5,89,15,104
https://kawalpemilu.org#24549,"BALI SADAR TENGAH, BANJIT, WAY KANAN, LAMPUNG",1,153,34,187
https://kawalpemilu.org#24549,"BALI SADAR TENGAH, BANJIT, WAY KANAN, LAMPUNG",2,178,22,200
https://kawalpemilu.org#24549,"BALI SADAR TENGAH, BANJIT, WAY KANAN, LAMPUNG",3,220,25,245
https://kawalpemilu.org#24549,"BALI SADAR TENGAH, BANJIT, WAY KANAN, LAMPUNG",4,184,45,229
https://kawalpemilu.org#24549,"BALI SADAR TENGAH, BANJIT, WAY KANAN, LAMPUNG",5,196,5,201
https://kawalpemilu.org#24549,"BALI SADAR TENGAH, BANJIT, WAY KANAN, LAMPUNG",6,235,15,250
https://kawalpemilu.org#24551,"SETIA NEGARA, BARADATU, WAY KANAN, LAMPUNG",1,84,100,184
https://kawalpemilu.org#24551,"SETIA NEGARA, BARADATU, WAY KANAN, LAMPUNG",2,127,94,221
https://kawalpemilu.org#24551,"SETIA NEGARA, BARADATU, WAY KANAN, LAMPUNG",3,155,66,221
https://kawalpemilu.org#24551,"SETIA NEGARA, BARADATU, WAY KANAN, LAMPUNG",4,102,50,152
https://kawalpemilu.org#24551,"SETIA NEGARA, BARADATU, WAY KANAN, LAMPUNG",5,176,70,246
https://kawalpemilu.org#24551,"SETIA NEGARA, BARADATU, WAY KANAN, LAMPUNG",6,122,75,197
https://kawalpemilu.org#24551,"SETIA NEGARA, BARADATU, WAY KANAN, LAMPUNG",7,147,74,221
https://kawalpemilu.org#24551,"SETIA NEGARA, BARADATU, WAY KANAN, LAMPUNG",8,159,36,195
https://kawalpemilu.org#24551,"SETIA NEGARA, BARADATU, WAY KANAN, LAMPUNG",9,114,65,179
https://kawalpemilu.org#24551,"SETIA NEGARA, BARADATU, WAY KANAN, LAMPUNG",10,181,58,239
https://kawalpemilu.org#24551,"SETIA NEGARA, BARADATU, WAY KANAN, LAMPUNG",11,174,39,213
https://kawalpemilu.org#24551,"SETIA NEGARA, BARADATU, WAY KANAN, LAMPUNG",12,94,42,136
https://kawalpemilu.org#24551,"SETIA NEGARA, BARADATU, WAY KANAN, LAMPUNG",13,139,53,192
https://kawalpemilu.org#24552,"GEDUNG PAKUON, BARADATU, WAY KANAN, LAMPUNG",1,80,144,224
https://kawalpemilu.org#24552,"GEDUNG PAKUON, BARADATU, WAY KANAN, LAMPUNG",2,171,54,225
https://kawalpemilu.org#24552,"GEDUNG PAKUON, BARADATU, WAY KANAN, LAMPUNG",3,122,55,177
https://kawalpemilu.org#24552,"GEDUNG PAKUON, BARADATU, WAY KANAN, LAMPUNG",4,110,50,160
https://kawalpemilu.org#24552,"GEDUNG PAKUON, BARADATU, WAY KANAN, LAMPUNG",5,140,31,171
https://kawalpemilu.org#24552,"GEDUNG PAKUON, BARADATU, WAY KANAN, LAMPUNG",6,51,100,151
https://kawalpemilu.org#24553,"BUMI MERAPI, BARADATU, WAY KANAN, LAMPUNG",1,141,87,228
https://kawalpemilu.org#24553,"BUMI MERAPI, BARADATU, WAY KANAN, LAMPUNG",2,140,80,220
https://kawalpemilu.org#24553,"BUMI MERAPI, BARADATU, WAY KANAN, LAMPUNG",3,134,87,221
https://kawalpemilu.org#24554,"BANJAR SARI, BARADATU, WAY KANAN, LAMPUNG",1,87,105,192
https://kawalpemilu.org#24554,"BANJAR SARI, BARADATU, WAY KANAN, LAMPUNG",2,123,70,193
https://kawalpemilu.org#24554,"BANJAR SARI, BARADATU, WAY KANAN, LAMPUNG",3,118,53,171
https://kawalpemilu.org#24555,"GUNUNG KATUN, BARADATU, WAY KANAN, LAMPUNG",1,73,106,179
https://kawalpemilu.org#24555,"GUNUNG KATUN, BARADATU, WAY KANAN, LAMPUNG",2,58,142,200
https://kawalpemilu.org#24555,"GUNUNG KATUN, BARADATU, WAY KANAN, LAMPUNG",3,74,90,164
https://kawalpemilu.org#24555,"GUNUNG KATUN, BARADATU, WAY KANAN, LAMPUNG",4,118,52,170
https://kawalpemilu.org#24555,"GUNUNG KATUN, BARADATU, WAY KANAN, LAMPUNG",5,108,52,160
https://kawalpemilu.org#24555,"GUNUNG KATUN, BARADATU, WAY KANAN, LAMPUNG",6,118,56,174
https://kawalpemilu.org#24555,"GUNUNG KATUN, BARADATU, WAY KANAN, LAMPUNG",7,116,101,217
https://kawalpemilu.org#24555,"GUNUNG KATUN, BARADATU, WAY KANAN, LAMPUNG",8,121,57,178
https://kawalpemilu.org#24555,"GUNUNG KATUN, BARADATU, WAY KANAN, LAMPUNG",9,57,104,161
https://kawalpemilu.org#24555,"GUNUNG KATUN, BARADATU, WAY KANAN, LAMPUNG",10,44,113,157
https://kawalpemilu.org#24555,"GUNUNG KATUN, BARADATU, WAY KANAN, LAMPUNG",11,52,129,181
https://kawalpemilu.org#24555,"GUNUNG KATUN, BARADATU, WAY KANAN, LAMPUNG",12,100,80,180
https://kawalpemilu.org#24555,"GUNUNG KATUN, BARADATU, WAY KANAN, LAMPUNG",13,81,99,180
https://kawalpemilu.org#24555,"GUNUNG KATUN, BARADATU, WAY KANAN, LAMPUNG",14,82,82,164
https://kawalpemilu.org#24555,"GUNUNG KATUN, BARADATU, WAY KANAN, LAMPUNG",15,76,56,132
https://kawalpemilu.org#24555,"GUNUNG KATUN, BARADATU, WAY KANAN, LAMPUNG",16,94,36,130
https://kawalpemilu.org#24555,"GUNUNG KATUN, BARADATU, WAY KANAN, LAMPUNG",17,61,108,169
https://kawalpemilu.org#24555,"GUNUNG KATUN, BARADATU, WAY KANAN, LAMPUNG",18,138,39,177
https://kawalpemilu.org#24555,"GUNUNG KATUN, BARADATU, WAY KANAN, LAMPUNG",19,51,113,164
https://kawalpemilu.org#24556,"BAKTI NEGARA, BARADATU, WAY KANAN, LAMPUNG",1,86,94,180
https://kawalpemilu.org#24556,"BAKTI NEGARA, BARADATU, WAY KANAN, LAMPUNG",2,98,67,165
https://kawalpemilu.org#24556,"BAKTI NEGARA, BARADATU, WAY KANAN, LAMPUNG",3,148,57,205
https://kawalpemilu.org#24556,"BAKTI NEGARA, BARADATU, WAY KANAN, LAMPUNG",4,137,49,186
https://kawalpemilu.org#24556,"BAKTI NEGARA, BARADATU, WAY KANAN, LAMPUNG",5,108,71,179
https://kawalpemilu.org#24556,"BAKTI NEGARA, BARADATU, WAY KANAN, LAMPUNG",6,118,81,199
https://kawalpemilu.org#24556,"BAKTI NEGARA, BARADATU, WAY KANAN, LAMPUNG",7,159,29,188
https://kawalpemilu.org#24556,"BAKTI NEGARA, BARADATU, WAY KANAN, LAMPUNG",8,167,49,216
https://kawalpemilu.org#24556,"BAKTI NEGARA, BARADATU, WAY KANAN, LAMPUNG",9,139,63,202
https://kawalpemilu.org#24556,"BAKTI NEGARA, BARADATU, WAY KANAN, LAMPUNG",10,130,48,178
https://kawalpemilu.org#24557,"BUMI REJO, BARADATU, WAY KANAN, LAMPUNG",1,102,82,184
https://kawalpemilu.org#24557,"BUMI REJO, BARADATU, WAY KANAN, LAMPUNG",2,115,61,176
https://kawalpemilu.org#24557,"BUMI REJO, BARADATU, WAY KANAN, LAMPUNG",3,134,37,171
https://kawalpemilu.org#24557,"BUMI REJO, BARADATU, WAY KANAN, LAMPUNG",4,151,32,183
https://kawalpemilu.org#24557,"BUMI REJO, BARADATU, WAY KANAN, LAMPUNG",5,129,43,172
https://kawalpemilu.org#24557,"BUMI REJO, BARADATU, WAY KANAN, LAMPUNG",6,88,81,169
https://kawalpemilu.org#24558,"SUKOSARI, BARADATU, WAY KANAN, LAMPUNG",1,145,55,200
https://kawalpemilu.org#24558,"SUKOSARI, BARADATU, WAY KANAN, LAMPUNG",2,111,81,192
https://kawalpemilu.org#24558,"SUKOSARI, BARADATU, WAY KANAN, LAMPUNG",3,127,64,191
https://kawalpemilu.org#24558,"SUKOSARI, BARADATU, WAY KANAN, LAMPUNG",4,46,103,149
https://kawalpemilu.org#24559,"TAMAN ASRI, BARADATU, WAY KANAN, LAMPUNG",1,57,90,147
https://kawalpemilu.org#24559,"TAMAN ASRI, BARADATU, WAY KANAN, LAMPUNG",2,80,83,163
https://kawalpemilu.org#24559,"TAMAN ASRI, BARADATU, WAY KANAN, LAMPUNG",3,52,142,194
https://kawalpemilu.org#24559,"TAMAN ASRI, BARADATU, WAY KANAN, LAMPUNG",4,128,114,242
https://kawalpemilu.org#24559,"TAMAN ASRI, BARADATU, WAY KANAN, LAMPUNG",5,65,95,160
https://kawalpemilu.org#24559,"TAMAN ASRI, BARADATU, WAY KANAN, LAMPUNG",6,75,92,167
https://kawalpemilu.org#24559,"TAMAN ASRI, BARADATU, WAY KANAN, LAMPUNG",7,106,72,178
https://kawalpemilu.org#24559,"TAMAN ASRI, BARADATU, WAY KANAN, LAMPUNG",8,133,72,205
https://kawalpemilu.org#24560,"BANJAR SETIA, BARADATU, WAY KANAN, LAMPUNG",1,135,84,219
https://kawalpemilu.org#24561,"GEDUNG REJO, BARADATU, WAY KANAN, LAMPUNG",1,160,58,218
https://kawalpemilu.org#24561,"GEDUNG REJO, BARADATU, WAY KANAN, LAMPUNG",2,142,63,205
https://kawalpemilu.org#24561,"GEDUNG REJO, BARADATU, WAY KANAN, LAMPUNG",3,150,63,213
https://kawalpemilu.org#24562,"BANJAR AGUNG, BARADATU, WAY KANAN, LAMPUNG",1,65,94,159
https://kawalpemilu.org#24562,"BANJAR AGUNG, BARADATU, WAY KANAN, LAMPUNG",2,64,113,177
https://kawalpemilu.org#24562,"BANJAR AGUNG, BARADATU, WAY KANAN, LAMPUNG",3,44,76,120
https://kawalpemilu.org#24562,"BANJAR AGUNG, BARADATU, WAY KANAN, LAMPUNG",4,59,108,167
https://kawalpemilu.org#24563,"CUGAH, BARADATU, WAY KANAN, LAMPUNG",1,28,143,171
https://kawalpemilu.org#24563,"CUGAH, BARADATU, WAY KANAN, LAMPUNG",2,86,113,199
https://kawalpemilu.org#24563,"CUGAH, BARADATU, WAY KANAN, LAMPUNG",3,72,78,150
https://kawalpemilu.org#24563,"CUGAH, BARADATU, WAY KANAN, LAMPUNG",4,28,150,178
https://kawalpemilu.org#24563,"CUGAH, BARADATU, WAY KANAN, LAMPUNG",5,68,143,211
https://kawalpemilu.org#24563,"CUGAH, BARADATU, WAY KANAN, LAMPUNG",6,106,44,150
https://kawalpemilu.org#24564,"TIUH BALAK I, BARADATU, WAY KANAN, LAMPUNG",1,71,89,160
https://kawalpemilu.org#24564,"TIUH BALAK I, BARADATU, WAY KANAN, LAMPUNG",2,103,71,174
https://kawalpemilu.org#24564,"TIUH BALAK I, BARADATU, WAY KANAN, LAMPUNG",3,85,65,150
https://kawalpemilu.org#24565,"TIUH BALAK PASAR, BARADATU, WAY KANAN, LAMPUNG",1,40,118,158
https://kawalpemilu.org#24565,"TIUH BALAK PASAR, BARADATU, WAY KANAN, LAMPUNG",2,38,110,148
https://kawalpemilu.org#24565,"TIUH BALAK PASAR, BARADATU, WAY KANAN, LAMPUNG",3,54,128,182
https://kawalpemilu.org#24565,"TIUH BALAK PASAR, BARADATU, WAY KANAN, LAMPUNG",4,97,107,204
https://kawalpemilu.org#24565,"TIUH BALAK PASAR, BARADATU, WAY KANAN, LAMPUNG",5,92,105,197
https://kawalpemilu.org#24565,"TIUH BALAK PASAR, BARADATU, WAY KANAN, LAMPUNG",7,81,68,149
https://kawalpemilu.org#24565,"TIUH BALAK PASAR, BARADATU, WAY KANAN, LAMPUNG",8,41,107,148
https://kawalpemilu.org#24565,"TIUH BALAK PASAR, BARADATU, WAY KANAN, LAMPUNG",9,40,112,152
https://kawalpemilu.org#24565,"TIUH BALAK PASAR, BARADATU, WAY KANAN, LAMPUNG",10,25,47,72
https://kawalpemilu.org#24565,"TIUH BALAK PASAR, BARADATU, WAY KANAN, LAMPUNG",11,59,109,168
https://kawalpemilu.org#24565,"TIUH BALAK PASAR, BARADATU, WAY KANAN, LAMPUNG",12,45,41,86
https://kawalpemilu.org#24565,"TIUH BALAK PASAR, BARADATU, WAY KANAN, LAMPUNG",13,84,82,166
https://kawalpemilu.org#24566,"CAMPUR ASRI, BARADATU, WAY KANAN, LAMPUNG",1,67,112,179
https://kawalpemilu.org#24566,"CAMPUR ASRI, BARADATU, WAY KANAN, LAMPUNG",2,85,150,235
https://kawalpemilu.org#24566,"CAMPUR ASRI, BARADATU, WAY KANAN, LAMPUNG",3,102,83,185
https://kawalpemilu.org#24566,"CAMPUR ASRI, BARADATU, WAY KANAN, LAMPUNG",4,105,91,196
https://kawalpemilu.org#24566,"CAMPUR ASRI, BARADATU, WAY KANAN, LAMPUNG",5,76,74,150
https://kawalpemilu.org#24566,"CAMPUR ASRI, BARADATU, WAY KANAN, LAMPUNG",6,56,95,151
https://kawalpemilu.org#24566,"CAMPUR ASRI, BARADATU, WAY KANAN, LAMPUNG",7,106,65,171
https://kawalpemilu.org#24566,"CAMPUR ASRI, BARADATU, WAY KANAN, LAMPUNG",8,138,55,193
https://kawalpemilu.org#24567,"TIUH BALAK, BARADATU, WAY KANAN, LAMPUNG",1,47,138,185
https://kawalpemilu.org#24567,"TIUH BALAK, BARADATU, WAY KANAN, LAMPUNG",2,44,126,170
https://kawalpemilu.org#24567,"TIUH BALAK, BARADATU, WAY KANAN, LAMPUNG",3,59,83,142
https://kawalpemilu.org#24567,"TIUH BALAK, BARADATU, WAY KANAN, LAMPUNG",4,72,91,163
https://kawalpemilu.org#24567,"TIUH BALAK, BARADATU, WAY KANAN, LAMPUNG",5,70,39,109
https://kawalpemilu.org#24567,"TIUH BALAK, BARADATU, WAY KANAN, LAMPUNG",6,44,120,164
https://kawalpemilu.org#24567,"TIUH BALAK, BARADATU, WAY KANAN, LAMPUNG",7,35,111,146
https://kawalpemilu.org#24567,"TIUH BALAK, BARADATU, WAY KANAN, LAMPUNG",8,62,59,121
https://kawalpemilu.org#24567,"TIUH BALAK, BARADATU, WAY KANAN, LAMPUNG",9,68,56,124
https://kawalpemilu.org#24567,"TIUH BALAK, BARADATU, WAY KANAN, LAMPUNG",10,98,66,164
https://kawalpemilu.org#24568,"MEKAR ASRI, BARADATU, WAY KANAN, LAMPUNG",2,90,75,165
https://kawalpemilu.org#24568,"MEKAR ASRI, BARADATU, WAY KANAN, LAMPUNG",3,96,48,144
https://kawalpemilu.org#24568,"MEKAR ASRI, BARADATU, WAY KANAN, LAMPUNG",4,82,73,155
https://kawalpemilu.org#24568,"MEKAR ASRI, BARADATU, WAY KANAN, LAMPUNG",5,143,46,189
https://kawalpemilu.org#24568,"MEKAR ASRI, BARADATU, WAY KANAN, LAMPUNG",6,116,53,169
https://kawalpemilu.org#24569,"BANJAR NEGARA, BARADATU, WAY KANAN, LAMPUNG",1,34,149,183
https://kawalpemilu.org#24569,"BANJAR NEGARA, BARADATU, WAY KANAN, LAMPUNG",2,68,125,193
https://kawalpemilu.org#24569,"BANJAR NEGARA, BARADATU, WAY KANAN, LAMPUNG",3,47,167,214
https://kawalpemilu.org#24569,"BANJAR NEGARA, BARADATU, WAY KANAN, LAMPUNG",4,66,134,200
https://kawalpemilu.org#24569,"BANJAR NEGARA, BARADATU, WAY KANAN, LAMPUNG",5,69,111,180
https://kawalpemilu.org#24569,"BANJAR NEGARA, BARADATU, WAY KANAN, LAMPUNG",6,48,107,155
https://kawalpemilu.org#24570,"BANJAR MASIN, BARADATU, WAY KANAN, LAMPUNG",1,52,115,167
https://kawalpemilu.org#24570,"BANJAR MASIN, BARADATU, WAY KANAN, LAMPUNG",2,49,119,168
https://kawalpemilu.org#24570,"BANJAR MASIN, BARADATU, WAY KANAN, LAMPUNG",3,31,133,164
https://kawalpemilu.org#24571,"BANJAR MULYA, BARADATU, WAY KANAN, LAMPUNG",1,82,85,167
https://kawalpemilu.org#24571,"BANJAR MULYA, BARADATU, WAY KANAN, LAMPUNG",2,73,65,138
https://kawalpemilu.org#24571,"BANJAR MULYA, BARADATU, WAY KANAN, LAMPUNG",3,84,75,159
https://kawalpemilu.org#24571,"BANJAR MULYA, BARADATU, WAY KANAN, LAMPUNG",4,136,11,147
https://kawalpemilu.org#24571,"BANJAR MULYA, BARADATU, WAY KANAN, LAMPUNG",5,100,46,146
https://kawalpemilu.org#24571,"BANJAR MULYA, BARADATU, WAY KANAN, LAMPUNG",6,62,65,127
https://kawalpemilu.org#24571,"BANJAR MULYA, BARADATU, WAY KANAN, LAMPUNG",7,154,30,184
https://kawalpemilu.org#24571,"BANJAR MULYA, BARADATU, WAY KANAN, LAMPUNG",8,45,33,78
https://kawalpemilu.org#24572,"BANJAR BARU, BARADATU, WAY KANAN, LAMPUNG",1,54,120,174
https://kawalpemilu.org#24572,"BANJAR BARU, BARADATU, WAY KANAN, LAMPUNG",2,45,111,156
https://kawalpemilu.org#24572,"BANJAR BARU, BARADATU, WAY KANAN, LAMPUNG",3,49,129,178
https://kawalpemilu.org#24574,"TULANG BAWANG, BAHUGA, WAY KANAN, LAMPUNG",1,65,175,240
https://kawalpemilu.org#24574,"TULANG BAWANG, BAHUGA, WAY KANAN, LAMPUNG",2,98,66,164
https://kawalpemilu.org#24574,"TULANG BAWANG, BAHUGA, WAY KANAN, LAMPUNG",3,55,57,112
https://kawalpemilu.org#24575,"MESIR UDIK, BAHUGA, WAY KANAN, LAMPUNG",1,8,49,57
https://kawalpemilu.org#24576,"MESIR ILIR, BAHUGA, WAY KANAN, LAMPUNG",1,54,104,158
https://kawalpemilu.org#24576,"MESIR ILIR, BAHUGA, WAY KANAN, LAMPUNG",2,67,169,236
https://kawalpemilu.org#24576,"MESIR ILIR, BAHUGA, WAY KANAN, LAMPUNG",3,65,120,185
https://kawalpemilu.org#24577,"SAPTO RENGGO, BAHUGA, WAY KANAN, LAMPUNG",1,89,153,242
https://kawalpemilu.org#24577,"SAPTO RENGGO, BAHUGA, WAY KANAN, LAMPUNG",2,91,80,171
https://kawalpemilu.org#24577,"SAPTO RENGGO, BAHUGA, WAY KANAN, LAMPUNG",3,109,57,166
https://kawalpemilu.org#24577,"SAPTO RENGGO, BAHUGA, WAY KANAN, LAMPUNG",4,82,117,199
https://kawalpemilu.org#24577,"SAPTO RENGGO, BAHUGA, WAY KANAN, LAMPUNG",5,134,64,198
https://kawalpemilu.org#24577,"SAPTO RENGGO, BAHUGA, WAY KANAN, LAMPUNG",6,123,49,172
https://kawalpemilu.org#24578,"GIRI HARJO, BAHUGA, WAY KANAN, LAMPUNG",1,156,84,240
https://kawalpemilu.org#24578,"GIRI HARJO, BAHUGA, WAY KANAN, LAMPUNG",2,177,80,257
https://kawalpemilu.org#24578,"GIRI HARJO, BAHUGA, WAY KANAN, LAMPUNG",3,160,59,219
https://kawalpemilu.org#24578,"GIRI HARJO, BAHUGA, WAY KANAN, LAMPUNG",4,138,59,197
https://kawalpemilu.org#24579,"BUMI AGUNG WATES, BAHUGA, WAY KANAN, LAMPUNG",1,201,37,238
https://kawalpemilu.org#24579,"BUMI AGUNG WATES, BAHUGA, WAY KANAN, LAMPUNG",2,50,149,199
https://kawalpemilu.org#24579,"BUMI AGUNG WATES, BAHUGA, WAY KANAN, LAMPUNG",4,52,157,209
https://kawalpemilu.org#24580,"SERDANG KURING, BAHUGA, WAY KANAN, LAMPUNG",1,141,100,241
https://kawalpemilu.org#24580,"SERDANG KURING, BAHUGA, WAY KANAN, LAMPUNG",2,126,92,218
https://kawalpemilu.org#24580,"SERDANG KURING, BAHUGA, WAY KANAN, LAMPUNG",4,127,96,223
https://kawalpemilu.org#24580,"SERDANG KURING, BAHUGA, WAY KANAN, LAMPUNG",5,115,80,195
https://kawalpemilu.org#24580,"SERDANG KURING, BAHUGA, WAY KANAN, LAMPUNG",6,106,72,178
https://kawalpemilu.org#24580,"SERDANG KURING, BAHUGA, WAY KANAN, LAMPUNG",7,83,101,184
https://kawalpemilu.org#24580,"SERDANG KURING, BAHUGA, WAY KANAN, LAMPUNG",8,72,98,170
https://kawalpemilu.org#24581,"BUMI  AGUNG, BAHUGA, WAY KANAN, LAMPUNG",1,90,67,157
https://kawalpemilu.org#24581,"BUMI  AGUNG, BAHUGA, WAY KANAN, LAMPUNG",2,55,49,104
https://kawalpemilu.org#928925,"MEKAR JAYA, BAHUGA, WAY KANAN, LAMPUNG",1,63,53,116
https://kawalpemilu.org#928925,"MEKAR JAYA, BAHUGA, WAY KANAN, LAMPUNG",2,87,69,156
https://kawalpemilu.org#928926,"KOTA DEWA, BAHUGA, WAY KANAN, LAMPUNG",1,50,125,175
https://kawalpemilu.org#928926,"KOTA DEWA, BAHUGA, WAY KANAN, LAMPUNG",2,139,115,254
https://kawalpemilu.org#928927,"DEWA AGUNG, BAHUGA, WAY KANAN, LAMPUNG",1,33,77,110
https://kawalpemilu.org#928927,"DEWA AGUNG, BAHUGA, WAY KANAN, LAMPUNG",2,115,80,195
https://kawalpemilu.org#24583,"KARANG AGUNG, PAKUAN RATU, WAY KANAN, LAMPUNG",1,21,93,114
https://kawalpemilu.org#24583,"KARANG AGUNG, PAKUAN RATU, WAY KANAN, LAMPUNG",2,41,108,149
https://kawalpemilu.org#24583,"KARANG AGUNG, PAKUAN RATU, WAY KANAN, LAMPUNG",3,181,37,218
https://kawalpemilu.org#24583,"KARANG AGUNG, PAKUAN RATU, WAY KANAN, LAMPUNG",4,164,28,192
https://kawalpemilu.org#24583,"KARANG AGUNG, PAKUAN RATU, WAY KANAN, LAMPUNG",5,52,71,123
https://kawalpemilu.org#24583,"KARANG AGUNG, PAKUAN RATU, WAY KANAN, LAMPUNG",6,129,56,185
https://kawalpemilu.org#24583,"KARANG AGUNG, PAKUAN RATU, WAY KANAN, LAMPUNG",7,142,20,162
https://kawalpemilu.org#24584,"TANJUNG RATU, PAKUAN RATU, WAY KANAN, LAMPUNG",1,123,148,271
https://kawalpemilu.org#24584,"TANJUNG RATU, PAKUAN RATU, WAY KANAN, LAMPUNG",2,75,59,134
https://kawalpemilu.org#24584,"TANJUNG RATU, PAKUAN RATU, WAY KANAN, LAMPUNG",3,104,43,147
https://kawalpemilu.org#24584,"TANJUNG RATU, PAKUAN RATU, WAY KANAN, LAMPUNG",4,171,101,272
https://kawalpemilu.org#24585,"PAKUAN RATU, PAKUAN RATU, WAY KANAN, LAMPUNG",1,43,117,160
https://kawalpemilu.org#24585,"PAKUAN RATU, PAKUAN RATU, WAY KANAN, LAMPUNG",2,53,131,184
https://kawalpemilu.org#24585,"PAKUAN RATU, PAKUAN RATU, WAY KANAN, LAMPUNG",3,188,56,244
https://kawalpemilu.org#24585,"PAKUAN RATU, PAKUAN RATU, WAY KANAN, LAMPUNG",4,47,113,160
https://kawalpemilu.org#24585,"PAKUAN RATU, PAKUAN RATU, WAY KANAN, LAMPUNG",5,95,142,237
https://kawalpemilu.org#24585,"PAKUAN RATU, PAKUAN RATU, WAY KANAN, LAMPUNG",6,102,50,152
https://kawalpemilu.org#24586,"GUNUNG CAHYA, PAKUAN RATU, WAY KANAN, LAMPUNG",1,53,132,185
https://kawalpemilu.org#24586,"GUNUNG CAHYA, PAKUAN RATU, WAY KANAN, LAMPUNG",2,69,117,186
https://kawalpemilu.org#24587,"RUMBIH, PAKUAN RATU, WAY KANAN, LAMPUNG",2,30,128,158
https://kawalpemilu.org#24587,"RUMBIH, PAKUAN RATU, WAY KANAN, LAMPUNG",3,99,21,120
https://kawalpemilu.org#24587,"RUMBIH, PAKUAN RATU, WAY KANAN, LAMPUNG",4,32,128,160
https://kawalpemilu.org#24587,"RUMBIH, PAKUAN RATU, WAY KANAN, LAMPUNG",5,17,84,101
https://kawalpemilu.org#24587,"RUMBIH, PAKUAN RATU, WAY KANAN, LAMPUNG",6,73,45,118
https://kawalpemilu.org#24588,"NEGARA RATU, PAKUAN RATU, WAY KANAN, LAMPUNG",1,39,154,193
https://kawalpemilu.org#24588,"NEGARA RATU, PAKUAN RATU, WAY KANAN, LAMPUNG",2,71,28,99
https://kawalpemilu.org#24588,"NEGARA RATU, PAKUAN RATU, WAY KANAN, LAMPUNG",3,36,118,154
https://kawalpemilu.org#24588,"NEGARA RATU, PAKUAN RATU, WAY KANAN, LAMPUNG",4,82,25,107
https://kawalpemilu.org#24589,"NEGARA SAKTI, PAKUAN RATU, WAY KANAN, LAMPUNG",1,48,68,113
https://kawalpemilu.org#24589,"NEGARA SAKTI, PAKUAN RATU, WAY KANAN, LAMPUNG",2,68,60,128
https://kawalpemilu.org#24589,"NEGARA SAKTI, PAKUAN RATU, WAY KANAN, LAMPUNG",3,129,21,150
https://kawalpemilu.org#24589,"NEGARA SAKTI, PAKUAN RATU, WAY KANAN, LAMPUNG",4,132,8,140
https://kawalpemilu.org#24589,"NEGARA SAKTI, PAKUAN RATU, WAY KANAN, LAMPUNG",5,51,75,126
https://kawalpemilu.org#24589,"NEGARA SAKTI, PAKUAN RATU, WAY KANAN, LAMPUNG",6,82,37,119
https://kawalpemilu.org#24589,"NEGARA SAKTI, PAKUAN RATU, WAY KANAN, LAMPUNG",7,93,46,139
https://kawalpemilu.org#24589,"NEGARA SAKTI, PAKUAN RATU, WAY KANAN, LAMPUNG",8,116,13,129
https://kawalpemilu.org#24590,"SUKA BUMI, PAKUAN RATU, WAY KANAN, LAMPUNG",1,166,51,217
https://kawalpemilu.org#24590,"SUKA BUMI, PAKUAN RATU, WAY KANAN, LAMPUNG",2,155,53,208
https://kawalpemilu.org#24590,"SUKA BUMI, PAKUAN RATU, WAY KANAN, LAMPUNG",3,159,25,184
https://kawalpemilu.org#24590,"SUKA BUMI, PAKUAN RATU, WAY KANAN, LAMPUNG",4,135,48,183
https://kawalpemilu.org#24590,"SUKA BUMI, PAKUAN RATU, WAY KANAN, LAMPUNG",5,179,24,203
https://kawalpemilu.org#24590,"SUKA BUMI, PAKUAN RATU, WAY KANAN, LAMPUNG",6,132,35,167
https://kawalpemilu.org#24590,"SUKA BUMI, PAKUAN RATU, WAY KANAN, LAMPUNG",7,87,35,122
https://kawalpemilu.org#24590,"SUKA BUMI, PAKUAN RATU, WAY KANAN, LAMPUNG",8,146,17,163
https://kawalpemilu.org#24590,"SUKA BUMI, PAKUAN RATU, WAY KANAN, LAMPUNG",9,132,47,179
https://kawalpemilu.org#24590,"SUKA BUMI, PAKUAN RATU, WAY KANAN, LAMPUNG",10,154,39,193
https://kawalpemilu.org#24590,"SUKA BUMI, PAKUAN RATU, WAY KANAN, LAMPUNG",11,153,28,181
https://kawalpemilu.org#24590,"SUKA BUMI, PAKUAN RATU, WAY KANAN, LAMPUNG",12,160,40,200
https://kawalpemilu.org#24590,"SUKA BUMI, PAKUAN RATU, WAY KANAN, LAMPUNG",13,171,56,227
https://kawalpemilu.org#24590,"SUKA BUMI, PAKUAN RATU, WAY KANAN, LAMPUNG",14,84,38,122
https://kawalpemilu.org#24591,"TANJUNG AGUNG, PAKUAN RATU, WAY KANAN, LAMPUNG",1,121,47,168
https://kawalpemilu.org#24591,"TANJUNG AGUNG, PAKUAN RATU, WAY KANAN, LAMPUNG",2,113,31,144
https://kawalpemilu.org#24591,"TANJUNG AGUNG, PAKUAN RATU, WAY KANAN, LAMPUNG",3,164,27,191
https://kawalpemilu.org#24591,"TANJUNG AGUNG, PAKUAN RATU, WAY KANAN, LAMPUNG",4,185,58,243
https://kawalpemilu.org#24591,"TANJUNG AGUNG, PAKUAN RATU, WAY KANAN, LAMPUNG",5,181,19,200
https://kawalpemilu.org#24591,"TANJUNG AGUNG, PAKUAN RATU, WAY KANAN, LAMPUNG",6,144,64,208
https://kawalpemilu.org#24591,"TANJUNG AGUNG, PAKUAN RATU, WAY KANAN, LAMPUNG",7,95,82,177
https://kawalpemilu.org#24591,"TANJUNG AGUNG, PAKUAN RATU, WAY KANAN, LAMPUNG",8,133,46,179
https://kawalpemilu.org#24591,"TANJUNG AGUNG, PAKUAN RATU, WAY KANAN, LAMPUNG",9,166,35,201
https://kawalpemilu.org#24591,"TANJUNG AGUNG, PAKUAN RATU, WAY KANAN, LAMPUNG",10,156,24,180
https://kawalpemilu.org#24592,"TANJUNG SERUPA, PAKUAN RATU, WAY KANAN, LAMPUNG",1,126,73,199
https://kawalpemilu.org#24592,"TANJUNG SERUPA, PAKUAN RATU, WAY KANAN, LAMPUNG",2,175,48,223
https://kawalpemilu.org#24592,"TANJUNG SERUPA, PAKUAN RATU, WAY KANAN, LAMPUNG",3,154,41,195
https://kawalpemilu.org#24592,"TANJUNG SERUPA, PAKUAN RATU, WAY KANAN, LAMPUNG",4,101,29,130
https://kawalpemilu.org#24592,"TANJUNG SERUPA, PAKUAN RATU, WAY KANAN, LAMPUNG",5,200,80,280
https://kawalpemilu.org#24592,"TANJUNG SERUPA, PAKUAN RATU, WAY KANAN, LAMPUNG",6,158,36,194
https://kawalpemilu.org#24592,"TANJUNG SERUPA, PAKUAN RATU, WAY KANAN, LAMPUNG",7,165,41,206
https://kawalpemilu.org#24592,"TANJUNG SERUPA, PAKUAN RATU, WAY KANAN, LAMPUNG",8,157,49,206
https://kawalpemilu.org#24592,"TANJUNG SERUPA, PAKUAN RATU, WAY KANAN, LAMPUNG",9,188,25,213
https://kawalpemilu.org#24592,"TANJUNG SERUPA, PAKUAN RATU, WAY KANAN, LAMPUNG",10,162,21,183
https://kawalpemilu.org#24592,"TANJUNG SERUPA, PAKUAN RATU, WAY KANAN, LAMPUNG",11,146,19,165
https://kawalpemilu.org#24592,"TANJUNG SERUPA, PAKUAN RATU, WAY KANAN, LAMPUNG",12,211,30,241
https://kawalpemilu.org#24593,"NEGARA HARJA, PAKUAN RATU, WAY KANAN, LAMPUNG",1,129,63,192
https://kawalpemilu.org#24593,"NEGARA HARJA, PAKUAN RATU, WAY KANAN, LAMPUNG",2,132,43,175
https://kawalpemilu.org#24593,"NEGARA HARJA, PAKUAN RATU, WAY KANAN, LAMPUNG",3,154,47,201
https://kawalpemilu.org#24593,"NEGARA HARJA, PAKUAN RATU, WAY KANAN, LAMPUNG",4,164,43,207
https://kawalpemilu.org#24593,"NEGARA HARJA, PAKUAN RATU, WAY KANAN, LAMPUNG",5,148,39,187
https://kawalpemilu.org#24593,"NEGARA HARJA, PAKUAN RATU, WAY KANAN, LAMPUNG",6,91,43,134
https://kawalpemilu.org#24593,"NEGARA HARJA, PAKUAN RATU, WAY KANAN, LAMPUNG",7,123,22,145
https://kawalpemilu.org#24594,"BAKTI NEGARA, PAKUAN RATU, WAY KANAN, LAMPUNG",1,112,107,219
https://kawalpemilu.org#24594,"BAKTI NEGARA, PAKUAN RATU, WAY KANAN, LAMPUNG",2,145,62,207
https://kawalpemilu.org#24594,"BAKTI NEGARA, PAKUAN RATU, WAY KANAN, LAMPUNG",3,191,49,240
https://kawalpemilu.org#24594,"BAKTI NEGARA, PAKUAN RATU, WAY KANAN, LAMPUNG",4,162,36,198
https://kawalpemilu.org#24594,"BAKTI NEGARA, PAKUAN RATU, WAY KANAN, LAMPUNG",5,104,84,188
https://kawalpemilu.org#24594,"BAKTI NEGARA, PAKUAN RATU, WAY KANAN, LAMPUNG",6,148,53,201
https://kawalpemilu.org#24595,"PAKUAN BARU, PAKUAN RATU, WAY KANAN, LAMPUNG",1,136,48,184
https://kawalpemilu.org#24595,"PAKUAN BARU, PAKUAN RATU, WAY KANAN, LAMPUNG",2,139,58,197
https://kawalpemilu.org#24595,"PAKUAN BARU, PAKUAN RATU, WAY KANAN, LAMPUNG",3,165,52,217
https://kawalpemilu.org#24595,"PAKUAN BARU, PAKUAN RATU, WAY KANAN, LAMPUNG",4,153,37,190
https://kawalpemilu.org#24595,"PAKUAN BARU, PAKUAN RATU, WAY KANAN, LAMPUNG",5,147,22,169
https://kawalpemilu.org#24595,"PAKUAN BARU, PAKUAN RATU, WAY KANAN, LAMPUNG",6,150,31,181
https://kawalpemilu.org#24595,"PAKUAN BARU, PAKUAN RATU, WAY KANAN, LAMPUNG",7,140,50,190
https://kawalpemilu.org#24595,"PAKUAN BARU, PAKUAN RATU, WAY KANAN, LAMPUNG",8,119,58,177
https://kawalpemilu.org#24595,"PAKUAN BARU, PAKUAN RATU, WAY KANAN, LAMPUNG",9,144,27,171
https://kawalpemilu.org#24595,"PAKUAN BARU, PAKUAN RATU, WAY KANAN, LAMPUNG",10,136,27,163
https://kawalpemilu.org#24596,"NEGARA TAMA, PAKUAN RATU, WAY KANAN, LAMPUNG",1,148,19,167
https://kawalpemilu.org#24596,"NEGARA TAMA, PAKUAN RATU, WAY KANAN, LAMPUNG",2,155,7,162
https://kawalpemilu.org#24596,"NEGARA TAMA, PAKUAN RATU, WAY KANAN, LAMPUNG",3,81,10,91
https://kawalpemilu.org#24596,"NEGARA TAMA, PAKUAN RATU, WAY KANAN, LAMPUNG",4,125,10,135
https://kawalpemilu.org#24596,"NEGARA TAMA, PAKUAN RATU, WAY KANAN, LAMPUNG",5,156,26,182
https://kawalpemilu.org#24596,"NEGARA TAMA, PAKUAN RATU, WAY KANAN, LAMPUNG",6,127,9,136
https://kawalpemilu.org#24597,"WAY TAWAR, PAKUAN RATU, WAY KANAN, LAMPUNG",1,123,39,162
https://kawalpemilu.org#24597,"WAY TAWAR, PAKUAN RATU, WAY KANAN, LAMPUNG",2,98,89,187
https://kawalpemilu.org#24597,"WAY TAWAR, PAKUAN RATU, WAY KANAN, LAMPUNG",3,153,52,205
https://kawalpemilu.org#24597,"WAY TAWAR, PAKUAN RATU, WAY KANAN, LAMPUNG",4,157,19,176
https://kawalpemilu.org#24597,"WAY TAWAR, PAKUAN RATU, WAY KANAN, LAMPUNG",5,98,68,166
https://kawalpemilu.org#24597,"WAY TAWAR, PAKUAN RATU, WAY KANAN, LAMPUNG",6,164,35,199
https://kawalpemilu.org#24598,"GUNUNG WARAS, PAKUAN RATU, WAY KANAN, LAMPUNG",1,19,137,156
https://kawalpemilu.org#24598,"GUNUNG WARAS, PAKUAN RATU, WAY KANAN, LAMPUNG",2,118,103,221
https://kawalpemilu.org#24598,"GUNUNG WARAS, PAKUAN RATU, WAY KANAN, LAMPUNG",3,98,131,229
https://kawalpemilu.org#24598,"GUNUNG WARAS, PAKUAN RATU, WAY KANAN, LAMPUNG",4,55,121,176
https://kawalpemilu.org#24598,"GUNUNG WARAS, PAKUAN RATU, WAY KANAN, LAMPUNG",5,22,151,173
https://kawalpemilu.org#24599,"PAKUAN SAKTI, PAKUAN RATU, WAY KANAN, LAMPUNG",1,95,29,124
https://kawalpemilu.org#24599,"PAKUAN SAKTI, PAKUAN RATU, WAY KANAN, LAMPUNG",2,163,31,194
https://kawalpemilu.org#24599,"PAKUAN SAKTI, PAKUAN RATU, WAY KANAN, LAMPUNG",3,140,43,183
https://kawalpemilu.org#24599,"PAKUAN SAKTI, PAKUAN RATU, WAY KANAN, LAMPUNG",4,71,52,123
https://kawalpemilu.org#24599,"PAKUAN SAKTI, PAKUAN RATU, WAY KANAN, LAMPUNG",5,124,48,172
https://kawalpemilu.org#24599,"PAKUAN SAKTI, PAKUAN RATU, WAY KANAN, LAMPUNG",6,162,40,202
https://kawalpemilu.org#24600,"SERUPA INDAH, PAKUAN RATU, WAY KANAN, LAMPUNG",1,148,9,157
https://kawalpemilu.org#24600,"SERUPA INDAH, PAKUAN RATU, WAY KANAN, LAMPUNG",2,140,33,173
https://kawalpemilu.org#24600,"SERUPA INDAH, PAKUAN RATU, WAY KANAN, LAMPUNG",3,101,59,160
https://kawalpemilu.org#24600,"SERUPA INDAH, PAKUAN RATU, WAY KANAN, LAMPUNG",4,174,26,200
https://kawalpemilu.org#24600,"SERUPA INDAH, PAKUAN RATU, WAY KANAN, LAMPUNG",5,173,42,215
https://kawalpemilu.org#24600,"SERUPA INDAH, PAKUAN RATU, WAY KANAN, LAMPUNG",6,108,58,166
https://kawalpemilu.org#24600,"SERUPA INDAH, PAKUAN RATU, WAY KANAN, LAMPUNG",7,114,16,130
https://kawalpemilu.org#24600,"SERUPA INDAH, PAKUAN RATU, WAY KANAN, LAMPUNG",8,107,39,146
https://kawalpemilu.org#24600,"SERUPA INDAH, PAKUAN RATU, WAY KANAN, LAMPUNG",9,116,11,127
https://kawalpemilu.org#24600,"SERUPA INDAH, PAKUAN RATU, WAY KANAN, LAMPUNG",10,142,47,189
https://kawalpemilu.org#24600,"SERUPA INDAH, PAKUAN RATU, WAY KANAN, LAMPUNG",11,89,36,125
https://kawalpemilu.org#24600,"SERUPA INDAH, PAKUAN RATU, WAY KANAN, LAMPUNG",12,141,14,155
https://kawalpemilu.org#24600,"SERUPA INDAH, PAKUAN RATU, WAY KANAN, LAMPUNG",13,122,19,141
https://kawalpemilu.org#24601,"BUMI MULYA, PAKUAN RATU, WAY KANAN, LAMPUNG",1,95,50,145
https://kawalpemilu.org#24601,"BUMI MULYA, PAKUAN RATU, WAY KANAN, LAMPUNG",2,94,109,203
https://kawalpemilu.org#24601,"BUMI MULYA, PAKUAN RATU, WAY KANAN, LAMPUNG",3,102,51,153
https://kawalpemilu.org#24601,"BUMI MULYA, PAKUAN RATU, WAY KANAN, LAMPUNG",4,80,81,161
https://kawalpemilu.org#24601,"BUMI MULYA, PAKUAN RATU, WAY KANAN, LAMPUNG",5,151,57,208
https://kawalpemilu.org#24601,"BUMI MULYA, PAKUAN RATU, WAY KANAN, LAMPUNG",6,128,94,222
https://kawalpemilu.org#24601,"BUMI MULYA, PAKUAN RATU, WAY KANAN, LAMPUNG",7,94,53,147
https://kawalpemilu.org#24601,"BUMI MULYA, PAKUAN RATU, WAY KANAN, LAMPUNG",8,74,84,158
https://kawalpemilu.org#24603,"NEGERI AGUNG, NEGERI AGUNG, WAY KANAN, LAMPUNG",1,26,170,196
https://kawalpemilu.org#24603,"NEGERI AGUNG, NEGERI AGUNG, WAY KANAN, LAMPUNG",2,33,159,192
https://kawalpemilu.org#24603,"NEGERI AGUNG, NEGERI AGUNG, WAY KANAN, LAMPUNG",3,34,145,179
https://kawalpemilu.org#24603,"NEGERI AGUNG, NEGERI AGUNG, WAY KANAN, LAMPUNG",4,33,160,193
https://kawalpemilu.org#24603,"NEGERI AGUNG, NEGERI AGUNG, WAY KANAN, LAMPUNG",5,12,159,171
https://kawalpemilu.org#24603,"NEGERI AGUNG, NEGERI AGUNG, WAY KANAN, LAMPUNG",6,9,189,198
https://kawalpemilu.org#24604,"BANDAR DALAM, NEGERI AGUNG, WAY KANAN, LAMPUNG",1,32,160,192
https://kawalpemilu.org#24604,"BANDAR DALAM, NEGERI AGUNG, WAY KANAN, LAMPUNG",2,156,23,179
https://kawalpemilu.org#24604,"BANDAR DALAM, NEGERI AGUNG, WAY KANAN, LAMPUNG",4,108,88,196
https://kawalpemilu.org#24604,"BANDAR DALAM, NEGERI AGUNG, WAY KANAN, LAMPUNG",5,120,47,167
https://kawalpemilu.org#24604,"BANDAR DALAM, NEGERI AGUNG, WAY KANAN, LAMPUNG",6,106,105,211
https://kawalpemilu.org#24604,"BANDAR DALAM, NEGERI AGUNG, WAY KANAN, LAMPUNG",7,144,42,186
https://kawalpemilu.org#24604,"BANDAR DALAM, NEGERI AGUNG, WAY KANAN, LAMPUNG",8,109,79,188
https://kawalpemilu.org#24604,"BANDAR DALAM, NEGERI AGUNG, WAY KANAN, LAMPUNG",9,85,82,167
https://kawalpemilu.org#24605,"PULAU BATU, NEGERI AGUNG, WAY KANAN, LAMPUNG",1,30,136,166
https://kawalpemilu.org#24605,"PULAU BATU, NEGERI AGUNG, WAY KANAN, LAMPUNG",2,45,156,201
https://kawalpemilu.org#24605,"PULAU BATU, NEGERI AGUNG, WAY KANAN, LAMPUNG",3,25,151,176
https://kawalpemilu.org#24605,"PULAU BATU, NEGERI AGUNG, WAY KANAN, LAMPUNG",4,29,124,153
https://kawalpemilu.org#24606,"PENENGAHAN, NEGERI AGUNG, WAY KANAN, LAMPUNG",1,17,241,258
https://kawalpemilu.org#24606,"PENENGAHAN, NEGERI AGUNG, WAY KANAN, LAMPUNG",2,56,99,155
https://kawalpemilu.org#24606,"PENENGAHAN, NEGERI AGUNG, WAY KANAN, LAMPUNG",3,43,94,137
https://kawalpemilu.org#24607,"KARYA AGUNG, NEGERI AGUNG, WAY KANAN, LAMPUNG",2,0,0,0
https://kawalpemilu.org#24607,"KARYA AGUNG, NEGERI AGUNG, WAY KANAN, LAMPUNG",3,201,96,297
https://kawalpemilu.org#24608,"SUNSANG, NEGERI AGUNG, WAY KANAN, LAMPUNG",1,66,189,255
https://kawalpemilu.org#24608,"SUNSANG, NEGERI AGUNG, WAY KANAN, LAMPUNG",2,91,110,201
https://kawalpemilu.org#24608,"SUNSANG, NEGERI AGUNG, WAY KANAN, LAMPUNG",3,107,99,206
https://kawalpemilu.org#24608,"SUNSANG, NEGERI AGUNG, WAY KANAN, LAMPUNG",4,87,89,176
https://kawalpemilu.org#24608,"SUNSANG, NEGERI AGUNG, WAY KANAN, LAMPUNG",5,106,78,184
https://kawalpemilu.org#24608,"SUNSANG, NEGERI AGUNG, WAY KANAN, LAMPUNG",6,146,59,205
https://kawalpemilu.org#24608,"SUNSANG, NEGERI AGUNG, WAY KANAN, LAMPUNG",7,115,79,194
https://kawalpemilu.org#24609,"KOTA BARU, NEGERI AGUNG, WAY KANAN, LAMPUNG",1,120,123,243
https://kawalpemilu.org#24609,"KOTA BARU, NEGERI AGUNG, WAY KANAN, LAMPUNG",2,167,69,236
https://kawalpemilu.org#24609,"KOTA BARU, NEGERI AGUNG, WAY KANAN, LAMPUNG",3,138,41,179
https://kawalpemilu.org#24609,"KOTA BARU, NEGERI AGUNG, WAY KANAN, LAMPUNG",4,170,47,217
https://kawalpemilu.org#24610,"KOTABUMI WAY KANAN, NEGERI AGUNG, WAY KANAN, LAMPUNG",1,107,104,211
https://kawalpemilu.org#24610,"KOTABUMI WAY KANAN, NEGERI AGUNG, WAY KANAN, LAMPUNG",2,68,57,125
https://kawalpemilu.org#24610,"KOTABUMI WAY KANAN, NEGERI AGUNG, WAY KANAN, LAMPUNG",3,89,24,113
https://kawalpemilu.org#24610,"KOTABUMI WAY KANAN, NEGERI AGUNG, WAY KANAN, LAMPUNG",4,80,45,125
https://kawalpemilu.org#24610,"KOTABUMI WAY KANAN, NEGERI AGUNG, WAY KANAN, LAMPUNG",5,166,38,204
https://kawalpemilu.org#24610,"KOTABUMI WAY KANAN, NEGERI AGUNG, WAY KANAN, LAMPUNG",6,158,53,211
https://kawalpemilu.org#24611,"GEDUNG MENENG, NEGERI AGUNG, WAY KANAN, LAMPUNG",1,47,125,172
https://kawalpemilu.org#24611,"GEDUNG MENENG, NEGERI AGUNG, WAY KANAN, LAMPUNG",2,144,53,197
https://kawalpemilu.org#24611,"GEDUNG MENENG, NEGERI AGUNG, WAY KANAN, LAMPUNG",3,97,90,187
https://kawalpemilu.org#24611,"GEDUNG MENENG, NEGERI AGUNG, WAY KANAN, LAMPUNG",4,149,58,207
https://kawalpemilu.org#24612,"GEDUNG HARAPAN, NEGERI AGUNG, WAY KANAN, LAMPUNG",1,87,60,147
https://kawalpemilu.org#24612,"GEDUNG HARAPAN, NEGERI AGUNG, WAY KANAN, LAMPUNG",2,112,40,152
https://kawalpemilu.org#24612,"GEDUNG HARAPAN, NEGERI AGUNG, WAY KANAN, LAMPUNG",3,139,38,177
https://kawalpemilu.org#24612,"GEDUNG HARAPAN, NEGERI AGUNG, WAY KANAN, LAMPUNG",4,151,41,192
https://kawalpemilu.org#24612,"GEDUNG HARAPAN, NEGERI AGUNG, WAY KANAN, LAMPUNG",5,107,46,153
https://kawalpemilu.org#24612,"GEDUNG HARAPAN, NEGERI AGUNG, WAY KANAN, LAMPUNG",7,120,49,169
https://kawalpemilu.org#24612,"GEDUNG HARAPAN, NEGERI AGUNG, WAY KANAN, LAMPUNG",8,116,59,175
https://kawalpemilu.org#24613,"TANJUNG REJO, NEGERI AGUNG, WAY KANAN, LAMPUNG",1,103,64,167
https://kawalpemilu.org#24613,"TANJUNG REJO, NEGERI AGUNG, WAY KANAN, LAMPUNG",2,102,97,199
https://kawalpemilu.org#24613,"TANJUNG REJO, NEGERI AGUNG, WAY KANAN, LAMPUNG",3,176,64,240
https://kawalpemilu.org#24613,"TANJUNG REJO, NEGERI AGUNG, WAY KANAN, LAMPUNG",4,117,40,157
https://kawalpemilu.org#24613,"TANJUNG REJO, NEGERI AGUNG, WAY KANAN, LAMPUNG",5,201,14,215
https://kawalpemilu.org#24613,"TANJUNG REJO, NEGERI AGUNG, WAY KANAN, LAMPUNG",6,126,37,163
https://kawalpemilu.org#24613,"TANJUNG REJO, NEGERI AGUNG, WAY KANAN, LAMPUNG",8,130,91,221
https://kawalpemilu.org#24613,"TANJUNG REJO, NEGERI AGUNG, WAY KANAN, LAMPUNG",9,75,38,113
https://kawalpemilu.org#24613,"TANJUNG REJO, NEGERI AGUNG, WAY KANAN, LAMPUNG",10,133,108,241
https://kawalpemilu.org#24613,"TANJUNG REJO, NEGERI AGUNG, WAY KANAN, LAMPUNG",11,88,15,103
https://kawalpemilu.org#24613,"TANJUNG REJO, NEGERI AGUNG, WAY KANAN, LAMPUNG",12,119,40,159
https://kawalpemilu.org#24613,"TANJUNG REJO, NEGERI AGUNG, WAY KANAN, LAMPUNG",13,89,44,133
https://kawalpemilu.org#24613,"TANJUNG REJO, NEGERI AGUNG, WAY KANAN, LAMPUNG",14,137,54,191
https://kawalpemilu.org#24614,"KALI PAPAN, NEGERI AGUNG, WAY KANAN, LAMPUNG",1,60,177,237
https://kawalpemilu.org#24614,"KALI PAPAN, NEGERI AGUNG, WAY KANAN, LAMPUNG",2,59,97,156
https://kawalpemilu.org#24614,"KALI PAPAN, NEGERI AGUNG, WAY KANAN, LAMPUNG",4,65,115,180
https://kawalpemilu.org#24614,"KALI PAPAN, NEGERI AGUNG, WAY KANAN, LAMPUNG",6,42,150,192
https://kawalpemilu.org#24614,"KALI PAPAN, NEGERI AGUNG, WAY KANAN, LAMPUNG",7,56,115,171
https://kawalpemilu.org#24614,"KALI PAPAN, NEGERI AGUNG, WAY KANAN, LAMPUNG",9,70,138,208
https://kawalpemilu.org#24614,"KALI PAPAN, NEGERI AGUNG, WAY KANAN, LAMPUNG",10,118,131,249
https://kawalpemilu.org#24614,"KALI PAPAN, NEGERI AGUNG, WAY KANAN, LAMPUNG",11,73,149,222
https://kawalpemilu.org#24614,"KALI PAPAN, NEGERI AGUNG, WAY KANAN, LAMPUNG",12,46,123,169
https://kawalpemilu.org#24614,"KALI PAPAN, NEGERI AGUNG, WAY KANAN, LAMPUNG",13,69,192,261
https://kawalpemilu.org#24614,"KALI PAPAN, NEGERI AGUNG, WAY KANAN, LAMPUNG",14,44,129,173
https://kawalpemilu.org#24614,"KALI PAPAN, NEGERI AGUNG, WAY KANAN, LAMPUNG",15,57,140,197
https://kawalpemilu.org#24614,"KALI PAPAN, NEGERI AGUNG, WAY KANAN, LAMPUNG",16,50,128,178
https://kawalpemilu.org#24614,"KALI PAPAN, NEGERI AGUNG, WAY KANAN, LAMPUNG",17,36,137,173
https://kawalpemilu.org#24614,"KALI PAPAN, NEGERI AGUNG, WAY KANAN, LAMPUNG",20,97,145,242
https://kawalpemilu.org#24615,"MULYA SARI, NEGERI AGUNG, WAY KANAN, LAMPUNG",1,155,26,181
https://kawalpemilu.org#24615,"MULYA SARI, NEGERI AGUNG, WAY KANAN, LAMPUNG",2,157,6,163
https://kawalpemilu.org#24615,"MULYA SARI, NEGERI AGUNG, WAY KANAN, LAMPUNG",3,137,5,142
https://kawalpemilu.org#24615,"MULYA SARI, NEGERI AGUNG, WAY KANAN, LAMPUNG",4,133,19,152
https://kawalpemilu.org#24615,"MULYA SARI, NEGERI AGUNG, WAY KANAN, LAMPUNG",5,160,16,176
https://kawalpemilu.org#24615,"MULYA SARI, NEGERI AGUNG, WAY KANAN, LAMPUNG",6,113,6,119
https://kawalpemilu.org#24615,"MULYA SARI, NEGERI AGUNG, WAY KANAN, LAMPUNG",7,132,8,140
https://kawalpemilu.org#24615,"MULYA SARI, NEGERI AGUNG, WAY KANAN, LAMPUNG",8,134,14,148
https://kawalpemilu.org#24616,"WAY LIMAU, NEGERI AGUNG, WAY KANAN, LAMPUNG",1,42,121,163
https://kawalpemilu.org#24616,"WAY LIMAU, NEGERI AGUNG, WAY KANAN, LAMPUNG",2,112,87,199
https://kawalpemilu.org#24617,"GEDUNG JAYA, NEGERI AGUNG, WAY KANAN, LAMPUNG",1,13,164,177
https://kawalpemilu.org#24617,"GEDUNG JAYA, NEGERI AGUNG, WAY KANAN, LAMPUNG",2,41,144,185
https://kawalpemilu.org#24617,"GEDUNG JAYA, NEGERI AGUNG, WAY KANAN, LAMPUNG",3,18,140,158
https://kawalpemilu.org#24618,"REJO SARI, NEGERI AGUNG, WAY KANAN, LAMPUNG",1,131,42,173
https://kawalpemilu.org#24618,"REJO SARI, NEGERI AGUNG, WAY KANAN, LAMPUNG",2,92,20,112
https://kawalpemilu.org#24618,"REJO SARI, NEGERI AGUNG, WAY KANAN, LAMPUNG",3,109,25,134
https://kawalpemilu.org#24618,"REJO SARI, NEGERI AGUNG, WAY KANAN, LAMPUNG",4,105,44,149
https://kawalpemilu.org#24618,"REJO SARI, NEGERI AGUNG, WAY KANAN, LAMPUNG",5,180,38,218
https://kawalpemilu.org#24618,"REJO SARI, NEGERI AGUNG, WAY KANAN, LAMPUNG",6,127,32,159
https://kawalpemilu.org#24618,"REJO SARI, NEGERI AGUNG, WAY KANAN, LAMPUNG",8,85,55,140
https://kawalpemilu.org#24619,"BANDAR KASIH, NEGERI AGUNG, WAY KANAN, LAMPUNG",1,163,42,205
https://kawalpemilu.org#24619,"BANDAR KASIH, NEGERI AGUNG, WAY KANAN, LAMPUNG",2,89,81,170
https://kawalpemilu.org#24619,"BANDAR KASIH, NEGERI AGUNG, WAY KANAN, LAMPUNG",3,137,65,202
https://kawalpemilu.org#24620,"SUMBER REJEKI, NEGERI AGUNG, WAY KANAN, LAMPUNG",1,81,106,187
https://kawalpemilu.org#24620,"SUMBER REJEKI, NEGERI AGUNG, WAY KANAN, LAMPUNG",2,120,119,239
https://kawalpemilu.org#24620,"SUMBER REJEKI, NEGERI AGUNG, WAY KANAN, LAMPUNG",4,38,47,85
https://kawalpemilu.org#24620,"SUMBER REJEKI, NEGERI AGUNG, WAY KANAN, LAMPUNG",5,54,56,110
https://kawalpemilu.org#928928,"MULYA AGUNG, NEGERI AGUNG, WAY KANAN, LAMPUNG",1,123,72,195
https://kawalpemilu.org#928928,"MULYA AGUNG, NEGERI AGUNG, WAY KANAN, LAMPUNG",2,83,96,179
https://kawalpemilu.org#928928,"MULYA AGUNG, NEGERI AGUNG, WAY KANAN, LAMPUNG",3,129,75,204
https://kawalpemilu.org#928928,"MULYA AGUNG, NEGERI AGUNG, WAY KANAN, LAMPUNG",4,83,84,167
https://kawalpemilu.org#928928,"MULYA AGUNG, NEGERI AGUNG, WAY KANAN, LAMPUNG",5,57,80,137
https://kawalpemilu.org#24622,"WAY TUBA, WAY TUBA, WAY KANAN, LAMPUNG",1,74,113,187
https://kawalpemilu.org#24622,"WAY TUBA, WAY TUBA, WAY KANAN, LAMPUNG",2,78,82,160
https://kawalpemilu.org#24622,"WAY TUBA, WAY TUBA, WAY KANAN, LAMPUNG",3,81,92,173
https://kawalpemilu.org#24622,"WAY TUBA, WAY TUBA, WAY KANAN, LAMPUNG",4,114,109,223
https://kawalpemilu.org#24622,"WAY TUBA, WAY TUBA, WAY KANAN, LAMPUNG",5,42,108,150
https://kawalpemilu.org#24622,"WAY TUBA, WAY TUBA, WAY KANAN, LAMPUNG",6,100,84,184
https://kawalpemilu.org#24622,"WAY TUBA, WAY TUBA, WAY KANAN, LAMPUNG",7,53,93,146
https://kawalpemilu.org#24622,"WAY TUBA, WAY TUBA, WAY KANAN, LAMPUNG",9,90,142,232
https://kawalpemilu.org#24622,"WAY TUBA, WAY TUBA, WAY KANAN, LAMPUNG",10,45,106,151
https://kawalpemilu.org#24622,"WAY TUBA, WAY TUBA, WAY KANAN, LAMPUNG",11,57,117,174
https://kawalpemilu.org#24623,"KARYA JAYA, WAY TUBA, WAY KANAN, LAMPUNG",1,67,105,172
https://kawalpemilu.org#24623,"KARYA JAYA, WAY TUBA, WAY KANAN, LAMPUNG",2,40,155,195
https://kawalpemilu.org#24623,"KARYA JAYA, WAY TUBA, WAY KANAN, LAMPUNG",3,53,161,214
https://kawalpemilu.org#24623,"KARYA JAYA, WAY TUBA, WAY KANAN, LAMPUNG",4,48,124,172
https://kawalpemilu.org#24623,"KARYA JAYA, WAY TUBA, WAY KANAN, LAMPUNG",6,53,145,198
https://kawalpemilu.org#24624,"SAY UMPU, WAY TUBA, WAY KANAN, LAMPUNG",1,106,85,191
https://kawalpemilu.org#24624,"SAY UMPU, WAY TUBA, WAY KANAN, LAMPUNG",2,101,135,236
https://kawalpemilu.org#24624,"SAY UMPU, WAY TUBA, WAY KANAN, LAMPUNG",3,72,101,173
https://kawalpemilu.org#24624,"SAY UMPU, WAY TUBA, WAY KANAN, LAMPUNG",4,131,92,223
https://kawalpemilu.org#24625,"BERINGIN JAYA, WAY TUBA, WAY KANAN, LAMPUNG",1,73,139,212
https://kawalpemilu.org#24625,"BERINGIN JAYA, WAY TUBA, WAY KANAN, LAMPUNG",2,124,83,207
https://kawalpemilu.org#24625,"BERINGIN JAYA, WAY TUBA, WAY KANAN, LAMPUNG",3,108,54,155
https://kawalpemilu.org#24625,"BERINGIN JAYA, WAY TUBA, WAY KANAN, LAMPUNG",4,86,79,165
https://kawalpemilu.org#24626,"SUMA MUKTI, WAY TUBA, WAY KANAN, LAMPUNG",1,86,97,183
https://kawalpemilu.org#24626,"SUMA MUKTI, WAY TUBA, WAY KANAN, LAMPUNG",2,89,119,208
https://kawalpemilu.org#24626,"SUMA MUKTI, WAY TUBA, WAY KANAN, LAMPUNG",3,100,79,179
https://kawalpemilu.org#24626,"SUMA MUKTI, WAY TUBA, WAY KANAN, LAMPUNG",4,51,150,201
https://kawalpemilu.org#24627,"RAMSAI, WAY TUBA, WAY KANAN, LAMPUNG",1,158,57,215
https://kawalpemilu.org#24627,"RAMSAI, WAY TUBA, WAY KANAN, LAMPUNG",2,105,111,216
https://kawalpemilu.org#24627,"RAMSAI, WAY TUBA, WAY KANAN, LAMPUNG",3,102,64,166
https://kawalpemilu.org#24627,"RAMSAI, WAY TUBA, WAY KANAN, LAMPUNG",6,119,116,235
https://kawalpemilu.org#24627,"RAMSAI, WAY TUBA, WAY KANAN, LAMPUNG",7,114,54,168
https://kawalpemilu.org#24627,"RAMSAI, WAY TUBA, WAY KANAN, LAMPUNG",8,138,67,205
https://kawalpemilu.org#24628,"BANDAR SARI, WAY TUBA, WAY KANAN, LAMPUNG",1,99,39,138
https://kawalpemilu.org#24628,"BANDAR SARI, WAY TUBA, WAY KANAN, LAMPUNG",2,77,89,166
https://kawalpemilu.org#24628,"BANDAR SARI, WAY TUBA, WAY KANAN, LAMPUNG",3,136,66,202
https://kawalpemilu.org#24628,"BANDAR SARI, WAY TUBA, WAY KANAN, LAMPUNG",4,82,98,180
https://kawalpemilu.org#24628,"BANDAR SARI, WAY TUBA, WAY KANAN, LAMPUNG",5,71,116,187
https://kawalpemilu.org#24628,"BANDAR SARI, WAY TUBA, WAY KANAN, LAMPUNG",6,80,110,190
https://kawalpemilu.org#24628,"BANDAR SARI, WAY TUBA, WAY KANAN, LAMPUNG",7,86,81,167
https://kawalpemilu.org#24628,"BANDAR SARI, WAY TUBA, WAY KANAN, LAMPUNG",8,110,68,3
https://kawalpemilu.org#24628,"BANDAR SARI, WAY TUBA, WAY KANAN, LAMPUNG",9,141,71,212
https://kawalpemilu.org#24628,"BANDAR SARI, WAY TUBA, WAY KANAN, LAMPUNG",10,94,126,220
https://kawalpemilu.org#24628,"BANDAR SARI, WAY TUBA, WAY KANAN, LAMPUNG",11,42,64,106
https://kawalpemilu.org#24628,"BANDAR SARI, WAY TUBA, WAY KANAN, LAMPUNG",12,104,89,193
https://kawalpemilu.org#24629,"BUMI DANA, WAY TUBA, WAY KANAN, LAMPUNG",1,91,125,216
https://kawalpemilu.org#24629,"BUMI DANA, WAY TUBA, WAY KANAN, LAMPUNG",2,159,50,209
https://kawalpemilu.org#24629,"BUMI DANA, WAY TUBA, WAY KANAN, LAMPUNG",3,155,53,208
https://kawalpemilu.org#24629,"BUMI DANA, WAY TUBA, WAY KANAN, LAMPUNG",4,117,29,146
https://kawalpemilu.org#24630,"BUKIT GEMURUH, WAY TUBA, WAY KANAN, LAMPUNG",1,77,89,166
https://kawalpemilu.org#24630,"BUKIT GEMURUH, WAY TUBA, WAY KANAN, LAMPUNG",3,90,137,227
https://kawalpemilu.org#24630,"BUKIT GEMURUH, WAY TUBA, WAY KANAN, LAMPUNG",4,48,39,87
https://kawalpemilu.org#24630,"BUKIT GEMURUH, WAY TUBA, WAY KANAN, LAMPUNG",6,35,156,191
https://kawalpemilu.org#24630,"BUKIT GEMURUH, WAY TUBA, WAY KANAN, LAMPUNG",7,61,100,161
https://kawalpemilu.org#24631,"WAY MENCAR, WAY TUBA, WAY KANAN, LAMPUNG",2,33,46,79
https://kawalpemilu.org#24631,"WAY MENCAR, WAY TUBA, WAY KANAN, LAMPUNG",3,74,81,155
https://kawalpemilu.org#24632,"WAY PISANG, WAY TUBA, WAY KANAN, LAMPUNG",2,136,72,208
https://kawalpemilu.org#24632,"WAY PISANG, WAY TUBA, WAY KANAN, LAMPUNG",3,105,112,217
https://kawalpemilu.org#24632,"WAY PISANG, WAY TUBA, WAY KANAN, LAMPUNG",4,151,42,193
https://kawalpemilu.org#24633,"BUKIT HARAPAN, WAY TUBA, WAY KANAN, LAMPUNG",1,89,153,242
https://kawalpemilu.org#24633,"BUKIT HARAPAN, WAY TUBA, WAY KANAN, LAMPUNG",2,76,60,136
https://kawalpemilu.org#87239,"WAY TUBA ASRI, WAY TUBA, WAY KANAN, LAMPUNG",1,104,104,208
https://kawalpemilu.org#87239,"WAY TUBA ASRI, WAY TUBA, WAY KANAN, LAMPUNG",2,113,111,224
https://kawalpemilu.org#87239,"WAY TUBA ASRI, WAY TUBA, WAY KANAN, LAMPUNG",3,85,66,151
https://kawalpemilu.org#87239,"WAY TUBA ASRI, WAY TUBA, WAY KANAN, LAMPUNG",4,117,84,201
https://kawalpemilu.org#87239,"WAY TUBA ASRI, WAY TUBA, WAY KANAN, LAMPUNG",5,82,129,211
https://kawalpemilu.org#87239,"WAY TUBA ASRI, WAY TUBA, WAY KANAN, LAMPUNG",6,111,99,210
https://kawalpemilu.org#87239,"WAY TUBA ASRI, WAY TUBA, WAY KANAN, LAMPUNG",7,54,86,140
https://kawalpemilu.org#87239,"WAY TUBA ASRI, WAY TUBA, WAY KANAN, LAMPUNG",8,98,89,187
https://kawalpemilu.org#24635,"LEBAK PENIANGAN, REBANG TANGKAS, WAY KANAN, LAMPUNG",1,64,76,140
https://kawalpemilu.org#24635,"LEBAK PENIANGAN, REBANG TANGKAS, WAY KANAN, LAMPUNG",2,129,60,189
https://kawalpemilu.org#24635,"LEBAK PENIANGAN, REBANG TANGKAS, WAY KANAN, LAMPUNG",3,102,128,230
https://kawalpemilu.org#24635,"LEBAK PENIANGAN, REBANG TANGKAS, WAY KANAN, LAMPUNG",4,55,33,88
https://kawalpemilu.org#24635,"LEBAK PENIANGAN, REBANG TANGKAS, WAY KANAN, LAMPUNG",5,117,50,167
https://kawalpemilu.org#24635,"LEBAK PENIANGAN, REBANG TANGKAS, WAY KANAN, LAMPUNG",6,65,50,115
https://kawalpemilu.org#24635,"LEBAK PENIANGAN, REBANG TANGKAS, WAY KANAN, LAMPUNG",7,124,64,188
https://kawalpemilu.org#24635,"LEBAK PENIANGAN, REBANG TANGKAS, WAY KANAN, LAMPUNG",8,75,80,155
https://kawalpemilu.org#24635,"LEBAK PENIANGAN, REBANG TANGKAS, WAY KANAN, LAMPUNG",9,91,40,131
https://kawalpemilu.org#24635,"LEBAK PENIANGAN, REBANG TANGKAS, WAY KANAN, LAMPUNG",10,103,81,184
https://kawalpemilu.org#24635,"LEBAK PENIANGAN, REBANG TANGKAS, WAY KANAN, LAMPUNG",11,105,71,176
https://kawalpemilu.org#24635,"LEBAK PENIANGAN, REBANG TANGKAS, WAY KANAN, LAMPUNG",12,81,69,150
https://kawalpemilu.org#24635,"LEBAK PENIANGAN, REBANG TANGKAS, WAY KANAN, LAMPUNG",13,108,30,138
https://kawalpemilu.org#24635,"LEBAK PENIANGAN, REBANG TANGKAS, WAY KANAN, LAMPUNG",14,144,19,163
https://kawalpemilu.org#24636,"TANJUNG TIGA, REBANG TANGKAS, WAY KANAN, LAMPUNG",1,132,58,190
https://kawalpemilu.org#24636,"TANJUNG TIGA, REBANG TANGKAS, WAY KANAN, LAMPUNG",2,129,38,167
https://kawalpemilu.org#24636,"TANJUNG TIGA, REBANG TANGKAS, WAY KANAN, LAMPUNG",3,40,106,146
https://kawalpemilu.org#24636,"TANJUNG TIGA, REBANG TANGKAS, WAY KANAN, LAMPUNG",4,105,115,220
https://kawalpemilu.org#24636,"TANJUNG TIGA, REBANG TANGKAS, WAY KANAN, LAMPUNG",5,48,144,192
https://kawalpemilu.org#24636,"TANJUNG TIGA, REBANG TANGKAS, WAY KANAN, LAMPUNG",6,64,77,141
https://kawalpemilu.org#24636,"TANJUNG TIGA, REBANG TANGKAS, WAY KANAN, LAMPUNG",7,41,69,110
https://kawalpemilu.org#24636,"TANJUNG TIGA, REBANG TANGKAS, WAY KANAN, LAMPUNG",8,129,111,240
https://kawalpemilu.org#24637,"MADANG JAYA, REBANG TANGKAS, WAY KANAN, LAMPUNG",1,153,111,264
https://kawalpemilu.org#24637,"MADANG JAYA, REBANG TANGKAS, WAY KANAN, LAMPUNG",2,114,53,167
https://kawalpemilu.org#24637,"MADANG JAYA, REBANG TANGKAS, WAY KANAN, LAMPUNG",3,55,132,187
https://kawalpemilu.org#24637,"MADANG JAYA, REBANG TANGKAS, WAY KANAN, LAMPUNG",4,65,43,108
https://kawalpemilu.org#24638,"AIR RINGKIH, REBANG TANGKAS, WAY KANAN, LAMPUNG",1,179,62,241
https://kawalpemilu.org#24638,"AIR RINGKIH, REBANG TANGKAS, WAY KANAN, LAMPUNG",2,149,82,231
https://kawalpemilu.org#24638,"AIR RINGKIH, REBANG TANGKAS, WAY KANAN, LAMPUNG",3,134,93,227
https://kawalpemilu.org#24638,"AIR RINGKIH, REBANG TANGKAS, WAY KANAN, LAMPUNG",5,55,173,228
https://kawalpemilu.org#24638,"AIR RINGKIH, REBANG TANGKAS, WAY KANAN, LAMPUNG",6,88,74,162
https://kawalpemilu.org#24638,"AIR RINGKIH, REBANG TANGKAS, WAY KANAN, LAMPUNG",7,81,102,183
https://kawalpemilu.org#24638,"AIR RINGKIH, REBANG TANGKAS, WAY KANAN, LAMPUNG",8,74,82,156
https://kawalpemilu.org#24638,"AIR RINGKIH, REBANG TANGKAS, WAY KANAN, LAMPUNG",9,89,45,134
https://kawalpemilu.org#24639,"GUNUNG SARI, REBANG TANGKAS, WAY KANAN, LAMPUNG",1,111,119,230
https://kawalpemilu.org#24639,"GUNUNG SARI, REBANG TANGKAS, WAY KANAN, LAMPUNG",2,133,105,238
https://kawalpemilu.org#24639,"GUNUNG SARI, REBANG TANGKAS, WAY KANAN, LAMPUNG",3,98,71,169
https://kawalpemilu.org#24639,"GUNUNG SARI, REBANG TANGKAS, WAY KANAN, LAMPUNG",4,121,49,170
https://kawalpemilu.org#24639,"GUNUNG SARI, REBANG TANGKAS, WAY KANAN, LAMPUNG",5,79,164,243
https://kawalpemilu.org#24639,"GUNUNG SARI, REBANG TANGKAS, WAY KANAN, LAMPUNG",6,22,89,111
https://kawalpemilu.org#24639,"GUNUNG SARI, REBANG TANGKAS, WAY KANAN, LAMPUNG",7,58,31,89
https://kawalpemilu.org#24640,"SIMPANG TIGA, REBANG TANGKAS, WAY KANAN, LAMPUNG",1,47,174,221
https://kawalpemilu.org#24640,"SIMPANG TIGA, REBANG TANGKAS, WAY KANAN, LAMPUNG",2,124,33,157
https://kawalpemilu.org#24640,"SIMPANG TIGA, REBANG TANGKAS, WAY KANAN, LAMPUNG",3,147,84,231
https://kawalpemilu.org#24640,"SIMPANG TIGA, REBANG TANGKAS, WAY KANAN, LAMPUNG",4,74,90,164
https://kawalpemilu.org#24640,"SIMPANG TIGA, REBANG TANGKAS, WAY KANAN, LAMPUNG",5,23,61,134
https://kawalpemilu.org#24640,"SIMPANG TIGA, REBANG TANGKAS, WAY KANAN, LAMPUNG",6,151,52,203
https://kawalpemilu.org#24640,"SIMPANG TIGA, REBANG TANGKAS, WAY KANAN, LAMPUNG",7,114,59,173
https://kawalpemilu.org#24640,"SIMPANG TIGA, REBANG TANGKAS, WAY KANAN, LAMPUNG",8,43,60,103
https://kawalpemilu.org#24640,"SIMPANG TIGA, REBANG TANGKAS, WAY KANAN, LAMPUNG",9,72,52,124
https://kawalpemilu.org#24640,"SIMPANG TIGA, REBANG TANGKAS, WAY KANAN, LAMPUNG",10,65,57,122
https://kawalpemilu.org#24641,"TANJUNG RAYA, REBANG TANGKAS, WAY KANAN, LAMPUNG",1,62,141,203
https://kawalpemilu.org#24641,"TANJUNG RAYA, REBANG TANGKAS, WAY KANAN, LAMPUNG",2,89,124,213
https://kawalpemilu.org#24641,"TANJUNG RAYA, REBANG TANGKAS, WAY KANAN, LAMPUNG",3,108,51,159
https://kawalpemilu.org#24641,"TANJUNG RAYA, REBANG TANGKAS, WAY KANAN, LAMPUNG",4,74,30,104
https://kawalpemilu.org#24641,"TANJUNG RAYA, REBANG TANGKAS, WAY KANAN, LAMPUNG",5,50,75,125
https://kawalpemilu.org#24641,"TANJUNG RAYA, REBANG TANGKAS, WAY KANAN, LAMPUNG",6,106,27,133
https://kawalpemilu.org#24642,"BERINGIN JAYA, REBANG TANGKAS, WAY KANAN, LAMPUNG",2,67,112,179
https://kawalpemilu.org#24642,"BERINGIN JAYA, REBANG TANGKAS, WAY KANAN, LAMPUNG",3,54,62,116
https://kawalpemilu.org#24642,"BERINGIN JAYA, REBANG TANGKAS, WAY KANAN, LAMPUNG",4,38,104,142
https://kawalpemilu.org#24642,"BERINGIN JAYA, REBANG TANGKAS, WAY KANAN, LAMPUNG",5,164,96,160
https://kawalpemilu.org#24642,"BERINGIN JAYA, REBANG TANGKAS, WAY KANAN, LAMPUNG",6,136,49,185
https://kawalpemilu.org#24643,"KARYA MAJU, REBANG TANGKAS, WAY KANAN, LAMPUNG",1,91,87,178
https://kawalpemilu.org#24643,"KARYA MAJU, REBANG TANGKAS, WAY KANAN, LAMPUNG",2,109,89,198
https://kawalpemilu.org#24643,"KARYA MAJU, REBANG TANGKAS, WAY KANAN, LAMPUNG",3,95,9,104
https://kawalpemilu.org#24643,"KARYA MAJU, REBANG TANGKAS, WAY KANAN, LAMPUNG",4,37,39,76
https://kawalpemilu.org#24644,"MULYA JAYA, REBANG TANGKAS, WAY KANAN, LAMPUNG",1,50,132,182
https://kawalpemilu.org#24644,"MULYA JAYA, REBANG TANGKAS, WAY KANAN, LAMPUNG",2,144,80,224
https://kawalpemilu.org#24644,"MULYA JAYA, REBANG TANGKAS, WAY KANAN, LAMPUNG",4,119,125,244
https://kawalpemilu.org#24644,"MULYA JAYA, REBANG TANGKAS, WAY KANAN, LAMPUNG",5,105,118,223
https://kawalpemilu.org#24646,"GUNUNG LABUHAN, GUNUNG LABUHAN, WAY KANAN, LAMPUNG",1,37,138,175
https://kawalpemilu.org#24646,"GUNUNG LABUHAN, GUNUNG LABUHAN, WAY KANAN, LAMPUNG",2,45,107,152
https://kawalpemilu.org#24646,"GUNUNG LABUHAN, GUNUNG LABUHAN, WAY KANAN, LAMPUNG",3,47,165,212
https://kawalpemilu.org#24646,"GUNUNG LABUHAN, GUNUNG LABUHAN, WAY KANAN, LAMPUNG",4,34,175,209
https://kawalpemilu.org#24646,"GUNUNG LABUHAN, GUNUNG LABUHAN, WAY KANAN, LAMPUNG",5,40,93,133
https://kawalpemilu.org#24646,"GUNUNG LABUHAN, GUNUNG LABUHAN, WAY KANAN, LAMPUNG",6,41,118,159
https://kawalpemilu.org#24646,"GUNUNG LABUHAN, GUNUNG LABUHAN, WAY KANAN, LAMPUNG",7,108,61,169
https://kawalpemilu.org#24646,"GUNUNG LABUHAN, GUNUNG LABUHAN, WAY KANAN, LAMPUNG",8,40,173,4
https://kawalpemilu.org#24646,"GUNUNG LABUHAN, GUNUNG LABUHAN, WAY KANAN, LAMPUNG",9,29,142,171
https://kawalpemilu.org#24646,"GUNUNG LABUHAN, GUNUNG LABUHAN, WAY KANAN, LAMPUNG",10,41,77,118
https://kawalpemilu.org#24647,"GUNUNG BARU, GUNUNG LABUHAN, WAY KANAN, LAMPUNG",1,52,160,212
https://kawalpemilu.org#24647,"GUNUNG BARU, GUNUNG LABUHAN, WAY KANAN, LAMPUNG",2,39,141,180
https://kawalpemilu.org#24647,"GUNUNG BARU, GUNUNG LABUHAN, WAY KANAN, LAMPUNG",3,56,106,162
https://kawalpemilu.org#24648,"BANJAR SAKTI, GUNUNG LABUHAN, WAY KANAN, LAMPUNG",1,64,114,178
https://kawalpemilu.org#24648,"BANJAR SAKTI, GUNUNG LABUHAN, WAY KANAN, LAMPUNG",2,52,92,144
https://kawalpemilu.org#24648,"BANJAR SAKTI, GUNUNG LABUHAN, WAY KANAN, LAMPUNG",3,28,103,131
https://kawalpemilu.org#24649,"SUKA NEGERI, GUNUNG LABUHAN, WAY KANAN, LAMPUNG",1,72,123,195
https://kawalpemilu.org#24649,"SUKA NEGERI, GUNUNG LABUHAN, WAY KANAN, LAMPUNG",2,131,91,222
https://kawalpemilu.org#24649,"SUKA NEGERI, GUNUNG LABUHAN, WAY KANAN, LAMPUNG",3,54,142,196
https://kawalpemilu.org#24649,"SUKA NEGERI, GUNUNG LABUHAN, WAY KANAN, LAMPUNG",4,64,96,160
https://kawalpemilu.org#24649,"SUKA NEGERI, GUNUNG LABUHAN, WAY KANAN, LAMPUNG",5,40,124,164
https://kawalpemilu.org#24649,"SUKA NEGERI, GUNUNG LABUHAN, WAY KANAN, LAMPUNG",6,28,60,88
https://kawalpemilu.org#24649,"SUKA NEGERI, GUNUNG LABUHAN, WAY KANAN, LAMPUNG",7,109,79,188
https://kawalpemilu.org#24649,"SUKA NEGERI, GUNUNG LABUHAN, WAY KANAN, LAMPUNG",8,23,75,98
https://kawalpemilu.org#24649,"SUKA NEGERI, GUNUNG LABUHAN, WAY KANAN, LAMPUNG",9,53,53,106
https://kawalpemilu.org#24649,"SUKA NEGERI, GUNUNG LABUHAN, WAY KANAN, LAMPUNG",10,55,76,131
https://kawalpemilu.org#24650,"NEGERI MULYO, GUNUNG LABUHAN, WAY KANAN, LAMPUNG",1,93,120,213
https://kawalpemilu.org#24650,"NEGERI MULYO, GUNUNG LABUHAN, WAY KANAN, LAMPUNG",3,64,49,113
https://kawalpemilu.org#24650,"NEGERI MULYO, GUNUNG LABUHAN, WAY KANAN, LAMPUNG",4,57,46,103
https://kawalpemilu.org#24651,"NEGERI SUNGKAI, GUNUNG LABUHAN, WAY KANAN, LAMPUNG",1,35,161,196
https://kawalpemilu.org#24651,"NEGERI SUNGKAI, GUNUNG LABUHAN, WAY KANAN, LAMPUNG",3,24,86,110
https://kawalpemilu.org#24652,"GUNUNG SARI, GUNUNG LABUHAN, WAY KANAN, LAMPUNG",1,49,86,135
https://kawalpemilu.org#24652,"GUNUNG SARI, GUNUNG LABUHAN, WAY KANAN, LAMPUNG",2,27,95,122
https://kawalpemilu.org#24652,"GUNUNG SARI, GUNUNG LABUHAN, WAY KANAN, LAMPUNG",3,66,91,157
https://kawalpemilu.org#24652,"GUNUNG SARI, GUNUNG LABUHAN, WAY KANAN, LAMPUNG",4,28,93,121
https://kawalpemilu.org#24653,"WAY TUBA, GUNUNG LABUHAN, WAY KANAN, LAMPUNG",1,83,74,157
https://kawalpemilu.org#24653,"WAY TUBA, GUNUNG LABUHAN, WAY KANAN, LAMPUNG",2,82,113,195
https://kawalpemilu.org#24653,"WAY TUBA, GUNUNG LABUHAN, WAY KANAN, LAMPUNG",3,59,84,143
https://kawalpemilu.org#24653,"WAY TUBA, GUNUNG LABUHAN, WAY KANAN, LAMPUNG",4,35,165,200
https://kawalpemilu.org#24654,"BENGKULU, GUNUNG LABUHAN, WAY KANAN, LAMPUNG",1,80,113,193
https://kawalpemilu.org#24654,"BENGKULU, GUNUNG LABUHAN, WAY KANAN, LAMPUNG",2,50,102,152
https://kawalpemilu.org#24654,"BENGKULU, GUNUNG LABUHAN, WAY KANAN, LAMPUNG",3,41,87,128
https://kawalpemilu.org#24654,"BENGKULU, GUNUNG LABUHAN, WAY KANAN, LAMPUNG",4,123,74,197
https://kawalpemilu.org#24654,"BENGKULU, GUNUNG LABUHAN, WAY KANAN, LAMPUNG",5,49,157,206
https://kawalpemilu.org#24654,"BENGKULU, GUNUNG LABUHAN, WAY KANAN, LAMPUNG",6,84,70,154
https://kawalpemilu.org#24654,"BENGKULU, GUNUNG LABUHAN, WAY KANAN, LAMPUNG",7,61,92,153
https://kawalpemilu.org#24654,"BENGKULU, GUNUNG LABUHAN, WAY KANAN, LAMPUNG",8,40,82,122
https://kawalpemilu.org#24654,"BENGKULU, GUNUNG LABUHAN, WAY KANAN, LAMPUNG",9,62,98,160
https://kawalpemilu.org#24654,"BENGKULU, GUNUNG LABUHAN, WAY KANAN, LAMPUNG",10,59,142,201
https://kawalpemilu.org#24655,"BENGKULU REJO, GUNUNG LABUHAN, WAY KANAN, LAMPUNG",1,70,92,162
https://kawalpemilu.org#24655,"BENGKULU REJO, GUNUNG LABUHAN, WAY KANAN, LAMPUNG",2,51,131,182
https://kawalpemilu.org#24655,"BENGKULU REJO, GUNUNG LABUHAN, WAY KANAN, LAMPUNG",3,45,64,109
https://kawalpemilu.org#24655,"BENGKULU REJO, GUNUNG LABUHAN, WAY KANAN, LAMPUNG",4,110,92,202
https://kawalpemilu.org#24655,"BENGKULU REJO, GUNUNG LABUHAN, WAY KANAN, LAMPUNG",5,14,146,160
https://kawalpemilu.org#24655,"BENGKULU REJO, GUNUNG LABUHAN, WAY KANAN, LAMPUNG",6,12,84,96
https://kawalpemilu.org#24656,"KAYU BATU, GUNUNG LABUHAN, WAY KANAN, LAMPUNG",1,16,152,168
https://kawalpemilu.org#24656,"KAYU BATU, GUNUNG LABUHAN, WAY KANAN, LAMPUNG",2,47,162,209
https://kawalpemilu.org#24656,"KAYU BATU, GUNUNG LABUHAN, WAY KANAN, LAMPUNG",3,17,133,150
https://kawalpemilu.org#24657,"BENGKULU RAMAN, GUNUNG LABUHAN, WAY KANAN, LAMPUNG",1,68,88,156
https://kawalpemilu.org#24657,"BENGKULU RAMAN, GUNUNG LABUHAN, WAY KANAN, LAMPUNG",2,40,167,207
https://kawalpemilu.org#24657,"BENGKULU RAMAN, GUNUNG LABUHAN, WAY KANAN, LAMPUNG",3,27,60,87
https://kawalpemilu.org#24658,"BENGKULU JAYA, GUNUNG LABUHAN, WAY KANAN, LAMPUNG",1,40,175,215
https://kawalpemilu.org#24658,"BENGKULU JAYA, GUNUNG LABUHAN, WAY KANAN, LAMPUNG",2,58,115,173
https://kawalpemilu.org#24658,"BENGKULU JAYA, GUNUNG LABUHAN, WAY KANAN, LAMPUNG",3,36,148,184
https://kawalpemilu.org#24658,"BENGKULU JAYA, GUNUNG LABUHAN, WAY KANAN, LAMPUNG",4,54,61,115
https://kawalpemilu.org#24659,"TIUH BALAK II, GUNUNG LABUHAN, WAY KANAN, LAMPUNG",1,33,153,186
https://kawalpemilu.org#24659,"TIUH BALAK II, GUNUNG LABUHAN, WAY KANAN, LAMPUNG",2,54,112,166
https://kawalpemilu.org#24659,"TIUH BALAK II, GUNUNG LABUHAN, WAY KANAN, LAMPUNG",3,18,121,139
https://kawalpemilu.org#24659,"TIUH BALAK II, GUNUNG LABUHAN, WAY KANAN, LAMPUNG",4,67,43,110
https://kawalpemilu.org#24660,"CURUP PATAH, GUNUNG LABUHAN, WAY KANAN, LAMPUNG",1,25,151,176
https://kawalpemilu.org#24660,"CURUP PATAH, GUNUNG LABUHAN, WAY KANAN, LAMPUNG",2,23,166,189
https://kawalpemilu.org#24660,"CURUP PATAH, GUNUNG LABUHAN, WAY KANAN, LAMPUNG",3,32,140,172
https://kawalpemilu.org#24660,"CURUP PATAH, GUNUNG LABUHAN, WAY KANAN, LAMPUNG",4,48,114,162
https://kawalpemilu.org#24661,"SUKA RAME, GUNUNG LABUHAN, WAY KANAN, LAMPUNG",2,41,99,140
https://kawalpemilu.org#24661,"SUKA RAME, GUNUNG LABUHAN, WAY KANAN, LAMPUNG",3,18,119,137
https://kawalpemilu.org#24661,"SUKA RAME, GUNUNG LABUHAN, WAY KANAN, LAMPUNG",4,22,109,131
https://kawalpemilu.org#24661,"SUKA RAME, GUNUNG LABUHAN, WAY KANAN, LAMPUNG",5,65,83,148
https://kawalpemilu.org#24661,"SUKA RAME, GUNUNG LABUHAN, WAY KANAN, LAMPUNG",6,19,111,130
https://kawalpemilu.org#24662,"BANJAR RATU, GUNUNG LABUHAN, WAY KANAN, LAMPUNG",1,96,119,215
https://kawalpemilu.org#24662,"BANJAR RATU, GUNUNG LABUHAN, WAY KANAN, LAMPUNG",3,50,103,153
https://kawalpemilu.org#24662,"BANJAR RATU, GUNUNG LABUHAN, WAY KANAN, LAMPUNG",5,34,117,151
https://kawalpemilu.org#24662,"BANJAR RATU, GUNUNG LABUHAN, WAY KANAN, LAMPUNG",6,111,92,203
https://kawalpemilu.org#24662,"BANJAR RATU, GUNUNG LABUHAN, WAY KANAN, LAMPUNG",8,58,101,159
https://kawalpemilu.org#24663,"NEGERI UJAN MAS, GUNUNG LABUHAN, WAY KANAN, LAMPUNG",1,112,101,213
https://kawalpemilu.org#24663,"NEGERI UJAN MAS, GUNUNG LABUHAN, WAY KANAN, LAMPUNG",2,102,106,208
https://kawalpemilu.org#24663,"NEGERI UJAN MAS, GUNUNG LABUHAN, WAY KANAN, LAMPUNG",3,39,46,85
https://kawalpemilu.org#24664,"BENGKULU TENGAH, GUNUNG LABUHAN, WAY KANAN, LAMPUNG",1,38,164,202
https://kawalpemilu.org#24664,"BENGKULU TENGAH, GUNUNG LABUHAN, WAY KANAN, LAMPUNG",2,67,154,221
https://kawalpemilu.org#24664,"BENGKULU TENGAH, GUNUNG LABUHAN, WAY KANAN, LAMPUNG",3,21,83,104
https://kawalpemilu.org#24664,"BENGKULU TENGAH, GUNUNG LABUHAN, WAY KANAN, LAMPUNG",4,26,97,123
https://kawalpemilu.org#87242,"GUNUNGPEKUWON, GUNUNG LABUHAN, WAY KANAN, LAMPUNG",1,36,73,109
https://kawalpemilu.org#87242,"GUNUNGPEKUWON, GUNUNG LABUHAN, WAY KANAN, LAMPUNG",2,45,60,105
https://kawalpemilu.org#87243,"LABUHAN JAYA, GUNUNG LABUHAN, WAY KANAN, LAMPUNG",1,39,70,109
https://kawalpemilu.org#87243,"LABUHAN JAYA, GUNUNG LABUHAN, WAY KANAN, LAMPUNG",2,71,85,156
https://kawalpemilu.org#87243,"LABUHAN JAYA, GUNUNG LABUHAN, WAY KANAN, LAMPUNG",3,49,114,163
https://kawalpemilu.org#24666,"NEGARA BATIN, NEGARA BATIN, WAY KANAN, LAMPUNG",1,166,76,242
https://kawalpemilu.org#24666,"NEGARA BATIN, NEGARA BATIN, WAY KANAN, LAMPUNG",2,81,59,140
https://kawalpemilu.org#24666,"NEGARA BATIN, NEGARA BATIN, WAY KANAN, LAMPUNG",3,115,37,152
https://kawalpemilu.org#24666,"NEGARA BATIN, NEGARA BATIN, WAY KANAN, LAMPUNG",4,165,31,196
https://kawalpemilu.org#24666,"NEGARA BATIN, NEGARA BATIN, WAY KANAN, LAMPUNG",5,191,76,267
https://kawalpemilu.org#24666,"NEGARA BATIN, NEGARA BATIN, WAY KANAN, LAMPUNG",6,84,58,142
https://kawalpemilu.org#24666,"NEGARA BATIN, NEGARA BATIN, WAY KANAN, LAMPUNG",8,99,19,118
https://kawalpemilu.org#24667,"PURWA AGUNG, NEGARA BATIN, WAY KANAN, LAMPUNG",1,181,44,225
https://kawalpemilu.org#24667,"PURWA AGUNG, NEGARA BATIN, WAY KANAN, LAMPUNG",2,167,19,186
https://kawalpemilu.org#24667,"PURWA AGUNG, NEGARA BATIN, WAY KANAN, LAMPUNG",3,123,40,163
https://kawalpemilu.org#24667,"PURWA AGUNG, NEGARA BATIN, WAY KANAN, LAMPUNG",4,142,40,182
https://kawalpemilu.org#24667,"PURWA AGUNG, NEGARA BATIN, WAY KANAN, LAMPUNG",5,148,27,175
https://kawalpemilu.org#24667,"PURWA AGUNG, NEGARA BATIN, WAY KANAN, LAMPUNG",6,134,17,151
https://kawalpemilu.org#24667,"PURWA AGUNG, NEGARA BATIN, WAY KANAN, LAMPUNG",7,159,51,210
https://kawalpemilu.org#24667,"PURWA AGUNG, NEGARA BATIN, WAY KANAN, LAMPUNG",8,162,11,173
https://kawalpemilu.org#24667,"PURWA AGUNG, NEGARA BATIN, WAY KANAN, LAMPUNG",9,100,25,125
https://kawalpemilu.org#24667,"PURWA AGUNG, NEGARA BATIN, WAY KANAN, LAMPUNG",10,197,33,230
https://kawalpemilu.org#24667,"PURWA AGUNG, NEGARA BATIN, WAY KANAN, LAMPUNG",11,141,15,156
https://kawalpemilu.org#24667,"PURWA AGUNG, NEGARA BATIN, WAY KANAN, LAMPUNG",12,139,13,152
https://kawalpemilu.org#24668,"PURWA NEGARA, NEGARA BATIN, WAY KANAN, LAMPUNG",1,165,35,200
https://kawalpemilu.org#24668,"PURWA NEGARA, NEGARA BATIN, WAY KANAN, LAMPUNG",2,115,58,173
https://kawalpemilu.org#24668,"PURWA NEGARA, NEGARA BATIN, WAY KANAN, LAMPUNG",3,155,57,212
https://kawalpemilu.org#24668,"PURWA NEGARA, NEGARA BATIN, WAY KANAN, LAMPUNG",4,163,25,188
https://kawalpemilu.org#24668,"PURWA NEGARA, NEGARA BATIN, WAY KANAN, LAMPUNG",5,121,62,183
https://kawalpemilu.org#24668,"PURWA NEGARA, NEGARA BATIN, WAY KANAN, LAMPUNG",6,141,37,178
https://kawalpemilu.org#24668,"PURWA NEGARA, NEGARA BATIN, WAY KANAN, LAMPUNG",7,180,41,221
https://kawalpemilu.org#24668,"PURWA NEGARA, NEGARA BATIN, WAY KANAN, LAMPUNG",8,115,63,178
https://kawalpemilu.org#24668,"PURWA NEGARA, NEGARA BATIN, WAY KANAN, LAMPUNG",9,134,20,154
https://kawalpemilu.org#24668,"PURWA NEGARA, NEGARA BATIN, WAY KANAN, LAMPUNG",10,186,22,208
https://kawalpemilu.org#24668,"PURWA NEGARA, NEGARA BATIN, WAY KANAN, LAMPUNG",11,179,15,194
https://kawalpemilu.org#24668,"PURWA NEGARA, NEGARA BATIN, WAY KANAN, LAMPUNG",12,180,29,209
https://kawalpemilu.org#24669,"SETIA NEGARA, NEGARA BATIN, WAY KANAN, LAMPUNG",1,119,41,160
https://kawalpemilu.org#24669,"SETIA NEGARA, NEGARA BATIN, WAY KANAN, LAMPUNG",2,162,40,202
https://kawalpemilu.org#24669,"SETIA NEGARA, NEGARA BATIN, WAY KANAN, LAMPUNG",3,141,24,165
https://kawalpemilu.org#24669,"SETIA NEGARA, NEGARA BATIN, WAY KANAN, LAMPUNG",4,137,21,158
https://kawalpemilu.org#24669,"SETIA NEGARA, NEGARA BATIN, WAY KANAN, LAMPUNG",5,161,17,178
https://kawalpemilu.org#24669,"SETIA NEGARA, NEGARA BATIN, WAY KANAN, LAMPUNG",6,121,10,131
https://kawalpemilu.org#24669,"SETIA NEGARA, NEGARA BATIN, WAY KANAN, LAMPUNG",7,155,32,187
https://kawalpemilu.org#24669,"SETIA NEGARA, NEGARA BATIN, WAY KANAN, LAMPUNG",8,157,18,175
https://kawalpemilu.org#24670,"SRI MULYO, NEGARA BATIN, WAY KANAN, LAMPUNG",1,128,35,163
https://kawalpemilu.org#24670,"SRI MULYO, NEGARA BATIN, WAY KANAN, LAMPUNG",2,124,26,6
https://kawalpemilu.org#24670,"SRI MULYO, NEGARA BATIN, WAY KANAN, LAMPUNG",3,130,34,164
https://kawalpemilu.org#24670,"SRI MULYO, NEGARA BATIN, WAY KANAN, LAMPUNG",4,118,41,159
https://kawalpemilu.org#24670,"SRI MULYO, NEGARA BATIN, WAY KANAN, LAMPUNG",5,132,25,157
https://kawalpemilu.org#24670,"SRI MULYO, NEGARA BATIN, WAY KANAN, LAMPUNG",6,136,32,168
https://kawalpemilu.org#24670,"SRI MULYO, NEGARA BATIN, WAY KANAN, LAMPUNG",7,112,55,167
https://kawalpemilu.org#24670,"SRI MULYO, NEGARA BATIN, WAY KANAN, LAMPUNG",8,105,43,148
https://kawalpemilu.org#24671,"SRI MENANTI, NEGARA BATIN, WAY KANAN, LAMPUNG",1,49,58,107
https://kawalpemilu.org#24671,"SRI MENANTI, NEGARA BATIN, WAY KANAN, LAMPUNG",2,29,42,71
https://kawalpemilu.org#24671,"SRI MENANTI, NEGARA BATIN, WAY KANAN, LAMPUNG",3,38,76,114
https://kawalpemilu.org#24671,"SRI MENANTI, NEGARA BATIN, WAY KANAN, LAMPUNG",4,32,45,77
https://kawalpemilu.org#24672,"KARTA JAYA, NEGARA BATIN, WAY KANAN, LAMPUNG",1,63,60,123
https://kawalpemilu.org#24672,"KARTA JAYA, NEGARA BATIN, WAY KANAN, LAMPUNG",2,46,57,103
https://kawalpemilu.org#24672,"KARTA JAYA, NEGARA BATIN, WAY KANAN, LAMPUNG",3,43,68,111
https://kawalpemilu.org#24672,"KARTA JAYA, NEGARA BATIN, WAY KANAN, LAMPUNG",4,59,83,142
https://kawalpemilu.org#24673,"GISTING JAYA, NEGARA BATIN, WAY KANAN, LAMPUNG",1,149,18,167
https://kawalpemilu.org#24673,"GISTING JAYA, NEGARA BATIN, WAY KANAN, LAMPUNG",2,172,20,192
https://kawalpemilu.org#24673,"GISTING JAYA, NEGARA BATIN, WAY KANAN, LAMPUNG",3,198,24,222
https://kawalpemilu.org#24673,"GISTING JAYA, NEGARA BATIN, WAY KANAN, LAMPUNG",4,177,9,186
https://kawalpemilu.org#24673,"GISTING JAYA, NEGARA BATIN, WAY KANAN, LAMPUNG",5,158,24,182
https://kawalpemilu.org#24673,"GISTING JAYA, NEGARA BATIN, WAY KANAN, LAMPUNG",6,165,17,182
https://kawalpemilu.org#24673,"GISTING JAYA, NEGARA BATIN, WAY KANAN, LAMPUNG",7,152,10,162
https://kawalpemilu.org#24673,"GISTING JAYA, NEGARA BATIN, WAY KANAN, LAMPUNG",8,147,19,166
https://kawalpemilu.org#24673,"GISTING JAYA, NEGARA BATIN, WAY KANAN, LAMPUNG",9,181,13,194
https://kawalpemilu.org#24673,"GISTING JAYA, NEGARA BATIN, WAY KANAN, LAMPUNG",10,173,18,191
https://kawalpemilu.org#24673,"GISTING JAYA, NEGARA BATIN, WAY KANAN, LAMPUNG",11,160,27,187
https://kawalpemilu.org#24673,"GISTING JAYA, NEGARA BATIN, WAY KANAN, LAMPUNG",12,181,20,201
https://kawalpemilu.org#24674,"MARGA JAYA, NEGARA BATIN, WAY KANAN, LAMPUNG",1,160,44,204
https://kawalpemilu.org#24674,"MARGA JAYA, NEGARA BATIN, WAY KANAN, LAMPUNG",2,206,25,231
https://kawalpemilu.org#24674,"MARGA JAYA, NEGARA BATIN, WAY KANAN, LAMPUNG",3,112,29,141
https://kawalpemilu.org#24674,"MARGA JAYA, NEGARA BATIN, WAY KANAN, LAMPUNG",4,162,42,204
https://kawalpemilu.org#24674,"MARGA JAYA, NEGARA BATIN, WAY KANAN, LAMPUNG",5,183,50,233
https://kawalpemilu.org#24674,"MARGA JAYA, NEGARA BATIN, WAY KANAN, LAMPUNG",6,123,39,162
https://kawalpemilu.org#24675,"BUMI JAYA, NEGARA BATIN, WAY KANAN, LAMPUNG",1,118,62,180
https://kawalpemilu.org#24675,"BUMI JAYA, NEGARA BATIN, WAY KANAN, LAMPUNG",2,162,33,195
https://kawalpemilu.org#24675,"BUMI JAYA, NEGARA BATIN, WAY KANAN, LAMPUNG",3,104,97,201
https://kawalpemilu.org#24675,"BUMI JAYA, NEGARA BATIN, WAY KANAN, LAMPUNG",4,142,57,199
https://kawalpemilu.org#24675,"BUMI JAYA, NEGARA BATIN, WAY KANAN, LAMPUNG",5,141,64,205
https://kawalpemilu.org#24675,"BUMI JAYA, NEGARA BATIN, WAY KANAN, LAMPUNG",6,127,61,188
https://kawalpemilu.org#24675,"BUMI JAYA, NEGARA BATIN, WAY KANAN, LAMPUNG",7,115,39,154
https://kawalpemilu.org#24675,"BUMI JAYA, NEGARA BATIN, WAY KANAN, LAMPUNG",8,122,64,186
https://kawalpemilu.org#24675,"BUMI JAYA, NEGARA BATIN, WAY KANAN, LAMPUNG",9,117,69,186
https://kawalpemilu.org#24675,"BUMI JAYA, NEGARA BATIN, WAY KANAN, LAMPUNG",10,146,28,174
https://kawalpemilu.org#24675,"BUMI JAYA, NEGARA BATIN, WAY KANAN, LAMPUNG",11,133,52,185
https://kawalpemilu.org#24675,"BUMI JAYA, NEGARA BATIN, WAY KANAN, LAMPUNG",12,140,44,184
https://kawalpemilu.org#24676,"GEDUNG JAYA, NEGARA BATIN, WAY KANAN, LAMPUNG",1,115,29,144
https://kawalpemilu.org#24676,"GEDUNG JAYA, NEGARA BATIN, WAY KANAN, LAMPUNG",2,139,35,174
https://kawalpemilu.org#24676,"GEDUNG JAYA, NEGARA BATIN, WAY KANAN, LAMPUNG",3,136,29,165
https://kawalpemilu.org#24676,"GEDUNG JAYA, NEGARA BATIN, WAY KANAN, LAMPUNG",4,117,23,140
https://kawalpemilu.org#24676,"GEDUNG JAYA, NEGARA BATIN, WAY KANAN, LAMPUNG",5,99,29,128
https://kawalpemilu.org#24676,"GEDUNG JAYA, NEGARA BATIN, WAY KANAN, LAMPUNG",6,147,31,178
https://kawalpemilu.org#24676,"GEDUNG JAYA, NEGARA BATIN, WAY KANAN, LAMPUNG",7,139,18,157
https://kawalpemilu.org#24676,"GEDUNG JAYA, NEGARA BATIN, WAY KANAN, LAMPUNG",8,142,19,161
https://kawalpemilu.org#24677,"ADI JAYA, NEGARA BATIN, WAY KANAN, LAMPUNG",1,147,40,187
https://kawalpemilu.org#24677,"ADI JAYA, NEGARA BATIN, WAY KANAN, LAMPUNG",2,133,36,169
https://kawalpemilu.org#24677,"ADI JAYA, NEGARA BATIN, WAY KANAN, LAMPUNG",3,120,77,197
https://kawalpemilu.org#24677,"ADI JAYA, NEGARA BATIN, WAY KANAN, LAMPUNG",4,93,46,139
https://kawalpemilu.org#24677,"ADI JAYA, NEGARA BATIN, WAY KANAN, LAMPUNG",5,85,33,118
https://kawalpemilu.org#24677,"ADI JAYA, NEGARA BATIN, WAY KANAN, LAMPUNG",6,93,79,172
https://kawalpemilu.org#24677,"ADI JAYA, NEGARA BATIN, WAY KANAN, LAMPUNG",8,92,89,181
https://kawalpemilu.org#24677,"ADI JAYA, NEGARA BATIN, WAY KANAN, LAMPUNG",9,95,52,147
https://kawalpemilu.org#24677,"ADI JAYA, NEGARA BATIN, WAY KANAN, LAMPUNG",10,105,11,116
https://kawalpemilu.org#24678,"SARI JAYA, NEGARA BATIN, WAY KANAN, LAMPUNG",1,108,19,127
https://kawalpemilu.org#24678,"SARI JAYA, NEGARA BATIN, WAY KANAN, LAMPUNG",2,103,41,144
https://kawalpemilu.org#24678,"SARI JAYA, NEGARA BATIN, WAY KANAN, LAMPUNG",3,108,16,124
https://kawalpemilu.org#24678,"SARI JAYA, NEGARA BATIN, WAY KANAN, LAMPUNG",4,94,11,105
https://kawalpemilu.org#24679,"NEGARA MULYA, NEGARA BATIN, WAY KANAN, LAMPUNG",1,76,55,131
https://kawalpemilu.org#24679,"NEGARA MULYA, NEGARA BATIN, WAY KANAN, LAMPUNG",2,89,59,148
https://kawalpemilu.org#87246,"KOTA JAWA, NEGARA BATIN, WAY KANAN, LAMPUNG",1,131,20,151
https://kawalpemilu.org#87246,"KOTA JAWA, NEGARA BATIN, WAY KANAN, LAMPUNG",2,100,41,141
https://kawalpemilu.org#87246,"KOTA JAWA, NEGARA BATIN, WAY KANAN, LAMPUNG",3,150,9,159
https://kawalpemilu.org#87246,"KOTA JAWA, NEGARA BATIN, WAY KANAN, LAMPUNG",4,102,28,130
https://kawalpemilu.org#87246,"KOTA JAWA, NEGARA BATIN, WAY KANAN, LAMPUNG",5,91,29,120
https://kawalpemilu.org#87246,"KOTA JAWA, NEGARA BATIN, WAY KANAN, LAMPUNG",6,147,20,167
https://kawalpemilu.org#24681,"NEGERI BESAR, NEGERI BESAR, WAY KANAN, LAMPUNG",1,75,63,138
https://kawalpemilu.org#24681,"NEGERI BESAR, NEGERI BESAR, WAY KANAN, LAMPUNG",2,74,66,140
https://kawalpemilu.org#24681,"NEGERI BESAR, NEGERI BESAR, WAY KANAN, LAMPUNG",3,111,9,120
https://kawalpemilu.org#24681,"NEGERI BESAR, NEGERI BESAR, WAY KANAN, LAMPUNG",4,51,65,116
https://kawalpemilu.org#24681,"NEGERI BESAR, NEGERI BESAR, WAY KANAN, LAMPUNG",5,74,77,151
https://kawalpemilu.org#24682,"KILING-KILING, NEGERI BESAR, WAY KANAN, LAMPUNG",1,56,47,103
https://kawalpemilu.org#24682,"KILING-KILING, NEGERI BESAR, WAY KANAN, LAMPUNG",2,104,61,165
https://kawalpemilu.org#24682,"KILING-KILING, NEGERI BESAR, WAY KANAN, LAMPUNG",3,156,37,193
https://kawalpemilu.org#24682,"KILING-KILING, NEGERI BESAR, WAY KANAN, LAMPUNG",4,47,20,67
https://kawalpemilu.org#24682,"KILING-KILING, NEGERI BESAR, WAY KANAN, LAMPUNG",5,86,51,137
https://kawalpemilu.org#24682,"KILING-KILING, NEGERI BESAR, WAY KANAN, LAMPUNG",6,118,49,167
https://kawalpemilu.org#24683,"KALI AWI, NEGERI BESAR, WAY KANAN, LAMPUNG",1,34,46,80
https://kawalpemilu.org#24683,"KALI AWI, NEGERI BESAR, WAY KANAN, LAMPUNG",2,42,52,94
https://kawalpemilu.org#24683,"KALI AWI, NEGERI BESAR, WAY KANAN, LAMPUNG",3,35,33,68
https://kawalpemilu.org#24683,"KALI AWI, NEGERI BESAR, WAY KANAN, LAMPUNG",4,43,88,131
https://kawalpemilu.org#24684,"TIUH BARU, NEGERI BESAR, WAY KANAN, LAMPUNG",1,39,64,103
https://kawalpemilu.org#24684,"TIUH BARU, NEGERI BESAR, WAY KANAN, LAMPUNG",2,80,37,117
https://kawalpemilu.org#24684,"TIUH BARU, NEGERI BESAR, WAY KANAN, LAMPUNG",3,63,127,190
https://kawalpemilu.org#24685,"BIMA SAKTI, NEGERI BESAR, WAY KANAN, LAMPUNG",1,153,52,205
https://kawalpemilu.org#24685,"BIMA SAKTI, NEGERI BESAR, WAY KANAN, LAMPUNG",2,140,57,197
https://kawalpemilu.org#24685,"BIMA SAKTI, NEGERI BESAR, WAY KANAN, LAMPUNG",3,153,39,192
https://kawalpemilu.org#24685,"BIMA SAKTI, NEGERI BESAR, WAY KANAN, LAMPUNG",4,146,27,173
https://kawalpemilu.org#24685,"BIMA SAKTI, NEGERI BESAR, WAY KANAN, LAMPUNG",5,110,28,138
https://kawalpemilu.org#24685,"BIMA SAKTI, NEGERI BESAR, WAY KANAN, LAMPUNG",6,131,26,157
https://kawalpemilu.org#24685,"BIMA SAKTI, NEGERI BESAR, WAY KANAN, LAMPUNG",7,160,38,198
https://kawalpemilu.org#24685,"BIMA SAKTI, NEGERI BESAR, WAY KANAN, LAMPUNG",8,119,23,142
https://kawalpemilu.org#24686,"TEGAL MUKTI, NEGERI BESAR, WAY KANAN, LAMPUNG",1,161,35,196
https://kawalpemilu.org#24686,"TEGAL MUKTI, NEGERI BESAR, WAY KANAN, LAMPUNG",2,152,34,186
https://kawalpemilu.org#24686,"TEGAL MUKTI, NEGERI BESAR, WAY KANAN, LAMPUNG",3,165,42,207
https://kawalpemilu.org#24686,"TEGAL MUKTI, NEGERI BESAR, WAY KANAN, LAMPUNG",4,149,37,186
https://kawalpemilu.org#24686,"TEGAL MUKTI, NEGERI BESAR, WAY KANAN, LAMPUNG",5,105,30,135
https://kawalpemilu.org#24686,"TEGAL MUKTI, NEGERI BESAR, WAY KANAN, LAMPUNG",6,126,58,184
https://kawalpemilu.org#24686,"TEGAL MUKTI, NEGERI BESAR, WAY KANAN, LAMPUNG",7,130,38,168
https://kawalpemilu.org#24686,"TEGAL MUKTI, NEGERI BESAR, WAY KANAN, LAMPUNG",8,141,34,175
https://kawalpemilu.org#24686,"TEGAL MUKTI, NEGERI BESAR, WAY KANAN, LAMPUNG",9,125,49,174
https://kawalpemilu.org#24686,"TEGAL MUKTI, NEGERI BESAR, WAY KANAN, LAMPUNG",10,99,41,140
https://kawalpemilu.org#24687,"NEGARA JAYA, NEGERI BESAR, WAY KANAN, LAMPUNG",1,128,55,183
https://kawalpemilu.org#24687,"NEGARA JAYA, NEGERI BESAR, WAY KANAN, LAMPUNG",2,129,25,154
https://kawalpemilu.org#24687,"NEGARA JAYA, NEGERI BESAR, WAY KANAN, LAMPUNG",3,134,43,177
https://kawalpemilu.org#24687,"NEGARA JAYA, NEGERI BESAR, WAY KANAN, LAMPUNG",4,120,46,166
https://kawalpemilu.org#24687,"NEGARA JAYA, NEGERI BESAR, WAY KANAN, LAMPUNG",5,108,72,180
https://kawalpemilu.org#24687,"NEGARA JAYA, NEGERI BESAR, WAY KANAN, LAMPUNG",6,102,30,132
https://kawalpemilu.org#24687,"NEGARA JAYA, NEGERI BESAR, WAY KANAN, LAMPUNG",7,139,23,162
https://kawalpemilu.org#24687,"NEGARA JAYA, NEGERI BESAR, WAY KANAN, LAMPUNG",8,140,33,173
https://kawalpemilu.org#24688,"PAGAR IMAN, NEGERI BESAR, WAY KANAN, LAMPUNG",1,100,32,132
https://kawalpemilu.org#24688,"PAGAR IMAN, NEGERI BESAR, WAY KANAN, LAMPUNG",2,120,34,154
https://kawalpemilu.org#24688,"PAGAR IMAN, NEGERI BESAR, WAY KANAN, LAMPUNG",3,84,43,127
https://kawalpemilu.org#24688,"PAGAR IMAN, NEGERI BESAR, WAY KANAN, LAMPUNG",4,105,38,143
https://kawalpemilu.org#24688,"PAGAR IMAN, NEGERI BESAR, WAY KANAN, LAMPUNG",5,118,21,139
https://kawalpemilu.org#24688,"PAGAR IMAN, NEGERI BESAR, WAY KANAN, LAMPUNG",6,125,44,169
https://kawalpemilu.org#24688,"PAGAR IMAN, NEGERI BESAR, WAY KANAN, LAMPUNG",7,72,48,120
https://kawalpemilu.org#24688,"PAGAR IMAN, NEGERI BESAR, WAY KANAN, LAMPUNG",8,109,36,145
https://kawalpemilu.org#24689,"SRI BASUKI, NEGERI BESAR, WAY KANAN, LAMPUNG",1,144,30,174
https://kawalpemilu.org#24689,"SRI BASUKI, NEGERI BESAR, WAY KANAN, LAMPUNG",2,111,44,155
https://kawalpemilu.org#24689,"SRI BASUKI, NEGERI BESAR, WAY KANAN, LAMPUNG",3,129,25,154
https://kawalpemilu.org#24689,"SRI BASUKI, NEGERI BESAR, WAY KANAN, LAMPUNG",4,128,22,150
https://kawalpemilu.org#24689,"SRI BASUKI, NEGERI BESAR, WAY KANAN, LAMPUNG",5,128,37,165
https://kawalpemilu.org#24689,"SRI BASUKI, NEGERI BESAR, WAY KANAN, LAMPUNG",6,100,26,126
https://kawalpemilu.org#24689,"SRI BASUKI, NEGERI BESAR, WAY KANAN, LAMPUNG",7,123,24,147
https://kawalpemilu.org#24689,"SRI BASUKI, NEGERI BESAR, WAY KANAN, LAMPUNG",8,136,24,160
https://kawalpemilu.org#24690,"KALI AWI INDAH, NEGERI BESAR, WAY KANAN, LAMPUNG",1,151,26,177
https://kawalpemilu.org#24690,"KALI AWI INDAH, NEGERI BESAR, WAY KANAN, LAMPUNG",2,137,51,188
https://kawalpemilu.org#87254,"NEGERI JAYA, NEGERI BESAR, WAY KANAN, LAMPUNG",1,126,36,162
https://kawalpemilu.org#87254,"NEGERI JAYA, NEGERI BESAR, WAY KANAN, LAMPUNG",2,130,15,145
https://kawalpemilu.org#87254,"NEGERI JAYA, NEGERI BESAR, WAY KANAN, LAMPUNG",3,143,36,179
https://kawalpemilu.org#87254,"NEGERI JAYA, NEGERI BESAR, WAY KANAN, LAMPUNG",4,90,59,149
https://kawalpemilu.org#87254,"NEGERI JAYA, NEGERI BESAR, WAY KANAN, LAMPUNG",5,142,47,189
https://kawalpemilu.org#87254,"NEGERI JAYA, NEGERI BESAR, WAY KANAN, LAMPUNG",6,108,29,137
https://kawalpemilu.org#87254,"NEGERI JAYA, NEGERI BESAR, WAY KANAN, LAMPUNG",7,119,30,149
https://kawalpemilu.org#87254,"NEGERI JAYA, NEGERI BESAR, WAY KANAN, LAMPUNG",8,94,29,123
https://kawalpemilu.org#87257,"TANJUNGMAS, NEGERI BESAR, WAY KANAN, LAMPUNG",1,184,46,230
https://kawalpemilu.org#87257,"TANJUNGMAS, NEGERI BESAR, WAY KANAN, LAMPUNG",2,183,33,216
https://kawalpemilu.org#87258,"NEGERI KASIH, NEGERI BESAR, WAY KANAN, LAMPUNG",1,137,22,159
https://kawalpemilu.org#24692,"BUMI HARJO, BUAY BAHUGA, WAY KANAN, LAMPUNG",1,35,119,154
https://kawalpemilu.org#24692,"BUMI HARJO, BUAY BAHUGA, WAY KANAN, LAMPUNG",2,63,114,177
https://kawalpemilu.org#24692,"BUMI HARJO, BUAY BAHUGA, WAY KANAN, LAMPUNG",3,64,95,159
https://kawalpemilu.org#24692,"BUMI HARJO, BUAY BAHUGA, WAY KANAN, LAMPUNG",4,89,79,168
https://kawalpemilu.org#24692,"BUMI HARJO, BUAY BAHUGA, WAY KANAN, LAMPUNG",5,74,119,193
https://kawalpemilu.org#24692,"BUMI HARJO, BUAY BAHUGA, WAY KANAN, LAMPUNG",6,86,83,169
https://kawalpemilu.org#24692,"BUMI HARJO, BUAY BAHUGA, WAY KANAN, LAMPUNG",7,59,95,154
https://kawalpemilu.org#24692,"BUMI HARJO, BUAY BAHUGA, WAY KANAN, LAMPUNG",8,66,80,146
https://kawalpemilu.org#24692,"BUMI HARJO, BUAY BAHUGA, WAY KANAN, LAMPUNG",9,65,84,149
https://kawalpemilu.org#24692,"BUMI HARJO, BUAY BAHUGA, WAY KANAN, LAMPUNG",10,67,136,203
https://kawalpemilu.org#24692,"BUMI HARJO, BUAY BAHUGA, WAY KANAN, LAMPUNG",11,98,108,206
https://kawalpemilu.org#24692,"BUMI HARJO, BUAY BAHUGA, WAY KANAN, LAMPUNG",12,56,101,157
https://kawalpemilu.org#24692,"BUMI HARJO, BUAY BAHUGA, WAY KANAN, LAMPUNG",13,120,68,188
https://kawalpemilu.org#24692,"BUMI HARJO, BUAY BAHUGA, WAY KANAN, LAMPUNG",14,93,94,187
https://kawalpemilu.org#24692,"BUMI HARJO, BUAY BAHUGA, WAY KANAN, LAMPUNG",15,21,89,110
https://kawalpemilu.org#24692,"BUMI HARJO, BUAY BAHUGA, WAY KANAN, LAMPUNG",16,103,39,142
https://kawalpemilu.org#24693,"PUNJUL AGUNG, BUAY BAHUGA, WAY KANAN, LAMPUNG",1,116,130,246
https://kawalpemilu.org#24693,"PUNJUL AGUNG, BUAY BAHUGA, WAY KANAN, LAMPUNG",2,84,111,195
https://kawalpemilu.org#24693,"PUNJUL AGUNG, BUAY BAHUGA, WAY KANAN, LAMPUNG",3,91,103,194
https://kawalpemilu.org#24693,"PUNJUL AGUNG, BUAY BAHUGA, WAY KANAN, LAMPUNG",4,108,72,180
https://kawalpemilu.org#24693,"PUNJUL AGUNG, BUAY BAHUGA, WAY KANAN, LAMPUNG",5,129,76,205
https://kawalpemilu.org#24693,"PUNJUL AGUNG, BUAY BAHUGA, WAY KANAN, LAMPUNG",6,69,91,160
https://kawalpemilu.org#24693,"PUNJUL AGUNG, BUAY BAHUGA, WAY KANAN, LAMPUNG",7,108,83,191
https://kawalpemilu.org#24693,"PUNJUL AGUNG, BUAY BAHUGA, WAY KANAN, LAMPUNG",8,126,90,216
https://kawalpemilu.org#24694,"SRI TUNGGAL, BUAY BAHUGA, WAY KANAN, LAMPUNG",1,101,51,152
https://kawalpemilu.org#24694,"SRI TUNGGAL, BUAY BAHUGA, WAY KANAN, LAMPUNG",2,39,124,163
https://kawalpemilu.org#24694,"SRI TUNGGAL, BUAY BAHUGA, WAY KANAN, LAMPUNG",3,46,93,139
https://kawalpemilu.org#24694,"SRI TUNGGAL, BUAY BAHUGA, WAY KANAN, LAMPUNG",4,25,118,143
https://kawalpemilu.org#24694,"SRI TUNGGAL, BUAY BAHUGA, WAY KANAN, LAMPUNG",5,82,120,202
https://kawalpemilu.org#24694,"SRI TUNGGAL, BUAY BAHUGA, WAY KANAN, LAMPUNG",6,25,128,153
https://kawalpemilu.org#24694,"SRI TUNGGAL, BUAY BAHUGA, WAY KANAN, LAMPUNG",7,44,91,135
https://kawalpemilu.org#24694,"SRI TUNGGAL, BUAY BAHUGA, WAY KANAN, LAMPUNG",8,56,110,166
https://kawalpemilu.org#24695,"SUKA BUMI, BUAY BAHUGA, WAY KANAN, LAMPUNG",1,68,116,184
https://kawalpemilu.org#24695,"SUKA BUMI, BUAY BAHUGA, WAY KANAN, LAMPUNG",2,64,150,214
https://kawalpemilu.org#24695,"SUKA BUMI, BUAY BAHUGA, WAY KANAN, LAMPUNG",3,47,134,181
https://kawalpemilu.org#24695,"SUKA BUMI, BUAY BAHUGA, WAY KANAN, LAMPUNG",4,53,134,187
https://kawalpemilu.org#24695,"SUKA BUMI, BUAY BAHUGA, WAY KANAN, LAMPUNG",5,86,85,171
https://kawalpemilu.org#24695,"SUKA BUMI, BUAY BAHUGA, WAY KANAN, LAMPUNG",6,133,106,239
https://kawalpemilu.org#24695,"SUKA BUMI, BUAY BAHUGA, WAY KANAN, LAMPUNG",7,74,47,121
https://kawalpemilu.org#24695,"SUKA BUMI, BUAY BAHUGA, WAY KANAN, LAMPUNG",8,53,153,206
https://kawalpemilu.org#24695,"SUKA BUMI, BUAY BAHUGA, WAY KANAN, LAMPUNG",9,62,148,210
https://kawalpemilu.org#24695,"SUKA BUMI, BUAY BAHUGA, WAY KANAN, LAMPUNG",10,30,101,131
https://kawalpemilu.org#24695,"SUKA BUMI, BUAY BAHUGA, WAY KANAN, LAMPUNG",11,65,113,178
https://kawalpemilu.org#24695,"SUKA BUMI, BUAY BAHUGA, WAY KANAN, LAMPUNG",12,85,94,179
https://kawalpemilu.org#24695,"SUKA BUMI, BUAY BAHUGA, WAY KANAN, LAMPUNG",13,78,78,156
https://kawalpemilu.org#24696,"SUKA AGUNG, BUAY BAHUGA, WAY KANAN, LAMPUNG",1,58,88,146
https://kawalpemilu.org#24696,"SUKA AGUNG, BUAY BAHUGA, WAY KANAN, LAMPUNG",2,42,79,121
https://kawalpemilu.org#24696,"SUKA AGUNG, BUAY BAHUGA, WAY KANAN, LAMPUNG",3,48,73,121
https://kawalpemilu.org#24696,"SUKA AGUNG, BUAY BAHUGA, WAY KANAN, LAMPUNG",4,63,107,170
https://kawalpemilu.org#24696,"SUKA AGUNG, BUAY BAHUGA, WAY KANAN, LAMPUNG",5,64,88,152
https://kawalpemilu.org#24696,"SUKA AGUNG, BUAY BAHUGA, WAY KANAN, LAMPUNG",6,55,82,137
https://kawalpemilu.org#24697,"SUKA DANA, BUAY BAHUGA, WAY KANAN, LAMPUNG",1,71,59,130
https://kawalpemilu.org#24697,"SUKA DANA, BUAY BAHUGA, WAY KANAN, LAMPUNG",2,126,30,156
https://kawalpemilu.org#24697,"SUKA DANA, BUAY BAHUGA, WAY KANAN, LAMPUNG",3,129,97,226
https://kawalpemilu.org#24697,"SUKA DANA, BUAY BAHUGA, WAY KANAN, LAMPUNG",4,40,113,153
https://kawalpemilu.org#24697,"SUKA DANA, BUAY BAHUGA, WAY KANAN, LAMPUNG",5,45,51,96
https://kawalpemilu.org#24697,"SUKA DANA, BUAY BAHUGA, WAY KANAN, LAMPUNG",6,57,39,96
https://kawalpemilu.org#24697,"SUKA DANA, BUAY BAHUGA, WAY KANAN, LAMPUNG",7,104,75,179
https://kawalpemilu.org#24697,"SUKA DANA, BUAY BAHUGA, WAY KANAN, LAMPUNG",8,136,51,187
https://kawalpemilu.org#24698,"NUAR MAJU, BUAY BAHUGA, WAY KANAN, LAMPUNG",1,102,120,222
https://kawalpemilu.org#24698,"NUAR MAJU, BUAY BAHUGA, WAY KANAN, LAMPUNG",2,61,86,147
https://kawalpemilu.org#24698,"NUAR MAJU, BUAY BAHUGA, WAY KANAN, LAMPUNG",3,90,102,192
https://kawalpemilu.org#24698,"NUAR MAJU, BUAY BAHUGA, WAY KANAN, LAMPUNG",4,83,112,195
https://kawalpemilu.org#24698,"NUAR MAJU, BUAY BAHUGA, WAY KANAN, LAMPUNG",5,100,87,187
https://kawalpemilu.org#24698,"NUAR MAJU, BUAY BAHUGA, WAY KANAN, LAMPUNG",6,101,111,212
https://kawalpemilu.org#84822,"LEBUNG LAWE, BUAY BAHUGA, WAY KANAN, LAMPUNG",1,119,81,200
https://kawalpemilu.org#84822,"LEBUNG LAWE, BUAY BAHUGA, WAY KANAN, LAMPUNG",2,137,85,222
https://kawalpemilu.org#84822,"LEBUNG LAWE, BUAY BAHUGA, WAY KANAN, LAMPUNG",3,105,65,170
https://kawalpemilu.org#84822,"LEBUNG LAWE, BUAY BAHUGA, WAY KANAN, LAMPUNG",4,117,91,208
https://kawalpemilu.org#87262,"WAY AGUNG, BUAY BAHUGA, WAY KANAN, LAMPUNG",1,103,61,164
https://kawalpemilu.org#87262,"WAY AGUNG, BUAY BAHUGA, WAY KANAN, LAMPUNG",2,116,92,208
https://kawalpemilu.org#87262,"WAY AGUNG, BUAY BAHUGA, WAY KANAN, LAMPUNG",3,98,102,200
https://kawalpemilu.org#87262,"WAY AGUNG, BUAY BAHUGA, WAY KANAN, LAMPUNG",4,87,71,158
https://kawalpemilu.org#87262,"WAY AGUNG, BUAY BAHUGA, WAY KANAN, LAMPUNG",5,104,88,192
https://kawalpemilu.org#24700,"PISANG BARU, BUMI AGUNG, WAY KANAN, LAMPUNG",1,53,175,228
https://kawalpemilu.org#24700,"PISANG BARU, BUMI AGUNG, WAY KANAN, LAMPUNG",2,36,181,217
https://kawalpemilu.org#24700,"PISANG BARU, BUMI AGUNG, WAY KANAN, LAMPUNG",3,24,185,209
https://kawalpemilu.org#24700,"PISANG BARU, BUMI AGUNG, WAY KANAN, LAMPUNG",4,24,202,226
https://kawalpemilu.org#24700,"PISANG BARU, BUMI AGUNG, WAY KANAN, LAMPUNG",5,53,124,177
https://kawalpemilu.org#24700,"PISANG BARU, BUMI AGUNG, WAY KANAN, LAMPUNG",6,69,106,175
https://kawalpemilu.org#24700,"PISANG BARU, BUMI AGUNG, WAY KANAN, LAMPUNG",7,55,87,142
https://kawalpemilu.org#24700,"PISANG BARU, BUMI AGUNG, WAY KANAN, LAMPUNG",8,61,78,139
https://kawalpemilu.org#24700,"PISANG BARU, BUMI AGUNG, WAY KANAN, LAMPUNG",9,136,52,188
https://kawalpemilu.org#24700,"PISANG BARU, BUMI AGUNG, WAY KANAN, LAMPUNG",10,77,97,174
https://kawalpemilu.org#24700,"PISANG BARU, BUMI AGUNG, WAY KANAN, LAMPUNG",11,34,73,107
https://kawalpemilu.org#24700,"PISANG BARU, BUMI AGUNG, WAY KANAN, LAMPUNG",12,41,158,199
https://kawalpemilu.org#24700,"PISANG BARU, BUMI AGUNG, WAY KANAN, LAMPUNG",13,23,200,223
https://kawalpemilu.org#24700,"PISANG BARU, BUMI AGUNG, WAY KANAN, LAMPUNG",14,42,184,226
https://kawalpemilu.org#24700,"PISANG BARU, BUMI AGUNG, WAY KANAN, LAMPUNG",15,41,86,127
https://kawalpemilu.org#24700,"PISANG BARU, BUMI AGUNG, WAY KANAN, LAMPUNG",16,71,109,180
https://kawalpemilu.org#24700,"PISANG BARU, BUMI AGUNG, WAY KANAN, LAMPUNG",17,65,129,194
https://kawalpemilu.org#24700,"PISANG BARU, BUMI AGUNG, WAY KANAN, LAMPUNG",18,74,65,139
https://kawalpemilu.org#24701,"PISANG INDAH, BUMI AGUNG, WAY KANAN, LAMPUNG",1,164,67,231
https://kawalpemilu.org#24701,"PISANG INDAH, BUMI AGUNG, WAY KANAN, LAMPUNG",2,126,121,247
https://kawalpemilu.org#24701,"PISANG INDAH, BUMI AGUNG, WAY KANAN, LAMPUNG",3,79,120,199
https://kawalpemilu.org#24701,"PISANG INDAH, BUMI AGUNG, WAY KANAN, LAMPUNG",4,92,121,213
https://kawalpemilu.org#24701,"PISANG INDAH, BUMI AGUNG, WAY KANAN, LAMPUNG",5,149,105,254
https://kawalpemilu.org#24701,"PISANG INDAH, BUMI AGUNG, WAY KANAN, LAMPUNG",6,122,116,238
https://kawalpemilu.org#24701,"PISANG INDAH, BUMI AGUNG, WAY KANAN, LAMPUNG",7,220,17,237
https://kawalpemilu.org#24701,"PISANG INDAH, BUMI AGUNG, WAY KANAN, LAMPUNG",8,111,122,240
https://kawalpemilu.org#24701,"PISANG INDAH, BUMI AGUNG, WAY KANAN, LAMPUNG",9,59,56,115
https://kawalpemilu.org#24702,"SRI NUMPI, BUMI AGUNG, WAY KANAN, LAMPUNG",1,74,65,139
https://kawalpemilu.org#24702,"SRI NUMPI, BUMI AGUNG, WAY KANAN, LAMPUNG",2,48,90,138
https://kawalpemilu.org#24702,"SRI NUMPI, BUMI AGUNG, WAY KANAN, LAMPUNG",3,38,104,142
https://kawalpemilu.org#24702,"SRI NUMPI, BUMI AGUNG, WAY KANAN, LAMPUNG",4,32,115,147
https://kawalpemilu.org#24703,"MULYO HARJO, BUMI AGUNG, WAY KANAN, LAMPUNG",2,125,26,151
https://kawalpemilu.org#24703,"MULYO HARJO, BUMI AGUNG, WAY KANAN, LAMPUNG",4,116,43,159
https://kawalpemilu.org#24704,"BUMI AGUNG, BUMI AGUNG, WAY KANAN, LAMPUNG",1,103,52,155
https://kawalpemilu.org#24704,"BUMI AGUNG, BUMI AGUNG, WAY KANAN, LAMPUNG",2,118,65,183
https://kawalpemilu.org#24704,"BUMI AGUNG, BUMI AGUNG, WAY KANAN, LAMPUNG",3,158,62,220
https://kawalpemilu.org#24704,"BUMI AGUNG, BUMI AGUNG, WAY KANAN, LAMPUNG",4,147,84,231
https://kawalpemilu.org#24704,"BUMI AGUNG, BUMI AGUNG, WAY KANAN, LAMPUNG",5,121,55,176
https://kawalpemilu.org#24704,"BUMI AGUNG, BUMI AGUNG, WAY KANAN, LAMPUNG",6,104,73,177
https://kawalpemilu.org#24704,"BUMI AGUNG, BUMI AGUNG, WAY KANAN, LAMPUNG",7,101,101,202
https://kawalpemilu.org#24704,"BUMI AGUNG, BUMI AGUNG, WAY KANAN, LAMPUNG",8,88,139,227
https://kawalpemilu.org#24704,"BUMI AGUNG, BUMI AGUNG, WAY KANAN, LAMPUNG",9,113,112,225
https://kawalpemilu.org#24704,"BUMI AGUNG, BUMI AGUNG, WAY KANAN, LAMPUNG",10,95,96,191
https://kawalpemilu.org#24704,"BUMI AGUNG, BUMI AGUNG, WAY KANAN, LAMPUNG",11,109,52,161
https://kawalpemilu.org#24704,"BUMI AGUNG, BUMI AGUNG, WAY KANAN, LAMPUNG",12,120,54,174
https://kawalpemilu.org#24704,"BUMI AGUNG, BUMI AGUNG, WAY KANAN, LAMPUNG",13,109,66,175
https://kawalpemilu.org#24704,"BUMI AGUNG, BUMI AGUNG, WAY KANAN, LAMPUNG",14,104,92,196
https://kawalpemilu.org#24704,"BUMI AGUNG, BUMI AGUNG, WAY KANAN, LAMPUNG",15,111,46,157
https://kawalpemilu.org#24704,"BUMI AGUNG, BUMI AGUNG, WAY KANAN, LAMPUNG",16,89,90,179
https://kawalpemilu.org#24704,"BUMI AGUNG, BUMI AGUNG, WAY KANAN, LAMPUNG",17,60,112,172
https://kawalpemilu.org#24704,"BUMI AGUNG, BUMI AGUNG, WAY KANAN, LAMPUNG",18,82,128,210
https://kawalpemilu.org#24704,"BUMI AGUNG, BUMI AGUNG, WAY KANAN, LAMPUNG",19,61,100,161
https://kawalpemilu.org#24705,"KARANGAN, BUMI AGUNG, WAY KANAN, LAMPUNG",1,36,216,252
https://kawalpemilu.org#24705,"KARANGAN, BUMI AGUNG, WAY KANAN, LAMPUNG",2,74,121,195
https://kawalpemilu.org#24705,"KARANGAN, BUMI AGUNG, WAY KANAN, LAMPUNG",3,58,98,156
https://kawalpemilu.org#24705,"KARANGAN, BUMI AGUNG, WAY KANAN, LAMPUNG",4,145,67,212
https://kawalpemilu.org#24705,"KARANGAN, BUMI AGUNG, WAY KANAN, LAMPUNG",5,146,48,194
https://kawalpemilu.org#24705,"KARANGAN, BUMI AGUNG, WAY KANAN, LAMPUNG",6,77,92,169
https://kawalpemilu.org#24706,"WONO HARJO, BUMI AGUNG, WAY KANAN, LAMPUNG",1,74,88,162
https://kawalpemilu.org#24706,"WONO HARJO, BUMI AGUNG, WAY KANAN, LAMPUNG",2,137,83,220
https://kawalpemilu.org#24706,"WONO HARJO, BUMI AGUNG, WAY KANAN, LAMPUNG",3,126,101,227
https://kawalpemilu.org#24706,"WONO HARJO, BUMI AGUNG, WAY KANAN, LAMPUNG",4,157,26,183
https://kawalpemilu.org#24706,"WONO HARJO, BUMI AGUNG, WAY KANAN, LAMPUNG",5,89,128,217
https://kawalpemilu.org#24706,"WONO HARJO, BUMI AGUNG, WAY KANAN, LAMPUNG",6,115,97,212
https://kawalpemilu.org#24707,"SUKA MAJU, BUMI AGUNG, WAY KANAN, LAMPUNG",1,121,78,199
https://kawalpemilu.org#24707,"SUKA MAJU, BUMI AGUNG, WAY KANAN, LAMPUNG",2,112,127,239
https://kawalpemilu.org#24707,"SUKA MAJU, BUMI AGUNG, WAY KANAN, LAMPUNG",3,122,114,236
https://kawalpemilu.org#24707,"SUKA MAJU, BUMI AGUNG, WAY KANAN, LAMPUNG",4,126,63,189
https://kawalpemilu.org#24707,"SUKA MAJU, BUMI AGUNG, WAY KANAN, LAMPUNG",5,157,82,239
https://kawalpemilu.org#24707,"SUKA MAJU, BUMI AGUNG, WAY KANAN, LAMPUNG",6,111,89,200
https://kawalpemilu.org#24707,"SUKA MAJU, BUMI AGUNG, WAY KANAN, LAMPUNG",7,96,100,196
https://kawalpemilu.org#24707,"SUKA MAJU, BUMI AGUNG, WAY KANAN, LAMPUNG",8,105,97,202
https://kawalpemilu.org#24708,"TANJUNG DALOM, BUMI AGUNG, WAY KANAN, LAMPUNG",1,123,106,229
https://kawalpemilu.org#24708,"TANJUNG DALOM, BUMI AGUNG, WAY KANAN, LAMPUNG",2,109,117,226
https://kawalpemilu.org#24708,"TANJUNG DALOM, BUMI AGUNG, WAY KANAN, LAMPUNG",3,81,91,172
https://kawalpemilu.org#24708,"TANJUNG DALOM, BUMI AGUNG, WAY KANAN, LAMPUNG",4,69,103,172
https://kawalpemilu.org#24708,"TANJUNG DALOM, BUMI AGUNG, WAY KANAN, LAMPUNG",5,78,62,140
https://kawalpemilu.org#24708,"TANJUNG DALOM, BUMI AGUNG, WAY KANAN, LAMPUNG",6,94,72,166
https://kawalpemilu.org#87266,"BUMI SAY AGUNG, BUMI AGUNG, WAY KANAN, LAMPUNG",1,126,39,165
https://kawalpemilu.org#87266,"BUMI SAY AGUNG, BUMI AGUNG, WAY KANAN, LAMPUNG",2,133,53,186
https://kawalpemilu.org#87266,"BUMI SAY AGUNG, BUMI AGUNG, WAY KANAN, LAMPUNG",3,133,126,259
https://kawalpemilu.org#87266,"BUMI SAY AGUNG, BUMI AGUNG, WAY KANAN, LAMPUNG",4,102,70,172
https://kawalpemilu.org#87266,"BUMI SAY AGUNG, BUMI AGUNG, WAY KANAN, LAMPUNG",5,104,72,176
https://kawalpemilu.org#87266,"BUMI SAY AGUNG, BUMI AGUNG, WAY KANAN, LAMPUNG",6,123,107,230
https://kawalpemilu.org#24713,"KEDATON, KEDATON, KOTA BANDAR LAMPUNG, LAMPUNG",1,66,106,172
https://kawalpemilu.org#24713,"KEDATON, KEDATON, KOTA BANDAR LAMPUNG, LAMPUNG",3,86,114,200
https://kawalpemilu.org#24713,"KEDATON, KEDATON, KOTA BANDAR LAMPUNG, LAMPUNG",4,78,84,162
https://kawalpemilu.org#24713,"KEDATON, KEDATON, KOTA BANDAR LAMPUNG, LAMPUNG",5,32,103,135
https://kawalpemilu.org#24713,"KEDATON, KEDATON, KOTA BANDAR LAMPUNG, LAMPUNG",6,105,71,176
https://kawalpemilu.org#24713,"KEDATON, KEDATON, KOTA BANDAR LAMPUNG, LAMPUNG",7,56,103,159
https://kawalpemilu.org#24713,"KEDATON, KEDATON, KOTA BANDAR LAMPUNG, LAMPUNG",8,83,72,155
https://kawalpemilu.org#24713,"KEDATON, KEDATON, KOTA BANDAR LAMPUNG, LAMPUNG",9,62,76,138
https://kawalpemilu.org#24713,"KEDATON, KEDATON, KOTA BANDAR LAMPUNG, LAMPUNG",10,101,69,170
https://kawalpemilu.org#24713,"KEDATON, KEDATON, KOTA BANDAR LAMPUNG, LAMPUNG",11,63,101,164
https://kawalpemilu.org#24713,"KEDATON, KEDATON, KOTA BANDAR LAMPUNG, LAMPUNG",12,113,171,284
https://kawalpemilu.org#24713,"KEDATON, KEDATON, KOTA BANDAR LAMPUNG, LAMPUNG",13,48,107,155
https://kawalpemilu.org#24713,"KEDATON, KEDATON, KOTA BANDAR LAMPUNG, LAMPUNG",14,84,92,176
https://kawalpemilu.org#24713,"KEDATON, KEDATON, KOTA BANDAR LAMPUNG, LAMPUNG",15,104,109,213
https://kawalpemilu.org#24713,"KEDATON, KEDATON, KOTA BANDAR LAMPUNG, LAMPUNG",16,103,123,226
https://kawalpemilu.org#24713,"KEDATON, KEDATON, KOTA BANDAR LAMPUNG, LAMPUNG",17,150,143,293
https://kawalpemilu.org#24713,"KEDATON, KEDATON, KOTA BANDAR LAMPUNG, LAMPUNG",18,69,88,157
https://kawalpemilu.org#24713,"KEDATON, KEDATON, KOTA BANDAR LAMPUNG, LAMPUNG",19,75,115,190
https://kawalpemilu.org#24713,"KEDATON, KEDATON, KOTA BANDAR LAMPUNG, LAMPUNG",20,106,65,171
https://kawalpemilu.org#24713,"KEDATON, KEDATON, KOTA BANDAR LAMPUNG, LAMPUNG",21,100,75,175
https://kawalpemilu.org#24713,"KEDATON, KEDATON, KOTA BANDAR LAMPUNG, LAMPUNG",22,131,70,201
https://kawalpemilu.org#24713,"KEDATON, KEDATON, KOTA BANDAR LAMPUNG, LAMPUNG",23,95,95,190
https://kawalpemilu.org#24713,"KEDATON, KEDATON, KOTA BANDAR LAMPUNG, LAMPUNG",24,87,57,144
https://kawalpemilu.org#24713,"KEDATON, KEDATON, KOTA BANDAR LAMPUNG, LAMPUNG",25,80,52,132
https://kawalpemilu.org#24713,"KEDATON, KEDATON, KOTA BANDAR LAMPUNG, LAMPUNG",26,107,104,211
https://kawalpemilu.org#24713,"KEDATON, KEDATON, KOTA BANDAR LAMPUNG, LAMPUNG",27,78,107,185
https://kawalpemilu.org#24713,"KEDATON, KEDATON, KOTA BANDAR LAMPUNG, LAMPUNG",28,66,53,119
https://kawalpemilu.org#24713,"KEDATON, KEDATON, KOTA BANDAR LAMPUNG, LAMPUNG",29,98,55,153
https://kawalpemilu.org#24713,"KEDATON, KEDATON, KOTA BANDAR LAMPUNG, LAMPUNG",30,111,35,146
https://kawalpemilu.org#24713,"KEDATON, KEDATON, KOTA BANDAR LAMPUNG, LAMPUNG",31,120,56,176
https://kawalpemilu.org#24713,"KEDATON, KEDATON, KOTA BANDAR LAMPUNG, LAMPUNG",32,106,135,241
https://kawalpemilu.org#24713,"KEDATON, KEDATON, KOTA BANDAR LAMPUNG, LAMPUNG",33,108,104,212
https://kawalpemilu.org#24713,"KEDATON, KEDATON, KOTA BANDAR LAMPUNG, LAMPUNG",34,62,118,180
https://kawalpemilu.org#24713,"KEDATON, KEDATON, KOTA BANDAR LAMPUNG, LAMPUNG",35,83,123,206
https://kawalpemilu.org#24713,"KEDATON, KEDATON, KOTA BANDAR LAMPUNG, LAMPUNG",36,119,179,298
https://kawalpemilu.org#24714,"SURABAYA, KEDATON, KOTA BANDAR LAMPUNG, LAMPUNG",1,43,101,144
https://kawalpemilu.org#24714,"SURABAYA, KEDATON, KOTA BANDAR LAMPUNG, LAMPUNG",2,63,104,167
https://kawalpemilu.org#24714,"SURABAYA, KEDATON, KOTA BANDAR LAMPUNG, LAMPUNG",3,49,97,146
https://kawalpemilu.org#24714,"SURABAYA, KEDATON, KOTA BANDAR LAMPUNG, LAMPUNG",4,100,142,242
https://kawalpemilu.org#24714,"SURABAYA, KEDATON, KOTA BANDAR LAMPUNG, LAMPUNG",5,25,65,90
https://kawalpemilu.org#24714,"SURABAYA, KEDATON, KOTA BANDAR LAMPUNG, LAMPUNG",7,76,80,156
https://kawalpemilu.org#24714,"SURABAYA, KEDATON, KOTA BANDAR LAMPUNG, LAMPUNG",8,42,84,126
https://kawalpemilu.org#24714,"SURABAYA, KEDATON, KOTA BANDAR LAMPUNG, LAMPUNG",9,37,95,132
https://kawalpemilu.org#24714,"SURABAYA, KEDATON, KOTA BANDAR LAMPUNG, LAMPUNG",10,65,126,191
https://kawalpemilu.org#24714,"SURABAYA, KEDATON, KOTA BANDAR LAMPUNG, LAMPUNG",11,65,83,148
https://kawalpemilu.org#24714,"SURABAYA, KEDATON, KOTA BANDAR LAMPUNG, LAMPUNG",12,39,119,158
https://kawalpemilu.org#24714,"SURABAYA, KEDATON, KOTA BANDAR LAMPUNG, LAMPUNG",13,78,41,119
https://kawalpemilu.org#24714,"SURABAYA, KEDATON, KOTA BANDAR LAMPUNG, LAMPUNG",14,77,120,197
https://kawalpemilu.org#24714,"SURABAYA, KEDATON, KOTA BANDAR LAMPUNG, LAMPUNG",15,92,179,271
https://kawalpemilu.org#24714,"SURABAYA, KEDATON, KOTA BANDAR LAMPUNG, LAMPUNG",16,54,93,147
https://kawalpemilu.org#24714,"SURABAYA, KEDATON, KOTA BANDAR LAMPUNG, LAMPUNG",17,47,52,99
https://kawalpemilu.org#24714,"SURABAYA, KEDATON, KOTA BANDAR LAMPUNG, LAMPUNG",18,71,98,169
https://kawalpemilu.org#24714,"SURABAYA, KEDATON, KOTA BANDAR LAMPUNG, LAMPUNG",19,101,96,197
https://kawalpemilu.org#24714,"SURABAYA, KEDATON, KOTA BANDAR LAMPUNG, LAMPUNG",20,75,77,152
https://kawalpemilu.org#24714,"SURABAYA, KEDATON, KOTA BANDAR LAMPUNG, LAMPUNG",21,89,87,176
https://kawalpemilu.org#24714,"SURABAYA, KEDATON, KOTA BANDAR LAMPUNG, LAMPUNG",22,77,130,207
https://kawalpemilu.org#24714,"SURABAYA, KEDATON, KOTA BANDAR LAMPUNG, LAMPUNG",23,70,130,200
https://kawalpemilu.org#24714,"SURABAYA, KEDATON, KOTA BANDAR LAMPUNG, LAMPUNG",24,79,96,175
https://kawalpemilu.org#24714,"SURABAYA, KEDATON, KOTA BANDAR LAMPUNG, LAMPUNG",25,89,122,211
https://kawalpemilu.org#24714,"SURABAYA, KEDATON, KOTA BANDAR LAMPUNG, LAMPUNG",26,39,104,143
https://kawalpemilu.org#24714,"SURABAYA, KEDATON, KOTA BANDAR LAMPUNG, LAMPUNG",27,78,153,231
https://kawalpemilu.org#24714,"SURABAYA, KEDATON, KOTA BANDAR LAMPUNG, LAMPUNG",28,80,167,147
https://kawalpemilu.org#24714,"SURABAYA, KEDATON, KOTA BANDAR LAMPUNG, LAMPUNG",29,99,151,250
https://kawalpemilu.org#24714,"SURABAYA, KEDATON, KOTA BANDAR LAMPUNG, LAMPUNG",30,63,73,136
https://kawalpemilu.org#24714,"SURABAYA, KEDATON, KOTA BANDAR LAMPUNG, LAMPUNG",31,109,129,238
https://kawalpemilu.org#24714,"SURABAYA, KEDATON, KOTA BANDAR LAMPUNG, LAMPUNG",32,97,115,212
https://kawalpemilu.org#24714,"SURABAYA, KEDATON, KOTA BANDAR LAMPUNG, LAMPUNG",33,67,105,172
https://kawalpemilu.org#24714,"SURABAYA, KEDATON, KOTA BANDAR LAMPUNG, LAMPUNG",34,81,76,157
https://kawalpemilu.org#24714,"SURABAYA, KEDATON, KOTA BANDAR LAMPUNG, LAMPUNG",35,75,20,95
https://kawalpemilu.org#24715,"SUKAMENANTI, KEDATON, KOTA BANDAR LAMPUNG, LAMPUNG",1,109,116,225
https://kawalpemilu.org#24715,"SUKAMENANTI, KEDATON, KOTA BANDAR LAMPUNG, LAMPUNG",2,115,114,229
https://kawalpemilu.org#24715,"SUKAMENANTI, KEDATON, KOTA BANDAR LAMPUNG, LAMPUNG",4,113,134,247
https://kawalpemilu.org#24715,"SUKAMENANTI, KEDATON, KOTA BANDAR LAMPUNG, LAMPUNG",5,142,100,242
https://kawalpemilu.org#24715,"SUKAMENANTI, KEDATON, KOTA BANDAR LAMPUNG, LAMPUNG",6,112,119,231
https://kawalpemilu.org#24715,"SUKAMENANTI, KEDATON, KOTA BANDAR LAMPUNG, LAMPUNG",7,112,135,247
https://kawalpemilu.org#24715,"SUKAMENANTI, KEDATON, KOTA BANDAR LAMPUNG, LAMPUNG",8,122,84,206
https://kawalpemilu.org#24715,"SUKAMENANTI, KEDATON, KOTA BANDAR LAMPUNG, LAMPUNG",10,147,106,253
https://kawalpemilu.org#24716,"SIDODADI, KEDATON, KOTA BANDAR LAMPUNG, LAMPUNG",2,68,145,213
https://kawalpemilu.org#24716,"SIDODADI, KEDATON, KOTA BANDAR LAMPUNG, LAMPUNG",3,91,195,286
https://kawalpemilu.org#24716,"SIDODADI, KEDATON, KOTA BANDAR LAMPUNG, LAMPUNG",4,123,151,274
https://kawalpemilu.org#24716,"SIDODADI, KEDATON, KOTA BANDAR LAMPUNG, LAMPUNG",5,100,182,282
https://kawalpemilu.org#24716,"SIDODADI, KEDATON, KOTA BANDAR LAMPUNG, LAMPUNG",6,117,146,263
https://kawalpemilu.org#24716,"SIDODADI, KEDATON, KOTA BANDAR LAMPUNG, LAMPUNG",7,100,151,251
https://kawalpemilu.org#24716,"SIDODADI, KEDATON, KOTA BANDAR LAMPUNG, LAMPUNG",8,123,152,275
https://kawalpemilu.org#24716,"SIDODADI, KEDATON, KOTA BANDAR LAMPUNG, LAMPUNG",9,109,156,265
https://kawalpemilu.org#24716,"SIDODADI, KEDATON, KOTA BANDAR LAMPUNG, LAMPUNG",10,119,93,212
https://kawalpemilu.org#24716,"SIDODADI, KEDATON, KOTA BANDAR LAMPUNG, LAMPUNG",11,98,58,156
https://kawalpemilu.org#24716,"SIDODADI, KEDATON, KOTA BANDAR LAMPUNG, LAMPUNG",12,60,96,156
https://kawalpemilu.org#24716,"SIDODADI, KEDATON, KOTA BANDAR LAMPUNG, LAMPUNG",13,51,94,145
https://kawalpemilu.org#24716,"SIDODADI, KEDATON, KOTA BANDAR LAMPUNG, LAMPUNG",14,70,128,198
https://kawalpemilu.org#24716,"SIDODADI, KEDATON, KOTA BANDAR LAMPUNG, LAMPUNG",15,100,67,167
https://kawalpemilu.org#24716,"SIDODADI, KEDATON, KOTA BANDAR LAMPUNG, LAMPUNG",16,149,44,193
https://kawalpemilu.org#24716,"SIDODADI, KEDATON, KOTA BANDAR LAMPUNG, LAMPUNG",17,133,102,235
https://kawalpemilu.org#24716,"SIDODADI, KEDATON, KOTA BANDAR LAMPUNG, LAMPUNG",18,96,56,152
https://kawalpemilu.org#24716,"SIDODADI, KEDATON, KOTA BANDAR LAMPUNG, LAMPUNG",19,76,69,145
https://kawalpemilu.org#24716,"SIDODADI, KEDATON, KOTA BANDAR LAMPUNG, LAMPUNG",20,155,92,247
https://kawalpemilu.org#24716,"SIDODADI, KEDATON, KOTA BANDAR LAMPUNG, LAMPUNG",21,132,119,251
https://kawalpemilu.org#24716,"SIDODADI, KEDATON, KOTA BANDAR LAMPUNG, LAMPUNG",22,100,154,254
https://kawalpemilu.org#24716,"SIDODADI, KEDATON, KOTA BANDAR LAMPUNG, LAMPUNG",23,70,64,134
https://kawalpemilu.org#24716,"SIDODADI, KEDATON, KOTA BANDAR LAMPUNG, LAMPUNG",24,105,101,206
https://kawalpemilu.org#24716,"SIDODADI, KEDATON, KOTA BANDAR LAMPUNG, LAMPUNG",25,62,53,115
https://kawalpemilu.org#24716,"SIDODADI, KEDATON, KOTA BANDAR LAMPUNG, LAMPUNG",26,94,145,239
https://kawalpemilu.org#24763,"PENENGAHAN, KEDATON, KOTA BANDAR LAMPUNG, LAMPUNG",1,38,100,138
https://kawalpemilu.org#24763,"PENENGAHAN, KEDATON, KOTA BANDAR LAMPUNG, LAMPUNG",2,58,81,139
https://kawalpemilu.org#24763,"PENENGAHAN, KEDATON, KOTA BANDAR LAMPUNG, LAMPUNG",4,32,71,103
https://kawalpemilu.org#24763,"PENENGAHAN, KEDATON, KOTA BANDAR LAMPUNG, LAMPUNG",5,75,162,237
https://kawalpemilu.org#24763,"PENENGAHAN, KEDATON, KOTA BANDAR LAMPUNG, LAMPUNG",7,30,83,113
https://kawalpemilu.org#24763,"PENENGAHAN, KEDATON, KOTA BANDAR LAMPUNG, LAMPUNG",9,3,102,105
https://kawalpemilu.org#24763,"PENENGAHAN, KEDATON, KOTA BANDAR LAMPUNG, LAMPUNG",10,61,104,165
https://kawalpemilu.org#24763,"PENENGAHAN, KEDATON, KOTA BANDAR LAMPUNG, LAMPUNG",11,105,134,239
https://kawalpemilu.org#87221,"SUKAMENANTI BARU, KEDATON, KOTA BANDAR LAMPUNG, LAMPUNG",1,98,122,220
https://kawalpemilu.org#87221,"SUKAMENANTI BARU, KEDATON, KOTA BANDAR LAMPUNG, LAMPUNG",2,85,128,213
https://kawalpemilu.org#87221,"SUKAMENANTI BARU, KEDATON, KOTA BANDAR LAMPUNG, LAMPUNG",4,66,103,169
https://kawalpemilu.org#87221,"SUKAMENANTI BARU, KEDATON, KOTA BANDAR LAMPUNG, LAMPUNG",5,109,96,205
https://kawalpemilu.org#87221,"SUKAMENANTI BARU, KEDATON, KOTA BANDAR LAMPUNG, LAMPUNG",6,43,89,132
https://kawalpemilu.org#87221,"SUKAMENANTI BARU, KEDATON, KOTA BANDAR LAMPUNG, LAMPUNG",7,118,147,265
https://kawalpemilu.org#87221,"SUKAMENANTI BARU, KEDATON, KOTA BANDAR LAMPUNG, LAMPUNG",8,109,128,237
https://kawalpemilu.org#87221,"SUKAMENANTI BARU, KEDATON, KOTA BANDAR LAMPUNG, LAMPUNG",9,85,167,252
https://kawalpemilu.org#87221,"SUKAMENANTI BARU, KEDATON, KOTA BANDAR LAMPUNG, LAMPUNG",10,132,102,234
https://kawalpemilu.org#87221,"SUKAMENANTI BARU, KEDATON, KOTA BANDAR LAMPUNG, LAMPUNG",11,117,70,187
https://kawalpemilu.org#87222,"PENENGAHAN RAYA, KEDATON, KOTA BANDAR LAMPUNG, LAMPUNG",1,43,75,118
https://kawalpemilu.org#87222,"PENENGAHAN RAYA, KEDATON, KOTA BANDAR LAMPUNG, LAMPUNG",2,47,89,136
https://kawalpemilu.org#87222,"PENENGAHAN RAYA, KEDATON, KOTA BANDAR LAMPUNG, LAMPUNG",3,95,88,183
https://kawalpemilu.org#87222,"PENENGAHAN RAYA, KEDATON, KOTA BANDAR LAMPUNG, LAMPUNG",4,54,103,157
https://kawalpemilu.org#87222,"PENENGAHAN RAYA, KEDATON, KOTA BANDAR LAMPUNG, LAMPUNG",5,71,128,199
https://kawalpemilu.org#87222,"PENENGAHAN RAYA, KEDATON, KOTA BANDAR LAMPUNG, LAMPUNG",6,48,66,114
https://kawalpemilu.org#87222,"PENENGAHAN RAYA, KEDATON, KOTA BANDAR LAMPUNG, LAMPUNG",7,88,130,218
https://kawalpemilu.org#87222,"PENENGAHAN RAYA, KEDATON, KOTA BANDAR LAMPUNG, LAMPUNG",8,167,86,253
https://kawalpemilu.org#87222,"PENENGAHAN RAYA, KEDATON, KOTA BANDAR LAMPUNG, LAMPUNG",9,99,55,154
https://kawalpemilu.org#87222,"PENENGAHAN RAYA, KEDATON, KOTA BANDAR LAMPUNG, LAMPUNG",10,88,87,175
https://kawalpemilu.org#87222,"PENENGAHAN RAYA, KEDATON, KOTA BANDAR LAMPUNG, LAMPUNG",11,46,112,158
https://kawalpemilu.org#87222,"PENENGAHAN RAYA, KEDATON, KOTA BANDAR LAMPUNG, LAMPUNG",12,58,113,171
https://kawalpemilu.org#87222,"PENENGAHAN RAYA, KEDATON, KOTA BANDAR LAMPUNG, LAMPUNG",13,66,103,169
https://kawalpemilu.org#87222,"PENENGAHAN RAYA, KEDATON, KOTA BANDAR LAMPUNG, LAMPUNG",14,38,54,92
https://kawalpemilu.org#87222,"PENENGAHAN RAYA, KEDATON, KOTA BANDAR LAMPUNG, LAMPUNG",15,4,13,17
https://kawalpemilu.org#87222,"PENENGAHAN RAYA, KEDATON, KOTA BANDAR LAMPUNG, LAMPUNG",16,24,35,59
https://kawalpemilu.org#87222,"PENENGAHAN RAYA, KEDATON, KOTA BANDAR LAMPUNG, LAMPUNG",17,8,18,26
https://kawalpemilu.org#24720,"SUKARAME BARU, SUKARAME, KOTA BANDAR LAMPUNG, LAMPUNG",1,78,160,238
https://kawalpemilu.org#24720,"SUKARAME BARU, SUKARAME, KOTA BANDAR LAMPUNG, LAMPUNG",3,73,103,176
https://kawalpemilu.org#24720,"SUKARAME BARU, SUKARAME, KOTA BANDAR LAMPUNG, LAMPUNG",4,74,130,204
https://kawalpemilu.org#24720,"SUKARAME BARU, SUKARAME, KOTA BANDAR LAMPUNG, LAMPUNG",5,87,149,236
https://kawalpemilu.org#24720,"SUKARAME BARU, SUKARAME, KOTA BANDAR LAMPUNG, LAMPUNG",6,44,102,146
https://kawalpemilu.org#24720,"SUKARAME BARU, SUKARAME, KOTA BANDAR LAMPUNG, LAMPUNG",7,61,168,229
https://kawalpemilu.org#24720,"SUKARAME BARU, SUKARAME, KOTA BANDAR LAMPUNG, LAMPUNG",8,51,131,182
https://kawalpemilu.org#24720,"SUKARAME BARU, SUKARAME, KOTA BANDAR LAMPUNG, LAMPUNG",9,62,129,191
https://kawalpemilu.org#24720,"SUKARAME BARU, SUKARAME, KOTA BANDAR LAMPUNG, LAMPUNG",10,57,171,228
https://kawalpemilu.org#24720,"SUKARAME BARU, SUKARAME, KOTA BANDAR LAMPUNG, LAMPUNG",11,37,90,127
https://kawalpemilu.org#24720,"SUKARAME BARU, SUKARAME, KOTA BANDAR LAMPUNG, LAMPUNG",12,80,158,238
https://kawalpemilu.org#24720,"SUKARAME BARU, SUKARAME, KOTA BANDAR LAMPUNG, LAMPUNG",13,68,103,171
https://kawalpemilu.org#24720,"SUKARAME BARU, SUKARAME, KOTA BANDAR LAMPUNG, LAMPUNG",14,79,117,196
https://kawalpemilu.org#24720,"SUKARAME BARU, SUKARAME, KOTA BANDAR LAMPUNG, LAMPUNG",15,69,130,199
https://kawalpemilu.org#24720,"SUKARAME BARU, SUKARAME, KOTA BANDAR LAMPUNG, LAMPUNG",16,105,150,255
https://kawalpemilu.org#24720,"SUKARAME BARU, SUKARAME, KOTA BANDAR LAMPUNG, LAMPUNG",17,120,118,238
https://kawalpemilu.org#24720,"SUKARAME BARU, SUKARAME, KOTA BANDAR LAMPUNG, LAMPUNG",18,86,145,231
https://kawalpemilu.org#24720,"SUKARAME BARU, SUKARAME, KOTA BANDAR LAMPUNG, LAMPUNG",19,74,154,228
https://kawalpemilu.org#24720,"SUKARAME BARU, SUKARAME, KOTA BANDAR LAMPUNG, LAMPUNG",20,97,146,243
https://kawalpemilu.org#24720,"SUKARAME BARU, SUKARAME, KOTA BANDAR LAMPUNG, LAMPUNG",21,129,136,265
https://kawalpemilu.org#24720,"SUKARAME BARU, SUKARAME, KOTA BANDAR LAMPUNG, LAMPUNG",22,114,119,233
https://kawalpemilu.org#24722,"SUKARAME, SUKARAME, KOTA BANDAR LAMPUNG, LAMPUNG",1,45,174,219
https://kawalpemilu.org#24722,"SUKARAME, SUKARAME, KOTA BANDAR LAMPUNG, LAMPUNG",2,88,133,221
https://kawalpemilu.org#24722,"SUKARAME, SUKARAME, KOTA BANDAR LAMPUNG, LAMPUNG",3,64,124,188
https://kawalpemilu.org#24722,"SUKARAME, SUKARAME, KOTA BANDAR LAMPUNG, LAMPUNG",4,62,123,185
https://kawalpemilu.org#24722,"SUKARAME, SUKARAME, KOTA BANDAR LAMPUNG, LAMPUNG",5,72,97,169
https://kawalpemilu.org#24722,"SUKARAME, SUKARAME, KOTA BANDAR LAMPUNG, LAMPUNG",6,96,154,250
https://kawalpemilu.org#24722,"SUKARAME, SUKARAME, KOTA BANDAR LAMPUNG, LAMPUNG",7,76,128,204
https://kawalpemilu.org#24722,"SUKARAME, SUKARAME, KOTA BANDAR LAMPUNG, LAMPUNG",8,91,146,237
https://kawalpemilu.org#24722,"SUKARAME, SUKARAME, KOTA BANDAR LAMPUNG, LAMPUNG",9,105,133,238
https://kawalpemilu.org#24722,"SUKARAME, SUKARAME, KOTA BANDAR LAMPUNG, LAMPUNG",10,139,134,273
https://kawalpemilu.org#24722,"SUKARAME, SUKARAME, KOTA BANDAR LAMPUNG, LAMPUNG",11,72,138,210
https://kawalpemilu.org#24722,"SUKARAME, SUKARAME, KOTA BANDAR LAMPUNG, LAMPUNG",13,87,141,228
https://kawalpemilu.org#24722,"SUKARAME, SUKARAME, KOTA BANDAR LAMPUNG, LAMPUNG",14,84,136,220
https://kawalpemilu.org#24722,"SUKARAME, SUKARAME, KOTA BANDAR LAMPUNG, LAMPUNG",15,72,110,182
https://kawalpemilu.org#24722,"SUKARAME, SUKARAME, KOTA BANDAR LAMPUNG, LAMPUNG",16,76,119,195
https://kawalpemilu.org#24722,"SUKARAME, SUKARAME, KOTA BANDAR LAMPUNG, LAMPUNG",17,79,156,235
https://kawalpemilu.org#24722,"SUKARAME, SUKARAME, KOTA BANDAR LAMPUNG, LAMPUNG",18,120,158,278
https://kawalpemilu.org#24722,"SUKARAME, SUKARAME, KOTA BANDAR LAMPUNG, LAMPUNG",19,111,134,245
https://kawalpemilu.org#24722,"SUKARAME, SUKARAME, KOTA BANDAR LAMPUNG, LAMPUNG",20,73,132,205
https://kawalpemilu.org#24722,"SUKARAME, SUKARAME, KOTA BANDAR LAMPUNG, LAMPUNG",21,67,147,214
https://kawalpemilu.org#24722,"SUKARAME, SUKARAME, KOTA BANDAR LAMPUNG, LAMPUNG",22,78,130,208
https://kawalpemilu.org#24722,"SUKARAME, SUKARAME, KOTA BANDAR LAMPUNG, LAMPUNG",23,79,122,201
https://kawalpemilu.org#24722,"SUKARAME, SUKARAME, KOTA BANDAR LAMPUNG, LAMPUNG",24,55,148,203
https://kawalpemilu.org#24722,"SUKARAME, SUKARAME, KOTA BANDAR LAMPUNG, LAMPUNG",25,86,118,204
https://kawalpemilu.org#24722,"SUKARAME, SUKARAME, KOTA BANDAR LAMPUNG, LAMPUNG",26,97,142,239
https://kawalpemilu.org#24722,"SUKARAME, SUKARAME, KOTA BANDAR LAMPUNG, LAMPUNG",27,110,133,243
https://kawalpemilu.org#24722,"SUKARAME, SUKARAME, KOTA BANDAR LAMPUNG, LAMPUNG",28,110,132,242
https://kawalpemilu.org#24722,"SUKARAME, SUKARAME, KOTA BANDAR LAMPUNG, LAMPUNG",29,106,160,266
https://kawalpemilu.org#24722,"SUKARAME, SUKARAME, KOTA BANDAR LAMPUNG, LAMPUNG",30,81,121,202
https://kawalpemilu.org#24722,"SUKARAME, SUKARAME, KOTA BANDAR LAMPUNG, LAMPUNG",31,106,166,272
https://kawalpemilu.org#24722,"SUKARAME, SUKARAME, KOTA BANDAR LAMPUNG, LAMPUNG",32,117,150,267
https://kawalpemilu.org#24722,"SUKARAME, SUKARAME, KOTA BANDAR LAMPUNG, LAMPUNG",33,42,87,129
https://kawalpemilu.org#24722,"SUKARAME, SUKARAME, KOTA BANDAR LAMPUNG, LAMPUNG",34,39,97,136
https://kawalpemilu.org#24722,"SUKARAME, SUKARAME, KOTA BANDAR LAMPUNG, LAMPUNG",35,46,80,125
https://kawalpemilu.org#24722,"SUKARAME, SUKARAME, KOTA BANDAR LAMPUNG, LAMPUNG",36,51,70,121
https://kawalpemilu.org#24722,"SUKARAME, SUKARAME, KOTA BANDAR LAMPUNG, LAMPUNG",37,58,134,192
https://kawalpemilu.org#24722,"SUKARAME, SUKARAME, KOTA BANDAR LAMPUNG, LAMPUNG",38,62,104,166
https://kawalpemilu.org#24722,"SUKARAME, SUKARAME, KOTA BANDAR LAMPUNG, LAMPUNG",39,84,162,246
https://kawalpemilu.org#24722,"SUKARAME, SUKARAME, KOTA BANDAR LAMPUNG, LAMPUNG",40,95,175,270
https://kawalpemilu.org#24722,"SUKARAME, SUKARAME, KOTA BANDAR LAMPUNG, LAMPUNG",41,144,115,259
https://kawalpemilu.org#24722,"SUKARAME, SUKARAME, KOTA BANDAR LAMPUNG, LAMPUNG",42,124,124,248
https://kawalpemilu.org#24722,"SUKARAME, SUKARAME, KOTA BANDAR LAMPUNG, LAMPUNG",43,66,80,146
https://kawalpemilu.org#24722,"SUKARAME, SUKARAME, KOTA BANDAR LAMPUNG, LAMPUNG",44,63,87,150
https://kawalpemilu.org#24722,"SUKARAME, SUKARAME, KOTA BANDAR LAMPUNG, LAMPUNG",45,72,108,180
https://kawalpemilu.org#24722,"SUKARAME, SUKARAME, KOTA BANDAR LAMPUNG, LAMPUNG",46,66,128,194
https://kawalpemilu.org#24722,"SUKARAME, SUKARAME, KOTA BANDAR LAMPUNG, LAMPUNG",47,56,175,231
https://kawalpemilu.org#24722,"SUKARAME, SUKARAME, KOTA BANDAR LAMPUNG, LAMPUNG",48,56,135,191
https://kawalpemilu.org#24723,"WAY DADI, SUKARAME, KOTA BANDAR LAMPUNG, LAMPUNG",1,93,90,183
https://kawalpemilu.org#24723,"WAY DADI, SUKARAME, KOTA BANDAR LAMPUNG, LAMPUNG",2,96,63,159
https://kawalpemilu.org#24723,"WAY DADI, SUKARAME, KOTA BANDAR LAMPUNG, LAMPUNG",3,67,64,131
https://kawalpemilu.org#24723,"WAY DADI, SUKARAME, KOTA BANDAR LAMPUNG, LAMPUNG",4,71,44,115
https://kawalpemilu.org#24723,"WAY DADI, SUKARAME, KOTA BANDAR LAMPUNG, LAMPUNG",5,117,67,184
https://kawalpemilu.org#24723,"WAY DADI, SUKARAME, KOTA BANDAR LAMPUNG, LAMPUNG",6,101,84,185
https://kawalpemilu.org#24723,"WAY DADI, SUKARAME, KOTA BANDAR LAMPUNG, LAMPUNG",7,118,106,224
https://kawalpemilu.org#24723,"WAY DADI, SUKARAME, KOTA BANDAR LAMPUNG, LAMPUNG",8,86,50,136
https://kawalpemilu.org#24723,"WAY DADI, SUKARAME, KOTA BANDAR LAMPUNG, LAMPUNG",9,117,49,166
https://kawalpemilu.org#24723,"WAY DADI, SUKARAME, KOTA BANDAR LAMPUNG, LAMPUNG",10,160,129,289
https://kawalpemilu.org#24723,"WAY DADI, SUKARAME, KOTA BANDAR LAMPUNG, LAMPUNG",11,124,106,230
https://kawalpemilu.org#24723,"WAY DADI, SUKARAME, KOTA BANDAR LAMPUNG, LAMPUNG",12,56,90,146
https://kawalpemilu.org#24723,"WAY DADI, SUKARAME, KOTA BANDAR LAMPUNG, LAMPUNG",14,69,173,242
https://kawalpemilu.org#24723,"WAY DADI, SUKARAME, KOTA BANDAR LAMPUNG, LAMPUNG",15,60,75,135
https://kawalpemilu.org#24723,"WAY DADI, SUKARAME, KOTA BANDAR LAMPUNG, LAMPUNG",16,81,99,180
https://kawalpemilu.org#24723,"WAY DADI, SUKARAME, KOTA BANDAR LAMPUNG, LAMPUNG",17,97,117,214
https://kawalpemilu.org#24723,"WAY DADI, SUKARAME, KOTA BANDAR LAMPUNG, LAMPUNG",18,35,101,136
https://kawalpemilu.org#24723,"WAY DADI, SUKARAME, KOTA BANDAR LAMPUNG, LAMPUNG",19,58,123,181
https://kawalpemilu.org#24723,"WAY DADI, SUKARAME, KOTA BANDAR LAMPUNG, LAMPUNG",20,46,89,135
https://kawalpemilu.org#24723,"WAY DADI, SUKARAME, KOTA BANDAR LAMPUNG, LAMPUNG",21,68,180,248
https://kawalpemilu.org#24723,"WAY DADI, SUKARAME, KOTA BANDAR LAMPUNG, LAMPUNG",22,81,139,220
https://kawalpemilu.org#24723,"WAY DADI, SUKARAME, KOTA BANDAR LAMPUNG, LAMPUNG",23,123,144,267
https://kawalpemilu.org#24723,"WAY DADI, SUKARAME, KOTA BANDAR LAMPUNG, LAMPUNG",24,160,107,267
https://kawalpemilu.org#24723,"WAY DADI, SUKARAME, KOTA BANDAR LAMPUNG, LAMPUNG",25,109,8,117
https://kawalpemilu.org#24724,"KORPRI JAYA, SUKARAME, KOTA BANDAR LAMPUNG, LAMPUNG",1,0,0,0
https://kawalpemilu.org#24724,"KORPRI JAYA, SUKARAME, KOTA BANDAR LAMPUNG, LAMPUNG",2,81,135,216
https://kawalpemilu.org#24724,"KORPRI JAYA, SUKARAME, KOTA BANDAR LAMPUNG, LAMPUNG",3,85,192,277
https://kawalpemilu.org#24724,"KORPRI JAYA, SUKARAME, KOTA BANDAR LAMPUNG, LAMPUNG",4,80,139,219
https://kawalpemilu.org#24724,"KORPRI JAYA, SUKARAME, KOTA BANDAR LAMPUNG, LAMPUNG",5,76,108,184
https://kawalpemilu.org#24724,"KORPRI JAYA, SUKARAME, KOTA BANDAR LAMPUNG, LAMPUNG",6,86,105,191
https://kawalpemilu.org#24724,"KORPRI JAYA, SUKARAME, KOTA BANDAR LAMPUNG, LAMPUNG",7,129,109,238
https://kawalpemilu.org#24724,"KORPRI JAYA, SUKARAME, KOTA BANDAR LAMPUNG, LAMPUNG",8,115,129,244
https://kawalpemilu.org#24724,"KORPRI JAYA, SUKARAME, KOTA BANDAR LAMPUNG, LAMPUNG",9,115,102,217
https://kawalpemilu.org#24724,"KORPRI JAYA, SUKARAME, KOTA BANDAR LAMPUNG, LAMPUNG",10,143,78,221
https://kawalpemilu.org#24724,"KORPRI JAYA, SUKARAME, KOTA BANDAR LAMPUNG, LAMPUNG",11,114,110,224
https://kawalpemilu.org#24724,"KORPRI JAYA, SUKARAME, KOTA BANDAR LAMPUNG, LAMPUNG",12,90,124,214
https://kawalpemilu.org#24724,"KORPRI JAYA, SUKARAME, KOTA BANDAR LAMPUNG, LAMPUNG",13,95,70,165
https://kawalpemilu.org#24724,"KORPRI JAYA, SUKARAME, KOTA BANDAR LAMPUNG, LAMPUNG",14,63,115,178
https://kawalpemilu.org#24724,"KORPRI JAYA, SUKARAME, KOTA BANDAR LAMPUNG, LAMPUNG",15,102,118,220
https://kawalpemilu.org#87224,"WAY DADI BARU, SUKARAME, KOTA BANDAR LAMPUNG, LAMPUNG",1,111,124,235
https://kawalpemilu.org#87224,"WAY DADI BARU, SUKARAME, KOTA BANDAR LAMPUNG, LAMPUNG",2,145,140,285
https://kawalpemilu.org#87224,"WAY DADI BARU, SUKARAME, KOTA BANDAR LAMPUNG, LAMPUNG",3,106,85,191
https://kawalpemilu.org#87224,"WAY DADI BARU, SUKARAME, KOTA BANDAR LAMPUNG, LAMPUNG",4,128,124,252
https://kawalpemilu.org#87224,"WAY DADI BARU, SUKARAME, KOTA BANDAR LAMPUNG, LAMPUNG",5,122,91,213
https://kawalpemilu.org#87224,"WAY DADI BARU, SUKARAME, KOTA BANDAR LAMPUNG, LAMPUNG",6,116,114,230
https://kawalpemilu.org#87224,"WAY DADI BARU, SUKARAME, KOTA BANDAR LAMPUNG, LAMPUNG",7,83,123,206
https://kawalpemilu.org#87224,"WAY DADI BARU, SUKARAME, KOTA BANDAR LAMPUNG, LAMPUNG",8,91,98,189
https://kawalpemilu.org#87224,"WAY DADI BARU, SUKARAME, KOTA BANDAR LAMPUNG, LAMPUNG",9,86,129,215
https://kawalpemilu.org#87224,"WAY DADI BARU, SUKARAME, KOTA BANDAR LAMPUNG, LAMPUNG",10,87,96,183
https://kawalpemilu.org#87224,"WAY DADI BARU, SUKARAME, KOTA BANDAR LAMPUNG, LAMPUNG",11,170,116,286
https://kawalpemilu.org#87224,"WAY DADI BARU, SUKARAME, KOTA BANDAR LAMPUNG, LAMPUNG",12,120,128,248
https://kawalpemilu.org#87224,"WAY DADI BARU, SUKARAME, KOTA BANDAR LAMPUNG, LAMPUNG",13,145,147,292
https://kawalpemilu.org#87224,"WAY DADI BARU, SUKARAME, KOTA BANDAR LAMPUNG, LAMPUNG",14,134,119,253
https://kawalpemilu.org#87224,"WAY DADI BARU, SUKARAME, KOTA BANDAR LAMPUNG, LAMPUNG",15,125,169,294
https://kawalpemilu.org#87224,"WAY DADI BARU, SUKARAME, KOTA BANDAR LAMPUNG, LAMPUNG",16,132,99,7
https://kawalpemilu.org#87224,"WAY DADI BARU, SUKARAME, KOTA BANDAR LAMPUNG, LAMPUNG",17,106,149,255
https://kawalpemilu.org#87224,"WAY DADI BARU, SUKARAME, KOTA BANDAR LAMPUNG, LAMPUNG",19,78,115,193
https://kawalpemilu.org#87224,"WAY DADI BARU, SUKARAME, KOTA BANDAR LAMPUNG, LAMPUNG",20,53,68,121
https://kawalpemilu.org#87224,"WAY DADI BARU, SUKARAME, KOTA BANDAR LAMPUNG, LAMPUNG",21,87,114,201
https://kawalpemilu.org#87224,"WAY DADI BARU, SUKARAME, KOTA BANDAR LAMPUNG, LAMPUNG",22,128,123,251
https://kawalpemilu.org#87224,"WAY DADI BARU, SUKARAME, KOTA BANDAR LAMPUNG, LAMPUNG",23,132,153,285
https://kawalpemilu.org#87224,"WAY DADI BARU, SUKARAME, KOTA BANDAR LAMPUNG, LAMPUNG",24,80,119,199
https://kawalpemilu.org#87224,"WAY DADI BARU, SUKARAME, KOTA BANDAR LAMPUNG, LAMPUNG",25,70,111,181
https://kawalpemilu.org#87224,"WAY DADI BARU, SUKARAME, KOTA BANDAR LAMPUNG, LAMPUNG",26,60,111,171
https://kawalpemilu.org#87224,"WAY DADI BARU, SUKARAME, KOTA BANDAR LAMPUNG, LAMPUNG",27,53,144,197
https://kawalpemilu.org#87224,"WAY DADI BARU, SUKARAME, KOTA BANDAR LAMPUNG, LAMPUNG",28,62,163,225
https://kawalpemilu.org#87226,"KORPRI RAYA, SUKARAME, KOTA BANDAR LAMPUNG, LAMPUNG",1,73,170,243
https://kawalpemilu.org#87226,"KORPRI RAYA, SUKARAME, KOTA BANDAR LAMPUNG, LAMPUNG",2,62,195,257
https://kawalpemilu.org#87226,"KORPRI RAYA, SUKARAME, KOTA BANDAR LAMPUNG, LAMPUNG",3,63,126,189
https://kawalpemilu.org#87226,"KORPRI RAYA, SUKARAME, KOTA BANDAR LAMPUNG, LAMPUNG",4,78,136,214
https://kawalpemilu.org#87226,"KORPRI RAYA, SUKARAME, KOTA BANDAR LAMPUNG, LAMPUNG",5,24,199,223
https://kawalpemilu.org#87226,"KORPRI RAYA, SUKARAME, KOTA BANDAR LAMPUNG, LAMPUNG",6,45,144,189
https://kawalpemilu.org#87226,"KORPRI RAYA, SUKARAME, KOTA BANDAR LAMPUNG, LAMPUNG",7,73,150,223
https://kawalpemilu.org#87226,"KORPRI RAYA, SUKARAME, KOTA BANDAR LAMPUNG, LAMPUNG",8,51,139,190
https://kawalpemilu.org#87226,"KORPRI RAYA, SUKARAME, KOTA BANDAR LAMPUNG, LAMPUNG",9,82,197,279
https://kawalpemilu.org#87226,"KORPRI RAYA, SUKARAME, KOTA BANDAR LAMPUNG, LAMPUNG",10,50,135,185
https://kawalpemilu.org#87226,"KORPRI RAYA, SUKARAME, KOTA BANDAR LAMPUNG, LAMPUNG",11,59,124,183
https://kawalpemilu.org#87226,"KORPRI RAYA, SUKARAME, KOTA BANDAR LAMPUNG, LAMPUNG",13,65,104,169
https://kawalpemilu.org#87226,"KORPRI RAYA, SUKARAME, KOTA BANDAR LAMPUNG, LAMPUNG",14,63,115,178
https://kawalpemilu.org#87226,"KORPRI RAYA, SUKARAME, KOTA BANDAR LAMPUNG, LAMPUNG",15,55,65,120
https://kawalpemilu.org#87226,"KORPRI RAYA, SUKARAME, KOTA BANDAR LAMPUNG, LAMPUNG",16,72,120,192
https://kawalpemilu.org#87226,"KORPRI RAYA, SUKARAME, KOTA BANDAR LAMPUNG, LAMPUNG",17,92,105,197
https://kawalpemilu.org#87226,"KORPRI RAYA, SUKARAME, KOTA BANDAR LAMPUNG, LAMPUNG",18,56,199,255
https://kawalpemilu.org#87226,"KORPRI RAYA, SUKARAME, KOTA BANDAR LAMPUNG, LAMPUNG",19,56,142,198
https://kawalpemilu.org#87226,"KORPRI RAYA, SUKARAME, KOTA BANDAR LAMPUNG, LAMPUNG",20,63,128,191
https://kawalpemilu.org#87226,"KORPRI RAYA, SUKARAME, KOTA BANDAR LAMPUNG, LAMPUNG",21,51,118,169
https://kawalpemilu.org#24726,"GEDONG AIR, TANJUNGKARANG BARAT, KOTA BANDAR LAMPUNG, LAMPUNG",1,71,131,202
https://kawalpemilu.org#24726,"GEDONG AIR, TANJUNGKARANG BARAT, KOTA BANDAR LAMPUNG, LAMPUNG",2,169,61,230
https://kawalpemilu.org#24726,"GEDONG AIR, TANJUNGKARANG BARAT, KOTA BANDAR LAMPUNG, LAMPUNG",3,80,115,195
https://kawalpemilu.org#24726,"GEDONG AIR, TANJUNGKARANG BARAT, KOTA BANDAR LAMPUNG, LAMPUNG",4,112,97,209
https://kawalpemilu.org#24726,"GEDONG AIR, TANJUNGKARANG BARAT, KOTA BANDAR LAMPUNG, LAMPUNG",5,108,125,233
https://kawalpemilu.org#24726,"GEDONG AIR, TANJUNGKARANG BARAT, KOTA BANDAR LAMPUNG, LAMPUNG",6,71,90,161
https://kawalpemilu.org#24726,"GEDONG AIR, TANJUNGKARANG BARAT, KOTA BANDAR LAMPUNG, LAMPUNG",7,67,165,232
https://kawalpemilu.org#24726,"GEDONG AIR, TANJUNGKARANG BARAT, KOTA BANDAR LAMPUNG, LAMPUNG",8,33,76,109
https://kawalpemilu.org#24726,"GEDONG AIR, TANJUNGKARANG BARAT, KOTA BANDAR LAMPUNG, LAMPUNG",9,62,164,226
https://kawalpemilu.org#24726,"GEDONG AIR, TANJUNGKARANG BARAT, KOTA BANDAR LAMPUNG, LAMPUNG",11,138,118,256
https://kawalpemilu.org#24726,"GEDONG AIR, TANJUNGKARANG BARAT, KOTA BANDAR LAMPUNG, LAMPUNG",12,171,102,273
https://kawalpemilu.org#24726,"GEDONG AIR, TANJUNGKARANG BARAT, KOTA BANDAR LAMPUNG, LAMPUNG",13,79,91,170
https://kawalpemilu.org#24726,"GEDONG AIR, TANJUNGKARANG BARAT, KOTA BANDAR LAMPUNG, LAMPUNG",14,71,109,180
https://kawalpemilu.org#24726,"GEDONG AIR, TANJUNGKARANG BARAT, KOTA BANDAR LAMPUNG, LAMPUNG",15,81,105,186
https://kawalpemilu.org#24726,"GEDONG AIR, TANJUNGKARANG BARAT, KOTA BANDAR LAMPUNG, LAMPUNG",16,74,112,186
https://kawalpemilu.org#24726,"GEDONG AIR, TANJUNGKARANG BARAT, KOTA BANDAR LAMPUNG, LAMPUNG",17,63,73,136
https://kawalpemilu.org#24726,"GEDONG AIR, TANJUNGKARANG BARAT, KOTA BANDAR LAMPUNG, LAMPUNG",18,77,166,243
https://kawalpemilu.org#24726,"GEDONG AIR, TANJUNGKARANG BARAT, KOTA BANDAR LAMPUNG, LAMPUNG",19,77,71,148
https://kawalpemilu.org#24726,"GEDONG AIR, TANJUNGKARANG BARAT, KOTA BANDAR LAMPUNG, LAMPUNG",20,117,77,194
https://kawalpemilu.org#24726,"GEDONG AIR, TANJUNGKARANG BARAT, KOTA BANDAR LAMPUNG, LAMPUNG",21,75,40,115
https://kawalpemilu.org#24726,"GEDONG AIR, TANJUNGKARANG BARAT, KOTA BANDAR LAMPUNG, LAMPUNG",22,87,93,180
https://kawalpemilu.org#24726,"GEDONG AIR, TANJUNGKARANG BARAT, KOTA BANDAR LAMPUNG, LAMPUNG",23,100,138,238
https://kawalpemilu.org#24726,"GEDONG AIR, TANJUNGKARANG BARAT, KOTA BANDAR LAMPUNG, LAMPUNG",24,120,131,251
https://kawalpemilu.org#24726,"GEDONG AIR, TANJUNGKARANG BARAT, KOTA BANDAR LAMPUNG, LAMPUNG",25,108,133,241
https://kawalpemilu.org#24726,"GEDONG AIR, TANJUNGKARANG BARAT, KOTA BANDAR LAMPUNG, LAMPUNG",27,129,133,262
https://kawalpemilu.org#24726,"GEDONG AIR, TANJUNGKARANG BARAT, KOTA BANDAR LAMPUNG, LAMPUNG",28,106,127,233
https://kawalpemilu.org#24726,"GEDONG AIR, TANJUNGKARANG BARAT, KOTA BANDAR LAMPUNG, LAMPUNG",29,110,110,220
https://kawalpemilu.org#24726,"GEDONG AIR, TANJUNGKARANG BARAT, KOTA BANDAR LAMPUNG, LAMPUNG",30,143,112,255
https://kawalpemilu.org#24726,"GEDONG AIR, TANJUNGKARANG BARAT, KOTA BANDAR LAMPUNG, LAMPUNG",31,105,121,226
https://kawalpemilu.org#24726,"GEDONG AIR, TANJUNGKARANG BARAT, KOTA BANDAR LAMPUNG, LAMPUNG",32,122,130,252
https://kawalpemilu.org#24726,"GEDONG AIR, TANJUNGKARANG BARAT, KOTA BANDAR LAMPUNG, LAMPUNG",33,109,115,224
https://kawalpemilu.org#24726,"GEDONG AIR, TANJUNGKARANG BARAT, KOTA BANDAR LAMPUNG, LAMPUNG",34,123,144,267
https://kawalpemilu.org#24726,"GEDONG AIR, TANJUNGKARANG BARAT, KOTA BANDAR LAMPUNG, LAMPUNG",35,92,132,224
https://kawalpemilu.org#24726,"GEDONG AIR, TANJUNGKARANG BARAT, KOTA BANDAR LAMPUNG, LAMPUNG",36,73,137,210
https://kawalpemilu.org#24726,"GEDONG AIR, TANJUNGKARANG BARAT, KOTA BANDAR LAMPUNG, LAMPUNG",37,120,139,259
https://kawalpemilu.org#24726,"GEDONG AIR, TANJUNGKARANG BARAT, KOTA BANDAR LAMPUNG, LAMPUNG",38,86,110,196
https://kawalpemilu.org#24726,"GEDONG AIR, TANJUNGKARANG BARAT, KOTA BANDAR LAMPUNG, LAMPUNG",39,82,101,183
https://kawalpemilu.org#24727,"SUKAJAWA, TANJUNGKARANG BARAT, KOTA BANDAR LAMPUNG, LAMPUNG",1,94,125,219
https://kawalpemilu.org#24727,"SUKAJAWA, TANJUNGKARANG BARAT, KOTA BANDAR LAMPUNG, LAMPUNG",2,78,56,134
https://kawalpemilu.org#24727,"SUKAJAWA, TANJUNGKARANG BARAT, KOTA BANDAR LAMPUNG, LAMPUNG",3,86,95,181
https://kawalpemilu.org#24727,"SUKAJAWA, TANJUNGKARANG BARAT, KOTA BANDAR LAMPUNG, LAMPUNG",4,91,88,179
https://kawalpemilu.org#24727,"SUKAJAWA, TANJUNGKARANG BARAT, KOTA BANDAR LAMPUNG, LAMPUNG",5,76,51,127
https://kawalpemilu.org#24727,"SUKAJAWA, TANJUNGKARANG BARAT, KOTA BANDAR LAMPUNG, LAMPUNG",6,57,42,99
https://kawalpemilu.org#24727,"SUKAJAWA, TANJUNGKARANG BARAT, KOTA BANDAR LAMPUNG, LAMPUNG",7,55,175,230
https://kawalpemilu.org#24727,"SUKAJAWA, TANJUNGKARANG BARAT, KOTA BANDAR LAMPUNG, LAMPUNG",8,66,150,216
https://kawalpemilu.org#24727,"SUKAJAWA, TANJUNGKARANG BARAT, KOTA BANDAR LAMPUNG, LAMPUNG",9,69,161,226
https://kawalpemilu.org#24727,"SUKAJAWA, TANJUNGKARANG BARAT, KOTA BANDAR LAMPUNG, LAMPUNG",10,127,102,229
https://kawalpemilu.org#24727,"SUKAJAWA, TANJUNGKARANG BARAT, KOTA BANDAR LAMPUNG, LAMPUNG",11,117,117,234
https://kawalpemilu.org#24727,"SUKAJAWA, TANJUNGKARANG BARAT, KOTA BANDAR LAMPUNG, LAMPUNG",12,65,124,189
https://kawalpemilu.org#24727,"SUKAJAWA, TANJUNGKARANG BARAT, KOTA BANDAR LAMPUNG, LAMPUNG",13,64,123,187
https://kawalpemilu.org#24727,"SUKAJAWA, TANJUNGKARANG BARAT, KOTA BANDAR LAMPUNG, LAMPUNG",14,61,92,153
https://kawalpemilu.org#24727,"SUKAJAWA, TANJUNGKARANG BARAT, KOTA BANDAR LAMPUNG, LAMPUNG",15,109,139,248
https://kawalpemilu.org#24727,"SUKAJAWA, TANJUNGKARANG BARAT, KOTA BANDAR LAMPUNG, LAMPUNG",16,56,112,168
https://kawalpemilu.org#24727,"SUKAJAWA, TANJUNGKARANG BARAT, KOTA BANDAR LAMPUNG, LAMPUNG",17,92,119,211
https://kawalpemilu.org#24727,"SUKAJAWA, TANJUNGKARANG BARAT, KOTA BANDAR LAMPUNG, LAMPUNG",18,63,124,187
https://kawalpemilu.org#24727,"SUKAJAWA, TANJUNGKARANG BARAT, KOTA BANDAR LAMPUNG, LAMPUNG",19,31,89,120
https://kawalpemilu.org#24727,"SUKAJAWA, TANJUNGKARANG BARAT, KOTA BANDAR LAMPUNG, LAMPUNG",20,44,80,124
https://kawalpemilu.org#24727,"SUKAJAWA, TANJUNGKARANG BARAT, KOTA BANDAR LAMPUNG, LAMPUNG",21,55,174,229
https://kawalpemilu.org#24727,"SUKAJAWA, TANJUNGKARANG BARAT, KOTA BANDAR LAMPUNG, LAMPUNG",22,68,117,185
https://kawalpemilu.org#24727,"SUKAJAWA, TANJUNGKARANG BARAT, KOTA BANDAR LAMPUNG, LAMPUNG",23,97,106,203
https://kawalpemilu.org#24727,"SUKAJAWA, TANJUNGKARANG BARAT, KOTA BANDAR LAMPUNG, LAMPUNG",24,92,174,266
https://kawalpemilu.org#24727,"SUKAJAWA, TANJUNGKARANG BARAT, KOTA BANDAR LAMPUNG, LAMPUNG",25,101,82,183
https://kawalpemilu.org#24727,"SUKAJAWA, TANJUNGKARANG BARAT, KOTA BANDAR LAMPUNG, LAMPUNG",26,90,72,162
https://kawalpemilu.org#24727,"SUKAJAWA, TANJUNGKARANG BARAT, KOTA BANDAR LAMPUNG, LAMPUNG",27,77,76,153
https://kawalpemilu.org#24728,"SEGALAMIDER, TANJUNGKARANG BARAT, KOTA BANDAR LAMPUNG, LAMPUNG",1,40,164,204
https://kawalpemilu.org#24728,"SEGALAMIDER, TANJUNGKARANG BARAT, KOTA BANDAR LAMPUNG, LAMPUNG",2,62,164,226
https://kawalpemilu.org#24728,"SEGALAMIDER, TANJUNGKARANG BARAT, KOTA BANDAR LAMPUNG, LAMPUNG",3,56,117,173
https://kawalpemilu.org#24728,"SEGALAMIDER, TANJUNGKARANG BARAT, KOTA BANDAR LAMPUNG, LAMPUNG",4,47,132,179
https://kawalpemilu.org#24728,"SEGALAMIDER, TANJUNGKARANG BARAT, KOTA BANDAR LAMPUNG, LAMPUNG",5,98,152,250
https://kawalpemilu.org#24728,"SEGALAMIDER, TANJUNGKARANG BARAT, KOTA BANDAR LAMPUNG, LAMPUNG",6,86,166,252
https://kawalpemilu.org#24728,"SEGALAMIDER, TANJUNGKARANG BARAT, KOTA BANDAR LAMPUNG, LAMPUNG",7,57,121,178
https://kawalpemilu.org#24728,"SEGALAMIDER, TANJUNGKARANG BARAT, KOTA BANDAR LAMPUNG, LAMPUNG",8,74,100,174
https://kawalpemilu.org#24728,"SEGALAMIDER, TANJUNGKARANG BARAT, KOTA BANDAR LAMPUNG, LAMPUNG",9,66,151,217
https://kawalpemilu.org#24728,"SEGALAMIDER, TANJUNGKARANG BARAT, KOTA BANDAR LAMPUNG, LAMPUNG",10,42,110,152
https://kawalpemilu.org#24728,"SEGALAMIDER, TANJUNGKARANG BARAT, KOTA BANDAR LAMPUNG, LAMPUNG",11,45,100,145
https://kawalpemilu.org#24728,"SEGALAMIDER, TANJUNGKARANG BARAT, KOTA BANDAR LAMPUNG, LAMPUNG",12,83,113,196
https://kawalpemilu.org#24728,"SEGALAMIDER, TANJUNGKARANG BARAT, KOTA BANDAR LAMPUNG, LAMPUNG",13,87,101,188
https://kawalpemilu.org#24728,"SEGALAMIDER, TANJUNGKARANG BARAT, KOTA BANDAR LAMPUNG, LAMPUNG",14,142,117,259
https://kawalpemilu.org#24728,"SEGALAMIDER, TANJUNGKARANG BARAT, KOTA BANDAR LAMPUNG, LAMPUNG",15,107,152,259
https://kawalpemilu.org#24728,"SEGALAMIDER, TANJUNGKARANG BARAT, KOTA BANDAR LAMPUNG, LAMPUNG",16,119,122,241
https://kawalpemilu.org#24728,"SEGALAMIDER, TANJUNGKARANG BARAT, KOTA BANDAR LAMPUNG, LAMPUNG",17,101,96,197
https://kawalpemilu.org#24728,"SEGALAMIDER, TANJUNGKARANG BARAT, KOTA BANDAR LAMPUNG, LAMPUNG",18,111,89,200
https://kawalpemilu.org#24728,"SEGALAMIDER, TANJUNGKARANG BARAT, KOTA BANDAR LAMPUNG, LAMPUNG",19,78,76,154
https://kawalpemilu.org#24728,"SEGALAMIDER, TANJUNGKARANG BARAT, KOTA BANDAR LAMPUNG, LAMPUNG",20,73,104,177
https://kawalpemilu.org#24728,"SEGALAMIDER, TANJUNGKARANG BARAT, KOTA BANDAR LAMPUNG, LAMPUNG",21,57,118,175
https://kawalpemilu.org#24728,"SEGALAMIDER, TANJUNGKARANG BARAT, KOTA BANDAR LAMPUNG, LAMPUNG",22,87,125,212
https://kawalpemilu.org#24728,"SEGALAMIDER, TANJUNGKARANG BARAT, KOTA BANDAR LAMPUNG, LAMPUNG",23,83,125,208
https://kawalpemilu.org#24728,"SEGALAMIDER, TANJUNGKARANG BARAT, KOTA BANDAR LAMPUNG, LAMPUNG",24,89,106,195
https://kawalpemilu.org#24728,"SEGALAMIDER, TANJUNGKARANG BARAT, KOTA BANDAR LAMPUNG, LAMPUNG",25,81,181,262
https://kawalpemilu.org#24728,"SEGALAMIDER, TANJUNGKARANG BARAT, KOTA BANDAR LAMPUNG, LAMPUNG",26,80,163,243
https://kawalpemilu.org#24728,"SEGALAMIDER, TANJUNGKARANG BARAT, KOTA BANDAR LAMPUNG, LAMPUNG",27,103,119,222
https://kawalpemilu.org#24728,"SEGALAMIDER, TANJUNGKARANG BARAT, KOTA BANDAR LAMPUNG, LAMPUNG",28,116,91,207
https://kawalpemilu.org#24728,"SEGALAMIDER, TANJUNGKARANG BARAT, KOTA BANDAR LAMPUNG, LAMPUNG",29,106,78,0
https://kawalpemilu.org#24728,"SEGALAMIDER, TANJUNGKARANG BARAT, KOTA BANDAR LAMPUNG, LAMPUNG",30,144,143,0
https://kawalpemilu.org#24728,"SEGALAMIDER, TANJUNGKARANG BARAT, KOTA BANDAR LAMPUNG, LAMPUNG",31,13,166,179
https://kawalpemilu.org#24728,"SEGALAMIDER, TANJUNGKARANG BARAT, KOTA BANDAR LAMPUNG, LAMPUNG",32,50,77,127
https://kawalpemilu.org#24728,"SEGALAMIDER, TANJUNGKARANG BARAT, KOTA BANDAR LAMPUNG, LAMPUNG",33,0,0,0
https://kawalpemilu.org#24729,"SUSUNAN BARU, TANJUNGKARANG BARAT, KOTA BANDAR LAMPUNG, LAMPUNG",1,116,126,242
https://kawalpemilu.org#24729,"SUSUNAN BARU, TANJUNGKARANG BARAT, KOTA BANDAR LAMPUNG, LAMPUNG",2,111,80,191
https://kawalpemilu.org#24729,"SUSUNAN BARU, TANJUNGKARANG BARAT, KOTA BANDAR LAMPUNG, LAMPUNG",3,125,113,238
https://kawalpemilu.org#24729,"SUSUNAN BARU, TANJUNGKARANG BARAT, KOTA BANDAR LAMPUNG, LAMPUNG",4,94,100,194
https://kawalpemilu.org#24729,"SUSUNAN BARU, TANJUNGKARANG BARAT, KOTA BANDAR LAMPUNG, LAMPUNG",5,109,142,251
https://kawalpemilu.org#24729,"SUSUNAN BARU, TANJUNGKARANG BARAT, KOTA BANDAR LAMPUNG, LAMPUNG",6,88,122,210
https://kawalpemilu.org#24729,"SUSUNAN BARU, TANJUNGKARANG BARAT, KOTA BANDAR LAMPUNG, LAMPUNG",7,136,125,261
https://kawalpemilu.org#24729,"SUSUNAN BARU, TANJUNGKARANG BARAT, KOTA BANDAR LAMPUNG, LAMPUNG",8,105,112,217
https://kawalpemilu.org#24729,"SUSUNAN BARU, TANJUNGKARANG BARAT, KOTA BANDAR LAMPUNG, LAMPUNG",9,107,89,196
https://kawalpemilu.org#24729,"SUSUNAN BARU, TANJUNGKARANG BARAT, KOTA BANDAR LAMPUNG, LAMPUNG",10,78,124,202
https://kawalpemilu.org#24729,"SUSUNAN BARU, TANJUNGKARANG BARAT, KOTA BANDAR LAMPUNG, LAMPUNG",11,101,159,260
https://kawalpemilu.org#24729,"SUSUNAN BARU, TANJUNGKARANG BARAT, KOTA BANDAR LAMPUNG, LAMPUNG",12,78,167,245
https://kawalpemilu.org#24730,"KELAPA TIGA PERMAI, TANJUNGKARANG BARAT, KOTA BANDAR LAMPUNG, LAMPUNG",1,87,40,127
https://kawalpemilu.org#24730,"KELAPA TIGA PERMAI, TANJUNGKARANG BARAT, KOTA BANDAR LAMPUNG, LAMPUNG",2,81,153,234
https://kawalpemilu.org#24730,"KELAPA TIGA PERMAI, TANJUNGKARANG BARAT, KOTA BANDAR LAMPUNG, LAMPUNG",3,52,133,185
https://kawalpemilu.org#24730,"KELAPA TIGA PERMAI, TANJUNGKARANG BARAT, KOTA BANDAR LAMPUNG, LAMPUNG",4,35,105,140
https://kawalpemilu.org#24730,"KELAPA TIGA PERMAI, TANJUNGKARANG BARAT, KOTA BANDAR LAMPUNG, LAMPUNG",5,73,179,252
https://kawalpemilu.org#24730,"KELAPA TIGA PERMAI, TANJUNGKARANG BARAT, KOTA BANDAR LAMPUNG, LAMPUNG",6,39,124,163
https://kawalpemilu.org#24730,"KELAPA TIGA PERMAI, TANJUNGKARANG BARAT, KOTA BANDAR LAMPUNG, LAMPUNG",7,46,192,238
https://kawalpemilu.org#24730,"KELAPA TIGA PERMAI, TANJUNGKARANG BARAT, KOTA BANDAR LAMPUNG, LAMPUNG",8,36,115,151
https://kawalpemilu.org#24730,"KELAPA TIGA PERMAI, TANJUNGKARANG BARAT, KOTA BANDAR LAMPUNG, LAMPUNG",9,51,208,259
https://kawalpemilu.org#24730,"KELAPA TIGA PERMAI, TANJUNGKARANG BARAT, KOTA BANDAR LAMPUNG, LAMPUNG",10,27,115,142
https://kawalpemilu.org#24730,"KELAPA TIGA PERMAI, TANJUNGKARANG BARAT, KOTA BANDAR LAMPUNG, LAMPUNG",11,60,142,202
https://kawalpemilu.org#24730,"KELAPA TIGA PERMAI, TANJUNGKARANG BARAT, KOTA BANDAR LAMPUNG, LAMPUNG",12,51,118,169
https://kawalpemilu.org#24730,"KELAPA TIGA PERMAI, TANJUNGKARANG BARAT, KOTA BANDAR LAMPUNG, LAMPUNG",13,58,128,186
https://kawalpemilu.org#24731,"SUKADANA HAM, TANJUNGKARANG BARAT, KOTA BANDAR LAMPUNG, LAMPUNG",1,69,102,171
https://kawalpemilu.org#24731,"SUKADANA HAM, TANJUNGKARANG BARAT, KOTA BANDAR LAMPUNG, LAMPUNG",2,58,124,182
https://kawalpemilu.org#24731,"SUKADANA HAM, TANJUNGKARANG BARAT, KOTA BANDAR LAMPUNG, LAMPUNG",3,95,92,187
https://kawalpemilu.org#24731,"SUKADANA HAM, TANJUNGKARANG BARAT, KOTA BANDAR LAMPUNG, LAMPUNG",4,67,84,151
https://kawalpemilu.org#24731,"SUKADANA HAM, TANJUNGKARANG BARAT, KOTA BANDAR LAMPUNG, LAMPUNG",5,36,166,202
https://kawalpemilu.org#24731,"SUKADANA HAM, TANJUNGKARANG BARAT, KOTA BANDAR LAMPUNG, LAMPUNG",6,48,214,262
https://kawalpemilu.org#24731,"SUKADANA HAM, TANJUNGKARANG BARAT, KOTA BANDAR LAMPUNG, LAMPUNG",7,59,138,197
https://kawalpemilu.org#24731,"SUKADANA HAM, TANJUNGKARANG BARAT, KOTA BANDAR LAMPUNG, LAMPUNG",8,99,145,244
https://kawalpemilu.org#24731,"SUKADANA HAM, TANJUNGKARANG BARAT, KOTA BANDAR LAMPUNG, LAMPUNG",9,88,145,233
https://kawalpemilu.org#24731,"SUKADANA HAM, TANJUNGKARANG BARAT, KOTA BANDAR LAMPUNG, LAMPUNG",10,91,127,118
https://kawalpemilu.org#24731,"SUKADANA HAM, TANJUNGKARANG BARAT, KOTA BANDAR LAMPUNG, LAMPUNG",11,79,94,173
https://kawalpemilu.org#24731,"SUKADANA HAM, TANJUNGKARANG BARAT, KOTA BANDAR LAMPUNG, LAMPUNG",12,103,128,231
https://kawalpemilu.org#24731,"SUKADANA HAM, TANJUNGKARANG BARAT, KOTA BANDAR LAMPUNG, LAMPUNG",13,70,143,213
https://kawalpemilu.org#87228,"SUKAJAWA BARU, TANJUNGKARANG BARAT, KOTA BANDAR LAMPUNG, LAMPUNG",1,48,53,101
https://kawalpemilu.org#87228,"SUKAJAWA BARU, TANJUNGKARANG BARAT, KOTA BANDAR LAMPUNG, LAMPUNG",2,46,109,155
https://kawalpemilu.org#87228,"SUKAJAWA BARU, TANJUNGKARANG BARAT, KOTA BANDAR LAMPUNG, LAMPUNG",3,73,154,227
https://kawalpemilu.org#87228,"SUKAJAWA BARU, TANJUNGKARANG BARAT, KOTA BANDAR LAMPUNG, LAMPUNG",4,94,134,228
https://kawalpemilu.org#87228,"SUKAJAWA BARU, TANJUNGKARANG BARAT, KOTA BANDAR LAMPUNG, LAMPUNG",5,83,145,228
https://kawalpemilu.org#87228,"SUKAJAWA BARU, TANJUNGKARANG BARAT, KOTA BANDAR LAMPUNG, LAMPUNG",6,70,148,218
https://kawalpemilu.org#87228,"SUKAJAWA BARU, TANJUNGKARANG BARAT, KOTA BANDAR LAMPUNG, LAMPUNG",7,113,128,241
https://kawalpemilu.org#87228,"SUKAJAWA BARU, TANJUNGKARANG BARAT, KOTA BANDAR LAMPUNG, LAMPUNG",8,81,85,166
https://kawalpemilu.org#87228,"SUKAJAWA BARU, TANJUNGKARANG BARAT, KOTA BANDAR LAMPUNG, LAMPUNG",9,110,95,205
https://kawalpemilu.org#87228,"SUKAJAWA BARU, TANJUNGKARANG BARAT, KOTA BANDAR LAMPUNG, LAMPUNG",10,69,100,169
https://kawalpemilu.org#87228,"SUKAJAWA BARU, TANJUNGKARANG BARAT, KOTA BANDAR LAMPUNG, LAMPUNG",11,75,186,261
https://kawalpemilu.org#87228,"SUKAJAWA BARU, TANJUNGKARANG BARAT, KOTA BANDAR LAMPUNG, LAMPUNG",12,80,166,246
https://kawalpemilu.org#87228,"SUKAJAWA BARU, TANJUNGKARANG BARAT, KOTA BANDAR LAMPUNG, LAMPUNG",13,47,70,117
https://kawalpemilu.org#87228,"SUKAJAWA BARU, TANJUNGKARANG BARAT, KOTA BANDAR LAMPUNG, LAMPUNG",14,76,184,260
https://kawalpemilu.org#87228,"SUKAJAWA BARU, TANJUNGKARANG BARAT, KOTA BANDAR LAMPUNG, LAMPUNG",15,45,98,143
https://kawalpemilu.org#87228,"SUKAJAWA BARU, TANJUNGKARANG BARAT, KOTA BANDAR LAMPUNG, LAMPUNG",16,45,98,143
https://kawalpemilu.org#87228,"SUKAJAWA BARU, TANJUNGKARANG BARAT, KOTA BANDAR LAMPUNG, LAMPUNG",17,78,142,220
https://kawalpemilu.org#87228,"SUKAJAWA BARU, TANJUNGKARANG BARAT, KOTA BANDAR LAMPUNG, LAMPUNG",18,67,85,152
https://kawalpemilu.org#24733,"PANJANG SELATAN, PANJANG, KOTA BANDAR LAMPUNG, LAMPUNG",1,134,93,227
https://kawalpemilu.org#24733,"PANJANG SELATAN, PANJANG, KOTA BANDAR LAMPUNG, LAMPUNG",4,105,73,178
https://kawalpemilu.org#24733,"PANJANG SELATAN, PANJANG, KOTA BANDAR LAMPUNG, LAMPUNG",5,94,43,137
https://kawalpemilu.org#24733,"PANJANG SELATAN, PANJANG, KOTA BANDAR LAMPUNG, LAMPUNG",6,124,65,189
https://kawalpemilu.org#24733,"PANJANG SELATAN, PANJANG, KOTA BANDAR LAMPUNG, LAMPUNG",7,113,70,183
https://kawalpemilu.org#24733,"PANJANG SELATAN, PANJANG, KOTA BANDAR LAMPUNG, LAMPUNG",8,136,35,171
https://kawalpemilu.org#24733,"PANJANG SELATAN, PANJANG, KOTA BANDAR LAMPUNG, LAMPUNG",9,140,52,192
https://kawalpemilu.org#24733,"PANJANG SELATAN, PANJANG, KOTA BANDAR LAMPUNG, LAMPUNG",10,157,50,207
https://kawalpemilu.org#24733,"PANJANG SELATAN, PANJANG, KOTA BANDAR LAMPUNG, LAMPUNG",11,137,53,190
https://kawalpemilu.org#24733,"PANJANG SELATAN, PANJANG, KOTA BANDAR LAMPUNG, LAMPUNG",12,125,127,252
https://kawalpemilu.org#24733,"PANJANG SELATAN, PANJANG, KOTA BANDAR LAMPUNG, LAMPUNG",13,139,98,237
https://kawalpemilu.org#24733,"PANJANG SELATAN, PANJANG, KOTA BANDAR LAMPUNG, LAMPUNG",14,181,93,274
https://kawalpemilu.org#24733,"PANJANG SELATAN, PANJANG, KOTA BANDAR LAMPUNG, LAMPUNG",15,195,84,279
https://kawalpemilu.org#24733,"PANJANG SELATAN, PANJANG, KOTA BANDAR LAMPUNG, LAMPUNG",16,166,89,255
https://kawalpemilu.org#24733,"PANJANG SELATAN, PANJANG, KOTA BANDAR LAMPUNG, LAMPUNG",17,163,79,242
https://kawalpemilu.org#24733,"PANJANG SELATAN, PANJANG, KOTA BANDAR LAMPUNG, LAMPUNG",18,157,48,205
https://kawalpemilu.org#24733,"PANJANG SELATAN, PANJANG, KOTA BANDAR LAMPUNG, LAMPUNG",19,165,65,230
https://kawalpemilu.org#24733,"PANJANG SELATAN, PANJANG, KOTA BANDAR LAMPUNG, LAMPUNG",20,163,66,229
https://kawalpemilu.org#24733,"PANJANG SELATAN, PANJANG, KOTA BANDAR LAMPUNG, LAMPUNG",21,159,68,227
https://kawalpemilu.org#24733,"PANJANG SELATAN, PANJANG, KOTA BANDAR LAMPUNG, LAMPUNG",22,128,71,199
https://kawalpemilu.org#24733,"PANJANG SELATAN, PANJANG, KOTA BANDAR LAMPUNG, LAMPUNG",23,128,64,192
https://kawalpemilu.org#24733,"PANJANG SELATAN, PANJANG, KOTA BANDAR LAMPUNG, LAMPUNG",24,73,82,155
https://kawalpemilu.org#24733,"PANJANG SELATAN, PANJANG, KOTA BANDAR LAMPUNG, LAMPUNG",25,101,91,192
https://kawalpemilu.org#24733,"PANJANG SELATAN, PANJANG, KOTA BANDAR LAMPUNG, LAMPUNG",26,76,81,157
https://kawalpemilu.org#24733,"PANJANG SELATAN, PANJANG, KOTA BANDAR LAMPUNG, LAMPUNG",27,89,76,165
https://kawalpemilu.org#24733,"PANJANG SELATAN, PANJANG, KOTA BANDAR LAMPUNG, LAMPUNG",28,81,83,164
https://kawalpemilu.org#24733,"PANJANG SELATAN, PANJANG, KOTA BANDAR LAMPUNG, LAMPUNG",29,111,48,159
https://kawalpemilu.org#24733,"PANJANG SELATAN, PANJANG, KOTA BANDAR LAMPUNG, LAMPUNG",30,133,126,259
https://kawalpemilu.org#24733,"PANJANG SELATAN, PANJANG, KOTA BANDAR LAMPUNG, LAMPUNG",31,135,85,220
https://kawalpemilu.org#24733,"PANJANG SELATAN, PANJANG, KOTA BANDAR LAMPUNG, LAMPUNG",32,104,103,207
https://kawalpemilu.org#24733,"PANJANG SELATAN, PANJANG, KOTA BANDAR LAMPUNG, LAMPUNG",33,140,79,219
https://kawalpemilu.org#24733,"PANJANG SELATAN, PANJANG, KOTA BANDAR LAMPUNG, LAMPUNG",34,62,114,176
https://kawalpemilu.org#24734,"SRENGSEM, PANJANG, KOTA BANDAR LAMPUNG, LAMPUNG",1,100,57,157
https://kawalpemilu.org#24734,"SRENGSEM, PANJANG, KOTA BANDAR LAMPUNG, LAMPUNG",2,119,74,193
https://kawalpemilu.org#24734,"SRENGSEM, PANJANG, KOTA BANDAR LAMPUNG, LAMPUNG",3,102,58,160
https://kawalpemilu.org#24734,"SRENGSEM, PANJANG, KOTA BANDAR LAMPUNG, LAMPUNG",4,63,70,133
https://kawalpemilu.org#24734,"SRENGSEM, PANJANG, KOTA BANDAR LAMPUNG, LAMPUNG",5,128,85,213
https://kawalpemilu.org#24734,"SRENGSEM, PANJANG, KOTA BANDAR LAMPUNG, LAMPUNG",6,83,106,189
https://kawalpemilu.org#24734,"SRENGSEM, PANJANG, KOTA BANDAR LAMPUNG, LAMPUNG",7,79,85,164
https://kawalpemilu.org#24734,"SRENGSEM, PANJANG, KOTA BANDAR LAMPUNG, LAMPUNG",8,103,87,190
https://kawalpemilu.org#24734,"SRENGSEM, PANJANG, KOTA BANDAR LAMPUNG, LAMPUNG",9,104,119,223
https://kawalpemilu.org#24734,"SRENGSEM, PANJANG, KOTA BANDAR LAMPUNG, LAMPUNG",10,67,40,107
https://kawalpemilu.org#24734,"SRENGSEM, PANJANG, KOTA BANDAR LAMPUNG, LAMPUNG",11,66,42,108
https://kawalpemilu.org#24734,"SRENGSEM, PANJANG, KOTA BANDAR LAMPUNG, LAMPUNG",12,85,88,173
https://kawalpemilu.org#24734,"SRENGSEM, PANJANG, KOTA BANDAR LAMPUNG, LAMPUNG",13,80,82,162
https://kawalpemilu.org#24734,"SRENGSEM, PANJANG, KOTA BANDAR LAMPUNG, LAMPUNG",14,88,56,144
https://kawalpemilu.org#24734,"SRENGSEM, PANJANG, KOTA BANDAR LAMPUNG, LAMPUNG",15,74,45,119
https://kawalpemilu.org#24734,"SRENGSEM, PANJANG, KOTA BANDAR LAMPUNG, LAMPUNG",16,85,98,183
https://kawalpemilu.org#24734,"SRENGSEM, PANJANG, KOTA BANDAR LAMPUNG, LAMPUNG",18,153,77,230
https://kawalpemilu.org#24734,"SRENGSEM, PANJANG, KOTA BANDAR LAMPUNG, LAMPUNG",19,136,90,226
https://kawalpemilu.org#24734,"SRENGSEM, PANJANG, KOTA BANDAR LAMPUNG, LAMPUNG",20,70,33,103
https://kawalpemilu.org#24734,"SRENGSEM, PANJANG, KOTA BANDAR LAMPUNG, LAMPUNG",21,85,89,174
https://kawalpemilu.org#24734,"SRENGSEM, PANJANG, KOTA BANDAR LAMPUNG, LAMPUNG",22,86,58,144
https://kawalpemilu.org#24734,"SRENGSEM, PANJANG, KOTA BANDAR LAMPUNG, LAMPUNG",23,77,69,146
https://kawalpemilu.org#24734,"SRENGSEM, PANJANG, KOTA BANDAR LAMPUNG, LAMPUNG",24,88,42,130
https://kawalpemilu.org#24735,"PANJANG UTARA, PANJANG, KOTA BANDAR LAMPUNG, LAMPUNG",1,137,58,195
https://kawalpemilu.org#24735,"PANJANG UTARA, PANJANG, KOTA BANDAR LAMPUNG, LAMPUNG",2,136,81,217
https://kawalpemilu.org#24735,"PANJANG UTARA, PANJANG, KOTA BANDAR LAMPUNG, LAMPUNG",3,101,81,182
https://kawalpemilu.org#24735,"PANJANG UTARA, PANJANG, KOTA BANDAR LAMPUNG, LAMPUNG",4,107,99,206
https://kawalpemilu.org#24735,"PANJANG UTARA, PANJANG, KOTA BANDAR LAMPUNG, LAMPUNG",5,68,167,235
https://kawalpemilu.org#24735,"PANJANG UTARA, PANJANG, KOTA BANDAR LAMPUNG, LAMPUNG",6,64,111,175
https://kawalpemilu.org#24735,"PANJANG UTARA, PANJANG, KOTA BANDAR LAMPUNG, LAMPUNG",7,124,110,234
https://kawalpemilu.org#24735,"PANJANG UTARA, PANJANG, KOTA BANDAR LAMPUNG, LAMPUNG",8,76,107,183
https://kawalpemilu.org#24735,"PANJANG UTARA, PANJANG, KOTA BANDAR LAMPUNG, LAMPUNG",9,76,118,194
https://kawalpemilu.org#24735,"PANJANG UTARA, PANJANG, KOTA BANDAR LAMPUNG, LAMPUNG",10,79,85,164
https://kawalpemilu.org#24735,"PANJANG UTARA, PANJANG, KOTA BANDAR LAMPUNG, LAMPUNG",11,116,95,211
https://kawalpemilu.org#24735,"PANJANG UTARA, PANJANG, KOTA BANDAR LAMPUNG, LAMPUNG",12,100,113,213
https://kawalpemilu.org#24735,"PANJANG UTARA, PANJANG, KOTA BANDAR LAMPUNG, LAMPUNG",13,86,93,179
https://kawalpemilu.org#24735,"PANJANG UTARA, PANJANG, KOTA BANDAR LAMPUNG, LAMPUNG",14,113,73,186
https://kawalpemilu.org#24735,"PANJANG UTARA, PANJANG, KOTA BANDAR LAMPUNG, LAMPUNG",15,123,103,226
https://kawalpemilu.org#24735,"PANJANG UTARA, PANJANG, KOTA BANDAR LAMPUNG, LAMPUNG",16,124,128,252
https://kawalpemilu.org#24735,"PANJANG UTARA, PANJANG, KOTA BANDAR LAMPUNG, LAMPUNG",17,91,112,203
https://kawalpemilu.org#24735,"PANJANG UTARA, PANJANG, KOTA BANDAR LAMPUNG, LAMPUNG",18,78,110,188
https://kawalpemilu.org#24735,"PANJANG UTARA, PANJANG, KOTA BANDAR LAMPUNG, LAMPUNG",19,137,104,241
https://kawalpemilu.org#24735,"PANJANG UTARA, PANJANG, KOTA BANDAR LAMPUNG, LAMPUNG",20,150,71,221
https://kawalpemilu.org#24735,"PANJANG UTARA, PANJANG, KOTA BANDAR LAMPUNG, LAMPUNG",21,123,78,201
https://kawalpemilu.org#24735,"PANJANG UTARA, PANJANG, KOTA BANDAR LAMPUNG, LAMPUNG",22,136,78,214
https://kawalpemilu.org#24735,"PANJANG UTARA, PANJANG, KOTA BANDAR LAMPUNG, LAMPUNG",23,90,112,202
https://kawalpemilu.org#24735,"PANJANG UTARA, PANJANG, KOTA BANDAR LAMPUNG, LAMPUNG",24,104,128,232
https://kawalpemilu.org#24735,"PANJANG UTARA, PANJANG, KOTA BANDAR LAMPUNG, LAMPUNG",25,128,105,233
https://kawalpemilu.org#24735,"PANJANG UTARA, PANJANG, KOTA BANDAR LAMPUNG, LAMPUNG",26,105,68,173
https://kawalpemilu.org#24735,"PANJANG UTARA, PANJANG, KOTA BANDAR LAMPUNG, LAMPUNG",27,154,47,201
https://kawalpemilu.org#24735,"PANJANG UTARA, PANJANG, KOTA BANDAR LAMPUNG, LAMPUNG",28,117,99,216
https://kawalpemilu.org#24735,"PANJANG UTARA, PANJANG, KOTA BANDAR LAMPUNG, LAMPUNG",29,92,102,194
https://kawalpemilu.org#24735,"PANJANG UTARA, PANJANG, KOTA BANDAR LAMPUNG, LAMPUNG",30,82,133,215
https://kawalpemilu.org#24735,"PANJANG UTARA, PANJANG, KOTA BANDAR LAMPUNG, LAMPUNG",31,97,87,184
https://kawalpemilu.org#24735,"PANJANG UTARA, PANJANG, KOTA BANDAR LAMPUNG, LAMPUNG",32,128,70,198
https://kawalpemilu.org#24735,"PANJANG UTARA, PANJANG, KOTA BANDAR LAMPUNG, LAMPUNG",33,162,64,226
https://kawalpemilu.org#24735,"PANJANG UTARA, PANJANG, KOTA BANDAR LAMPUNG, LAMPUNG",34,161,99,260
https://kawalpemilu.org#24736,"PIDADA, PANJANG, KOTA BANDAR LAMPUNG, LAMPUNG",1,83,66,149
https://kawalpemilu.org#24736,"PIDADA, PANJANG, KOTA BANDAR LAMPUNG, LAMPUNG",2,70,115,185
https://kawalpemilu.org#24736,"PIDADA, PANJANG, KOTA BANDAR LAMPUNG, LAMPUNG",3,62,82,145
https://kawalpemilu.org#24736,"PIDADA, PANJANG, KOTA BANDAR LAMPUNG, LAMPUNG",4,114,124,238
https://kawalpemilu.org#24736,"PIDADA, PANJANG, KOTA BANDAR LAMPUNG, LAMPUNG",5,97,88,185
https://kawalpemilu.org#24736,"PIDADA, PANJANG, KOTA BANDAR LAMPUNG, LAMPUNG",6,100,103,203
https://kawalpemilu.org#24736,"PIDADA, PANJANG, KOTA BANDAR LAMPUNG, LAMPUNG",7,85,120,205
https://kawalpemilu.org#24736,"PIDADA, PANJANG, KOTA BANDAR LAMPUNG, LAMPUNG",8,138,94,232
https://kawalpemilu.org#24736,"PIDADA, PANJANG, KOTA BANDAR LAMPUNG, LAMPUNG",9,104,89,193
https://kawalpemilu.org#24736,"PIDADA, PANJANG, KOTA BANDAR LAMPUNG, LAMPUNG",10,130,63,193
https://kawalpemilu.org#24736,"PIDADA, PANJANG, KOTA BANDAR LAMPUNG, LAMPUNG",11,130,54,184
https://kawalpemilu.org#24736,"PIDADA, PANJANG, KOTA BANDAR LAMPUNG, LAMPUNG",12,112,135,247
https://kawalpemilu.org#24736,"PIDADA, PANJANG, KOTA BANDAR LAMPUNG, LAMPUNG",13,105,105,210
https://kawalpemilu.org#24736,"PIDADA, PANJANG, KOTA BANDAR LAMPUNG, LAMPUNG",14,108,123,231
https://kawalpemilu.org#24736,"PIDADA, PANJANG, KOTA BANDAR LAMPUNG, LAMPUNG",15,112,125,237
https://kawalpemilu.org#24736,"PIDADA, PANJANG, KOTA BANDAR LAMPUNG, LAMPUNG",16,125,88,213
https://kawalpemilu.org#24736,"PIDADA, PANJANG, KOTA BANDAR LAMPUNG, LAMPUNG",17,144,114,258
https://kawalpemilu.org#24736,"PIDADA, PANJANG, KOTA BANDAR LAMPUNG, LAMPUNG",18,116,80,196
https://kawalpemilu.org#24736,"PIDADA, PANJANG, KOTA BANDAR LAMPUNG, LAMPUNG",19,115,97,212
https://kawalpemilu.org#24736,"PIDADA, PANJANG, KOTA BANDAR LAMPUNG, LAMPUNG",20,151,78,229
https://kawalpemilu.org#24736,"PIDADA, PANJANG, KOTA BANDAR LAMPUNG, LAMPUNG",21,115,101,116
https://kawalpemilu.org#24736,"PIDADA, PANJANG, KOTA BANDAR LAMPUNG, LAMPUNG",22,92,149,242
https://kawalpemilu.org#24736,"PIDADA, PANJANG, KOTA BANDAR LAMPUNG, LAMPUNG",23,85,127,212
https://kawalpemilu.org#24736,"PIDADA, PANJANG, KOTA BANDAR LAMPUNG, LAMPUNG",24,103,117,220
https://kawalpemilu.org#24736,"PIDADA, PANJANG, KOTA BANDAR LAMPUNG, LAMPUNG",25,95,117,212
https://kawalpemilu.org#24736,"PIDADA, PANJANG, KOTA BANDAR LAMPUNG, LAMPUNG",26,102,133,235
https://kawalpemilu.org#24736,"PIDADA, PANJANG, KOTA BANDAR LAMPUNG, LAMPUNG",27,129,86,215
https://kawalpemilu.org#24736,"PIDADA, PANJANG, KOTA BANDAR LAMPUNG, LAMPUNG",28,93,35,128
https://kawalpemilu.org#24736,"PIDADA, PANJANG, KOTA BANDAR LAMPUNG, LAMPUNG",29,114,75,189
https://kawalpemilu.org#24739,"KARANG MARITIM, PANJANG, KOTA BANDAR LAMPUNG, LAMPUNG",1,136,54,190
https://kawalpemilu.org#24739,"KARANG MARITIM, PANJANG, KOTA BANDAR LAMPUNG, LAMPUNG",2,122,40,162
https://kawalpemilu.org#24739,"KARANG MARITIM, PANJANG, KOTA BANDAR LAMPUNG, LAMPUNG",3,142,91,233
https://kawalpemilu.org#24739,"KARANG MARITIM, PANJANG, KOTA BANDAR LAMPUNG, LAMPUNG",4,107,53,160
https://kawalpemilu.org#24739,"KARANG MARITIM, PANJANG, KOTA BANDAR LAMPUNG, LAMPUNG",5,160,59,219
https://kawalpemilu.org#24739,"KARANG MARITIM, PANJANG, KOTA BANDAR LAMPUNG, LAMPUNG",6,102,48,150
https://kawalpemilu.org#24739,"KARANG MARITIM, PANJANG, KOTA BANDAR LAMPUNG, LAMPUNG",7,147,45,192
https://kawalpemilu.org#24739,"KARANG MARITIM, PANJANG, KOTA BANDAR LAMPUNG, LAMPUNG",9,123,57,180
https://kawalpemilu.org#24739,"KARANG MARITIM, PANJANG, KOTA BANDAR LAMPUNG, LAMPUNG",10,131,20,151
https://kawalpemilu.org#24739,"KARANG MARITIM, PANJANG, KOTA BANDAR LAMPUNG, LAMPUNG",11,116,51,167
https://kawalpemilu.org#24739,"KARANG MARITIM, PANJANG, KOTA BANDAR LAMPUNG, LAMPUNG",12,100,77,177
https://kawalpemilu.org#24739,"KARANG MARITIM, PANJANG, KOTA BANDAR LAMPUNG, LAMPUNG",13,89,71,160
https://kawalpemilu.org#24739,"KARANG MARITIM, PANJANG, KOTA BANDAR LAMPUNG, LAMPUNG",14,153,58,211
https://kawalpemilu.org#24739,"KARANG MARITIM, PANJANG, KOTA BANDAR LAMPUNG, LAMPUNG",15,132,72,204
https://kawalpemilu.org#24739,"KARANG MARITIM, PANJANG, KOTA BANDAR LAMPUNG, LAMPUNG",16,102,115,217
https://kawalpemilu.org#24739,"KARANG MARITIM, PANJANG, KOTA BANDAR LAMPUNG, LAMPUNG",17,135,83,218
https://kawalpemilu.org#24739,"KARANG MARITIM, PANJANG, KOTA BANDAR LAMPUNG, LAMPUNG",18,116,110,226
https://kawalpemilu.org#24739,"KARANG MARITIM, PANJANG, KOTA BANDAR LAMPUNG, LAMPUNG",19,82,64,146
https://kawalpemilu.org#24739,"KARANG MARITIM, PANJANG, KOTA BANDAR LAMPUNG, LAMPUNG",20,109,139,248
https://kawalpemilu.org#24739,"KARANG MARITIM, PANJANG, KOTA BANDAR LAMPUNG, LAMPUNG",21,116,101,217
https://kawalpemilu.org#24739,"KARANG MARITIM, PANJANG, KOTA BANDAR LAMPUNG, LAMPUNG",22,136,125,261
https://kawalpemilu.org#24739,"KARANG MARITIM, PANJANG, KOTA BANDAR LAMPUNG, LAMPUNG",23,116,97,213
https://kawalpemilu.org#24739,"KARANG MARITIM, PANJANG, KOTA BANDAR LAMPUNG, LAMPUNG",24,140,86,226
https://kawalpemilu.org#24739,"KARANG MARITIM, PANJANG, KOTA BANDAR LAMPUNG, LAMPUNG",25,112,86,198
https://kawalpemilu.org#24739,"KARANG MARITIM, PANJANG, KOTA BANDAR LAMPUNG, LAMPUNG",26,148,76,224
https://kawalpemilu.org#24739,"KARANG MARITIM, PANJANG, KOTA BANDAR LAMPUNG, LAMPUNG",27,136,107,243
https://kawalpemilu.org#24774,"KETAPANG, PANJANG, KOTA BANDAR LAMPUNG, LAMPUNG",1,115,139,254
https://kawalpemilu.org#24774,"KETAPANG, PANJANG, KOTA BANDAR LAMPUNG, LAMPUNG",2,136,93,229
https://kawalpemilu.org#24774,"KETAPANG, PANJANG, KOTA BANDAR LAMPUNG, LAMPUNG",3,102,150,252
https://kawalpemilu.org#24774,"KETAPANG, PANJANG, KOTA BANDAR LAMPUNG, LAMPUNG",4,100,88,188
https://kawalpemilu.org#24774,"KETAPANG, PANJANG, KOTA BANDAR LAMPUNG, LAMPUNG",5,124,90,214
https://kawalpemilu.org#24774,"KETAPANG, PANJANG, KOTA BANDAR LAMPUNG, LAMPUNG",6,153,67,220
https://kawalpemilu.org#24774,"KETAPANG, PANJANG, KOTA BANDAR LAMPUNG, LAMPUNG",9,144,86,230
https://kawalpemilu.org#24775,"WAY LUNIK, PANJANG, KOTA BANDAR LAMPUNG, LAMPUNG",1,169,85,0
https://kawalpemilu.org#24775,"WAY LUNIK, PANJANG, KOTA BANDAR LAMPUNG, LAMPUNG",2,111,54,165
https://kawalpemilu.org#24775,"WAY LUNIK, PANJANG, KOTA BANDAR LAMPUNG, LAMPUNG",3,153,46,199
https://kawalpemilu.org#24775,"WAY LUNIK, PANJANG, KOTA BANDAR LAMPUNG, LAMPUNG",4,154,66,220
https://kawalpemilu.org#24775,"WAY LUNIK, PANJANG, KOTA BANDAR LAMPUNG, LAMPUNG",5,166,67,233
https://kawalpemilu.org#24775,"WAY LUNIK, PANJANG, KOTA BANDAR LAMPUNG, LAMPUNG",6,154,67,221
https://kawalpemilu.org#24775,"WAY LUNIK, PANJANG, KOTA BANDAR LAMPUNG, LAMPUNG",7,189,78,267
https://kawalpemilu.org#24775,"WAY LUNIK, PANJANG, KOTA BANDAR LAMPUNG, LAMPUNG",8,117,119,236
https://kawalpemilu.org#24775,"WAY LUNIK, PANJANG, KOTA BANDAR LAMPUNG, LAMPUNG",9,144,69,213
https://kawalpemilu.org#24775,"WAY LUNIK, PANJANG, KOTA BANDAR LAMPUNG, LAMPUNG",10,115,68,183
https://kawalpemilu.org#24775,"WAY LUNIK, PANJANG, KOTA BANDAR LAMPUNG, LAMPUNG",11,122,62,184
https://kawalpemilu.org#24775,"WAY LUNIK, PANJANG, KOTA BANDAR LAMPUNG, LAMPUNG",12,202,48,250
https://kawalpemilu.org#24775,"WAY LUNIK, PANJANG, KOTA BANDAR LAMPUNG, LAMPUNG",13,128,37,165
https://kawalpemilu.org#24775,"WAY LUNIK, PANJANG, KOTA BANDAR LAMPUNG, LAMPUNG",14,118,40,158
https://kawalpemilu.org#24775,"WAY LUNIK, PANJANG, KOTA BANDAR LAMPUNG, LAMPUNG",15,131,64,195
https://kawalpemilu.org#24775,"WAY LUNIK, PANJANG, KOTA BANDAR LAMPUNG, LAMPUNG",16,89,34,123
https://kawalpemilu.org#24775,"WAY LUNIK, PANJANG, KOTA BANDAR LAMPUNG, LAMPUNG",17,186,70,256
https://kawalpemilu.org#24775,"WAY LUNIK, PANJANG, KOTA BANDAR LAMPUNG, LAMPUNG",18,115,75,190
https://kawalpemilu.org#24775,"WAY LUNIK, PANJANG, KOTA BANDAR LAMPUNG, LAMPUNG",19,157,85,242
https://kawalpemilu.org#24775,"WAY LUNIK, PANJANG, KOTA BANDAR LAMPUNG, LAMPUNG",20,147,82,229
https://kawalpemilu.org#24775,"WAY LUNIK, PANJANG, KOTA BANDAR LAMPUNG, LAMPUNG",21,109,56,165
https://kawalpemilu.org#24775,"WAY LUNIK, PANJANG, KOTA BANDAR LAMPUNG, LAMPUNG",22,130,60,190
https://kawalpemilu.org#24775,"WAY LUNIK, PANJANG, KOTA BANDAR LAMPUNG, LAMPUNG",23,92,75,167
https://kawalpemilu.org#87230,"KETAPANG KUALA, PANJANG, KOTA BANDAR LAMPUNG, LAMPUNG",1,95,68,163
https://kawalpemilu.org#87230,"KETAPANG KUALA, PANJANG, KOTA BANDAR LAMPUNG, LAMPUNG",2,107,94,201
https://kawalpemilu.org#87230,"KETAPANG KUALA, PANJANG, KOTA BANDAR LAMPUNG, LAMPUNG",3,147,97,243
https://kawalpemilu.org#87230,"KETAPANG KUALA, PANJANG, KOTA BANDAR LAMPUNG, LAMPUNG",4,136,68,204
https://kawalpemilu.org#87230,"KETAPANG KUALA, PANJANG, KOTA BANDAR LAMPUNG, LAMPUNG",5,138,75,213
https://kawalpemilu.org#87230,"KETAPANG KUALA, PANJANG, KOTA BANDAR LAMPUNG, LAMPUNG",6,95,36,131
https://kawalpemilu.org#87230,"KETAPANG KUALA, PANJANG, KOTA BANDAR LAMPUNG, LAMPUNG",7,89,46,135
https://kawalpemilu.org#87230,"KETAPANG KUALA, PANJANG, KOTA BANDAR LAMPUNG, LAMPUNG",8,140,59,199
https://kawalpemilu.org#24742,"KOTA BARU, TANJUNGKARANG TIMUR, KOTA BANDAR LAMPUNG, LAMPUNG",1,67,81,148
https://kawalpemilu.org#24742,"KOTA BARU, TANJUNGKARANG TIMUR, KOTA BANDAR LAMPUNG, LAMPUNG",2,81,125,206
https://kawalpemilu.org#24742,"KOTA BARU, TANJUNGKARANG TIMUR, KOTA BANDAR LAMPUNG, LAMPUNG",3,53,139,192
https://kawalpemilu.org#24742,"KOTA BARU, TANJUNGKARANG TIMUR, KOTA BANDAR LAMPUNG, LAMPUNG",4,97,133,230
https://kawalpemilu.org#24742,"KOTA BARU, TANJUNGKARANG TIMUR, KOTA BANDAR LAMPUNG, LAMPUNG",5,111,139,250
https://kawalpemilu.org#24742,"KOTA BARU, TANJUNGKARANG TIMUR, KOTA BANDAR LAMPUNG, LAMPUNG",6,113,134,247
https://kawalpemilu.org#24742,"KOTA BARU, TANJUNGKARANG TIMUR, KOTA BANDAR LAMPUNG, LAMPUNG",7,65,130,201
https://kawalpemilu.org#24742,"KOTA BARU, TANJUNGKARANG TIMUR, KOTA BANDAR LAMPUNG, LAMPUNG",8,40,120,160
https://kawalpemilu.org#24742,"KOTA BARU, TANJUNGKARANG TIMUR, KOTA BANDAR LAMPUNG, LAMPUNG",9,58,113,171
https://kawalpemilu.org#24742,"KOTA BARU, TANJUNGKARANG TIMUR, KOTA BANDAR LAMPUNG, LAMPUNG",10,65,102,167
https://kawalpemilu.org#24742,"KOTA BARU, TANJUNGKARANG TIMUR, KOTA BANDAR LAMPUNG, LAMPUNG",11,42,148,190
https://kawalpemilu.org#24742,"KOTA BARU, TANJUNGKARANG TIMUR, KOTA BANDAR LAMPUNG, LAMPUNG",12,32,108,140
https://kawalpemilu.org#24742,"KOTA BARU, TANJUNGKARANG TIMUR, KOTA BANDAR LAMPUNG, LAMPUNG",13,68,130,198
https://kawalpemilu.org#24742,"KOTA BARU, TANJUNGKARANG TIMUR, KOTA BANDAR LAMPUNG, LAMPUNG",14,117,91,208
https://kawalpemilu.org#24742,"KOTA BARU, TANJUNGKARANG TIMUR, KOTA BANDAR LAMPUNG, LAMPUNG",15,97,125,222
https://kawalpemilu.org#24742,"KOTA BARU, TANJUNGKARANG TIMUR, KOTA BANDAR LAMPUNG, LAMPUNG",16,103,99,202
https://kawalpemilu.org#24742,"KOTA BARU, TANJUNGKARANG TIMUR, KOTA BANDAR LAMPUNG, LAMPUNG",17,107,71,178
https://kawalpemilu.org#24742,"KOTA BARU, TANJUNGKARANG TIMUR, KOTA BANDAR LAMPUNG, LAMPUNG",18,89,70,159
https://kawalpemilu.org#24742,"KOTA BARU, TANJUNGKARANG TIMUR, KOTA BANDAR LAMPUNG, LAMPUNG",19,102,150,252
https://kawalpemilu.org#24742,"KOTA BARU, TANJUNGKARANG TIMUR, KOTA BANDAR LAMPUNG, LAMPUNG",20,76,100,176
https://kawalpemilu.org#24742,"KOTA BARU, TANJUNGKARANG TIMUR, KOTA BANDAR LAMPUNG, LAMPUNG",21,102,194,296
https://kawalpemilu.org#24742,"KOTA BARU, TANJUNGKARANG TIMUR, KOTA BANDAR LAMPUNG, LAMPUNG",22,111,147,258
https://kawalpemilu.org#24742,"KOTA BARU, TANJUNGKARANG TIMUR, KOTA BANDAR LAMPUNG, LAMPUNG",23,32,137,169
https://kawalpemilu.org#24742,"KOTA BARU, TANJUNGKARANG TIMUR, KOTA BANDAR LAMPUNG, LAMPUNG",24,79,103,182
https://kawalpemilu.org#24742,"KOTA BARU, TANJUNGKARANG TIMUR, KOTA BANDAR LAMPUNG, LAMPUNG",25,72,137,209
https://kawalpemilu.org#24742,"KOTA BARU, TANJUNGKARANG TIMUR, KOTA BANDAR LAMPUNG, LAMPUNG",26,78,100,178
https://kawalpemilu.org#24742,"KOTA BARU, TANJUNGKARANG TIMUR, KOTA BANDAR LAMPUNG, LAMPUNG",27,72,112,184
https://kawalpemilu.org#24742,"KOTA BARU, TANJUNGKARANG TIMUR, KOTA BANDAR LAMPUNG, LAMPUNG",28,71,107,178
https://kawalpemilu.org#24742,"KOTA BARU, TANJUNGKARANG TIMUR, KOTA BANDAR LAMPUNG, LAMPUNG",29,100,124,224
https://kawalpemilu.org#24742,"KOTA BARU, TANJUNGKARANG TIMUR, KOTA BANDAR LAMPUNG, LAMPUNG",30,75,97,172
https://kawalpemilu.org#24742,"KOTA BARU, TANJUNGKARANG TIMUR, KOTA BANDAR LAMPUNG, LAMPUNG",31,153,87,240
https://kawalpemilu.org#24742,"KOTA BARU, TANJUNGKARANG TIMUR, KOTA BANDAR LAMPUNG, LAMPUNG",32,118,203,320
https://kawalpemilu.org#24742,"KOTA BARU, TANJUNGKARANG TIMUR, KOTA BANDAR LAMPUNG, LAMPUNG",33,90,133,223
https://kawalpemilu.org#24742,"KOTA BARU, TANJUNGKARANG TIMUR, KOTA BANDAR LAMPUNG, LAMPUNG",34,97,134,231
https://kawalpemilu.org#24742,"KOTA BARU, TANJUNGKARANG TIMUR, KOTA BANDAR LAMPUNG, LAMPUNG",35,59,110,169
https://kawalpemilu.org#24742,"KOTA BARU, TANJUNGKARANG TIMUR, KOTA BANDAR LAMPUNG, LAMPUNG",36,74,90,164
https://kawalpemilu.org#24742,"KOTA BARU, TANJUNGKARANG TIMUR, KOTA BANDAR LAMPUNG, LAMPUNG",37,75,114,189
https://kawalpemilu.org#24742,"KOTA BARU, TANJUNGKARANG TIMUR, KOTA BANDAR LAMPUNG, LAMPUNG",38,110,149,259
https://kawalpemilu.org#24743,"TANJUNG AGUNG, TANJUNGKARANG TIMUR, KOTA BANDAR LAMPUNG, LAMPUNG",1,112,118,230
https://kawalpemilu.org#24743,"TANJUNG AGUNG, TANJUNGKARANG TIMUR, KOTA BANDAR LAMPUNG, LAMPUNG",2,108,95,203
https://kawalpemilu.org#24743,"TANJUNG AGUNG, TANJUNGKARANG TIMUR, KOTA BANDAR LAMPUNG, LAMPUNG",3,52,72,124
https://kawalpemilu.org#24743,"TANJUNG AGUNG, TANJUNGKARANG TIMUR, KOTA BANDAR LAMPUNG, LAMPUNG",4,72,88,160
https://kawalpemilu.org#24743,"TANJUNG AGUNG, TANJUNGKARANG TIMUR, KOTA BANDAR LAMPUNG, LAMPUNG",5,75,73,148
https://kawalpemilu.org#24743,"TANJUNG AGUNG, TANJUNGKARANG TIMUR, KOTA BANDAR LAMPUNG, LAMPUNG",6,73,107,180
https://kawalpemilu.org#24743,"TANJUNG AGUNG, TANJUNGKARANG TIMUR, KOTA BANDAR LAMPUNG, LAMPUNG",7,80,140,220
https://kawalpemilu.org#24743,"TANJUNG AGUNG, TANJUNGKARANG TIMUR, KOTA BANDAR LAMPUNG, LAMPUNG",8,105,135,240
https://kawalpemilu.org#24743,"TANJUNG AGUNG, TANJUNGKARANG TIMUR, KOTA BANDAR LAMPUNG, LAMPUNG",9,129,109,238
https://kawalpemilu.org#24743,"TANJUNG AGUNG, TANJUNGKARANG TIMUR, KOTA BANDAR LAMPUNG, LAMPUNG",10,85,141,226
https://kawalpemilu.org#24744,"KEBON JERUK, TANJUNGKARANG TIMUR, KOTA BANDAR LAMPUNG, LAMPUNG",1,44,158,202
https://kawalpemilu.org#24744,"KEBON JERUK, TANJUNGKARANG TIMUR, KOTA BANDAR LAMPUNG, LAMPUNG",2,54,122,176
https://kawalpemilu.org#24744,"KEBON JERUK, TANJUNGKARANG TIMUR, KOTA BANDAR LAMPUNG, LAMPUNG",3,71,178,249
https://kawalpemilu.org#24744,"KEBON JERUK, TANJUNGKARANG TIMUR, KOTA BANDAR LAMPUNG, LAMPUNG",4,91,115,206
https://kawalpemilu.org#24744,"KEBON JERUK, TANJUNGKARANG TIMUR, KOTA BANDAR LAMPUNG, LAMPUNG",5,53,125,178
https://kawalpemilu.org#24744,"KEBON JERUK, TANJUNGKARANG TIMUR, KOTA BANDAR LAMPUNG, LAMPUNG",6,59,134,193
https://kawalpemilu.org#24744,"KEBON JERUK, TANJUNGKARANG TIMUR, KOTA BANDAR LAMPUNG, LAMPUNG",7,123,157,280
https://kawalpemilu.org#24744,"KEBON JERUK, TANJUNGKARANG TIMUR, KOTA BANDAR LAMPUNG, LAMPUNG",8,96,171,267
https://kawalpemilu.org#24744,"KEBON JERUK, TANJUNGKARANG TIMUR, KOTA BANDAR LAMPUNG, LAMPUNG",9,107,144,251
https://kawalpemilu.org#24744,"KEBON JERUK, TANJUNGKARANG TIMUR, KOTA BANDAR LAMPUNG, LAMPUNG",10,117,140,257
https://kawalpemilu.org#24744,"KEBON JERUK, TANJUNGKARANG TIMUR, KOTA BANDAR LAMPUNG, LAMPUNG",11,132,107,239
https://kawalpemilu.org#24744,"KEBON JERUK, TANJUNGKARANG TIMUR, KOTA BANDAR LAMPUNG, LAMPUNG",12,100,90,190
https://kawalpemilu.org#24744,"KEBON JERUK, TANJUNGKARANG TIMUR, KOTA BANDAR LAMPUNG, LAMPUNG",13,100,110,210
https://kawalpemilu.org#24744,"KEBON JERUK, TANJUNGKARANG TIMUR, KOTA BANDAR LAMPUNG, LAMPUNG",14,105,109,214
https://kawalpemilu.org#24744,"KEBON JERUK, TANJUNGKARANG TIMUR, KOTA BANDAR LAMPUNG, LAMPUNG",15,129,83,212
https://kawalpemilu.org#24744,"KEBON JERUK, TANJUNGKARANG TIMUR, KOTA BANDAR LAMPUNG, LAMPUNG",16,81,131,212
https://kawalpemilu.org#24745,"SAWAH LAMA, TANJUNGKARANG TIMUR, KOTA BANDAR LAMPUNG, LAMPUNG",1,122,75,197
https://kawalpemilu.org#24745,"SAWAH LAMA, TANJUNGKARANG TIMUR, KOTA BANDAR LAMPUNG, LAMPUNG",2,100,64,164
https://kawalpemilu.org#24745,"SAWAH LAMA, TANJUNGKARANG TIMUR, KOTA BANDAR LAMPUNG, LAMPUNG",3,111,83,194
https://kawalpemilu.org#24745,"SAWAH LAMA, TANJUNGKARANG TIMUR, KOTA BANDAR LAMPUNG, LAMPUNG",4,82,93,175
https://kawalpemilu.org#24745,"SAWAH LAMA, TANJUNGKARANG TIMUR, KOTA BANDAR LAMPUNG, LAMPUNG",5,102,90,192
https://kawalpemilu.org#24745,"SAWAH LAMA, TANJUNGKARANG TIMUR, KOTA BANDAR LAMPUNG, LAMPUNG",6,98,85,183
https://kawalpemilu.org#24745,"SAWAH LAMA, TANJUNGKARANG TIMUR, KOTA BANDAR LAMPUNG, LAMPUNG",7,89,86,175
https://kawalpemilu.org#24745,"SAWAH LAMA, TANJUNGKARANG TIMUR, KOTA BANDAR LAMPUNG, LAMPUNG",8,91,84,175
https://kawalpemilu.org#24745,"SAWAH LAMA, TANJUNGKARANG TIMUR, KOTA BANDAR LAMPUNG, LAMPUNG",9,142,127,269
https://kawalpemilu.org#24745,"SAWAH LAMA, TANJUNGKARANG TIMUR, KOTA BANDAR LAMPUNG, LAMPUNG",10,125,114,7
https://kawalpemilu.org#24745,"SAWAH LAMA, TANJUNGKARANG TIMUR, KOTA BANDAR LAMPUNG, LAMPUNG",11,102,94,196
https://kawalpemilu.org#24745,"SAWAH LAMA, TANJUNGKARANG TIMUR, KOTA BANDAR LAMPUNG, LAMPUNG",12,93,93,186
https://kawalpemilu.org#24746,"SAWAH BREBES, TANJUNGKARANG TIMUR, KOTA BANDAR LAMPUNG, LAMPUNG",1,113,128,241
https://kawalpemilu.org#24746,"SAWAH BREBES, TANJUNGKARANG TIMUR, KOTA BANDAR LAMPUNG, LAMPUNG",2,105,110,215
https://kawalpemilu.org#24746,"SAWAH BREBES, TANJUNGKARANG TIMUR, KOTA BANDAR LAMPUNG, LAMPUNG",3,58,100,158
https://kawalpemilu.org#24746,"SAWAH BREBES, TANJUNGKARANG TIMUR, KOTA BANDAR LAMPUNG, LAMPUNG",4,58,99,157
https://kawalpemilu.org#24746,"SAWAH BREBES, TANJUNGKARANG TIMUR, KOTA BANDAR LAMPUNG, LAMPUNG",5,134,82,216
https://kawalpemilu.org#24746,"SAWAH BREBES, TANJUNGKARANG TIMUR, KOTA BANDAR LAMPUNG, LAMPUNG",6,113,112,225
https://kawalpemilu.org#24746,"SAWAH BREBES, TANJUNGKARANG TIMUR, KOTA BANDAR LAMPUNG, LAMPUNG",7,120,112,232
https://kawalpemilu.org#24746,"SAWAH BREBES, TANJUNGKARANG TIMUR, KOTA BANDAR LAMPUNG, LAMPUNG",9,149,110,259
https://kawalpemilu.org#24746,"SAWAH BREBES, TANJUNGKARANG TIMUR, KOTA BANDAR LAMPUNG, LAMPUNG",10,158,101,259
https://kawalpemilu.org#24746,"SAWAH BREBES, TANJUNGKARANG TIMUR, KOTA BANDAR LAMPUNG, LAMPUNG",11,127,119,246
https://kawalpemilu.org#24746,"SAWAH BREBES, TANJUNGKARANG TIMUR, KOTA BANDAR LAMPUNG, LAMPUNG",12,135,53,188
https://kawalpemilu.org#24746,"SAWAH BREBES, TANJUNGKARANG TIMUR, KOTA BANDAR LAMPUNG, LAMPUNG",13,83,61,144
https://kawalpemilu.org#24746,"SAWAH BREBES, TANJUNGKARANG TIMUR, KOTA BANDAR LAMPUNG, LAMPUNG",14,137,95,232
https://kawalpemilu.org#24746,"SAWAH BREBES, TANJUNGKARANG TIMUR, KOTA BANDAR LAMPUNG, LAMPUNG",15,136,117,253
https://kawalpemilu.org#24746,"SAWAH BREBES, TANJUNGKARANG TIMUR, KOTA BANDAR LAMPUNG, LAMPUNG",17,118,116,234
https://kawalpemilu.org#24746,"SAWAH BREBES, TANJUNGKARANG TIMUR, KOTA BANDAR LAMPUNG, LAMPUNG",18,104,135,239
https://kawalpemilu.org#24746,"SAWAH BREBES, TANJUNGKARANG TIMUR, KOTA BANDAR LAMPUNG, LAMPUNG",19,120,59,179
https://kawalpemilu.org#24753,"DURIAN PAYUNG, TANJUNGKARANG PUSAT, KOTA BANDAR LAMPUNG, LAMPUNG",1,96,89,185
https://kawalpemilu.org#24753,"DURIAN PAYUNG, TANJUNGKARANG PUSAT, KOTA BANDAR LAMPUNG, LAMPUNG",2,119,86,205
https://kawalpemilu.org#24753,"DURIAN PAYUNG, TANJUNGKARANG PUSAT, KOTA BANDAR LAMPUNG, LAMPUNG",3,96,115,211
https://kawalpemilu.org#24753,"DURIAN PAYUNG, TANJUNGKARANG PUSAT, KOTA BANDAR LAMPUNG, LAMPUNG",4,77,153,230
https://kawalpemilu.org#24753,"DURIAN PAYUNG, TANJUNGKARANG PUSAT, KOTA BANDAR LAMPUNG, LAMPUNG",5,95,156,251
https://kawalpemilu.org#24753,"DURIAN PAYUNG, TANJUNGKARANG PUSAT, KOTA BANDAR LAMPUNG, LAMPUNG",6,92,117,209
https://kawalpemilu.org#24753,"DURIAN PAYUNG, TANJUNGKARANG PUSAT, KOTA BANDAR LAMPUNG, LAMPUNG",7,61,145,206
https://kawalpemilu.org#24753,"DURIAN PAYUNG, TANJUNGKARANG PUSAT, KOTA BANDAR LAMPUNG, LAMPUNG",8,74,130,204
https://kawalpemilu.org#24753,"DURIAN PAYUNG, TANJUNGKARANG PUSAT, KOTA BANDAR LAMPUNG, LAMPUNG",9,124,80,204
https://kawalpemilu.org#24753,"DURIAN PAYUNG, TANJUNGKARANG PUSAT, KOTA BANDAR LAMPUNG, LAMPUNG",10,88,105,193
https://kawalpemilu.org#24753,"DURIAN PAYUNG, TANJUNGKARANG PUSAT, KOTA BANDAR LAMPUNG, LAMPUNG",11,108,88,196
https://kawalpemilu.org#24753,"DURIAN PAYUNG, TANJUNGKARANG PUSAT, KOTA BANDAR LAMPUNG, LAMPUNG",12,91,117,208
https://kawalpemilu.org#24753,"DURIAN PAYUNG, TANJUNGKARANG PUSAT, KOTA BANDAR LAMPUNG, LAMPUNG",13,85,131,216
https://kawalpemilu.org#24753,"DURIAN PAYUNG, TANJUNGKARANG PUSAT, KOTA BANDAR LAMPUNG, LAMPUNG",14,69,150,219
https://kawalpemilu.org#24753,"DURIAN PAYUNG, TANJUNGKARANG PUSAT, KOTA BANDAR LAMPUNG, LAMPUNG",15,125,107,232
https://kawalpemilu.org#24753,"DURIAN PAYUNG, TANJUNGKARANG PUSAT, KOTA BANDAR LAMPUNG, LAMPUNG",16,79,152,231
https://kawalpemilu.org#24753,"DURIAN PAYUNG, TANJUNGKARANG PUSAT, KOTA BANDAR LAMPUNG, LAMPUNG",17,113,105,218
https://kawalpemilu.org#24753,"DURIAN PAYUNG, TANJUNGKARANG PUSAT, KOTA BANDAR LAMPUNG, LAMPUNG",18,134,101,235
https://kawalpemilu.org#24753,"DURIAN PAYUNG, TANJUNGKARANG PUSAT, KOTA BANDAR LAMPUNG, LAMPUNG",19,125,128,253
https://kawalpemilu.org#24753,"DURIAN PAYUNG, TANJUNGKARANG PUSAT, KOTA BANDAR LAMPUNG, LAMPUNG",20,80,130,210
https://kawalpemilu.org#24753,"DURIAN PAYUNG, TANJUNGKARANG PUSAT, KOTA BANDAR LAMPUNG, LAMPUNG",21,72,144,216
https://kawalpemilu.org#24753,"DURIAN PAYUNG, TANJUNGKARANG PUSAT, KOTA BANDAR LAMPUNG, LAMPUNG",22,123,83,206
https://kawalpemilu.org#24753,"DURIAN PAYUNG, TANJUNGKARANG PUSAT, KOTA BANDAR LAMPUNG, LAMPUNG",23,78,132,210
https://kawalpemilu.org#24753,"DURIAN PAYUNG, TANJUNGKARANG PUSAT, KOTA BANDAR LAMPUNG, LAMPUNG",24,114,89,203
https://kawalpemilu.org#24753,"DURIAN PAYUNG, TANJUNGKARANG PUSAT, KOTA BANDAR LAMPUNG, LAMPUNG",25,73,140,213
https://kawalpemilu.org#24753,"DURIAN PAYUNG, TANJUNGKARANG PUSAT, KOTA BANDAR LAMPUNG, LAMPUNG",26,112,135,247
https://kawalpemilu.org#24754,"GOTONG ROYONG, TANJUNGKARANG PUSAT, KOTA BANDAR LAMPUNG, LAMPUNG",1,69,141,210
https://kawalpemilu.org#24754,"GOTONG ROYONG, TANJUNGKARANG PUSAT, KOTA BANDAR LAMPUNG, LAMPUNG",2,69,140,209
https://kawalpemilu.org#24754,"GOTONG ROYONG, TANJUNGKARANG PUSAT, KOTA BANDAR LAMPUNG, LAMPUNG",3,71,176,247
https://kawalpemilu.org#24754,"GOTONG ROYONG, TANJUNGKARANG PUSAT, KOTA BANDAR LAMPUNG, LAMPUNG",4,95,106,201
https://kawalpemilu.org#24754,"GOTONG ROYONG, TANJUNGKARANG PUSAT, KOTA BANDAR LAMPUNG, LAMPUNG",5,84,129,213
https://kawalpemilu.org#24754,"GOTONG ROYONG, TANJUNGKARANG PUSAT, KOTA BANDAR LAMPUNG, LAMPUNG",6,118,93,211
https://kawalpemilu.org#24754,"GOTONG ROYONG, TANJUNGKARANG PUSAT, KOTA BANDAR LAMPUNG, LAMPUNG",7,117,99,216
https://kawalpemilu.org#24754,"GOTONG ROYONG, TANJUNGKARANG PUSAT, KOTA BANDAR LAMPUNG, LAMPUNG",8,77,160,237
https://kawalpemilu.org#24754,"GOTONG ROYONG, TANJUNGKARANG PUSAT, KOTA BANDAR LAMPUNG, LAMPUNG",9,78,110,188
https://kawalpemilu.org#24754,"GOTONG ROYONG, TANJUNGKARANG PUSAT, KOTA BANDAR LAMPUNG, LAMPUNG",10,111,165,276
https://kawalpemilu.org#24754,"GOTONG ROYONG, TANJUNGKARANG PUSAT, KOTA BANDAR LAMPUNG, LAMPUNG",11,94,141,235
https://kawalpemilu.org#24754,"GOTONG ROYONG, TANJUNGKARANG PUSAT, KOTA BANDAR LAMPUNG, LAMPUNG",12,119,121,240
https://kawalpemilu.org#24754,"GOTONG ROYONG, TANJUNGKARANG PUSAT, KOTA BANDAR LAMPUNG, LAMPUNG",13,70,142,212
https://kawalpemilu.org#24757,"PALAPA, TANJUNGKARANG PUSAT, KOTA BANDAR LAMPUNG, LAMPUNG",1,98,73,171
https://kawalpemilu.org#24757,"PALAPA, TANJUNGKARANG PUSAT, KOTA BANDAR LAMPUNG, LAMPUNG",2,65,153,218
https://kawalpemilu.org#24757,"PALAPA, TANJUNGKARANG PUSAT, KOTA BANDAR LAMPUNG, LAMPUNG",3,69,80,149
https://kawalpemilu.org#24757,"PALAPA, TANJUNGKARANG PUSAT, KOTA BANDAR LAMPUNG, LAMPUNG",4,87,99,186
https://kawalpemilu.org#24757,"PALAPA, TANJUNGKARANG PUSAT, KOTA BANDAR LAMPUNG, LAMPUNG",5,63,80,143
https://kawalpemilu.org#24757,"PALAPA, TANJUNGKARANG PUSAT, KOTA BANDAR LAMPUNG, LAMPUNG",6,126,63,189
https://kawalpemilu.org#24757,"PALAPA, TANJUNGKARANG PUSAT, KOTA BANDAR LAMPUNG, LAMPUNG",7,89,111,200
https://kawalpemilu.org#24757,"PALAPA, TANJUNGKARANG PUSAT, KOTA BANDAR LAMPUNG, LAMPUNG",8,79,146,225
https://kawalpemilu.org#24757,"PALAPA, TANJUNGKARANG PUSAT, KOTA BANDAR LAMPUNG, LAMPUNG",9,41,145,186
https://kawalpemilu.org#24757,"PALAPA, TANJUNGKARANG PUSAT, KOTA BANDAR LAMPUNG, LAMPUNG",10,105,114,219
https://kawalpemilu.org#24757,"PALAPA, TANJUNGKARANG PUSAT, KOTA BANDAR LAMPUNG, LAMPUNG",11,79,131,210
https://kawalpemilu.org#24757,"PALAPA, TANJUNGKARANG PUSAT, KOTA BANDAR LAMPUNG, LAMPUNG",12,70,153,223
https://kawalpemilu.org#24758,"KALIAWI, TANJUNGKARANG PUSAT, KOTA BANDAR LAMPUNG, LAMPUNG",1,107,80,187
https://kawalpemilu.org#24758,"KALIAWI, TANJUNGKARANG PUSAT, KOTA BANDAR LAMPUNG, LAMPUNG",2,79,109,188
https://kawalpemilu.org#24758,"KALIAWI, TANJUNGKARANG PUSAT, KOTA BANDAR LAMPUNG, LAMPUNG",3,146,68,214
https://kawalpemilu.org#24758,"KALIAWI, TANJUNGKARANG PUSAT, KOTA BANDAR LAMPUNG, LAMPUNG",4,94,149,243
https://kawalpemilu.org#24758,"KALIAWI, TANJUNGKARANG PUSAT, KOTA BANDAR LAMPUNG, LAMPUNG",5,89,117,206
https://kawalpemilu.org#24758,"KALIAWI, TANJUNGKARANG PUSAT, KOTA BANDAR LAMPUNG, LAMPUNG",6,79,157,236
https://kawalpemilu.org#24758,"KALIAWI, TANJUNGKARANG PUSAT, KOTA BANDAR LAMPUNG, LAMPUNG",7,53,151,204
https://kawalpemilu.org#24758,"KALIAWI, TANJUNGKARANG PUSAT, KOTA BANDAR LAMPUNG, LAMPUNG",8,96,137,233
https://kawalpemilu.org#24758,"KALIAWI, TANJUNGKARANG PUSAT, KOTA BANDAR LAMPUNG, LAMPUNG",9,69,168,237
https://kawalpemilu.org#24758,"KALIAWI, TANJUNGKARANG PUSAT, KOTA BANDAR LAMPUNG, LAMPUNG",10,61,159,220
https://kawalpemilu.org#24758,"KALIAWI, TANJUNGKARANG PUSAT, KOTA BANDAR LAMPUNG, LAMPUNG",11,62,187,249
https://kawalpemilu.org#24758,"KALIAWI, TANJUNGKARANG PUSAT, KOTA BANDAR LAMPUNG, LAMPUNG",12,47,181,228
https://kawalpemilu.org#24758,"KALIAWI, TANJUNGKARANG PUSAT, KOTA BANDAR LAMPUNG, LAMPUNG",13,51,120,171
https://kawalpemilu.org#24758,"KALIAWI, TANJUNGKARANG PUSAT, KOTA BANDAR LAMPUNG, LAMPUNG",14,53,111,164
https://kawalpemilu.org#24758,"KALIAWI, TANJUNGKARANG PUSAT, KOTA BANDAR LAMPUNG, LAMPUNG",15,92,168,260
https://kawalpemilu.org#24758,"KALIAWI, TANJUNGKARANG PUSAT, KOTA BANDAR LAMPUNG, LAMPUNG",16,84,152,236
https://kawalpemilu.org#24758,"KALIAWI, TANJUNGKARANG PUSAT, KOTA BANDAR LAMPUNG, LAMPUNG",17,75,189,264
https://kawalpemilu.org#24758,"KALIAWI, TANJUNGKARANG PUSAT, KOTA BANDAR LAMPUNG, LAMPUNG",18,54,158,212
https://kawalpemilu.org#24758,"KALIAWI, TANJUNGKARANG PUSAT, KOTA BANDAR LAMPUNG, LAMPUNG",19,62,81,143
https://kawalpemilu.org#24758,"KALIAWI, TANJUNGKARANG PUSAT, KOTA BANDAR LAMPUNG, LAMPUNG",20,59,106,165
https://kawalpemilu.org#24758,"KALIAWI, TANJUNGKARANG PUSAT, KOTA BANDAR LAMPUNG, LAMPUNG",21,57,115,172
https://kawalpemilu.org#24758,"KALIAWI, TANJUNGKARANG PUSAT, KOTA BANDAR LAMPUNG, LAMPUNG",22,63,75,138
https://kawalpemilu.org#24758,"KALIAWI, TANJUNGKARANG PUSAT, KOTA BANDAR LAMPUNG, LAMPUNG",23,48,127,175
https://kawalpemilu.org#24758,"KALIAWI, TANJUNGKARANG PUSAT, KOTA BANDAR LAMPUNG, LAMPUNG",24,48,89,137
https://kawalpemilu.org#24758,"KALIAWI, TANJUNGKARANG PUSAT, KOTA BANDAR LAMPUNG, LAMPUNG",25,149,66,215
https://kawalpemilu.org#24758,"KALIAWI, TANJUNGKARANG PUSAT, KOTA BANDAR LAMPUNG, LAMPUNG",26,146,73,219
https://kawalpemilu.org#24758,"KALIAWI, TANJUNGKARANG PUSAT, KOTA BANDAR LAMPUNG, LAMPUNG",27,83,43,128
https://kawalpemilu.org#24758,"KALIAWI, TANJUNGKARANG PUSAT, KOTA BANDAR LAMPUNG, LAMPUNG",28,112,59,171
https://kawalpemilu.org#24758,"KALIAWI, TANJUNGKARANG PUSAT, KOTA BANDAR LAMPUNG, LAMPUNG",29,48,89,137
https://kawalpemilu.org#24758,"KALIAWI, TANJUNGKARANG PUSAT, KOTA BANDAR LAMPUNG, LAMPUNG",30,65,63,128
https://kawalpemilu.org#24758,"KALIAWI, TANJUNGKARANG PUSAT, KOTA BANDAR LAMPUNG, LAMPUNG",31,61,89,150
https://kawalpemilu.org#24758,"KALIAWI, TANJUNGKARANG PUSAT, KOTA BANDAR LAMPUNG, LAMPUNG",32,75,134,209
https://kawalpemilu.org#24759,"KELAPA TIGA, TANJUNGKARANG PUSAT, KOTA BANDAR LAMPUNG, LAMPUNG",1,110,66,176
https://kawalpemilu.org#24759,"KELAPA TIGA, TANJUNGKARANG PUSAT, KOTA BANDAR LAMPUNG, LAMPUNG",2,99,91,190
https://kawalpemilu.org#24759,"KELAPA TIGA, TANJUNGKARANG PUSAT, KOTA BANDAR LAMPUNG, LAMPUNG",3,104,144,248
https://kawalpemilu.org#24759,"KELAPA TIGA, TANJUNGKARANG PUSAT, KOTA BANDAR LAMPUNG, LAMPUNG",4,89,154,243
https://kawalpemilu.org#24759,"KELAPA TIGA, TANJUNGKARANG PUSAT, KOTA BANDAR LAMPUNG, LAMPUNG",5,61,69,130
https://kawalpemilu.org#24759,"KELAPA TIGA, TANJUNGKARANG PUSAT, KOTA BANDAR LAMPUNG, LAMPUNG",6,67,120,187
https://kawalpemilu.org#24759,"KELAPA TIGA, TANJUNGKARANG PUSAT, KOTA BANDAR LAMPUNG, LAMPUNG",7,45,132,177
https://kawalpemilu.org#24759,"KELAPA TIGA, TANJUNGKARANG PUSAT, KOTA BANDAR LAMPUNG, LAMPUNG",8,83,108,191
https://kawalpemilu.org#24759,"KELAPA TIGA, TANJUNGKARANG PUSAT, KOTA BANDAR LAMPUNG, LAMPUNG",9,85,138,223
https://kawalpemilu.org#24759,"KELAPA TIGA, TANJUNGKARANG PUSAT, KOTA BANDAR LAMPUNG, LAMPUNG",10,62,136,198
https://kawalpemilu.org#24759,"KELAPA TIGA, TANJUNGKARANG PUSAT, KOTA BANDAR LAMPUNG, LAMPUNG",11,100,90,190
https://kawalpemilu.org#24759,"KELAPA TIGA, TANJUNGKARANG PUSAT, KOTA BANDAR LAMPUNG, LAMPUNG",12,122,101,223
https://kawalpemilu.org#24759,"KELAPA TIGA, TANJUNGKARANG PUSAT, KOTA BANDAR LAMPUNG, LAMPUNG",13,81,136,217
https://kawalpemilu.org#24759,"KELAPA TIGA, TANJUNGKARANG PUSAT, KOTA BANDAR LAMPUNG, LAMPUNG",14,65,158,223
https://kawalpemilu.org#24759,"KELAPA TIGA, TANJUNGKARANG PUSAT, KOTA BANDAR LAMPUNG, LAMPUNG",15,70,154,224
https://kawalpemilu.org#24759,"KELAPA TIGA, TANJUNGKARANG PUSAT, KOTA BANDAR LAMPUNG, LAMPUNG",16,37,119,156
https://kawalpemilu.org#24759,"KELAPA TIGA, TANJUNGKARANG PUSAT, KOTA BANDAR LAMPUNG, LAMPUNG",17,57,136,193
https://kawalpemilu.org#24759,"KELAPA TIGA, TANJUNGKARANG PUSAT, KOTA BANDAR LAMPUNG, LAMPUNG",18,89,145,234
https://kawalpemilu.org#24759,"KELAPA TIGA, TANJUNGKARANG PUSAT, KOTA BANDAR LAMPUNG, LAMPUNG",19,131,113,244
https://kawalpemilu.org#24759,"KELAPA TIGA, TANJUNGKARANG PUSAT, KOTA BANDAR LAMPUNG, LAMPUNG",20,67,96,163
https://kawalpemilu.org#24759,"KELAPA TIGA, TANJUNGKARANG PUSAT, KOTA BANDAR LAMPUNG, LAMPUNG",21,82,125,207
https://kawalpemilu.org#24759,"KELAPA TIGA, TANJUNGKARANG PUSAT, KOTA BANDAR LAMPUNG, LAMPUNG",22,49,149,198
https://kawalpemilu.org#24760,"KALIAWI PERSADA, TANJUNGKARANG PUSAT, KOTA BANDAR LAMPUNG, LAMPUNG",1,42,107,149
https://kawalpemilu.org#24760,"KALIAWI PERSADA, TANJUNGKARANG PUSAT, KOTA BANDAR LAMPUNG, LAMPUNG",2,40,115,155
https://kawalpemilu.org#24760,"KALIAWI PERSADA, TANJUNGKARANG PUSAT, KOTA BANDAR LAMPUNG, LAMPUNG",3,77,173,250
https://kawalpemilu.org#24760,"KALIAWI PERSADA, TANJUNGKARANG PUSAT, KOTA BANDAR LAMPUNG, LAMPUNG",4,97,173,270
https://kawalpemilu.org#24760,"KALIAWI PERSADA, TANJUNGKARANG PUSAT, KOTA BANDAR LAMPUNG, LAMPUNG",5,77,145,222
https://kawalpemilu.org#24760,"KALIAWI PERSADA, TANJUNGKARANG PUSAT, KOTA BANDAR LAMPUNG, LAMPUNG",6,69,138,207
https://kawalpemilu.org#24760,"KALIAWI PERSADA, TANJUNGKARANG PUSAT, KOTA BANDAR LAMPUNG, LAMPUNG",7,86,125,211
https://kawalpemilu.org#24760,"KALIAWI PERSADA, TANJUNGKARANG PUSAT, KOTA BANDAR LAMPUNG, LAMPUNG",8,90,156,246
https://kawalpemilu.org#24760,"KALIAWI PERSADA, TANJUNGKARANG PUSAT, KOTA BANDAR LAMPUNG, LAMPUNG",9,75,150,225
https://kawalpemilu.org#24760,"KALIAWI PERSADA, TANJUNGKARANG PUSAT, KOTA BANDAR LAMPUNG, LAMPUNG",10,62,129,191
https://kawalpemilu.org#24760,"KALIAWI PERSADA, TANJUNGKARANG PUSAT, KOTA BANDAR LAMPUNG, LAMPUNG",11,71,105,176
https://kawalpemilu.org#24762,"PASIR GINTUNG, TANJUNGKARANG PUSAT, KOTA BANDAR LAMPUNG, LAMPUNG",1,95,120,215
https://kawalpemilu.org#24762,"PASIR GINTUNG, TANJUNGKARANG PUSAT, KOTA BANDAR LAMPUNG, LAMPUNG",2,99,123,222
https://kawalpemilu.org#24762,"PASIR GINTUNG, TANJUNGKARANG PUSAT, KOTA BANDAR LAMPUNG, LAMPUNG",3,116,89,205
https://kawalpemilu.org#24762,"PASIR GINTUNG, TANJUNGKARANG PUSAT, KOTA BANDAR LAMPUNG, LAMPUNG",4,102,116,218
https://kawalpemilu.org#24762,"PASIR GINTUNG, TANJUNGKARANG PUSAT, KOTA BANDAR LAMPUNG, LAMPUNG",5,90,144,234
https://kawalpemilu.org#24762,"PASIR GINTUNG, TANJUNGKARANG PUSAT, KOTA BANDAR LAMPUNG, LAMPUNG",6,86,114,200
https://kawalpemilu.org#24762,"PASIR GINTUNG, TANJUNGKARANG PUSAT, KOTA BANDAR LAMPUNG, LAMPUNG",7,164,48,212
https://kawalpemilu.org#24762,"PASIR GINTUNG, TANJUNGKARANG PUSAT, KOTA BANDAR LAMPUNG, LAMPUNG",8,102,68,170
https://kawalpemilu.org#24762,"PASIR GINTUNG, TANJUNGKARANG PUSAT, KOTA BANDAR LAMPUNG, LAMPUNG",9,129,84,213
https://kawalpemilu.org#24762,"PASIR GINTUNG, TANJUNGKARANG PUSAT, KOTA BANDAR LAMPUNG, LAMPUNG",10,95,83,178
https://kawalpemilu.org#24762,"PASIR GINTUNG, TANJUNGKARANG PUSAT, KOTA BANDAR LAMPUNG, LAMPUNG",11,100,79,177
https://kawalpemilu.org#24762,"PASIR GINTUNG, TANJUNGKARANG PUSAT, KOTA BANDAR LAMPUNG, LAMPUNG",12,96,101,197
https://kawalpemilu.org#24762,"PASIR GINTUNG, TANJUNGKARANG PUSAT, KOTA BANDAR LAMPUNG, LAMPUNG",13,112,123,235
https://kawalpemilu.org#24762,"PASIR GINTUNG, TANJUNGKARANG PUSAT, KOTA BANDAR LAMPUNG, LAMPUNG",14,117,105,222
https://kawalpemilu.org#24762,"PASIR GINTUNG, TANJUNGKARANG PUSAT, KOTA BANDAR LAMPUNG, LAMPUNG",15,123,101,224
https://kawalpemilu.org#24762,"PASIR GINTUNG, TANJUNGKARANG PUSAT, KOTA BANDAR LAMPUNG, LAMPUNG",16,135,114,249
https://kawalpemilu.org#24762,"PASIR GINTUNG, TANJUNGKARANG PUSAT, KOTA BANDAR LAMPUNG, LAMPUNG",17,132,113,245
https://kawalpemilu.org#24765,"PESAWAHAN, TELUKBETUNG SELATAN, KOTA BANDAR LAMPUNG, LAMPUNG",1,149,6,155
https://kawalpemilu.org#24765,"PESAWAHAN, TELUKBETUNG SELATAN, KOTA BANDAR LAMPUNG, LAMPUNG",2,168,9,177
https://kawalpemilu.org#24765,"PESAWAHAN, TELUKBETUNG SELATAN, KOTA BANDAR LAMPUNG, LAMPUNG",3,174,17,191
https://kawalpemilu.org#24765,"PESAWAHAN, TELUKBETUNG SELATAN, KOTA BANDAR LAMPUNG, LAMPUNG",4,160,17,177
https://kawalpemilu.org#24765,"PESAWAHAN, TELUKBETUNG SELATAN, KOTA BANDAR LAMPUNG, LAMPUNG",5,171,29,200
https://kawalpemilu.org#24765,"PESAWAHAN, TELUKBETUNG SELATAN, KOTA BANDAR LAMPUNG, LAMPUNG",6,140,32,172
https://kawalpemilu.org#24765,"PESAWAHAN, TELUKBETUNG SELATAN, KOTA BANDAR LAMPUNG, LAMPUNG",7,119,115,234
https://kawalpemilu.org#24765,"PESAWAHAN, TELUKBETUNG SELATAN, KOTA BANDAR LAMPUNG, LAMPUNG",8,146,82,228
https://kawalpemilu.org#24765,"PESAWAHAN, TELUKBETUNG SELATAN, KOTA BANDAR LAMPUNG, LAMPUNG",9,92,43,135
https://kawalpemilu.org#24765,"PESAWAHAN, TELUKBETUNG SELATAN, KOTA BANDAR LAMPUNG, LAMPUNG",10,127,76,203
https://kawalpemilu.org#24765,"PESAWAHAN, TELUKBETUNG SELATAN, KOTA BANDAR LAMPUNG, LAMPUNG",11,143,67,210
https://kawalpemilu.org#24765,"PESAWAHAN, TELUKBETUNG SELATAN, KOTA BANDAR LAMPUNG, LAMPUNG",12,101,86,187
https://kawalpemilu.org#24765,"PESAWAHAN, TELUKBETUNG SELATAN, KOTA BANDAR LAMPUNG, LAMPUNG",13,102,45,147
https://kawalpemilu.org#24765,"PESAWAHAN, TELUKBETUNG SELATAN, KOTA BANDAR LAMPUNG, LAMPUNG",14,99,72,171
https://kawalpemilu.org#24765,"PESAWAHAN, TELUKBETUNG SELATAN, KOTA BANDAR LAMPUNG, LAMPUNG",15,142,60,202
https://kawalpemilu.org#24765,"PESAWAHAN, TELUKBETUNG SELATAN, KOTA BANDAR LAMPUNG, LAMPUNG",16,76,99,175
https://kawalpemilu.org#24765,"PESAWAHAN, TELUKBETUNG SELATAN, KOTA BANDAR LAMPUNG, LAMPUNG",17,149,51,200
https://kawalpemilu.org#24765,"PESAWAHAN, TELUKBETUNG SELATAN, KOTA BANDAR LAMPUNG, LAMPUNG",18,108,34,142
https://kawalpemilu.org#24765,"PESAWAHAN, TELUKBETUNG SELATAN, KOTA BANDAR LAMPUNG, LAMPUNG",19,108,64,172
https://kawalpemilu.org#24765,"PESAWAHAN, TELUKBETUNG SELATAN, KOTA BANDAR LAMPUNG, LAMPUNG",20,76,98,174
https://kawalpemilu.org#24765,"PESAWAHAN, TELUKBETUNG SELATAN, KOTA BANDAR LAMPUNG, LAMPUNG",21,101,115,216
https://kawalpemilu.org#24765,"PESAWAHAN, TELUKBETUNG SELATAN, KOTA BANDAR LAMPUNG, LAMPUNG",22,72,80,152
https://kawalpemilu.org#24765,"PESAWAHAN, TELUKBETUNG SELATAN, KOTA BANDAR LAMPUNG, LAMPUNG",23,81,133,214
https://kawalpemilu.org#24765,"PESAWAHAN, TELUKBETUNG SELATAN, KOTA BANDAR LAMPUNG, LAMPUNG",24,83,116,199
https://kawalpemilu.org#24765,"PESAWAHAN, TELUKBETUNG SELATAN, KOTA BANDAR LAMPUNG, LAMPUNG",25,59,114,173
https://kawalpemilu.org#24765,"PESAWAHAN, TELUKBETUNG SELATAN, KOTA BANDAR LAMPUNG, LAMPUNG",26,81,84,165
https://kawalpemilu.org#24765,"PESAWAHAN, TELUKBETUNG SELATAN, KOTA BANDAR LAMPUNG, LAMPUNG",27,53,99,152
https://kawalpemilu.org#24765,"PESAWAHAN, TELUKBETUNG SELATAN, KOTA BANDAR LAMPUNG, LAMPUNG",28,99,176,275
https://kawalpemilu.org#24765,"PESAWAHAN, TELUKBETUNG SELATAN, KOTA BANDAR LAMPUNG, LAMPUNG",29,89,124,213
https://kawalpemilu.org#24765,"PESAWAHAN, TELUKBETUNG SELATAN, KOTA BANDAR LAMPUNG, LAMPUNG",30,45,58,103
https://kawalpemilu.org#24765,"PESAWAHAN, TELUKBETUNG SELATAN, KOTA BANDAR LAMPUNG, LAMPUNG",31,122,94,216
https://kawalpemilu.org#24765,"PESAWAHAN, TELUKBETUNG SELATAN, KOTA BANDAR LAMPUNG, LAMPUNG",32,108,72,180
https://kawalpemilu.org#24765,"PESAWAHAN, TELUKBETUNG SELATAN, KOTA BANDAR LAMPUNG, LAMPUNG",33,119,70,189
https://kawalpemilu.org#24765,"PESAWAHAN, TELUKBETUNG SELATAN, KOTA BANDAR LAMPUNG, LAMPUNG",34,100,76,176
https://kawalpemilu.org#24765,"PESAWAHAN, TELUKBETUNG SELATAN, KOTA BANDAR LAMPUNG, LAMPUNG",35,131,110,241
https://kawalpemilu.org#24765,"PESAWAHAN, TELUKBETUNG SELATAN, KOTA BANDAR LAMPUNG, LAMPUNG",36,122,96,218
https://kawalpemilu.org#24766,"TELUKBETUNG, TELUKBETUNG SELATAN, KOTA BANDAR LAMPUNG, LAMPUNG",1,98,126,224
https://kawalpemilu.org#24766,"TELUKBETUNG, TELUKBETUNG SELATAN, KOTA BANDAR LAMPUNG, LAMPUNG",2,99,89,188
https://kawalpemilu.org#24766,"TELUKBETUNG, TELUKBETUNG SELATAN, KOTA BANDAR LAMPUNG, LAMPUNG",3,64,58,122
https://kawalpemilu.org#24766,"TELUKBETUNG, TELUKBETUNG SELATAN, KOTA BANDAR LAMPUNG, LAMPUNG",4,52,103,155
https://kawalpemilu.org#24766,"TELUKBETUNG, TELUKBETUNG SELATAN, KOTA BANDAR LAMPUNG, LAMPUNG",9,141,46,187
https://kawalpemilu.org#24766,"TELUKBETUNG, TELUKBETUNG SELATAN, KOTA BANDAR LAMPUNG, LAMPUNG",10,155,61,216
https://kawalpemilu.org#24766,"TELUKBETUNG, TELUKBETUNG SELATAN, KOTA BANDAR LAMPUNG, LAMPUNG",12,67,94,161
https://kawalpemilu.org#24766,"TELUKBETUNG, TELUKBETUNG SELATAN, KOTA BANDAR LAMPUNG, LAMPUNG",13,84,69,153
https://kawalpemilu.org#24766,"TELUKBETUNG, TELUKBETUNG SELATAN, KOTA BANDAR LAMPUNG, LAMPUNG",14,64,46,110
https://kawalpemilu.org#24766,"TELUKBETUNG, TELUKBETUNG SELATAN, KOTA BANDAR LAMPUNG, LAMPUNG",15,59,63,122
https://kawalpemilu.org#24766,"TELUKBETUNG, TELUKBETUNG SELATAN, KOTA BANDAR LAMPUNG, LAMPUNG",16,92,83,175
https://kawalpemilu.org#24771,"GUNUNGMAS, TELUKBETUNG SELATAN, KOTA BANDAR LAMPUNG, LAMPUNG",1,90,97,187
https://kawalpemilu.org#24771,"GUNUNGMAS, TELUKBETUNG SELATAN, KOTA BANDAR LAMPUNG, LAMPUNG",2,117,66,183
https://kawalpemilu.org#24771,"GUNUNGMAS, TELUKBETUNG SELATAN, KOTA BANDAR LAMPUNG, LAMPUNG",3,99,109,208
https://kawalpemilu.org#24771,"GUNUNGMAS, TELUKBETUNG SELATAN, KOTA BANDAR LAMPUNG, LAMPUNG",4,72,116,188
https://kawalpemilu.org#24771,"GUNUNGMAS, TELUKBETUNG SELATAN, KOTA BANDAR LAMPUNG, LAMPUNG",5,113,92,205
https://kawalpemilu.org#24771,"GUNUNGMAS, TELUKBETUNG SELATAN, KOTA BANDAR LAMPUNG, LAMPUNG",6,108,115,223
https://kawalpemilu.org#24771,"GUNUNGMAS, TELUKBETUNG SELATAN, KOTA BANDAR LAMPUNG, LAMPUNG",8,128,108,236
https://kawalpemilu.org#24771,"GUNUNGMAS, TELUKBETUNG SELATAN, KOTA BANDAR LAMPUNG, LAMPUNG",9,116,84,200
https://kawalpemilu.org#24772,"GEDONG PAKUON, TELUKBETUNG SELATAN, KOTA BANDAR LAMPUNG, LAMPUNG",1,160,61,221
https://kawalpemilu.org#24772,"GEDONG PAKUON, TELUKBETUNG SELATAN, KOTA BANDAR LAMPUNG, LAMPUNG",2,72,59,131
https://kawalpemilu.org#24772,"GEDONG PAKUON, TELUKBETUNG SELATAN, KOTA BANDAR LAMPUNG, LAMPUNG",4,91,94,185
https://kawalpemilu.org#24772,"GEDONG PAKUON, TELUKBETUNG SELATAN, KOTA BANDAR LAMPUNG, LAMPUNG",5,66,120,186
https://kawalpemilu.org#24772,"GEDONG PAKUON, TELUKBETUNG SELATAN, KOTA BANDAR LAMPUNG, LAMPUNG",6,87,89,176
https://kawalpemilu.org#24772,"GEDONG PAKUON, TELUKBETUNG SELATAN, KOTA BANDAR LAMPUNG, LAMPUNG",7,58,92,150
https://kawalpemilu.org#24772,"GEDONG PAKUON, TELUKBETUNG SELATAN, KOTA BANDAR LAMPUNG, LAMPUNG",8,58,122,180
https://kawalpemilu.org#24772,"GEDONG PAKUON, TELUKBETUNG SELATAN, KOTA BANDAR LAMPUNG, LAMPUNG",9,80,96,176
https://kawalpemilu.org#24772,"GEDONG PAKUON, TELUKBETUNG SELATAN, KOTA BANDAR LAMPUNG, LAMPUNG",10,125,67,192
https://kawalpemilu.org#24772,"GEDONG PAKUON, TELUKBETUNG SELATAN, KOTA BANDAR LAMPUNG, LAMPUNG",11,62,82,144
https://kawalpemilu.org#24772,"GEDONG PAKUON, TELUKBETUNG SELATAN, KOTA BANDAR LAMPUNG, LAMPUNG",12,87,67,154
https://kawalpemilu.org#24772,"GEDONG PAKUON, TELUKBETUNG SELATAN, KOTA BANDAR LAMPUNG, LAMPUNG",13,76,89,165
https://kawalpemilu.org#24772,"GEDONG PAKUON, TELUKBETUNG SELATAN, KOTA BANDAR LAMPUNG, LAMPUNG",14,66,91,157
https://kawalpemilu.org#24773,"TALANG, TELUKBETUNG SELATAN, KOTA BANDAR LAMPUNG, LAMPUNG",1,88,92,180
https://kawalpemilu.org#24773,"TALANG, TELUKBETUNG SELATAN, KOTA BANDAR LAMPUNG, LAMPUNG",2,115,105,220
https://kawalpemilu.org#24773,"TALANG, TELUKBETUNG SELATAN, KOTA BANDAR LAMPUNG, LAMPUNG",3,77,128,205
https://kawalpemilu.org#24773,"TALANG, TELUKBETUNG SELATAN, KOTA BANDAR LAMPUNG, LAMPUNG",4,86,86,172
https://kawalpemilu.org#24773,"TALANG, TELUKBETUNG SELATAN, KOTA BANDAR LAMPUNG, LAMPUNG",5,100,84,160
https://kawalpemilu.org#24773,"TALANG, TELUKBETUNG SELATAN, KOTA BANDAR LAMPUNG, LAMPUNG",6,116,59,175
https://kawalpemilu.org#24773,"TALANG, TELUKBETUNG SELATAN, KOTA BANDAR LAMPUNG, LAMPUNG",7,60,155,215
https://kawalpemilu.org#24773,"TALANG, TELUKBETUNG SELATAN, KOTA BANDAR LAMPUNG, LAMPUNG",8,84,93,173
https://kawalpemilu.org#24773,"TALANG, TELUKBETUNG SELATAN, KOTA BANDAR LAMPUNG, LAMPUNG",9,97,103,200
https://kawalpemilu.org#24773,"TALANG, TELUKBETUNG SELATAN, KOTA BANDAR LAMPUNG, LAMPUNG",10,66,134,200
https://kawalpemilu.org#24773,"TALANG, TELUKBETUNG SELATAN, KOTA BANDAR LAMPUNG, LAMPUNG",11,76,102,178
https://kawalpemilu.org#24773,"TALANG, TELUKBETUNG SELATAN, KOTA BANDAR LAMPUNG, LAMPUNG",12,101,102,203
https://kawalpemilu.org#24773,"TALANG, TELUKBETUNG SELATAN, KOTA BANDAR LAMPUNG, LAMPUNG",13,69,79,148
https://kawalpemilu.org#24773,"TALANG, TELUKBETUNG SELATAN, KOTA BANDAR LAMPUNG, LAMPUNG",14,85,110,195
https://kawalpemilu.org#24773,"TALANG, TELUKBETUNG SELATAN, KOTA BANDAR LAMPUNG, LAMPUNG",15,114,88,202
https://kawalpemilu.org#24773,"TALANG, TELUKBETUNG SELATAN, KOTA BANDAR LAMPUNG, LAMPUNG",16,138,77,215
https://kawalpemilu.org#24773,"TALANG, TELUKBETUNG SELATAN, KOTA BANDAR LAMPUNG, LAMPUNG",17,149,58,207
https://kawalpemilu.org#24773,"TALANG, TELUKBETUNG SELATAN, KOTA BANDAR LAMPUNG, LAMPUNG",18,116,98,214
https://kawalpemilu.org#24773,"TALANG, TELUKBETUNG SELATAN, KOTA BANDAR LAMPUNG, LAMPUNG",19,98,103,201
https://kawalpemilu.org#24773,"TALANG, TELUKBETUNG SELATAN, KOTA BANDAR LAMPUNG, LAMPUNG",20,137,74,211
https://kawalpemilu.org#24773,"TALANG, TELUKBETUNG SELATAN, KOTA BANDAR LAMPUNG, LAMPUNG",21,127,125,252
https://kawalpemilu.org#24773,"TALANG, TELUKBETUNG SELATAN, KOTA BANDAR LAMPUNG, LAMPUNG",22,92,134,226
https://kawalpemilu.org#24773,"TALANG, TELUKBETUNG SELATAN, KOTA BANDAR LAMPUNG, LAMPUNG",24,89,41,130
https://kawalpemilu.org#24773,"TALANG, TELUKBETUNG SELATAN, KOTA BANDAR LAMPUNG, LAMPUNG",25,70,97,167
https://kawalpemilu.org#24773,"TALANG, TELUKBETUNG SELATAN, KOTA BANDAR LAMPUNG, LAMPUNG",26,87,70,157
https://kawalpemilu.org#24790,"SUMUR PUTRI, TELUKBETUNG SELATAN, KOTA BANDAR LAMPUNG, LAMPUNG",1,104,126,230
https://kawalpemilu.org#24790,"SUMUR PUTRI, TELUKBETUNG SELATAN, KOTA BANDAR LAMPUNG, LAMPUNG",2,69,129,198
https://kawalpemilu.org#24790,"SUMUR PUTRI, TELUKBETUNG SELATAN, KOTA BANDAR LAMPUNG, LAMPUNG",3,114,75,189
https://kawalpemilu.org#24790,"SUMUR PUTRI, TELUKBETUNG SELATAN, KOTA BANDAR LAMPUNG, LAMPUNG",6,85,148,233
https://kawalpemilu.org#24790,"SUMUR PUTRI, TELUKBETUNG SELATAN, KOTA BANDAR LAMPUNG, LAMPUNG",7,86,143,229
https://kawalpemilu.org#24790,"SUMUR PUTRI, TELUKBETUNG SELATAN, KOTA BANDAR LAMPUNG, LAMPUNG",9,62,103,165
https://kawalpemilu.org#24790,"SUMUR PUTRI, TELUKBETUNG SELATAN, KOTA BANDAR LAMPUNG, LAMPUNG",10,78,96,174
https://kawalpemilu.org#24790,"SUMUR PUTRI, TELUKBETUNG SELATAN, KOTA BANDAR LAMPUNG, LAMPUNG",11,46,90,136
https://kawalpemilu.org#24790,"SUMUR PUTRI, TELUKBETUNG SELATAN, KOTA BANDAR LAMPUNG, LAMPUNG",12,34,80,114
https://kawalpemilu.org#24790,"SUMUR PUTRI, TELUKBETUNG SELATAN, KOTA BANDAR LAMPUNG, LAMPUNG",13,67,159,226
https://kawalpemilu.org#24790,"SUMUR PUTRI, TELUKBETUNG SELATAN, KOTA BANDAR LAMPUNG, LAMPUNG",14,41,100,141
https://kawalpemilu.org#24790,"SUMUR PUTRI, TELUKBETUNG SELATAN, KOTA BANDAR LAMPUNG, LAMPUNG",16,84,158,242
https://kawalpemilu.org#24790,"SUMUR PUTRI, TELUKBETUNG SELATAN, KOTA BANDAR LAMPUNG, LAMPUNG",17,72,72,144
https://kawalpemilu.org#24790,"SUMUR PUTRI, TELUKBETUNG SELATAN, KOTA BANDAR LAMPUNG, LAMPUNG",18,36,76,112
https://kawalpemilu.org#24790,"SUMUR PUTRI, TELUKBETUNG SELATAN, KOTA BANDAR LAMPUNG, LAMPUNG",19,31,41,72
https://kawalpemilu.org#24781,"BAKUNG, TELUKBETUNG BARAT, KOTA BANDAR LAMPUNG, LAMPUNG",1,138,59,197
https://kawalpemilu.org#24781,"BAKUNG, TELUKBETUNG BARAT, KOTA BANDAR LAMPUNG, LAMPUNG",2,95,79,174
https://kawalpemilu.org#24781,"BAKUNG, TELUKBETUNG BARAT, KOTA BANDAR LAMPUNG, LAMPUNG",3,0,0,0
https://kawalpemilu.org#24781,"BAKUNG, TELUKBETUNG BARAT, KOTA BANDAR LAMPUNG, LAMPUNG",4,80,91,171
https://kawalpemilu.org#24781,"BAKUNG, TELUKBETUNG BARAT, KOTA BANDAR LAMPUNG, LAMPUNG",5,98,65,163
https://kawalpemilu.org#24781,"BAKUNG, TELUKBETUNG BARAT, KOTA BANDAR LAMPUNG, LAMPUNG",6,137,100,237
https://kawalpemilu.org#24781,"BAKUNG, TELUKBETUNG BARAT, KOTA BANDAR LAMPUNG, LAMPUNG",7,112,114,226
https://kawalpemilu.org#24781,"BAKUNG, TELUKBETUNG BARAT, KOTA BANDAR LAMPUNG, LAMPUNG",8,99,111,210
https://kawalpemilu.org#24781,"BAKUNG, TELUKBETUNG BARAT, KOTA BANDAR LAMPUNG, LAMPUNG",9,132,116,248
https://kawalpemilu.org#24781,"BAKUNG, TELUKBETUNG BARAT, KOTA BANDAR LAMPUNG, LAMPUNG",10,98,139,237
https://kawalpemilu.org#24781,"BAKUNG, TELUKBETUNG BARAT, KOTA BANDAR LAMPUNG, LAMPUNG",12,76,118,194
https://kawalpemilu.org#24781,"BAKUNG, TELUKBETUNG BARAT, KOTA BANDAR LAMPUNG, LAMPUNG",13,111,109,220
https://kawalpemilu.org#24781,"BAKUNG, TELUKBETUNG BARAT, KOTA BANDAR LAMPUNG, LAMPUNG",14,0,0,0
https://kawalpemilu.org#24781,"BAKUNG, TELUKBETUNG BARAT, KOTA BANDAR LAMPUNG, LAMPUNG",16,63,114,177
https://kawalpemilu.org#24781,"BAKUNG, TELUKBETUNG BARAT, KOTA BANDAR LAMPUNG, LAMPUNG",17,114,130,244
https://kawalpemilu.org#24781,"BAKUNG, TELUKBETUNG BARAT, KOTA BANDAR LAMPUNG, LAMPUNG",18,89,85,174
https://kawalpemilu.org#24781,"BAKUNG, TELUKBETUNG BARAT, KOTA BANDAR LAMPUNG, LAMPUNG",19,110,148,258
https://kawalpemilu.org#24781,"BAKUNG, TELUKBETUNG BARAT, KOTA BANDAR LAMPUNG, LAMPUNG",20,105,141,246
https://kawalpemilu.org#24782,"KURIPAN, TELUKBETUNG BARAT, KOTA BANDAR LAMPUNG, LAMPUNG",1,59,94,153
https://kawalpemilu.org#24782,"KURIPAN, TELUKBETUNG BARAT, KOTA BANDAR LAMPUNG, LAMPUNG",2,61,95,156
https://kawalpemilu.org#24782,"KURIPAN, TELUKBETUNG BARAT, KOTA BANDAR LAMPUNG, LAMPUNG",3,57,148,205
https://kawalpemilu.org#24782,"KURIPAN, TELUKBETUNG BARAT, KOTA BANDAR LAMPUNG, LAMPUNG",4,37,139,176
https://kawalpemilu.org#24782,"KURIPAN, TELUKBETUNG BARAT, KOTA BANDAR LAMPUNG, LAMPUNG",5,124,130,254
https://kawalpemilu.org#24782,"KURIPAN, TELUKBETUNG BARAT, KOTA BANDAR LAMPUNG, LAMPUNG",6,121,127,248
https://kawalpemilu.org#24782,"KURIPAN, TELUKBETUNG BARAT, KOTA BANDAR LAMPUNG, LAMPUNG",7,34,122,156
https://kawalpemilu.org#24782,"KURIPAN, TELUKBETUNG BARAT, KOTA BANDAR LAMPUNG, LAMPUNG",8,50,104,154
https://kawalpemilu.org#24782,"KURIPAN, TELUKBETUNG BARAT, KOTA BANDAR LAMPUNG, LAMPUNG",9,59,73,132
https://kawalpemilu.org#24782,"KURIPAN, TELUKBETUNG BARAT, KOTA BANDAR LAMPUNG, LAMPUNG",10,88,70,158
https://kawalpemilu.org#24782,"KURIPAN, TELUKBETUNG BARAT, KOTA BANDAR LAMPUNG, LAMPUNG",11,123,78,201
https://kawalpemilu.org#24782,"KURIPAN, TELUKBETUNG BARAT, KOTA BANDAR LAMPUNG, LAMPUNG",12,125,94,219
https://kawalpemilu.org#24782,"KURIPAN, TELUKBETUNG BARAT, KOTA BANDAR LAMPUNG, LAMPUNG",13,101,106,207
https://kawalpemilu.org#24782,"KURIPAN, TELUKBETUNG BARAT, KOTA BANDAR LAMPUNG, LAMPUNG",14,110,104,214
https://kawalpemilu.org#24782,"KURIPAN, TELUKBETUNG BARAT, KOTA BANDAR LAMPUNG, LAMPUNG",15,93,74,167
https://kawalpemilu.org#24782,"KURIPAN, TELUKBETUNG BARAT, KOTA BANDAR LAMPUNG, LAMPUNG",16,113,89,202
https://kawalpemilu.org#24783,"NEGERI OLOK GADING, TELUKBETUNG BARAT, KOTA BANDAR LAMPUNG, LAMPUNG",2,68,105,173
https://kawalpemilu.org#24783,"NEGERI OLOK GADING, TELUKBETUNG BARAT, KOTA BANDAR LAMPUNG, LAMPUNG",3,84,96,180
https://kawalpemilu.org#24783,"NEGERI OLOK GADING, TELUKBETUNG BARAT, KOTA BANDAR LAMPUNG, LAMPUNG",4,51,113,164
https://kawalpemilu.org#24783,"NEGERI OLOK GADING, TELUKBETUNG BARAT, KOTA BANDAR LAMPUNG, LAMPUNG",5,27,98,125
https://kawalpemilu.org#24783,"NEGERI OLOK GADING, TELUKBETUNG BARAT, KOTA BANDAR LAMPUNG, LAMPUNG",6,31,132,163
https://kawalpemilu.org#24783,"NEGERI OLOK GADING, TELUKBETUNG BARAT, KOTA BANDAR LAMPUNG, LAMPUNG",7,43,146,189
https://kawalpemilu.org#24783,"NEGERI OLOK GADING, TELUKBETUNG BARAT, KOTA BANDAR LAMPUNG, LAMPUNG",8,40,148,188
https://kawalpemilu.org#24783,"NEGERI OLOK GADING, TELUKBETUNG BARAT, KOTA BANDAR LAMPUNG, LAMPUNG",9,66,146,212
https://kawalpemilu.org#24783,"NEGERI OLOK GADING, TELUKBETUNG BARAT, KOTA BANDAR LAMPUNG, LAMPUNG",10,67,80,147
https://kawalpemilu.org#24783,"NEGERI OLOK GADING, TELUKBETUNG BARAT, KOTA BANDAR LAMPUNG, LAMPUNG",11,88,85,173
https://kawalpemilu.org#24783,"NEGERI OLOK GADING, TELUKBETUNG BARAT, KOTA BANDAR LAMPUNG, LAMPUNG",12,69,143,212
https://kawalpemilu.org#24783,"NEGERI OLOK GADING, TELUKBETUNG BARAT, KOTA BANDAR LAMPUNG, LAMPUNG",14,86,117,203
https://kawalpemilu.org#24783,"NEGERI OLOK GADING, TELUKBETUNG BARAT, KOTA BANDAR LAMPUNG, LAMPUNG",15,123,120,243
https://kawalpemilu.org#24783,"NEGERI OLOK GADING, TELUKBETUNG BARAT, KOTA BANDAR LAMPUNG, LAMPUNG",16,103,157,260
https://kawalpemilu.org#24783,"NEGERI OLOK GADING, TELUKBETUNG BARAT, KOTA BANDAR LAMPUNG, LAMPUNG",17,34,216,250
https://kawalpemilu.org#24783,"NEGERI OLOK GADING, TELUKBETUNG BARAT, KOTA BANDAR LAMPUNG, LAMPUNG",18,75,218,293
https://kawalpemilu.org#24783,"NEGERI OLOK GADING, TELUKBETUNG BARAT, KOTA BANDAR LAMPUNG, LAMPUNG",20,231,76,307
https://kawalpemilu.org#24784,"SUKARAME II, TELUKBETUNG BARAT, KOTA BANDAR LAMPUNG, LAMPUNG",1,81,177,258
https://kawalpemilu.org#24784,"SUKARAME II, TELUKBETUNG BARAT, KOTA BANDAR LAMPUNG, LAMPUNG",2,62,177,239
https://kawalpemilu.org#24784,"SUKARAME II, TELUKBETUNG BARAT, KOTA BANDAR LAMPUNG, LAMPUNG",3,70,190,260
https://kawalpemilu.org#24784,"SUKARAME II, TELUKBETUNG BARAT, KOTA BANDAR LAMPUNG, LAMPUNG",4,73,162,235
https://kawalpemilu.org#24784,"SUKARAME II, TELUKBETUNG BARAT, KOTA BANDAR LAMPUNG, LAMPUNG",5,78,116,194
https://kawalpemilu.org#24784,"SUKARAME II, TELUKBETUNG BARAT, KOTA BANDAR LAMPUNG, LAMPUNG",6,61,137,198
https://kawalpemilu.org#24784,"SUKARAME II, TELUKBETUNG BARAT, KOTA BANDAR LAMPUNG, LAMPUNG",7,92,120,212
https://kawalpemilu.org#24784,"SUKARAME II, TELUKBETUNG BARAT, KOTA BANDAR LAMPUNG, LAMPUNG",8,108,113,221
https://kawalpemilu.org#24784,"SUKARAME II, TELUKBETUNG BARAT, KOTA BANDAR LAMPUNG, LAMPUNG",9,92,83,175
https://kawalpemilu.org#24784,"SUKARAME II, TELUKBETUNG BARAT, KOTA BANDAR LAMPUNG, LAMPUNG",10,81,100,181
https://kawalpemilu.org#24784,"SUKARAME II, TELUKBETUNG BARAT, KOTA BANDAR LAMPUNG, LAMPUNG",11,85,121,206
https://kawalpemilu.org#24784,"SUKARAME II, TELUKBETUNG BARAT, KOTA BANDAR LAMPUNG, LAMPUNG",12,117,91,208
https://kawalpemilu.org#24784,"SUKARAME II, TELUKBETUNG BARAT, KOTA BANDAR LAMPUNG, LAMPUNG",13,80,134,214
https://kawalpemilu.org#24784,"SUKARAME II, TELUKBETUNG BARAT, KOTA BANDAR LAMPUNG, LAMPUNG",14,195,43,238
https://kawalpemilu.org#24784,"SUKARAME II, TELUKBETUNG BARAT, KOTA BANDAR LAMPUNG, LAMPUNG",15,187,41,228
https://kawalpemilu.org#24784,"SUKARAME II, TELUKBETUNG BARAT, KOTA BANDAR LAMPUNG, LAMPUNG",16,81,44,125
https://kawalpemilu.org#24784,"SUKARAME II, TELUKBETUNG BARAT, KOTA BANDAR LAMPUNG, LAMPUNG",17,123,70,193
https://kawalpemilu.org#24784,"SUKARAME II, TELUKBETUNG BARAT, KOTA BANDAR LAMPUNG, LAMPUNG",18,107,129,236
https://kawalpemilu.org#24795,"BATU PUTUK, TELUKBETUNG BARAT, KOTA BANDAR LAMPUNG, LAMPUNG",1,106,18,124
https://kawalpemilu.org#24795,"BATU PUTUK, TELUKBETUNG BARAT, KOTA BANDAR LAMPUNG, LAMPUNG",2,147,105,252
https://kawalpemilu.org#24795,"BATU PUTUK, TELUKBETUNG BARAT, KOTA BANDAR LAMPUNG, LAMPUNG",3,56,144,200
https://kawalpemilu.org#24795,"BATU PUTUK, TELUKBETUNG BARAT, KOTA BANDAR LAMPUNG, LAMPUNG",4,87,118,205
https://kawalpemilu.org#24795,"BATU PUTUK, TELUKBETUNG BARAT, KOTA BANDAR LAMPUNG, LAMPUNG",5,98,77,175
https://kawalpemilu.org#24795,"BATU PUTUK, TELUKBETUNG BARAT, KOTA BANDAR LAMPUNG, LAMPUNG",6,174,79,253
https://kawalpemilu.org#24795,"BATU PUTUK, TELUKBETUNG BARAT, KOTA BANDAR LAMPUNG, LAMPUNG",7,103,71,174
https://kawalpemilu.org#24795,"BATU PUTUK, TELUKBETUNG BARAT, KOTA BANDAR LAMPUNG, LAMPUNG",8,76,30,106
https://kawalpemilu.org#24795,"BATU PUTUK, TELUKBETUNG BARAT, KOTA BANDAR LAMPUNG, LAMPUNG",9,127,52,179
https://kawalpemilu.org#24795,"BATU PUTUK, TELUKBETUNG BARAT, KOTA BANDAR LAMPUNG, LAMPUNG",10,207,35,242
https://kawalpemilu.org#24795,"BATU PUTUK, TELUKBETUNG BARAT, KOTA BANDAR LAMPUNG, LAMPUNG",11,102,15,117
https://kawalpemilu.org#24795,"BATU PUTUK, TELUKBETUNG BARAT, KOTA BANDAR LAMPUNG, LAMPUNG",12,177,28,205
https://kawalpemilu.org#24795,"BATU PUTUK, TELUKBETUNG BARAT, KOTA BANDAR LAMPUNG, LAMPUNG",13,147,69,216
https://kawalpemilu.org#24795,"BATU PUTUK, TELUKBETUNG BARAT, KOTA BANDAR LAMPUNG, LAMPUNG",14,99,64,163
https://kawalpemilu.org#24795,"BATU PUTUK, TELUKBETUNG BARAT, KOTA BANDAR LAMPUNG, LAMPUNG",15,99,104,203
https://kawalpemilu.org#24795,"BATU PUTUK, TELUKBETUNG BARAT, KOTA BANDAR LAMPUNG, LAMPUNG",16,124,36,160
https://kawalpemilu.org#24795,"BATU PUTUK, TELUKBETUNG BARAT, KOTA BANDAR LAMPUNG, LAMPUNG",17,92,45,137
https://kawalpemilu.org#24795,"BATU PUTUK, TELUKBETUNG BARAT, KOTA BANDAR LAMPUNG, LAMPUNG",18,110,60,170
https://kawalpemilu.org#24795,"BATU PUTUK, TELUKBETUNG BARAT, KOTA BANDAR LAMPUNG, LAMPUNG",19,130,63,193
https://kawalpemilu.org#24795,"BATU PUTUK, TELUKBETUNG BARAT, KOTA BANDAR LAMPUNG, LAMPUNG",20,72,82,154
https://kawalpemilu.org#24786,"KUPANG KOTA, TELUKBETUNG UTARA, KOTA BANDAR LAMPUNG, LAMPUNG",1,85,107,192
https://kawalpemilu.org#24786,"KUPANG KOTA, TELUKBETUNG UTARA, KOTA BANDAR LAMPUNG, LAMPUNG",2,93,140,233
https://kawalpemilu.org#24786,"KUPANG KOTA, TELUKBETUNG UTARA, KOTA BANDAR LAMPUNG, LAMPUNG",3,105,172,277
https://kawalpemilu.org#24786,"KUPANG KOTA, TELUKBETUNG UTARA, KOTA BANDAR LAMPUNG, LAMPUNG",4,138,92,230
https://kawalpemilu.org#24786,"KUPANG KOTA, TELUKBETUNG UTARA, KOTA BANDAR LAMPUNG, LAMPUNG",5,81,133,214
https://kawalpemilu.org#24786,"KUPANG KOTA, TELUKBETUNG UTARA, KOTA BANDAR LAMPUNG, LAMPUNG",6,57,151,208
https://kawalpemilu.org#24786,"KUPANG KOTA, TELUKBETUNG UTARA, KOTA BANDAR LAMPUNG, LAMPUNG",7,81,133,214
https://kawalpemilu.org#24786,"KUPANG KOTA, TELUKBETUNG UTARA, KOTA BANDAR LAMPUNG, LAMPUNG",8,105,93,198
https://kawalpemilu.org#24786,"KUPANG KOTA, TELUKBETUNG UTARA, KOTA BANDAR LAMPUNG, LAMPUNG",9,122,94,216
https://kawalpemilu.org#24786,"KUPANG KOTA, TELUKBETUNG UTARA, KOTA BANDAR LAMPUNG, LAMPUNG",10,114,61,175
https://kawalpemilu.org#24786,"KUPANG KOTA, TELUKBETUNG UTARA, KOTA BANDAR LAMPUNG, LAMPUNG",11,107,69,176
https://kawalpemilu.org#24786,"KUPANG KOTA, TELUKBETUNG UTARA, KOTA BANDAR LAMPUNG, LAMPUNG",12,167,86,236
https://kawalpemilu.org#24786,"KUPANG KOTA, TELUKBETUNG UTARA, KOTA BANDAR LAMPUNG, LAMPUNG",13,115,73,188
https://kawalpemilu.org#24786,"KUPANG KOTA, TELUKBETUNG UTARA, KOTA BANDAR LAMPUNG, LAMPUNG",14,71,101,172
https://kawalpemilu.org#24786,"KUPANG KOTA, TELUKBETUNG UTARA, KOTA BANDAR LAMPUNG, LAMPUNG",15,142,60,202
https://kawalpemilu.org#24786,"KUPANG KOTA, TELUKBETUNG UTARA, KOTA BANDAR LAMPUNG, LAMPUNG",16,91,69,160
https://kawalpemilu.org#24786,"KUPANG KOTA, TELUKBETUNG UTARA, KOTA BANDAR LAMPUNG, LAMPUNG",17,158,109,267
https://kawalpemilu.org#24786,"KUPANG KOTA, TELUKBETUNG UTARA, KOTA BANDAR LAMPUNG, LAMPUNG",18,168,71,239
https://kawalpemilu.org#24786,"KUPANG KOTA, TELUKBETUNG UTARA, KOTA BANDAR LAMPUNG, LAMPUNG",19,77,60,137
https://kawalpemilu.org#24786,"KUPANG KOTA, TELUKBETUNG UTARA, KOTA BANDAR LAMPUNG, LAMPUNG",20,142,47,189
https://kawalpemilu.org#24786,"KUPANG KOTA, TELUKBETUNG UTARA, KOTA BANDAR LAMPUNG, LAMPUNG",21,101,86,187
https://kawalpemilu.org#24786,"KUPANG KOTA, TELUKBETUNG UTARA, KOTA BANDAR LAMPUNG, LAMPUNG",22,63,62,125
https://kawalpemilu.org#24786,"KUPANG KOTA, TELUKBETUNG UTARA, KOTA BANDAR LAMPUNG, LAMPUNG",23,82,61,143
https://kawalpemilu.org#24786,"KUPANG KOTA, TELUKBETUNG UTARA, KOTA BANDAR LAMPUNG, LAMPUNG",24,170,90,260
https://kawalpemilu.org#24786,"KUPANG KOTA, TELUKBETUNG UTARA, KOTA BANDAR LAMPUNG, LAMPUNG",25,110,40,150
https://kawalpemilu.org#24786,"KUPANG KOTA, TELUKBETUNG UTARA, KOTA BANDAR LAMPUNG, LAMPUNG",26,58,48,106
https://kawalpemilu.org#24786,"KUPANG KOTA, TELUKBETUNG UTARA, KOTA BANDAR LAMPUNG, LAMPUNG",27,55,95,150
https://kawalpemilu.org#24788,"KUPANG RAYA, TELUKBETUNG UTARA, KOTA BANDAR LAMPUNG, LAMPUNG",1,123,61,184
https://kawalpemilu.org#24788,"KUPANG RAYA, TELUKBETUNG UTARA, KOTA BANDAR LAMPUNG, LAMPUNG",2,80,107,187
https://kawalpemilu.org#24788,"KUPANG RAYA, TELUKBETUNG UTARA, KOTA BANDAR LAMPUNG, LAMPUNG",3,132,111,243
https://kawalpemilu.org#24788,"KUPANG RAYA, TELUKBETUNG UTARA, KOTA BANDAR LAMPUNG, LAMPUNG",4,126,63,189
https://kawalpemilu.org#24788,"KUPANG RAYA, TELUKBETUNG UTARA, KOTA BANDAR LAMPUNG, LAMPUNG",5,95,86,181
https://kawalpemilu.org#24788,"KUPANG RAYA, TELUKBETUNG UTARA, KOTA BANDAR LAMPUNG, LAMPUNG",6,118,97,215
https://kawalpemilu.org#24788,"KUPANG RAYA, TELUKBETUNG UTARA, KOTA BANDAR LAMPUNG, LAMPUNG",7,133,76,209
https://kawalpemilu.org#24788,"KUPANG RAYA, TELUKBETUNG UTARA, KOTA BANDAR LAMPUNG, LAMPUNG",9,99,110,209
https://kawalpemilu.org#24788,"KUPANG RAYA, TELUKBETUNG UTARA, KOTA BANDAR LAMPUNG, LAMPUNG",10,108,115,223
https://kawalpemilu.org#24789,"KUPANG TEBA, TELUKBETUNG UTARA, KOTA BANDAR LAMPUNG, LAMPUNG",1,91,115,206
https://kawalpemilu.org#24789,"KUPANG TEBA, TELUKBETUNG UTARA, KOTA BANDAR LAMPUNG, LAMPUNG",2,99,77,176
https://kawalpemilu.org#24789,"KUPANG TEBA, TELUKBETUNG UTARA, KOTA BANDAR LAMPUNG, LAMPUNG",3,121,47,168
https://kawalpemilu.org#24789,"KUPANG TEBA, TELUKBETUNG UTARA, KOTA BANDAR LAMPUNG, LAMPUNG",4,114,78,192
https://kawalpemilu.org#24789,"KUPANG TEBA, TELUKBETUNG UTARA, KOTA BANDAR LAMPUNG, LAMPUNG",5,77,127,204
https://kawalpemilu.org#24789,"KUPANG TEBA, TELUKBETUNG UTARA, KOTA BANDAR LAMPUNG, LAMPUNG",6,90,65,155
https://kawalpemilu.org#24789,"KUPANG TEBA, TELUKBETUNG UTARA, KOTA BANDAR LAMPUNG, LAMPUNG",7,153,68,221
https://kawalpemilu.org#24789,"KUPANG TEBA, TELUKBETUNG UTARA, KOTA BANDAR LAMPUNG, LAMPUNG",8,105,54,159
https://kawalpemilu.org#24789,"KUPANG TEBA, TELUKBETUNG UTARA, KOTA BANDAR LAMPUNG, LAMPUNG",9,104,131,235
https://kawalpemilu.org#24789,"KUPANG TEBA, TELUKBETUNG UTARA, KOTA BANDAR LAMPUNG, LAMPUNG",10,111,65,176
https://kawalpemilu.org#24789,"KUPANG TEBA, TELUKBETUNG UTARA, KOTA BANDAR LAMPUNG, LAMPUNG",11,94,52,146
https://kawalpemilu.org#24789,"KUPANG TEBA, TELUKBETUNG UTARA, KOTA BANDAR LAMPUNG, LAMPUNG",12,126,33,159
https://kawalpemilu.org#24789,"KUPANG TEBA, TELUKBETUNG UTARA, KOTA BANDAR LAMPUNG, LAMPUNG",13,101,52,153
https://kawalpemilu.org#24789,"KUPANG TEBA, TELUKBETUNG UTARA, KOTA BANDAR LAMPUNG, LAMPUNG",14,102,46,148
https://kawalpemilu.org#24789,"KUPANG TEBA, TELUKBETUNG UTARA, KOTA BANDAR LAMPUNG, LAMPUNG",15,85,72,157
https://kawalpemilu.org#24789,"KUPANG TEBA, TELUKBETUNG UTARA, KOTA BANDAR LAMPUNG, LAMPUNG",16,92,89,181
https://kawalpemilu.org#24789,"KUPANG TEBA, TELUKBETUNG UTARA, KOTA BANDAR LAMPUNG, LAMPUNG",17,102,130,232
https://kawalpemilu.org#24789,"KUPANG TEBA, TELUKBETUNG UTARA, KOTA BANDAR LAMPUNG, LAMPUNG",18,132,104,236
https://kawalpemilu.org#24789,"KUPANG TEBA, TELUKBETUNG UTARA, KOTA BANDAR LAMPUNG, LAMPUNG",19,137,71,208
https://kawalpemilu.org#24789,"KUPANG TEBA, TELUKBETUNG UTARA, KOTA BANDAR LAMPUNG, LAMPUNG",20,147,65,212
https://kawalpemilu.org#24789,"KUPANG TEBA, TELUKBETUNG UTARA, KOTA BANDAR LAMPUNG, LAMPUNG",21,120,134,254
https://kawalpemilu.org#24789,"KUPANG TEBA, TELUKBETUNG UTARA, KOTA BANDAR LAMPUNG, LAMPUNG",22,118,104,224
https://kawalpemilu.org#24789,"KUPANG TEBA, TELUKBETUNG UTARA, KOTA BANDAR LAMPUNG, LAMPUNG",23,132,75,207
https://kawalpemilu.org#24789,"KUPANG TEBA, TELUKBETUNG UTARA, KOTA BANDAR LAMPUNG, LAMPUNG",24,192,55,247
https://kawalpemilu.org#24789,"KUPANG TEBA, TELUKBETUNG UTARA, KOTA BANDAR LAMPUNG, LAMPUNG",25,61,31,92
https://kawalpemilu.org#24789,"KUPANG TEBA, TELUKBETUNG UTARA, KOTA BANDAR LAMPUNG, LAMPUNG",26,87,69,156
https://kawalpemilu.org#24789,"KUPANG TEBA, TELUKBETUNG UTARA, KOTA BANDAR LAMPUNG, LAMPUNG",27,77,36,113
https://kawalpemilu.org#24789,"KUPANG TEBA, TELUKBETUNG UTARA, KOTA BANDAR LAMPUNG, LAMPUNG",28,86,172,258
https://kawalpemilu.org#24789,"KUPANG TEBA, TELUKBETUNG UTARA, KOTA BANDAR LAMPUNG, LAMPUNG",29,120,131,251
https://kawalpemilu.org#24789,"KUPANG TEBA, TELUKBETUNG UTARA, KOTA BANDAR LAMPUNG, LAMPUNG",31,121,142,263
https://kawalpemilu.org#24789,"KUPANG TEBA, TELUKBETUNG UTARA, KOTA BANDAR LAMPUNG, LAMPUNG",32,83,118,201
https://kawalpemilu.org#24789,"KUPANG TEBA, TELUKBETUNG UTARA, KOTA BANDAR LAMPUNG, LAMPUNG",33,121,124,245
https://kawalpemilu.org#24789,"KUPANG TEBA, TELUKBETUNG UTARA, KOTA BANDAR LAMPUNG, LAMPUNG",34,139,107,246
https://kawalpemilu.org#24789,"KUPANG TEBA, TELUKBETUNG UTARA, KOTA BANDAR LAMPUNG, LAMPUNG",35,119,142,261
https://kawalpemilu.org#24791,"PENGAJARAN, TELUKBETUNG UTARA, KOTA BANDAR LAMPUNG, LAMPUNG",1,57,194,251
https://kawalpemilu.org#24791,"PENGAJARAN, TELUKBETUNG UTARA, KOTA BANDAR LAMPUNG, LAMPUNG",2,71,134,205
https://kawalpemilu.org#24791,"PENGAJARAN, TELUKBETUNG UTARA, KOTA BANDAR LAMPUNG, LAMPUNG",3,86,187,273
https://kawalpemilu.org#24791,"PENGAJARAN, TELUKBETUNG UTARA, KOTA BANDAR LAMPUNG, LAMPUNG",4,112,144,256
https://kawalpemilu.org#24791,"PENGAJARAN, TELUKBETUNG UTARA, KOTA BANDAR LAMPUNG, LAMPUNG",5,121,145,266
https://kawalpemilu.org#24791,"PENGAJARAN, TELUKBETUNG UTARA, KOTA BANDAR LAMPUNG, LAMPUNG",6,49,84,133
https://kawalpemilu.org#24791,"PENGAJARAN, TELUKBETUNG UTARA, KOTA BANDAR LAMPUNG, LAMPUNG",7,69,114,183
https://kawalpemilu.org#24791,"PENGAJARAN, TELUKBETUNG UTARA, KOTA BANDAR LAMPUNG, LAMPUNG",8,105,148,253
https://kawalpemilu.org#24791,"PENGAJARAN, TELUKBETUNG UTARA, KOTA BANDAR LAMPUNG, LAMPUNG",9,135,151,286
https://kawalpemilu.org#24791,"PENGAJARAN, TELUKBETUNG UTARA, KOTA BANDAR LAMPUNG, LAMPUNG",10,107,142,249
https://kawalpemilu.org#24791,"PENGAJARAN, TELUKBETUNG UTARA, KOTA BANDAR LAMPUNG, LAMPUNG",11,89,145,234
https://kawalpemilu.org#24791,"PENGAJARAN, TELUKBETUNG UTARA, KOTA BANDAR LAMPUNG, LAMPUNG",12,39,120,159
https://kawalpemilu.org#24791,"PENGAJARAN, TELUKBETUNG UTARA, KOTA BANDAR LAMPUNG, LAMPUNG",13,94,158,252
https://kawalpemilu.org#24791,"PENGAJARAN, TELUKBETUNG UTARA, KOTA BANDAR LAMPUNG, LAMPUNG",14,86,131,217
https://kawalpemilu.org#24791,"PENGAJARAN, TELUKBETUNG UTARA, KOTA BANDAR LAMPUNG, LAMPUNG",15,76,122,198
https://kawalpemilu.org#24791,"PENGAJARAN, TELUKBETUNG UTARA, KOTA BANDAR LAMPUNG, LAMPUNG",16,55,71,126
https://kawalpemilu.org#24791,"PENGAJARAN, TELUKBETUNG UTARA, KOTA BANDAR LAMPUNG, LAMPUNG",17,28,55,83
https://kawalpemilu.org#24792,"GULAK GALIK, TELUKBETUNG UTARA, KOTA BANDAR LAMPUNG, LAMPUNG",1,34,84,118
https://kawalpemilu.org#24792,"GULAK GALIK, TELUKBETUNG UTARA, KOTA BANDAR LAMPUNG, LAMPUNG",2,121,118,239
https://kawalpemilu.org#24792,"GULAK GALIK, TELUKBETUNG UTARA, KOTA BANDAR LAMPUNG, LAMPUNG",3,100,131,231
https://kawalpemilu.org#24792,"GULAK GALIK, TELUKBETUNG UTARA, KOTA BANDAR LAMPUNG, LAMPUNG",4,42,102,144
https://kawalpemilu.org#24792,"GULAK GALIK, TELUKBETUNG UTARA, KOTA BANDAR LAMPUNG, LAMPUNG",5,86,117,203
https://kawalpemilu.org#24792,"GULAK GALIK, TELUKBETUNG UTARA, KOTA BANDAR LAMPUNG, LAMPUNG",6,97,154,251
https://kawalpemilu.org#24792,"GULAK GALIK, TELUKBETUNG UTARA, KOTA BANDAR LAMPUNG, LAMPUNG",7,94,139,233
https://kawalpemilu.org#24792,"GULAK GALIK, TELUKBETUNG UTARA, KOTA BANDAR LAMPUNG, LAMPUNG",8,121,149,270
https://kawalpemilu.org#24792,"GULAK GALIK, TELUKBETUNG UTARA, KOTA BANDAR LAMPUNG, LAMPUNG",9,110,142,252
https://kawalpemilu.org#24792,"GULAK GALIK, TELUKBETUNG UTARA, KOTA BANDAR LAMPUNG, LAMPUNG",10,97,152,249
https://kawalpemilu.org#24792,"GULAK GALIK, TELUKBETUNG UTARA, KOTA BANDAR LAMPUNG, LAMPUNG",11,46,99,145
https://kawalpemilu.org#24792,"GULAK GALIK, TELUKBETUNG UTARA, KOTA BANDAR LAMPUNG, LAMPUNG",12,72,116,188
https://kawalpemilu.org#24792,"GULAK GALIK, TELUKBETUNG UTARA, KOTA BANDAR LAMPUNG, LAMPUNG",13,85,152,237
https://kawalpemilu.org#24792,"GULAK GALIK, TELUKBETUNG UTARA, KOTA BANDAR LAMPUNG, LAMPUNG",15,92,135,227
https://kawalpemilu.org#24792,"GULAK GALIK, TELUKBETUNG UTARA, KOTA BANDAR LAMPUNG, LAMPUNG",16,62,99,161
https://kawalpemilu.org#24792,"GULAK GALIK, TELUKBETUNG UTARA, KOTA BANDAR LAMPUNG, LAMPUNG",17,77,92,169
https://kawalpemilu.org#24792,"GULAK GALIK, TELUKBETUNG UTARA, KOTA BANDAR LAMPUNG, LAMPUNG",18,95,124,219
https://kawalpemilu.org#24792,"GULAK GALIK, TELUKBETUNG UTARA, KOTA BANDAR LAMPUNG, LAMPUNG",19,112,156,268
https://kawalpemilu.org#24792,"GULAK GALIK, TELUKBETUNG UTARA, KOTA BANDAR LAMPUNG, LAMPUNG",20,93,129,222
https://kawalpemilu.org#24792,"GULAK GALIK, TELUKBETUNG UTARA, KOTA BANDAR LAMPUNG, LAMPUNG",21,116,102,218
https://kawalpemilu.org#24793,"SUMUR BATU, TELUKBETUNG UTARA, KOTA BANDAR LAMPUNG, LAMPUNG",1,86,170,256
https://kawalpemilu.org#24793,"SUMUR BATU, TELUKBETUNG UTARA, KOTA BANDAR LAMPUNG, LAMPUNG",2,122,123,245
https://kawalpemilu.org#24793,"SUMUR BATU, TELUKBETUNG UTARA, KOTA BANDAR LAMPUNG, LAMPUNG",3,111,150,261
https://kawalpemilu.org#24793,"SUMUR BATU, TELUKBETUNG UTARA, KOTA BANDAR LAMPUNG, LAMPUNG",4,141,132,273
https://kawalpemilu.org#24793,"SUMUR BATU, TELUKBETUNG UTARA, KOTA BANDAR LAMPUNG, LAMPUNG",5,155,127,282
https://kawalpemilu.org#24793,"SUMUR BATU, TELUKBETUNG UTARA, KOTA BANDAR LAMPUNG, LAMPUNG",6,121,118,239
https://kawalpemilu.org#24793,"SUMUR BATU, TELUKBETUNG UTARA, KOTA BANDAR LAMPUNG, LAMPUNG",7,113,114,254
https://kawalpemilu.org#24793,"SUMUR BATU, TELUKBETUNG UTARA, KOTA BANDAR LAMPUNG, LAMPUNG",9,75,114,189
https://kawalpemilu.org#24793,"SUMUR BATU, TELUKBETUNG UTARA, KOTA BANDAR LAMPUNG, LAMPUNG",10,103,96,199
https://kawalpemilu.org#24793,"SUMUR BATU, TELUKBETUNG UTARA, KOTA BANDAR LAMPUNG, LAMPUNG",11,82,134,216
https://kawalpemilu.org#24793,"SUMUR BATU, TELUKBETUNG UTARA, KOTA BANDAR LAMPUNG, LAMPUNG",13,104,120,224
https://kawalpemilu.org#24793,"SUMUR BATU, TELUKBETUNG UTARA, KOTA BANDAR LAMPUNG, LAMPUNG",14,99,121,220
https://kawalpemilu.org#24793,"SUMUR BATU, TELUKBETUNG UTARA, KOTA BANDAR LAMPUNG, LAMPUNG",15,102,84,186
https://kawalpemilu.org#24793,"SUMUR BATU, TELUKBETUNG UTARA, KOTA BANDAR LAMPUNG, LAMPUNG",16,82,127,209
https://kawalpemilu.org#24793,"SUMUR BATU, TELUKBETUNG UTARA, KOTA BANDAR LAMPUNG, LAMPUNG",17,127,94,221
https://kawalpemilu.org#24793,"SUMUR BATU, TELUKBETUNG UTARA, KOTA BANDAR LAMPUNG, LAMPUNG",18,118,112,230
https://kawalpemilu.org#24793,"SUMUR BATU, TELUKBETUNG UTARA, KOTA BANDAR LAMPUNG, LAMPUNG",19,92,132,224
https://kawalpemilu.org#24793,"SUMUR BATU, TELUKBETUNG UTARA, KOTA BANDAR LAMPUNG, LAMPUNG",20,38,132,170
https://kawalpemilu.org#24793,"SUMUR BATU, TELUKBETUNG UTARA, KOTA BANDAR LAMPUNG, LAMPUNG",21,90,142,232
https://kawalpemilu.org#24797,"RAJABASA, RAJABASA, KOTA BANDAR LAMPUNG, LAMPUNG",1,48,176,224
https://kawalpemilu.org#24797,"RAJABASA, RAJABASA, KOTA BANDAR LAMPUNG, LAMPUNG",2,67,147,214
https://kawalpemilu.org#24797,"RAJABASA, RAJABASA, KOTA BANDAR LAMPUNG, LAMPUNG",3,56,96,152
https://kawalpemilu.org#24797,"RAJABASA, RAJABASA, KOTA BANDAR LAMPUNG, LAMPUNG",4,59,84,143
https://kawalpemilu.org#24797,"RAJABASA, RAJABASA, KOTA BANDAR LAMPUNG, LAMPUNG",5,109,155,264
https://kawalpemilu.org#24797,"RAJABASA, RAJABASA, KOTA BANDAR LAMPUNG, LAMPUNG",6,81,164,245
https://kawalpemilu.org#24797,"RAJABASA, RAJABASA, KOTA BANDAR LAMPUNG, LAMPUNG",7,95,114,209
https://kawalpemilu.org#24797,"RAJABASA, RAJABASA, KOTA BANDAR LAMPUNG, LAMPUNG",8,93,118,211
https://kawalpemilu.org#24797,"RAJABASA, RAJABASA, KOTA BANDAR LAMPUNG, LAMPUNG",9,103,116,219
https://kawalpemilu.org#24797,"RAJABASA, RAJABASA, KOTA BANDAR LAMPUNG, LAMPUNG",10,111,124,235
https://kawalpemilu.org#24797,"RAJABASA, RAJABASA, KOTA BANDAR LAMPUNG, LAMPUNG",11,79,137,216
https://kawalpemilu.org#24797,"RAJABASA, RAJABASA, KOTA BANDAR LAMPUNG, LAMPUNG",12,94,171,265
https://kawalpemilu.org#24797,"RAJABASA, RAJABASA, KOTA BANDAR LAMPUNG, LAMPUNG",13,54,93,147
https://kawalpemilu.org#24797,"RAJABASA, RAJABASA, KOTA BANDAR LAMPUNG, LAMPUNG",14,33,100,133
https://kawalpemilu.org#24798,"GEDONG MENENG, RAJABASA, KOTA BANDAR LAMPUNG, LAMPUNG",1,94,220,314
https://kawalpemilu.org#24798,"GEDONG MENENG, RAJABASA, KOTA BANDAR LAMPUNG, LAMPUNG",2,57,229,286
https://kawalpemilu.org#24798,"GEDONG MENENG, RAJABASA, KOTA BANDAR LAMPUNG, LAMPUNG",3,25,125,150
https://kawalpemilu.org#24798,"GEDONG MENENG, RAJABASA, KOTA BANDAR LAMPUNG, LAMPUNG",4,78,183,261
https://kawalpemilu.org#24798,"GEDONG MENENG, RAJABASA, KOTA BANDAR LAMPUNG, LAMPUNG",5,45,136,181
https://kawalpemilu.org#24798,"GEDONG MENENG, RAJABASA, KOTA BANDAR LAMPUNG, LAMPUNG",6,42,136,178
https://kawalpemilu.org#24798,"GEDONG MENENG, RAJABASA, KOTA BANDAR LAMPUNG, LAMPUNG",7,29,99,128
https://kawalpemilu.org#24798,"GEDONG MENENG, RAJABASA, KOTA BANDAR LAMPUNG, LAMPUNG",8,69,141,210
https://kawalpemilu.org#24798,"GEDONG MENENG, RAJABASA, KOTA BANDAR LAMPUNG, LAMPUNG",9,60,103,163
https://kawalpemilu.org#24798,"GEDONG MENENG, RAJABASA, KOTA BANDAR LAMPUNG, LAMPUNG",10,59,95,154
https://kawalpemilu.org#24798,"GEDONG MENENG, RAJABASA, KOTA BANDAR LAMPUNG, LAMPUNG",11,60,133,193
https://kawalpemilu.org#24798,"GEDONG MENENG, RAJABASA, KOTA BANDAR LAMPUNG, LAMPUNG",12,66,155,221
https://kawalpemilu.org#24798,"GEDONG MENENG, RAJABASA, KOTA BANDAR LAMPUNG, LAMPUNG",13,33,100,133
https://kawalpemilu.org#24798,"GEDONG MENENG, RAJABASA, KOTA BANDAR LAMPUNG, LAMPUNG",14,86,156,242
https://kawalpemilu.org#24798,"GEDONG MENENG, RAJABASA, KOTA BANDAR LAMPUNG, LAMPUNG",15,46,117,163
https://kawalpemilu.org#24799,"RAJABASA RAYA, RAJABASA, KOTA BANDAR LAMPUNG, LAMPUNG",1,97,125,222
https://kawalpemilu.org#24799,"RAJABASA RAYA, RAJABASA, KOTA BANDAR LAMPUNG, LAMPUNG",2,58,136,194
https://kawalpemilu.org#24799,"RAJABASA RAYA, RAJABASA, KOTA BANDAR LAMPUNG, LAMPUNG",3,121,189,310
https://kawalpemilu.org#24799,"RAJABASA RAYA, RAJABASA, KOTA BANDAR LAMPUNG, LAMPUNG",4,162,102,264
https://kawalpemilu.org#24799,"RAJABASA RAYA, RAJABASA, KOTA BANDAR LAMPUNG, LAMPUNG",5,117,160,277
https://kawalpemilu.org#24799,"RAJABASA RAYA, RAJABASA, KOTA BANDAR LAMPUNG, LAMPUNG",6,53,94,147
https://kawalpemilu.org#24799,"RAJABASA RAYA, RAJABASA, KOTA BANDAR LAMPUNG, LAMPUNG",7,53,87,140
https://kawalpemilu.org#24799,"RAJABASA RAYA, RAJABASA, KOTA BANDAR LAMPUNG, LAMPUNG",8,66,113,179
https://kawalpemilu.org#24799,"RAJABASA RAYA, RAJABASA, KOTA BANDAR LAMPUNG, LAMPUNG",9,83,124,207
https://kawalpemilu.org#24799,"RAJABASA RAYA, RAJABASA, KOTA BANDAR LAMPUNG, LAMPUNG",10,68,118,186
https://kawalpemilu.org#24799,"RAJABASA RAYA, RAJABASA, KOTA BANDAR LAMPUNG, LAMPUNG",11,47,118,165
https://kawalpemilu.org#24799,"RAJABASA RAYA, RAJABASA, KOTA BANDAR LAMPUNG, LAMPUNG",12,65,161,226
https://kawalpemilu.org#24799,"RAJABASA RAYA, RAJABASA, KOTA BANDAR LAMPUNG, LAMPUNG",13,79,135,214
https://kawalpemilu.org#24799,"RAJABASA RAYA, RAJABASA, KOTA BANDAR LAMPUNG, LAMPUNG",14,94,145,239
https://kawalpemilu.org#24799,"RAJABASA RAYA, RAJABASA, KOTA BANDAR LAMPUNG, LAMPUNG",15,75,152,227
https://kawalpemilu.org#24799,"RAJABASA RAYA, RAJABASA, KOTA BANDAR LAMPUNG, LAMPUNG",16,74,153,227
https://kawalpemilu.org#24799,"RAJABASA RAYA, RAJABASA, KOTA BANDAR LAMPUNG, LAMPUNG",17,87,194,281
https://kawalpemilu.org#24799,"RAJABASA RAYA, RAJABASA, KOTA BANDAR LAMPUNG, LAMPUNG",18,112,117,229
https://kawalpemilu.org#24799,"RAJABASA RAYA, RAJABASA, KOTA BANDAR LAMPUNG, LAMPUNG",19,107,122,229
https://kawalpemilu.org#24799,"RAJABASA RAYA, RAJABASA, KOTA BANDAR LAMPUNG, LAMPUNG",20,115,165,280
https://kawalpemilu.org#24799,"RAJABASA RAYA, RAJABASA, KOTA BANDAR LAMPUNG, LAMPUNG",21,72,107,179
https://kawalpemilu.org#24800,"RAJABASA JAYA, RAJABASA, KOTA BANDAR LAMPUNG, LAMPUNG",1,96,135,231
https://kawalpemilu.org#24800,"RAJABASA JAYA, RAJABASA, KOTA BANDAR LAMPUNG, LAMPUNG",2,85,91,176
https://kawalpemilu.org#24800,"RAJABASA JAYA, RAJABASA, KOTA BANDAR LAMPUNG, LAMPUNG",3,150,90,240
https://kawalpemilu.org#24800,"RAJABASA JAYA, RAJABASA, KOTA BANDAR LAMPUNG, LAMPUNG",4,93,162,255
https://kawalpemilu.org#24800,"RAJABASA JAYA, RAJABASA, KOTA BANDAR LAMPUNG, LAMPUNG",5,118,168,286
https://kawalpemilu.org#24800,"RAJABASA JAYA, RAJABASA, KOTA BANDAR LAMPUNG, LAMPUNG",6,129,81,210
https://kawalpemilu.org#24800,"RAJABASA JAYA, RAJABASA, KOTA BANDAR LAMPUNG, LAMPUNG",7,110,81,191
https://kawalpemilu.org#24800,"RAJABASA JAYA, RAJABASA, KOTA BANDAR LAMPUNG, LAMPUNG",8,59,130,189
https://kawalpemilu.org#24800,"RAJABASA JAYA, RAJABASA, KOTA BANDAR LAMPUNG, LAMPUNG",9,68,86,154
https://kawalpemilu.org#24800,"RAJABASA JAYA, RAJABASA, KOTA BANDAR LAMPUNG, LAMPUNG",10,53,71,124
https://kawalpemilu.org#24800,"RAJABASA JAYA, RAJABASA, KOTA BANDAR LAMPUNG, LAMPUNG",11,105,132,237
https://kawalpemilu.org#24800,"RAJABASA JAYA, RAJABASA, KOTA BANDAR LAMPUNG, LAMPUNG",12,123,140,263
https://kawalpemilu.org#24800,"RAJABASA JAYA, RAJABASA, KOTA BANDAR LAMPUNG, LAMPUNG",13,41,82,123
https://kawalpemilu.org#24800,"RAJABASA JAYA, RAJABASA, KOTA BANDAR LAMPUNG, LAMPUNG",14,72,67,139
https://kawalpemilu.org#24800,"RAJABASA JAYA, RAJABASA, KOTA BANDAR LAMPUNG, LAMPUNG",15,90,87,177
https://kawalpemilu.org#24800,"RAJABASA JAYA, RAJABASA, KOTA BANDAR LAMPUNG, LAMPUNG",16,72,83,155
https://kawalpemilu.org#24800,"RAJABASA JAYA, RAJABASA, KOTA BANDAR LAMPUNG, LAMPUNG",17,105,133,238
https://kawalpemilu.org#24800,"RAJABASA JAYA, RAJABASA, KOTA BANDAR LAMPUNG, LAMPUNG",18,97,124,221
https://kawalpemilu.org#24800,"RAJABASA JAYA, RAJABASA, KOTA BANDAR LAMPUNG, LAMPUNG",19,107,96,203
https://kawalpemilu.org#24800,"RAJABASA JAYA, RAJABASA, KOTA BANDAR LAMPUNG, LAMPUNG",20,92,97,189
https://kawalpemilu.org#24800,"RAJABASA JAYA, RAJABASA, KOTA BANDAR LAMPUNG, LAMPUNG",21,105,93,198
https://kawalpemilu.org#24800,"RAJABASA JAYA, RAJABASA, KOTA BANDAR LAMPUNG, LAMPUNG",22,95,142,237
https://kawalpemilu.org#24800,"RAJABASA JAYA, RAJABASA, KOTA BANDAR LAMPUNG, LAMPUNG",23,81,122,203
https://kawalpemilu.org#24800,"RAJABASA JAYA, RAJABASA, KOTA BANDAR LAMPUNG, LAMPUNG",24,96,166,262
https://kawalpemilu.org#24800,"RAJABASA JAYA, RAJABASA, KOTA BANDAR LAMPUNG, LAMPUNG",25,98,141,239
https://kawalpemilu.org#87235,"RAJABASA NUNYAI, RAJABASA, KOTA BANDAR LAMPUNG, LAMPUNG",1,78,194,272
https://kawalpemilu.org#87235,"RAJABASA NUNYAI, RAJABASA, KOTA BANDAR LAMPUNG, LAMPUNG",2,61,129,190
https://kawalpemilu.org#87235,"RAJABASA NUNYAI, RAJABASA, KOTA BANDAR LAMPUNG, LAMPUNG",3,50,123,173
https://kawalpemilu.org#87235,"RAJABASA NUNYAI, RAJABASA, KOTA BANDAR LAMPUNG, LAMPUNG",4,62,139,201
https://kawalpemilu.org#87235,"RAJABASA NUNYAI, RAJABASA, KOTA BANDAR LAMPUNG, LAMPUNG",5,98,159,257
https://kawalpemilu.org#87235,"RAJABASA NUNYAI, RAJABASA, KOTA BANDAR LAMPUNG, LAMPUNG",6,97,147,244
https://kawalpemilu.org#87235,"RAJABASA NUNYAI, RAJABASA, KOTA BANDAR LAMPUNG, LAMPUNG",7,90,186,276
https://kawalpemilu.org#87235,"RAJABASA NUNYAI, RAJABASA, KOTA BANDAR LAMPUNG, LAMPUNG",8,81,101,182
https://kawalpemilu.org#87235,"RAJABASA NUNYAI, RAJABASA, KOTA BANDAR LAMPUNG, LAMPUNG",9,64,149,213
https://kawalpemilu.org#87235,"RAJABASA NUNYAI, RAJABASA, KOTA BANDAR LAMPUNG, LAMPUNG",10,62,128,190
https://kawalpemilu.org#87235,"RAJABASA NUNYAI, RAJABASA, KOTA BANDAR LAMPUNG, LAMPUNG",11,68,152,220
https://kawalpemilu.org#87235,"RAJABASA NUNYAI, RAJABASA, KOTA BANDAR LAMPUNG, LAMPUNG",12,97,149,246
https://kawalpemilu.org#87235,"RAJABASA NUNYAI, RAJABASA, KOTA BANDAR LAMPUNG, LAMPUNG",13,120,119,239
https://kawalpemilu.org#87235,"RAJABASA NUNYAI, RAJABASA, KOTA BANDAR LAMPUNG, LAMPUNG",14,61,187,248
https://kawalpemilu.org#87235,"RAJABASA NUNYAI, RAJABASA, KOTA BANDAR LAMPUNG, LAMPUNG",15,87,163,250
https://kawalpemilu.org#87235,"RAJABASA NUNYAI, RAJABASA, KOTA BANDAR LAMPUNG, LAMPUNG",16,56,175,231
https://kawalpemilu.org#87235,"RAJABASA NUNYAI, RAJABASA, KOTA BANDAR LAMPUNG, LAMPUNG",17,81,163,244
https://kawalpemilu.org#87235,"RAJABASA NUNYAI, RAJABASA, KOTA BANDAR LAMPUNG, LAMPUNG",18,74,86,160
https://kawalpemilu.org#87235,"RAJABASA NUNYAI, RAJABASA, KOTA BANDAR LAMPUNG, LAMPUNG",19,66,185,251
https://kawalpemilu.org#87235,"RAJABASA NUNYAI, RAJABASA, KOTA BANDAR LAMPUNG, LAMPUNG",20,75,175,250
https://kawalpemilu.org#87235,"RAJABASA NUNYAI, RAJABASA, KOTA BANDAR LAMPUNG, LAMPUNG",21,59,82,141
https://kawalpemilu.org#87237,"GEDONG MENENG BARU, RAJABASA, KOTA BANDAR LAMPUNG, LAMPUNG",1,118,45,163
https://kawalpemilu.org#87237,"GEDONG MENENG BARU, RAJABASA, KOTA BANDAR LAMPUNG, LAMPUNG",2,119,94,213
https://kawalpemilu.org#87237,"GEDONG MENENG BARU, RAJABASA, KOTA BANDAR LAMPUNG, LAMPUNG",3,115,116,231
https://kawalpemilu.org#87237,"GEDONG MENENG BARU, RAJABASA, KOTA BANDAR LAMPUNG, LAMPUNG",4,59,103,162
https://kawalpemilu.org#87237,"GEDONG MENENG BARU, RAJABASA, KOTA BANDAR LAMPUNG, LAMPUNG",5,77,107,184
https://kawalpemilu.org#87237,"GEDONG MENENG BARU, RAJABASA, KOTA BANDAR LAMPUNG, LAMPUNG",6,116,79,195
https://kawalpemilu.org#92003,"RAJABASA PEMUKA, RAJABASA, KOTA BANDAR LAMPUNG, LAMPUNG",1,76,150,226
https://kawalpemilu.org#92003,"RAJABASA PEMUKA, RAJABASA, KOTA BANDAR LAMPUNG, LAMPUNG",2,71,155,226
https://kawalpemilu.org#92003,"RAJABASA PEMUKA, RAJABASA, KOTA BANDAR LAMPUNG, LAMPUNG",3,77,147,224
https://kawalpemilu.org#92003,"RAJABASA PEMUKA, RAJABASA, KOTA BANDAR LAMPUNG, LAMPUNG",4,31,152,183
https://kawalpemilu.org#92003,"RAJABASA PEMUKA, RAJABASA, KOTA BANDAR LAMPUNG, LAMPUNG",6,64,175,239
https://kawalpemilu.org#92003,"RAJABASA PEMUKA, RAJABASA, KOTA BANDAR LAMPUNG, LAMPUNG",7,76,194,270
https://kawalpemilu.org#92003,"RAJABASA PEMUKA, RAJABASA, KOTA BANDAR LAMPUNG, LAMPUNG",8,62,182,244
https://kawalpemilu.org#92003,"RAJABASA PEMUKA, RAJABASA, KOTA BANDAR LAMPUNG, LAMPUNG",9,62,209,271
https://kawalpemilu.org#92003,"RAJABASA PEMUKA, RAJABASA, KOTA BANDAR LAMPUNG, LAMPUNG",10,94,204,298
https://kawalpemilu.org#92003,"RAJABASA PEMUKA, RAJABASA, KOTA BANDAR LAMPUNG, LAMPUNG",11,50,117,167
https://kawalpemilu.org#92003,"RAJABASA PEMUKA, RAJABASA, KOTA BANDAR LAMPUNG, LAMPUNG",12,104,157,261
https://kawalpemilu.org#92003,"RAJABASA PEMUKA, RAJABASA, KOTA BANDAR LAMPUNG, LAMPUNG",14,66,200,266
https://kawalpemilu.org#92003,"RAJABASA PEMUKA, RAJABASA, KOTA BANDAR LAMPUNG, LAMPUNG",15,31,184,215
https://kawalpemilu.org#92003,"RAJABASA PEMUKA, RAJABASA, KOTA BANDAR LAMPUNG, LAMPUNG",16,19,71,90
https://kawalpemilu.org#92003,"RAJABASA PEMUKA, RAJABASA, KOTA BANDAR LAMPUNG, LAMPUNG",17,21,48,69
https://kawalpemilu.org#92003,"RAJABASA PEMUKA, RAJABASA, KOTA BANDAR LAMPUNG, LAMPUNG",18,22,53,75
https://kawalpemilu.org#92003,"RAJABASA PEMUKA, RAJABASA, KOTA BANDAR LAMPUNG, LAMPUNG",19,15,35,50
https://kawalpemilu.org#24802,"TANJUNG SENANG, TANJUNG SENANG, KOTA BANDAR LAMPUNG, LAMPUNG",1,60,87,147
https://kawalpemilu.org#24802,"TANJUNG SENANG, TANJUNG SENANG, KOTA BANDAR LAMPUNG, LAMPUNG",2,107,94,201
https://kawalpemilu.org#24802,"TANJUNG SENANG, TANJUNG SENANG, KOTA BANDAR LAMPUNG, LAMPUNG",3,87,128,215
https://kawalpemilu.org#24802,"TANJUNG SENANG, TANJUNG SENANG, KOTA BANDAR LAMPUNG, LAMPUNG",4,80,96,176
https://kawalpemilu.org#24802,"TANJUNG SENANG, TANJUNG SENANG, KOTA BANDAR LAMPUNG, LAMPUNG",5,100,82,182
https://kawalpemilu.org#24802,"TANJUNG SENANG, TANJUNG SENANG, KOTA BANDAR LAMPUNG, LAMPUNG",6,101,106,207
https://kawalpemilu.org#24802,"TANJUNG SENANG, TANJUNG SENANG, KOTA BANDAR LAMPUNG, LAMPUNG",7,145,128,273
https://kawalpemilu.org#24802,"TANJUNG SENANG, TANJUNG SENANG, KOTA BANDAR LAMPUNG, LAMPUNG",9,67,102,169
https://kawalpemilu.org#24802,"TANJUNG SENANG, TANJUNG SENANG, KOTA BANDAR LAMPUNG, LAMPUNG",10,89,76,165
https://kawalpemilu.org#24802,"TANJUNG SENANG, TANJUNG SENANG, KOTA BANDAR LAMPUNG, LAMPUNG",11,81,88,169
https://kawalpemilu.org#24802,"TANJUNG SENANG, TANJUNG SENANG, KOTA BANDAR LAMPUNG, LAMPUNG",12,87,62,149
https://kawalpemilu.org#24802,"TANJUNG SENANG, TANJUNG SENANG, KOTA BANDAR LAMPUNG, LAMPUNG",14,102,138,240
https://kawalpemilu.org#24802,"TANJUNG SENANG, TANJUNG SENANG, KOTA BANDAR LAMPUNG, LAMPUNG",15,118,135,253
https://kawalpemilu.org#24802,"TANJUNG SENANG, TANJUNG SENANG, KOTA BANDAR LAMPUNG, LAMPUNG",16,95,142,237
https://kawalpemilu.org#24802,"TANJUNG SENANG, TANJUNG SENANG, KOTA BANDAR LAMPUNG, LAMPUNG",17,81,126,207
https://kawalpemilu.org#24802,"TANJUNG SENANG, TANJUNG SENANG, KOTA BANDAR LAMPUNG, LAMPUNG",18,77,153,230
https://kawalpemilu.org#24802,"TANJUNG SENANG, TANJUNG SENANG, KOTA BANDAR LAMPUNG, LAMPUNG",19,82,165,247
https://kawalpemilu.org#24802,"TANJUNG SENANG, TANJUNG SENANG, KOTA BANDAR LAMPUNG, LAMPUNG",20,72,134,206
https://kawalpemilu.org#24802,"TANJUNG SENANG, TANJUNG SENANG, KOTA BANDAR LAMPUNG, LAMPUNG",21,73,113,186
https://kawalpemilu.org#24802,"TANJUNG SENANG, TANJUNG SENANG, KOTA BANDAR LAMPUNG, LAMPUNG",22,143,132,275
https://kawalpemilu.org#24802,"TANJUNG SENANG, TANJUNG SENANG, KOTA BANDAR LAMPUNG, LAMPUNG",23,83,157,240
https://kawalpemilu.org#24802,"TANJUNG SENANG, TANJUNG SENANG, KOTA BANDAR LAMPUNG, LAMPUNG",24,73,137,210
https://kawalpemilu.org#24802,"TANJUNG SENANG, TANJUNG SENANG, KOTA BANDAR LAMPUNG, LAMPUNG",25,79,103,182
https://kawalpemilu.org#24802,"TANJUNG SENANG, TANJUNG SENANG, KOTA BANDAR LAMPUNG, LAMPUNG",26,118,119,237
https://kawalpemilu.org#24802,"TANJUNG SENANG, TANJUNG SENANG, KOTA BANDAR LAMPUNG, LAMPUNG",27,153,101,254
https://kawalpemilu.org#24802,"TANJUNG SENANG, TANJUNG SENANG, KOTA BANDAR LAMPUNG, LAMPUNG",28,121,87,208
https://kawalpemilu.org#24802,"TANJUNG SENANG, TANJUNG SENANG, KOTA BANDAR LAMPUNG, LAMPUNG",29,128,97,225
https://kawalpemilu.org#24802,"TANJUNG SENANG, TANJUNG SENANG, KOTA BANDAR LAMPUNG, LAMPUNG",30,114,71,185
https://kawalpemilu.org#24802,"TANJUNG SENANG, TANJUNG SENANG, KOTA BANDAR LAMPUNG, LAMPUNG",31,127,87,214
https://kawalpemilu.org#24802,"TANJUNG SENANG, TANJUNG SENANG, KOTA BANDAR LAMPUNG, LAMPUNG",32,87,73,160
https://kawalpemilu.org#24802,"TANJUNG SENANG, TANJUNG SENANG, KOTA BANDAR LAMPUNG, LAMPUNG",33,92,134,226
https://kawalpemilu.org#24802,"TANJUNG SENANG, TANJUNG SENANG, KOTA BANDAR LAMPUNG, LAMPUNG",34,114,93,207
https://kawalpemilu.org#24802,"TANJUNG SENANG, TANJUNG SENANG, KOTA BANDAR LAMPUNG, LAMPUNG",35,110,85,195
https://kawalpemilu.org#24802,"TANJUNG SENANG, TANJUNG SENANG, KOTA BANDAR LAMPUNG, LAMPUNG",36,109,111,220
https://kawalpemilu.org#24802,"TANJUNG SENANG, TANJUNG SENANG, KOTA BANDAR LAMPUNG, LAMPUNG",37,105,104,209
https://kawalpemilu.org#24802,"TANJUNG SENANG, TANJUNG SENANG, KOTA BANDAR LAMPUNG, LAMPUNG",38,96,153,249
https://kawalpemilu.org#24803,"WAY KANDIS, TANJUNG SENANG, KOTA BANDAR LAMPUNG, LAMPUNG",1,100,150,250
https://kawalpemilu.org#24803,"WAY KANDIS, TANJUNG SENANG, KOTA BANDAR LAMPUNG, LAMPUNG",2,126,105,231
https://kawalpemilu.org#24803,"WAY KANDIS, TANJUNG SENANG, KOTA BANDAR LAMPUNG, LAMPUNG",3,99,97,196
https://kawalpemilu.org#24803,"WAY KANDIS, TANJUNG SENANG, KOTA BANDAR LAMPUNG, LAMPUNG",4,109,99,208
https://kawalpemilu.org#24803,"WAY KANDIS, TANJUNG SENANG, KOTA BANDAR LAMPUNG, LAMPUNG",5,131,124,255
https://kawalpemilu.org#24803,"WAY KANDIS, TANJUNG SENANG, KOTA BANDAR LAMPUNG, LAMPUNG",6,121,105,226
https://kawalpemilu.org#24803,"WAY KANDIS, TANJUNG SENANG, KOTA BANDAR LAMPUNG, LAMPUNG",7,175,83,258
https://kawalpemilu.org#24803,"WAY KANDIS, TANJUNG SENANG, KOTA BANDAR LAMPUNG, LAMPUNG",8,161,109,270
https://kawalpemilu.org#24803,"WAY KANDIS, TANJUNG SENANG, KOTA BANDAR LAMPUNG, LAMPUNG",9,96,138,234
https://kawalpemilu.org#24803,"WAY KANDIS, TANJUNG SENANG, KOTA BANDAR LAMPUNG, LAMPUNG",10,96,127,223
https://kawalpemilu.org#24803,"WAY KANDIS, TANJUNG SENANG, KOTA BANDAR LAMPUNG, LAMPUNG",11,80,116,196
https://kawalpemilu.org#24803,"WAY KANDIS, TANJUNG SENANG, KOTA BANDAR LAMPUNG, LAMPUNG",12,81,103,184
https://kawalpemilu.org#24803,"WAY KANDIS, TANJUNG SENANG, KOTA BANDAR LAMPUNG, LAMPUNG",13,120,66,186
https://kawalpemilu.org#24803,"WAY KANDIS, TANJUNG SENANG, KOTA BANDAR LAMPUNG, LAMPUNG",14,90,53,143
https://kawalpemilu.org#24803,"WAY KANDIS, TANJUNG SENANG, KOTA BANDAR LAMPUNG, LAMPUNG",15,86,57,143
https://kawalpemilu.org#24803,"WAY KANDIS, TANJUNG SENANG, KOTA BANDAR LAMPUNG, LAMPUNG",16,134,124,258
https://kawalpemilu.org#24803,"WAY KANDIS, TANJUNG SENANG, KOTA BANDAR LAMPUNG, LAMPUNG",17,177,72,249
https://kawalpemilu.org#24803,"WAY KANDIS, TANJUNG SENANG, KOTA BANDAR LAMPUNG, LAMPUNG",18,117,82,199
https://kawalpemilu.org#24803,"WAY KANDIS, TANJUNG SENANG, KOTA BANDAR LAMPUNG, LAMPUNG",19,133,113,246
https://kawalpemilu.org#24803,"WAY KANDIS, TANJUNG SENANG, KOTA BANDAR LAMPUNG, LAMPUNG",20,106,90,196
https://kawalpemilu.org#24803,"WAY KANDIS, TANJUNG SENANG, KOTA BANDAR LAMPUNG, LAMPUNG",21,103,125,228
https://kawalpemilu.org#24803,"WAY KANDIS, TANJUNG SENANG, KOTA BANDAR LAMPUNG, LAMPUNG",22,119,150,269
https://kawalpemilu.org#24803,"WAY KANDIS, TANJUNG SENANG, KOTA BANDAR LAMPUNG, LAMPUNG",23,77,63,140
https://kawalpemilu.org#24803,"WAY KANDIS, TANJUNG SENANG, KOTA BANDAR LAMPUNG, LAMPUNG",25,119,107,226
https://kawalpemilu.org#24803,"WAY KANDIS, TANJUNG SENANG, KOTA BANDAR LAMPUNG, LAMPUNG",26,88,125,213
https://kawalpemilu.org#24803,"WAY KANDIS, TANJUNG SENANG, KOTA BANDAR LAMPUNG, LAMPUNG",27,107,118,225
https://kawalpemilu.org#24803,"WAY KANDIS, TANJUNG SENANG, KOTA BANDAR LAMPUNG, LAMPUNG",28,116,130,246
https://kawalpemilu.org#24803,"WAY KANDIS, TANJUNG SENANG, KOTA BANDAR LAMPUNG, LAMPUNG",29,83,129,212
https://kawalpemilu.org#24803,"WAY KANDIS, TANJUNG SENANG, KOTA BANDAR LAMPUNG, LAMPUNG",30,80,94,174
https://kawalpemilu.org#24804,"LABUHAN DALAM, TANJUNG SENANG, KOTA BANDAR LAMPUNG, LAMPUNG",1,125,70,195
https://kawalpemilu.org#24804,"LABUHAN DALAM, TANJUNG SENANG, KOTA BANDAR LAMPUNG, LAMPUNG",2,118,81,199
https://kawalpemilu.org#24804,"LABUHAN DALAM, TANJUNG SENANG, KOTA BANDAR LAMPUNG, LAMPUNG",3,90,100,190
https://kawalpemilu.org#24804,"LABUHAN DALAM, TANJUNG SENANG, KOTA BANDAR LAMPUNG, LAMPUNG",4,90,110,200
https://kawalpemilu.org#24804,"LABUHAN DALAM, TANJUNG SENANG, KOTA BANDAR LAMPUNG, LAMPUNG",5,132,97,229
https://kawalpemilu.org#24804,"LABUHAN DALAM, TANJUNG SENANG, KOTA BANDAR LAMPUNG, LAMPUNG",6,107,87,194
https://kawalpemilu.org#24804,"LABUHAN DALAM, TANJUNG SENANG, KOTA BANDAR LAMPUNG, LAMPUNG",7,104,109,213
https://kawalpemilu.org#24804,"LABUHAN DALAM, TANJUNG SENANG, KOTA BANDAR LAMPUNG, LAMPUNG",8,119,111,230
https://kawalpemilu.org#24804,"LABUHAN DALAM, TANJUNG SENANG, KOTA BANDAR LAMPUNG, LAMPUNG",9,98,134,232
https://kawalpemilu.org#24804,"LABUHAN DALAM, TANJUNG SENANG, KOTA BANDAR LAMPUNG, LAMPUNG",10,130,111,241
https://kawalpemilu.org#24804,"LABUHAN DALAM, TANJUNG SENANG, KOTA BANDAR LAMPUNG, LAMPUNG",11,115,92,207
https://kawalpemilu.org#24804,"LABUHAN DALAM, TANJUNG SENANG, KOTA BANDAR LAMPUNG, LAMPUNG",12,130,54,184
https://kawalpemilu.org#24804,"LABUHAN DALAM, TANJUNG SENANG, KOTA BANDAR LAMPUNG, LAMPUNG",13,118,82,200
https://kawalpemilu.org#24804,"LABUHAN DALAM, TANJUNG SENANG, KOTA BANDAR LAMPUNG, LAMPUNG",14,132,89,221
https://kawalpemilu.org#24804,"LABUHAN DALAM, TANJUNG SENANG, KOTA BANDAR LAMPUNG, LAMPUNG",15,109,111,220
https://kawalpemilu.org#24804,"LABUHAN DALAM, TANJUNG SENANG, KOTA BANDAR LAMPUNG, LAMPUNG",16,93,86,179
https://kawalpemilu.org#24804,"LABUHAN DALAM, TANJUNG SENANG, KOTA BANDAR LAMPUNG, LAMPUNG",17,107,112,219
https://kawalpemilu.org#24804,"LABUHAN DALAM, TANJUNG SENANG, KOTA BANDAR LAMPUNG, LAMPUNG",18,123,101,224
https://kawalpemilu.org#24804,"LABUHAN DALAM, TANJUNG SENANG, KOTA BANDAR LAMPUNG, LAMPUNG",19,105,115,220
https://kawalpemilu.org#24804,"LABUHAN DALAM, TANJUNG SENANG, KOTA BANDAR LAMPUNG, LAMPUNG",20,116,161,277
https://kawalpemilu.org#24804,"LABUHAN DALAM, TANJUNG SENANG, KOTA BANDAR LAMPUNG, LAMPUNG",21,95,152,247
https://kawalpemilu.org#24804,"LABUHAN DALAM, TANJUNG SENANG, KOTA BANDAR LAMPUNG, LAMPUNG",22,49,196,245
https://kawalpemilu.org#24804,"LABUHAN DALAM, TANJUNG SENANG, KOTA BANDAR LAMPUNG, LAMPUNG",23,47,158,205
https://kawalpemilu.org#24804,"LABUHAN DALAM, TANJUNG SENANG, KOTA BANDAR LAMPUNG, LAMPUNG",24,62,150,212
https://kawalpemilu.org#24804,"LABUHAN DALAM, TANJUNG SENANG, KOTA BANDAR LAMPUNG, LAMPUNG",25,123,104,227
https://kawalpemilu.org#24804,"LABUHAN DALAM, TANJUNG SENANG, KOTA BANDAR LAMPUNG, LAMPUNG",26,139,88,227
https://kawalpemilu.org#24805,"PERUMNAS WAY KANDIS, TANJUNG SENANG, KOTA BANDAR LAMPUNG, LAMPUNG",1,98,102,200
https://kawalpemilu.org#24805,"PERUMNAS WAY KANDIS, TANJUNG SENANG, KOTA BANDAR LAMPUNG, LAMPUNG",2,109,169,278
https://kawalpemilu.org#24805,"PERUMNAS WAY KANDIS, TANJUNG SENANG, KOTA BANDAR LAMPUNG, LAMPUNG",3,98,141,239
https://kawalpemilu.org#24805,"PERUMNAS WAY KANDIS, TANJUNG SENANG, KOTA BANDAR LAMPUNG, LAMPUNG",4,105,166,271
https://kawalpemilu.org#24805,"PERUMNAS WAY KANDIS, TANJUNG SENANG, KOTA BANDAR LAMPUNG, LAMPUNG",5,81,103,184
https://kawalpemilu.org#24805,"PERUMNAS WAY KANDIS, TANJUNG SENANG, KOTA BANDAR LAMPUNG, LAMPUNG",6,117,131,248
https://kawalpemilu.org#24805,"PERUMNAS WAY KANDIS, TANJUNG SENANG, KOTA BANDAR LAMPUNG, LAMPUNG",7,91,140,231
https://kawalpemilu.org#24805,"PERUMNAS WAY KANDIS, TANJUNG SENANG, KOTA BANDAR LAMPUNG, LAMPUNG",8,97,131,228
https://kawalpemilu.org#24805,"PERUMNAS WAY KANDIS, TANJUNG SENANG, KOTA BANDAR LAMPUNG, LAMPUNG",9,107,110,217
https://kawalpemilu.org#24805,"PERUMNAS WAY KANDIS, TANJUNG SENANG, KOTA BANDAR LAMPUNG, LAMPUNG",10,108,104,212
https://kawalpemilu.org#24805,"PERUMNAS WAY KANDIS, TANJUNG SENANG, KOTA BANDAR LAMPUNG, LAMPUNG",11,112,88,200
https://kawalpemilu.org#24805,"PERUMNAS WAY KANDIS, TANJUNG SENANG, KOTA BANDAR LAMPUNG, LAMPUNG",12,106,104,210
https://kawalpemilu.org#24805,"PERUMNAS WAY KANDIS, TANJUNG SENANG, KOTA BANDAR LAMPUNG, LAMPUNG",13,90,125,215
https://kawalpemilu.org#24805,"PERUMNAS WAY KANDIS, TANJUNG SENANG, KOTA BANDAR LAMPUNG, LAMPUNG",14,72,162,234
https://kawalpemilu.org#24805,"PERUMNAS WAY KANDIS, TANJUNG SENANG, KOTA BANDAR LAMPUNG, LAMPUNG",15,51,68,119
https://kawalpemilu.org#24805,"PERUMNAS WAY KANDIS, TANJUNG SENANG, KOTA BANDAR LAMPUNG, LAMPUNG",16,90,115,205
https://kawalpemilu.org#24805,"PERUMNAS WAY KANDIS, TANJUNG SENANG, KOTA BANDAR LAMPUNG, LAMPUNG",17,43,107,150
https://kawalpemilu.org#24805,"PERUMNAS WAY KANDIS, TANJUNG SENANG, KOTA BANDAR LAMPUNG, LAMPUNG",18,47,119,166
https://kawalpemilu.org#24805,"PERUMNAS WAY KANDIS, TANJUNG SENANG, KOTA BANDAR LAMPUNG, LAMPUNG",19,49,116,165
https://kawalpemilu.org#24805,"PERUMNAS WAY KANDIS, TANJUNG SENANG, KOTA BANDAR LAMPUNG, LAMPUNG",20,59,150,209
https://kawalpemilu.org#24805,"PERUMNAS WAY KANDIS, TANJUNG SENANG, KOTA BANDAR LAMPUNG, LAMPUNG",21,64,119,183
https://kawalpemilu.org#24805,"PERUMNAS WAY KANDIS, TANJUNG SENANG, KOTA BANDAR LAMPUNG, LAMPUNG",22,66,140,206
https://kawalpemilu.org#24805,"PERUMNAS WAY KANDIS, TANJUNG SENANG, KOTA BANDAR LAMPUNG, LAMPUNG",23,25,70,95
https://kawalpemilu.org#24805,"PERUMNAS WAY KANDIS, TANJUNG SENANG, KOTA BANDAR LAMPUNG, LAMPUNG",24,46,98,144
https://kawalpemilu.org#87238,"PEMATANG WANGI, TANJUNG SENANG, KOTA BANDAR LAMPUNG, LAMPUNG",1,93,163,256
https://kawalpemilu.org#87238,"PEMATANG WANGI, TANJUNG SENANG, KOTA BANDAR LAMPUNG, LAMPUNG",2,88,143,231
https://kawalpemilu.org#87238,"PEMATANG WANGI, TANJUNG SENANG, KOTA BANDAR LAMPUNG, LAMPUNG",3,78,142,220
https://kawalpemilu.org#87238,"PEMATANG WANGI, TANJUNG SENANG, KOTA BANDAR LAMPUNG, LAMPUNG",4,61,152,213
https://kawalpemilu.org#87238,"PEMATANG WANGI, TANJUNG SENANG, KOTA BANDAR LAMPUNG, LAMPUNG",5,140,257,397
https://kawalpemilu.org#87238,"PEMATANG WANGI, TANJUNG SENANG, KOTA BANDAR LAMPUNG, LAMPUNG",6,114,113,227
https://kawalpemilu.org#87238,"PEMATANG WANGI, TANJUNG SENANG, KOTA BANDAR LAMPUNG, LAMPUNG",7,101,163,264
https://kawalpemilu.org#87238,"PEMATANG WANGI, TANJUNG SENANG, KOTA BANDAR LAMPUNG, LAMPUNG",8,113,146,259
https://kawalpemilu.org#87238,"PEMATANG WANGI, TANJUNG SENANG, KOTA BANDAR LAMPUNG, LAMPUNG",9,68,127,195
https://kawalpemilu.org#87238,"PEMATANG WANGI, TANJUNG SENANG, KOTA BANDAR LAMPUNG, LAMPUNG",10,63,129,192
https://kawalpemilu.org#87238,"PEMATANG WANGI, TANJUNG SENANG, KOTA BANDAR LAMPUNG, LAMPUNG",11,80,137,217
https://kawalpemilu.org#87238,"PEMATANG WANGI, TANJUNG SENANG, KOTA BANDAR LAMPUNG, LAMPUNG",12,64,120,184
https://kawalpemilu.org#87238,"PEMATANG WANGI, TANJUNG SENANG, KOTA BANDAR LAMPUNG, LAMPUNG",13,65,139,204
https://kawalpemilu.org#87238,"PEMATANG WANGI, TANJUNG SENANG, KOTA BANDAR LAMPUNG, LAMPUNG",14,82,199,281
https://kawalpemilu.org#87238,"PEMATANG WANGI, TANJUNG SENANG, KOTA BANDAR LAMPUNG, LAMPUNG",15,110,165,275
https://kawalpemilu.org#87238,"PEMATANG WANGI, TANJUNG SENANG, KOTA BANDAR LAMPUNG, LAMPUNG",16,80,130,210
https://kawalpemilu.org#87238,"PEMATANG WANGI, TANJUNG SENANG, KOTA BANDAR LAMPUNG, LAMPUNG",17,48,144,192
https://kawalpemilu.org#87238,"PEMATANG WANGI, TANJUNG SENANG, KOTA BANDAR LAMPUNG, LAMPUNG",18,45,151,196
https://kawalpemilu.org#87238,"PEMATANG WANGI, TANJUNG SENANG, KOTA BANDAR LAMPUNG, LAMPUNG",19,71,89,160
https://kawalpemilu.org#24737,"WAY LAGA, SUKABUMI, KOTA BANDAR LAMPUNG, LAMPUNG",1,93,54,147
https://kawalpemilu.org#24737,"WAY LAGA, SUKABUMI, KOTA BANDAR LAMPUNG, LAMPUNG",2,80,110,190
https://kawalpemilu.org#24737,"WAY LAGA, SUKABUMI, KOTA BANDAR LAMPUNG, LAMPUNG",3,79,86,165
https://kawalpemilu.org#24737,"WAY LAGA, SUKABUMI, KOTA BANDAR LAMPUNG, LAMPUNG",4,83,69,152
https://kawalpemilu.org#24737,"WAY LAGA, SUKABUMI, KOTA BANDAR LAMPUNG, LAMPUNG",5,111,112,223
https://kawalpemilu.org#24737,"WAY LAGA, SUKABUMI, KOTA BANDAR LAMPUNG, LAMPUNG",6,150,42,192
https://kawalpemilu.org#24737,"WAY LAGA, SUKABUMI, KOTA BANDAR LAMPUNG, LAMPUNG",7,135,48,183
https://kawalpemilu.org#24737,"WAY LAGA, SUKABUMI, KOTA BANDAR LAMPUNG, LAMPUNG",8,124,86,210
https://kawalpemilu.org#24737,"WAY LAGA, SUKABUMI, KOTA BANDAR LAMPUNG, LAMPUNG",9,116,75,191
https://kawalpemilu.org#24737,"WAY LAGA, SUKABUMI, KOTA BANDAR LAMPUNG, LAMPUNG",10,78,47,125
https://kawalpemilu.org#24737,"WAY LAGA, SUKABUMI, KOTA BANDAR LAMPUNG, LAMPUNG",11,59,68,127
https://kawalpemilu.org#24737,"WAY LAGA, SUKABUMI, KOTA BANDAR LAMPUNG, LAMPUNG",12,88,112,200
https://kawalpemilu.org#24737,"WAY LAGA, SUKABUMI, KOTA BANDAR LAMPUNG, LAMPUNG",13,113,115,228
https://kawalpemilu.org#24737,"WAY LAGA, SUKABUMI, KOTA BANDAR LAMPUNG, LAMPUNG",14,78,119,197
https://kawalpemilu.org#24737,"WAY LAGA, SUKABUMI, KOTA BANDAR LAMPUNG, LAMPUNG",15,87,121,208
https://kawalpemilu.org#24737,"WAY LAGA, SUKABUMI, KOTA BANDAR LAMPUNG, LAMPUNG",16,82,169,251
https://kawalpemilu.org#24737,"WAY LAGA, SUKABUMI, KOTA BANDAR LAMPUNG, LAMPUNG",17,71,44,115
https://kawalpemilu.org#24737,"WAY LAGA, SUKABUMI, KOTA BANDAR LAMPUNG, LAMPUNG",18,130,117,247
https://kawalpemilu.org#24737,"WAY LAGA, SUKABUMI, KOTA BANDAR LAMPUNG, LAMPUNG",19,61,66,127
https://kawalpemilu.org#24737,"WAY LAGA, SUKABUMI, KOTA BANDAR LAMPUNG, LAMPUNG",20,98,71,169
https://kawalpemilu.org#24737,"WAY LAGA, SUKABUMI, KOTA BANDAR LAMPUNG, LAMPUNG",21,120,104,224
https://kawalpemilu.org#24737,"WAY LAGA, SUKABUMI, KOTA BANDAR LAMPUNG, LAMPUNG",22,62,48,110
https://kawalpemilu.org#24737,"WAY LAGA, SUKABUMI, KOTA BANDAR LAMPUNG, LAMPUNG",23,79,77,156
https://kawalpemilu.org#24737,"WAY LAGA, SUKABUMI, KOTA BANDAR LAMPUNG, LAMPUNG",24,91,89,177
https://kawalpemilu.org#24737,"WAY LAGA, SUKABUMI, KOTA BANDAR LAMPUNG, LAMPUNG",25,103,102,205
https://kawalpemilu.org#24738,"WAY GUBAK, SUKABUMI, KOTA BANDAR LAMPUNG, LAMPUNG",1,66,133,119
https://kawalpemilu.org#24738,"WAY GUBAK, SUKABUMI, KOTA BANDAR LAMPUNG, LAMPUNG",2,81,56,137
https://kawalpemilu.org#24738,"WAY GUBAK, SUKABUMI, KOTA BANDAR LAMPUNG, LAMPUNG",3,68,92,160
https://kawalpemilu.org#24738,"WAY GUBAK, SUKABUMI, KOTA BANDAR LAMPUNG, LAMPUNG",4,36,89,125
https://kawalpemilu.org#24738,"WAY GUBAK, SUKABUMI, KOTA BANDAR LAMPUNG, LAMPUNG",5,64,81,145
https://kawalpemilu.org#24738,"WAY GUBAK, SUKABUMI, KOTA BANDAR LAMPUNG, LAMPUNG",6,64,93,157
https://kawalpemilu.org#24738,"WAY GUBAK, SUKABUMI, KOTA BANDAR LAMPUNG, LAMPUNG",7,140,52,192
https://kawalpemilu.org#24738,"WAY GUBAK, SUKABUMI, KOTA BANDAR LAMPUNG, LAMPUNG",8,76,81,157
https://kawalpemilu.org#24738,"WAY GUBAK, SUKABUMI, KOTA BANDAR LAMPUNG, LAMPUNG",9,66,89,155
https://kawalpemilu.org#24738,"WAY GUBAK, SUKABUMI, KOTA BANDAR LAMPUNG, LAMPUNG",10,116,76,192
https://kawalpemilu.org#24738,"WAY GUBAK, SUKABUMI, KOTA BANDAR LAMPUNG, LAMPUNG",11,90,56,146
https://kawalpemilu.org#24738,"WAY GUBAK, SUKABUMI, KOTA BANDAR LAMPUNG, LAMPUNG",12,89,36,125
https://kawalpemilu.org#24738,"WAY GUBAK, SUKABUMI, KOTA BANDAR LAMPUNG, LAMPUNG",13,92,48,140
https://kawalpemilu.org#24738,"WAY GUBAK, SUKABUMI, KOTA BANDAR LAMPUNG, LAMPUNG",14,153,73,226
https://kawalpemilu.org#24738,"WAY GUBAK, SUKABUMI, KOTA BANDAR LAMPUNG, LAMPUNG",15,133,83,216
https://kawalpemilu.org#24751,"CAMPANG RAYA, SUKABUMI, KOTA BANDAR LAMPUNG, LAMPUNG",1,70,90,160
https://kawalpemilu.org#24751,"CAMPANG RAYA, SUKABUMI, KOTA BANDAR LAMPUNG, LAMPUNG",2,60,112,172
https://kawalpemilu.org#24751,"CAMPANG RAYA, SUKABUMI, KOTA BANDAR LAMPUNG, LAMPUNG",3,46,104,150
https://kawalpemilu.org#24751,"CAMPANG RAYA, SUKABUMI, KOTA BANDAR LAMPUNG, LAMPUNG",4,157,75,232
https://kawalpemilu.org#24751,"CAMPANG RAYA, SUKABUMI, KOTA BANDAR LAMPUNG, LAMPUNG",5,152,108,260
https://kawalpemilu.org#24751,"CAMPANG RAYA, SUKABUMI, KOTA BANDAR LAMPUNG, LAMPUNG",6,128,81,209
https://kawalpemilu.org#24751,"CAMPANG RAYA, SUKABUMI, KOTA BANDAR LAMPUNG, LAMPUNG",7,174,93,267
https://kawalpemilu.org#24751,"CAMPANG RAYA, SUKABUMI, KOTA BANDAR LAMPUNG, LAMPUNG",8,167,93,260
https://kawalpemilu.org#24751,"CAMPANG RAYA, SUKABUMI, KOTA BANDAR LAMPUNG, LAMPUNG",9,144,83,227
https://kawalpemilu.org#24751,"CAMPANG RAYA, SUKABUMI, KOTA BANDAR LAMPUNG, LAMPUNG",10,148,85,233
https://kawalpemilu.org#24751,"CAMPANG RAYA, SUKABUMI, KOTA BANDAR LAMPUNG, LAMPUNG",11,136,75,211
https://kawalpemilu.org#24751,"CAMPANG RAYA, SUKABUMI, KOTA BANDAR LAMPUNG, LAMPUNG",12,131,129,260
https://kawalpemilu.org#24751,"CAMPANG RAYA, SUKABUMI, KOTA BANDAR LAMPUNG, LAMPUNG",13,141,118,259
https://kawalpemilu.org#24751,"CAMPANG RAYA, SUKABUMI, KOTA BANDAR LAMPUNG, LAMPUNG",14,112,135,247
https://kawalpemilu.org#24751,"CAMPANG RAYA, SUKABUMI, KOTA BANDAR LAMPUNG, LAMPUNG",15,117,148,265
https://kawalpemilu.org#24751,"CAMPANG RAYA, SUKABUMI, KOTA BANDAR LAMPUNG, LAMPUNG",16,206,71,277
https://kawalpemilu.org#24751,"CAMPANG RAYA, SUKABUMI, KOTA BANDAR LAMPUNG, LAMPUNG",17,104,69,173
https://kawalpemilu.org#24807,"CAMPANG JAYA, SUKABUMI, KOTA BANDAR LAMPUNG, LAMPUNG",1,126,136,262
https://kawalpemilu.org#24807,"CAMPANG JAYA, SUKABUMI, KOTA BANDAR LAMPUNG, LAMPUNG",2,178,93,271
https://kawalpemilu.org#24807,"CAMPANG JAYA, SUKABUMI, KOTA BANDAR LAMPUNG, LAMPUNG",3,116,52,168
https://kawalpemilu.org#24807,"CAMPANG JAYA, SUKABUMI, KOTA BANDAR LAMPUNG, LAMPUNG",4,110,138,248
https://kawalpemilu.org#24807,"CAMPANG JAYA, SUKABUMI, KOTA BANDAR LAMPUNG, LAMPUNG",5,124,107,231
https://kawalpemilu.org#24807,"CAMPANG JAYA, SUKABUMI, KOTA BANDAR LAMPUNG, LAMPUNG",6,77,87,164
https://kawalpemilu.org#24807,"CAMPANG JAYA, SUKABUMI, KOTA BANDAR LAMPUNG, LAMPUNG",7,89,138,227
https://kawalpemilu.org#24807,"CAMPANG JAYA, SUKABUMI, KOTA BANDAR LAMPUNG, LAMPUNG",8,104,137,241
https://kawalpemilu.org#24807,"CAMPANG JAYA, SUKABUMI, KOTA BANDAR LAMPUNG, LAMPUNG",9,89,97,186
https://kawalpemilu.org#24807,"CAMPANG JAYA, SUKABUMI, KOTA BANDAR LAMPUNG, LAMPUNG",10,150,93,243
https://kawalpemilu.org#24807,"CAMPANG JAYA, SUKABUMI, KOTA BANDAR LAMPUNG, LAMPUNG",11,160,88,248
https://kawalpemilu.org#24807,"CAMPANG JAYA, SUKABUMI, KOTA BANDAR LAMPUNG, LAMPUNG",12,103,72,175
https://kawalpemilu.org#24807,"CAMPANG JAYA, SUKABUMI, KOTA BANDAR LAMPUNG, LAMPUNG",13,111,88,199
https://kawalpemilu.org#24807,"CAMPANG JAYA, SUKABUMI, KOTA BANDAR LAMPUNG, LAMPUNG",14,124,74,198
https://kawalpemilu.org#24807,"CAMPANG JAYA, SUKABUMI, KOTA BANDAR LAMPUNG, LAMPUNG",15,117,78,195
https://kawalpemilu.org#24807,"CAMPANG JAYA, SUKABUMI, KOTA BANDAR LAMPUNG, LAMPUNG",16,96,127,223
https://kawalpemilu.org#24807,"CAMPANG JAYA, SUKABUMI, KOTA BANDAR LAMPUNG, LAMPUNG",17,88,62,150
https://kawalpemilu.org#24807,"CAMPANG JAYA, SUKABUMI, KOTA BANDAR LAMPUNG, LAMPUNG",18,67,77,144
https://kawalpemilu.org#24807,"CAMPANG JAYA, SUKABUMI, KOTA BANDAR LAMPUNG, LAMPUNG",19,96,127,223
https://kawalpemilu.org#24807,"CAMPANG JAYA, SUKABUMI, KOTA BANDAR LAMPUNG, LAMPUNG",20,75,131,206
https://kawalpemilu.org#24807,"CAMPANG JAYA, SUKABUMI, KOTA BANDAR LAMPUNG, LAMPUNG",21,111,110,221
https://kawalpemilu.org#24807,"CAMPANG JAYA, SUKABUMI, KOTA BANDAR LAMPUNG, LAMPUNG",22,81,156,237
https://kawalpemilu.org#24807,"CAMPANG JAYA, SUKABUMI, KOTA BANDAR LAMPUNG, LAMPUNG",23,97,118,215
https://kawalpemilu.org#24807,"CAMPANG JAYA, SUKABUMI, KOTA BANDAR LAMPUNG, LAMPUNG",24,107,102,209
https://kawalpemilu.org#24807,"CAMPANG JAYA, SUKABUMI, KOTA BANDAR LAMPUNG, LAMPUNG",25,88,88,176
https://kawalpemilu.org#24807,"CAMPANG JAYA, SUKABUMI, KOTA BANDAR LAMPUNG, LAMPUNG",26,100,102,202
https://kawalpemilu.org#24807,"CAMPANG JAYA, SUKABUMI, KOTA BANDAR LAMPUNG, LAMPUNG",27,98,116,214
https://kawalpemilu.org#24808,"SUKABUMI, SUKABUMI, KOTA BANDAR LAMPUNG, LAMPUNG",1,66,113,179
https://kawalpemilu.org#24808,"SUKABUMI, SUKABUMI, KOTA BANDAR LAMPUNG, LAMPUNG",2,34,130,164
https://kawalpemilu.org#24808,"SUKABUMI, SUKABUMI, KOTA BANDAR LAMPUNG, LAMPUNG",3,22,124,146
https://kawalpemilu.org#24808,"SUKABUMI, SUKABUMI, KOTA BANDAR LAMPUNG, LAMPUNG",4,46,112,158
https://kawalpemilu.org#24808,"SUKABUMI, SUKABUMI, KOTA BANDAR LAMPUNG, LAMPUNG",5,91,94,185
https://kawalpemilu.org#24808,"SUKABUMI, SUKABUMI, KOTA BANDAR LAMPUNG, LAMPUNG",6,75,116,191
https://kawalpemilu.org#24808,"SUKABUMI, SUKABUMI, KOTA BANDAR LAMPUNG, LAMPUNG",7,109,179,283
https://kawalpemilu.org#24808,"SUKABUMI, SUKABUMI, KOTA BANDAR LAMPUNG, LAMPUNG",8,87,143,230
https://kawalpemilu.org#24808,"SUKABUMI, SUKABUMI, KOTA BANDAR LAMPUNG, LAMPUNG",9,75,196,271
https://kawalpemilu.org#24808,"SUKABUMI, SUKABUMI, KOTA BANDAR LAMPUNG, LAMPUNG",10,121,142,263
https://kawalpemilu.org#24808,"SUKABUMI, SUKABUMI, KOTA BANDAR LAMPUNG, LAMPUNG",11,98,133,231
https://kawalpemilu.org#24808,"SUKABUMI, SUKABUMI, KOTA BANDAR LAMPUNG, LAMPUNG",12,98,172,270
https://kawalpemilu.org#24808,"SUKABUMI, SUKABUMI, KOTA BANDAR LAMPUNG, LAMPUNG",13,71,101,172
https://kawalpemilu.org#24808,"SUKABUMI, SUKABUMI, KOTA BANDAR LAMPUNG, LAMPUNG",14,52,106,158
https://kawalpemilu.org#24808,"SUKABUMI, SUKABUMI, KOTA BANDAR LAMPUNG, LAMPUNG",15,62,164,226
https://kawalpemilu.org#24808,"SUKABUMI, SUKABUMI, KOTA BANDAR LAMPUNG, LAMPUNG",16,93,119,212
https://kawalpemilu.org#24808,"SUKABUMI, SUKABUMI, KOTA BANDAR LAMPUNG, LAMPUNG",17,59,128,187
https://kawalpemilu.org#24808,"SUKABUMI, SUKABUMI, KOTA BANDAR LAMPUNG, LAMPUNG",18,62,154,216
https://kawalpemilu.org#24808,"SUKABUMI, SUKABUMI, KOTA BANDAR LAMPUNG, LAMPUNG",19,86,142,228
https://kawalpemilu.org#24808,"SUKABUMI, SUKABUMI, KOTA BANDAR LAMPUNG, LAMPUNG",20,86,91,177
https://kawalpemilu.org#24808,"SUKABUMI, SUKABUMI, KOTA BANDAR LAMPUNG, LAMPUNG",21,0,0,0
https://kawalpemilu.org#24808,"SUKABUMI, SUKABUMI, KOTA BANDAR LAMPUNG, LAMPUNG",22,89,104,193
https://kawalpemilu.org#24808,"SUKABUMI, SUKABUMI, KOTA BANDAR LAMPUNG, LAMPUNG",23,64,92,156
https://kawalpemilu.org#24808,"SUKABUMI, SUKABUMI, KOTA BANDAR LAMPUNG, LAMPUNG",24,105,188,293
https://kawalpemilu.org#24808,"SUKABUMI, SUKABUMI, KOTA BANDAR LAMPUNG, LAMPUNG",25,94,110,204
https://kawalpemilu.org#24808,"SUKABUMI, SUKABUMI, KOTA BANDAR LAMPUNG, LAMPUNG",26,135,135,270
https://kawalpemilu.org#24808,"SUKABUMI, SUKABUMI, KOTA BANDAR LAMPUNG, LAMPUNG",27,156,145,301
https://kawalpemilu.org#24808,"SUKABUMI, SUKABUMI, KOTA BANDAR LAMPUNG, LAMPUNG",28,101,132,233
https://kawalpemilu.org#24808,"SUKABUMI, SUKABUMI, KOTA BANDAR LAMPUNG, LAMPUNG",29,112,94,206
https://kawalpemilu.org#24808,"SUKABUMI, SUKABUMI, KOTA BANDAR LAMPUNG, LAMPUNG",30,126,101,227
https://kawalpemilu.org#24808,"SUKABUMI, SUKABUMI, KOTA BANDAR LAMPUNG, LAMPUNG",31,89,169,258
https://kawalpemilu.org#24808,"SUKABUMI, SUKABUMI, KOTA BANDAR LAMPUNG, LAMPUNG",33,85,180,265
https://kawalpemilu.org#24808,"SUKABUMI, SUKABUMI, KOTA BANDAR LAMPUNG, LAMPUNG",34,82,128,210
https://kawalpemilu.org#24808,"SUKABUMI, SUKABUMI, KOTA BANDAR LAMPUNG, LAMPUNG",35,53,101,154
https://kawalpemilu.org#24808,"SUKABUMI, SUKABUMI, KOTA BANDAR LAMPUNG, LAMPUNG",36,109,75,184
https://kawalpemilu.org#24808,"SUKABUMI, SUKABUMI, KOTA BANDAR LAMPUNG, LAMPUNG",37,148,103,251
https://kawalpemilu.org#24808,"SUKABUMI, SUKABUMI, KOTA BANDAR LAMPUNG, LAMPUNG",38,83,162,245
https://kawalpemilu.org#24808,"SUKABUMI, SUKABUMI, KOTA BANDAR LAMPUNG, LAMPUNG",39,69,168,237
https://kawalpemilu.org#24808,"SUKABUMI, SUKABUMI, KOTA BANDAR LAMPUNG, LAMPUNG",40,59,100,159
https://kawalpemilu.org#24808,"SUKABUMI, SUKABUMI, KOTA BANDAR LAMPUNG, LAMPUNG",41,73,152,225
https://kawalpemilu.org#24808,"SUKABUMI, SUKABUMI, KOTA BANDAR LAMPUNG, LAMPUNG",43,86,116,202
https://kawalpemilu.org#24808,"SUKABUMI, SUKABUMI, KOTA BANDAR LAMPUNG, LAMPUNG",44,85,147,232
https://kawalpemilu.org#24808,"SUKABUMI, SUKABUMI, KOTA BANDAR LAMPUNG, LAMPUNG",45,86,176,262
https://kawalpemilu.org#24810,"SUKABUMI INDAH, SUKABUMI, KOTA BANDAR LAMPUNG, LAMPUNG",1,77,117,194
https://kawalpemilu.org#24810,"SUKABUMI INDAH, SUKABUMI, KOTA BANDAR LAMPUNG, LAMPUNG",2,104,145,249
https://kawalpemilu.org#24810,"SUKABUMI INDAH, SUKABUMI, KOTA BANDAR LAMPUNG, LAMPUNG",3,54,80,134
https://kawalpemilu.org#24810,"SUKABUMI INDAH, SUKABUMI, KOTA BANDAR LAMPUNG, LAMPUNG",4,102,136,238
https://kawalpemilu.org#24810,"SUKABUMI INDAH, SUKABUMI, KOTA BANDAR LAMPUNG, LAMPUNG",5,60,99,159
https://kawalpemilu.org#24810,"SUKABUMI INDAH, SUKABUMI, KOTA BANDAR LAMPUNG, LAMPUNG",6,50,119,169
https://kawalpemilu.org#24810,"SUKABUMI INDAH, SUKABUMI, KOTA BANDAR LAMPUNG, LAMPUNG",7,104,82,186
https://kawalpemilu.org#24810,"SUKABUMI INDAH, SUKABUMI, KOTA BANDAR LAMPUNG, LAMPUNG",8,58,89,147
https://kawalpemilu.org#24810,"SUKABUMI INDAH, SUKABUMI, KOTA BANDAR LAMPUNG, LAMPUNG",9,32,102,134
https://kawalpemilu.org#24810,"SUKABUMI INDAH, SUKABUMI, KOTA BANDAR LAMPUNG, LAMPUNG",10,68,69,137
https://kawalpemilu.org#24810,"SUKABUMI INDAH, SUKABUMI, KOTA BANDAR LAMPUNG, LAMPUNG",11,107,127,234
https://kawalpemilu.org#24810,"SUKABUMI INDAH, SUKABUMI, KOTA BANDAR LAMPUNG, LAMPUNG",12,114,168,282
https://kawalpemilu.org#24810,"SUKABUMI INDAH, SUKABUMI, KOTA BANDAR LAMPUNG, LAMPUNG",13,131,122,253
https://kawalpemilu.org#24810,"SUKABUMI INDAH, SUKABUMI, KOTA BANDAR LAMPUNG, LAMPUNG",14,104,110,214
https://kawalpemilu.org#24810,"SUKABUMI INDAH, SUKABUMI, KOTA BANDAR LAMPUNG, LAMPUNG",15,88,149,237
https://kawalpemilu.org#24810,"SUKABUMI INDAH, SUKABUMI, KOTA BANDAR LAMPUNG, LAMPUNG",16,70,66,136
https://kawalpemilu.org#24810,"SUKABUMI INDAH, SUKABUMI, KOTA BANDAR LAMPUNG, LAMPUNG",17,58,83,141
https://kawalpemilu.org#24810,"SUKABUMI INDAH, SUKABUMI, KOTA BANDAR LAMPUNG, LAMPUNG",18,108,115,223
https://kawalpemilu.org#24810,"SUKABUMI INDAH, SUKABUMI, KOTA BANDAR LAMPUNG, LAMPUNG",19,53,112,165
https://kawalpemilu.org#24810,"SUKABUMI INDAH, SUKABUMI, KOTA BANDAR LAMPUNG, LAMPUNG",20,102,137,239
https://kawalpemilu.org#24810,"SUKABUMI INDAH, SUKABUMI, KOTA BANDAR LAMPUNG, LAMPUNG",21,71,131,202
https://kawalpemilu.org#24810,"SUKABUMI INDAH, SUKABUMI, KOTA BANDAR LAMPUNG, LAMPUNG",22,89,170,259
https://kawalpemilu.org#24810,"SUKABUMI INDAH, SUKABUMI, KOTA BANDAR LAMPUNG, LAMPUNG",23,84,143,227
https://kawalpemilu.org#24810,"SUKABUMI INDAH, SUKABUMI, KOTA BANDAR LAMPUNG, LAMPUNG",24,105,188,293
https://kawalpemilu.org#24810,"SUKABUMI INDAH, SUKABUMI, KOTA BANDAR LAMPUNG, LAMPUNG",25,76,176,252
https://kawalpemilu.org#24810,"SUKABUMI INDAH, SUKABUMI, KOTA BANDAR LAMPUNG, LAMPUNG",26,65,96,161
https://kawalpemilu.org#24810,"SUKABUMI INDAH, SUKABUMI, KOTA BANDAR LAMPUNG, LAMPUNG",27,60,88,148
https://kawalpemilu.org#24810,"SUKABUMI INDAH, SUKABUMI, KOTA BANDAR LAMPUNG, LAMPUNG",28,122,152,274
https://kawalpemilu.org#24810,"SUKABUMI INDAH, SUKABUMI, KOTA BANDAR LAMPUNG, LAMPUNG",29,81,58,139
https://kawalpemilu.org#24811,"NUSANTARA PERMAI, SUKABUMI, KOTA BANDAR LAMPUNG, LAMPUNG",1,134,103,237
https://kawalpemilu.org#24811,"NUSANTARA PERMAI, SUKABUMI, KOTA BANDAR LAMPUNG, LAMPUNG",2,130,117,247
https://kawalpemilu.org#24811,"NUSANTARA PERMAI, SUKABUMI, KOTA BANDAR LAMPUNG, LAMPUNG",3,44,115,159
https://kawalpemilu.org#24811,"NUSANTARA PERMAI, SUKABUMI, KOTA BANDAR LAMPUNG, LAMPUNG",4,44,112,156
https://kawalpemilu.org#24811,"NUSANTARA PERMAI, SUKABUMI, KOTA BANDAR LAMPUNG, LAMPUNG",5,81,83,164
https://kawalpemilu.org#24811,"NUSANTARA PERMAI, SUKABUMI, KOTA BANDAR LAMPUNG, LAMPUNG",6,95,122,217
https://kawalpemilu.org#24811,"NUSANTARA PERMAI, SUKABUMI, KOTA BANDAR LAMPUNG, LAMPUNG",7,71,128,199
https://kawalpemilu.org#24811,"NUSANTARA PERMAI, SUKABUMI, KOTA BANDAR LAMPUNG, LAMPUNG",8,62,151,213
https://kawalpemilu.org#24811,"NUSANTARA PERMAI, SUKABUMI, KOTA BANDAR LAMPUNG, LAMPUNG",9,53,152,205
https://kawalpemilu.org#24811,"NUSANTARA PERMAI, SUKABUMI, KOTA BANDAR LAMPUNG, LAMPUNG",10,89,137,226
https://kawalpemilu.org#24811,"NUSANTARA PERMAI, SUKABUMI, KOTA BANDAR LAMPUNG, LAMPUNG",11,222,85,307
https://kawalpemilu.org#24815,"SUMBER REJO, KEMILING, KOTA BANDAR LAMPUNG, LAMPUNG",1,71,137,208
https://kawalpemilu.org#24815,"SUMBER REJO, KEMILING, KOTA BANDAR LAMPUNG, LAMPUNG",2,73,138,211
https://kawalpemilu.org#24815,"SUMBER REJO, KEMILING, KOTA BANDAR LAMPUNG, LAMPUNG",3,67,139,206
https://kawalpemilu.org#24815,"SUMBER REJO, KEMILING, KOTA BANDAR LAMPUNG, LAMPUNG",4,80,138,218
https://kawalpemilu.org#24815,"SUMBER REJO, KEMILING, KOTA BANDAR LAMPUNG, LAMPUNG",5,92,152,244
https://kawalpemilu.org#24815,"SUMBER REJO, KEMILING, KOTA BANDAR LAMPUNG, LAMPUNG",6,71,155,226
https://kawalpemilu.org#24815,"SUMBER REJO, KEMILING, KOTA BANDAR LAMPUNG, LAMPUNG",7,85,131,216
https://kawalpemilu.org#24815,"SUMBER REJO, KEMILING, KOTA BANDAR LAMPUNG, LAMPUNG",8,92,123,215
https://kawalpemilu.org#24815,"SUMBER REJO, KEMILING, KOTA BANDAR LAMPUNG, LAMPUNG",9,67,142,209
https://kawalpemilu.org#24815,"SUMBER REJO, KEMILING, KOTA BANDAR LAMPUNG, LAMPUNG",10,127,129,256
https://kawalpemilu.org#24815,"SUMBER REJO, KEMILING, KOTA BANDAR LAMPUNG, LAMPUNG",11,122,134,256
https://kawalpemilu.org#24815,"SUMBER REJO, KEMILING, KOTA BANDAR LAMPUNG, LAMPUNG",12,100,126,226
https://kawalpemilu.org#24815,"SUMBER REJO, KEMILING, KOTA BANDAR LAMPUNG, LAMPUNG",13,115,77,192
https://kawalpemilu.org#24815,"SUMBER REJO, KEMILING, KOTA BANDAR LAMPUNG, LAMPUNG",14,98,101,199
https://kawalpemilu.org#24815,"SUMBER REJO, KEMILING, KOTA BANDAR LAMPUNG, LAMPUNG",15,131,106,237
https://kawalpemilu.org#24815,"SUMBER REJO, KEMILING, KOTA BANDAR LAMPUNG, LAMPUNG",16,55,144,199
https://kawalpemilu.org#24815,"SUMBER REJO, KEMILING, KOTA BANDAR LAMPUNG, LAMPUNG",17,91,121,212
https://kawalpemilu.org#24815,"SUMBER REJO, KEMILING, KOTA BANDAR LAMPUNG, LAMPUNG",18,82,154,236
https://kawalpemilu.org#24815,"SUMBER REJO, KEMILING, KOTA BANDAR LAMPUNG, LAMPUNG",19,102,124,226
https://kawalpemilu.org#24815,"SUMBER REJO, KEMILING, KOTA BANDAR LAMPUNG, LAMPUNG",20,137,121,258
https://kawalpemilu.org#24815,"SUMBER REJO, KEMILING, KOTA BANDAR LAMPUNG, LAMPUNG",21,76,159,235
https://kawalpemilu.org#24815,"SUMBER REJO, KEMILING, KOTA BANDAR LAMPUNG, LAMPUNG",22,61,135,196
https://kawalpemilu.org#24815,"SUMBER REJO, KEMILING, KOTA BANDAR LAMPUNG, LAMPUNG",23,100,143,243
https://kawalpemilu.org#24815,"SUMBER REJO, KEMILING, KOTA BANDAR LAMPUNG, LAMPUNG",24,80,147,227
https://kawalpemilu.org#24815,"SUMBER REJO, KEMILING, KOTA BANDAR LAMPUNG, LAMPUNG",25,45,100,145
https://kawalpemilu.org#24815,"SUMBER REJO, KEMILING, KOTA BANDAR LAMPUNG, LAMPUNG",26,49,147,196
https://kawalpemilu.org#24817,"BERINGIN RAYA, KEMILING, KOTA BANDAR LAMPUNG, LAMPUNG",1,64,129,193
https://kawalpemilu.org#24817,"BERINGIN RAYA, KEMILING, KOTA BANDAR LAMPUNG, LAMPUNG",2,80,168,248
https://kawalpemilu.org#24817,"BERINGIN RAYA, KEMILING, KOTA BANDAR LAMPUNG, LAMPUNG",3,49,203,252
https://kawalpemilu.org#24817,"BERINGIN RAYA, KEMILING, KOTA BANDAR LAMPUNG, LAMPUNG",4,73,102,175
https://kawalpemilu.org#24817,"BERINGIN RAYA, KEMILING, KOTA BANDAR LAMPUNG, LAMPUNG",5,79,137,216
https://kawalpemilu.org#24817,"BERINGIN RAYA, KEMILING, KOTA BANDAR LAMPUNG, LAMPUNG",6,54,104,158
https://kawalpemilu.org#24817,"BERINGIN RAYA, KEMILING, KOTA BANDAR LAMPUNG, LAMPUNG",7,71,132,203
https://kawalpemilu.org#24817,"BERINGIN RAYA, KEMILING, KOTA BANDAR LAMPUNG, LAMPUNG",9,76,168,244
https://kawalpemilu.org#24817,"BERINGIN RAYA, KEMILING, KOTA BANDAR LAMPUNG, LAMPUNG",10,53,159,212
https://kawalpemilu.org#24817,"BERINGIN RAYA, KEMILING, KOTA BANDAR LAMPUNG, LAMPUNG",11,68,124,192
https://kawalpemilu.org#24817,"BERINGIN RAYA, KEMILING, KOTA BANDAR LAMPUNG, LAMPUNG",12,56,150,206
https://kawalpemilu.org#24817,"BERINGIN RAYA, KEMILING, KOTA BANDAR LAMPUNG, LAMPUNG",13,56,157,213
https://kawalpemilu.org#24817,"BERINGIN RAYA, KEMILING, KOTA BANDAR LAMPUNG, LAMPUNG",14,71,176,247
https://kawalpemilu.org#24817,"BERINGIN RAYA, KEMILING, KOTA BANDAR LAMPUNG, LAMPUNG",15,115,169,284
https://kawalpemilu.org#24817,"BERINGIN RAYA, KEMILING, KOTA BANDAR LAMPUNG, LAMPUNG",16,59,132,191
https://kawalpemilu.org#24817,"BERINGIN RAYA, KEMILING, KOTA BANDAR LAMPUNG, LAMPUNG",17,53,165,218
https://kawalpemilu.org#24817,"BERINGIN RAYA, KEMILING, KOTA BANDAR LAMPUNG, LAMPUNG",18,63,157,220
https://kawalpemilu.org#24817,"BERINGIN RAYA, KEMILING, KOTA BANDAR LAMPUNG, LAMPUNG",19,90,127,217
https://kawalpemilu.org#24817,"BERINGIN RAYA, KEMILING, KOTA BANDAR LAMPUNG, LAMPUNG",20,73,167,240
https://kawalpemilu.org#24817,"BERINGIN RAYA, KEMILING, KOTA BANDAR LAMPUNG, LAMPUNG",21,70,119,189
https://kawalpemilu.org#24817,"BERINGIN RAYA, KEMILING, KOTA BANDAR LAMPUNG, LAMPUNG",22,103,125,228
https://kawalpemilu.org#24817,"BERINGIN RAYA, KEMILING, KOTA BANDAR LAMPUNG, LAMPUNG",23,77,138,215
https://kawalpemilu.org#24817,"BERINGIN RAYA, KEMILING, KOTA BANDAR LAMPUNG, LAMPUNG",24,42,149,191
https://kawalpemilu.org#24817,"BERINGIN RAYA, KEMILING, KOTA BANDAR LAMPUNG, LAMPUNG",25,63,126,189
https://kawalpemilu.org#24817,"BERINGIN RAYA, KEMILING, KOTA BANDAR LAMPUNG, LAMPUNG",26,66,197,263
https://kawalpemilu.org#24817,"BERINGIN RAYA, KEMILING, KOTA BANDAR LAMPUNG, LAMPUNG",27,49,71,120
https://kawalpemilu.org#24817,"BERINGIN RAYA, KEMILING, KOTA BANDAR LAMPUNG, LAMPUNG",28,28,100,128
https://kawalpemilu.org#24817,"BERINGIN RAYA, KEMILING, KOTA BANDAR LAMPUNG, LAMPUNG",29,47,159,206
https://kawalpemilu.org#24817,"BERINGIN RAYA, KEMILING, KOTA BANDAR LAMPUNG, LAMPUNG",30,43,132,175
https://kawalpemilu.org#24817,"BERINGIN RAYA, KEMILING, KOTA BANDAR LAMPUNG, LAMPUNG",32,75,145,220
https://kawalpemilu.org#24817,"BERINGIN RAYA, KEMILING, KOTA BANDAR LAMPUNG, LAMPUNG",33,53,156,209
https://kawalpemilu.org#24817,"BERINGIN RAYA, KEMILING, KOTA BANDAR LAMPUNG, LAMPUNG",34,52,99,151
https://kawalpemilu.org#24818,"KEMILING PERMAI, KEMILING, KOTA BANDAR LAMPUNG, LAMPUNG",1,64,174,238
https://kawalpemilu.org#24818,"KEMILING PERMAI, KEMILING, KOTA BANDAR LAMPUNG, LAMPUNG",2,69,219,288
https://kawalpemilu.org#24818,"KEMILING PERMAI, KEMILING, KOTA BANDAR LAMPUNG, LAMPUNG",3,54,190,244
https://kawalpemilu.org#24818,"KEMILING PERMAI, KEMILING, KOTA BANDAR LAMPUNG, LAMPUNG",4,34,179,213
https://kawalpemilu.org#24818,"KEMILING PERMAI, KEMILING, KOTA BANDAR LAMPUNG, LAMPUNG",5,66,173,239
https://kawalpemilu.org#24818,"KEMILING PERMAI, KEMILING, KOTA BANDAR LAMPUNG, LAMPUNG",6,33,116,149
https://kawalpemilu.org#24818,"KEMILING PERMAI, KEMILING, KOTA BANDAR LAMPUNG, LAMPUNG",7,34,77,111
https://kawalpemilu.org#24818,"KEMILING PERMAI, KEMILING, KOTA BANDAR LAMPUNG, LAMPUNG",8,71,180,251
https://kawalpemilu.org#24818,"KEMILING PERMAI, KEMILING, KOTA BANDAR LAMPUNG, LAMPUNG",9,61,195,256
https://kawalpemilu.org#24818,"KEMILING PERMAI, KEMILING, KOTA BANDAR LAMPUNG, LAMPUNG",10,66,190,256
https://kawalpemilu.org#24818,"KEMILING PERMAI, KEMILING, KOTA BANDAR LAMPUNG, LAMPUNG",11,70,174,244
https://kawalpemilu.org#24818,"KEMILING PERMAI, KEMILING, KOTA BANDAR LAMPUNG, LAMPUNG",12,49,179,228
https://kawalpemilu.org#24818,"KEMILING PERMAI, KEMILING, KOTA BANDAR LAMPUNG, LAMPUNG",13,78,192,270
https://kawalpemilu.org#24818,"KEMILING PERMAI, KEMILING, KOTA BANDAR LAMPUNG, LAMPUNG",14,50,104,154
https://kawalpemilu.org#24818,"KEMILING PERMAI, KEMILING, KOTA BANDAR LAMPUNG, LAMPUNG",15,43,97,140
https://kawalpemilu.org#24818,"KEMILING PERMAI, KEMILING, KOTA BANDAR LAMPUNG, LAMPUNG",16,78,120,198
https://kawalpemilu.org#24818,"KEMILING PERMAI, KEMILING, KOTA BANDAR LAMPUNG, LAMPUNG",17,41,110,151
https://kawalpemilu.org#24818,"KEMILING PERMAI, KEMILING, KOTA BANDAR LAMPUNG, LAMPUNG",18,43,159,202
https://kawalpemilu.org#24818,"KEMILING PERMAI, KEMILING, KOTA BANDAR LAMPUNG, LAMPUNG",19,45,113,158
https://kawalpemilu.org#24818,"KEMILING PERMAI, KEMILING, KOTA BANDAR LAMPUNG, LAMPUNG",20,57,113,170
https://kawalpemilu.org#24818,"KEMILING PERMAI, KEMILING, KOTA BANDAR LAMPUNG, LAMPUNG",21,44,115,159
https://kawalpemilu.org#24818,"KEMILING PERMAI, KEMILING, KOTA BANDAR LAMPUNG, LAMPUNG",22,58,92,150
https://kawalpemilu.org#24818,"KEMILING PERMAI, KEMILING, KOTA BANDAR LAMPUNG, LAMPUNG",23,64,83,147
https://kawalpemilu.org#24818,"KEMILING PERMAI, KEMILING, KOTA BANDAR LAMPUNG, LAMPUNG",24,65,110,175
https://kawalpemilu.org#24818,"KEMILING PERMAI, KEMILING, KOTA BANDAR LAMPUNG, LAMPUNG",25,60,127,187
https://kawalpemilu.org#24818,"KEMILING PERMAI, KEMILING, KOTA BANDAR LAMPUNG, LAMPUNG",26,51,117,168
https://kawalpemilu.org#24818,"KEMILING PERMAI, KEMILING, KOTA BANDAR LAMPUNG, LAMPUNG",27,72,150,222
https://kawalpemilu.org#24818,"KEMILING PERMAI, KEMILING, KOTA BANDAR LAMPUNG, LAMPUNG",28,79,161,240
https://kawalpemilu.org#24818,"KEMILING PERMAI, KEMILING, KOTA BANDAR LAMPUNG, LAMPUNG",29,94,211,305
https://kawalpemilu.org#24818,"KEMILING PERMAI, KEMILING, KOTA BANDAR LAMPUNG, LAMPUNG",30,57,224,281
https://kawalpemilu.org#24818,"KEMILING PERMAI, KEMILING, KOTA BANDAR LAMPUNG, LAMPUNG",31,48,141,189
https://kawalpemilu.org#24818,"KEMILING PERMAI, KEMILING, KOTA BANDAR LAMPUNG, LAMPUNG",32,87,137,224
https://kawalpemilu.org#24818,"KEMILING PERMAI, KEMILING, KOTA BANDAR LAMPUNG, LAMPUNG",33,52,124,176
https://kawalpemilu.org#24819,"SUMBER AGUNG, KEMILING, KOTA BANDAR LAMPUNG, LAMPUNG",1,139,105,244
https://kawalpemilu.org#24819,"SUMBER AGUNG, KEMILING, KOTA BANDAR LAMPUNG, LAMPUNG",2,142,74,216
https://kawalpemilu.org#24819,"SUMBER AGUNG, KEMILING, KOTA BANDAR LAMPUNG, LAMPUNG",3,152,38,190
https://kawalpemilu.org#24819,"SUMBER AGUNG, KEMILING, KOTA BANDAR LAMPUNG, LAMPUNG",4,170,71,241
https://kawalpemilu.org#24819,"SUMBER AGUNG, KEMILING, KOTA BANDAR LAMPUNG, LAMPUNG",5,142,85,227
https://kawalpemilu.org#24819,"SUMBER AGUNG, KEMILING, KOTA BANDAR LAMPUNG, LAMPUNG",6,152,83,235
https://kawalpemilu.org#24819,"SUMBER AGUNG, KEMILING, KOTA BANDAR LAMPUNG, LAMPUNG",7,120,85,205
https://kawalpemilu.org#24819,"SUMBER AGUNG, KEMILING, KOTA BANDAR LAMPUNG, LAMPUNG",8,116,100,216
https://kawalpemilu.org#24819,"SUMBER AGUNG, KEMILING, KOTA BANDAR LAMPUNG, LAMPUNG",9,105,92,197
https://kawalpemilu.org#24819,"SUMBER AGUNG, KEMILING, KOTA BANDAR LAMPUNG, LAMPUNG",10,93,98,191
https://kawalpemilu.org#24819,"SUMBER AGUNG, KEMILING, KOTA BANDAR LAMPUNG, LAMPUNG",11,89,58,147
https://kawalpemilu.org#24819,"SUMBER AGUNG, KEMILING, KOTA BANDAR LAMPUNG, LAMPUNG",12,132,76,208
https://kawalpemilu.org#24820,"KEDAUNG, KEMILING, KOTA BANDAR LAMPUNG, LAMPUNG",1,94,132,226
https://kawalpemilu.org#24820,"KEDAUNG, KEMILING, KOTA BANDAR LAMPUNG, LAMPUNG",2,103,114,217
https://kawalpemilu.org#24820,"KEDAUNG, KEMILING, KOTA BANDAR LAMPUNG, LAMPUNG",3,109,113,222
https://kawalpemilu.org#24820,"KEDAUNG, KEMILING, KOTA BANDAR LAMPUNG, LAMPUNG",4,87,121,208
https://kawalpemilu.org#24820,"KEDAUNG, KEMILING, KOTA BANDAR LAMPUNG, LAMPUNG",5,122,75,197
https://kawalpemilu.org#24820,"KEDAUNG, KEMILING, KOTA BANDAR LAMPUNG, LAMPUNG",6,98,94,192
https://kawalpemilu.org#24820,"KEDAUNG, KEMILING, KOTA BANDAR LAMPUNG, LAMPUNG",7,101,33,134
https://kawalpemilu.org#24821,"PINANG JAYA, KEMILING, KOTA BANDAR LAMPUNG, LAMPUNG",1,97,119,216
https://kawalpemilu.org#24821,"PINANG JAYA, KEMILING, KOTA BANDAR LAMPUNG, LAMPUNG",2,126,94,220
https://kawalpemilu.org#24821,"PINANG JAYA, KEMILING, KOTA BANDAR LAMPUNG, LAMPUNG",3,138,97,235
https://kawalpemilu.org#24821,"PINANG JAYA, KEMILING, KOTA BANDAR LAMPUNG, LAMPUNG",4,154,79,233
https://kawalpemilu.org#24821,"PINANG JAYA, KEMILING, KOTA BANDAR LAMPUNG, LAMPUNG",6,90,67,157
https://kawalpemilu.org#24821,"PINANG JAYA, KEMILING, KOTA BANDAR LAMPUNG, LAMPUNG",7,99,132,231
https://kawalpemilu.org#24821,"PINANG JAYA, KEMILING, KOTA BANDAR LAMPUNG, LAMPUNG",8,57,83,140
https://kawalpemilu.org#24821,"PINANG JAYA, KEMILING, KOTA BANDAR LAMPUNG, LAMPUNG",9,34,109,143
https://kawalpemilu.org#24821,"PINANG JAYA, KEMILING, KOTA BANDAR LAMPUNG, LAMPUNG",10,113,65,178
https://kawalpemilu.org#24821,"PINANG JAYA, KEMILING, KOTA BANDAR LAMPUNG, LAMPUNG",11,92,98,190
https://kawalpemilu.org#24821,"PINANG JAYA, KEMILING, KOTA BANDAR LAMPUNG, LAMPUNG",12,93,94,187
https://kawalpemilu.org#24821,"PINANG JAYA, KEMILING, KOTA BANDAR LAMPUNG, LAMPUNG",14,109,119,228
https://kawalpemilu.org#24821,"PINANG JAYA, KEMILING, KOTA BANDAR LAMPUNG, LAMPUNG",15,106,118,224
https://kawalpemilu.org#24821,"PINANG JAYA, KEMILING, KOTA BANDAR LAMPUNG, LAMPUNG",16,61,152,213
https://kawalpemilu.org#24821,"PINANG JAYA, KEMILING, KOTA BANDAR LAMPUNG, LAMPUNG",17,36,158,194
https://kawalpemilu.org#24821,"PINANG JAYA, KEMILING, KOTA BANDAR LAMPUNG, LAMPUNG",18,102,137,239
https://kawalpemilu.org#24821,"PINANG JAYA, KEMILING, KOTA BANDAR LAMPUNG, LAMPUNG",19,91,131,222
https://kawalpemilu.org#24821,"PINANG JAYA, KEMILING, KOTA BANDAR LAMPUNG, LAMPUNG",20,79,75,154
https://kawalpemilu.org#87248,"BERINGIN JAYA, KEMILING, KOTA BANDAR LAMPUNG, LAMPUNG",1,100,153,253
https://kawalpemilu.org#87248,"BERINGIN JAYA, KEMILING, KOTA BANDAR LAMPUNG, LAMPUNG",2,53,174,227
https://kawalpemilu.org#87248,"BERINGIN JAYA, KEMILING, KOTA BANDAR LAMPUNG, LAMPUNG",3,47,152,199
https://kawalpemilu.org#87248,"BERINGIN JAYA, KEMILING, KOTA BANDAR LAMPUNG, LAMPUNG",4,61,170,231
https://kawalpemilu.org#87248,"BERINGIN JAYA, KEMILING, KOTA BANDAR LAMPUNG, LAMPUNG",5,81,164,245
https://kawalpemilu.org#87248,"BERINGIN JAYA, KEMILING, KOTA BANDAR LAMPUNG, LAMPUNG",6,76,128,204
https://kawalpemilu.org#87248,"BERINGIN JAYA, KEMILING, KOTA BANDAR LAMPUNG, LAMPUNG",7,62,150,212
https://kawalpemilu.org#87248,"BERINGIN JAYA, KEMILING, KOTA BANDAR LAMPUNG, LAMPUNG",8,62,131,193
https://kawalpemilu.org#87248,"BERINGIN JAYA, KEMILING, KOTA BANDAR LAMPUNG, LAMPUNG",9,80,155,235
https://kawalpemilu.org#87248,"BERINGIN JAYA, KEMILING, KOTA BANDAR LAMPUNG, LAMPUNG",10,89,155,244
https://kawalpemilu.org#87248,"BERINGIN JAYA, KEMILING, KOTA BANDAR LAMPUNG, LAMPUNG",11,34,204,238
https://kawalpemilu.org#87248,"BERINGIN JAYA, KEMILING, KOTA BANDAR LAMPUNG, LAMPUNG",12,130,92,222
https://kawalpemilu.org#87248,"BERINGIN JAYA, KEMILING, KOTA BANDAR LAMPUNG, LAMPUNG",13,99,119,218
https://kawalpemilu.org#87248,"BERINGIN JAYA, KEMILING, KOTA BANDAR LAMPUNG, LAMPUNG",14,86,85,171
https://kawalpemilu.org#87248,"BERINGIN JAYA, KEMILING, KOTA BANDAR LAMPUNG, LAMPUNG",15,115,114,229
https://kawalpemilu.org#87248,"BERINGIN JAYA, KEMILING, KOTA BANDAR LAMPUNG, LAMPUNG",16,123,78,201
https://kawalpemilu.org#87248,"BERINGIN JAYA, KEMILING, KOTA BANDAR LAMPUNG, LAMPUNG",17,109,114,223
https://kawalpemilu.org#87248,"BERINGIN JAYA, KEMILING, KOTA BANDAR LAMPUNG, LAMPUNG",18,125,92,217
https://kawalpemilu.org#87248,"BERINGIN JAYA, KEMILING, KOTA BANDAR LAMPUNG, LAMPUNG",19,97,129,226
https://kawalpemilu.org#87248,"BERINGIN JAYA, KEMILING, KOTA BANDAR LAMPUNG, LAMPUNG",20,91,95,186
https://kawalpemilu.org#87248,"BERINGIN JAYA, KEMILING, KOTA BANDAR LAMPUNG, LAMPUNG",21,79,125,204
https://kawalpemilu.org#87248,"BERINGIN JAYA, KEMILING, KOTA BANDAR LAMPUNG, LAMPUNG",22,130,71,201
https://kawalpemilu.org#87250,"SUMBERREJO SEJAHTERA, KEMILING, KOTA BANDAR LAMPUNG, LAMPUNG",2,83,132,215
https://kawalpemilu.org#87250,"SUMBERREJO SEJAHTERA, KEMILING, KOTA BANDAR LAMPUNG, LAMPUNG",3,84,120,204
https://kawalpemilu.org#87250,"SUMBERREJO SEJAHTERA, KEMILING, KOTA BANDAR LAMPUNG, LAMPUNG",4,66,111,177
https://kawalpemilu.org#87250,"SUMBERREJO SEJAHTERA, KEMILING, KOTA BANDAR LAMPUNG, LAMPUNG",5,80,128,208
https://kawalpemilu.org#87250,"SUMBERREJO SEJAHTERA, KEMILING, KOTA BANDAR LAMPUNG, LAMPUNG",6,60,132,192
https://kawalpemilu.org#87250,"SUMBERREJO SEJAHTERA, KEMILING, KOTA BANDAR LAMPUNG, LAMPUNG",7,99,163,262
https://kawalpemilu.org#87250,"SUMBERREJO SEJAHTERA, KEMILING, KOTA BANDAR LAMPUNG, LAMPUNG",8,80,126,206
https://kawalpemilu.org#87250,"SUMBERREJO SEJAHTERA, KEMILING, KOTA BANDAR LAMPUNG, LAMPUNG",9,87,96,183
https://kawalpemilu.org#87250,"SUMBERREJO SEJAHTERA, KEMILING, KOTA BANDAR LAMPUNG, LAMPUNG",10,75,96,171
https://kawalpemilu.org#87250,"SUMBERREJO SEJAHTERA, KEMILING, KOTA BANDAR LAMPUNG, LAMPUNG",11,92,87,179
https://kawalpemilu.org#87250,"SUMBERREJO SEJAHTERA, KEMILING, KOTA BANDAR LAMPUNG, LAMPUNG",12,135,87,222
https://kawalpemilu.org#87250,"SUMBERREJO SEJAHTERA, KEMILING, KOTA BANDAR LAMPUNG, LAMPUNG",13,132,97,229
https://kawalpemilu.org#87250,"SUMBERREJO SEJAHTERA, KEMILING, KOTA BANDAR LAMPUNG, LAMPUNG",14,105,111,216
https://kawalpemilu.org#87250,"SUMBERREJO SEJAHTERA, KEMILING, KOTA BANDAR LAMPUNG, LAMPUNG",15,121,106,227
https://kawalpemilu.org#87250,"SUMBERREJO SEJAHTERA, KEMILING, KOTA BANDAR LAMPUNG, LAMPUNG",16,92,107,199
https://kawalpemilu.org#87250,"SUMBERREJO SEJAHTERA, KEMILING, KOTA BANDAR LAMPUNG, LAMPUNG",17,108,103,211
https://kawalpemilu.org#87250,"SUMBERREJO SEJAHTERA, KEMILING, KOTA BANDAR LAMPUNG, LAMPUNG",18,76,145,221
https://kawalpemilu.org#87250,"SUMBERREJO SEJAHTERA, KEMILING, KOTA BANDAR LAMPUNG, LAMPUNG",19,117,142,259
https://kawalpemilu.org#87250,"SUMBERREJO SEJAHTERA, KEMILING, KOTA BANDAR LAMPUNG, LAMPUNG",20,101,161,262
https://kawalpemilu.org#87250,"SUMBERREJO SEJAHTERA, KEMILING, KOTA BANDAR LAMPUNG, LAMPUNG",21,121,109,230
https://kawalpemilu.org#87250,"SUMBERREJO SEJAHTERA, KEMILING, KOTA BANDAR LAMPUNG, LAMPUNG",22,114,115,229
https://kawalpemilu.org#87250,"SUMBERREJO SEJAHTERA, KEMILING, KOTA BANDAR LAMPUNG, LAMPUNG",23,109,123,232
https://kawalpemilu.org#87250,"SUMBERREJO SEJAHTERA, KEMILING, KOTA BANDAR LAMPUNG, LAMPUNG",24,71,192,263
https://kawalpemilu.org#87250,"SUMBERREJO SEJAHTERA, KEMILING, KOTA BANDAR LAMPUNG, LAMPUNG",25,66,175,241
https://kawalpemilu.org#87250,"SUMBERREJO SEJAHTERA, KEMILING, KOTA BANDAR LAMPUNG, LAMPUNG",26,68,79,147
https://kawalpemilu.org#87250,"SUMBERREJO SEJAHTERA, KEMILING, KOTA BANDAR LAMPUNG, LAMPUNG",27,108,62,170
https://kawalpemilu.org#87250,"SUMBERREJO SEJAHTERA, KEMILING, KOTA BANDAR LAMPUNG, LAMPUNG",28,85,121,206
https://kawalpemilu.org#87252,"KEMILING RAYA, KEMILING, KOTA BANDAR LAMPUNG, LAMPUNG",1,74,143,217
https://kawalpemilu.org#87252,"KEMILING RAYA, KEMILING, KOTA BANDAR LAMPUNG, LAMPUNG",2,51,148,199
https://kawalpemilu.org#87252,"KEMILING RAYA, KEMILING, KOTA BANDAR LAMPUNG, LAMPUNG",3,77,130,207
https://kawalpemilu.org#87252,"KEMILING RAYA, KEMILING, KOTA BANDAR LAMPUNG, LAMPUNG",4,62,137,199
https://kawalpemilu.org#87252,"KEMILING RAYA, KEMILING, KOTA BANDAR LAMPUNG, LAMPUNG",5,89,103,192
https://kawalpemilu.org#87252,"KEMILING RAYA, KEMILING, KOTA BANDAR LAMPUNG, LAMPUNG",6,75,114,189
https://kawalpemilu.org#87252,"KEMILING RAYA, KEMILING, KOTA BANDAR LAMPUNG, LAMPUNG",8,101,112,213
https://kawalpemilu.org#87252,"KEMILING RAYA, KEMILING, KOTA BANDAR LAMPUNG, LAMPUNG",9,91,93,184
https://kawalpemilu.org#87252,"KEMILING RAYA, KEMILING, KOTA BANDAR LAMPUNG, LAMPUNG",10,90,101,191
https://kawalpemilu.org#87252,"KEMILING RAYA, KEMILING, KOTA BANDAR LAMPUNG, LAMPUNG",11,103,131,234
https://kawalpemilu.org#87252,"KEMILING RAYA, KEMILING, KOTA BANDAR LAMPUNG, LAMPUNG",12,121,129,250
https://kawalpemilu.org#87252,"KEMILING RAYA, KEMILING, KOTA BANDAR LAMPUNG, LAMPUNG",13,93,132,225
https://kawalpemilu.org#87252,"KEMILING RAYA, KEMILING, KOTA BANDAR LAMPUNG, LAMPUNG",14,79,149,228
https://kawalpemilu.org#87252,"KEMILING RAYA, KEMILING, KOTA BANDAR LAMPUNG, LAMPUNG",15,115,129,244
https://kawalpemilu.org#87252,"KEMILING RAYA, KEMILING, KOTA BANDAR LAMPUNG, LAMPUNG",16,90,136,226
https://kawalpemilu.org#87252,"KEMILING RAYA, KEMILING, KOTA BANDAR LAMPUNG, LAMPUNG",17,80,79,159
https://kawalpemilu.org#87252,"KEMILING RAYA, KEMILING, KOTA BANDAR LAMPUNG, LAMPUNG",18,73,69,142
https://kawalpemilu.org#87252,"KEMILING RAYA, KEMILING, KOTA BANDAR LAMPUNG, LAMPUNG",19,60,106,166
https://kawalpemilu.org#87252,"KEMILING RAYA, KEMILING, KOTA BANDAR LAMPUNG, LAMPUNG",20,32,86,118
https://kawalpemilu.org#87252,"KEMILING RAYA, KEMILING, KOTA BANDAR LAMPUNG, LAMPUNG",21,33,50,83
https://kawalpemilu.org#24711,"KAMPUNG BARU, LABUHAN RATU, KOTA BANDAR LAMPUNG, LAMPUNG",1,111,138,249
https://kawalpemilu.org#24711,"KAMPUNG BARU, LABUHAN RATU, KOTA BANDAR LAMPUNG, LAMPUNG",2,55,157,212
https://kawalpemilu.org#24711,"KAMPUNG BARU, LABUHAN RATU, KOTA BANDAR LAMPUNG, LAMPUNG",3,72,154,226
https://kawalpemilu.org#24711,"KAMPUNG BARU, LABUHAN RATU, KOTA BANDAR LAMPUNG, LAMPUNG",4,56,167,223
https://kawalpemilu.org#24711,"KAMPUNG BARU, LABUHAN RATU, KOTA BANDAR LAMPUNG, LAMPUNG",5,105,130,235
https://kawalpemilu.org#24711,"KAMPUNG BARU, LABUHAN RATU, KOTA BANDAR LAMPUNG, LAMPUNG",6,124,155,279
https://kawalpemilu.org#24711,"KAMPUNG BARU, LABUHAN RATU, KOTA BANDAR LAMPUNG, LAMPUNG",7,100,141,241
https://kawalpemilu.org#24711,"KAMPUNG BARU, LABUHAN RATU, KOTA BANDAR LAMPUNG, LAMPUNG",8,91,176,267
https://kawalpemilu.org#24711,"KAMPUNG BARU, LABUHAN RATU, KOTA BANDAR LAMPUNG, LAMPUNG",9,75,156,231
https://kawalpemilu.org#24711,"KAMPUNG BARU, LABUHAN RATU, KOTA BANDAR LAMPUNG, LAMPUNG",10,68,138,206
https://kawalpemilu.org#24711,"KAMPUNG BARU, LABUHAN RATU, KOTA BANDAR LAMPUNG, LAMPUNG",11,56,142,198
https://kawalpemilu.org#24711,"KAMPUNG BARU, LABUHAN RATU, KOTA BANDAR LAMPUNG, LAMPUNG",12,84,111,195
https://kawalpemilu.org#24711,"KAMPUNG BARU, LABUHAN RATU, KOTA BANDAR LAMPUNG, LAMPUNG",13,95,117,212
https://kawalpemilu.org#24711,"KAMPUNG BARU, LABUHAN RATU, KOTA BANDAR LAMPUNG, LAMPUNG",14,111,127,238
https://kawalpemilu.org#24717,"LABUHAN RATU, LABUHAN RATU, KOTA BANDAR LAMPUNG, LAMPUNG",1,34,97,131
https://kawalpemilu.org#24717,"LABUHAN RATU, LABUHAN RATU, KOTA BANDAR LAMPUNG, LAMPUNG",2,29,92,121
https://kawalpemilu.org#24717,"LABUHAN RATU, LABUHAN RATU, KOTA BANDAR LAMPUNG, LAMPUNG",3,65,80,145
https://kawalpemilu.org#24717,"LABUHAN RATU, LABUHAN RATU, KOTA BANDAR LAMPUNG, LAMPUNG",4,28,110,138
https://kawalpemilu.org#24717,"LABUHAN RATU, LABUHAN RATU, KOTA BANDAR LAMPUNG, LAMPUNG",5,33,114,147
https://kawalpemilu.org#24717,"LABUHAN RATU, LABUHAN RATU, KOTA BANDAR LAMPUNG, LAMPUNG",6,38,82,120
https://kawalpemilu.org#24717,"LABUHAN RATU, LABUHAN RATU, KOTA BANDAR LAMPUNG, LAMPUNG",8,48,95,143
https://kawalpemilu.org#24717,"LABUHAN RATU, LABUHAN RATU, KOTA BANDAR LAMPUNG, LAMPUNG",9,85,184,269
https://kawalpemilu.org#24717,"LABUHAN RATU, LABUHAN RATU, KOTA BANDAR LAMPUNG, LAMPUNG",10,43,89,132
https://kawalpemilu.org#24717,"LABUHAN RATU, LABUHAN RATU, KOTA BANDAR LAMPUNG, LAMPUNG",11,44,120,164
https://kawalpemilu.org#24717,"LABUHAN RATU, LABUHAN RATU, KOTA BANDAR LAMPUNG, LAMPUNG",12,22,120,142
https://kawalpemilu.org#24717,"LABUHAN RATU, LABUHAN RATU, KOTA BANDAR LAMPUNG, LAMPUNG",13,45,101,146
https://kawalpemilu.org#24717,"LABUHAN RATU, LABUHAN RATU, KOTA BANDAR LAMPUNG, LAMPUNG",14,64,153,217
https://kawalpemilu.org#24717,"LABUHAN RATU, LABUHAN RATU, KOTA BANDAR LAMPUNG, LAMPUNG",15,74,110,184
https://kawalpemilu.org#24717,"LABUHAN RATU, LABUHAN RATU, KOTA BANDAR LAMPUNG, LAMPUNG",16,69,109,178
https://kawalpemilu.org#24717,"LABUHAN RATU, LABUHAN RATU, KOTA BANDAR LAMPUNG, LAMPUNG",17,59,162,221
https://kawalpemilu.org#24717,"LABUHAN RATU, LABUHAN RATU, KOTA BANDAR LAMPUNG, LAMPUNG",18,64,130,194
https://kawalpemilu.org#24717,"LABUHAN RATU, LABUHAN RATU, KOTA BANDAR LAMPUNG, LAMPUNG",19,58,81,139
https://kawalpemilu.org#24717,"LABUHAN RATU, LABUHAN RATU, KOTA BANDAR LAMPUNG, LAMPUNG",20,90,57,147
https://kawalpemilu.org#24717,"LABUHAN RATU, LABUHAN RATU, KOTA BANDAR LAMPUNG, LAMPUNG",21,64,122,186
https://kawalpemilu.org#24717,"LABUHAN RATU, LABUHAN RATU, KOTA BANDAR LAMPUNG, LAMPUNG",22,68,83,151
https://kawalpemilu.org#24717,"LABUHAN RATU, LABUHAN RATU, KOTA BANDAR LAMPUNG, LAMPUNG",23,47,129,176
https://kawalpemilu.org#24717,"LABUHAN RATU, LABUHAN RATU, KOTA BANDAR LAMPUNG, LAMPUNG",24,42,97,139
https://kawalpemilu.org#24717,"LABUHAN RATU, LABUHAN RATU, KOTA BANDAR LAMPUNG, LAMPUNG",25,55,121,176
https://kawalpemilu.org#24717,"LABUHAN RATU, LABUHAN RATU, KOTA BANDAR LAMPUNG, LAMPUNG",26,50,110,160
https://kawalpemilu.org#24717,"LABUHAN RATU, LABUHAN RATU, KOTA BANDAR LAMPUNG, LAMPUNG",27,68,99,167
https://kawalpemilu.org#24717,"LABUHAN RATU, LABUHAN RATU, KOTA BANDAR LAMPUNG, LAMPUNG",28,47,139,186
https://kawalpemilu.org#24717,"LABUHAN RATU, LABUHAN RATU, KOTA BANDAR LAMPUNG, LAMPUNG",29,61,124,185
https://kawalpemilu.org#24717,"LABUHAN RATU, LABUHAN RATU, KOTA BANDAR LAMPUNG, LAMPUNG",30,40,90,130
https://kawalpemilu.org#24718,"SEPANG JAYA, LABUHAN RATU, KOTA BANDAR LAMPUNG, LAMPUNG",1,111,88,199
https://kawalpemilu.org#24718,"SEPANG JAYA, LABUHAN RATU, KOTA BANDAR LAMPUNG, LAMPUNG",2,76,90,166
https://kawalpemilu.org#24718,"SEPANG JAYA, LABUHAN RATU, KOTA BANDAR LAMPUNG, LAMPUNG",3,87,122,209
https://kawalpemilu.org#24718,"SEPANG JAYA, LABUHAN RATU, KOTA BANDAR LAMPUNG, LAMPUNG",4,94,133,227
https://kawalpemilu.org#24718,"SEPANG JAYA, LABUHAN RATU, KOTA BANDAR LAMPUNG, LAMPUNG",5,89,72,161
https://kawalpemilu.org#24718,"SEPANG JAYA, LABUHAN RATU, KOTA BANDAR LAMPUNG, LAMPUNG",6,129,61,190
https://kawalpemilu.org#24718,"SEPANG JAYA, LABUHAN RATU, KOTA BANDAR LAMPUNG, LAMPUNG",7,103,65,168
https://kawalpemilu.org#24718,"SEPANG JAYA, LABUHAN RATU, KOTA BANDAR LAMPUNG, LAMPUNG",8,145,80,225
https://kawalpemilu.org#24718,"SEPANG JAYA, LABUHAN RATU, KOTA BANDAR LAMPUNG, LAMPUNG",9,82,100,182
https://kawalpemilu.org#24718,"SEPANG JAYA, LABUHAN RATU, KOTA BANDAR LAMPUNG, LAMPUNG",10,106,65,171
https://kawalpemilu.org#24718,"SEPANG JAYA, LABUHAN RATU, KOTA BANDAR LAMPUNG, LAMPUNG",11,63,71,134
https://kawalpemilu.org#24718,"SEPANG JAYA, LABUHAN RATU, KOTA BANDAR LAMPUNG, LAMPUNG",12,81,75,156
https://kawalpemilu.org#24718,"SEPANG JAYA, LABUHAN RATU, KOTA BANDAR LAMPUNG, LAMPUNG",13,78,78,156
https://kawalpemilu.org#24718,"SEPANG JAYA, LABUHAN RATU, KOTA BANDAR LAMPUNG, LAMPUNG",14,93,113,206
https://kawalpemilu.org#24718,"SEPANG JAYA, LABUHAN RATU, KOTA BANDAR LAMPUNG, LAMPUNG",15,94,112,206
https://kawalpemilu.org#24718,"SEPANG JAYA, LABUHAN RATU, KOTA BANDAR LAMPUNG, LAMPUNG",17,67,68,135
https://kawalpemilu.org#24718,"SEPANG JAYA, LABUHAN RATU, KOTA BANDAR LAMPUNG, LAMPUNG",18,81,92,173
https://kawalpemilu.org#24718,"SEPANG JAYA, LABUHAN RATU, KOTA BANDAR LAMPUNG, LAMPUNG",20,72,108,180
https://kawalpemilu.org#24718,"SEPANG JAYA, LABUHAN RATU, KOTA BANDAR LAMPUNG, LAMPUNG",21,83,112,195
https://kawalpemilu.org#24718,"SEPANG JAYA, LABUHAN RATU, KOTA BANDAR LAMPUNG, LAMPUNG",22,73,92,165
https://kawalpemilu.org#24718,"SEPANG JAYA, LABUHAN RATU, KOTA BANDAR LAMPUNG, LAMPUNG",23,66,83,149
https://kawalpemilu.org#24718,"SEPANG JAYA, LABUHAN RATU, KOTA BANDAR LAMPUNG, LAMPUNG",24,123,100,223
https://kawalpemilu.org#24718,"SEPANG JAYA, LABUHAN RATU, KOTA BANDAR LAMPUNG, LAMPUNG",26,131,113,244
https://kawalpemilu.org#24718,"SEPANG JAYA, LABUHAN RATU, KOTA BANDAR LAMPUNG, LAMPUNG",27,139,97,236
https://kawalpemilu.org#24718,"SEPANG JAYA, LABUHAN RATU, KOTA BANDAR LAMPUNG, LAMPUNG",28,65,155,220
https://kawalpemilu.org#24718,"SEPANG JAYA, LABUHAN RATU, KOTA BANDAR LAMPUNG, LAMPUNG",29,77,116,193
https://kawalpemilu.org#24718,"SEPANG JAYA, LABUHAN RATU, KOTA BANDAR LAMPUNG, LAMPUNG",30,89,91,180
https://kawalpemilu.org#24718,"SEPANG JAYA, LABUHAN RATU, KOTA BANDAR LAMPUNG, LAMPUNG",31,113,141,254
https://kawalpemilu.org#24718,"SEPANG JAYA, LABUHAN RATU, KOTA BANDAR LAMPUNG, LAMPUNG",32,121,121,242
https://kawalpemilu.org#24718,"SEPANG JAYA, LABUHAN RATU, KOTA BANDAR LAMPUNG, LAMPUNG",33,133,122,255
https://kawalpemilu.org#24718,"SEPANG JAYA, LABUHAN RATU, KOTA BANDAR LAMPUNG, LAMPUNG",34,133,108,241
https://kawalpemilu.org#87253,"LABUHAN RATU RAYA, LABUHAN RATU, KOTA BANDAR LAMPUNG, LAMPUNG",1,86,104,190
https://kawalpemilu.org#87253,"LABUHAN RATU RAYA, LABUHAN RATU, KOTA BANDAR LAMPUNG, LAMPUNG",2,77,126,203
https://kawalpemilu.org#87253,"LABUHAN RATU RAYA, LABUHAN RATU, KOTA BANDAR LAMPUNG, LAMPUNG",3,50,102,152
https://kawalpemilu.org#87253,"LABUHAN RATU RAYA, LABUHAN RATU, KOTA BANDAR LAMPUNG, LAMPUNG",4,82,151,233
https://kawalpemilu.org#87253,"LABUHAN RATU RAYA, LABUHAN RATU, KOTA BANDAR LAMPUNG, LAMPUNG",5,72,160,232
https://kawalpemilu.org#87253,"LABUHAN RATU RAYA, LABUHAN RATU, KOTA BANDAR LAMPUNG, LAMPUNG",6,63,140,203
https://kawalpemilu.org#87253,"LABUHAN RATU RAYA, LABUHAN RATU, KOTA BANDAR LAMPUNG, LAMPUNG",7,0,0,0
https://kawalpemilu.org#87253,"LABUHAN RATU RAYA, LABUHAN RATU, KOTA BANDAR LAMPUNG, LAMPUNG",8,69,206,275
https://kawalpemilu.org#87253,"LABUHAN RATU RAYA, LABUHAN RATU, KOTA BANDAR LAMPUNG, LAMPUNG",9,46,189,235
https://kawalpemilu.org#87253,"LABUHAN RATU RAYA, LABUHAN RATU, KOTA BANDAR LAMPUNG, LAMPUNG",10,104,149,253
https://kawalpemilu.org#87253,"LABUHAN RATU RAYA, LABUHAN RATU, KOTA BANDAR LAMPUNG, LAMPUNG",11,94,117,211
https://kawalpemilu.org#87253,"LABUHAN RATU RAYA, LABUHAN RATU, KOTA BANDAR LAMPUNG, LAMPUNG",12,106,140,246
https://kawalpemilu.org#87253,"LABUHAN RATU RAYA, LABUHAN RATU, KOTA BANDAR LAMPUNG, LAMPUNG",14,67,149,216
https://kawalpemilu.org#87253,"LABUHAN RATU RAYA, LABUHAN RATU, KOTA BANDAR LAMPUNG, LAMPUNG",15,89,139,228
https://kawalpemilu.org#87253,"LABUHAN RATU RAYA, LABUHAN RATU, KOTA BANDAR LAMPUNG, LAMPUNG",16,62,121,183
https://kawalpemilu.org#87253,"LABUHAN RATU RAYA, LABUHAN RATU, KOTA BANDAR LAMPUNG, LAMPUNG",17,101,175,276
https://kawalpemilu.org#87253,"LABUHAN RATU RAYA, LABUHAN RATU, KOTA BANDAR LAMPUNG, LAMPUNG",18,79,135,214
https://kawalpemilu.org#87253,"LABUHAN RATU RAYA, LABUHAN RATU, KOTA BANDAR LAMPUNG, LAMPUNG",19,84,149,233
https://kawalpemilu.org#87253,"LABUHAN RATU RAYA, LABUHAN RATU, KOTA BANDAR LAMPUNG, LAMPUNG",20,93,143,236
https://kawalpemilu.org#87253,"LABUHAN RATU RAYA, LABUHAN RATU, KOTA BANDAR LAMPUNG, LAMPUNG",22,62,107,169
https://kawalpemilu.org#87253,"LABUHAN RATU RAYA, LABUHAN RATU, KOTA BANDAR LAMPUNG, LAMPUNG",23,64,154,214
https://kawalpemilu.org#87253,"LABUHAN RATU RAYA, LABUHAN RATU, KOTA BANDAR LAMPUNG, LAMPUNG",24,78,157,235
https://kawalpemilu.org#87253,"LABUHAN RATU RAYA, LABUHAN RATU, KOTA BANDAR LAMPUNG, LAMPUNG",25,54,161,215
https://kawalpemilu.org#87253,"LABUHAN RATU RAYA, LABUHAN RATU, KOTA BANDAR LAMPUNG, LAMPUNG",26,70,154,224
https://kawalpemilu.org#87253,"LABUHAN RATU RAYA, LABUHAN RATU, KOTA BANDAR LAMPUNG, LAMPUNG",28,58,105,163
https://kawalpemilu.org#87255,"KOTA SEPANG, LABUHAN RATU, KOTA BANDAR LAMPUNG, LAMPUNG",1,60,176,236
https://kawalpemilu.org#87255,"KOTA SEPANG, LABUHAN RATU, KOTA BANDAR LAMPUNG, LAMPUNG",2,64,113,177
https://kawalpemilu.org#87255,"KOTA SEPANG, LABUHAN RATU, KOTA BANDAR LAMPUNG, LAMPUNG",3,73,122,195
https://kawalpemilu.org#87255,"KOTA SEPANG, LABUHAN RATU, KOTA BANDAR LAMPUNG, LAMPUNG",4,71,111,182
https://kawalpemilu.org#87255,"KOTA SEPANG, LABUHAN RATU, KOTA BANDAR LAMPUNG, LAMPUNG",5,70,89,159
https://kawalpemilu.org#87255,"KOTA SEPANG, LABUHAN RATU, KOTA BANDAR LAMPUNG, LAMPUNG",6,29,90,119
https://kawalpemilu.org#87255,"KOTA SEPANG, LABUHAN RATU, KOTA BANDAR LAMPUNG, LAMPUNG",7,68,100,168
https://kawalpemilu.org#87255,"KOTA SEPANG, LABUHAN RATU, KOTA BANDAR LAMPUNG, LAMPUNG",8,56,114,170
https://kawalpemilu.org#87255,"KOTA SEPANG, LABUHAN RATU, KOTA BANDAR LAMPUNG, LAMPUNG",10,54,74,128
https://kawalpemilu.org#87255,"KOTA SEPANG, LABUHAN RATU, KOTA BANDAR LAMPUNG, LAMPUNG",11,90,119,209
https://kawalpemilu.org#87255,"KOTA SEPANG, LABUHAN RATU, KOTA BANDAR LAMPUNG, LAMPUNG",12,86,78,164
https://kawalpemilu.org#87255,"KOTA SEPANG, LABUHAN RATU, KOTA BANDAR LAMPUNG, LAMPUNG",13,48,100,148
https://kawalpemilu.org#87255,"KOTA SEPANG, LABUHAN RATU, KOTA BANDAR LAMPUNG, LAMPUNG",14,80,110,190
https://kawalpemilu.org#87256,"KAMPUNG BARU RAYA, LABUHAN RATU, KOTA BANDAR LAMPUNG, LAMPUNG",1,117,121,238
https://kawalpemilu.org#87256,"KAMPUNG BARU RAYA, LABUHAN RATU, KOTA BANDAR LAMPUNG, LAMPUNG",2,99,96,195
https://kawalpemilu.org#87256,"KAMPUNG BARU RAYA, LABUHAN RATU, KOTA BANDAR LAMPUNG, LAMPUNG",3,87,131,218
https://kawalpemilu.org#87256,"KAMPUNG BARU RAYA, LABUHAN RATU, KOTA BANDAR LAMPUNG, LAMPUNG",4,49,139,188
https://kawalpemilu.org#87256,"KAMPUNG BARU RAYA, LABUHAN RATU, KOTA BANDAR LAMPUNG, LAMPUNG",5,56,84,140
https://kawalpemilu.org#87256,"KAMPUNG BARU RAYA, LABUHAN RATU, KOTA BANDAR LAMPUNG, LAMPUNG",6,73,130,203
https://kawalpemilu.org#87256,"KAMPUNG BARU RAYA, LABUHAN RATU, KOTA BANDAR LAMPUNG, LAMPUNG",7,67,111,178
https://kawalpemilu.org#24712,"PERUMNAS WAY HALIM, WAY HALIM, KOTA BANDAR LAMPUNG, LAMPUNG",1,73,109,182
https://kawalpemilu.org#24712,"PERUMNAS WAY HALIM, WAY HALIM, KOTA BANDAR LAMPUNG, LAMPUNG",2,81,124,205
https://kawalpemilu.org#24712,"PERUMNAS WAY HALIM, WAY HALIM, KOTA BANDAR LAMPUNG, LAMPUNG",3,68,128,196
https://kawalpemilu.org#24712,"PERUMNAS WAY HALIM, WAY HALIM, KOTA BANDAR LAMPUNG, LAMPUNG",4,52,63,115
https://kawalpemilu.org#24712,"PERUMNAS WAY HALIM, WAY HALIM, KOTA BANDAR LAMPUNG, LAMPUNG",5,47,128,175
https://kawalpemilu.org#24712,"PERUMNAS WAY HALIM, WAY HALIM, KOTA BANDAR LAMPUNG, LAMPUNG",6,114,71,185
https://kawalpemilu.org#24712,"PERUMNAS WAY HALIM, WAY HALIM, KOTA BANDAR LAMPUNG, LAMPUNG",7,82,149,231
https://kawalpemilu.org#24712,"PERUMNAS WAY HALIM, WAY HALIM, KOTA BANDAR LAMPUNG, LAMPUNG",8,55,97,152
https://kawalpemilu.org#24712,"PERUMNAS WAY HALIM, WAY HALIM, KOTA BANDAR LAMPUNG, LAMPUNG",10,79,170,249
https://kawalpemilu.org#24712,"PERUMNAS WAY HALIM, WAY HALIM, KOTA BANDAR LAMPUNG, LAMPUNG",11,76,105,181
https://kawalpemilu.org#24712,"PERUMNAS WAY HALIM, WAY HALIM, KOTA BANDAR LAMPUNG, LAMPUNG",12,58,90,148
https://kawalpemilu.org#24712,"PERUMNAS WAY HALIM, WAY HALIM, KOTA BANDAR LAMPUNG, LAMPUNG",13,64,111,175
https://kawalpemilu.org#24712,"PERUMNAS WAY HALIM, WAY HALIM, KOTA BANDAR LAMPUNG, LAMPUNG",14,39,150,189
https://kawalpemilu.org#24712,"PERUMNAS WAY HALIM, WAY HALIM, KOTA BANDAR LAMPUNG, LAMPUNG",15,62,117,179
https://kawalpemilu.org#24712,"PERUMNAS WAY HALIM, WAY HALIM, KOTA BANDAR LAMPUNG, LAMPUNG",16,55,102,157
https://kawalpemilu.org#24712,"PERUMNAS WAY HALIM, WAY HALIM, KOTA BANDAR LAMPUNG, LAMPUNG",17,81,109,190
https://kawalpemilu.org#24712,"PERUMNAS WAY HALIM, WAY HALIM, KOTA BANDAR LAMPUNG, LAMPUNG",18,50,129,179
https://kawalpemilu.org#24712,"PERUMNAS WAY HALIM, WAY HALIM, KOTA BANDAR LAMPUNG, LAMPUNG",19,74,99,173
https://kawalpemilu.org#24712,"PERUMNAS WAY HALIM, WAY HALIM, KOTA BANDAR LAMPUNG, LAMPUNG",21,50,89,139
https://kawalpemilu.org#24712,"PERUMNAS WAY HALIM, WAY HALIM, KOTA BANDAR LAMPUNG, LAMPUNG",22,48,128,180
https://kawalpemilu.org#24712,"PERUMNAS WAY HALIM, WAY HALIM, KOTA BANDAR LAMPUNG, LAMPUNG",23,42,112,154
https://kawalpemilu.org#24712,"PERUMNAS WAY HALIM, WAY HALIM, KOTA BANDAR LAMPUNG, LAMPUNG",24,44,99,143
https://kawalpemilu.org#24712,"PERUMNAS WAY HALIM, WAY HALIM, KOTA BANDAR LAMPUNG, LAMPUNG",25,38,111,149
https://kawalpemilu.org#24712,"PERUMNAS WAY HALIM, WAY HALIM, KOTA BANDAR LAMPUNG, LAMPUNG",26,74,104,178
https://kawalpemilu.org#24712,"PERUMNAS WAY HALIM, WAY HALIM, KOTA BANDAR LAMPUNG, LAMPUNG",27,50,104,154
https://kawalpemilu.org#24712,"PERUMNAS WAY HALIM, WAY HALIM, KOTA BANDAR LAMPUNG, LAMPUNG",28,73,97,170
https://kawalpemilu.org#24712,"PERUMNAS WAY HALIM, WAY HALIM, KOTA BANDAR LAMPUNG, LAMPUNG",29,71,120,191
https://kawalpemilu.org#24712,"PERUMNAS WAY HALIM, WAY HALIM, KOTA BANDAR LAMPUNG, LAMPUNG",30,54,115,169
https://kawalpemilu.org#24712,"PERUMNAS WAY HALIM, WAY HALIM, KOTA BANDAR LAMPUNG, LAMPUNG",31,37,151,189
https://kawalpemilu.org#24712,"PERUMNAS WAY HALIM, WAY HALIM, KOTA BANDAR LAMPUNG, LAMPUNG",33,66,151,217
https://kawalpemilu.org#24712,"PERUMNAS WAY HALIM, WAY HALIM, KOTA BANDAR LAMPUNG, LAMPUNG",34,52,131,183
https://kawalpemilu.org#24712,"PERUMNAS WAY HALIM, WAY HALIM, KOTA BANDAR LAMPUNG, LAMPUNG",35,48,89,137
https://kawalpemilu.org#24712,"PERUMNAS WAY HALIM, WAY HALIM, KOTA BANDAR LAMPUNG, LAMPUNG",36,61,125,186
https://kawalpemilu.org#24712,"PERUMNAS WAY HALIM, WAY HALIM, KOTA BANDAR LAMPUNG, LAMPUNG",37,83,71,154
https://kawalpemilu.org#24721,"WAY HALIM PERMAI, WAY HALIM, KOTA BANDAR LAMPUNG, LAMPUNG",1,80,100,180
https://kawalpemilu.org#24721,"WAY HALIM PERMAI, WAY HALIM, KOTA BANDAR LAMPUNG, LAMPUNG",3,106,92,198
https://kawalpemilu.org#24721,"WAY HALIM PERMAI, WAY HALIM, KOTA BANDAR LAMPUNG, LAMPUNG",4,58,69,127
https://kawalpemilu.org#24721,"WAY HALIM PERMAI, WAY HALIM, KOTA BANDAR LAMPUNG, LAMPUNG",5,85,117,202
https://kawalpemilu.org#24721,"WAY HALIM PERMAI, WAY HALIM, KOTA BANDAR LAMPUNG, LAMPUNG",6,93,95,188
https://kawalpemilu.org#24721,"WAY HALIM PERMAI, WAY HALIM, KOTA BANDAR LAMPUNG, LAMPUNG",7,82,149,231
https://kawalpemilu.org#24721,"WAY HALIM PERMAI, WAY HALIM, KOTA BANDAR LAMPUNG, LAMPUNG",8,75,86,161
https://kawalpemilu.org#24721,"WAY HALIM PERMAI, WAY HALIM, KOTA BANDAR LAMPUNG, LAMPUNG",9,109,88,197
https://kawalpemilu.org#24721,"WAY HALIM PERMAI, WAY HALIM, KOTA BANDAR LAMPUNG, LAMPUNG",10,126,119,245
https://kawalpemilu.org#24721,"WAY HALIM PERMAI, WAY HALIM, KOTA BANDAR LAMPUNG, LAMPUNG",12,146,127,273
https://kawalpemilu.org#24721,"WAY HALIM PERMAI, WAY HALIM, KOTA BANDAR LAMPUNG, LAMPUNG",13,72,56,128
https://kawalpemilu.org#24721,"WAY HALIM PERMAI, WAY HALIM, KOTA BANDAR LAMPUNG, LAMPUNG",14,119,112,231
https://kawalpemilu.org#24721,"WAY HALIM PERMAI, WAY HALIM, KOTA BANDAR LAMPUNG, LAMPUNG",16,76,120,196
https://kawalpemilu.org#24721,"WAY HALIM PERMAI, WAY HALIM, KOTA BANDAR LAMPUNG, LAMPUNG",17,74,116,190
https://kawalpemilu.org#24721,"WAY HALIM PERMAI, WAY HALIM, KOTA BANDAR LAMPUNG, LAMPUNG",19,85,86,171
https://kawalpemilu.org#24721,"WAY HALIM PERMAI, WAY HALIM, KOTA BANDAR LAMPUNG, LAMPUNG",20,82,157,239
https://kawalpemilu.org#24721,"WAY HALIM PERMAI, WAY HALIM, KOTA BANDAR LAMPUNG, LAMPUNG",21,88,113,201
https://kawalpemilu.org#24721,"WAY HALIM PERMAI, WAY HALIM, KOTA BANDAR LAMPUNG, LAMPUNG",22,56,124,180
https://kawalpemilu.org#24721,"WAY HALIM PERMAI, WAY HALIM, KOTA BANDAR LAMPUNG, LAMPUNG",24,89,121,210
https://kawalpemilu.org#24721,"WAY HALIM PERMAI, WAY HALIM, KOTA BANDAR LAMPUNG, LAMPUNG",25,121,121,242
https://kawalpemilu.org#24721,"WAY HALIM PERMAI, WAY HALIM, KOTA BANDAR LAMPUNG, LAMPUNG",26,103,97,200
https://kawalpemilu.org#24721,"WAY HALIM PERMAI, WAY HALIM, KOTA BANDAR LAMPUNG, LAMPUNG",27,39,65,104
https://kawalpemilu.org#24721,"WAY HALIM PERMAI, WAY HALIM, KOTA BANDAR LAMPUNG, LAMPUNG",28,69,65,134
https://kawalpemilu.org#24721,"WAY HALIM PERMAI, WAY HALIM, KOTA BANDAR LAMPUNG, LAMPUNG",29,146,96,242
https://kawalpemilu.org#24721,"WAY HALIM PERMAI, WAY HALIM, KOTA BANDAR LAMPUNG, LAMPUNG",30,168,114,282
https://kawalpemilu.org#24721,"WAY HALIM PERMAI, WAY HALIM, KOTA BANDAR LAMPUNG, LAMPUNG",31,84,94,178
https://kawalpemilu.org#24721,"WAY HALIM PERMAI, WAY HALIM, KOTA BANDAR LAMPUNG, LAMPUNG",32,88,60,148
https://kawalpemilu.org#24721,"WAY HALIM PERMAI, WAY HALIM, KOTA BANDAR LAMPUNG, LAMPUNG",34,98,76,174
https://kawalpemilu.org#24721,"WAY HALIM PERMAI, WAY HALIM, KOTA BANDAR LAMPUNG, LAMPUNG",35,72,103,175
https://kawalpemilu.org#24721,"WAY HALIM PERMAI, WAY HALIM, KOTA BANDAR LAMPUNG, LAMPUNG",36,5,101,106
https://kawalpemilu.org#24809,"JAGABAYA II, WAY HALIM, KOTA BANDAR LAMPUNG, LAMPUNG",1,32,78,110
https://kawalpemilu.org#24809,"JAGABAYA II, WAY HALIM, KOTA BANDAR LAMPUNG, LAMPUNG",2,90,80,170
https://kawalpemilu.org#24809,"JAGABAYA II, WAY HALIM, KOTA BANDAR LAMPUNG, LAMPUNG",3,51,95,146
https://kawalpemilu.org#24809,"JAGABAYA II, WAY HALIM, KOTA BANDAR LAMPUNG, LAMPUNG",4,71,133,204
https://kawalpemilu.org#24809,"JAGABAYA II, WAY HALIM, KOTA BANDAR LAMPUNG, LAMPUNG",5,117,119,236
https://kawalpemilu.org#24809,"JAGABAYA II, WAY HALIM, KOTA BANDAR LAMPUNG, LAMPUNG",6,47,131,178
https://kawalpemilu.org#24809,"JAGABAYA II, WAY HALIM, KOTA BANDAR LAMPUNG, LAMPUNG",7,59,77,136
https://kawalpemilu.org#24809,"JAGABAYA II, WAY HALIM, KOTA BANDAR LAMPUNG, LAMPUNG",8,55,106,161
https://kawalpemilu.org#24809,"JAGABAYA II, WAY HALIM, KOTA BANDAR LAMPUNG, LAMPUNG",9,65,131,196
https://kawalpemilu.org#24809,"JAGABAYA II, WAY HALIM, KOTA BANDAR LAMPUNG, LAMPUNG",10,50,140,190
https://kawalpemilu.org#24809,"JAGABAYA II, WAY HALIM, KOTA BANDAR LAMPUNG, LAMPUNG",11,77,101,178
https://kawalpemilu.org#24809,"JAGABAYA II, WAY HALIM, KOTA BANDAR LAMPUNG, LAMPUNG",12,83,102,185
https://kawalpemilu.org#24809,"JAGABAYA II, WAY HALIM, KOTA BANDAR LAMPUNG, LAMPUNG",13,92,84,176
https://kawalpemilu.org#24809,"JAGABAYA II, WAY HALIM, KOTA BANDAR LAMPUNG, LAMPUNG",14,48,108,156
https://kawalpemilu.org#24809,"JAGABAYA II, WAY HALIM, KOTA BANDAR LAMPUNG, LAMPUNG",15,50,103,153
https://kawalpemilu.org#24809,"JAGABAYA II, WAY HALIM, KOTA BANDAR LAMPUNG, LAMPUNG",16,120,90,210
https://kawalpemilu.org#24809,"JAGABAYA II, WAY HALIM, KOTA BANDAR LAMPUNG, LAMPUNG",17,91,115,206
https://kawalpemilu.org#24809,"JAGABAYA II, WAY HALIM, KOTA BANDAR LAMPUNG, LAMPUNG",18,113,145,258
https://kawalpemilu.org#24809,"JAGABAYA II, WAY HALIM, KOTA BANDAR LAMPUNG, LAMPUNG",19,98,160,258
https://kawalpemilu.org#24809,"JAGABAYA II, WAY HALIM, KOTA BANDAR LAMPUNG, LAMPUNG",20,113,99,212
https://kawalpemilu.org#24809,"JAGABAYA II, WAY HALIM, KOTA BANDAR LAMPUNG, LAMPUNG",21,64,84,148
https://kawalpemilu.org#24809,"JAGABAYA II, WAY HALIM, KOTA BANDAR LAMPUNG, LAMPUNG",22,64,98,162
https://kawalpemilu.org#24809,"JAGABAYA II, WAY HALIM, KOTA BANDAR LAMPUNG, LAMPUNG",23,143,102,245
https://kawalpemilu.org#24809,"JAGABAYA II, WAY HALIM, KOTA BANDAR LAMPUNG, LAMPUNG",24,83,138,221
https://kawalpemilu.org#24809,"JAGABAYA II, WAY HALIM, KOTA BANDAR LAMPUNG, LAMPUNG",25,53,74,127
https://kawalpemilu.org#24809,"JAGABAYA II, WAY HALIM, KOTA BANDAR LAMPUNG, LAMPUNG",27,38,115,153
https://kawalpemilu.org#24809,"JAGABAYA II, WAY HALIM, KOTA BANDAR LAMPUNG, LAMPUNG",28,60,191,251
https://kawalpemilu.org#24809,"JAGABAYA II, WAY HALIM, KOTA BANDAR LAMPUNG, LAMPUNG",29,86,111,197
https://kawalpemilu.org#24809,"JAGABAYA II, WAY HALIM, KOTA BANDAR LAMPUNG, LAMPUNG",30,63,77,140
https://kawalpemilu.org#24809,"JAGABAYA II, WAY HALIM, KOTA BANDAR LAMPUNG, LAMPUNG",31,100,158,258
https://kawalpemilu.org#24809,"JAGABAYA II, WAY HALIM, KOTA BANDAR LAMPUNG, LAMPUNG",32,85,92,177
https://kawalpemilu.org#24809,"JAGABAYA II, WAY HALIM, KOTA BANDAR LAMPUNG, LAMPUNG",33,81,74,155
https://kawalpemilu.org#24809,"JAGABAYA II, WAY HALIM, KOTA BANDAR LAMPUNG, LAMPUNG",34,183,82,265
https://kawalpemilu.org#24809,"JAGABAYA II, WAY HALIM, KOTA BANDAR LAMPUNG, LAMPUNG",35,155,91,246
https://kawalpemilu.org#24809,"JAGABAYA II, WAY HALIM, KOTA BANDAR LAMPUNG, LAMPUNG",36,68,114,182
https://kawalpemilu.org#24809,"JAGABAYA II, WAY HALIM, KOTA BANDAR LAMPUNG, LAMPUNG",37,159,77,236
https://kawalpemilu.org#24809,"JAGABAYA II, WAY HALIM, KOTA BANDAR LAMPUNG, LAMPUNG",38,171,60,231
https://kawalpemilu.org#24809,"JAGABAYA II, WAY HALIM, KOTA BANDAR LAMPUNG, LAMPUNG",39,183,54,237
https://kawalpemilu.org#24809,"JAGABAYA II, WAY HALIM, KOTA BANDAR LAMPUNG, LAMPUNG",40,162,62,224
https://kawalpemilu.org#24809,"JAGABAYA II, WAY HALIM, KOTA BANDAR LAMPUNG, LAMPUNG",41,170,111,281
https://kawalpemilu.org#24809,"JAGABAYA II, WAY HALIM, KOTA BANDAR LAMPUNG, LAMPUNG",42,88,126,214
https://kawalpemilu.org#24809,"JAGABAYA II, WAY HALIM, KOTA BANDAR LAMPUNG, LAMPUNG",43,114,107,221
https://kawalpemilu.org#24812,"JAGABAYA III, WAY HALIM, KOTA BANDAR LAMPUNG, LAMPUNG",1,192,93,285
https://kawalpemilu.org#24812,"JAGABAYA III, WAY HALIM, KOTA BANDAR LAMPUNG, LAMPUNG",2,0,0,0
https://kawalpemilu.org#24812,"JAGABAYA III, WAY HALIM, KOTA BANDAR LAMPUNG, LAMPUNG",5,125,96,221
https://kawalpemilu.org#24812,"JAGABAYA III, WAY HALIM, KOTA BANDAR LAMPUNG, LAMPUNG",6,134,84,218
https://kawalpemilu.org#24812,"JAGABAYA III, WAY HALIM, KOTA BANDAR LAMPUNG, LAMPUNG",7,258,29,287
https://kawalpemilu.org#24812,"JAGABAYA III, WAY HALIM, KOTA BANDAR LAMPUNG, LAMPUNG",8,166,9,175
https://kawalpemilu.org#24812,"JAGABAYA III, WAY HALIM, KOTA BANDAR LAMPUNG, LAMPUNG",9,178,17,0
https://kawalpemilu.org#24812,"JAGABAYA III, WAY HALIM, KOTA BANDAR LAMPUNG, LAMPUNG",10,142,24,166
https://kawalpemilu.org#24812,"JAGABAYA III, WAY HALIM, KOTA BANDAR LAMPUNG, LAMPUNG",11,234,16,250
https://kawalpemilu.org#24812,"JAGABAYA III, WAY HALIM, KOTA BANDAR LAMPUNG, LAMPUNG",12,226,15,241
https://kawalpemilu.org#24812,"JAGABAYA III, WAY HALIM, KOTA BANDAR LAMPUNG, LAMPUNG",13,227,28,255
https://kawalpemilu.org#24812,"JAGABAYA III, WAY HALIM, KOTA BANDAR LAMPUNG, LAMPUNG",14,140,97,237
https://kawalpemilu.org#24812,"JAGABAYA III, WAY HALIM, KOTA BANDAR LAMPUNG, LAMPUNG",15,104,111,215
https://kawalpemilu.org#24812,"JAGABAYA III, WAY HALIM, KOTA BANDAR LAMPUNG, LAMPUNG",16,99,99,198
https://kawalpemilu.org#24812,"JAGABAYA III, WAY HALIM, KOTA BANDAR LAMPUNG, LAMPUNG",17,113,31,144
https://kawalpemilu.org#24812,"JAGABAYA III, WAY HALIM, KOTA BANDAR LAMPUNG, LAMPUNG",18,128,51,179
https://kawalpemilu.org#24812,"JAGABAYA III, WAY HALIM, KOTA BANDAR LAMPUNG, LAMPUNG",19,168,76,244
https://kawalpemilu.org#24812,"JAGABAYA III, WAY HALIM, KOTA BANDAR LAMPUNG, LAMPUNG",20,147,101,248
https://kawalpemilu.org#24812,"JAGABAYA III, WAY HALIM, KOTA BANDAR LAMPUNG, LAMPUNG",21,131,59,190
https://kawalpemilu.org#24812,"JAGABAYA III, WAY HALIM, KOTA BANDAR LAMPUNG, LAMPUNG",22,109,67,176
https://kawalpemilu.org#87267,"GUNUNGSULAH, WAY HALIM, KOTA BANDAR LAMPUNG, LAMPUNG",1,132,128,260
https://kawalpemilu.org#87267,"GUNUNGSULAH, WAY HALIM, KOTA BANDAR LAMPUNG, LAMPUNG",2,48,54,102
https://kawalpemilu.org#87267,"GUNUNGSULAH, WAY HALIM, KOTA BANDAR LAMPUNG, LAMPUNG",3,153,89,242
https://kawalpemilu.org#87267,"GUNUNGSULAH, WAY HALIM, KOTA BANDAR LAMPUNG, LAMPUNG",5,109,93,196
https://kawalpemilu.org#87267,"GUNUNGSULAH, WAY HALIM, KOTA BANDAR LAMPUNG, LAMPUNG",7,138,109,247
https://kawalpemilu.org#87267,"GUNUNGSULAH, WAY HALIM, KOTA BANDAR LAMPUNG, LAMPUNG",10,89,108,197
https://kawalpemilu.org#87267,"GUNUNGSULAH, WAY HALIM, KOTA BANDAR LAMPUNG, LAMPUNG",11,79,116,195
https://kawalpemilu.org#87267,"GUNUNGSULAH, WAY HALIM, KOTA BANDAR LAMPUNG, LAMPUNG",12,169,69,238
https://kawalpemilu.org#87267,"GUNUNGSULAH, WAY HALIM, KOTA BANDAR LAMPUNG, LAMPUNG",14,54,78,132
https://kawalpemilu.org#87267,"GUNUNGSULAH, WAY HALIM, KOTA BANDAR LAMPUNG, LAMPUNG",15,201,105,306
https://kawalpemilu.org#87267,"GUNUNGSULAH, WAY HALIM, KOTA BANDAR LAMPUNG, LAMPUNG",16,111,102,213
https://kawalpemilu.org#87267,"GUNUNGSULAH, WAY HALIM, KOTA BANDAR LAMPUNG, LAMPUNG",19,116,111,227
https://kawalpemilu.org#87267,"GUNUNGSULAH, WAY HALIM, KOTA BANDAR LAMPUNG, LAMPUNG",20,182,109,291
https://kawalpemilu.org#87267,"GUNUNGSULAH, WAY HALIM, KOTA BANDAR LAMPUNG, LAMPUNG",22,108,51,159
https://kawalpemilu.org#87267,"GUNUNGSULAH, WAY HALIM, KOTA BANDAR LAMPUNG, LAMPUNG",23,123,72,195
https://kawalpemilu.org#87267,"GUNUNGSULAH, WAY HALIM, KOTA BANDAR LAMPUNG, LAMPUNG",24,106,68,174
https://kawalpemilu.org#87267,"GUNUNGSULAH, WAY HALIM, KOTA BANDAR LAMPUNG, LAMPUNG",25,170,92,262
https://kawalpemilu.org#87267,"GUNUNGSULAH, WAY HALIM, KOTA BANDAR LAMPUNG, LAMPUNG",27,86,54,140
https://kawalpemilu.org#87267,"GUNUNGSULAH, WAY HALIM, KOTA BANDAR LAMPUNG, LAMPUNG",28,132,50,182
https://kawalpemilu.org#87267,"GUNUNGSULAH, WAY HALIM, KOTA BANDAR LAMPUNG, LAMPUNG",29,96,33,129
https://kawalpemilu.org#87267,"GUNUNGSULAH, WAY HALIM, KOTA BANDAR LAMPUNG, LAMPUNG",30,153,55,208
https://kawalpemilu.org#87267,"GUNUNGSULAH, WAY HALIM, KOTA BANDAR LAMPUNG, LAMPUNG",31,103,25,128
https://kawalpemilu.org#87267,"GUNUNGSULAH, WAY HALIM, KOTA BANDAR LAMPUNG, LAMPUNG",33,129,128,257
https://kawalpemilu.org#87267,"GUNUNGSULAH, WAY HALIM, KOTA BANDAR LAMPUNG, LAMPUNG",34,129,118,247
https://kawalpemilu.org#87267,"GUNUNGSULAH, WAY HALIM, KOTA BANDAR LAMPUNG, LAMPUNG",35,119,96,215
https://kawalpemilu.org#87267,"GUNUNGSULAH, WAY HALIM, KOTA BANDAR LAMPUNG, LAMPUNG",36,26,61,87
https://kawalpemilu.org#87268,"JAGABAYA I, WAY HALIM, KOTA BANDAR LAMPUNG, LAMPUNG",3,143,123,266
https://kawalpemilu.org#87268,"JAGABAYA I, WAY HALIM, KOTA BANDAR LAMPUNG, LAMPUNG",4,76,122,198
https://kawalpemilu.org#87268,"JAGABAYA I, WAY HALIM, KOTA BANDAR LAMPUNG, LAMPUNG",5,132,92,224
https://kawalpemilu.org#87268,"JAGABAYA I, WAY HALIM, KOTA BANDAR LAMPUNG, LAMPUNG",6,142,72,214
https://kawalpemilu.org#87268,"JAGABAYA I, WAY HALIM, KOTA BANDAR LAMPUNG, LAMPUNG",7,133,80,213
https://kawalpemilu.org#87268,"JAGABAYA I, WAY HALIM, KOTA BANDAR LAMPUNG, LAMPUNG",8,39,68,107
https://kawalpemilu.org#24816,"LANGKAPURA, LANGKAPURA, KOTA BANDAR LAMPUNG, LAMPUNG",2,28,144,172
https://kawalpemilu.org#24816,"LANGKAPURA, LANGKAPURA, KOTA BANDAR LAMPUNG, LAMPUNG",3,55,125,180
https://kawalpemilu.org#24816,"LANGKAPURA, LANGKAPURA, KOTA BANDAR LAMPUNG, LAMPUNG",4,56,135,191
https://kawalpemilu.org#24816,"LANGKAPURA, LANGKAPURA, KOTA BANDAR LAMPUNG, LAMPUNG",5,73,153,226
https://kawalpemilu.org#24816,"LANGKAPURA, LANGKAPURA, KOTA BANDAR LAMPUNG, LAMPUNG",6,44,153,197
https://kawalpemilu.org#24816,"LANGKAPURA, LANGKAPURA, KOTA BANDAR LAMPUNG, LAMPUNG",7,65,188,253
https://kawalpemilu.org#24816,"LANGKAPURA, LANGKAPURA, KOTA BANDAR LAMPUNG, LAMPUNG",8,102,188,290
https://kawalpemilu.org#24816,"LANGKAPURA, LANGKAPURA, KOTA BANDAR LAMPUNG, LAMPUNG",9,82,163,245
https://kawalpemilu.org#24816,"LANGKAPURA, LANGKAPURA, KOTA BANDAR LAMPUNG, LAMPUNG",10,61,156,217
https://kawalpemilu.org#24816,"LANGKAPURA, LANGKAPURA, KOTA BANDAR LAMPUNG, LAMPUNG",11,58,121,179
https://kawalpemilu.org#24816,"LANGKAPURA, LANGKAPURA, KOTA BANDAR LAMPUNG, LAMPUNG",12,70,119,189
https://kawalpemilu.org#24816,"LANGKAPURA, LANGKAPURA, KOTA BANDAR LAMPUNG, LAMPUNG",13,95,102,197
https://kawalpemilu.org#24816,"LANGKAPURA, LANGKAPURA, KOTA BANDAR LAMPUNG, LAMPUNG",14,100,85,185
https://kawalpemilu.org#24816,"LANGKAPURA, LANGKAPURA, KOTA BANDAR LAMPUNG, LAMPUNG",15,59,161,220
https://kawalpemilu.org#24816,"LANGKAPURA, LANGKAPURA, KOTA BANDAR LAMPUNG, LAMPUNG",16,62,172,234
https://kawalpemilu.org#24816,"LANGKAPURA, LANGKAPURA, KOTA BANDAR LAMPUNG, LAMPUNG",17,89,165,254
https://kawalpemilu.org#24816,"LANGKAPURA, LANGKAPURA, KOTA BANDAR LAMPUNG, LAMPUNG",18,141,129,270
https://kawalpemilu.org#24816,"LANGKAPURA, LANGKAPURA, KOTA BANDAR LAMPUNG, LAMPUNG",19,103,100,203
https://kawalpemilu.org#24816,"LANGKAPURA, LANGKAPURA, KOTA BANDAR LAMPUNG, LAMPUNG",20,138,135,273
https://kawalpemilu.org#24816,"LANGKAPURA, LANGKAPURA, KOTA BANDAR LAMPUNG, LAMPUNG",21,142,95,237
https://kawalpemilu.org#24816,"LANGKAPURA, LANGKAPURA, KOTA BANDAR LAMPUNG, LAMPUNG",22,150,95,245
https://kawalpemilu.org#87269,"LANGKAPURA BARU, LANGKAPURA, KOTA BANDAR LAMPUNG, LAMPUNG",1,46,106,152
https://kawalpemilu.org#87269,"LANGKAPURA BARU, LANGKAPURA, KOTA BANDAR LAMPUNG, LAMPUNG",2,90,67,157
https://kawalpemilu.org#87269,"LANGKAPURA BARU, LANGKAPURA, KOTA BANDAR LAMPUNG, LAMPUNG",3,47,143,190
https://kawalpemilu.org#87269,"LANGKAPURA BARU, LANGKAPURA, KOTA BANDAR LAMPUNG, LAMPUNG",4,23,126,149
https://kawalpemilu.org#87269,"LANGKAPURA BARU, LANGKAPURA, KOTA BANDAR LAMPUNG, LAMPUNG",5,40,152,192
https://kawalpemilu.org#87269,"LANGKAPURA BARU, LANGKAPURA, KOTA BANDAR LAMPUNG, LAMPUNG",6,23,115,138
https://kawalpemilu.org#87269,"LANGKAPURA BARU, LANGKAPURA, KOTA BANDAR LAMPUNG, LAMPUNG",7,45,130,175
https://kawalpemilu.org#87269,"LANGKAPURA BARU, LANGKAPURA, KOTA BANDAR LAMPUNG, LAMPUNG",8,53,106,159
https://kawalpemilu.org#87269,"LANGKAPURA BARU, LANGKAPURA, KOTA BANDAR LAMPUNG, LAMPUNG",9,26,91,117
https://kawalpemilu.org#87269,"LANGKAPURA BARU, LANGKAPURA, KOTA BANDAR LAMPUNG, LAMPUNG",10,20,88,108
https://kawalpemilu.org#87269,"LANGKAPURA BARU, LANGKAPURA, KOTA BANDAR LAMPUNG, LAMPUNG",11,61,120,181
https://kawalpemilu.org#87269,"LANGKAPURA BARU, LANGKAPURA, KOTA BANDAR LAMPUNG, LAMPUNG",12,49,136,185
https://kawalpemilu.org#87269,"LANGKAPURA BARU, LANGKAPURA, KOTA BANDAR LAMPUNG, LAMPUNG",13,69,97,166
https://kawalpemilu.org#87269,"LANGKAPURA BARU, LANGKAPURA, KOTA BANDAR LAMPUNG, LAMPUNG",14,55,104,159
https://kawalpemilu.org#87269,"LANGKAPURA BARU, LANGKAPURA, KOTA BANDAR LAMPUNG, LAMPUNG",15,68,110,178
https://kawalpemilu.org#87269,"LANGKAPURA BARU, LANGKAPURA, KOTA BANDAR LAMPUNG, LAMPUNG",16,49,74,123
https://kawalpemilu.org#87269,"LANGKAPURA BARU, LANGKAPURA, KOTA BANDAR LAMPUNG, LAMPUNG",17,47,102,149
https://kawalpemilu.org#87269,"LANGKAPURA BARU, LANGKAPURA, KOTA BANDAR LAMPUNG, LAMPUNG",18,44,126,170
https://kawalpemilu.org#87269,"LANGKAPURA BARU, LANGKAPURA, KOTA BANDAR LAMPUNG, LAMPUNG",19,42,100,142
https://kawalpemilu.org#87269,"LANGKAPURA BARU, LANGKAPURA, KOTA BANDAR LAMPUNG, LAMPUNG",20,57,110,167
https://kawalpemilu.org#87269,"LANGKAPURA BARU, LANGKAPURA, KOTA BANDAR LAMPUNG, LAMPUNG",21,47,118,165
https://kawalpemilu.org#87269,"LANGKAPURA BARU, LANGKAPURA, KOTA BANDAR LAMPUNG, LAMPUNG",22,47,146,193
https://kawalpemilu.org#87269,"LANGKAPURA BARU, LANGKAPURA, KOTA BANDAR LAMPUNG, LAMPUNG",23,47,170,217
https://kawalpemilu.org#87269,"LANGKAPURA BARU, LANGKAPURA, KOTA BANDAR LAMPUNG, LAMPUNG",24,39,147,186
https://kawalpemilu.org#87270,"GUNUNGTERANG, LANGKAPURA, KOTA BANDAR LAMPUNG, LAMPUNG",2,81,148,229
https://kawalpemilu.org#87270,"GUNUNGTERANG, LANGKAPURA, KOTA BANDAR LAMPUNG, LAMPUNG",3,92,126,218
https://kawalpemilu.org#87270,"GUNUNGTERANG, LANGKAPURA, KOTA BANDAR LAMPUNG, LAMPUNG",4,79,129,208
https://kawalpemilu.org#87270,"GUNUNGTERANG, LANGKAPURA, KOTA BANDAR LAMPUNG, LAMPUNG",5,95,161,256
https://kawalpemilu.org#87270,"GUNUNGTERANG, LANGKAPURA, KOTA BANDAR LAMPUNG, LAMPUNG",6,86,116,202
https://kawalpemilu.org#87270,"GUNUNGTERANG, LANGKAPURA, KOTA BANDAR LAMPUNG, LAMPUNG",7,87,117,204
https://kawalpemilu.org#87270,"GUNUNGTERANG, LANGKAPURA, KOTA BANDAR LAMPUNG, LAMPUNG",8,66,82,148
https://kawalpemilu.org#87270,"GUNUNGTERANG, LANGKAPURA, KOTA BANDAR LAMPUNG, LAMPUNG",9,117,151,268
https://kawalpemilu.org#87270,"GUNUNGTERANG, LANGKAPURA, KOTA BANDAR LAMPUNG, LAMPUNG",10,139,150,289
https://kawalpemilu.org#87270,"GUNUNGTERANG, LANGKAPURA, KOTA BANDAR LAMPUNG, LAMPUNG",11,69,169,238
https://kawalpemilu.org#87270,"GUNUNGTERANG, LANGKAPURA, KOTA BANDAR LAMPUNG, LAMPUNG",12,72,108,180
https://kawalpemilu.org#87270,"GUNUNGTERANG, LANGKAPURA, KOTA BANDAR LAMPUNG, LAMPUNG",13,60,158,218
https://kawalpemilu.org#87270,"GUNUNGTERANG, LANGKAPURA, KOTA BANDAR LAMPUNG, LAMPUNG",14,54,155,209
https://kawalpemilu.org#87270,"GUNUNGTERANG, LANGKAPURA, KOTA BANDAR LAMPUNG, LAMPUNG",15,52,154,206
https://kawalpemilu.org#87270,"GUNUNGTERANG, LANGKAPURA, KOTA BANDAR LAMPUNG, LAMPUNG",16,93,114,207
https://kawalpemilu.org#87270,"GUNUNGTERANG, LANGKAPURA, KOTA BANDAR LAMPUNG, LAMPUNG",18,52,154,206
https://kawalpemilu.org#87270,"GUNUNGTERANG, LANGKAPURA, KOTA BANDAR LAMPUNG, LAMPUNG",19,51,77,128
https://kawalpemilu.org#87270,"GUNUNGTERANG, LANGKAPURA, KOTA BANDAR LAMPUNG, LAMPUNG",20,67,148,215
https://kawalpemilu.org#87270,"GUNUNGTERANG, LANGKAPURA, KOTA BANDAR LAMPUNG, LAMPUNG",21,54,141,195
https://kawalpemilu.org#87270,"GUNUNGTERANG, LANGKAPURA, KOTA BANDAR LAMPUNG, LAMPUNG",22,115,136,251
https://kawalpemilu.org#87270,"GUNUNGTERANG, LANGKAPURA, KOTA BANDAR LAMPUNG, LAMPUNG",23,92,142,234
https://kawalpemilu.org#87270,"GUNUNGTERANG, LANGKAPURA, KOTA BANDAR LAMPUNG, LAMPUNG",24,70,123,193
https://kawalpemilu.org#87270,"GUNUNGTERANG, LANGKAPURA, KOTA BANDAR LAMPUNG, LAMPUNG",25,84,121,203
https://kawalpemilu.org#87270,"GUNUNGTERANG, LANGKAPURA, KOTA BANDAR LAMPUNG, LAMPUNG",26,83,135,218
https://kawalpemilu.org#87270,"GUNUNGTERANG, LANGKAPURA, KOTA BANDAR LAMPUNG, LAMPUNG",27,71,95,166
https://kawalpemilu.org#87270,"GUNUNGTERANG, LANGKAPURA, KOTA BANDAR LAMPUNG, LAMPUNG",28,81,158,239
https://kawalpemilu.org#87270,"GUNUNGTERANG, LANGKAPURA, KOTA BANDAR LAMPUNG, LAMPUNG",29,97,140,237
https://kawalpemilu.org#87270,"GUNUNGTERANG, LANGKAPURA, KOTA BANDAR LAMPUNG, LAMPUNG",30,67,119,186
https://kawalpemilu.org#87270,"GUNUNGTERANG, LANGKAPURA, KOTA BANDAR LAMPUNG, LAMPUNG",31,86,144,230
https://kawalpemilu.org#87271,"BILABONG JAYA, LANGKAPURA, KOTA BANDAR LAMPUNG, LAMPUNG",1,73,148,221
https://kawalpemilu.org#87271,"BILABONG JAYA, LANGKAPURA, KOTA BANDAR LAMPUNG, LAMPUNG",2,74,116,190
https://kawalpemilu.org#87271,"BILABONG JAYA, LANGKAPURA, KOTA BANDAR LAMPUNG, LAMPUNG",3,58,122,180
https://kawalpemilu.org#87271,"BILABONG JAYA, LANGKAPURA, KOTA BANDAR LAMPUNG, LAMPUNG",4,74,57,231
https://kawalpemilu.org#87271,"BILABONG JAYA, LANGKAPURA, KOTA BANDAR LAMPUNG, LAMPUNG",5,104,151,255
https://kawalpemilu.org#87271,"BILABONG JAYA, LANGKAPURA, KOTA BANDAR LAMPUNG, LAMPUNG",6,59,175,234
https://kawalpemilu.org#87271,"BILABONG JAYA, LANGKAPURA, KOTA BANDAR LAMPUNG, LAMPUNG",7,82,140,222
https://kawalpemilu.org#87272,"GUNUNGAGUNG, LANGKAPURA, KOTA BANDAR LAMPUNG, LAMPUNG",1,68,129,197
https://kawalpemilu.org#87272,"GUNUNGAGUNG, LANGKAPURA, KOTA BANDAR LAMPUNG, LAMPUNG",2,91,123,214
https://kawalpemilu.org#87272,"GUNUNGAGUNG, LANGKAPURA, KOTA BANDAR LAMPUNG, LAMPUNG",3,52,85,137
https://kawalpemilu.org#87272,"GUNUNGAGUNG, LANGKAPURA, KOTA BANDAR LAMPUNG, LAMPUNG",4,63,153,216
https://kawalpemilu.org#87272,"GUNUNGAGUNG, LANGKAPURA, KOTA BANDAR LAMPUNG, LAMPUNG",5,72,158,230
https://kawalpemilu.org#87272,"GUNUNGAGUNG, LANGKAPURA, KOTA BANDAR LAMPUNG, LAMPUNG",6,60,185,245
https://kawalpemilu.org#87272,"GUNUNGAGUNG, LANGKAPURA, KOTA BANDAR LAMPUNG, LAMPUNG",7,45,96,141
https://kawalpemilu.org#87272,"GUNUNGAGUNG, LANGKAPURA, KOTA BANDAR LAMPUNG, LAMPUNG",8,64,143,207
https://kawalpemilu.org#87272,"GUNUNGAGUNG, LANGKAPURA, KOTA BANDAR LAMPUNG, LAMPUNG",9,45,167,212
https://kawalpemilu.org#87272,"GUNUNGAGUNG, LANGKAPURA, KOTA BANDAR LAMPUNG, LAMPUNG",10,52,156,208
https://kawalpemilu.org#87272,"GUNUNGAGUNG, LANGKAPURA, KOTA BANDAR LAMPUNG, LAMPUNG",11,54,233,287
https://kawalpemilu.org#87272,"GUNUNGAGUNG, LANGKAPURA, KOTA BANDAR LAMPUNG, LAMPUNG",12,40,186,226
https://kawalpemilu.org#87272,"GUNUNGAGUNG, LANGKAPURA, KOTA BANDAR LAMPUNG, LAMPUNG",13,61,187,248
https://kawalpemilu.org#87272,"GUNUNGAGUNG, LANGKAPURA, KOTA BANDAR LAMPUNG, LAMPUNG",14,55,176,231
https://kawalpemilu.org#87272,"GUNUNGAGUNG, LANGKAPURA, KOTA BANDAR LAMPUNG, LAMPUNG",15,57,134,191
https://kawalpemilu.org#87272,"GUNUNGAGUNG, LANGKAPURA, KOTA BANDAR LAMPUNG, LAMPUNG",16,59,101,160
https://kawalpemilu.org#87272,"GUNUNGAGUNG, LANGKAPURA, KOTA BANDAR LAMPUNG, LAMPUNG",17,48,108,156
https://kawalpemilu.org#87272,"GUNUNGAGUNG, LANGKAPURA, KOTA BANDAR LAMPUNG, LAMPUNG",18,72,155,227
https://kawalpemilu.org#87272,"GUNUNGAGUNG, LANGKAPURA, KOTA BANDAR LAMPUNG, LAMPUNG",19,105,120,225
https://kawalpemilu.org#87272,"GUNUNGAGUNG, LANGKAPURA, KOTA BANDAR LAMPUNG, LAMPUNG",20,109,141,250
https://kawalpemilu.org#87272,"GUNUNGAGUNG, LANGKAPURA, KOTA BANDAR LAMPUNG, LAMPUNG",21,106,131,237
https://kawalpemilu.org#24755,"ENGGAL, ENGGAL, KOTA BANDAR LAMPUNG, LAMPUNG",1,101,95,196
https://kawalpemilu.org#24755,"ENGGAL, ENGGAL, KOTA BANDAR LAMPUNG, LAMPUNG",2,70,145,215
https://kawalpemilu.org#24755,"ENGGAL, ENGGAL, KOTA BANDAR LAMPUNG, LAMPUNG",3,73,145,218
https://kawalpemilu.org#24755,"ENGGAL, ENGGAL, KOTA BANDAR LAMPUNG, LAMPUNG",4,90,123,213
https://kawalpemilu.org#24755,"ENGGAL, ENGGAL, KOTA BANDAR LAMPUNG, LAMPUNG",5,92,106,198
https://kawalpemilu.org#24755,"ENGGAL, ENGGAL, KOTA BANDAR LAMPUNG, LAMPUNG",6,57,119,176
https://kawalpemilu.org#24755,"ENGGAL, ENGGAL, KOTA BANDAR LAMPUNG, LAMPUNG",7,79,135,214
https://kawalpemilu.org#24755,"ENGGAL, ENGGAL, KOTA BANDAR LAMPUNG, LAMPUNG",8,74,116,190
https://kawalpemilu.org#24755,"ENGGAL, ENGGAL, KOTA BANDAR LAMPUNG, LAMPUNG",9,111,118,229
https://kawalpemilu.org#24755,"ENGGAL, ENGGAL, KOTA BANDAR LAMPUNG, LAMPUNG",11,93,67,160
https://kawalpemilu.org#24755,"ENGGAL, ENGGAL, KOTA BANDAR LAMPUNG, LAMPUNG",12,64,87,151
https://kawalpemilu.org#24755,"ENGGAL, ENGGAL, KOTA BANDAR LAMPUNG, LAMPUNG",13,73,123,195
https://kawalpemilu.org#24755,"ENGGAL, ENGGAL, KOTA BANDAR LAMPUNG, LAMPUNG",14,83,126,209
https://kawalpemilu.org#24755,"ENGGAL, ENGGAL, KOTA BANDAR LAMPUNG, LAMPUNG",15,64,136,200
https://kawalpemilu.org#24755,"ENGGAL, ENGGAL, KOTA BANDAR LAMPUNG, LAMPUNG",16,102,121,223
https://kawalpemilu.org#24756,"PELITA, ENGGAL, KOTA BANDAR LAMPUNG, LAMPUNG",1,102,113,215
https://kawalpemilu.org#24756,"PELITA, ENGGAL, KOTA BANDAR LAMPUNG, LAMPUNG",2,40,113,153
https://kawalpemilu.org#24756,"PELITA, ENGGAL, KOTA BANDAR LAMPUNG, LAMPUNG",3,115,108,223
https://kawalpemilu.org#24756,"PELITA, ENGGAL, KOTA BANDAR LAMPUNG, LAMPUNG",4,115,119,234
https://kawalpemilu.org#24756,"PELITA, ENGGAL, KOTA BANDAR LAMPUNG, LAMPUNG",5,99,118,217
https://kawalpemilu.org#24756,"PELITA, ENGGAL, KOTA BANDAR LAMPUNG, LAMPUNG",6,75,105,180
https://kawalpemilu.org#24756,"PELITA, ENGGAL, KOTA BANDAR LAMPUNG, LAMPUNG",7,86,90,176
https://kawalpemilu.org#24756,"PELITA, ENGGAL, KOTA BANDAR LAMPUNG, LAMPUNG",8,66,96,162
https://kawalpemilu.org#24756,"PELITA, ENGGAL, KOTA BANDAR LAMPUNG, LAMPUNG",9,71,107,178
https://kawalpemilu.org#24756,"PELITA, ENGGAL, KOTA BANDAR LAMPUNG, LAMPUNG",10,52,96,148
https://kawalpemilu.org#24756,"PELITA, ENGGAL, KOTA BANDAR LAMPUNG, LAMPUNG",12,74,69,143
https://kawalpemilu.org#24794,"PAHOMAN, ENGGAL, KOTA BANDAR LAMPUNG, LAMPUNG",1,69,93,162
https://kawalpemilu.org#24794,"PAHOMAN, ENGGAL, KOTA BANDAR LAMPUNG, LAMPUNG",2,57,92,149
https://kawalpemilu.org#24794,"PAHOMAN, ENGGAL, KOTA BANDAR LAMPUNG, LAMPUNG",3,147,114,261
https://kawalpemilu.org#24794,"PAHOMAN, ENGGAL, KOTA BANDAR LAMPUNG, LAMPUNG",4,59,83,142
https://kawalpemilu.org#24794,"PAHOMAN, ENGGAL, KOTA BANDAR LAMPUNG, LAMPUNG",5,71,114,185
https://kawalpemilu.org#24794,"PAHOMAN, ENGGAL, KOTA BANDAR LAMPUNG, LAMPUNG",6,76,139,215
https://kawalpemilu.org#24794,"PAHOMAN, ENGGAL, KOTA BANDAR LAMPUNG, LAMPUNG",7,37,88,125
https://kawalpemilu.org#24794,"PAHOMAN, ENGGAL, KOTA BANDAR LAMPUNG, LAMPUNG",8,80,90,170
https://kawalpemilu.org#24794,"PAHOMAN, ENGGAL, KOTA BANDAR LAMPUNG, LAMPUNG",9,50,69,119
https://kawalpemilu.org#24794,"PAHOMAN, ENGGAL, KOTA BANDAR LAMPUNG, LAMPUNG",10,57,73,130
https://kawalpemilu.org#24794,"PAHOMAN, ENGGAL, KOTA BANDAR LAMPUNG, LAMPUNG",11,121,115,236
https://kawalpemilu.org#24794,"PAHOMAN, ENGGAL, KOTA BANDAR LAMPUNG, LAMPUNG",12,49,94,143
https://kawalpemilu.org#24794,"PAHOMAN, ENGGAL, KOTA BANDAR LAMPUNG, LAMPUNG",13,80,146,226
https://kawalpemilu.org#87273,"TANJUNGKARANG, ENGGAL, KOTA BANDAR LAMPUNG, LAMPUNG",1,105,102,207
https://kawalpemilu.org#87273,"TANJUNGKARANG, ENGGAL, KOTA BANDAR LAMPUNG, LAMPUNG",2,68,136,204
https://kawalpemilu.org#87273,"TANJUNGKARANG, ENGGAL, KOTA BANDAR LAMPUNG, LAMPUNG",3,53,129,182
https://kawalpemilu.org#87273,"TANJUNGKARANG, ENGGAL, KOTA BANDAR LAMPUNG, LAMPUNG",4,166,38,204
https://kawalpemilu.org#87273,"TANJUNGKARANG, ENGGAL, KOTA BANDAR LAMPUNG, LAMPUNG",5,146,27,173
https://kawalpemilu.org#87273,"TANJUNGKARANG, ENGGAL, KOTA BANDAR LAMPUNG, LAMPUNG",6,54,98,152
https://kawalpemilu.org#87273,"TANJUNGKARANG, ENGGAL, KOTA BANDAR LAMPUNG, LAMPUNG",7,62,87,149
https://kawalpemilu.org#87273,"TANJUNGKARANG, ENGGAL, KOTA BANDAR LAMPUNG, LAMPUNG",8,78,51,129
https://kawalpemilu.org#87273,"TANJUNGKARANG, ENGGAL, KOTA BANDAR LAMPUNG, LAMPUNG",9,103,104,207
https://kawalpemilu.org#87273,"TANJUNGKARANG, ENGGAL, KOTA BANDAR LAMPUNG, LAMPUNG",10,77,141,218
https://kawalpemilu.org#87273,"TANJUNGKARANG, ENGGAL, KOTA BANDAR LAMPUNG, LAMPUNG",11,71,223,294
https://kawalpemilu.org#87274,"GUNUNGSARI, ENGGAL, KOTA BANDAR LAMPUNG, LAMPUNG",1,113,81,194
https://kawalpemilu.org#87274,"GUNUNGSARI, ENGGAL, KOTA BANDAR LAMPUNG, LAMPUNG",2,97,84,181
https://kawalpemilu.org#87274,"GUNUNGSARI, ENGGAL, KOTA BANDAR LAMPUNG, LAMPUNG",3,114,88,202
https://kawalpemilu.org#87274,"GUNUNGSARI, ENGGAL, KOTA BANDAR LAMPUNG, LAMPUNG",4,99,94,193
https://kawalpemilu.org#87274,"GUNUNGSARI, ENGGAL, KOTA BANDAR LAMPUNG, LAMPUNG",5,107,90,197
https://kawalpemilu.org#87274,"GUNUNGSARI, ENGGAL, KOTA BANDAR LAMPUNG, LAMPUNG",6,109,91,200
https://kawalpemilu.org#87274,"GUNUNGSARI, ENGGAL, KOTA BANDAR LAMPUNG, LAMPUNG",7,103,56,159
https://kawalpemilu.org#87274,"GUNUNGSARI, ENGGAL, KOTA BANDAR LAMPUNG, LAMPUNG",8,78,76,154
https://kawalpemilu.org#87275,"RAWALAUT, ENGGAL, KOTA BANDAR LAMPUNG, LAMPUNG",1,56,37,93
https://kawalpemilu.org#87275,"RAWALAUT, ENGGAL, KOTA BANDAR LAMPUNG, LAMPUNG",2,34,54,88
https://kawalpemilu.org#87275,"RAWALAUT, ENGGAL, KOTA BANDAR LAMPUNG, LAMPUNG",3,65,94,159
https://kawalpemilu.org#87275,"RAWALAUT, ENGGAL, KOTA BANDAR LAMPUNG, LAMPUNG",4,78,103,181
https://kawalpemilu.org#87275,"RAWALAUT, ENGGAL, KOTA BANDAR LAMPUNG, LAMPUNG",5,53,87,140
https://kawalpemilu.org#87275,"RAWALAUT, ENGGAL, KOTA BANDAR LAMPUNG, LAMPUNG",6,99,123,222
https://kawalpemilu.org#87275,"RAWALAUT, ENGGAL, KOTA BANDAR LAMPUNG, LAMPUNG",7,56,101,157
https://kawalpemilu.org#87275,"RAWALAUT, ENGGAL, KOTA BANDAR LAMPUNG, LAMPUNG",8,69,105,174
https://kawalpemilu.org#87275,"RAWALAUT, ENGGAL, KOTA BANDAR LAMPUNG, LAMPUNG",9,75,98,173
https://kawalpemilu.org#87275,"RAWALAUT, ENGGAL, KOTA BANDAR LAMPUNG, LAMPUNG",10,78,55,133
https://kawalpemilu.org#87275,"RAWALAUT, ENGGAL, KOTA BANDAR LAMPUNG, LAMPUNG",11,79,89,168
https://kawalpemilu.org#87275,"RAWALAUT, ENGGAL, KOTA BANDAR LAMPUNG, LAMPUNG",12,67,112,179
https://kawalpemilu.org#87275,"RAWALAUT, ENGGAL, KOTA BANDAR LAMPUNG, LAMPUNG",13,100,111,211
https://kawalpemilu.org#87275,"RAWALAUT, ENGGAL, KOTA BANDAR LAMPUNG, LAMPUNG",14,100,110,210
https://kawalpemilu.org#87275,"RAWALAUT, ENGGAL, KOTA BANDAR LAMPUNG, LAMPUNG",15,56,92,148
https://kawalpemilu.org#24748,"KEDAMAIAN, KEDAMAIAN, KOTA BANDAR LAMPUNG, LAMPUNG",1,54,198,252
https://kawalpemilu.org#24748,"KEDAMAIAN, KEDAMAIAN, KOTA BANDAR LAMPUNG, LAMPUNG",2,40,83,123
https://kawalpemilu.org#24748,"KEDAMAIAN, KEDAMAIAN, KOTA BANDAR LAMPUNG, LAMPUNG",3,68,163,231
https://kawalpemilu.org#24748,"KEDAMAIAN, KEDAMAIAN, KOTA BANDAR LAMPUNG, LAMPUNG",4,87,132,219
https://kawalpemilu.org#24748,"KEDAMAIAN, KEDAMAIAN, KOTA BANDAR LAMPUNG, LAMPUNG",5,117,112,229
https://kawalpemilu.org#24748,"KEDAMAIAN, KEDAMAIAN, KOTA BANDAR LAMPUNG, LAMPUNG",6,86,136,222
https://kawalpemilu.org#24748,"KEDAMAIAN, KEDAMAIAN, KOTA BANDAR LAMPUNG, LAMPUNG",7,72,149,221
https://kawalpemilu.org#24748,"KEDAMAIAN, KEDAMAIAN, KOTA BANDAR LAMPUNG, LAMPUNG",8,62,117,179
https://kawalpemilu.org#24748,"KEDAMAIAN, KEDAMAIAN, KOTA BANDAR LAMPUNG, LAMPUNG",9,83,153,236
https://kawalpemilu.org#24748,"KEDAMAIAN, KEDAMAIAN, KOTA BANDAR LAMPUNG, LAMPUNG",10,84,164,248
https://kawalpemilu.org#24748,"KEDAMAIAN, KEDAMAIAN, KOTA BANDAR LAMPUNG, LAMPUNG",11,115,135,250
https://kawalpemilu.org#24748,"KEDAMAIAN, KEDAMAIAN, KOTA BANDAR LAMPUNG, LAMPUNG",12,216,29,245
https://kawalpemilu.org#24748,"KEDAMAIAN, KEDAMAIAN, KOTA BANDAR LAMPUNG, LAMPUNG",13,0,0,0
https://kawalpemilu.org#24748,"KEDAMAIAN, KEDAMAIAN, KOTA BANDAR LAMPUNG, LAMPUNG",14,169,31,200
https://kawalpemilu.org#24748,"KEDAMAIAN, KEDAMAIAN, KOTA BANDAR LAMPUNG, LAMPUNG",15,78,109,187
https://kawalpemilu.org#24748,"KEDAMAIAN, KEDAMAIAN, KOTA BANDAR LAMPUNG, LAMPUNG",16,100,157,257
https://kawalpemilu.org#24748,"KEDAMAIAN, KEDAMAIAN, KOTA BANDAR LAMPUNG, LAMPUNG",17,67,107,174
https://kawalpemilu.org#24748,"KEDAMAIAN, KEDAMAIAN, KOTA BANDAR LAMPUNG, LAMPUNG",18,48,111,159
https://kawalpemilu.org#24748,"KEDAMAIAN, KEDAMAIAN, KOTA BANDAR LAMPUNG, LAMPUNG",19,72,80,152
https://kawalpemilu.org#24748,"KEDAMAIAN, KEDAMAIAN, KOTA BANDAR LAMPUNG, LAMPUNG",20,143,109,252
https://kawalpemilu.org#24748,"KEDAMAIAN, KEDAMAIAN, KOTA BANDAR LAMPUNG, LAMPUNG",21,107,118,225
https://kawalpemilu.org#24748,"KEDAMAIAN, KEDAMAIAN, KOTA BANDAR LAMPUNG, LAMPUNG",22,153,102,255
https://kawalpemilu.org#24748,"KEDAMAIAN, KEDAMAIAN, KOTA BANDAR LAMPUNG, LAMPUNG",23,84,73,157
https://kawalpemilu.org#24748,"KEDAMAIAN, KEDAMAIAN, KOTA BANDAR LAMPUNG, LAMPUNG",24,113,109,222
https://kawalpemilu.org#24748,"KEDAMAIAN, KEDAMAIAN, KOTA BANDAR LAMPUNG, LAMPUNG",25,62,59,121
https://kawalpemilu.org#24748,"KEDAMAIAN, KEDAMAIAN, KOTA BANDAR LAMPUNG, LAMPUNG",26,70,64,134
https://kawalpemilu.org#87259,"BUMI KEDAMAIAN, KEDAMAIAN, KOTA BANDAR LAMPUNG, LAMPUNG",1,112,145,257
https://kawalpemilu.org#87259,"BUMI KEDAMAIAN, KEDAMAIAN, KOTA BANDAR LAMPUNG, LAMPUNG",2,98,121,219
https://kawalpemilu.org#87259,"BUMI KEDAMAIAN, KEDAMAIAN, KOTA BANDAR LAMPUNG, LAMPUNG",3,120,120,240
https://kawalpemilu.org#87259,"BUMI KEDAMAIAN, KEDAMAIAN, KOTA BANDAR LAMPUNG, LAMPUNG",5,75,89,164
https://kawalpemilu.org#87259,"BUMI KEDAMAIAN, KEDAMAIAN, KOTA BANDAR LAMPUNG, LAMPUNG",6,108,103,211
https://kawalpemilu.org#87259,"BUMI KEDAMAIAN, KEDAMAIAN, KOTA BANDAR LAMPUNG, LAMPUNG",7,124,95,219
https://kawalpemilu.org#87259,"BUMI KEDAMAIAN, KEDAMAIAN, KOTA BANDAR LAMPUNG, LAMPUNG",8,241,19,260
https://kawalpemilu.org#87259,"BUMI KEDAMAIAN, KEDAMAIAN, KOTA BANDAR LAMPUNG, LAMPUNG",9,173,8,181
https://kawalpemilu.org#87259,"BUMI KEDAMAIAN, KEDAMAIAN, KOTA BANDAR LAMPUNG, LAMPUNG",10,147,8,155
https://kawalpemilu.org#87259,"BUMI KEDAMAIAN, KEDAMAIAN, KOTA BANDAR LAMPUNG, LAMPUNG",11,139,11,150
https://kawalpemilu.org#87259,"BUMI KEDAMAIAN, KEDAMAIAN, KOTA BANDAR LAMPUNG, LAMPUNG",13,133,19,152
https://kawalpemilu.org#87259,"BUMI KEDAMAIAN, KEDAMAIAN, KOTA BANDAR LAMPUNG, LAMPUNG",14,108,20,128
https://kawalpemilu.org#87259,"BUMI KEDAMAIAN, KEDAMAIAN, KOTA BANDAR LAMPUNG, LAMPUNG",15,105,87,192
https://kawalpemilu.org#87259,"BUMI KEDAMAIAN, KEDAMAIAN, KOTA BANDAR LAMPUNG, LAMPUNG",16,76,125,201
https://kawalpemilu.org#87259,"BUMI KEDAMAIAN, KEDAMAIAN, KOTA BANDAR LAMPUNG, LAMPUNG",17,74,120,194
https://kawalpemilu.org#87259,"BUMI KEDAMAIAN, KEDAMAIAN, KOTA BANDAR LAMPUNG, LAMPUNG",18,59,49,108
https://kawalpemilu.org#87259,"BUMI KEDAMAIAN, KEDAMAIAN, KOTA BANDAR LAMPUNG, LAMPUNG",19,38,79,117
https://kawalpemilu.org#87259,"BUMI KEDAMAIAN, KEDAMAIAN, KOTA BANDAR LAMPUNG, LAMPUNG",20,52,64,116
https://kawalpemilu.org#87259,"BUMI KEDAMAIAN, KEDAMAIAN, KOTA BANDAR LAMPUNG, LAMPUNG",21,39,41,80
https://kawalpemilu.org#87259,"BUMI KEDAMAIAN, KEDAMAIAN, KOTA BANDAR LAMPUNG, LAMPUNG",22,77,111,188
https://kawalpemilu.org#87259,"BUMI KEDAMAIAN, KEDAMAIAN, KOTA BANDAR LAMPUNG, LAMPUNG",23,107,82,189
https://kawalpemilu.org#87259,"BUMI KEDAMAIAN, KEDAMAIAN, KOTA BANDAR LAMPUNG, LAMPUNG",24,73,75,148
https://kawalpemilu.org#87259,"BUMI KEDAMAIAN, KEDAMAIAN, KOTA BANDAR LAMPUNG, LAMPUNG",25,76,108,184
https://kawalpemilu.org#87259,"BUMI KEDAMAIAN, KEDAMAIAN, KOTA BANDAR LAMPUNG, LAMPUNG",26,76,94,170
https://kawalpemilu.org#87259,"BUMI KEDAMAIAN, KEDAMAIAN, KOTA BANDAR LAMPUNG, LAMPUNG",27,81,129,210
https://kawalpemilu.org#87259,"BUMI KEDAMAIAN, KEDAMAIAN, KOTA BANDAR LAMPUNG, LAMPUNG",28,93,74,167
https://kawalpemilu.org#87260,"TANJUNGAGUNG RAYA, KEDAMAIAN, KOTA BANDAR LAMPUNG, LAMPUNG",1,86,105,191
https://kawalpemilu.org#87260,"TANJUNGAGUNG RAYA, KEDAMAIAN, KOTA BANDAR LAMPUNG, LAMPUNG",2,70,162,232
https://kawalpemilu.org#87260,"TANJUNGAGUNG RAYA, KEDAMAIAN, KOTA BANDAR LAMPUNG, LAMPUNG",3,96,143,239
https://kawalpemilu.org#87260,"TANJUNGAGUNG RAYA, KEDAMAIAN, KOTA BANDAR LAMPUNG, LAMPUNG",4,97,119,216
https://kawalpemilu.org#87260,"TANJUNGAGUNG RAYA, KEDAMAIAN, KOTA BANDAR LAMPUNG, LAMPUNG",5,63,128,191
https://kawalpemilu.org#87260,"TANJUNGAGUNG RAYA, KEDAMAIAN, KOTA BANDAR LAMPUNG, LAMPUNG",6,67,71,138
https://kawalpemilu.org#87260,"TANJUNGAGUNG RAYA, KEDAMAIAN, KOTA BANDAR LAMPUNG, LAMPUNG",7,27,35,62
https://kawalpemilu.org#87261,"TANJUNGBARU, KEDAMAIAN, KOTA BANDAR LAMPUNG, LAMPUNG",1,79,81,160
https://kawalpemilu.org#87261,"TANJUNGBARU, KEDAMAIAN, KOTA BANDAR LAMPUNG, LAMPUNG",2,92,66,158
https://kawalpemilu.org#87261,"TANJUNGBARU, KEDAMAIAN, KOTA BANDAR LAMPUNG, LAMPUNG",3,103,95,198
https://kawalpemilu.org#87261,"TANJUNGBARU, KEDAMAIAN, KOTA BANDAR LAMPUNG, LAMPUNG",4,117,115,232
https://kawalpemilu.org#87261,"TANJUNGBARU, KEDAMAIAN, KOTA BANDAR LAMPUNG, LAMPUNG",5,142,86,228
https://kawalpemilu.org#87261,"TANJUNGBARU, KEDAMAIAN, KOTA BANDAR LAMPUNG, LAMPUNG",7,121,47,168
https://kawalpemilu.org#87261,"TANJUNGBARU, KEDAMAIAN, KOTA BANDAR LAMPUNG, LAMPUNG",8,75,105,180
https://kawalpemilu.org#87261,"TANJUNGBARU, KEDAMAIAN, KOTA BANDAR LAMPUNG, LAMPUNG",9,126,113,239
https://kawalpemilu.org#87261,"TANJUNGBARU, KEDAMAIAN, KOTA BANDAR LAMPUNG, LAMPUNG",10,167,113,280
https://kawalpemilu.org#87261,"TANJUNGBARU, KEDAMAIAN, KOTA BANDAR LAMPUNG, LAMPUNG",11,114,122,236
https://kawalpemilu.org#87261,"TANJUNGBARU, KEDAMAIAN, KOTA BANDAR LAMPUNG, LAMPUNG",12,129,151,280
https://kawalpemilu.org#87261,"TANJUNGBARU, KEDAMAIAN, KOTA BANDAR LAMPUNG, LAMPUNG",13,105,99,204
https://kawalpemilu.org#87261,"TANJUNGBARU, KEDAMAIAN, KOTA BANDAR LAMPUNG, LAMPUNG",15,100,149,249
https://kawalpemilu.org#87261,"TANJUNGBARU, KEDAMAIAN, KOTA BANDAR LAMPUNG, LAMPUNG",16,85,133,218
https://kawalpemilu.org#87261,"TANJUNGBARU, KEDAMAIAN, KOTA BANDAR LAMPUNG, LAMPUNG",17,96,118,214
https://kawalpemilu.org#87261,"TANJUNGBARU, KEDAMAIAN, KOTA BANDAR LAMPUNG, LAMPUNG",18,88,101,189
https://kawalpemilu.org#87261,"TANJUNGBARU, KEDAMAIAN, KOTA BANDAR LAMPUNG, LAMPUNG",19,99,113,212
https://kawalpemilu.org#87261,"TANJUNGBARU, KEDAMAIAN, KOTA BANDAR LAMPUNG, LAMPUNG",20,99,79,178
https://kawalpemilu.org#87261,"TANJUNGBARU, KEDAMAIAN, KOTA BANDAR LAMPUNG, LAMPUNG",21,88,101,189
https://kawalpemilu.org#87261,"TANJUNGBARU, KEDAMAIAN, KOTA BANDAR LAMPUNG, LAMPUNG",22,124,105,229
https://kawalpemilu.org#87261,"TANJUNGBARU, KEDAMAIAN, KOTA BANDAR LAMPUNG, LAMPUNG",23,103,95,198
https://kawalpemilu.org#87263,"KALIBALAU KENCANA, KEDAMAIAN, KOTA BANDAR LAMPUNG, LAMPUNG",1,99,113,212
https://kawalpemilu.org#87263,"KALIBALAU KENCANA, KEDAMAIAN, KOTA BANDAR LAMPUNG, LAMPUNG",2,92,97,189
https://kawalpemilu.org#87263,"KALIBALAU KENCANA, KEDAMAIAN, KOTA BANDAR LAMPUNG, LAMPUNG",3,99,110,209
https://kawalpemilu.org#87263,"KALIBALAU KENCANA, KEDAMAIAN, KOTA BANDAR LAMPUNG, LAMPUNG",4,118,127,245
https://kawalpemilu.org#87263,"KALIBALAU KENCANA, KEDAMAIAN, KOTA BANDAR LAMPUNG, LAMPUNG",5,77,132,209
https://kawalpemilu.org#87263,"KALIBALAU KENCANA, KEDAMAIAN, KOTA BANDAR LAMPUNG, LAMPUNG",6,90,131,221
https://kawalpemilu.org#87263,"KALIBALAU KENCANA, KEDAMAIAN, KOTA BANDAR LAMPUNG, LAMPUNG",7,75,171,246
https://kawalpemilu.org#87263,"KALIBALAU KENCANA, KEDAMAIAN, KOTA BANDAR LAMPUNG, LAMPUNG",8,136,146,283
https://kawalpemilu.org#87263,"KALIBALAU KENCANA, KEDAMAIAN, KOTA BANDAR LAMPUNG, LAMPUNG",9,79,92,171
https://kawalpemilu.org#87263,"KALIBALAU KENCANA, KEDAMAIAN, KOTA BANDAR LAMPUNG, LAMPUNG",10,87,80,167
https://kawalpemilu.org#87263,"KALIBALAU KENCANA, KEDAMAIAN, KOTA BANDAR LAMPUNG, LAMPUNG",11,127,119,246
https://kawalpemilu.org#87263,"KALIBALAU KENCANA, KEDAMAIAN, KOTA BANDAR LAMPUNG, LAMPUNG",12,143,141,284
https://kawalpemilu.org#87263,"KALIBALAU KENCANA, KEDAMAIAN, KOTA BANDAR LAMPUNG, LAMPUNG",13,222,62,284
https://kawalpemilu.org#87263,"KALIBALAU KENCANA, KEDAMAIAN, KOTA BANDAR LAMPUNG, LAMPUNG",14,130,69,199
https://kawalpemilu.org#87263,"KALIBALAU KENCANA, KEDAMAIAN, KOTA BANDAR LAMPUNG, LAMPUNG",15,80,131,211
https://kawalpemilu.org#87263,"KALIBALAU KENCANA, KEDAMAIAN, KOTA BANDAR LAMPUNG, LAMPUNG",16,105,32,137
https://kawalpemilu.org#87263,"KALIBALAU KENCANA, KEDAMAIAN, KOTA BANDAR LAMPUNG, LAMPUNG",17,127,69,196
https://kawalpemilu.org#87263,"KALIBALAU KENCANA, KEDAMAIAN, KOTA BANDAR LAMPUNG, LAMPUNG",18,91,76,167
https://kawalpemilu.org#87263,"KALIBALAU KENCANA, KEDAMAIAN, KOTA BANDAR LAMPUNG, LAMPUNG",19,79,58,137
https://kawalpemilu.org#87263,"KALIBALAU KENCANA, KEDAMAIAN, KOTA BANDAR LAMPUNG, LAMPUNG",20,90,94,184
https://kawalpemilu.org#87263,"KALIBALAU KENCANA, KEDAMAIAN, KOTA BANDAR LAMPUNG, LAMPUNG",21,113,131,244
https://kawalpemilu.org#87263,"KALIBALAU KENCANA, KEDAMAIAN, KOTA BANDAR LAMPUNG, LAMPUNG",22,210,51,261
https://kawalpemilu.org#87263,"KALIBALAU KENCANA, KEDAMAIAN, KOTA BANDAR LAMPUNG, LAMPUNG",23,103,112,215
https://kawalpemilu.org#87264,"TANJUNGRAYA, KEDAMAIAN, KOTA BANDAR LAMPUNG, LAMPUNG",2,35,76,111
https://kawalpemilu.org#87264,"TANJUNGRAYA, KEDAMAIAN, KOTA BANDAR LAMPUNG, LAMPUNG",3,47,61,108
https://kawalpemilu.org#87264,"TANJUNGRAYA, KEDAMAIAN, KOTA BANDAR LAMPUNG, LAMPUNG",4,99,112,211
https://kawalpemilu.org#87264,"TANJUNGRAYA, KEDAMAIAN, KOTA BANDAR LAMPUNG, LAMPUNG",5,119,107,226
https://kawalpemilu.org#87264,"TANJUNGRAYA, KEDAMAIAN, KOTA BANDAR LAMPUNG, LAMPUNG",6,47,80,127
https://kawalpemilu.org#87264,"TANJUNGRAYA, KEDAMAIAN, KOTA BANDAR LAMPUNG, LAMPUNG",7,109,131,240
https://kawalpemilu.org#87264,"TANJUNGRAYA, KEDAMAIAN, KOTA BANDAR LAMPUNG, LAMPUNG",8,106,96,202
https://kawalpemilu.org#87264,"TANJUNGRAYA, KEDAMAIAN, KOTA BANDAR LAMPUNG, LAMPUNG",9,92,105,197
https://kawalpemilu.org#87264,"TANJUNGRAYA, KEDAMAIAN, KOTA BANDAR LAMPUNG, LAMPUNG",10,57,105,162
https://kawalpemilu.org#87264,"TANJUNGRAYA, KEDAMAIAN, KOTA BANDAR LAMPUNG, LAMPUNG",11,62,96,158
https://kawalpemilu.org#87264,"TANJUNGRAYA, KEDAMAIAN, KOTA BANDAR LAMPUNG, LAMPUNG",12,93,138,231
https://kawalpemilu.org#87264,"TANJUNGRAYA, KEDAMAIAN, KOTA BANDAR LAMPUNG, LAMPUNG",13,47,94,141
https://kawalpemilu.org#87264,"TANJUNGRAYA, KEDAMAIAN, KOTA BANDAR LAMPUNG, LAMPUNG",15,76,93,169
https://kawalpemilu.org#87264,"TANJUNGRAYA, KEDAMAIAN, KOTA BANDAR LAMPUNG, LAMPUNG",16,101,116,217
https://kawalpemilu.org#87264,"TANJUNGRAYA, KEDAMAIAN, KOTA BANDAR LAMPUNG, LAMPUNG",17,79,119,198
https://kawalpemilu.org#87264,"TANJUNGRAYA, KEDAMAIAN, KOTA BANDAR LAMPUNG, LAMPUNG",18,55,104,159
https://kawalpemilu.org#87264,"TANJUNGRAYA, KEDAMAIAN, KOTA BANDAR LAMPUNG, LAMPUNG",19,50,143,193
https://kawalpemilu.org#87264,"TANJUNGRAYA, KEDAMAIAN, KOTA BANDAR LAMPUNG, LAMPUNG",20,60,78,138
https://kawalpemilu.org#87264,"TANJUNGRAYA, KEDAMAIAN, KOTA BANDAR LAMPUNG, LAMPUNG",21,88,105,193
https://kawalpemilu.org#87264,"TANJUNGRAYA, KEDAMAIAN, KOTA BANDAR LAMPUNG, LAMPUNG",22,118,91,209
https://kawalpemilu.org#87264,"TANJUNGRAYA, KEDAMAIAN, KOTA BANDAR LAMPUNG, LAMPUNG",23,84,64,148
https://kawalpemilu.org#87264,"TANJUNGRAYA, KEDAMAIAN, KOTA BANDAR LAMPUNG, LAMPUNG",24,132,27,159
https://kawalpemilu.org#87264,"TANJUNGRAYA, KEDAMAIAN, KOTA BANDAR LAMPUNG, LAMPUNG",25,96,78,174
https://kawalpemilu.org#87264,"TANJUNGRAYA, KEDAMAIAN, KOTA BANDAR LAMPUNG, LAMPUNG",26,54,67,121
https://kawalpemilu.org#87265,"TANJUNGGADING, KEDAMAIAN, KOTA BANDAR LAMPUNG, LAMPUNG",1,87,86,173
https://kawalpemilu.org#87265,"TANJUNGGADING, KEDAMAIAN, KOTA BANDAR LAMPUNG, LAMPUNG",2,100,70,170
https://kawalpemilu.org#87265,"TANJUNGGADING, KEDAMAIAN, KOTA BANDAR LAMPUNG, LAMPUNG",3,64,151,179
https://kawalpemilu.org#87265,"TANJUNGGADING, KEDAMAIAN, KOTA BANDAR LAMPUNG, LAMPUNG",4,107,99,207
https://kawalpemilu.org#87265,"TANJUNGGADING, KEDAMAIAN, KOTA BANDAR LAMPUNG, LAMPUNG",5,116,133,249
https://kawalpemilu.org#87265,"TANJUNGGADING, KEDAMAIAN, KOTA BANDAR LAMPUNG, LAMPUNG",6,84,91,175
https://kawalpemilu.org#87265,"TANJUNGGADING, KEDAMAIAN, KOTA BANDAR LAMPUNG, LAMPUNG",7,111,94,205
https://kawalpemilu.org#87265,"TANJUNGGADING, KEDAMAIAN, KOTA BANDAR LAMPUNG, LAMPUNG",8,124,110,234
https://kawalpemilu.org#87265,"TANJUNGGADING, KEDAMAIAN, KOTA BANDAR LAMPUNG, LAMPUNG",9,101,107,208
https://kawalpemilu.org#87265,"TANJUNGGADING, KEDAMAIAN, KOTA BANDAR LAMPUNG, LAMPUNG",10,120,86,206
https://kawalpemilu.org#87265,"TANJUNGGADING, KEDAMAIAN, KOTA BANDAR LAMPUNG, LAMPUNG",11,61,132,193
https://kawalpemilu.org#87265,"TANJUNGGADING, KEDAMAIAN, KOTA BANDAR LAMPUNG, LAMPUNG",12,71,110,181
https://kawalpemilu.org#87265,"TANJUNGGADING, KEDAMAIAN, KOTA BANDAR LAMPUNG, LAMPUNG",13,63,129,192
https://kawalpemilu.org#24777,"SUKAMAJU, TELUKBETUNG TIMUR, KOTA BANDAR LAMPUNG, LAMPUNG",1,48,147,195
https://kawalpemilu.org#24777,"SUKAMAJU, TELUKBETUNG TIMUR, KOTA BANDAR LAMPUNG, LAMPUNG",2,64,147,211
https://kawalpemilu.org#24777,"SUKAMAJU, TELUKBETUNG TIMUR, KOTA BANDAR LAMPUNG, LAMPUNG",3,67,128,195
https://kawalpemilu.org#24777,"SUKAMAJU, TELUKBETUNG TIMUR, KOTA BANDAR LAMPUNG, LAMPUNG",4,67,123,190
https://kawalpemilu.org#24777,"SUKAMAJU, TELUKBETUNG TIMUR, KOTA BANDAR LAMPUNG, LAMPUNG",5,80,89,169
https://kawalpemilu.org#24777,"SUKAMAJU, TELUKBETUNG TIMUR, KOTA BANDAR LAMPUNG, LAMPUNG",6,109,93,202
https://kawalpemilu.org#24777,"SUKAMAJU, TELUKBETUNG TIMUR, KOTA BANDAR LAMPUNG, LAMPUNG",7,89,113,202
https://kawalpemilu.org#24777,"SUKAMAJU, TELUKBETUNG TIMUR, KOTA BANDAR LAMPUNG, LAMPUNG",8,69,125,194
https://kawalpemilu.org#24777,"SUKAMAJU, TELUKBETUNG TIMUR, KOTA BANDAR LAMPUNG, LAMPUNG",9,55,146,201
https://kawalpemilu.org#24777,"SUKAMAJU, TELUKBETUNG TIMUR, KOTA BANDAR LAMPUNG, LAMPUNG",10,115,80,195
https://kawalpemilu.org#24777,"SUKAMAJU, TELUKBETUNG TIMUR, KOTA BANDAR LAMPUNG, LAMPUNG",11,60,128,188
https://kawalpemilu.org#24777,"SUKAMAJU, TELUKBETUNG TIMUR, KOTA BANDAR LAMPUNG, LAMPUNG",12,84,115,199
https://kawalpemilu.org#24777,"SUKAMAJU, TELUKBETUNG TIMUR, KOTA BANDAR LAMPUNG, LAMPUNG",13,88,98,186
https://kawalpemilu.org#24777,"SUKAMAJU, TELUKBETUNG TIMUR, KOTA BANDAR LAMPUNG, LAMPUNG",14,75,77,152
https://kawalpemilu.org#24778,"KETEGUHAN, TELUKBETUNG TIMUR, KOTA BANDAR LAMPUNG, LAMPUNG",1,85,104,189
https://kawalpemilu.org#24778,"KETEGUHAN, TELUKBETUNG TIMUR, KOTA BANDAR LAMPUNG, LAMPUNG",2,56,132,188
https://kawalpemilu.org#24778,"KETEGUHAN, TELUKBETUNG TIMUR, KOTA BANDAR LAMPUNG, LAMPUNG",3,56,126,182
https://kawalpemilu.org#24778,"KETEGUHAN, TELUKBETUNG TIMUR, KOTA BANDAR LAMPUNG, LAMPUNG",4,66,141,207
https://kawalpemilu.org#24778,"KETEGUHAN, TELUKBETUNG TIMUR, KOTA BANDAR LAMPUNG, LAMPUNG",5,83,80,163
https://kawalpemilu.org#24778,"KETEGUHAN, TELUKBETUNG TIMUR, KOTA BANDAR LAMPUNG, LAMPUNG",6,73,92,165
https://kawalpemilu.org#24778,"KETEGUHAN, TELUKBETUNG TIMUR, KOTA BANDAR LAMPUNG, LAMPUNG",7,89,116,205
https://kawalpemilu.org#24778,"KETEGUHAN, TELUKBETUNG TIMUR, KOTA BANDAR LAMPUNG, LAMPUNG",8,112,83,195
https://kawalpemilu.org#24778,"KETEGUHAN, TELUKBETUNG TIMUR, KOTA BANDAR LAMPUNG, LAMPUNG",9,176,40,216
https://kawalpemilu.org#24778,"KETEGUHAN, TELUKBETUNG TIMUR, KOTA BANDAR LAMPUNG, LAMPUNG",10,155,65,220
https://kawalpemilu.org#24778,"KETEGUHAN, TELUKBETUNG TIMUR, KOTA BANDAR LAMPUNG, LAMPUNG",11,104,104,208
https://kawalpemilu.org#24778,"KETEGUHAN, TELUKBETUNG TIMUR, KOTA BANDAR LAMPUNG, LAMPUNG",12,117,123,240
https://kawalpemilu.org#24778,"KETEGUHAN, TELUKBETUNG TIMUR, KOTA BANDAR LAMPUNG, LAMPUNG",13,105,94,199
https://kawalpemilu.org#24778,"KETEGUHAN, TELUKBETUNG TIMUR, KOTA BANDAR LAMPUNG, LAMPUNG",14,100,80,180
https://kawalpemilu.org#24778,"KETEGUHAN, TELUKBETUNG TIMUR, KOTA BANDAR LAMPUNG, LAMPUNG",15,67,113,180
https://kawalpemilu.org#24778,"KETEGUHAN, TELUKBETUNG TIMUR, KOTA BANDAR LAMPUNG, LAMPUNG",16,84,135,219
https://kawalpemilu.org#24778,"KETEGUHAN, TELUKBETUNG TIMUR, KOTA BANDAR LAMPUNG, LAMPUNG",17,105,106,211
https://kawalpemilu.org#24778,"KETEGUHAN, TELUKBETUNG TIMUR, KOTA BANDAR LAMPUNG, LAMPUNG",18,66,78,144
https://kawalpemilu.org#24778,"KETEGUHAN, TELUKBETUNG TIMUR, KOTA BANDAR LAMPUNG, LAMPUNG",19,112,128,240
https://kawalpemilu.org#24778,"KETEGUHAN, TELUKBETUNG TIMUR, KOTA BANDAR LAMPUNG, LAMPUNG",20,117,61,178
https://kawalpemilu.org#24778,"KETEGUHAN, TELUKBETUNG TIMUR, KOTA BANDAR LAMPUNG, LAMPUNG",21,108,133,241
https://kawalpemilu.org#24778,"KETEGUHAN, TELUKBETUNG TIMUR, KOTA BANDAR LAMPUNG, LAMPUNG",23,99,78,177
https://kawalpemilu.org#24778,"KETEGUHAN, TELUKBETUNG TIMUR, KOTA BANDAR LAMPUNG, LAMPUNG",24,103,50,153
https://kawalpemilu.org#24778,"KETEGUHAN, TELUKBETUNG TIMUR, KOTA BANDAR LAMPUNG, LAMPUNG",25,55,67,122
https://kawalpemilu.org#24778,"KETEGUHAN, TELUKBETUNG TIMUR, KOTA BANDAR LAMPUNG, LAMPUNG",26,106,60,166
https://kawalpemilu.org#24778,"KETEGUHAN, TELUKBETUNG TIMUR, KOTA BANDAR LAMPUNG, LAMPUNG",27,118,66,184
https://kawalpemilu.org#24778,"KETEGUHAN, TELUKBETUNG TIMUR, KOTA BANDAR LAMPUNG, LAMPUNG",28,122,98,220
https://kawalpemilu.org#24778,"KETEGUHAN, TELUKBETUNG TIMUR, KOTA BANDAR LAMPUNG, LAMPUNG",29,130,80,210
https://kawalpemilu.org#24778,"KETEGUHAN, TELUKBETUNG TIMUR, KOTA BANDAR LAMPUNG, LAMPUNG",30,119,50,169
https://kawalpemilu.org#24778,"KETEGUHAN, TELUKBETUNG TIMUR, KOTA BANDAR LAMPUNG, LAMPUNG",31,135,73,208
https://kawalpemilu.org#24778,"KETEGUHAN, TELUKBETUNG TIMUR, KOTA BANDAR LAMPUNG, LAMPUNG",32,84,99,183
https://kawalpemilu.org#24778,"KETEGUHAN, TELUKBETUNG TIMUR, KOTA BANDAR LAMPUNG, LAMPUNG",33,86,102,188
https://kawalpemilu.org#24778,"KETEGUHAN, TELUKBETUNG TIMUR, KOTA BANDAR LAMPUNG, LAMPUNG",34,76,95,171
https://kawalpemilu.org#24778,"KETEGUHAN, TELUKBETUNG TIMUR, KOTA BANDAR LAMPUNG, LAMPUNG",35,79,119,198
https://kawalpemilu.org#24778,"KETEGUHAN, TELUKBETUNG TIMUR, KOTA BANDAR LAMPUNG, LAMPUNG",36,63,102,165
https://kawalpemilu.org#24778,"KETEGUHAN, TELUKBETUNG TIMUR, KOTA BANDAR LAMPUNG, LAMPUNG",37,72,167,239
https://kawalpemilu.org#24778,"KETEGUHAN, TELUKBETUNG TIMUR, KOTA BANDAR LAMPUNG, LAMPUNG",38,44,146,190
https://kawalpemilu.org#24778,"KETEGUHAN, TELUKBETUNG TIMUR, KOTA BANDAR LAMPUNG, LAMPUNG",39,100,126,226
https://kawalpemilu.org#24778,"KETEGUHAN, TELUKBETUNG TIMUR, KOTA BANDAR LAMPUNG, LAMPUNG",40,94,139,233
https://kawalpemilu.org#24779,"KOTA KARANG, TELUKBETUNG TIMUR, KOTA BANDAR LAMPUNG, LAMPUNG",1,71,153,224
https://kawalpemilu.org#24779,"KOTA KARANG, TELUKBETUNG TIMUR, KOTA BANDAR LAMPUNG, LAMPUNG",2,69,113,182
https://kawalpemilu.org#24779,"KOTA KARANG, TELUKBETUNG TIMUR, KOTA BANDAR LAMPUNG, LAMPUNG",3,63,123,186
https://kawalpemilu.org#24779,"KOTA KARANG, TELUKBETUNG TIMUR, KOTA BANDAR LAMPUNG, LAMPUNG",4,74,119,193
https://kawalpemilu.org#24779,"KOTA KARANG, TELUKBETUNG TIMUR, KOTA BANDAR LAMPUNG, LAMPUNG",5,88,124,212
https://kawalpemilu.org#24779,"KOTA KARANG, TELUKBETUNG TIMUR, KOTA BANDAR LAMPUNG, LAMPUNG",6,138,33,171
https://kawalpemilu.org#24779,"KOTA KARANG, TELUKBETUNG TIMUR, KOTA BANDAR LAMPUNG, LAMPUNG",7,199,17,216
https://kawalpemilu.org#24779,"KOTA KARANG, TELUKBETUNG TIMUR, KOTA BANDAR LAMPUNG, LAMPUNG",8,126,101,227
https://kawalpemilu.org#24779,"KOTA KARANG, TELUKBETUNG TIMUR, KOTA BANDAR LAMPUNG, LAMPUNG",9,122,77,199
https://kawalpemilu.org#24779,"KOTA KARANG, TELUKBETUNG TIMUR, KOTA BANDAR LAMPUNG, LAMPUNG",10,130,84,214
https://kawalpemilu.org#24779,"KOTA KARANG, TELUKBETUNG TIMUR, KOTA BANDAR LAMPUNG, LAMPUNG",11,103,80,183
https://kawalpemilu.org#24779,"KOTA KARANG, TELUKBETUNG TIMUR, KOTA BANDAR LAMPUNG, LAMPUNG",12,112,100,212
https://kawalpemilu.org#24779,"KOTA KARANG, TELUKBETUNG TIMUR, KOTA BANDAR LAMPUNG, LAMPUNG",13,84,119,203
https://kawalpemilu.org#24779,"KOTA KARANG, TELUKBETUNG TIMUR, KOTA BANDAR LAMPUNG, LAMPUNG",14,85,91,176
https://kawalpemilu.org#24779,"KOTA KARANG, TELUKBETUNG TIMUR, KOTA BANDAR LAMPUNG, LAMPUNG",15,88,129,217
https://kawalpemilu.org#24779,"KOTA KARANG, TELUKBETUNG TIMUR, KOTA BANDAR LAMPUNG, LAMPUNG",17,71,102,173
https://kawalpemilu.org#24779,"KOTA KARANG, TELUKBETUNG TIMUR, KOTA BANDAR LAMPUNG, LAMPUNG",18,75,95,170
https://kawalpemilu.org#24779,"KOTA KARANG, TELUKBETUNG TIMUR, KOTA BANDAR LAMPUNG, LAMPUNG",19,89,89,178
https://kawalpemilu.org#24779,"KOTA KARANG, TELUKBETUNG TIMUR, KOTA BANDAR LAMPUNG, LAMPUNG",20,80,110,190
https://kawalpemilu.org#24779,"KOTA KARANG, TELUKBETUNG TIMUR, KOTA BANDAR LAMPUNG, LAMPUNG",21,75,129,204
https://kawalpemilu.org#24779,"KOTA KARANG, TELUKBETUNG TIMUR, KOTA BANDAR LAMPUNG, LAMPUNG",22,87,159,246
https://kawalpemilu.org#24779,"KOTA KARANG, TELUKBETUNG TIMUR, KOTA BANDAR LAMPUNG, LAMPUNG",23,83,143,226
https://kawalpemilu.org#24779,"KOTA KARANG, TELUKBETUNG TIMUR, KOTA BANDAR LAMPUNG, LAMPUNG",24,62,140,202
https://kawalpemilu.org#24779,"KOTA KARANG, TELUKBETUNG TIMUR, KOTA BANDAR LAMPUNG, LAMPUNG",25,87,108,195
https://kawalpemilu.org#24779,"KOTA KARANG, TELUKBETUNG TIMUR, KOTA BANDAR LAMPUNG, LAMPUNG",26,94,119,213
https://kawalpemilu.org#24779,"KOTA KARANG, TELUKBETUNG TIMUR, KOTA BANDAR LAMPUNG, LAMPUNG",27,121,112,233
https://kawalpemilu.org#24779,"KOTA KARANG, TELUKBETUNG TIMUR, KOTA BANDAR LAMPUNG, LAMPUNG",28,155,47,202
https://kawalpemilu.org#24779,"KOTA KARANG, TELUKBETUNG TIMUR, KOTA BANDAR LAMPUNG, LAMPUNG",29,163,49,212
https://kawalpemilu.org#24779,"KOTA KARANG, TELUKBETUNG TIMUR, KOTA BANDAR LAMPUNG, LAMPUNG",30,135,47,182
https://kawalpemilu.org#24779,"KOTA KARANG, TELUKBETUNG TIMUR, KOTA BANDAR LAMPUNG, LAMPUNG",31,124,42,166
https://kawalpemilu.org#87276,"KOTA KARANG RAYA, TELUKBETUNG TIMUR, KOTA BANDAR LAMPUNG, LAMPUNG",1,104,99,203
https://kawalpemilu.org#87276,"KOTA KARANG RAYA, TELUKBETUNG TIMUR, KOTA BANDAR LAMPUNG, LAMPUNG",2,84,104,188
https://kawalpemilu.org#87276,"KOTA KARANG RAYA, TELUKBETUNG TIMUR, KOTA BANDAR LAMPUNG, LAMPUNG",3,102,97,199
https://kawalpemilu.org#87276,"KOTA KARANG RAYA, TELUKBETUNG TIMUR, KOTA BANDAR LAMPUNG, LAMPUNG",4,105,113,218
https://kawalpemilu.org#87276,"KOTA KARANG RAYA, TELUKBETUNG TIMUR, KOTA BANDAR LAMPUNG, LAMPUNG",5,105,95,200
https://kawalpemilu.org#87276,"KOTA KARANG RAYA, TELUKBETUNG TIMUR, KOTA BANDAR LAMPUNG, LAMPUNG",6,133,95,228
https://kawalpemilu.org#87276,"KOTA KARANG RAYA, TELUKBETUNG TIMUR, KOTA BANDAR LAMPUNG, LAMPUNG",7,121,95,216
https://kawalpemilu.org#87276,"KOTA KARANG RAYA, TELUKBETUNG TIMUR, KOTA BANDAR LAMPUNG, LAMPUNG",8,103,72,175
https://kawalpemilu.org#87276,"KOTA KARANG RAYA, TELUKBETUNG TIMUR, KOTA BANDAR LAMPUNG, LAMPUNG",9,125,105,230
https://kawalpemilu.org#87276,"KOTA KARANG RAYA, TELUKBETUNG TIMUR, KOTA BANDAR LAMPUNG, LAMPUNG",10,89,107,196
https://kawalpemilu.org#87276,"KOTA KARANG RAYA, TELUKBETUNG TIMUR, KOTA BANDAR LAMPUNG, LAMPUNG",11,63,104,167
https://kawalpemilu.org#87276,"KOTA KARANG RAYA, TELUKBETUNG TIMUR, KOTA BANDAR LAMPUNG, LAMPUNG",12,91,151,242
https://kawalpemilu.org#87276,"KOTA KARANG RAYA, TELUKBETUNG TIMUR, KOTA BANDAR LAMPUNG, LAMPUNG",13,93,105,198
https://kawalpemilu.org#87276,"KOTA KARANG RAYA, TELUKBETUNG TIMUR, KOTA BANDAR LAMPUNG, LAMPUNG",14,110,93,203
https://kawalpemilu.org#87276,"KOTA KARANG RAYA, TELUKBETUNG TIMUR, KOTA BANDAR LAMPUNG, LAMPUNG",15,116,126,242
https://kawalpemilu.org#87276,"KOTA KARANG RAYA, TELUKBETUNG TIMUR, KOTA BANDAR LAMPUNG, LAMPUNG",16,101,87,188
https://kawalpemilu.org#87276,"KOTA KARANG RAYA, TELUKBETUNG TIMUR, KOTA BANDAR LAMPUNG, LAMPUNG",17,116,140,256
https://kawalpemilu.org#87277,"PERWATA, TELUKBETUNG TIMUR, KOTA BANDAR LAMPUNG, LAMPUNG",2,111,127,238
https://kawalpemilu.org#87277,"PERWATA, TELUKBETUNG TIMUR, KOTA BANDAR LAMPUNG, LAMPUNG",3,121,104,225
https://kawalpemilu.org#87277,"PERWATA, TELUKBETUNG TIMUR, KOTA BANDAR LAMPUNG, LAMPUNG",4,134,79,213
https://kawalpemilu.org#87277,"PERWATA, TELUKBETUNG TIMUR, KOTA BANDAR LAMPUNG, LAMPUNG",5,135,131,266
https://kawalpemilu.org#87277,"PERWATA, TELUKBETUNG TIMUR, KOTA BANDAR LAMPUNG, LAMPUNG",6,106,133,239
https://kawalpemilu.org#87277,"PERWATA, TELUKBETUNG TIMUR, KOTA BANDAR LAMPUNG, LAMPUNG",7,116,76,192
https://kawalpemilu.org#87277,"PERWATA, TELUKBETUNG TIMUR, KOTA BANDAR LAMPUNG, LAMPUNG",8,128,70,198
https://kawalpemilu.org#87277,"PERWATA, TELUKBETUNG TIMUR, KOTA BANDAR LAMPUNG, LAMPUNG",9,135,68,203
https://kawalpemilu.org#87277,"PERWATA, TELUKBETUNG TIMUR, KOTA BANDAR LAMPUNG, LAMPUNG",10,154,86,240
https://kawalpemilu.org#87277,"PERWATA, TELUKBETUNG TIMUR, KOTA BANDAR LAMPUNG, LAMPUNG",11,170,14,184
https://kawalpemilu.org#87277,"PERWATA, TELUKBETUNG TIMUR, KOTA BANDAR LAMPUNG, LAMPUNG",12,252,13,265
https://kawalpemilu.org#87278,"WAY TATAAN, TELUKBETUNG TIMUR, KOTA BANDAR LAMPUNG, LAMPUNG",1,105,102,207
https://kawalpemilu.org#87278,"WAY TATAAN, TELUKBETUNG TIMUR, KOTA BANDAR LAMPUNG, LAMPUNG",2,141,67,208
https://kawalpemilu.org#87278,"WAY TATAAN, TELUKBETUNG TIMUR, KOTA BANDAR LAMPUNG, LAMPUNG",4,85,77,162
https://kawalpemilu.org#87278,"WAY TATAAN, TELUKBETUNG TIMUR, KOTA BANDAR LAMPUNG, LAMPUNG",5,89,119,208
https://kawalpemilu.org#87278,"WAY TATAAN, TELUKBETUNG TIMUR, KOTA BANDAR LAMPUNG, LAMPUNG",7,108,69,177
https://kawalpemilu.org#87278,"WAY TATAAN, TELUKBETUNG TIMUR, KOTA BANDAR LAMPUNG, LAMPUNG",8,137,33,170
https://kawalpemilu.org#24767,"KANGKUNG, BUMI WARAS, KOTA BANDAR LAMPUNG, LAMPUNG",1,103,72,175
https://kawalpemilu.org#24767,"KANGKUNG, BUMI WARAS, KOTA BANDAR LAMPUNG, LAMPUNG",2,90,40,130
https://kawalpemilu.org#24767,"KANGKUNG, BUMI WARAS, KOTA BANDAR LAMPUNG, LAMPUNG",3,76,57,131
https://kawalpemilu.org#24767,"KANGKUNG, BUMI WARAS, KOTA BANDAR LAMPUNG, LAMPUNG",4,94,6,100
https://kawalpemilu.org#24767,"KANGKUNG, BUMI WARAS, KOTA BANDAR LAMPUNG, LAMPUNG",5,57,109,166
https://kawalpemilu.org#24767,"KANGKUNG, BUMI WARAS, KOTA BANDAR LAMPUNG, LAMPUNG",6,77,115,192
https://kawalpemilu.org#24767,"KANGKUNG, BUMI WARAS, KOTA BANDAR LAMPUNG, LAMPUNG",7,126,99,225
https://kawalpemilu.org#24767,"KANGKUNG, BUMI WARAS, KOTA BANDAR LAMPUNG, LAMPUNG",8,130,65,195
https://kawalpemilu.org#24767,"KANGKUNG, BUMI WARAS, KOTA BANDAR LAMPUNG, LAMPUNG",9,107,68,175
https://kawalpemilu.org#24767,"KANGKUNG, BUMI WARAS, KOTA BANDAR LAMPUNG, LAMPUNG",10,158,104,262
https://kawalpemilu.org#24767,"KANGKUNG, BUMI WARAS, KOTA BANDAR LAMPUNG, LAMPUNG",11,114,100,214
https://kawalpemilu.org#24767,"KANGKUNG, BUMI WARAS, KOTA BANDAR LAMPUNG, LAMPUNG",12,103,87,190
https://kawalpemilu.org#24767,"KANGKUNG, BUMI WARAS, KOTA BANDAR LAMPUNG, LAMPUNG",13,109,93,202
https://kawalpemilu.org#24767,"KANGKUNG, BUMI WARAS, KOTA BANDAR LAMPUNG, LAMPUNG",14,90,105,195
https://kawalpemilu.org#24767,"KANGKUNG, BUMI WARAS, KOTA BANDAR LAMPUNG, LAMPUNG",15,125,79,204
https://kawalpemilu.org#24767,"KANGKUNG, BUMI WARAS, KOTA BANDAR LAMPUNG, LAMPUNG",16,127,105,232
https://kawalpemilu.org#24767,"KANGKUNG, BUMI WARAS, KOTA BANDAR LAMPUNG, LAMPUNG",17,99,76,175
https://kawalpemilu.org#24767,"KANGKUNG, BUMI WARAS, KOTA BANDAR LAMPUNG, LAMPUNG",18,92,99,191
https://kawalpemilu.org#24767,"KANGKUNG, BUMI WARAS, KOTA BANDAR LAMPUNG, LAMPUNG",19,125,92,217
https://kawalpemilu.org#24767,"KANGKUNG, BUMI WARAS, KOTA BANDAR LAMPUNG, LAMPUNG",20,143,49,192
https://kawalpemilu.org#24767,"KANGKUNG, BUMI WARAS, KOTA BANDAR LAMPUNG, LAMPUNG",21,150,41,191
https://kawalpemilu.org#24767,"KANGKUNG, BUMI WARAS, KOTA BANDAR LAMPUNG, LAMPUNG",22,155,65,220
https://kawalpemilu.org#24767,"KANGKUNG, BUMI WARAS, KOTA BANDAR LAMPUNG, LAMPUNG",23,154,47,201
https://kawalpemilu.org#24767,"KANGKUNG, BUMI WARAS, KOTA BANDAR LAMPUNG, LAMPUNG",24,198,23,221
https://kawalpemilu.org#24767,"KANGKUNG, BUMI WARAS, KOTA BANDAR LAMPUNG, LAMPUNG",25,157,81,238
https://kawalpemilu.org#24767,"KANGKUNG, BUMI WARAS, KOTA BANDAR LAMPUNG, LAMPUNG",26,128,55,183
https://kawalpemilu.org#24767,"KANGKUNG, BUMI WARAS, KOTA BANDAR LAMPUNG, LAMPUNG",27,166,55,221
https://kawalpemilu.org#24767,"KANGKUNG, BUMI WARAS, KOTA BANDAR LAMPUNG, LAMPUNG",28,177,24,201
https://kawalpemilu.org#24767,"KANGKUNG, BUMI WARAS, KOTA BANDAR LAMPUNG, LAMPUNG",29,172,32,204
https://kawalpemilu.org#24767,"KANGKUNG, BUMI WARAS, KOTA BANDAR LAMPUNG, LAMPUNG",30,137,34,171
https://kawalpemilu.org#24767,"KANGKUNG, BUMI WARAS, KOTA BANDAR LAMPUNG, LAMPUNG",31,122,45,167
https://kawalpemilu.org#24767,"KANGKUNG, BUMI WARAS, KOTA BANDAR LAMPUNG, LAMPUNG",32,109,50,159
https://kawalpemilu.org#24767,"KANGKUNG, BUMI WARAS, KOTA BANDAR LAMPUNG, LAMPUNG",33,94,57,151
https://kawalpemilu.org#24767,"KANGKUNG, BUMI WARAS, KOTA BANDAR LAMPUNG, LAMPUNG",34,125,55,180
https://kawalpemilu.org#24767,"KANGKUNG, BUMI WARAS, KOTA BANDAR LAMPUNG, LAMPUNG",35,117,57,174
https://kawalpemilu.org#24767,"KANGKUNG, BUMI WARAS, KOTA BANDAR LAMPUNG, LAMPUNG",36,85,55,140
https://kawalpemilu.org#24767,"KANGKUNG, BUMI WARAS, KOTA BANDAR LAMPUNG, LAMPUNG",37,132,55,187
https://kawalpemilu.org#24767,"KANGKUNG, BUMI WARAS, KOTA BANDAR LAMPUNG, LAMPUNG",38,122,56,178
https://kawalpemilu.org#24767,"KANGKUNG, BUMI WARAS, KOTA BANDAR LAMPUNG, LAMPUNG",39,142,27,169
https://kawalpemilu.org#24767,"KANGKUNG, BUMI WARAS, KOTA BANDAR LAMPUNG, LAMPUNG",40,173,30,203
https://kawalpemilu.org#24768,"BUMI WARAS, BUMI WARAS, KOTA BANDAR LAMPUNG, LAMPUNG",1,154,76,230
https://kawalpemilu.org#24768,"BUMI WARAS, BUMI WARAS, KOTA BANDAR LAMPUNG, LAMPUNG",2,179,76,255
https://kawalpemilu.org#24768,"BUMI WARAS, BUMI WARAS, KOTA BANDAR LAMPUNG, LAMPUNG",3,112,151,263
https://kawalpemilu.org#24768,"BUMI WARAS, BUMI WARAS, KOTA BANDAR LAMPUNG, LAMPUNG",4,116,126,242
https://kawalpemilu.org#24768,"BUMI WARAS, BUMI WARAS, KOTA BANDAR LAMPUNG, LAMPUNG",5,80,82,162
https://kawalpemilu.org#24768,"BUMI WARAS, BUMI WARAS, KOTA BANDAR LAMPUNG, LAMPUNG",6,136,50,186
https://kawalpemilu.org#24768,"BUMI WARAS, BUMI WARAS, KOTA BANDAR LAMPUNG, LAMPUNG",7,141,32,173
https://kawalpemilu.org#24768,"BUMI WARAS, BUMI WARAS, KOTA BANDAR LAMPUNG, LAMPUNG",8,108,59,167
https://kawalpemilu.org#24768,"BUMI WARAS, BUMI WARAS, KOTA BANDAR LAMPUNG, LAMPUNG",10,134,82,216
https://kawalpemilu.org#24768,"BUMI WARAS, BUMI WARAS, KOTA BANDAR LAMPUNG, LAMPUNG",11,149,83,232
https://kawalpemilu.org#24768,"BUMI WARAS, BUMI WARAS, KOTA BANDAR LAMPUNG, LAMPUNG",12,205,51,256
https://kawalpemilu.org#24768,"BUMI WARAS, BUMI WARAS, KOTA BANDAR LAMPUNG, LAMPUNG",13,136,117,253
https://kawalpemilu.org#24768,"BUMI WARAS, BUMI WARAS, KOTA BANDAR LAMPUNG, LAMPUNG",14,161,78,239
https://kawalpemilu.org#24768,"BUMI WARAS, BUMI WARAS, KOTA BANDAR LAMPUNG, LAMPUNG",15,159,22,181
https://kawalpemilu.org#24768,"BUMI WARAS, BUMI WARAS, KOTA BANDAR LAMPUNG, LAMPUNG",16,94,61,155
https://kawalpemilu.org#24768,"BUMI WARAS, BUMI WARAS, KOTA BANDAR LAMPUNG, LAMPUNG",17,151,63,214
https://kawalpemilu.org#24768,"BUMI WARAS, BUMI WARAS, KOTA BANDAR LAMPUNG, LAMPUNG",18,167,65,232
https://kawalpemilu.org#24768,"BUMI WARAS, BUMI WARAS, KOTA BANDAR LAMPUNG, LAMPUNG",19,115,39,154
https://kawalpemilu.org#24768,"BUMI WARAS, BUMI WARAS, KOTA BANDAR LAMPUNG, LAMPUNG",20,171,48,219
https://kawalpemilu.org#24768,"BUMI WARAS, BUMI WARAS, KOTA BANDAR LAMPUNG, LAMPUNG",21,153,47,200
https://kawalpemilu.org#24768,"BUMI WARAS, BUMI WARAS, KOTA BANDAR LAMPUNG, LAMPUNG",22,73,62,135
https://kawalpemilu.org#24768,"BUMI WARAS, BUMI WARAS, KOTA BANDAR LAMPUNG, LAMPUNG",23,53,45,98
https://kawalpemilu.org#24768,"BUMI WARAS, BUMI WARAS, KOTA BANDAR LAMPUNG, LAMPUNG",25,178,74,252
https://kawalpemilu.org#24768,"BUMI WARAS, BUMI WARAS, KOTA BANDAR LAMPUNG, LAMPUNG",26,172,59,231
https://kawalpemilu.org#24768,"BUMI WARAS, BUMI WARAS, KOTA BANDAR LAMPUNG, LAMPUNG",27,90,126,216
https://kawalpemilu.org#24768,"BUMI WARAS, BUMI WARAS, KOTA BANDAR LAMPUNG, LAMPUNG",28,128,109,237
https://kawalpemilu.org#24768,"BUMI WARAS, BUMI WARAS, KOTA BANDAR LAMPUNG, LAMPUNG",29,137,106,243
https://kawalpemilu.org#24768,"BUMI WARAS, BUMI WARAS, KOTA BANDAR LAMPUNG, LAMPUNG",30,116,133,249
https://kawalpemilu.org#24768,"BUMI WARAS, BUMI WARAS, KOTA BANDAR LAMPUNG, LAMPUNG",31,84,89,173
https://kawalpemilu.org#24768,"BUMI WARAS, BUMI WARAS, KOTA BANDAR LAMPUNG, LAMPUNG",32,64,109,173
https://kawalpemilu.org#24768,"BUMI WARAS, BUMI WARAS, KOTA BANDAR LAMPUNG, LAMPUNG",33,180,70,250
https://kawalpemilu.org#24768,"BUMI WARAS, BUMI WARAS, KOTA BANDAR LAMPUNG, LAMPUNG",34,157,36,193
https://kawalpemilu.org#24768,"BUMI WARAS, BUMI WARAS, KOTA BANDAR LAMPUNG, LAMPUNG",35,133,22,155
https://kawalpemilu.org#24768,"BUMI WARAS, BUMI WARAS, KOTA BANDAR LAMPUNG, LAMPUNG",36,117,110,227
https://kawalpemilu.org#24768,"BUMI WARAS, BUMI WARAS, KOTA BANDAR LAMPUNG, LAMPUNG",37,181,75,256
https://kawalpemilu.org#24768,"BUMI WARAS, BUMI WARAS, KOTA BANDAR LAMPUNG, LAMPUNG",38,203,54,257
https://kawalpemilu.org#24768,"BUMI WARAS, BUMI WARAS, KOTA BANDAR LAMPUNG, LAMPUNG",39,144,60,204
https://kawalpemilu.org#24768,"BUMI WARAS, BUMI WARAS, KOTA BANDAR LAMPUNG, LAMPUNG",40,107,53,160
https://kawalpemilu.org#24768,"BUMI WARAS, BUMI WARAS, KOTA BANDAR LAMPUNG, LAMPUNG",41,157,82,239
https://kawalpemilu.org#24768,"BUMI WARAS, BUMI WARAS, KOTA BANDAR LAMPUNG, LAMPUNG",42,161,22,183
https://kawalpemilu.org#24769,"SUKARAJA, BUMI WARAS, KOTA BANDAR LAMPUNG, LAMPUNG",1,161,57,218
https://kawalpemilu.org#24769,"SUKARAJA, BUMI WARAS, KOTA BANDAR LAMPUNG, LAMPUNG",2,125,58,183
https://kawalpemilu.org#24769,"SUKARAJA, BUMI WARAS, KOTA BANDAR LAMPUNG, LAMPUNG",3,112,70,182
https://kawalpemilu.org#24769,"SUKARAJA, BUMI WARAS, KOTA BANDAR LAMPUNG, LAMPUNG",4,128,70,198
https://kawalpemilu.org#24769,"SUKARAJA, BUMI WARAS, KOTA BANDAR LAMPUNG, LAMPUNG",5,131,72,203
https://kawalpemilu.org#24769,"SUKARAJA, BUMI WARAS, KOTA BANDAR LAMPUNG, LAMPUNG",6,128,76,204
https://kawalpemilu.org#24769,"SUKARAJA, BUMI WARAS, KOTA BANDAR LAMPUNG, LAMPUNG",7,128,73,201
https://kawalpemilu.org#24769,"SUKARAJA, BUMI WARAS, KOTA BANDAR LAMPUNG, LAMPUNG",8,119,97,216
https://kawalpemilu.org#24769,"SUKARAJA, BUMI WARAS, KOTA BANDAR LAMPUNG, LAMPUNG",9,122,37,159
https://kawalpemilu.org#24769,"SUKARAJA, BUMI WARAS, KOTA BANDAR LAMPUNG, LAMPUNG",10,118,68,186
https://kawalpemilu.org#24769,"SUKARAJA, BUMI WARAS, KOTA BANDAR LAMPUNG, LAMPUNG",11,105,48,153
https://kawalpemilu.org#24769,"SUKARAJA, BUMI WARAS, KOTA BANDAR LAMPUNG, LAMPUNG",12,160,63,223
https://kawalpemilu.org#24769,"SUKARAJA, BUMI WARAS, KOTA BANDAR LAMPUNG, LAMPUNG",13,127,40,167
https://kawalpemilu.org#24769,"SUKARAJA, BUMI WARAS, KOTA BANDAR LAMPUNG, LAMPUNG",14,150,45,195
https://kawalpemilu.org#24769,"SUKARAJA, BUMI WARAS, KOTA BANDAR LAMPUNG, LAMPUNG",15,145,82,227
https://kawalpemilu.org#24769,"SUKARAJA, BUMI WARAS, KOTA BANDAR LAMPUNG, LAMPUNG",16,88,52,140
https://kawalpemilu.org#24769,"SUKARAJA, BUMI WARAS, KOTA BANDAR LAMPUNG, LAMPUNG",17,107,36,143
https://kawalpemilu.org#24769,"SUKARAJA, BUMI WARAS, KOTA BANDAR LAMPUNG, LAMPUNG",18,109,74,183
https://kawalpemilu.org#24769,"SUKARAJA, BUMI WARAS, KOTA BANDAR LAMPUNG, LAMPUNG",19,97,81,178
https://kawalpemilu.org#24769,"SUKARAJA, BUMI WARAS, KOTA BANDAR LAMPUNG, LAMPUNG",20,122,58,180
https://kawalpemilu.org#24769,"SUKARAJA, BUMI WARAS, KOTA BANDAR LAMPUNG, LAMPUNG",21,147,50,197
https://kawalpemilu.org#24769,"SUKARAJA, BUMI WARAS, KOTA BANDAR LAMPUNG, LAMPUNG",22,167,39,206
https://kawalpemilu.org#24769,"SUKARAJA, BUMI WARAS, KOTA BANDAR LAMPUNG, LAMPUNG",23,147,46,193
https://kawalpemilu.org#24769,"SUKARAJA, BUMI WARAS, KOTA BANDAR LAMPUNG, LAMPUNG",24,149,75,224
https://kawalpemilu.org#24769,"SUKARAJA, BUMI WARAS, KOTA BANDAR LAMPUNG, LAMPUNG",25,147,39,186
https://kawalpemilu.org#24769,"SUKARAJA, BUMI WARAS, KOTA BANDAR LAMPUNG, LAMPUNG",26,106,57,163
https://kawalpemilu.org#24769,"SUKARAJA, BUMI WARAS, KOTA BANDAR LAMPUNG, LAMPUNG",27,133,39,172
https://kawalpemilu.org#24769,"SUKARAJA, BUMI WARAS, KOTA BANDAR LAMPUNG, LAMPUNG",28,137,32,169
https://kawalpemilu.org#24769,"SUKARAJA, BUMI WARAS, KOTA BANDAR LAMPUNG, LAMPUNG",29,184,20,204
https://kawalpemilu.org#24769,"SUKARAJA, BUMI WARAS, KOTA BANDAR LAMPUNG, LAMPUNG",30,164,53,217
https://kawalpemilu.org#24769,"SUKARAJA, BUMI WARAS, KOTA BANDAR LAMPUNG, LAMPUNG",31,108,50,158
https://kawalpemilu.org#24769,"SUKARAJA, BUMI WARAS, KOTA BANDAR LAMPUNG, LAMPUNG",32,83,66,149
https://kawalpemilu.org#24770,"GARUNTANG, BUMI WARAS, KOTA BANDAR LAMPUNG, LAMPUNG",1,156,44,200
https://kawalpemilu.org#24770,"GARUNTANG, BUMI WARAS, KOTA BANDAR LAMPUNG, LAMPUNG",2,145,51,196
https://kawalpemilu.org#24770,"GARUNTANG, BUMI WARAS, KOTA BANDAR LAMPUNG, LAMPUNG",3,90,128,218
https://kawalpemilu.org#24770,"GARUNTANG, BUMI WARAS, KOTA BANDAR LAMPUNG, LAMPUNG",4,63,65,128
https://kawalpemilu.org#24770,"GARUNTANG, BUMI WARAS, KOTA BANDAR LAMPUNG, LAMPUNG",5,91,82,173
https://kawalpemilu.org#24770,"GARUNTANG, BUMI WARAS, KOTA BANDAR LAMPUNG, LAMPUNG",6,85,57,142
https://kawalpemilu.org#24770,"GARUNTANG, BUMI WARAS, KOTA BANDAR LAMPUNG, LAMPUNG",7,90,91,181
https://kawalpemilu.org#24770,"GARUNTANG, BUMI WARAS, KOTA BANDAR LAMPUNG, LAMPUNG",8,59,102,161
https://kawalpemilu.org#24770,"GARUNTANG, BUMI WARAS, KOTA BANDAR LAMPUNG, LAMPUNG",9,99,114,213
https://kawalpemilu.org#24770,"GARUNTANG, BUMI WARAS, KOTA BANDAR LAMPUNG, LAMPUNG",10,106,53,159
https://kawalpemilu.org#24770,"GARUNTANG, BUMI WARAS, KOTA BANDAR LAMPUNG, LAMPUNG",11,151,100,251
https://kawalpemilu.org#24770,"GARUNTANG, BUMI WARAS, KOTA BANDAR LAMPUNG, LAMPUNG",12,119,59,178
https://kawalpemilu.org#24770,"GARUNTANG, BUMI WARAS, KOTA BANDAR LAMPUNG, LAMPUNG",13,148,49,197
https://kawalpemilu.org#24770,"GARUNTANG, BUMI WARAS, KOTA BANDAR LAMPUNG, LAMPUNG",14,108,66,174
https://kawalpemilu.org#24770,"GARUNTANG, BUMI WARAS, KOTA BANDAR LAMPUNG, LAMPUNG",15,80,86,166
https://kawalpemilu.org#24770,"GARUNTANG, BUMI WARAS, KOTA BANDAR LAMPUNG, LAMPUNG",16,102,99,201
https://kawalpemilu.org#24770,"GARUNTANG, BUMI WARAS, KOTA BANDAR LAMPUNG, LAMPUNG",17,86,98,184
https://kawalpemilu.org#24770,"GARUNTANG, BUMI WARAS, KOTA BANDAR LAMPUNG, LAMPUNG",18,126,86,212
https://kawalpemilu.org#24770,"GARUNTANG, BUMI WARAS, KOTA BANDAR LAMPUNG, LAMPUNG",19,175,81,256
https://kawalpemilu.org#24770,"GARUNTANG, BUMI WARAS, KOTA BANDAR LAMPUNG, LAMPUNG",20,127,72,199
https://kawalpemilu.org#24770,"GARUNTANG, BUMI WARAS, KOTA BANDAR LAMPUNG, LAMPUNG",21,145,105,250
https://kawalpemilu.org#24770,"GARUNTANG, BUMI WARAS, KOTA BANDAR LAMPUNG, LAMPUNG",22,110,62,172
https://kawalpemilu.org#24770,"GARUNTANG, BUMI WARAS, KOTA BANDAR LAMPUNG, LAMPUNG",23,112,72,184
https://kawalpemilu.org#24770,"GARUNTANG, BUMI WARAS, KOTA BANDAR LAMPUNG, LAMPUNG",24,96,118,214
https://kawalpemilu.org#24770,"GARUNTANG, BUMI WARAS, KOTA BANDAR LAMPUNG, LAMPUNG",25,140,72,212
https://kawalpemilu.org#24770,"GARUNTANG, BUMI WARAS, KOTA BANDAR LAMPUNG, LAMPUNG",26,71,51,122
https://kawalpemilu.org#92007,"BUMI RAYA, BUMI WARAS, KOTA BANDAR LAMPUNG, LAMPUNG",1,148,85,233
https://kawalpemilu.org#92007,"BUMI RAYA, BUMI WARAS, KOTA BANDAR LAMPUNG, LAMPUNG",2,135,77,212
https://kawalpemilu.org#92007,"BUMI RAYA, BUMI WARAS, KOTA BANDAR LAMPUNG, LAMPUNG",3,107,79,186
https://kawalpemilu.org#92007,"BUMI RAYA, BUMI WARAS, KOTA BANDAR LAMPUNG, LAMPUNG",4,126,62,188
https://kawalpemilu.org#92007,"BUMI RAYA, BUMI WARAS, KOTA BANDAR LAMPUNG, LAMPUNG",5,117,76,193
https://kawalpemilu.org#92007,"BUMI RAYA, BUMI WARAS, KOTA BANDAR LAMPUNG, LAMPUNG",6,171,15,186
https://kawalpemilu.org#92007,"BUMI RAYA, BUMI WARAS, KOTA BANDAR LAMPUNG, LAMPUNG",7,118,5,123
https://kawalpemilu.org#92007,"BUMI RAYA, BUMI WARAS, KOTA BANDAR LAMPUNG, LAMPUNG",8,152,40,192
https://kawalpemilu.org#92007,"BUMI RAYA, BUMI WARAS, KOTA BANDAR LAMPUNG, LAMPUNG",9,110,56,166
https://kawalpemilu.org#92007,"BUMI RAYA, BUMI WARAS, KOTA BANDAR LAMPUNG, LAMPUNG",10,197,16,213
https://kawalpemilu.org#92007,"BUMI RAYA, BUMI WARAS, KOTA BANDAR LAMPUNG, LAMPUNG",11,97,102,199
https://kawalpemilu.org#92007,"BUMI RAYA, BUMI WARAS, KOTA BANDAR LAMPUNG, LAMPUNG",12,100,88,188
https://kawalpemilu.org#92007,"BUMI RAYA, BUMI WARAS, KOTA BANDAR LAMPUNG, LAMPUNG",13,80,97,177
https://kawalpemilu.org#92007,"BUMI RAYA, BUMI WARAS, KOTA BANDAR LAMPUNG, LAMPUNG",14,52,87,139
https://kawalpemilu.org#92007,"BUMI RAYA, BUMI WARAS, KOTA BANDAR LAMPUNG, LAMPUNG",15,117,92,209
https://kawalpemilu.org#92007,"BUMI RAYA, BUMI WARAS, KOTA BANDAR LAMPUNG, LAMPUNG",16,132,90,222
https://kawalpemilu.org#92007,"BUMI RAYA, BUMI WARAS, KOTA BANDAR LAMPUNG, LAMPUNG",17,113,55,168
https://kawalpemilu.org#92007,"BUMI RAYA, BUMI WARAS, KOTA BANDAR LAMPUNG, LAMPUNG",18,87,59,146
https://kawalpemilu.org#92007,"BUMI RAYA, BUMI WARAS, KOTA BANDAR LAMPUNG, LAMPUNG",19,129,87,216
https://kawalpemilu.org#24824,"METRO, METRO PUSAT, KOTA METRO, LAMPUNG",1,126,93,219
https://kawalpemilu.org#24824,"METRO, METRO PUSAT, KOTA METRO, LAMPUNG",2,106,55,161
https://kawalpemilu.org#24824,"METRO, METRO PUSAT, KOTA METRO, LAMPUNG",3,94,93,187
https://kawalpemilu.org#24824,"METRO, METRO PUSAT, KOTA METRO, LAMPUNG",4,81,68,149
https://kawalpemilu.org#24824,"METRO, METRO PUSAT, KOTA METRO, LAMPUNG",5,164,48,212
https://kawalpemilu.org#24824,"METRO, METRO PUSAT, KOTA METRO, LAMPUNG",6,74,64,138
https://kawalpemilu.org#24824,"METRO, METRO PUSAT, KOTA METRO, LAMPUNG",7,73,73,146
https://kawalpemilu.org#24824,"METRO, METRO PUSAT, KOTA METRO, LAMPUNG",8,129,87,216
https://kawalpemilu.org#24824,"METRO, METRO PUSAT, KOTA METRO, LAMPUNG",9,46,40,86
https://kawalpemilu.org#24824,"METRO, METRO PUSAT, KOTA METRO, LAMPUNG",10,69,36,105
https://kawalpemilu.org#24824,"METRO, METRO PUSAT, KOTA METRO, LAMPUNG",11,76,117,193
https://kawalpemilu.org#24824,"METRO, METRO PUSAT, KOTA METRO, LAMPUNG",12,85,109,194
https://kawalpemilu.org#24824,"METRO, METRO PUSAT, KOTA METRO, LAMPUNG",13,95,89,184
https://kawalpemilu.org#24824,"METRO, METRO PUSAT, KOTA METRO, LAMPUNG",14,63,92,155
https://kawalpemilu.org#24824,"METRO, METRO PUSAT, KOTA METRO, LAMPUNG",15,48,65,113
https://kawalpemilu.org#24824,"METRO, METRO PUSAT, KOTA METRO, LAMPUNG",16,53,125,178
https://kawalpemilu.org#24824,"METRO, METRO PUSAT, KOTA METRO, LAMPUNG",17,54,91,145
https://kawalpemilu.org#24824,"METRO, METRO PUSAT, KOTA METRO, LAMPUNG",18,50,169,219
https://kawalpemilu.org#24824,"METRO, METRO PUSAT, KOTA METRO, LAMPUNG",19,61,160,221
https://kawalpemilu.org#24824,"METRO, METRO PUSAT, KOTA METRO, LAMPUNG",20,37,150,187
https://kawalpemilu.org#24824,"METRO, METRO PUSAT, KOTA METRO, LAMPUNG",21,66,152,218
https://kawalpemilu.org#24824,"METRO, METRO PUSAT, KOTA METRO, LAMPUNG",22,129,97,226
https://kawalpemilu.org#24824,"METRO, METRO PUSAT, KOTA METRO, LAMPUNG",23,126,100,226
https://kawalpemilu.org#24824,"METRO, METRO PUSAT, KOTA METRO, LAMPUNG",24,102,68,170
https://kawalpemilu.org#24824,"METRO, METRO PUSAT, KOTA METRO, LAMPUNG",25,76,70,146
https://kawalpemilu.org#24824,"METRO, METRO PUSAT, KOTA METRO, LAMPUNG",26,89,100,189
https://kawalpemilu.org#24824,"METRO, METRO PUSAT, KOTA METRO, LAMPUNG",27,66,108,174
https://kawalpemilu.org#24824,"METRO, METRO PUSAT, KOTA METRO, LAMPUNG",28,94,148,242
https://kawalpemilu.org#24824,"METRO, METRO PUSAT, KOTA METRO, LAMPUNG",29,66,117,183
https://kawalpemilu.org#24824,"METRO, METRO PUSAT, KOTA METRO, LAMPUNG",30,117,87,204
https://kawalpemilu.org#24824,"METRO, METRO PUSAT, KOTA METRO, LAMPUNG",31,128,83,211
https://kawalpemilu.org#24824,"METRO, METRO PUSAT, KOTA METRO, LAMPUNG",32,87,65,152
https://kawalpemilu.org#24824,"METRO, METRO PUSAT, KOTA METRO, LAMPUNG",33,167,48,215
https://kawalpemilu.org#24824,"METRO, METRO PUSAT, KOTA METRO, LAMPUNG",34,154,80,234
https://kawalpemilu.org#24824,"METRO, METRO PUSAT, KOTA METRO, LAMPUNG",35,147,104,251
https://kawalpemilu.org#24824,"METRO, METRO PUSAT, KOTA METRO, LAMPUNG",36,136,106,242
https://kawalpemilu.org#24824,"METRO, METRO PUSAT, KOTA METRO, LAMPUNG",37,89,73,162
https://kawalpemilu.org#24824,"METRO, METRO PUSAT, KOTA METRO, LAMPUNG",38,88,86,174
https://kawalpemilu.org#24824,"METRO, METRO PUSAT, KOTA METRO, LAMPUNG",39,78,68,146
https://kawalpemilu.org#24824,"METRO, METRO PUSAT, KOTA METRO, LAMPUNG",40,106,153,259
https://kawalpemilu.org#24824,"METRO, METRO PUSAT, KOTA METRO, LAMPUNG",42,106,116,222
https://kawalpemilu.org#24824,"METRO, METRO PUSAT, KOTA METRO, LAMPUNG",43,42,48,90
https://kawalpemilu.org#24824,"METRO, METRO PUSAT, KOTA METRO, LAMPUNG",44,63,98,161
https://kawalpemilu.org#24824,"METRO, METRO PUSAT, KOTA METRO, LAMPUNG",45,50,140,190
https://kawalpemilu.org#24825,"HADIMULYO TIMUR, METRO PUSAT, KOTA METRO, LAMPUNG",1,97,136,233
https://kawalpemilu.org#24825,"HADIMULYO TIMUR, METRO PUSAT, KOTA METRO, LAMPUNG",2,84,136,220
https://kawalpemilu.org#24825,"HADIMULYO TIMUR, METRO PUSAT, KOTA METRO, LAMPUNG",3,108,118,226
https://kawalpemilu.org#24825,"HADIMULYO TIMUR, METRO PUSAT, KOTA METRO, LAMPUNG",4,67,148,215
https://kawalpemilu.org#24825,"HADIMULYO TIMUR, METRO PUSAT, KOTA METRO, LAMPUNG",5,36,146,182
https://kawalpemilu.org#24825,"HADIMULYO TIMUR, METRO PUSAT, KOTA METRO, LAMPUNG",6,116,100,216
https://kawalpemilu.org#24825,"HADIMULYO TIMUR, METRO PUSAT, KOTA METRO, LAMPUNG",7,128,147,275
https://kawalpemilu.org#24825,"HADIMULYO TIMUR, METRO PUSAT, KOTA METRO, LAMPUNG",8,36,118,154
https://kawalpemilu.org#24825,"HADIMULYO TIMUR, METRO PUSAT, KOTA METRO, LAMPUNG",9,56,155,211
https://kawalpemilu.org#24825,"HADIMULYO TIMUR, METRO PUSAT, KOTA METRO, LAMPUNG",10,98,155,253
https://kawalpemilu.org#24825,"HADIMULYO TIMUR, METRO PUSAT, KOTA METRO, LAMPUNG",11,85,96,181
https://kawalpemilu.org#24825,"HADIMULYO TIMUR, METRO PUSAT, KOTA METRO, LAMPUNG",12,112,115,227
https://kawalpemilu.org#24825,"HADIMULYO TIMUR, METRO PUSAT, KOTA METRO, LAMPUNG",13,80,86,166
https://kawalpemilu.org#24825,"HADIMULYO TIMUR, METRO PUSAT, KOTA METRO, LAMPUNG",14,92,131,223
https://kawalpemilu.org#24825,"HADIMULYO TIMUR, METRO PUSAT, KOTA METRO, LAMPUNG",15,97,155,252
https://kawalpemilu.org#24825,"HADIMULYO TIMUR, METRO PUSAT, KOTA METRO, LAMPUNG",16,115,109,224
https://kawalpemilu.org#24825,"HADIMULYO TIMUR, METRO PUSAT, KOTA METRO, LAMPUNG",17,134,78,212
https://kawalpemilu.org#24825,"HADIMULYO TIMUR, METRO PUSAT, KOTA METRO, LAMPUNG",18,108,139,247
https://kawalpemilu.org#24825,"HADIMULYO TIMUR, METRO PUSAT, KOTA METRO, LAMPUNG",19,123,110,233
https://kawalpemilu.org#24825,"HADIMULYO TIMUR, METRO PUSAT, KOTA METRO, LAMPUNG",20,214,55,269
https://kawalpemilu.org#24825,"HADIMULYO TIMUR, METRO PUSAT, KOTA METRO, LAMPUNG",21,88,142,230
https://kawalpemilu.org#24825,"HADIMULYO TIMUR, METRO PUSAT, KOTA METRO, LAMPUNG",22,66,125,191
https://kawalpemilu.org#24825,"HADIMULYO TIMUR, METRO PUSAT, KOTA METRO, LAMPUNG",23,127,126,253
https://kawalpemilu.org#24825,"HADIMULYO TIMUR, METRO PUSAT, KOTA METRO, LAMPUNG",24,123,131,254
https://kawalpemilu.org#24825,"HADIMULYO TIMUR, METRO PUSAT, KOTA METRO, LAMPUNG",25,186,60,246
https://kawalpemilu.org#24825,"HADIMULYO TIMUR, METRO PUSAT, KOTA METRO, LAMPUNG",26,146,33,179
https://kawalpemilu.org#24826,"IMOPURO, METRO PUSAT, KOTA METRO, LAMPUNG",1,107,109,216
https://kawalpemilu.org#24826,"IMOPURO, METRO PUSAT, KOTA METRO, LAMPUNG",2,126,93,219
https://kawalpemilu.org#24826,"IMOPURO, METRO PUSAT, KOTA METRO, LAMPUNG",3,127,90,217
https://kawalpemilu.org#24826,"IMOPURO, METRO PUSAT, KOTA METRO, LAMPUNG",4,89,100,189
https://kawalpemilu.org#24826,"IMOPURO, METRO PUSAT, KOTA METRO, LAMPUNG",5,44,106,150
https://kawalpemilu.org#24826,"IMOPURO, METRO PUSAT, KOTA METRO, LAMPUNG",6,54,115,169
https://kawalpemilu.org#24826,"IMOPURO, METRO PUSAT, KOTA METRO, LAMPUNG",7,60,71,131
https://kawalpemilu.org#24826,"IMOPURO, METRO PUSAT, KOTA METRO, LAMPUNG",8,86,44,130
https://kawalpemilu.org#24826,"IMOPURO, METRO PUSAT, KOTA METRO, LAMPUNG",9,106,104,210
https://kawalpemilu.org#24826,"IMOPURO, METRO PUSAT, KOTA METRO, LAMPUNG",10,56,109,165
https://kawalpemilu.org#24826,"IMOPURO, METRO PUSAT, KOTA METRO, LAMPUNG",11,71,71,142
https://kawalpemilu.org#24826,"IMOPURO, METRO PUSAT, KOTA METRO, LAMPUNG",12,66,75,141
https://kawalpemilu.org#24826,"IMOPURO, METRO PUSAT, KOTA METRO, LAMPUNG",13,65,97,162
https://kawalpemilu.org#24826,"IMOPURO, METRO PUSAT, KOTA METRO, LAMPUNG",14,50,91,141
https://kawalpemilu.org#24826,"IMOPURO, METRO PUSAT, KOTA METRO, LAMPUNG",15,62,117,179
https://kawalpemilu.org#24826,"IMOPURO, METRO PUSAT, KOTA METRO, LAMPUNG",16,68,141,209
https://kawalpemilu.org#24826,"IMOPURO, METRO PUSAT, KOTA METRO, LAMPUNG",17,102,114,216
https://kawalpemilu.org#24826,"IMOPURO, METRO PUSAT, KOTA METRO, LAMPUNG",18,102,85,187
https://kawalpemilu.org#24826,"IMOPURO, METRO PUSAT, KOTA METRO, LAMPUNG",19,164,53,217
https://kawalpemilu.org#24826,"IMOPURO, METRO PUSAT, KOTA METRO, LAMPUNG",20,122,102,224
https://kawalpemilu.org#24826,"IMOPURO, METRO PUSAT, KOTA METRO, LAMPUNG",21,44,91,135
https://kawalpemilu.org#24826,"IMOPURO, METRO PUSAT, KOTA METRO, LAMPUNG",22,56,63,119
https://kawalpemilu.org#24827,"HADIMULYO BARAT, METRO PUSAT, KOTA METRO, LAMPUNG",1,96,89,185
https://kawalpemilu.org#24827,"HADIMULYO BARAT, METRO PUSAT, KOTA METRO, LAMPUNG",2,102,103,205
https://kawalpemilu.org#24827,"HADIMULYO BARAT, METRO PUSAT, KOTA METRO, LAMPUNG",3,85,164,249
https://kawalpemilu.org#24827,"HADIMULYO BARAT, METRO PUSAT, KOTA METRO, LAMPUNG",4,89,146,235
https://kawalpemilu.org#24827,"HADIMULYO BARAT, METRO PUSAT, KOTA METRO, LAMPUNG",5,94,123,217
https://kawalpemilu.org#24827,"HADIMULYO BARAT, METRO PUSAT, KOTA METRO, LAMPUNG",6,83,126,209
https://kawalpemilu.org#24827,"HADIMULYO BARAT, METRO PUSAT, KOTA METRO, LAMPUNG",7,71,129,200
https://kawalpemilu.org#24827,"HADIMULYO BARAT, METRO PUSAT, KOTA METRO, LAMPUNG",8,80,141,221
https://kawalpemilu.org#24827,"HADIMULYO BARAT, METRO PUSAT, KOTA METRO, LAMPUNG",9,92,127,219
https://kawalpemilu.org#24827,"HADIMULYO BARAT, METRO PUSAT, KOTA METRO, LAMPUNG",10,116,88,204
https://kawalpemilu.org#24827,"HADIMULYO BARAT, METRO PUSAT, KOTA METRO, LAMPUNG",11,113,51,164
https://kawalpemilu.org#24827,"HADIMULYO BARAT, METRO PUSAT, KOTA METRO, LAMPUNG",12,127,62,189
https://kawalpemilu.org#24827,"HADIMULYO BARAT, METRO PUSAT, KOTA METRO, LAMPUNG",13,40,107,147
https://kawalpemilu.org#24827,"HADIMULYO BARAT, METRO PUSAT, KOTA METRO, LAMPUNG",14,28,148,176
https://kawalpemilu.org#24827,"HADIMULYO BARAT, METRO PUSAT, KOTA METRO, LAMPUNG",15,37,204,241
https://kawalpemilu.org#24827,"HADIMULYO BARAT, METRO PUSAT, KOTA METRO, LAMPUNG",16,48,124,172
https://kawalpemilu.org#24827,"HADIMULYO BARAT, METRO PUSAT, KOTA METRO, LAMPUNG",17,60,119,179
https://kawalpemilu.org#24827,"HADIMULYO BARAT, METRO PUSAT, KOTA METRO, LAMPUNG",18,52,72,124
https://kawalpemilu.org#24827,"HADIMULYO BARAT, METRO PUSAT, KOTA METRO, LAMPUNG",19,69,68,137
https://kawalpemilu.org#24827,"HADIMULYO BARAT, METRO PUSAT, KOTA METRO, LAMPUNG",20,57,140,197
https://kawalpemilu.org#24827,"HADIMULYO BARAT, METRO PUSAT, KOTA METRO, LAMPUNG",21,66,119,185
https://kawalpemilu.org#24827,"HADIMULYO BARAT, METRO PUSAT, KOTA METRO, LAMPUNG",22,49,118,167
https://kawalpemilu.org#24827,"HADIMULYO BARAT, METRO PUSAT, KOTA METRO, LAMPUNG",23,55,83,138
https://kawalpemilu.org#24827,"HADIMULYO BARAT, METRO PUSAT, KOTA METRO, LAMPUNG",24,106,107,213
https://kawalpemilu.org#24827,"HADIMULYO BARAT, METRO PUSAT, KOTA METRO, LAMPUNG",25,79,110,189
https://kawalpemilu.org#24827,"HADIMULYO BARAT, METRO PUSAT, KOTA METRO, LAMPUNG",26,85,78,163
https://kawalpemilu.org#24827,"HADIMULYO BARAT, METRO PUSAT, KOTA METRO, LAMPUNG",27,74,75,149
https://kawalpemilu.org#24827,"HADIMULYO BARAT, METRO PUSAT, KOTA METRO, LAMPUNG",28,68,90,158
https://kawalpemilu.org#24827,"HADIMULYO BARAT, METRO PUSAT, KOTA METRO, LAMPUNG",29,69,68,137
https://kawalpemilu.org#24827,"HADIMULYO BARAT, METRO PUSAT, KOTA METRO, LAMPUNG",30,79,63,142
https://kawalpemilu.org#24827,"HADIMULYO BARAT, METRO PUSAT, KOTA METRO, LAMPUNG",31,90,96,186
https://kawalpemilu.org#24827,"HADIMULYO BARAT, METRO PUSAT, KOTA METRO, LAMPUNG",32,83,86,169
https://kawalpemilu.org#24827,"HADIMULYO BARAT, METRO PUSAT, KOTA METRO, LAMPUNG",33,101,62,163
https://kawalpemilu.org#24827,"HADIMULYO BARAT, METRO PUSAT, KOTA METRO, LAMPUNG",34,118,121,239
https://kawalpemilu.org#24827,"HADIMULYO BARAT, METRO PUSAT, KOTA METRO, LAMPUNG",35,124,103,227
https://kawalpemilu.org#24827,"HADIMULYO BARAT, METRO PUSAT, KOTA METRO, LAMPUNG",36,74,85,159
https://kawalpemilu.org#24827,"HADIMULYO BARAT, METRO PUSAT, KOTA METRO, LAMPUNG",37,86,65,151
https://kawalpemilu.org#24827,"HADIMULYO BARAT, METRO PUSAT, KOTA METRO, LAMPUNG",38,84,76,160
https://kawalpemilu.org#24827,"HADIMULYO BARAT, METRO PUSAT, KOTA METRO, LAMPUNG",39,59,100,159
https://kawalpemilu.org#24827,"HADIMULYO BARAT, METRO PUSAT, KOTA METRO, LAMPUNG",40,83,85,168
https://kawalpemilu.org#24827,"HADIMULYO BARAT, METRO PUSAT, KOTA METRO, LAMPUNG",41,52,94,146
https://kawalpemilu.org#24827,"HADIMULYO BARAT, METRO PUSAT, KOTA METRO, LAMPUNG",42,51,97,148
https://kawalpemilu.org#24827,"HADIMULYO BARAT, METRO PUSAT, KOTA METRO, LAMPUNG",43,79,74,153
https://kawalpemilu.org#24828,"YOSOMULYO, METRO PUSAT, KOTA METRO, LAMPUNG",1,105,74,179
https://kawalpemilu.org#24828,"YOSOMULYO, METRO PUSAT, KOTA METRO, LAMPUNG",2,142,55,197
https://kawalpemilu.org#24828,"YOSOMULYO, METRO PUSAT, KOTA METRO, LAMPUNG",3,81,59,140
https://kawalpemilu.org#24828,"YOSOMULYO, METRO PUSAT, KOTA METRO, LAMPUNG",4,109,132,241
https://kawalpemilu.org#24828,"YOSOMULYO, METRO PUSAT, KOTA METRO, LAMPUNG",5,109,105,214
https://kawalpemilu.org#24828,"YOSOMULYO, METRO PUSAT, KOTA METRO, LAMPUNG",6,76,60,136
https://kawalpemilu.org#24828,"YOSOMULYO, METRO PUSAT, KOTA METRO, LAMPUNG",7,134,66,200
https://kawalpemilu.org#24828,"YOSOMULYO, METRO PUSAT, KOTA METRO, LAMPUNG",8,126,85,211
https://kawalpemilu.org#24828,"YOSOMULYO, METRO PUSAT, KOTA METRO, LAMPUNG",9,85,86,171
https://kawalpemilu.org#24828,"YOSOMULYO, METRO PUSAT, KOTA METRO, LAMPUNG",10,53,110,163
https://kawalpemilu.org#24828,"YOSOMULYO, METRO PUSAT, KOTA METRO, LAMPUNG",11,100,108,208
https://kawalpemilu.org#24828,"YOSOMULYO, METRO PUSAT, KOTA METRO, LAMPUNG",12,51,109,160
https://kawalpemilu.org#24828,"YOSOMULYO, METRO PUSAT, KOTA METRO, LAMPUNG",13,58,112,170
https://kawalpemilu.org#24828,"YOSOMULYO, METRO PUSAT, KOTA METRO, LAMPUNG",14,127,107,234
https://kawalpemilu.org#24828,"YOSOMULYO, METRO PUSAT, KOTA METRO, LAMPUNG",15,101,113,214
https://kawalpemilu.org#24828,"YOSOMULYO, METRO PUSAT, KOTA METRO, LAMPUNG",16,77,146,223
https://kawalpemilu.org#24828,"YOSOMULYO, METRO PUSAT, KOTA METRO, LAMPUNG",17,71,133,204
https://kawalpemilu.org#24828,"YOSOMULYO, METRO PUSAT, KOTA METRO, LAMPUNG",18,117,115,232
https://kawalpemilu.org#24828,"YOSOMULYO, METRO PUSAT, KOTA METRO, LAMPUNG",19,87,104,191
https://kawalpemilu.org#24828,"YOSOMULYO, METRO PUSAT, KOTA METRO, LAMPUNG",20,105,111,216
https://kawalpemilu.org#24828,"YOSOMULYO, METRO PUSAT, KOTA METRO, LAMPUNG",21,85,98,183
https://kawalpemilu.org#24828,"YOSOMULYO, METRO PUSAT, KOTA METRO, LAMPUNG",22,79,92,171
https://kawalpemilu.org#24828,"YOSOMULYO, METRO PUSAT, KOTA METRO, LAMPUNG",23,116,69,185
https://kawalpemilu.org#24828,"YOSOMULYO, METRO PUSAT, KOTA METRO, LAMPUNG",24,87,112,199
https://kawalpemilu.org#24828,"YOSOMULYO, METRO PUSAT, KOTA METRO, LAMPUNG",25,96,113,209
https://kawalpemilu.org#24828,"YOSOMULYO, METRO PUSAT, KOTA METRO, LAMPUNG",26,158,70,228
https://kawalpemilu.org#24828,"YOSOMULYO, METRO PUSAT, KOTA METRO, LAMPUNG",27,93,123,216
https://kawalpemilu.org#24828,"YOSOMULYO, METRO PUSAT, KOTA METRO, LAMPUNG",28,92,167,259
https://kawalpemilu.org#24830,"BANJARSARI, METRO UTARA, KOTA METRO, LAMPUNG",1,99,171,270
https://kawalpemilu.org#24830,"BANJARSARI, METRO UTARA, KOTA METRO, LAMPUNG",2,129,120,249
https://kawalpemilu.org#24830,"BANJARSARI, METRO UTARA, KOTA METRO, LAMPUNG",3,140,109,249
https://kawalpemilu.org#24830,"BANJARSARI, METRO UTARA, KOTA METRO, LAMPUNG",4,133,103,236
https://kawalpemilu.org#24830,"BANJARSARI, METRO UTARA, KOTA METRO, LAMPUNG",5,115,145,260
https://kawalpemilu.org#24830,"BANJARSARI, METRO UTARA, KOTA METRO, LAMPUNG",6,125,139,264
https://kawalpemilu.org#24830,"BANJARSARI, METRO UTARA, KOTA METRO, LAMPUNG",7,145,98,243
https://kawalpemilu.org#24830,"BANJARSARI, METRO UTARA, KOTA METRO, LAMPUNG",8,124,108,232
https://kawalpemilu.org#24830,"BANJARSARI, METRO UTARA, KOTA METRO, LAMPUNG",9,88,154,242
https://kawalpemilu.org#24830,"BANJARSARI, METRO UTARA, KOTA METRO, LAMPUNG",10,98,138,236
https://kawalpemilu.org#24830,"BANJARSARI, METRO UTARA, KOTA METRO, LAMPUNG",11,130,133,263
https://kawalpemilu.org#24830,"BANJARSARI, METRO UTARA, KOTA METRO, LAMPUNG",12,131,131,262
https://kawalpemilu.org#24830,"BANJARSARI, METRO UTARA, KOTA METRO, LAMPUNG",13,148,129,277
https://kawalpemilu.org#24830,"BANJARSARI, METRO UTARA, KOTA METRO, LAMPUNG",14,137,107,244
https://kawalpemilu.org#24830,"BANJARSARI, METRO UTARA, KOTA METRO, LAMPUNG",15,192,65,257
https://kawalpemilu.org#24830,"BANJARSARI, METRO UTARA, KOTA METRO, LAMPUNG",16,152,74,226
https://kawalpemilu.org#24830,"BANJARSARI, METRO UTARA, KOTA METRO, LAMPUNG",17,121,146,267
https://kawalpemilu.org#24830,"BANJARSARI, METRO UTARA, KOTA METRO, LAMPUNG",18,113,141,254
https://kawalpemilu.org#24830,"BANJARSARI, METRO UTARA, KOTA METRO, LAMPUNG",19,190,83,273
https://kawalpemilu.org#24830,"BANJARSARI, METRO UTARA, KOTA METRO, LAMPUNG",20,183,81,264
https://kawalpemilu.org#24830,"BANJARSARI, METRO UTARA, KOTA METRO, LAMPUNG",21,147,91,238
https://kawalpemilu.org#24830,"BANJARSARI, METRO UTARA, KOTA METRO, LAMPUNG",22,166,77,243
https://kawalpemilu.org#24830,"BANJARSARI, METRO UTARA, KOTA METRO, LAMPUNG",23,145,75,220
https://kawalpemilu.org#24830,"BANJARSARI, METRO UTARA, KOTA METRO, LAMPUNG",24,153,79,232
https://kawalpemilu.org#24830,"BANJARSARI, METRO UTARA, KOTA METRO, LAMPUNG",25,163,79,242
https://kawalpemilu.org#24830,"BANJARSARI, METRO UTARA, KOTA METRO, LAMPUNG",26,195,61,256
https://kawalpemilu.org#24830,"BANJARSARI, METRO UTARA, KOTA METRO, LAMPUNG",27,174,86,260
https://kawalpemilu.org#24831,"PURWOSARI, METRO UTARA, KOTA METRO, LAMPUNG",1,137,137,274
https://kawalpemilu.org#24831,"PURWOSARI, METRO UTARA, KOTA METRO, LAMPUNG",2,145,134,279
https://kawalpemilu.org#24831,"PURWOSARI, METRO UTARA, KOTA METRO, LAMPUNG",3,164,118,282
https://kawalpemilu.org#24831,"PURWOSARI, METRO UTARA, KOTA METRO, LAMPUNG",4,142,112,254
https://kawalpemilu.org#24831,"PURWOSARI, METRO UTARA, KOTA METRO, LAMPUNG",5,157,107,264
https://kawalpemilu.org#24831,"PURWOSARI, METRO UTARA, KOTA METRO, LAMPUNG",6,164,103,267
https://kawalpemilu.org#24831,"PURWOSARI, METRO UTARA, KOTA METRO, LAMPUNG",7,153,70,223
https://kawalpemilu.org#24831,"PURWOSARI, METRO UTARA, KOTA METRO, LAMPUNG",8,172,73,245
https://kawalpemilu.org#24831,"PURWOSARI, METRO UTARA, KOTA METRO, LAMPUNG",9,93,168,261
https://kawalpemilu.org#24831,"PURWOSARI, METRO UTARA, KOTA METRO, LAMPUNG",10,148,105,253
https://kawalpemilu.org#24831,"PURWOSARI, METRO UTARA, KOTA METRO, LAMPUNG",11,135,120,255
https://kawalpemilu.org#24831,"PURWOSARI, METRO UTARA, KOTA METRO, LAMPUNG",12,98,148,246
https://kawalpemilu.org#24831,"PURWOSARI, METRO UTARA, KOTA METRO, LAMPUNG",13,44,183,227
https://kawalpemilu.org#24832,"KARANGREJO, METRO UTARA, KOTA METRO, LAMPUNG",1,137,137,274
https://kawalpemilu.org#24832,"KARANGREJO, METRO UTARA, KOTA METRO, LAMPUNG",2,124,122,246
https://kawalpemilu.org#24832,"KARANGREJO, METRO UTARA, KOTA METRO, LAMPUNG",3,129,109,238
https://kawalpemilu.org#24832,"KARANGREJO, METRO UTARA, KOTA METRO, LAMPUNG",4,172,81,253
https://kawalpemilu.org#24832,"KARANGREJO, METRO UTARA, KOTA METRO, LAMPUNG",5,140,86,226
https://kawalpemilu.org#24832,"KARANGREJO, METRO UTARA, KOTA METRO, LAMPUNG",6,92,92,184
https://kawalpemilu.org#24832,"KARANGREJO, METRO UTARA, KOTA METRO, LAMPUNG",7,149,68,217
https://kawalpemilu.org#24832,"KARANGREJO, METRO UTARA, KOTA METRO, LAMPUNG",8,127,62,189
https://kawalpemilu.org#24832,"KARANGREJO, METRO UTARA, KOTA METRO, LAMPUNG",9,188,72,260
https://kawalpemilu.org#24832,"KARANGREJO, METRO UTARA, KOTA METRO, LAMPUNG",10,147,85,232
https://kawalpemilu.org#24832,"KARANGREJO, METRO UTARA, KOTA METRO, LAMPUNG",11,134,79,213
https://kawalpemilu.org#24832,"KARANGREJO, METRO UTARA, KOTA METRO, LAMPUNG",12,142,104,246
https://kawalpemilu.org#24832,"KARANGREJO, METRO UTARA, KOTA METRO, LAMPUNG",13,185,45,230
https://kawalpemilu.org#24832,"KARANGREJO, METRO UTARA, KOTA METRO, LAMPUNG",14,147,73,220
https://kawalpemilu.org#24832,"KARANGREJO, METRO UTARA, KOTA METRO, LAMPUNG",15,158,60,218
https://kawalpemilu.org#24832,"KARANGREJO, METRO UTARA, KOTA METRO, LAMPUNG",16,167,55,222
https://kawalpemilu.org#24832,"KARANGREJO, METRO UTARA, KOTA METRO, LAMPUNG",17,172,48,220
https://kawalpemilu.org#24832,"KARANGREJO, METRO UTARA, KOTA METRO, LAMPUNG",18,172,74,246
https://kawalpemilu.org#24832,"KARANGREJO, METRO UTARA, KOTA METRO, LAMPUNG",19,130,106,236
https://kawalpemilu.org#24832,"KARANGREJO, METRO UTARA, KOTA METRO, LAMPUNG",20,117,132,249
https://kawalpemilu.org#24832,"KARANGREJO, METRO UTARA, KOTA METRO, LAMPUNG",21,137,103,240
https://kawalpemilu.org#24832,"KARANGREJO, METRO UTARA, KOTA METRO, LAMPUNG",22,171,96,267
https://kawalpemilu.org#24832,"KARANGREJO, METRO UTARA, KOTA METRO, LAMPUNG",23,178,90,268
https://kawalpemilu.org#24833,"PURWOASRI, METRO UTARA, KOTA METRO, LAMPUNG",1,140,71,211
https://kawalpemilu.org#24833,"PURWOASRI, METRO UTARA, KOTA METRO, LAMPUNG",2,101,89,190
https://kawalpemilu.org#24833,"PURWOASRI, METRO UTARA, KOTA METRO, LAMPUNG",3,86,80,166
https://kawalpemilu.org#24833,"PURWOASRI, METRO UTARA, KOTA METRO, LAMPUNG",4,154,44,198
https://kawalpemilu.org#24833,"PURWOASRI, METRO UTARA, KOTA METRO, LAMPUNG",5,116,106,222
https://kawalpemilu.org#24833,"PURWOASRI, METRO UTARA, KOTA METRO, LAMPUNG",6,127,91,218
https://kawalpemilu.org#24833,"PURWOASRI, METRO UTARA, KOTA METRO, LAMPUNG",7,78,125,203
https://kawalpemilu.org#24833,"PURWOASRI, METRO UTARA, KOTA METRO, LAMPUNG",8,157,100,257
https://kawalpemilu.org#24833,"PURWOASRI, METRO UTARA, KOTA METRO, LAMPUNG",9,148,70,218
https://kawalpemilu.org#24833,"PURWOASRI, METRO UTARA, KOTA METRO, LAMPUNG",10,104,59,163
https://kawalpemilu.org#24833,"PURWOASRI, METRO UTARA, KOTA METRO, LAMPUNG",11,108,35,143
https://kawalpemilu.org#24835,"MULYOJATI, METRO BARAT, KOTA METRO, LAMPUNG",1,148,108,256
https://kawalpemilu.org#24835,"MULYOJATI, METRO BARAT, KOTA METRO, LAMPUNG",2,144,130,274
https://kawalpemilu.org#24835,"MULYOJATI, METRO BARAT, KOTA METRO, LAMPUNG",3,138,119,257
https://kawalpemilu.org#24835,"MULYOJATI, METRO BARAT, KOTA METRO, LAMPUNG",4,172,104,276
https://kawalpemilu.org#24835,"MULYOJATI, METRO BARAT, KOTA METRO, LAMPUNG",5,204,70,274
https://kawalpemilu.org#24835,"MULYOJATI, METRO BARAT, KOTA METRO, LAMPUNG",6,144,121,265
https://kawalpemilu.org#24835,"MULYOJATI, METRO BARAT, KOTA METRO, LAMPUNG",7,166,87,253
https://kawalpemilu.org#24835,"MULYOJATI, METRO BARAT, KOTA METRO, LAMPUNG",8,152,101,253
https://kawalpemilu.org#24835,"MULYOJATI, METRO BARAT, KOTA METRO, LAMPUNG",9,139,104,243
https://kawalpemilu.org#24835,"MULYOJATI, METRO BARAT, KOTA METRO, LAMPUNG",10,130,121,251
https://kawalpemilu.org#24835,"MULYOJATI, METRO BARAT, KOTA METRO, LAMPUNG",11,163,106,269
https://kawalpemilu.org#24835,"MULYOJATI, METRO BARAT, KOTA METRO, LAMPUNG",12,140,107,247
https://kawalpemilu.org#24835,"MULYOJATI, METRO BARAT, KOTA METRO, LAMPUNG",13,127,121,248
https://kawalpemilu.org#24835,"MULYOJATI, METRO BARAT, KOTA METRO, LAMPUNG",14,102,131,233
https://kawalpemilu.org#24835,"MULYOJATI, METRO BARAT, KOTA METRO, LAMPUNG",15,96,131,227
https://kawalpemilu.org#24835,"MULYOJATI, METRO BARAT, KOTA METRO, LAMPUNG",16,92,144,236
https://kawalpemilu.org#24835,"MULYOJATI, METRO BARAT, KOTA METRO, LAMPUNG",17,76,159,235
https://kawalpemilu.org#24835,"MULYOJATI, METRO BARAT, KOTA METRO, LAMPUNG",18,95,131,226
https://kawalpemilu.org#24835,"MULYOJATI, METRO BARAT, KOTA METRO, LAMPUNG",19,99,142,241
https://kawalpemilu.org#24836,"GANJAR AGUNG, METRO BARAT, KOTA METRO, LAMPUNG",1,108,116,224
https://kawalpemilu.org#24836,"GANJAR AGUNG, METRO BARAT, KOTA METRO, LAMPUNG",2,127,86,213
https://kawalpemilu.org#24836,"GANJAR AGUNG, METRO BARAT, KOTA METRO, LAMPUNG",3,125,94,219
https://kawalpemilu.org#24836,"GANJAR AGUNG, METRO BARAT, KOTA METRO, LAMPUNG",4,123,94,217
https://kawalpemilu.org#24836,"GANJAR AGUNG, METRO BARAT, KOTA METRO, LAMPUNG",5,146,77,223
https://kawalpemilu.org#24836,"GANJAR AGUNG, METRO BARAT, KOTA METRO, LAMPUNG",6,143,88,231
https://kawalpemilu.org#24836,"GANJAR AGUNG, METRO BARAT, KOTA METRO, LAMPUNG",7,159,90,249
https://kawalpemilu.org#24836,"GANJAR AGUNG, METRO BARAT, KOTA METRO, LAMPUNG",8,98,135,233
https://kawalpemilu.org#24836,"GANJAR AGUNG, METRO BARAT, KOTA METRO, LAMPUNG",9,107,148,255
https://kawalpemilu.org#24836,"GANJAR AGUNG, METRO BARAT, KOTA METRO, LAMPUNG",10,69,143,212
https://kawalpemilu.org#24836,"GANJAR AGUNG, METRO BARAT, KOTA METRO, LAMPUNG",11,110,131,241
https://kawalpemilu.org#24836,"GANJAR AGUNG, METRO BARAT, KOTA METRO, LAMPUNG",12,119,157,276
https://kawalpemilu.org#24836,"GANJAR AGUNG, METRO BARAT, KOTA METRO, LAMPUNG",13,84,149,233
https://kawalpemilu.org#24836,"GANJAR AGUNG, METRO BARAT, KOTA METRO, LAMPUNG",14,110,132,242
https://kawalpemilu.org#24836,"GANJAR AGUNG, METRO BARAT, KOTA METRO, LAMPUNG",15,126,128,254
https://kawalpemilu.org#24836,"GANJAR AGUNG, METRO BARAT, KOTA METRO, LAMPUNG",16,132,135,267
https://kawalpemilu.org#24836,"GANJAR AGUNG, METRO BARAT, KOTA METRO, LAMPUNG",17,123,76,199
https://kawalpemilu.org#24836,"GANJAR AGUNG, METRO BARAT, KOTA METRO, LAMPUNG",18,103,76,179
https://kawalpemilu.org#24837,"MULYOSARI, METRO BARAT, KOTA METRO, LAMPUNG",1,138,69,207
https://kawalpemilu.org#24837,"MULYOSARI, METRO BARAT, KOTA METRO, LAMPUNG",2,150,60,210
https://kawalpemilu.org#24837,"MULYOSARI, METRO BARAT, KOTA METRO, LAMPUNG",3,119,72,191
https://kawalpemilu.org#24837,"MULYOSARI, METRO BARAT, KOTA METRO, LAMPUNG",4,137,71,208
https://kawalpemilu.org#24837,"MULYOSARI, METRO BARAT, KOTA METRO, LAMPUNG",5,137,74,211
https://kawalpemilu.org#24837,"MULYOSARI, METRO BARAT, KOTA METRO, LAMPUNG",6,98,77,175
https://kawalpemilu.org#24837,"MULYOSARI, METRO BARAT, KOTA METRO, LAMPUNG",7,132,65,197
https://kawalpemilu.org#24837,"MULYOSARI, METRO BARAT, KOTA METRO, LAMPUNG",8,110,57,167
https://kawalpemilu.org#24837,"MULYOSARI, METRO BARAT, KOTA METRO, LAMPUNG",9,93,79,172
https://kawalpemilu.org#24837,"MULYOSARI, METRO BARAT, KOTA METRO, LAMPUNG",10,88,77,165
https://kawalpemilu.org#24837,"MULYOSARI, METRO BARAT, KOTA METRO, LAMPUNG",11,93,94,187
https://kawalpemilu.org#24838,"GANJAR ASRI, METRO BARAT, KOTA METRO, LAMPUNG",1,110,120,230
https://kawalpemilu.org#24838,"GANJAR ASRI, METRO BARAT, KOTA METRO, LAMPUNG",2,68,132,200
https://kawalpemilu.org#24838,"GANJAR ASRI, METRO BARAT, KOTA METRO, LAMPUNG",3,135,95,230
https://kawalpemilu.org#24838,"GANJAR ASRI, METRO BARAT, KOTA METRO, LAMPUNG",4,103,124,227
https://kawalpemilu.org#24838,"GANJAR ASRI, METRO BARAT, KOTA METRO, LAMPUNG",5,83,96,179
https://kawalpemilu.org#24838,"GANJAR ASRI, METRO BARAT, KOTA METRO, LAMPUNG",6,104,82,186
https://kawalpemilu.org#24838,"GANJAR ASRI, METRO BARAT, KOTA METRO, LAMPUNG",7,84,117,201
https://kawalpemilu.org#24838,"GANJAR ASRI, METRO BARAT, KOTA METRO, LAMPUNG",8,69,147,216
https://kawalpemilu.org#24838,"GANJAR ASRI, METRO BARAT, KOTA METRO, LAMPUNG",9,146,92,238
https://kawalpemilu.org#24838,"GANJAR ASRI, METRO BARAT, KOTA METRO, LAMPUNG",10,131,121,252
https://kawalpemilu.org#24838,"GANJAR ASRI, METRO BARAT, KOTA METRO, LAMPUNG",11,143,88,231
https://kawalpemilu.org#24838,"GANJAR ASRI, METRO BARAT, KOTA METRO, LAMPUNG",12,126,109,235
https://kawalpemilu.org#24838,"GANJAR ASRI, METRO BARAT, KOTA METRO, LAMPUNG",13,135,104,239
https://kawalpemilu.org#24838,"GANJAR ASRI, METRO BARAT, KOTA METRO, LAMPUNG",14,161,70,231
https://kawalpemilu.org#24838,"GANJAR ASRI, METRO BARAT, KOTA METRO, LAMPUNG",15,96,47,143
https://kawalpemilu.org#24838,"GANJAR ASRI, METRO BARAT, KOTA METRO, LAMPUNG",16,130,53,183
https://kawalpemilu.org#24838,"GANJAR ASRI, METRO BARAT, KOTA METRO, LAMPUNG",17,146,73,219
https://kawalpemilu.org#24838,"GANJAR ASRI, METRO BARAT, KOTA METRO, LAMPUNG",18,152,61,213
https://kawalpemilu.org#24838,"GANJAR ASRI, METRO BARAT, KOTA METRO, LAMPUNG",19,124,44,168
https://kawalpemilu.org#24838,"GANJAR ASRI, METRO BARAT, KOTA METRO, LAMPUNG",20,119,40,159
https://kawalpemilu.org#24838,"GANJAR ASRI, METRO BARAT, KOTA METRO, LAMPUNG",21,156,59,215
https://kawalpemilu.org#24838,"GANJAR ASRI, METRO BARAT, KOTA METRO, LAMPUNG",22,127,59,186
https://kawalpemilu.org#24838,"GANJAR ASRI, METRO BARAT, KOTA METRO, LAMPUNG",23,94,105,199
https://kawalpemilu.org#24838,"GANJAR ASRI, METRO BARAT, KOTA METRO, LAMPUNG",24,110,77,187
https://kawalpemilu.org#24838,"GANJAR ASRI, METRO BARAT, KOTA METRO, LAMPUNG",25,114,71,185
https://kawalpemilu.org#24838,"GANJAR ASRI, METRO BARAT, KOTA METRO, LAMPUNG",26,97,73,170
https://kawalpemilu.org#24838,"GANJAR ASRI, METRO BARAT, KOTA METRO, LAMPUNG",27,94,83,177
https://kawalpemilu.org#24838,"GANJAR ASRI, METRO BARAT, KOTA METRO, LAMPUNG",28,93,83,176
https://kawalpemilu.org#24840,"YOSODADI, METRO TIMUR, KOTA METRO, LAMPUNG",1,91,111,202
https://kawalpemilu.org#24840,"YOSODADI, METRO TIMUR, KOTA METRO, LAMPUNG",2,129,119,248
https://kawalpemilu.org#24840,"YOSODADI, METRO TIMUR, KOTA METRO, LAMPUNG",3,147,70,217
https://kawalpemilu.org#24840,"YOSODADI, METRO TIMUR, KOTA METRO, LAMPUNG",4,128,92,220
https://kawalpemilu.org#24840,"YOSODADI, METRO TIMUR, KOTA METRO, LAMPUNG",5,149,93,242
https://kawalpemilu.org#24840,"YOSODADI, METRO TIMUR, KOTA METRO, LAMPUNG",6,116,115,231
https://kawalpemilu.org#24840,"YOSODADI, METRO TIMUR, KOTA METRO, LAMPUNG",7,0,0,0
https://kawalpemilu.org#24840,"YOSODADI, METRO TIMUR, KOTA METRO, LAMPUNG",8,145,124,269
https://kawalpemilu.org#24840,"YOSODADI, METRO TIMUR, KOTA METRO, LAMPUNG",9,69,134,203
https://kawalpemilu.org#24840,"YOSODADI, METRO TIMUR, KOTA METRO, LAMPUNG",10,110,108,218
https://kawalpemilu.org#24840,"YOSODADI, METRO TIMUR, KOTA METRO, LAMPUNG",11,103,90,193
https://kawalpemilu.org#24840,"YOSODADI, METRO TIMUR, KOTA METRO, LAMPUNG",12,163,83,246
https://kawalpemilu.org#24840,"YOSODADI, METRO TIMUR, KOTA METRO, LAMPUNG",13,95,121,216
https://kawalpemilu.org#24840,"YOSODADI, METRO TIMUR, KOTA METRO, LAMPUNG",14,142,110,252
https://kawalpemilu.org#24840,"YOSODADI, METRO TIMUR, KOTA METRO, LAMPUNG",15,121,136,257
https://kawalpemilu.org#24840,"YOSODADI, METRO TIMUR, KOTA METRO, LAMPUNG",16,140,128,268
https://kawalpemilu.org#24840,"YOSODADI, METRO TIMUR, KOTA METRO, LAMPUNG",17,110,97,207
https://kawalpemilu.org#24840,"YOSODADI, METRO TIMUR, KOTA METRO, LAMPUNG",18,115,105,220
https://kawalpemilu.org#24840,"YOSODADI, METRO TIMUR, KOTA METRO, LAMPUNG",19,120,62,182
https://kawalpemilu.org#24840,"YOSODADI, METRO TIMUR, KOTA METRO, LAMPUNG",20,108,88,196
https://kawalpemilu.org#24840,"YOSODADI, METRO TIMUR, KOTA METRO, LAMPUNG",21,177,72,249
https://kawalpemilu.org#24840,"YOSODADI, METRO TIMUR, KOTA METRO, LAMPUNG",22,185,72,257
https://kawalpemilu.org#24840,"YOSODADI, METRO TIMUR, KOTA METRO, LAMPUNG",23,188,47,235
https://kawalpemilu.org#24841,"TEJOSARI, METRO TIMUR, KOTA METRO, LAMPUNG",1,133,96,229
https://kawalpemilu.org#24841,"TEJOSARI, METRO TIMUR, KOTA METRO, LAMPUNG",2,168,87,255
https://kawalpemilu.org#24841,"TEJOSARI, METRO TIMUR, KOTA METRO, LAMPUNG",3,155,83,238
https://kawalpemilu.org#24841,"TEJOSARI, METRO TIMUR, KOTA METRO, LAMPUNG",4,169,71,240
https://kawalpemilu.org#24841,"TEJOSARI, METRO TIMUR, KOTA METRO, LAMPUNG",5,137,109,246
https://kawalpemilu.org#24841,"TEJOSARI, METRO TIMUR, KOTA METRO, LAMPUNG",6,73,97,170
https://kawalpemilu.org#24841,"TEJOSARI, METRO TIMUR, KOTA METRO, LAMPUNG",7,136,96,232
https://kawalpemilu.org#24841,"TEJOSARI, METRO TIMUR, KOTA METRO, LAMPUNG",8,107,137,242
https://kawalpemilu.org#24841,"TEJOSARI, METRO TIMUR, KOTA METRO, LAMPUNG",9,115,120,235
https://kawalpemilu.org#24842,"IRING MULYO, METRO TIMUR, KOTA METRO, LAMPUNG",1,134,103,237
https://kawalpemilu.org#24842,"IRING MULYO, METRO TIMUR, KOTA METRO, LAMPUNG",2,98,119,217
https://kawalpemilu.org#24842,"IRING MULYO, METRO TIMUR, KOTA METRO, LAMPUNG",3,65,115,180
https://kawalpemilu.org#24842,"IRING MULYO, METRO TIMUR, KOTA METRO, LAMPUNG",4,90,118,208
https://kawalpemilu.org#24842,"IRING MULYO, METRO TIMUR, KOTA METRO, LAMPUNG",5,107,92,199
https://kawalpemilu.org#24842,"IRING MULYO, METRO TIMUR, KOTA METRO, LAMPUNG",6,81,103,184
https://kawalpemilu.org#24842,"IRING MULYO, METRO TIMUR, KOTA METRO, LAMPUNG",7,131,111,242
https://kawalpemilu.org#24842,"IRING MULYO, METRO TIMUR, KOTA METRO, LAMPUNG",8,110,126,236
https://kawalpemilu.org#24842,"IRING MULYO, METRO TIMUR, KOTA METRO, LAMPUNG",9,72,107,179
https://kawalpemilu.org#24842,"IRING MULYO, METRO TIMUR, KOTA METRO, LAMPUNG",10,119,93,212
https://kawalpemilu.org#24842,"IRING MULYO, METRO TIMUR, KOTA METRO, LAMPUNG",11,94,127,221
https://kawalpemilu.org#24842,"IRING MULYO, METRO TIMUR, KOTA METRO, LAMPUNG",12,69,158,227
https://kawalpemilu.org#24842,"IRING MULYO, METRO TIMUR, KOTA METRO, LAMPUNG",13,108,119,227
https://kawalpemilu.org#24842,"IRING MULYO, METRO TIMUR, KOTA METRO, LAMPUNG",14,156,83,239
https://kawalpemilu.org#24842,"IRING MULYO, METRO TIMUR, KOTA METRO, LAMPUNG",15,146,98,244
https://kawalpemilu.org#24842,"IRING MULYO, METRO TIMUR, KOTA METRO, LAMPUNG",16,172,59,231
https://kawalpemilu.org#24842,"IRING MULYO, METRO TIMUR, KOTA METRO, LAMPUNG",17,147,72,219
https://kawalpemilu.org#24842,"IRING MULYO, METRO TIMUR, KOTA METRO, LAMPUNG",18,106,127,233
https://kawalpemilu.org#24842,"IRING MULYO, METRO TIMUR, KOTA METRO, LAMPUNG",19,156,119,275
https://kawalpemilu.org#24842,"IRING MULYO, METRO TIMUR, KOTA METRO, LAMPUNG",20,147,92,239
https://kawalpemilu.org#24842,"IRING MULYO, METRO TIMUR, KOTA METRO, LAMPUNG",21,107,110,217
https://kawalpemilu.org#24842,"IRING MULYO, METRO TIMUR, KOTA METRO, LAMPUNG",22,91,104,195
https://kawalpemilu.org#24842,"IRING MULYO, METRO TIMUR, KOTA METRO, LAMPUNG",23,135,113,248
https://kawalpemilu.org#24842,"IRING MULYO, METRO TIMUR, KOTA METRO, LAMPUNG",24,131,136,267
https://kawalpemilu.org#24842,"IRING MULYO, METRO TIMUR, KOTA METRO, LAMPUNG",25,161,74,235
https://kawalpemilu.org#24842,"IRING MULYO, METRO TIMUR, KOTA METRO, LAMPUNG",26,150,70,220
https://kawalpemilu.org#24842,"IRING MULYO, METRO TIMUR, KOTA METRO, LAMPUNG",27,131,59,190
https://kawalpemilu.org#24842,"IRING MULYO, METRO TIMUR, KOTA METRO, LAMPUNG",28,133,96,229
https://kawalpemilu.org#24842,"IRING MULYO, METRO TIMUR, KOTA METRO, LAMPUNG",29,91,108,199
https://kawalpemilu.org#24842,"IRING MULYO, METRO TIMUR, KOTA METRO, LAMPUNG",30,95,129,224
https://kawalpemilu.org#24842,"IRING MULYO, METRO TIMUR, KOTA METRO, LAMPUNG",31,107,115,222
https://kawalpemilu.org#24842,"IRING MULYO, METRO TIMUR, KOTA METRO, LAMPUNG",32,1,1,228
https://kawalpemilu.org#24842,"IRING MULYO, METRO TIMUR, KOTA METRO, LAMPUNG",33,131,83,214
https://kawalpemilu.org#24842,"IRING MULYO, METRO TIMUR, KOTA METRO, LAMPUNG",34,106,105,211
https://kawalpemilu.org#24842,"IRING MULYO, METRO TIMUR, KOTA METRO, LAMPUNG",35,27,87,114
https://kawalpemilu.org#24843,"YOSOREJO, METRO TIMUR, KOTA METRO, LAMPUNG",1,96,145,241
https://kawalpemilu.org#24843,"YOSOREJO, METRO TIMUR, KOTA METRO, LAMPUNG",2,78,181,259
https://kawalpemilu.org#24843,"YOSOREJO, METRO TIMUR, KOTA METRO, LAMPUNG",3,110,142,252
https://kawalpemilu.org#24843,"YOSOREJO, METRO TIMUR, KOTA METRO, LAMPUNG",4,140,106,246
https://kawalpemilu.org#24843,"YOSOREJO, METRO TIMUR, KOTA METRO, LAMPUNG",5,130,97,227
https://kawalpemilu.org#24843,"YOSOREJO, METRO TIMUR, KOTA METRO, LAMPUNG",6,150,84,234
https://kawalpemilu.org#24843,"YOSOREJO, METRO TIMUR, KOTA METRO, LAMPUNG",7,135,58,193
https://kawalpemilu.org#24843,"YOSOREJO, METRO TIMUR, KOTA METRO, LAMPUNG",8,145,110,255
https://kawalpemilu.org#24843,"YOSOREJO, METRO TIMUR, KOTA METRO, LAMPUNG",9,145,110,255
https://kawalpemilu.org#24843,"YOSOREJO, METRO TIMUR, KOTA METRO, LAMPUNG",10,99,137,236
https://kawalpemilu.org#24843,"YOSOREJO, METRO TIMUR, KOTA METRO, LAMPUNG",11,151,88,239
https://kawalpemilu.org#24843,"YOSOREJO, METRO TIMUR, KOTA METRO, LAMPUNG",12,154,100,254
https://kawalpemilu.org#24843,"YOSOREJO, METRO TIMUR, KOTA METRO, LAMPUNG",13,134,105,239
https://kawalpemilu.org#24843,"YOSOREJO, METRO TIMUR, KOTA METRO, LAMPUNG",14,124,97,221
https://kawalpemilu.org#24843,"YOSOREJO, METRO TIMUR, KOTA METRO, LAMPUNG",15,99,146,245
https://kawalpemilu.org#24843,"YOSOREJO, METRO TIMUR, KOTA METRO, LAMPUNG",16,98,115,213
https://kawalpemilu.org#24843,"YOSOREJO, METRO TIMUR, KOTA METRO, LAMPUNG",17,100,139,239
https://kawalpemilu.org#24843,"YOSOREJO, METRO TIMUR, KOTA METRO, LAMPUNG",18,110,161,271
https://kawalpemilu.org#24844,"TEJO AGUNG, METRO TIMUR, KOTA METRO, LAMPUNG",1,118,89,207
https://kawalpemilu.org#24844,"TEJO AGUNG, METRO TIMUR, KOTA METRO, LAMPUNG",2,121,100,221
https://kawalpemilu.org#24844,"TEJO AGUNG, METRO TIMUR, KOTA METRO, LAMPUNG",3,98,111,209
https://kawalpemilu.org#24844,"TEJO AGUNG, METRO TIMUR, KOTA METRO, LAMPUNG",4,75,105,180
https://kawalpemilu.org#24844,"TEJO AGUNG, METRO TIMUR, KOTA METRO, LAMPUNG",5,111,94,205
https://kawalpemilu.org#24844,"TEJO AGUNG, METRO TIMUR, KOTA METRO, LAMPUNG",6,108,127,235
https://kawalpemilu.org#24844,"TEJO AGUNG, METRO TIMUR, KOTA METRO, LAMPUNG",7,116,135,251
https://kawalpemilu.org#24844,"TEJO AGUNG, METRO TIMUR, KOTA METRO, LAMPUNG",8,96,143,239
https://kawalpemilu.org#24844,"TEJO AGUNG, METRO TIMUR, KOTA METRO, LAMPUNG",9,71,133,204
https://kawalpemilu.org#24844,"TEJO AGUNG, METRO TIMUR, KOTA METRO, LAMPUNG",10,130,82,212
https://kawalpemilu.org#24844,"TEJO AGUNG, METRO TIMUR, KOTA METRO, LAMPUNG",11,78,141,219
https://kawalpemilu.org#24844,"TEJO AGUNG, METRO TIMUR, KOTA METRO, LAMPUNG",12,84,147,231
https://kawalpemilu.org#24844,"TEJO AGUNG, METRO TIMUR, KOTA METRO, LAMPUNG",13,58,157,215
https://kawalpemilu.org#24844,"TEJO AGUNG, METRO TIMUR, KOTA METRO, LAMPUNG",14,71,144,215
https://kawalpemilu.org#24844,"TEJO AGUNG, METRO TIMUR, KOTA METRO, LAMPUNG",15,70,130,200
https://kawalpemilu.org#24844,"TEJO AGUNG, METRO TIMUR, KOTA METRO, LAMPUNG",16,59,123,182
https://kawalpemilu.org#24844,"TEJO AGUNG, METRO TIMUR, KOTA METRO, LAMPUNG",17,105,81,186
https://kawalpemilu.org#24844,"TEJO AGUNG, METRO TIMUR, KOTA METRO, LAMPUNG",18,93,85,178
https://kawalpemilu.org#24846,"REJOMULYO, METRO SELATAN, KOTA METRO, LAMPUNG",1,120,115,235
https://kawalpemilu.org#24846,"REJOMULYO, METRO SELATAN, KOTA METRO, LAMPUNG",2,99,94,193
https://kawalpemilu.org#24846,"REJOMULYO, METRO SELATAN, KOTA METRO, LAMPUNG",3,118,96,214
https://kawalpemilu.org#24846,"REJOMULYO, METRO SELATAN, KOTA METRO, LAMPUNG",4,151,77,228
https://kawalpemilu.org#24846,"REJOMULYO, METRO SELATAN, KOTA METRO, LAMPUNG",5,126,82,208
https://kawalpemilu.org#24846,"REJOMULYO, METRO SELATAN, KOTA METRO, LAMPUNG",6,103,126,229
https://kawalpemilu.org#24846,"REJOMULYO, METRO SELATAN, KOTA METRO, LAMPUNG",7,119,94,213
https://kawalpemilu.org#24846,"REJOMULYO, METRO SELATAN, KOTA METRO, LAMPUNG",8,134,84,218
https://kawalpemilu.org#24846,"REJOMULYO, METRO SELATAN, KOTA METRO, LAMPUNG",9,137,43,180
https://kawalpemilu.org#24846,"REJOMULYO, METRO SELATAN, KOTA METRO, LAMPUNG",10,141,52,193
https://kawalpemilu.org#24846,"REJOMULYO, METRO SELATAN, KOTA METRO, LAMPUNG",11,144,50,194
https://kawalpemilu.org#24846,"REJOMULYO, METRO SELATAN, KOTA METRO, LAMPUNG",12,153,46,199
https://kawalpemilu.org#24846,"REJOMULYO, METRO SELATAN, KOTA METRO, LAMPUNG",13,113,80,193
https://kawalpemilu.org#24846,"REJOMULYO, METRO SELATAN, KOTA METRO, LAMPUNG",14,99,86,185
https://kawalpemilu.org#24846,"REJOMULYO, METRO SELATAN, KOTA METRO, LAMPUNG",15,133,73,206
https://kawalpemilu.org#24846,"REJOMULYO, METRO SELATAN, KOTA METRO, LAMPUNG",16,148,72,220
https://kawalpemilu.org#24847,"MARGOREJO, METRO SELATAN, KOTA METRO, LAMPUNG",1,147,97,244
https://kawalpemilu.org#24847,"MARGOREJO, METRO SELATAN, KOTA METRO, LAMPUNG",2,136,93,229
https://kawalpemilu.org#24847,"MARGOREJO, METRO SELATAN, KOTA METRO, LAMPUNG",3,153,71,224
https://kawalpemilu.org#24847,"MARGOREJO, METRO SELATAN, KOTA METRO, LAMPUNG",4,123,102,225
https://kawalpemilu.org#24847,"MARGOREJO, METRO SELATAN, KOTA METRO, LAMPUNG",5,116,96,212
https://kawalpemilu.org#24847,"MARGOREJO, METRO SELATAN, KOTA METRO, LAMPUNG",6,99,120,219
https://kawalpemilu.org#24847,"MARGOREJO, METRO SELATAN, KOTA METRO, LAMPUNG",7,85,119,204
https://kawalpemilu.org#24847,"MARGOREJO, METRO SELATAN, KOTA METRO, LAMPUNG",8,104,139,243
https://kawalpemilu.org#24847,"MARGOREJO, METRO SELATAN, KOTA METRO, LAMPUNG",9,77,121,198
https://kawalpemilu.org#24847,"MARGOREJO, METRO SELATAN, KOTA METRO, LAMPUNG",10,105,107,212
https://kawalpemilu.org#24847,"MARGOREJO, METRO SELATAN, KOTA METRO, LAMPUNG",11,77,141,218
https://kawalpemilu.org#24847,"MARGOREJO, METRO SELATAN, KOTA METRO, LAMPUNG",12,62,148,210
https://kawalpemilu.org#24847,"MARGOREJO, METRO SELATAN, KOTA METRO, LAMPUNG",13,84,163,247
https://kawalpemilu.org#24847,"MARGOREJO, METRO SELATAN, KOTA METRO, LAMPUNG",14,81,132,213
https://kawalpemilu.org#24848,"SUMBER SARI, METRO SELATAN, KOTA METRO, LAMPUNG",1,142,97,239
https://kawalpemilu.org#24848,"SUMBER SARI, METRO SELATAN, KOTA METRO, LAMPUNG",2,184,49,233
https://kawalpemilu.org#24848,"SUMBER SARI, METRO SELATAN, KOTA METRO, LAMPUNG",3,105,94,199
https://kawalpemilu.org#24848,"SUMBER SARI, METRO SELATAN, KOTA METRO, LAMPUNG",4,115,109,224
https://kawalpemilu.org#24848,"SUMBER SARI, METRO SELATAN, KOTA METRO, LAMPUNG",5,103,91,194
https://kawalpemilu.org#24848,"SUMBER SARI, METRO SELATAN, KOTA METRO, LAMPUNG",6,105,84,189
https://kawalpemilu.org#24848,"SUMBER SARI, METRO SELATAN, KOTA METRO, LAMPUNG",7,121,93,214
https://kawalpemilu.org#24848,"SUMBER SARI, METRO SELATAN, KOTA METRO, LAMPUNG",8,144,65,209
https://kawalpemilu.org#24848,"SUMBER SARI, METRO SELATAN, KOTA METRO, LAMPUNG",9,157,86,243
https://kawalpemilu.org#24848,"SUMBER SARI, METRO SELATAN, KOTA METRO, LAMPUNG",10,151,79,230
https://kawalpemilu.org#24849,"MARGODADI, METRO SELATAN, KOTA METRO, LAMPUNG",1,135,105,240
https://kawalpemilu.org#24849,"MARGODADI, METRO SELATAN, KOTA METRO, LAMPUNG",2,172,105,232
https://kawalpemilu.org#24849,"MARGODADI, METRO SELATAN, KOTA METRO, LAMPUNG",3,151,105,256
https://kawalpemilu.org#24849,"MARGODADI, METRO SELATAN, KOTA METRO, LAMPUNG",4,154,74,228
https://kawalpemilu.org#24849,"MARGODADI, METRO SELATAN, KOTA METRO, LAMPUNG",5,128,133,261
https://kawalpemilu.org#24849,"MARGODADI, METRO SELATAN, KOTA METRO, LAMPUNG",6,128,119,247
https://kawalpemilu.org#24849,"MARGODADI, METRO SELATAN, KOTA METRO, LAMPUNG",7,148,105,253
https://kawalpemilu.org#24849,"MARGODADI, METRO SELATAN, KOTA METRO, LAMPUNG",8,152,73,225
https://kawalpemilu.org#24852,"PADANG RATU, GEDONG TATAAN, PESAWARAN, LAMPUNG",1,44,132,176
https://kawalpemilu.org#24852,"PADANG RATU, GEDONG TATAAN, PESAWARAN, LAMPUNG",2,54,140,194
https://kawalpemilu.org#24852,"PADANG RATU, GEDONG TATAAN, PESAWARAN, LAMPUNG",3,137,77,214
https://kawalpemilu.org#24852,"PADANG RATU, GEDONG TATAAN, PESAWARAN, LAMPUNG",4,102,35,137
https://kawalpemilu.org#24852,"PADANG RATU, GEDONG TATAAN, PESAWARAN, LAMPUNG",5,105,70,175
https://kawalpemilu.org#24852,"PADANG RATU, GEDONG TATAAN, PESAWARAN, LAMPUNG",6,107,32,139
https://kawalpemilu.org#24853,"PAMPANGAN, GEDONG TATAAN, PESAWARAN, LAMPUNG",1,33,151,184
https://kawalpemilu.org#24853,"PAMPANGAN, GEDONG TATAAN, PESAWARAN, LAMPUNG",2,36,139,175
https://kawalpemilu.org#24853,"PAMPANGAN, GEDONG TATAAN, PESAWARAN, LAMPUNG",3,76,119,195
https://kawalpemilu.org#24853,"PAMPANGAN, GEDONG TATAAN, PESAWARAN, LAMPUNG",4,104,69,173
https://kawalpemilu.org#24853,"PAMPANGAN, GEDONG TATAAN, PESAWARAN, LAMPUNG",5,50,83,133
https://kawalpemilu.org#24853,"PAMPANGAN, GEDONG TATAAN, PESAWARAN, LAMPUNG",6,27,154,181
https://kawalpemilu.org#24853,"PAMPANGAN, GEDONG TATAAN, PESAWARAN, LAMPUNG",7,54,25,79
https://kawalpemilu.org#24853,"PAMPANGAN, GEDONG TATAAN, PESAWARAN, LAMPUNG",8,56,72,128
https://kawalpemilu.org#24854,"CIPADANG, GEDONG TATAAN, PESAWARAN, LAMPUNG",1,53,106,159
https://kawalpemilu.org#24854,"CIPADANG, GEDONG TATAAN, PESAWARAN, LAMPUNG",2,185,48,233
https://kawalpemilu.org#24854,"CIPADANG, GEDONG TATAAN, PESAWARAN, LAMPUNG",3,81,82,163
https://kawalpemilu.org#24854,"CIPADANG, GEDONG TATAAN, PESAWARAN, LAMPUNG",5,154,67,221
https://kawalpemilu.org#24854,"CIPADANG, GEDONG TATAAN, PESAWARAN, LAMPUNG",6,76,127,203
https://kawalpemilu.org#24854,"CIPADANG, GEDONG TATAAN, PESAWARAN, LAMPUNG",7,81,115,196
https://kawalpemilu.org#24854,"CIPADANG, GEDONG TATAAN, PESAWARAN, LAMPUNG",8,129,79,208
https://kawalpemilu.org#24854,"CIPADANG, GEDONG TATAAN, PESAWARAN, LAMPUNG",9,99,73,172
https://kawalpemilu.org#24854,"CIPADANG, GEDONG TATAAN, PESAWARAN, LAMPUNG",10,83,137,220
https://kawalpemilu.org#24854,"CIPADANG, GEDONG TATAAN, PESAWARAN, LAMPUNG",11,132,87,219
https://kawalpemilu.org#24854,"CIPADANG, GEDONG TATAAN, PESAWARAN, LAMPUNG",12,151,55,206
https://kawalpemilu.org#24854,"CIPADANG, GEDONG TATAAN, PESAWARAN, LAMPUNG",13,222,17,239
https://kawalpemilu.org#24854,"CIPADANG, GEDONG TATAAN, PESAWARAN, LAMPUNG",14,230,23,253
https://kawalpemilu.org#24854,"CIPADANG, GEDONG TATAAN, PESAWARAN, LAMPUNG",15,88,84,172
https://kawalpemilu.org#24854,"CIPADANG, GEDONG TATAAN, PESAWARAN, LAMPUNG",16,78,86,164
https://kawalpemilu.org#24854,"CIPADANG, GEDONG TATAAN, PESAWARAN, LAMPUNG",17,51,143,194
https://kawalpemilu.org#24854,"CIPADANG, GEDONG TATAAN, PESAWARAN, LAMPUNG",18,110,117,227
https://kawalpemilu.org#24854,"CIPADANG, GEDONG TATAAN, PESAWARAN, LAMPUNG",19,75,98,173
https://kawalpemilu.org#24854,"CIPADANG, GEDONG TATAAN, PESAWARAN, LAMPUNG",20,110,89,199
https://kawalpemilu.org#24854,"CIPADANG, GEDONG TATAAN, PESAWARAN, LAMPUNG",21,41,116,157
https://kawalpemilu.org#24854,"CIPADANG, GEDONG TATAAN, PESAWARAN, LAMPUNG",22,121,131,252
https://kawalpemilu.org#24854,"CIPADANG, GEDONG TATAAN, PESAWARAN, LAMPUNG",23,95,149,244
https://kawalpemilu.org#24854,"CIPADANG, GEDONG TATAAN, PESAWARAN, LAMPUNG",24,219,28,247
https://kawalpemilu.org#24855,"WAY LAYAP, GEDONG TATAAN, PESAWARAN, LAMPUNG",1,108,79,187
https://kawalpemilu.org#24855,"WAY LAYAP, GEDONG TATAAN, PESAWARAN, LAMPUNG",2,98,85,183
https://kawalpemilu.org#24855,"WAY LAYAP, GEDONG TATAAN, PESAWARAN, LAMPUNG",3,54,100,154
https://kawalpemilu.org#24855,"WAY LAYAP, GEDONG TATAAN, PESAWARAN, LAMPUNG",4,116,74,190
https://kawalpemilu.org#24855,"WAY LAYAP, GEDONG TATAAN, PESAWARAN, LAMPUNG",5,70,91,161
https://kawalpemilu.org#24855,"WAY LAYAP, GEDONG TATAAN, PESAWARAN, LAMPUNG",6,84,90,174
https://kawalpemilu.org#24855,"WAY LAYAP, GEDONG TATAAN, PESAWARAN, LAMPUNG",7,107,75,182
https://kawalpemilu.org#24855,"WAY LAYAP, GEDONG TATAAN, PESAWARAN, LAMPUNG",8,108,62,170
https://kawalpemilu.org#24855,"WAY LAYAP, GEDONG TATAAN, PESAWARAN, LAMPUNG",9,73,82,155
https://kawalpemilu.org#24855,"WAY LAYAP, GEDONG TATAAN, PESAWARAN, LAMPUNG",10,60,93,153
https://kawalpemilu.org#24855,"WAY LAYAP, GEDONG TATAAN, PESAWARAN, LAMPUNG",11,118,73,191
https://kawalpemilu.org#24855,"WAY LAYAP, GEDONG TATAAN, PESAWARAN, LAMPUNG",12,43,72,115
https://kawalpemilu.org#24856,"SUKADADI, GEDONG TATAAN, PESAWARAN, LAMPUNG",1,105,74,179
https://kawalpemilu.org#24856,"SUKADADI, GEDONG TATAAN, PESAWARAN, LAMPUNG",3,51,115,166
https://kawalpemilu.org#24856,"SUKADADI, GEDONG TATAAN, PESAWARAN, LAMPUNG",4,94,94,188
https://kawalpemilu.org#24856,"SUKADADI, GEDONG TATAAN, PESAWARAN, LAMPUNG",5,103,94,197
https://kawalpemilu.org#24856,"SUKADADI, GEDONG TATAAN, PESAWARAN, LAMPUNG",6,115,109,224
https://kawalpemilu.org#24856,"SUKADADI, GEDONG TATAAN, PESAWARAN, LAMPUNG",7,165,41,206
https://kawalpemilu.org#24856,"SUKADADI, GEDONG TATAAN, PESAWARAN, LAMPUNG",8,112,62,174
https://kawalpemilu.org#24856,"SUKADADI, GEDONG TATAAN, PESAWARAN, LAMPUNG",9,108,62,170
https://kawalpemilu.org#24856,"SUKADADI, GEDONG TATAAN, PESAWARAN, LAMPUNG",10,154,76,230
https://kawalpemilu.org#24856,"SUKADADI, GEDONG TATAAN, PESAWARAN, LAMPUNG",11,192,46,237
https://kawalpemilu.org#24856,"SUKADADI, GEDONG TATAAN, PESAWARAN, LAMPUNG",12,111,49,160
https://kawalpemilu.org#24856,"SUKADADI, GEDONG TATAAN, PESAWARAN, LAMPUNG",13,93,76,169
https://kawalpemilu.org#24856,"SUKADADI, GEDONG TATAAN, PESAWARAN, LAMPUNG",14,122,63,185
https://kawalpemilu.org#24856,"SUKADADI, GEDONG TATAAN, PESAWARAN, LAMPUNG",15,157,32,189
https://kawalpemilu.org#24856,"SUKADADI, GEDONG TATAAN, PESAWARAN, LAMPUNG",16,128,39,167
https://kawalpemilu.org#24856,"SUKADADI, GEDONG TATAAN, PESAWARAN, LAMPUNG",17,173,33,206
https://kawalpemilu.org#24857,"GEDONG TATAAN, GEDONG TATAAN, PESAWARAN, LAMPUNG",1,45,145,190
https://kawalpemilu.org#24857,"GEDONG TATAAN, GEDONG TATAAN, PESAWARAN, LAMPUNG",2,69,150,219
https://kawalpemilu.org#24857,"GEDONG TATAAN, GEDONG TATAAN, PESAWARAN, LAMPUNG",3,69,147,216
https://kawalpemilu.org#24857,"GEDONG TATAAN, GEDONG TATAAN, PESAWARAN, LAMPUNG",4,74,140,214
https://kawalpemilu.org#24857,"GEDONG TATAAN, GEDONG TATAAN, PESAWARAN, LAMPUNG",5,85,83,168
https://kawalpemilu.org#24857,"GEDONG TATAAN, GEDONG TATAAN, PESAWARAN, LAMPUNG",6,165,12,177
https://kawalpemilu.org#24857,"GEDONG TATAAN, GEDONG TATAAN, PESAWARAN, LAMPUNG",7,79,114,193
https://kawalpemilu.org#24857,"GEDONG TATAAN, GEDONG TATAAN, PESAWARAN, LAMPUNG",8,178,76,254
https://kawalpemilu.org#24857,"GEDONG TATAAN, GEDONG TATAAN, PESAWARAN, LAMPUNG",9,57,115,172
https://kawalpemilu.org#24857,"GEDONG TATAAN, GEDONG TATAAN, PESAWARAN, LAMPUNG",10,48,68,116
https://kawalpemilu.org#24857,"GEDONG TATAAN, GEDONG TATAAN, PESAWARAN, LAMPUNG",11,64,144,208
https://kawalpemilu.org#24857,"GEDONG TATAAN, GEDONG TATAAN, PESAWARAN, LAMPUNG",12,87,78,165
https://kawalpemilu.org#24857,"GEDONG TATAAN, GEDONG TATAAN, PESAWARAN, LAMPUNG",13,90,60,150
https://kawalpemilu.org#24857,"GEDONG TATAAN, GEDONG TATAAN, PESAWARAN, LAMPUNG",14,72,118,190
https://kawalpemilu.org#24857,"GEDONG TATAAN, GEDONG TATAAN, PESAWARAN, LAMPUNG",15,76,144,220
https://kawalpemilu.org#24858,"BAGELEN, GEDONG TATAAN, PESAWARAN, LAMPUNG",1,72,195,267
https://kawalpemilu.org#24858,"BAGELEN, GEDONG TATAAN, PESAWARAN, LAMPUNG",2,51,187,238
https://kawalpemilu.org#24858,"BAGELEN, GEDONG TATAAN, PESAWARAN, LAMPUNG",3,106,139,245
https://kawalpemilu.org#24858,"BAGELEN, GEDONG TATAAN, PESAWARAN, LAMPUNG",4,90,141,231
https://kawalpemilu.org#24858,"BAGELEN, GEDONG TATAAN, PESAWARAN, LAMPUNG",5,108,136,244
https://kawalpemilu.org#24858,"BAGELEN, GEDONG TATAAN, PESAWARAN, LAMPUNG",6,92,101,193
https://kawalpemilu.org#24858,"BAGELEN, GEDONG TATAAN, PESAWARAN, LAMPUNG",7,97,142,239
https://kawalpemilu.org#24858,"BAGELEN, GEDONG TATAAN, PESAWARAN, LAMPUNG",8,92,153,245
https://kawalpemilu.org#24858,"BAGELEN, GEDONG TATAAN, PESAWARAN, LAMPUNG",9,119,129,248
https://kawalpemilu.org#24858,"BAGELEN, GEDONG TATAAN, PESAWARAN, LAMPUNG",10,109,115,224
https://kawalpemilu.org#24858,"BAGELEN, GEDONG TATAAN, PESAWARAN, LAMPUNG",11,83,140,223
https://kawalpemilu.org#24858,"BAGELEN, GEDONG TATAAN, PESAWARAN, LAMPUNG",12,128,124,252
https://kawalpemilu.org#24858,"BAGELEN, GEDONG TATAAN, PESAWARAN, LAMPUNG",13,82,101,183
https://kawalpemilu.org#24858,"BAGELEN, GEDONG TATAAN, PESAWARAN, LAMPUNG",14,80,117,197
https://kawalpemilu.org#24858,"BAGELEN, GEDONG TATAAN, PESAWARAN, LAMPUNG",15,83,100,183
https://kawalpemilu.org#24858,"BAGELEN, GEDONG TATAAN, PESAWARAN, LAMPUNG",16,76,97,173
https://kawalpemilu.org#24858,"BAGELEN, GEDONG TATAAN, PESAWARAN, LAMPUNG",17,69,62,131
https://kawalpemilu.org#24858,"BAGELEN, GEDONG TATAAN, PESAWARAN, LAMPUNG",18,55,124,179
https://kawalpemilu.org#24858,"BAGELEN, GEDONG TATAAN, PESAWARAN, LAMPUNG",19,98,87,185
https://kawalpemilu.org#24858,"BAGELEN, GEDONG TATAAN, PESAWARAN, LAMPUNG",20,125,101,226
https://kawalpemilu.org#24858,"BAGELEN, GEDONG TATAAN, PESAWARAN, LAMPUNG",21,60,77,137
https://kawalpemilu.org#24858,"BAGELEN, GEDONG TATAAN, PESAWARAN, LAMPUNG",22,79,98,177
https://kawalpemilu.org#24859,"SUKARAJA, GEDONG TATAAN, PESAWARAN, LAMPUNG",1,67,113,180
https://kawalpemilu.org#24859,"SUKARAJA, GEDONG TATAAN, PESAWARAN, LAMPUNG",2,58,100,158
https://kawalpemilu.org#24859,"SUKARAJA, GEDONG TATAAN, PESAWARAN, LAMPUNG",3,36,88,124
https://kawalpemilu.org#24859,"SUKARAJA, GEDONG TATAAN, PESAWARAN, LAMPUNG",4,59,114,173
https://kawalpemilu.org#24859,"SUKARAJA, GEDONG TATAAN, PESAWARAN, LAMPUNG",5,45,128,173
https://kawalpemilu.org#24859,"SUKARAJA, GEDONG TATAAN, PESAWARAN, LAMPUNG",6,56,123,179
https://kawalpemilu.org#24859,"SUKARAJA, GEDONG TATAAN, PESAWARAN, LAMPUNG",7,27,93,120
https://kawalpemilu.org#24859,"SUKARAJA, GEDONG TATAAN, PESAWARAN, LAMPUNG",8,52,85,137
https://kawalpemilu.org#24859,"SUKARAJA, GEDONG TATAAN, PESAWARAN, LAMPUNG",9,48,65,113
https://kawalpemilu.org#24859,"SUKARAJA, GEDONG TATAAN, PESAWARAN, LAMPUNG",10,91,121,212
https://kawalpemilu.org#24859,"SUKARAJA, GEDONG TATAAN, PESAWARAN, LAMPUNG",11,104,129,233
https://kawalpemilu.org#24859,"SUKARAJA, GEDONG TATAAN, PESAWARAN, LAMPUNG",13,95,115,210
https://kawalpemilu.org#24859,"SUKARAJA, GEDONG TATAAN, PESAWARAN, LAMPUNG",14,117,93,210
https://kawalpemilu.org#24859,"SUKARAJA, GEDONG TATAAN, PESAWARAN, LAMPUNG",15,93,70,163
https://kawalpemilu.org#24859,"SUKARAJA, GEDONG TATAAN, PESAWARAN, LAMPUNG",16,112,43,155
https://kawalpemilu.org#24859,"SUKARAJA, GEDONG TATAAN, PESAWARAN, LAMPUNG",17,69,106,175
https://kawalpemilu.org#24859,"SUKARAJA, GEDONG TATAAN, PESAWARAN, LAMPUNG",18,59,104,163
https://kawalpemilu.org#24859,"SUKARAJA, GEDONG TATAAN, PESAWARAN, LAMPUNG",19,76,105,181
https://kawalpemilu.org#24859,"SUKARAJA, GEDONG TATAAN, PESAWARAN, LAMPUNG",20,117,133,250
https://kawalpemilu.org#24859,"SUKARAJA, GEDONG TATAAN, PESAWARAN, LAMPUNG",21,58,126,184
https://kawalpemilu.org#24859,"SUKARAJA, GEDONG TATAAN, PESAWARAN, LAMPUNG",22,52,134,186
https://kawalpemilu.org#24859,"SUKARAJA, GEDONG TATAAN, PESAWARAN, LAMPUNG",23,0,0,0
https://kawalpemilu.org#24859,"SUKARAJA, GEDONG TATAAN, PESAWARAN, LAMPUNG",24,50,133,183
https://kawalpemilu.org#24859,"SUKARAJA, GEDONG TATAAN, PESAWARAN, LAMPUNG",25,67,165,232
https://kawalpemilu.org#24859,"SUKARAJA, GEDONG TATAAN, PESAWARAN, LAMPUNG",26,73,104,177
https://kawalpemilu.org#24859,"SUKARAJA, GEDONG TATAAN, PESAWARAN, LAMPUNG",27,74,135,209
https://kawalpemilu.org#24859,"SUKARAJA, GEDONG TATAAN, PESAWARAN, LAMPUNG",28,57,119,176
https://kawalpemilu.org#24859,"SUKARAJA, GEDONG TATAAN, PESAWARAN, LAMPUNG",29,66,132,198
https://kawalpemilu.org#24860,"KEBAGUSAN, GEDONG TATAAN, PESAWARAN, LAMPUNG",1,36,179,215
https://kawalpemilu.org#24860,"KEBAGUSAN, GEDONG TATAAN, PESAWARAN, LAMPUNG",2,42,188,230
https://kawalpemilu.org#24860,"KEBAGUSAN, GEDONG TATAAN, PESAWARAN, LAMPUNG",3,54,141,195
https://kawalpemilu.org#24860,"KEBAGUSAN, GEDONG TATAAN, PESAWARAN, LAMPUNG",4,50,132,182
https://kawalpemilu.org#24860,"KEBAGUSAN, GEDONG TATAAN, PESAWARAN, LAMPUNG",5,59,134,193
https://kawalpemilu.org#24860,"KEBAGUSAN, GEDONG TATAAN, PESAWARAN, LAMPUNG",6,69,78,147
https://kawalpemilu.org#24860,"KEBAGUSAN, GEDONG TATAAN, PESAWARAN, LAMPUNG",7,131,141,272
https://kawalpemilu.org#24860,"KEBAGUSAN, GEDONG TATAAN, PESAWARAN, LAMPUNG",8,83,145,228
https://kawalpemilu.org#24860,"KEBAGUSAN, GEDONG TATAAN, PESAWARAN, LAMPUNG",9,73,158,231
https://kawalpemilu.org#24860,"KEBAGUSAN, GEDONG TATAAN, PESAWARAN, LAMPUNG",10,89,154,243
https://kawalpemilu.org#24860,"KEBAGUSAN, GEDONG TATAAN, PESAWARAN, LAMPUNG",11,78,142,220
https://kawalpemilu.org#24860,"KEBAGUSAN, GEDONG TATAAN, PESAWARAN, LAMPUNG",12,152,79,231
https://kawalpemilu.org#24860,"KEBAGUSAN, GEDONG TATAAN, PESAWARAN, LAMPUNG",13,104,76,180
https://kawalpemilu.org#24860,"KEBAGUSAN, GEDONG TATAAN, PESAWARAN, LAMPUNG",14,166,104,270
https://kawalpemilu.org#24860,"KEBAGUSAN, GEDONG TATAAN, PESAWARAN, LAMPUNG",15,100,92,192
https://kawalpemilu.org#24860,"KEBAGUSAN, GEDONG TATAAN, PESAWARAN, LAMPUNG",16,74,60,134
https://kawalpemilu.org#24860,"KEBAGUSAN, GEDONG TATAAN, PESAWARAN, LAMPUNG",17,33,109,142
https://kawalpemilu.org#24860,"KEBAGUSAN, GEDONG TATAAN, PESAWARAN, LAMPUNG",18,9,96,105
https://kawalpemilu.org#24860,"KEBAGUSAN, GEDONG TATAAN, PESAWARAN, LAMPUNG",19,97,113,210
https://kawalpemilu.org#24860,"KEBAGUSAN, GEDONG TATAAN, PESAWARAN, LAMPUNG",20,62,109,171
https://kawalpemilu.org#24860,"KEBAGUSAN, GEDONG TATAAN, PESAWARAN, LAMPUNG",21,89,53,142
https://kawalpemilu.org#24860,"KEBAGUSAN, GEDONG TATAAN, PESAWARAN, LAMPUNG",22,189,29,218
https://kawalpemilu.org#24861,"SUNGAI LANGKA, GEDONG TATAAN, PESAWARAN, LAMPUNG",1,99,87,186
https://kawalpemilu.org#24861,"SUNGAI LANGKA, GEDONG TATAAN, PESAWARAN, LAMPUNG",2,94,132,226
https://kawalpemilu.org#24861,"SUNGAI LANGKA, GEDONG TATAAN, PESAWARAN, LAMPUNG",3,95,82,177
https://kawalpemilu.org#24861,"SUNGAI LANGKA, GEDONG TATAAN, PESAWARAN, LAMPUNG",4,144,98,242
https://kawalpemilu.org#24861,"SUNGAI LANGKA, GEDONG TATAAN, PESAWARAN, LAMPUNG",5,140,105,245
https://kawalpemilu.org#24861,"SUNGAI LANGKA, GEDONG TATAAN, PESAWARAN, LAMPUNG",6,130,86,216
https://kawalpemilu.org#24861,"SUNGAI LANGKA, GEDONG TATAAN, PESAWARAN, LAMPUNG",7,94,122,216
https://kawalpemilu.org#24861,"SUNGAI LANGKA, GEDONG TATAAN, PESAWARAN, LAMPUNG",8,127,99,226
https://kawalpemilu.org#24861,"SUNGAI LANGKA, GEDONG TATAAN, PESAWARAN, LAMPUNG",9,65,102,167
https://kawalpemilu.org#24861,"SUNGAI LANGKA, GEDONG TATAAN, PESAWARAN, LAMPUNG",10,118,117,235
https://kawalpemilu.org#24861,"SUNGAI LANGKA, GEDONG TATAAN, PESAWARAN, LAMPUNG",11,102,57,159
https://kawalpemilu.org#24861,"SUNGAI LANGKA, GEDONG TATAAN, PESAWARAN, LAMPUNG",12,143,41,184
https://kawalpemilu.org#24861,"SUNGAI LANGKA, GEDONG TATAAN, PESAWARAN, LAMPUNG",13,96,69,165
https://kawalpemilu.org#24861,"SUNGAI LANGKA, GEDONG TATAAN, PESAWARAN, LAMPUNG",14,110,91,201
https://kawalpemilu.org#24861,"SUNGAI LANGKA, GEDONG TATAAN, PESAWARAN, LAMPUNG",15,73,83,156
https://kawalpemilu.org#24861,"SUNGAI LANGKA, GEDONG TATAAN, PESAWARAN, LAMPUNG",16,108,114,222
https://kawalpemilu.org#24861,"SUNGAI LANGKA, GEDONG TATAAN, PESAWARAN, LAMPUNG",17,77,84,161
https://kawalpemilu.org#24861,"SUNGAI LANGKA, GEDONG TATAAN, PESAWARAN, LAMPUNG",18,135,110,245
https://kawalpemilu.org#24862,"KURUNGAN NYAWA, GEDONG TATAAN, PESAWARAN, LAMPUNG",1,94,112,206
https://kawalpemilu.org#24862,"KURUNGAN NYAWA, GEDONG TATAAN, PESAWARAN, LAMPUNG",3,49,109,158
https://kawalpemilu.org#24862,"KURUNGAN NYAWA, GEDONG TATAAN, PESAWARAN, LAMPUNG",4,61,132,193
https://kawalpemilu.org#24862,"KURUNGAN NYAWA, GEDONG TATAAN, PESAWARAN, LAMPUNG",5,55,126,181
https://kawalpemilu.org#24862,"KURUNGAN NYAWA, GEDONG TATAAN, PESAWARAN, LAMPUNG",6,82,208,290
https://kawalpemilu.org#24862,"KURUNGAN NYAWA, GEDONG TATAAN, PESAWARAN, LAMPUNG",7,0,0,256
https://kawalpemilu.org#24862,"KURUNGAN NYAWA, GEDONG TATAAN, PESAWARAN, LAMPUNG",8,103,124,227
https://kawalpemilu.org#24862,"KURUNGAN NYAWA, GEDONG TATAAN, PESAWARAN, LAMPUNG",9,93,39,132
https://kawalpemilu.org#24862,"KURUNGAN NYAWA, GEDONG TATAAN, PESAWARAN, LAMPUNG",10,62,136,198
https://kawalpemilu.org#24862,"KURUNGAN NYAWA, GEDONG TATAAN, PESAWARAN, LAMPUNG",12,51,167,218
https://kawalpemilu.org#24862,"KURUNGAN NYAWA, GEDONG TATAAN, PESAWARAN, LAMPUNG",13,80,133,213
https://kawalpemilu.org#24862,"KURUNGAN NYAWA, GEDONG TATAAN, PESAWARAN, LAMPUNG",14,64,179,243
https://kawalpemilu.org#24862,"KURUNGAN NYAWA, GEDONG TATAAN, PESAWARAN, LAMPUNG",15,96,118,214
https://kawalpemilu.org#24862,"KURUNGAN NYAWA, GEDONG TATAAN, PESAWARAN, LAMPUNG",16,70,51,110
https://kawalpemilu.org#24862,"KURUNGAN NYAWA, GEDONG TATAAN, PESAWARAN, LAMPUNG",17,28,18,46
https://kawalpemilu.org#24863,"NEGERI SAKTI, GEDONG TATAAN, PESAWARAN, LAMPUNG",1,50,198,248
https://kawalpemilu.org#24863,"NEGERI SAKTI, GEDONG TATAAN, PESAWARAN, LAMPUNG",2,90,158,248
https://kawalpemilu.org#24863,"NEGERI SAKTI, GEDONG TATAAN, PESAWARAN, LAMPUNG",3,40,115,155
https://kawalpemilu.org#24863,"NEGERI SAKTI, GEDONG TATAAN, PESAWARAN, LAMPUNG",4,41,145,186
https://kawalpemilu.org#24863,"NEGERI SAKTI, GEDONG TATAAN, PESAWARAN, LAMPUNG",5,99,182,281
https://kawalpemilu.org#24863,"NEGERI SAKTI, GEDONG TATAAN, PESAWARAN, LAMPUNG",6,57,161,218
https://kawalpemilu.org#24863,"NEGERI SAKTI, GEDONG TATAAN, PESAWARAN, LAMPUNG",7,51,157,208
https://kawalpemilu.org#24863,"NEGERI SAKTI, GEDONG TATAAN, PESAWARAN, LAMPUNG",8,50,125,175
https://kawalpemilu.org#24863,"NEGERI SAKTI, GEDONG TATAAN, PESAWARAN, LAMPUNG",9,61,111,172
https://kawalpemilu.org#24863,"NEGERI SAKTI, GEDONG TATAAN, PESAWARAN, LAMPUNG",10,0,0,0
https://kawalpemilu.org#24863,"NEGERI SAKTI, GEDONG TATAAN, PESAWARAN, LAMPUNG",11,48,98,146
https://kawalpemilu.org#24863,"NEGERI SAKTI, GEDONG TATAAN, PESAWARAN, LAMPUNG",12,15,118,133
https://kawalpemilu.org#24863,"NEGERI SAKTI, GEDONG TATAAN, PESAWARAN, LAMPUNG",13,54,122,176
https://kawalpemilu.org#24863,"NEGERI SAKTI, GEDONG TATAAN, PESAWARAN, LAMPUNG",14,0,0,0
https://kawalpemilu.org#24863,"NEGERI SAKTI, GEDONG TATAAN, PESAWARAN, LAMPUNG",15,35,138,173
https://kawalpemilu.org#24863,"NEGERI SAKTI, GEDONG TATAAN, PESAWARAN, LAMPUNG",16,87,107,194
https://kawalpemilu.org#24864,"BERNUNG, GEDONG TATAAN, PESAWARAN, LAMPUNG",1,85,157,242
https://kawalpemilu.org#24864,"BERNUNG, GEDONG TATAAN, PESAWARAN, LAMPUNG",2,90,144,234
https://kawalpemilu.org#24864,"BERNUNG, GEDONG TATAAN, PESAWARAN, LAMPUNG",3,74,175,249
https://kawalpemilu.org#24864,"BERNUNG, GEDONG TATAAN, PESAWARAN, LAMPUNG",4,90,134,224
https://kawalpemilu.org#24864,"BERNUNG, GEDONG TATAAN, PESAWARAN, LAMPUNG",5,112,106,218
https://kawalpemilu.org#24864,"BERNUNG, GEDONG TATAAN, PESAWARAN, LAMPUNG",6,110,75,185
https://kawalpemilu.org#24864,"BERNUNG, GEDONG TATAAN, PESAWARAN, LAMPUNG",7,114,121,235
https://kawalpemilu.org#24864,"BERNUNG, GEDONG TATAAN, PESAWARAN, LAMPUNG",8,59,174,233
https://kawalpemilu.org#24864,"BERNUNG, GEDONG TATAAN, PESAWARAN, LAMPUNG",9,91,147,238
https://kawalpemilu.org#24864,"BERNUNG, GEDONG TATAAN, PESAWARAN, LAMPUNG",10,89,97,186
https://kawalpemilu.org#24864,"BERNUNG, GEDONG TATAAN, PESAWARAN, LAMPUNG",12,89,81,170
https://kawalpemilu.org#24864,"BERNUNG, GEDONG TATAAN, PESAWARAN, LAMPUNG",13,106,157,263
https://kawalpemilu.org#24865,"SUKA BANJAR, GEDONG TATAAN, PESAWARAN, LAMPUNG",1,72,155,227
https://kawalpemilu.org#24865,"SUKA BANJAR, GEDONG TATAAN, PESAWARAN, LAMPUNG",2,132,71,203
https://kawalpemilu.org#24865,"SUKA BANJAR, GEDONG TATAAN, PESAWARAN, LAMPUNG",3,134,104,238
https://kawalpemilu.org#24865,"SUKA BANJAR, GEDONG TATAAN, PESAWARAN, LAMPUNG",5,99,139,238
https://kawalpemilu.org#24865,"SUKA BANJAR, GEDONG TATAAN, PESAWARAN, LAMPUNG",6,111,111,222
https://kawalpemilu.org#24865,"SUKA BANJAR, GEDONG TATAAN, PESAWARAN, LAMPUNG",7,104,65,169
https://kawalpemilu.org#24865,"SUKA BANJAR, GEDONG TATAAN, PESAWARAN, LAMPUNG",8,137,98,235
https://kawalpemilu.org#24866,"WIYONO, GEDONG TATAAN, PESAWARAN, LAMPUNG",1,123,68,191
https://kawalpemilu.org#24866,"WIYONO, GEDONG TATAAN, PESAWARAN, LAMPUNG",2,102,59,161
https://kawalpemilu.org#24866,"WIYONO, GEDONG TATAAN, PESAWARAN, LAMPUNG",3,104,40,144
https://kawalpemilu.org#24866,"WIYONO, GEDONG TATAAN, PESAWARAN, LAMPUNG",4,33,109,142
https://kawalpemilu.org#24866,"WIYONO, GEDONG TATAAN, PESAWARAN, LAMPUNG",6,63,144,207
https://kawalpemilu.org#24866,"WIYONO, GEDONG TATAAN, PESAWARAN, LAMPUNG",7,109,143,252
https://kawalpemilu.org#24866,"WIYONO, GEDONG TATAAN, PESAWARAN, LAMPUNG",8,161,70,231
https://kawalpemilu.org#24866,"WIYONO, GEDONG TATAAN, PESAWARAN, LAMPUNG",9,0,0,0
https://kawalpemilu.org#24866,"WIYONO, GEDONG TATAAN, PESAWARAN, LAMPUNG",10,125,105,230
https://kawalpemilu.org#24866,"WIYONO, GEDONG TATAAN, PESAWARAN, LAMPUNG",11,130,121,251
https://kawalpemilu.org#24866,"WIYONO, GEDONG TATAAN, PESAWARAN, LAMPUNG",12,119,133,252
https://kawalpemilu.org#24866,"WIYONO, GEDONG TATAAN, PESAWARAN, LAMPUNG",13,146,76,222
https://kawalpemilu.org#24866,"WIYONO, GEDONG TATAAN, PESAWARAN, LAMPUNG",15,184,84,268
https://kawalpemilu.org#24866,"WIYONO, GEDONG TATAAN, PESAWARAN, LAMPUNG",16,190,79,269
https://kawalpemilu.org#24866,"WIYONO, GEDONG TATAAN, PESAWARAN, LAMPUNG",17,107,96,203
https://kawalpemilu.org#24866,"WIYONO, GEDONG TATAAN, PESAWARAN, LAMPUNG",18,41,78,119
https://kawalpemilu.org#24866,"WIYONO, GEDONG TATAAN, PESAWARAN, LAMPUNG",19,108,107,215
https://kawalpemilu.org#24866,"WIYONO, GEDONG TATAAN, PESAWARAN, LAMPUNG",20,174,48,222
https://kawalpemilu.org#24866,"WIYONO, GEDONG TATAAN, PESAWARAN, LAMPUNG",21,205,49,254
https://kawalpemilu.org#24866,"WIYONO, GEDONG TATAAN, PESAWARAN, LAMPUNG",22,135,11,146
https://kawalpemilu.org#24867,"TAMAN SARI, GEDONG TATAAN, PESAWARAN, LAMPUNG",1,130,129,259
https://kawalpemilu.org#24867,"TAMAN SARI, GEDONG TATAAN, PESAWARAN, LAMPUNG",2,74,108,182
https://kawalpemilu.org#24867,"TAMAN SARI, GEDONG TATAAN, PESAWARAN, LAMPUNG",3,117,99,216
https://kawalpemilu.org#24867,"TAMAN SARI, GEDONG TATAAN, PESAWARAN, LAMPUNG",4,82,120,202
https://kawalpemilu.org#24867,"TAMAN SARI, GEDONG TATAAN, PESAWARAN, LAMPUNG",5,101,100,201
https://kawalpemilu.org#24867,"TAMAN SARI, GEDONG TATAAN, PESAWARAN, LAMPUNG",6,127,79,206
https://kawalpemilu.org#24867,"TAMAN SARI, GEDONG TATAAN, PESAWARAN, LAMPUNG",7,111,111,222
https://kawalpemilu.org#24867,"TAMAN SARI, GEDONG TATAAN, PESAWARAN, LAMPUNG",8,103,113,216
https://kawalpemilu.org#24867,"TAMAN SARI, GEDONG TATAAN, PESAWARAN, LAMPUNG",9,84,132,216
https://kawalpemilu.org#24867,"TAMAN SARI, GEDONG TATAAN, PESAWARAN, LAMPUNG",10,120,69,189
https://kawalpemilu.org#24867,"TAMAN SARI, GEDONG TATAAN, PESAWARAN, LAMPUNG",11,113,85,198
https://kawalpemilu.org#24867,"TAMAN SARI, GEDONG TATAAN, PESAWARAN, LAMPUNG",12,89,98,187
https://kawalpemilu.org#24867,"TAMAN SARI, GEDONG TATAAN, PESAWARAN, LAMPUNG",13,84,83,167
https://kawalpemilu.org#24867,"TAMAN SARI, GEDONG TATAAN, PESAWARAN, LAMPUNG",14,106,109,215
https://kawalpemilu.org#24867,"TAMAN SARI, GEDONG TATAAN, PESAWARAN, LAMPUNG",15,122,87,209
https://kawalpemilu.org#24867,"TAMAN SARI, GEDONG TATAAN, PESAWARAN, LAMPUNG",16,120,118,238
https://kawalpemilu.org#24867,"TAMAN SARI, GEDONG TATAAN, PESAWARAN, LAMPUNG",17,62,87,149
https://kawalpemilu.org#24867,"TAMAN SARI, GEDONG TATAAN, PESAWARAN, LAMPUNG",18,81,71,152
https://kawalpemilu.org#24868,"BOGOREJO, GEDONG TATAAN, PESAWARAN, LAMPUNG",1,129,72,201
https://kawalpemilu.org#24868,"BOGOREJO, GEDONG TATAAN, PESAWARAN, LAMPUNG",2,113,90,203
https://kawalpemilu.org#24868,"BOGOREJO, GEDONG TATAAN, PESAWARAN, LAMPUNG",3,138,83,221
https://kawalpemilu.org#24868,"BOGOREJO, GEDONG TATAAN, PESAWARAN, LAMPUNG",4,140,67,207
https://kawalpemilu.org#24868,"BOGOREJO, GEDONG TATAAN, PESAWARAN, LAMPUNG",5,121,67,188
https://kawalpemilu.org#24868,"BOGOREJO, GEDONG TATAAN, PESAWARAN, LAMPUNG",6,100,91,191
https://kawalpemilu.org#24868,"BOGOREJO, GEDONG TATAAN, PESAWARAN, LAMPUNG",7,91,76,167
https://kawalpemilu.org#24868,"BOGOREJO, GEDONG TATAAN, PESAWARAN, LAMPUNG",8,143,60,203
https://kawalpemilu.org#24868,"BOGOREJO, GEDONG TATAAN, PESAWARAN, LAMPUNG",9,152,52,204
https://kawalpemilu.org#24868,"BOGOREJO, GEDONG TATAAN, PESAWARAN, LAMPUNG",10,167,69,236
https://kawalpemilu.org#24868,"BOGOREJO, GEDONG TATAAN, PESAWARAN, LAMPUNG",11,143,63,206
https://kawalpemilu.org#24868,"BOGOREJO, GEDONG TATAAN, PESAWARAN, LAMPUNG",13,164,55,219
https://kawalpemilu.org#24868,"BOGOREJO, GEDONG TATAAN, PESAWARAN, LAMPUNG",14,217,26,243
https://kawalpemilu.org#24869,"KARANG ANYAR, GEDONG TATAAN, PESAWARAN, LAMPUNG",1,83,126,209
https://kawalpemilu.org#24869,"KARANG ANYAR, GEDONG TATAAN, PESAWARAN, LAMPUNG",2,99,106,205
https://kawalpemilu.org#24869,"KARANG ANYAR, GEDONG TATAAN, PESAWARAN, LAMPUNG",3,87,125,212
https://kawalpemilu.org#24869,"KARANG ANYAR, GEDONG TATAAN, PESAWARAN, LAMPUNG",4,117,120,237
https://kawalpemilu.org#24869,"KARANG ANYAR, GEDONG TATAAN, PESAWARAN, LAMPUNG",5,92,139,231
https://kawalpemilu.org#24869,"KARANG ANYAR, GEDONG TATAAN, PESAWARAN, LAMPUNG",6,100,118,218
https://kawalpemilu.org#24869,"KARANG ANYAR, GEDONG TATAAN, PESAWARAN, LAMPUNG",7,62,141,203
https://kawalpemilu.org#24869,"KARANG ANYAR, GEDONG TATAAN, PESAWARAN, LAMPUNG",8,49,150,199
https://kawalpemilu.org#24869,"KARANG ANYAR, GEDONG TATAAN, PESAWARAN, LAMPUNG",9,56,100,156
https://kawalpemilu.org#24869,"KARANG ANYAR, GEDONG TATAAN, PESAWARAN, LAMPUNG",10,28,166,194
https://kawalpemilu.org#24870,"KUTOARJO, GEDONG TATAAN, PESAWARAN, LAMPUNG",1,95,100,195
https://kawalpemilu.org#24870,"KUTOARJO, GEDONG TATAAN, PESAWARAN, LAMPUNG",2,109,134,243
https://kawalpemilu.org#24870,"KUTOARJO, GEDONG TATAAN, PESAWARAN, LAMPUNG",3,77,101,178
https://kawalpemilu.org#24870,"KUTOARJO, GEDONG TATAAN, PESAWARAN, LAMPUNG",4,94,87,181
https://kawalpemilu.org#24870,"KUTOARJO, GEDONG TATAAN, PESAWARAN, LAMPUNG",5,73,69,142
https://kawalpemilu.org#24870,"KUTOARJO, GEDONG TATAAN, PESAWARAN, LAMPUNG",6,161,65,226
https://kawalpemilu.org#24870,"KUTOARJO, GEDONG TATAAN, PESAWARAN, LAMPUNG",7,51,81,132
https://kawalpemilu.org#24870,"KUTOARJO, GEDONG TATAAN, PESAWARAN, LAMPUNG",8,71,84,155
https://kawalpemilu.org#24870,"KUTOARJO, GEDONG TATAAN, PESAWARAN, LAMPUNG",9,95,123,218
https://kawalpemilu.org#24870,"KUTOARJO, GEDONG TATAAN, PESAWARAN, LAMPUNG",10,181,89,270
https://kawalpemilu.org#24872,"KAGUNGAN RATU, NEGERI KATON, PESAWARAN, LAMPUNG",1,20,135,155
https://kawalpemilu.org#24872,"KAGUNGAN RATU, NEGERI KATON, PESAWARAN, LAMPUNG",2,24,195,219
https://kawalpemilu.org#24872,"KAGUNGAN RATU, NEGERI KATON, PESAWARAN, LAMPUNG",3,120,81,201
https://kawalpemilu.org#24872,"KAGUNGAN RATU, NEGERI KATON, PESAWARAN, LAMPUNG",4,38,133,171
https://kawalpemilu.org#24872,"KAGUNGAN RATU, NEGERI KATON, PESAWARAN, LAMPUNG",5,110,61,171
https://kawalpemilu.org#24873,"KALI REJO, NEGERI KATON, PESAWARAN, LAMPUNG",1,119,139,258
https://kawalpemilu.org#24873,"KALI REJO, NEGERI KATON, PESAWARAN, LAMPUNG",2,84,133,217
https://kawalpemilu.org#24873,"KALI REJO, NEGERI KATON, PESAWARAN, LAMPUNG",3,98,133,231
https://kawalpemilu.org#24873,"KALI REJO, NEGERI KATON, PESAWARAN, LAMPUNG",4,128,58,181
https://kawalpemilu.org#24873,"KALI REJO, NEGERI KATON, PESAWARAN, LAMPUNG",5,134,68,202
https://kawalpemilu.org#24873,"KALI REJO, NEGERI KATON, PESAWARAN, LAMPUNG",6,109,118,225
https://kawalpemilu.org#24873,"KALI REJO, NEGERI KATON, PESAWARAN, LAMPUNG",7,125,59,184
https://kawalpemilu.org#24873,"KALI REJO, NEGERI KATON, PESAWARAN, LAMPUNG",8,158,92,250
https://kawalpemilu.org#24873,"KALI REJO, NEGERI KATON, PESAWARAN, LAMPUNG",9,93,154,247
https://kawalpemilu.org#24873,"KALI REJO, NEGERI KATON, PESAWARAN, LAMPUNG",10,100,179,279
https://kawalpemilu.org#24873,"KALI REJO, NEGERI KATON, PESAWARAN, LAMPUNG",11,132,52,184
https://kawalpemilu.org#24873,"KALI REJO, NEGERI KATON, PESAWARAN, LAMPUNG",12,118,64,182
https://kawalpemilu.org#24873,"KALI REJO, NEGERI KATON, PESAWARAN, LAMPUNG",13,100,62,162
https://kawalpemilu.org#24874,"PURWOREJO, NEGERI KATON, PESAWARAN, LAMPUNG",3,52,117,169
https://kawalpemilu.org#24874,"PURWOREJO, NEGERI KATON, PESAWARAN, LAMPUNG",4,34,126,160
https://kawalpemilu.org#24874,"PURWOREJO, NEGERI KATON, PESAWARAN, LAMPUNG",5,90,98,188
https://kawalpemilu.org#24874,"PURWOREJO, NEGERI KATON, PESAWARAN, LAMPUNG",6,102,130,232
https://kawalpemilu.org#24874,"PURWOREJO, NEGERI KATON, PESAWARAN, LAMPUNG",7,85,138,223
https://kawalpemilu.org#24874,"PURWOREJO, NEGERI KATON, PESAWARAN, LAMPUNG",8,65,105,170
https://kawalpemilu.org#24874,"PURWOREJO, NEGERI KATON, PESAWARAN, LAMPUNG",9,76,100,176
https://kawalpemilu.org#24875,"PUJO RAHAYU, NEGERI KATON, PESAWARAN, LAMPUNG",1,87,81,168
https://kawalpemilu.org#24875,"PUJO RAHAYU, NEGERI KATON, PESAWARAN, LAMPUNG",2,91,68,159
https://kawalpemilu.org#24875,"PUJO RAHAYU, NEGERI KATON, PESAWARAN, LAMPUNG",3,118,60,178
https://kawalpemilu.org#24875,"PUJO RAHAYU, NEGERI KATON, PESAWARAN, LAMPUNG",4,104,40,144
https://kawalpemilu.org#24875,"PUJO RAHAYU, NEGERI KATON, PESAWARAN, LAMPUNG",5,98,67,165
https://kawalpemilu.org#24875,"PUJO RAHAYU, NEGERI KATON, PESAWARAN, LAMPUNG",6,120,45,165
https://kawalpemilu.org#24875,"PUJO RAHAYU, NEGERI KATON, PESAWARAN, LAMPUNG",7,106,77,183
https://kawalpemilu.org#24875,"PUJO RAHAYU, NEGERI KATON, PESAWARAN, LAMPUNG",8,88,102,190
https://kawalpemilu.org#24875,"PUJO RAHAYU, NEGERI KATON, PESAWARAN, LAMPUNG",9,135,39,174
https://kawalpemilu.org#24875,"PUJO RAHAYU, NEGERI KATON, PESAWARAN, LAMPUNG",10,139,53,192
https://kawalpemilu.org#24875,"PUJO RAHAYU, NEGERI KATON, PESAWARAN, LAMPUNG",11,116,32,148
https://kawalpemilu.org#24875,"PUJO RAHAYU, NEGERI KATON, PESAWARAN, LAMPUNG",12,91,35,126
https://kawalpemilu.org#24876,"NEGERI KATON, NEGERI KATON, PESAWARAN, LAMPUNG",1,69,115,184
https://kawalpemilu.org#24876,"NEGERI KATON, NEGERI KATON, PESAWARAN, LAMPUNG",2,84,120,204
https://kawalpemilu.org#24876,"NEGERI KATON, NEGERI KATON, PESAWARAN, LAMPUNG",3,76,127,203
https://kawalpemilu.org#24876,"NEGERI KATON, NEGERI KATON, PESAWARAN, LAMPUNG",4,87,169,256
https://kawalpemilu.org#24876,"NEGERI KATON, NEGERI KATON, PESAWARAN, LAMPUNG",5,68,163,231
https://kawalpemilu.org#24876,"NEGERI KATON, NEGERI KATON, PESAWARAN, LAMPUNG",6,91,93,184
https://kawalpemilu.org#24876,"NEGERI KATON, NEGERI KATON, PESAWARAN, LAMPUNG",7,50,143,193
https://kawalpemilu.org#24876,"NEGERI KATON, NEGERI KATON, PESAWARAN, LAMPUNG",8,51,126,177
https://kawalpemilu.org#24876,"NEGERI KATON, NEGERI KATON, PESAWARAN, LAMPUNG",9,74,125,199
https://kawalpemilu.org#24877,"PONCO KRESNO, NEGERI KATON, PESAWARAN, LAMPUNG",1,166,47,213
https://kawalpemilu.org#24877,"PONCO KRESNO, NEGERI KATON, PESAWARAN, LAMPUNG",2,114,47,161
https://kawalpemilu.org#24877,"PONCO KRESNO, NEGERI KATON, PESAWARAN, LAMPUNG",3,138,37,175
https://kawalpemilu.org#24877,"PONCO KRESNO, NEGERI KATON, PESAWARAN, LAMPUNG",4,120,31,151
https://kawalpemilu.org#24877,"PONCO KRESNO, NEGERI KATON, PESAWARAN, LAMPUNG",5,159,29,188
https://kawalpemilu.org#24877,"PONCO KRESNO, NEGERI KATON, PESAWARAN, LAMPUNG",6,158,21,179
https://kawalpemilu.org#24877,"PONCO KRESNO, NEGERI KATON, PESAWARAN, LAMPUNG",7,142,30,172
https://kawalpemilu.org#24877,"PONCO KRESNO, NEGERI KATON, PESAWARAN, LAMPUNG",8,169,52,221
https://kawalpemilu.org#24877,"PONCO KRESNO, NEGERI KATON, PESAWARAN, LAMPUNG",9,173,40,213
https://kawalpemilu.org#24877,"PONCO KRESNO, NEGERI KATON, PESAWARAN, LAMPUNG",10,157,10,167
https://kawalpemilu.org#24877,"PONCO KRESNO, NEGERI KATON, PESAWARAN, LAMPUNG",11,93,17,110
https://kawalpemilu.org#24877,"PONCO KRESNO, NEGERI KATON, PESAWARAN, LAMPUNG",12,185,51,236
https://kawalpemilu.org#24877,"PONCO KRESNO, NEGERI KATON, PESAWARAN, LAMPUNG",13,95,38,133
https://kawalpemilu.org#24877,"PONCO KRESNO, NEGERI KATON, PESAWARAN, LAMPUNG",14,146,48,194
https://kawalpemilu.org#24877,"PONCO KRESNO, NEGERI KATON, PESAWARAN, LAMPUNG",15,141,26,167
https://kawalpemilu.org#24877,"PONCO KRESNO, NEGERI KATON, PESAWARAN, LAMPUNG",16,179,27,206
https://kawalpemilu.org#24877,"PONCO KRESNO, NEGERI KATON, PESAWARAN, LAMPUNG",17,148,47,195
https://kawalpemilu.org#24877,"PONCO KRESNO, NEGERI KATON, PESAWARAN, LAMPUNG",18,153,23,176
https://kawalpemilu.org#24878,"HALANGAN RATU, NEGERI KATON, PESAWARAN, LAMPUNG",1,80,120,200
https://kawalpemilu.org#24878,"HALANGAN RATU, NEGERI KATON, PESAWARAN, LAMPUNG",2,37,145,182
https://kawalpemilu.org#24878,"HALANGAN RATU, NEGERI KATON, PESAWARAN, LAMPUNG",3,40,185,225
https://kawalpemilu.org#24878,"HALANGAN RATU, NEGERI KATON, PESAWARAN, LAMPUNG",4,45,103,148
https://kawalpemilu.org#24878,"HALANGAN RATU, NEGERI KATON, PESAWARAN, LAMPUNG",5,56,139,195
https://kawalpemilu.org#24878,"HALANGAN RATU, NEGERI KATON, PESAWARAN, LAMPUNG",6,65,69,134
https://kawalpemilu.org#24878,"HALANGAN RATU, NEGERI KATON, PESAWARAN, LAMPUNG",7,137,95,232
https://kawalpemilu.org#24878,"HALANGAN RATU, NEGERI KATON, PESAWARAN, LAMPUNG",8,38,112,150
https://kawalpemilu.org#24878,"HALANGAN RATU, NEGERI KATON, PESAWARAN, LAMPUNG",9,41,117,158
https://kawalpemilu.org#24878,"HALANGAN RATU, NEGERI KATON, PESAWARAN, LAMPUNG",10,58,96,154
https://kawalpemilu.org#24879,"PEJAMBON, NEGERI KATON, PESAWARAN, LAMPUNG",1,127,84,211
https://kawalpemilu.org#24879,"PEJAMBON, NEGERI KATON, PESAWARAN, LAMPUNG",2,97,68,166
https://kawalpemilu.org#24879,"PEJAMBON, NEGERI KATON, PESAWARAN, LAMPUNG",3,145,58,203
https://kawalpemilu.org#24879,"PEJAMBON, NEGERI KATON, PESAWARAN, LAMPUNG",4,128,59,187
https://kawalpemilu.org#24879,"PEJAMBON, NEGERI KATON, PESAWARAN, LAMPUNG",5,130,100,230
https://kawalpemilu.org#24879,"PEJAMBON, NEGERI KATON, PESAWARAN, LAMPUNG",6,156,19,175
https://kawalpemilu.org#24879,"PEJAMBON, NEGERI KATON, PESAWARAN, LAMPUNG",7,117,32,149
https://kawalpemilu.org#24879,"PEJAMBON, NEGERI KATON, PESAWARAN, LAMPUNG",8,106,63,169
https://kawalpemilu.org#24879,"PEJAMBON, NEGERI KATON, PESAWARAN, LAMPUNG",9,128,50,178
https://kawalpemilu.org#24879,"PEJAMBON, NEGERI KATON, PESAWARAN, LAMPUNG",10,140,64,204
https://kawalpemilu.org#24879,"PEJAMBON, NEGERI KATON, PESAWARAN, LAMPUNG",11,115,46,161
https://kawalpemilu.org#24879,"PEJAMBON, NEGERI KATON, PESAWARAN, LAMPUNG",12,131,32,163
https://kawalpemilu.org#24880,"NEGARA SAKA, NEGERI KATON, PESAWARAN, LAMPUNG",1,134,42,176
https://kawalpemilu.org#24880,"NEGARA SAKA, NEGERI KATON, PESAWARAN, LAMPUNG",2,155,72,227
https://kawalpemilu.org#24880,"NEGARA SAKA, NEGERI KATON, PESAWARAN, LAMPUNG",3,126,54,180
https://kawalpemilu.org#24880,"NEGARA SAKA, NEGERI KATON, PESAWARAN, LAMPUNG",4,151,72,223
https://kawalpemilu.org#24880,"NEGARA SAKA, NEGERI KATON, PESAWARAN, LAMPUNG",5,153,58,211
https://kawalpemilu.org#24880,"NEGARA SAKA, NEGERI KATON, PESAWARAN, LAMPUNG",6,137,64,201
https://kawalpemilu.org#24880,"NEGARA SAKA, NEGERI KATON, PESAWARAN, LAMPUNG",7,119,45,164
https://kawalpemilu.org#24880,"NEGARA SAKA, NEGERI KATON, PESAWARAN, LAMPUNG",8,107,32,139
https://kawalpemilu.org#24880,"NEGARA SAKA, NEGERI KATON, PESAWARAN, LAMPUNG",9,57,36,93
https://kawalpemilu.org#24880,"NEGARA SAKA, NEGERI KATON, PESAWARAN, LAMPUNG",10,143,66,209
https://kawalpemilu.org#24881,"SINAR BANDUNG, NEGERI KATON, PESAWARAN, LAMPUNG",2,56,117,173
https://kawalpemilu.org#24881,"SINAR BANDUNG, NEGERI KATON, PESAWARAN, LAMPUNG",3,64,102,166
https://kawalpemilu.org#24881,"SINAR BANDUNG, NEGERI KATON, PESAWARAN, LAMPUNG",4,58,106,164
https://kawalpemilu.org#24881,"SINAR BANDUNG, NEGERI KATON, PESAWARAN, LAMPUNG",5,71,88,159
https://kawalpemilu.org#24881,"SINAR BANDUNG, NEGERI KATON, PESAWARAN, LAMPUNG",6,97,57,154
https://kawalpemilu.org#24881,"SINAR BANDUNG, NEGERI KATON, PESAWARAN, LAMPUNG",7,34,129,163
https://kawalpemilu.org#24881,"SINAR BANDUNG, NEGERI KATON, PESAWARAN, LAMPUNG",8,88,80,168
https://kawalpemilu.org#24882,"TANJUNG REJO, NEGERI KATON, PESAWARAN, LAMPUNG",1,60,122,182
https://kawalpemilu.org#24882,"TANJUNG REJO, NEGERI KATON, PESAWARAN, LAMPUNG",2,72,84,156
https://kawalpemilu.org#24882,"TANJUNG REJO, NEGERI KATON, PESAWARAN, LAMPUNG",3,89,77,166
https://kawalpemilu.org#24882,"TANJUNG REJO, NEGERI KATON, PESAWARAN, LAMPUNG",4,68,160,228
https://kawalpemilu.org#24882,"TANJUNG REJO, NEGERI KATON, PESAWARAN, LAMPUNG",5,62,173,235
https://kawalpemilu.org#24882,"TANJUNG REJO, NEGERI KATON, PESAWARAN, LAMPUNG",6,71,85,156
https://kawalpemilu.org#24882,"TANJUNG REJO, NEGERI KATON, PESAWARAN, LAMPUNG",7,60,102,162
https://kawalpemilu.org#24882,"TANJUNG REJO, NEGERI KATON, PESAWARAN, LAMPUNG",8,142,56,198
https://kawalpemilu.org#24882,"TANJUNG REJO, NEGERI KATON, PESAWARAN, LAMPUNG",9,138,55,193
https://kawalpemilu.org#24882,"TANJUNG REJO, NEGERI KATON, PESAWARAN, LAMPUNG",10,103,76,179
https://kawalpemilu.org#24882,"TANJUNG REJO, NEGERI KATON, PESAWARAN, LAMPUNG",11,82,104,186
https://kawalpemilu.org#24882,"TANJUNG REJO, NEGERI KATON, PESAWARAN, LAMPUNG",12,56,100,156
https://kawalpemilu.org#24882,"TANJUNG REJO, NEGERI KATON, PESAWARAN, LAMPUNG",13,61,108,169
https://kawalpemilu.org#24882,"TANJUNG REJO, NEGERI KATON, PESAWARAN, LAMPUNG",15,80,70,150
https://kawalpemilu.org#24882,"TANJUNG REJO, NEGERI KATON, PESAWARAN, LAMPUNG",16,94,92,186
https://kawalpemilu.org#24882,"TANJUNG REJO, NEGERI KATON, PESAWARAN, LAMPUNG",17,51,122,173
https://kawalpemilu.org#24883,"ROWOREJO, NEGERI KATON, PESAWARAN, LAMPUNG",1,90,74,164
https://kawalpemilu.org#24883,"ROWOREJO, NEGERI KATON, PESAWARAN, LAMPUNG",2,81,57,138
https://kawalpemilu.org#24883,"ROWOREJO, NEGERI KATON, PESAWARAN, LAMPUNG",3,141,65,206
https://kawalpemilu.org#24883,"ROWOREJO, NEGERI KATON, PESAWARAN, LAMPUNG",4,98,74,172
https://kawalpemilu.org#24883,"ROWOREJO, NEGERI KATON, PESAWARAN, LAMPUNG",5,140,71,211
https://kawalpemilu.org#24883,"ROWOREJO, NEGERI KATON, PESAWARAN, LAMPUNG",6,172,45,217
https://kawalpemilu.org#24883,"ROWOREJO, NEGERI KATON, PESAWARAN, LAMPUNG",7,102,29,131
https://kawalpemilu.org#24883,"ROWOREJO, NEGERI KATON, PESAWARAN, LAMPUNG",8,108,65,173
https://kawalpemilu.org#24883,"ROWOREJO, NEGERI KATON, PESAWARAN, LAMPUNG",9,166,67,233
https://kawalpemilu.org#24883,"ROWOREJO, NEGERI KATON, PESAWARAN, LAMPUNG",10,110,63,173
https://kawalpemilu.org#24883,"ROWOREJO, NEGERI KATON, PESAWARAN, LAMPUNG",11,88,39,127
https://kawalpemilu.org#24883,"ROWOREJO, NEGERI KATON, PESAWARAN, LAMPUNG",12,80,33,113
https://kawalpemilu.org#24883,"ROWOREJO, NEGERI KATON, PESAWARAN, LAMPUNG",13,108,74,182
https://kawalpemilu.org#24883,"ROWOREJO, NEGERI KATON, PESAWARAN, LAMPUNG",14,117,74,191
https://kawalpemilu.org#24883,"ROWOREJO, NEGERI KATON, PESAWARAN, LAMPUNG",15,104,39,143
https://kawalpemilu.org#24883,"ROWOREJO, NEGERI KATON, PESAWARAN, LAMPUNG",16,99,45,144
https://kawalpemilu.org#24883,"ROWOREJO, NEGERI KATON, PESAWARAN, LAMPUNG",17,147,62,209
https://kawalpemilu.org#24883,"ROWOREJO, NEGERI KATON, PESAWARAN, LAMPUNG",18,102,16,118
https://kawalpemilu.org#24884,"TRESNO MAJU, NEGERI KATON, PESAWARAN, LAMPUNG",1,116,29,145
https://kawalpemilu.org#24884,"TRESNO MAJU, NEGERI KATON, PESAWARAN, LAMPUNG",2,152,50,202
https://kawalpemilu.org#24884,"TRESNO MAJU, NEGERI KATON, PESAWARAN, LAMPUNG",3,133,33,166
https://kawalpemilu.org#24884,"TRESNO MAJU, NEGERI KATON, PESAWARAN, LAMPUNG",4,145,43,188
https://kawalpemilu.org#24884,"TRESNO MAJU, NEGERI KATON, PESAWARAN, LAMPUNG",5,137,21,158
https://kawalpemilu.org#24884,"TRESNO MAJU, NEGERI KATON, PESAWARAN, LAMPUNG",6,148,34,182
https://kawalpemilu.org#24884,"TRESNO MAJU, NEGERI KATON, PESAWARAN, LAMPUNG",7,183,25,208
https://kawalpemilu.org#24884,"TRESNO MAJU, NEGERI KATON, PESAWARAN, LAMPUNG",8,135,53,188
https://kawalpemilu.org#24884,"TRESNO MAJU, NEGERI KATON, PESAWARAN, LAMPUNG",9,152,33,185
https://kawalpemilu.org#24884,"TRESNO MAJU, NEGERI KATON, PESAWARAN, LAMPUNG",10,190,48,238
https://kawalpemilu.org#24884,"TRESNO MAJU, NEGERI KATON, PESAWARAN, LAMPUNG",11,99,45,144
https://kawalpemilu.org#24884,"TRESNO MAJU, NEGERI KATON, PESAWARAN, LAMPUNG",12,153,52,205
https://kawalpemilu.org#24884,"TRESNO MAJU, NEGERI KATON, PESAWARAN, LAMPUNG",13,156,23,179
https://kawalpemilu.org#24884,"TRESNO MAJU, NEGERI KATON, PESAWARAN, LAMPUNG",14,141,44,185
https://kawalpemilu.org#24885,"SIDOMULYO, NEGERI KATON, PESAWARAN, LAMPUNG",1,146,44,190
https://kawalpemilu.org#24885,"SIDOMULYO, NEGERI KATON, PESAWARAN, LAMPUNG",2,125,52,177
https://kawalpemilu.org#24885,"SIDOMULYO, NEGERI KATON, PESAWARAN, LAMPUNG",3,89,62,151
https://kawalpemilu.org#24885,"SIDOMULYO, NEGERI KATON, PESAWARAN, LAMPUNG",4,77,123,200
https://kawalpemilu.org#24885,"SIDOMULYO, NEGERI KATON, PESAWARAN, LAMPUNG",5,112,60,172
https://kawalpemilu.org#24885,"SIDOMULYO, NEGERI KATON, PESAWARAN, LAMPUNG",6,99,34,133
https://kawalpemilu.org#24885,"SIDOMULYO, NEGERI KATON, PESAWARAN, LAMPUNG",7,162,36,198
https://kawalpemilu.org#24885,"SIDOMULYO, NEGERI KATON, PESAWARAN, LAMPUNG",8,155,42,197
https://kawalpemilu.org#24885,"SIDOMULYO, NEGERI KATON, PESAWARAN, LAMPUNG",9,108,21,129
https://kawalpemilu.org#24885,"SIDOMULYO, NEGERI KATON, PESAWARAN, LAMPUNG",10,216,35,251
https://kawalpemilu.org#24885,"SIDOMULYO, NEGERI KATON, PESAWARAN, LAMPUNG",11,73,35,108
https://kawalpemilu.org#24885,"SIDOMULYO, NEGERI KATON, PESAWARAN, LAMPUNG",12,90,62,152
https://kawalpemilu.org#24885,"SIDOMULYO, NEGERI KATON, PESAWARAN, LAMPUNG",13,135,43,178
https://kawalpemilu.org#24885,"SIDOMULYO, NEGERI KATON, PESAWARAN, LAMPUNG",14,130,24,154
https://kawalpemilu.org#24885,"SIDOMULYO, NEGERI KATON, PESAWARAN, LAMPUNG",15,125,22,147
https://kawalpemilu.org#24885,"SIDOMULYO, NEGERI KATON, PESAWARAN, LAMPUNG",16,188,32,220
https://kawalpemilu.org#24885,"SIDOMULYO, NEGERI KATON, PESAWARAN, LAMPUNG",17,113,31,144
https://kawalpemilu.org#24886,"LUMBIREJO, NEGERI KATON, PESAWARAN, LAMPUNG",2,111,71,182
https://kawalpemilu.org#24886,"LUMBIREJO, NEGERI KATON, PESAWARAN, LAMPUNG",3,197,43,240
https://kawalpemilu.org#24886,"LUMBIREJO, NEGERI KATON, PESAWARAN, LAMPUNG",4,90,82,172
https://kawalpemilu.org#24886,"LUMBIREJO, NEGERI KATON, PESAWARAN, LAMPUNG",5,107,56,163
https://kawalpemilu.org#24886,"LUMBIREJO, NEGERI KATON, PESAWARAN, LAMPUNG",6,105,12,117
https://kawalpemilu.org#24886,"LUMBIREJO, NEGERI KATON, PESAWARAN, LAMPUNG",7,138,27,165
https://kawalpemilu.org#24886,"LUMBIREJO, NEGERI KATON, PESAWARAN, LAMPUNG",8,95,18,113
https://kawalpemilu.org#24886,"LUMBIREJO, NEGERI KATON, PESAWARAN, LAMPUNG",10,82,47,129
https://kawalpemilu.org#24886,"LUMBIREJO, NEGERI KATON, PESAWARAN, LAMPUNG",11,126,21,147
https://kawalpemilu.org#24886,"LUMBIREJO, NEGERI KATON, PESAWARAN, LAMPUNG",12,75,43,118
https://kawalpemilu.org#24886,"LUMBIREJO, NEGERI KATON, PESAWARAN, LAMPUNG",13,108,10,118
https://kawalpemilu.org#24886,"LUMBIREJO, NEGERI KATON, PESAWARAN, LAMPUNG",14,125,44,169
https://kawalpemilu.org#24886,"LUMBIREJO, NEGERI KATON, PESAWARAN, LAMPUNG",15,103,38,141
https://kawalpemilu.org#24887,"TRI RAHAYU, NEGERI KATON, PESAWARAN, LAMPUNG",1,145,6,151
https://kawalpemilu.org#24887,"TRI RAHAYU, NEGERI KATON, PESAWARAN, LAMPUNG",2,168,27,195
https://kawalpemilu.org#24887,"TRI RAHAYU, NEGERI KATON, PESAWARAN, LAMPUNG",3,132,34,166
https://kawalpemilu.org#24887,"TRI RAHAYU, NEGERI KATON, PESAWARAN, LAMPUNG",4,127,20,147
https://kawalpemilu.org#24887,"TRI RAHAYU, NEGERI KATON, PESAWARAN, LAMPUNG",5,131,28,159
https://kawalpemilu.org#24887,"TRI RAHAYU, NEGERI KATON, PESAWARAN, LAMPUNG",6,145,20,165
https://kawalpemilu.org#24887,"TRI RAHAYU, NEGERI KATON, PESAWARAN, LAMPUNG",7,140,23,163
https://kawalpemilu.org#24887,"TRI RAHAYU, NEGERI KATON, PESAWARAN, LAMPUNG",8,163,17,180
https://kawalpemilu.org#24887,"TRI RAHAYU, NEGERI KATON, PESAWARAN, LAMPUNG",9,160,22,182
https://kawalpemilu.org#24887,"TRI RAHAYU, NEGERI KATON, PESAWARAN, LAMPUNG",10,160,21,181
https://kawalpemilu.org#24887,"TRI RAHAYU, NEGERI KATON, PESAWARAN, LAMPUNG",11,97,23,120
https://kawalpemilu.org#24887,"TRI RAHAYU, NEGERI KATON, PESAWARAN, LAMPUNG",12,109,13,122
https://kawalpemilu.org#24887,"TRI RAHAYU, NEGERI KATON, PESAWARAN, LAMPUNG",13,157,10,167
https://kawalpemilu.org#24888,"BANGUN SARI, NEGERI KATON, PESAWARAN, LAMPUNG",1,144,62,206
https://kawalpemilu.org#24888,"BANGUN SARI, NEGERI KATON, PESAWARAN, LAMPUNG",2,149,0,220
https://kawalpemilu.org#24888,"BANGUN SARI, NEGERI KATON, PESAWARAN, LAMPUNG",3,187,46,233
https://kawalpemilu.org#24888,"BANGUN SARI, NEGERI KATON, PESAWARAN, LAMPUNG",4,124,47,171
https://kawalpemilu.org#24888,"BANGUN SARI, NEGERI KATON, PESAWARAN, LAMPUNG",5,176,29,205
https://kawalpemilu.org#24888,"BANGUN SARI, NEGERI KATON, PESAWARAN, LAMPUNG",6,178,34,212
https://kawalpemilu.org#24888,"BANGUN SARI, NEGERI KATON, PESAWARAN, LAMPUNG",7,120,35,155
https://kawalpemilu.org#24888,"BANGUN SARI, NEGERI KATON, PESAWARAN, LAMPUNG",8,180,25,205
https://kawalpemilu.org#24888,"BANGUN SARI, NEGERI KATON, PESAWARAN, LAMPUNG",9,179,43,222
https://kawalpemilu.org#24888,"BANGUN SARI, NEGERI KATON, PESAWARAN, LAMPUNG",10,201,50,251
https://kawalpemilu.org#24888,"BANGUN SARI, NEGERI KATON, PESAWARAN, LAMPUNG",11,89,61,150
https://kawalpemilu.org#24889,"KARANG REJO, NEGERI KATON, PESAWARAN, LAMPUNG",1,106,53,159
https://kawalpemilu.org#24889,"KARANG REJO, NEGERI KATON, PESAWARAN, LAMPUNG",2,97,92,189
https://kawalpemilu.org#24889,"KARANG REJO, NEGERI KATON, PESAWARAN, LAMPUNG",3,143,72,215
https://kawalpemilu.org#24889,"KARANG REJO, NEGERI KATON, PESAWARAN, LAMPUNG",4,91,79,170
https://kawalpemilu.org#24889,"KARANG REJO, NEGERI KATON, PESAWARAN, LAMPUNG",5,92,82,174
https://kawalpemilu.org#24889,"KARANG REJO, NEGERI KATON, PESAWARAN, LAMPUNG",6,90,105,195
https://kawalpemilu.org#24889,"KARANG REJO, NEGERI KATON, PESAWARAN, LAMPUNG",7,113,82,195
https://kawalpemilu.org#24889,"KARANG REJO, NEGERI KATON, PESAWARAN, LAMPUNG",8,112,75,187
https://kawalpemilu.org#24889,"KARANG REJO, NEGERI KATON, PESAWARAN, LAMPUNG",9,97,74,171
https://kawalpemilu.org#24889,"KARANG REJO, NEGERI KATON, PESAWARAN, LAMPUNG",10,80,88,168
https://kawalpemilu.org#24889,"KARANG REJO, NEGERI KATON, PESAWARAN, LAMPUNG",11,100,107,207
https://kawalpemilu.org#24889,"KARANG REJO, NEGERI KATON, PESAWARAN, LAMPUNG",12,92,105,197
https://kawalpemilu.org#24890,"NEGERI ULANGAN JAYA, NEGERI KATON, PESAWARAN, LAMPUNG",2,98,139,237
https://kawalpemilu.org#24890,"NEGERI ULANGAN JAYA, NEGERI KATON, PESAWARAN, LAMPUNG",3,173,80,253
https://kawalpemilu.org#24890,"NEGERI ULANGAN JAYA, NEGERI KATON, PESAWARAN, LAMPUNG",4,110,16,126
https://kawalpemilu.org#24890,"NEGERI ULANGAN JAYA, NEGERI KATON, PESAWARAN, LAMPUNG",5,114,114,228
https://kawalpemilu.org#24890,"NEGERI ULANGAN JAYA, NEGERI KATON, PESAWARAN, LAMPUNG",6,92,89,181
https://kawalpemilu.org#24890,"NEGERI ULANGAN JAYA, NEGERI KATON, PESAWARAN, LAMPUNG",7,96,92,188
https://kawalpemilu.org#24893,"BUMI AGUNG, TEGINENENG, PESAWARAN, LAMPUNG",1,59,126,185
https://kawalpemilu.org#24893,"BUMI AGUNG, TEGINENENG, PESAWARAN, LAMPUNG",2,62,130,192
https://kawalpemilu.org#24893,"BUMI AGUNG, TEGINENENG, PESAWARAN, LAMPUNG",3,37,152,189
https://kawalpemilu.org#24893,"BUMI AGUNG, TEGINENENG, PESAWARAN, LAMPUNG",4,59,142,201
https://kawalpemilu.org#24893,"BUMI AGUNG, TEGINENENG, PESAWARAN, LAMPUNG",5,149,107,256
https://kawalpemilu.org#24893,"BUMI AGUNG, TEGINENENG, PESAWARAN, LAMPUNG",6,154,111,265
https://kawalpemilu.org#24893,"BUMI AGUNG, TEGINENENG, PESAWARAN, LAMPUNG",7,122,123,245
https://kawalpemilu.org#24893,"BUMI AGUNG, TEGINENENG, PESAWARAN, LAMPUNG",8,125,95,220
https://kawalpemilu.org#24893,"BUMI AGUNG, TEGINENENG, PESAWARAN, LAMPUNG",9,154,118,272
https://kawalpemilu.org#24893,"BUMI AGUNG, TEGINENENG, PESAWARAN, LAMPUNG",10,148,121,269
https://kawalpemilu.org#24893,"BUMI AGUNG, TEGINENENG, PESAWARAN, LAMPUNG",11,65,64,129
https://kawalpemilu.org#24893,"BUMI AGUNG, TEGINENENG, PESAWARAN, LAMPUNG",12,87,110,197
https://kawalpemilu.org#24893,"BUMI AGUNG, TEGINENENG, PESAWARAN, LAMPUNG",13,95,134,229
https://kawalpemilu.org#24893,"BUMI AGUNG, TEGINENENG, PESAWARAN, LAMPUNG",14,73,140,213
https://kawalpemilu.org#24893,"BUMI AGUNG, TEGINENENG, PESAWARAN, LAMPUNG",15,32,106,138
https://kawalpemilu.org#24893,"BUMI AGUNG, TEGINENENG, PESAWARAN, LAMPUNG",16,151,64,215
https://kawalpemilu.org#24893,"BUMI AGUNG, TEGINENENG, PESAWARAN, LAMPUNG",17,175,87,262
https://kawalpemilu.org#24893,"BUMI AGUNG, TEGINENENG, PESAWARAN, LAMPUNG",18,122,99,221
https://kawalpemilu.org#24893,"BUMI AGUNG, TEGINENENG, PESAWARAN, LAMPUNG",19,149,114,263
https://kawalpemilu.org#24893,"BUMI AGUNG, TEGINENENG, PESAWARAN, LAMPUNG",20,141,141,282
https://kawalpemilu.org#24893,"BUMI AGUNG, TEGINENENG, PESAWARAN, LAMPUNG",21,67,71,138
https://kawalpemilu.org#24893,"BUMI AGUNG, TEGINENENG, PESAWARAN, LAMPUNG",22,124,64,188
https://kawalpemilu.org#24893,"BUMI AGUNG, TEGINENENG, PESAWARAN, LAMPUNG",23,107,99,206
https://kawalpemilu.org#24893,"BUMI AGUNG, TEGINENENG, PESAWARAN, LAMPUNG",24,137,115,252
https://kawalpemilu.org#24894,"KEJADIAN, TEGINENENG, PESAWARAN, LAMPUNG",1,58,126,184
https://kawalpemilu.org#24894,"KEJADIAN, TEGINENENG, PESAWARAN, LAMPUNG",2,42,139,181
https://kawalpemilu.org#24894,"KEJADIAN, TEGINENENG, PESAWARAN, LAMPUNG",3,167,66,233
https://kawalpemilu.org#24894,"KEJADIAN, TEGINENENG, PESAWARAN, LAMPUNG",4,143,91,234
https://kawalpemilu.org#24894,"KEJADIAN, TEGINENENG, PESAWARAN, LAMPUNG",5,34,134,168
https://kawalpemilu.org#24895,"BATANG HARI OGAN, TEGINENENG, PESAWARAN, LAMPUNG",1,87,98,185
https://kawalpemilu.org#24895,"BATANG HARI OGAN, TEGINENENG, PESAWARAN, LAMPUNG",2,128,84,212
https://kawalpemilu.org#24895,"BATANG HARI OGAN, TEGINENENG, PESAWARAN, LAMPUNG",3,108,76,184
https://kawalpemilu.org#24895,"BATANG HARI OGAN, TEGINENENG, PESAWARAN, LAMPUNG",4,66,70,136
https://kawalpemilu.org#24895,"BATANG HARI OGAN, TEGINENENG, PESAWARAN, LAMPUNG",5,105,89,194
https://kawalpemilu.org#24895,"BATANG HARI OGAN, TEGINENENG, PESAWARAN, LAMPUNG",6,74,105,179
https://kawalpemilu.org#24895,"BATANG HARI OGAN, TEGINENENG, PESAWARAN, LAMPUNG",7,75,73,148
https://kawalpemilu.org#24895,"BATANG HARI OGAN, TEGINENENG, PESAWARAN, LAMPUNG",8,90,80,170
https://kawalpemilu.org#24895,"BATANG HARI OGAN, TEGINENENG, PESAWARAN, LAMPUNG",9,78,68,146
https://kawalpemilu.org#24895,"BATANG HARI OGAN, TEGINENENG, PESAWARAN, LAMPUNG",10,92,70,162
https://kawalpemilu.org#24896,"NEGARA RATU WATES, TEGINENENG, PESAWARAN, LAMPUNG",1,61,95,156
https://kawalpemilu.org#24896,"NEGARA RATU WATES, TEGINENENG, PESAWARAN, LAMPUNG",2,231,16,247
https://kawalpemilu.org#24896,"NEGARA RATU WATES, TEGINENENG, PESAWARAN, LAMPUNG",3,59,60,119
https://kawalpemilu.org#24897,"GUNUNG SUGIH BARU, TEGINENENG, PESAWARAN, LAMPUNG",1,71,165,236
https://kawalpemilu.org#24897,"GUNUNG SUGIH BARU, TEGINENENG, PESAWARAN, LAMPUNG",2,147,63,210
https://kawalpemilu.org#24897,"GUNUNG SUGIH BARU, TEGINENENG, PESAWARAN, LAMPUNG",3,133,53,186
https://kawalpemilu.org#24897,"GUNUNG SUGIH BARU, TEGINENENG, PESAWARAN, LAMPUNG",4,203,31,234
https://kawalpemilu.org#24898,"GEDUNG GUMANTI, TEGINENENG, PESAWARAN, LAMPUNG",1,50,139,189
https://kawalpemilu.org#24898,"GEDUNG GUMANTI, TEGINENENG, PESAWARAN, LAMPUNG",2,151,61,212
https://kawalpemilu.org#24898,"GEDUNG GUMANTI, TEGINENENG, PESAWARAN, LAMPUNG",3,151,43,194
https://kawalpemilu.org#24898,"GEDUNG GUMANTI, TEGINENENG, PESAWARAN, LAMPUNG",4,206,48,254
https://kawalpemilu.org#24898,"GEDUNG GUMANTI, TEGINENENG, PESAWARAN, LAMPUNG",5,127,21,148
https://kawalpemilu.org#24898,"GEDUNG GUMANTI, TEGINENENG, PESAWARAN, LAMPUNG",6,159,31,190
https://kawalpemilu.org#24898,"GEDUNG GUMANTI, TEGINENENG, PESAWARAN, LAMPUNG",7,181,96,277
https://kawalpemilu.org#24898,"GEDUNG GUMANTI, TEGINENENG, PESAWARAN, LAMPUNG",8,205,26,231
https://kawalpemilu.org#24898,"GEDUNG GUMANTI, TEGINENENG, PESAWARAN, LAMPUNG",9,159,26,185
https://kawalpemilu.org#24898,"GEDUNG GUMANTI, TEGINENENG, PESAWARAN, LAMPUNG",10,154,45,199
https://kawalpemilu.org#24898,"GEDUNG GUMANTI, TEGINENENG, PESAWARAN, LAMPUNG",11,37,124,161
https://kawalpemilu.org#24898,"GEDUNG GUMANTI, TEGINENENG, PESAWARAN, LAMPUNG",12,152,59,211
https://kawalpemilu.org#24898,"GEDUNG GUMANTI, TEGINENENG, PESAWARAN, LAMPUNG",13,161,13,174
https://kawalpemilu.org#24898,"GEDUNG GUMANTI, TEGINENENG, PESAWARAN, LAMPUNG",14,144,23,167
https://kawalpemilu.org#24898,"GEDUNG GUMANTI, TEGINENENG, PESAWARAN, LAMPUNG",15,129,39,168
https://kawalpemilu.org#24899,"KRESNO WIDODO, TEGINENENG, PESAWARAN, LAMPUNG",1,178,29,207
https://kawalpemilu.org#24899,"KRESNO WIDODO, TEGINENENG, PESAWARAN, LAMPUNG",2,159,39,198
https://kawalpemilu.org#24899,"KRESNO WIDODO, TEGINENENG, PESAWARAN, LAMPUNG",3,189,37,226
https://kawalpemilu.org#24899,"KRESNO WIDODO, TEGINENENG, PESAWARAN, LAMPUNG",4,190,42,232
https://kawalpemilu.org#24899,"KRESNO WIDODO, TEGINENENG, PESAWARAN, LAMPUNG",5,166,55,221
https://kawalpemilu.org#24899,"KRESNO WIDODO, TEGINENENG, PESAWARAN, LAMPUNG",6,174,49,223
https://kawalpemilu.org#24899,"KRESNO WIDODO, TEGINENENG, PESAWARAN, LAMPUNG",7,224,13,237
https://kawalpemilu.org#24899,"KRESNO WIDODO, TEGINENENG, PESAWARAN, LAMPUNG",8,164,29,193
https://kawalpemilu.org#24899,"KRESNO WIDODO, TEGINENENG, PESAWARAN, LAMPUNG",9,198,21,219
https://kawalpemilu.org#24899,"KRESNO WIDODO, TEGINENENG, PESAWARAN, LAMPUNG",10,156,30,186
https://kawalpemilu.org#24899,"KRESNO WIDODO, TEGINENENG, PESAWARAN, LAMPUNG",11,175,26,201
https://kawalpemilu.org#24899,"KRESNO WIDODO, TEGINENENG, PESAWARAN, LAMPUNG",12,208,36,244
https://kawalpemilu.org#24899,"KRESNO WIDODO, TEGINENENG, PESAWARAN, LAMPUNG",13,177,21,198
https://kawalpemilu.org#24899,"KRESNO WIDODO, TEGINENENG, PESAWARAN, LAMPUNG",14,196,21,217
https://kawalpemilu.org#24900,"SINAR JATI, TEGINENENG, PESAWARAN, LAMPUNG",1,144,92,236
https://kawalpemilu.org#24900,"SINAR JATI, TEGINENENG, PESAWARAN, LAMPUNG",2,154,34,188
https://kawalpemilu.org#24900,"SINAR JATI, TEGINENENG, PESAWARAN, LAMPUNG",3,126,27,153
https://kawalpemilu.org#24900,"SINAR JATI, TEGINENENG, PESAWARAN, LAMPUNG",4,102,80,182
https://kawalpemilu.org#24901,"MARGO REJO, TEGINENENG, PESAWARAN, LAMPUNG",1,164,58,222
https://kawalpemilu.org#24901,"MARGO REJO, TEGINENENG, PESAWARAN, LAMPUNG",3,158,39,197
https://kawalpemilu.org#24901,"MARGO REJO, TEGINENENG, PESAWARAN, LAMPUNG",4,173,33,206
https://kawalpemilu.org#24901,"MARGO REJO, TEGINENENG, PESAWARAN, LAMPUNG",5,120,38,158
https://kawalpemilu.org#24901,"MARGO REJO, TEGINENENG, PESAWARAN, LAMPUNG",6,124,48,172
https://kawalpemilu.org#24901,"MARGO REJO, TEGINENENG, PESAWARAN, LAMPUNG",7,140,32,172
https://kawalpemilu.org#24901,"MARGO REJO, TEGINENENG, PESAWARAN, LAMPUNG",8,150,14,164
https://kawalpemilu.org#24901,"MARGO REJO, TEGINENENG, PESAWARAN, LAMPUNG",9,162,9,171
https://kawalpemilu.org#24901,"MARGO REJO, TEGINENENG, PESAWARAN, LAMPUNG",10,144,51,195
https://kawalpemilu.org#24901,"MARGO REJO, TEGINENENG, PESAWARAN, LAMPUNG",11,202,16,218
https://kawalpemilu.org#24901,"MARGO REJO, TEGINENENG, PESAWARAN, LAMPUNG",12,145,12,157
https://kawalpemilu.org#24901,"MARGO REJO, TEGINENENG, PESAWARAN, LAMPUNG",13,104,33,137
https://kawalpemilu.org#24901,"MARGO REJO, TEGINENENG, PESAWARAN, LAMPUNG",14,128,21,149
https://kawalpemilu.org#24901,"MARGO REJO, TEGINENENG, PESAWARAN, LAMPUNG",15,170,11,181
https://kawalpemilu.org#24902,"GERNING, TEGINENENG, PESAWARAN, LAMPUNG",1,135,35,170
https://kawalpemilu.org#24902,"GERNING, TEGINENENG, PESAWARAN, LAMPUNG",2,140,24,164
https://kawalpemilu.org#24902,"GERNING, TEGINENENG, PESAWARAN, LAMPUNG",3,157,15,172
https://kawalpemilu.org#24902,"GERNING, TEGINENENG, PESAWARAN, LAMPUNG",4,207,38,245
https://kawalpemilu.org#24902,"GERNING, TEGINENENG, PESAWARAN, LAMPUNG",5,113,43,156
https://kawalpemilu.org#24902,"GERNING, TEGINENENG, PESAWARAN, LAMPUNG",6,147,25,172
https://kawalpemilu.org#24902,"GERNING, TEGINENENG, PESAWARAN, LAMPUNG",7,172,27,199
https://kawalpemilu.org#24902,"GERNING, TEGINENENG, PESAWARAN, LAMPUNG",8,125,26,151
https://kawalpemilu.org#24902,"GERNING, TEGINENENG, PESAWARAN, LAMPUNG",9,102,28,130
https://kawalpemilu.org#24902,"GERNING, TEGINENENG, PESAWARAN, LAMPUNG",10,214,25,239
https://kawalpemilu.org#24902,"GERNING, TEGINENENG, PESAWARAN, LAMPUNG",11,106,32,138
https://kawalpemilu.org#24902,"GERNING, TEGINENENG, PESAWARAN, LAMPUNG",12,93,35,128
https://kawalpemilu.org#24902,"GERNING, TEGINENENG, PESAWARAN, LAMPUNG",13,135,24,159
https://kawalpemilu.org#24903,"PANCA BAKTI, TEGINENENG, PESAWARAN, LAMPUNG",1,115,41,156
https://kawalpemilu.org#24903,"PANCA BAKTI, TEGINENENG, PESAWARAN, LAMPUNG",2,204,25,229
https://kawalpemilu.org#24903,"PANCA BAKTI, TEGINENENG, PESAWARAN, LAMPUNG",3,191,44,235
https://kawalpemilu.org#24903,"PANCA BAKTI, TEGINENENG, PESAWARAN, LAMPUNG",4,176,39,215
https://kawalpemilu.org#24904,"MARGO MULYO, TEGINENENG, PESAWARAN, LAMPUNG",1,164,64,228
https://kawalpemilu.org#24904,"MARGO MULYO, TEGINENENG, PESAWARAN, LAMPUNG",2,95,58,153
https://kawalpemilu.org#24904,"MARGO MULYO, TEGINENENG, PESAWARAN, LAMPUNG",3,135,22,157
https://kawalpemilu.org#24904,"MARGO MULYO, TEGINENENG, PESAWARAN, LAMPUNG",4,191,38,229
https://kawalpemilu.org#24904,"MARGO MULYO, TEGINENENG, PESAWARAN, LAMPUNG",5,166,42,208
https://kawalpemilu.org#24904,"MARGO MULYO, TEGINENENG, PESAWARAN, LAMPUNG",6,96,30,126
https://kawalpemilu.org#24904,"MARGO MULYO, TEGINENENG, PESAWARAN, LAMPUNG",7,174,27,201
https://kawalpemilu.org#24904,"MARGO MULYO, TEGINENENG, PESAWARAN, LAMPUNG",8,132,27,159
https://kawalpemilu.org#24904,"MARGO MULYO, TEGINENENG, PESAWARAN, LAMPUNG",9,146,36,182
https://kawalpemilu.org#24904,"MARGO MULYO, TEGINENENG, PESAWARAN, LAMPUNG",10,148,27,175
https://kawalpemilu.org#24904,"MARGO MULYO, TEGINENENG, PESAWARAN, LAMPUNG",11,151,20,171
https://kawalpemilu.org#24904,"MARGO MULYO, TEGINENENG, PESAWARAN, LAMPUNG",12,100,64,164
https://kawalpemilu.org#24904,"MARGO MULYO, TEGINENENG, PESAWARAN, LAMPUNG",13,150,30,180
https://kawalpemilu.org#24904,"MARGO MULYO, TEGINENENG, PESAWARAN, LAMPUNG",14,129,14,143
https://kawalpemilu.org#24905,"REJO AGUNG, TEGINENENG, PESAWARAN, LAMPUNG",1,127,85,212
https://kawalpemilu.org#24905,"REJO AGUNG, TEGINENENG, PESAWARAN, LAMPUNG",2,111,94,204
https://kawalpemilu.org#24905,"REJO AGUNG, TEGINENENG, PESAWARAN, LAMPUNG",3,138,91,229
https://kawalpemilu.org#24905,"REJO AGUNG, TEGINENENG, PESAWARAN, LAMPUNG",4,151,34,185
https://kawalpemilu.org#24905,"REJO AGUNG, TEGINENENG, PESAWARAN, LAMPUNG",5,172,40,212
https://kawalpemilu.org#24905,"REJO AGUNG, TEGINENENG, PESAWARAN, LAMPUNG",6,172,31,203
https://kawalpemilu.org#24905,"REJO AGUNG, TEGINENENG, PESAWARAN, LAMPUNG",7,164,63,227
https://kawalpemilu.org#24905,"REJO AGUNG, TEGINENENG, PESAWARAN, LAMPUNG",8,179,54,233
https://kawalpemilu.org#24905,"REJO AGUNG, TEGINENENG, PESAWARAN, LAMPUNG",9,154,48,202
https://kawalpemilu.org#24905,"REJO AGUNG, TEGINENENG, PESAWARAN, LAMPUNG",10,162,69,231
https://kawalpemilu.org#24905,"REJO AGUNG, TEGINENENG, PESAWARAN, LAMPUNG",11,135,67,202
https://kawalpemilu.org#24905,"REJO AGUNG, TEGINENENG, PESAWARAN, LAMPUNG",12,125,75,200
https://kawalpemilu.org#24905,"REJO AGUNG, TEGINENENG, PESAWARAN, LAMPUNG",13,168,54,222
https://kawalpemilu.org#24905,"REJO AGUNG, TEGINENENG, PESAWARAN, LAMPUNG",14,164,38,202
https://kawalpemilu.org#24905,"REJO AGUNG, TEGINENENG, PESAWARAN, LAMPUNG",15,147,55,202
https://kawalpemilu.org#24905,"REJO AGUNG, TEGINENENG, PESAWARAN, LAMPUNG",16,146,63,209
https://kawalpemilu.org#24905,"REJO AGUNG, TEGINENENG, PESAWARAN, LAMPUNG",17,125,60,185
https://kawalpemilu.org#24905,"REJO AGUNG, TEGINENENG, PESAWARAN, LAMPUNG",18,149,90,239
https://kawalpemilu.org#24906,"KOTA AGUNG, TEGINENENG, PESAWARAN, LAMPUNG",1,45,121,166
https://kawalpemilu.org#24906,"KOTA AGUNG, TEGINENENG, PESAWARAN, LAMPUNG",2,148,82,230
https://kawalpemilu.org#24906,"KOTA AGUNG, TEGINENENG, PESAWARAN, LAMPUNG",3,105,55,160
https://kawalpemilu.org#24906,"KOTA AGUNG, TEGINENENG, PESAWARAN, LAMPUNG",4,62,61,123
https://kawalpemilu.org#24906,"KOTA AGUNG, TEGINENENG, PESAWARAN, LAMPUNG",6,110,120,230
https://kawalpemilu.org#24906,"KOTA AGUNG, TEGINENENG, PESAWARAN, LAMPUNG",7,154,13,167
https://kawalpemilu.org#24906,"KOTA AGUNG, TEGINENENG, PESAWARAN, LAMPUNG",8,145,67,212
https://kawalpemilu.org#24906,"KOTA AGUNG, TEGINENENG, PESAWARAN, LAMPUNG",9,0,15,15
https://kawalpemilu.org#24907,"TRIMULYO, TEGINENENG, PESAWARAN, LAMPUNG",1,110,32,142
https://kawalpemilu.org#24907,"TRIMULYO, TEGINENENG, PESAWARAN, LAMPUNG",2,130,41,171
https://kawalpemilu.org#24907,"TRIMULYO, TEGINENENG, PESAWARAN, LAMPUNG",3,164,41,205
https://kawalpemilu.org#24907,"TRIMULYO, TEGINENENG, PESAWARAN, LAMPUNG",4,153,66,219
https://kawalpemilu.org#24907,"TRIMULYO, TEGINENENG, PESAWARAN, LAMPUNG",5,198,46,244
https://kawalpemilu.org#24907,"TRIMULYO, TEGINENENG, PESAWARAN, LAMPUNG",6,171,37,208
https://kawalpemilu.org#24907,"TRIMULYO, TEGINENENG, PESAWARAN, LAMPUNG",7,163,67,230
https://kawalpemilu.org#24907,"TRIMULYO, TEGINENENG, PESAWARAN, LAMPUNG",8,153,30,183
https://kawalpemilu.org#24907,"TRIMULYO, TEGINENENG, PESAWARAN, LAMPUNG",9,182,29,211
https://kawalpemilu.org#24907,"TRIMULYO, TEGINENENG, PESAWARAN, LAMPUNG",10,168,49,217
https://kawalpemilu.org#24907,"TRIMULYO, TEGINENENG, PESAWARAN, LAMPUNG",11,191,35,226
https://kawalpemilu.org#24907,"TRIMULYO, TEGINENENG, PESAWARAN, LAMPUNG",12,136,30,166
https://kawalpemilu.org#24907,"TRIMULYO, TEGINENENG, PESAWARAN, LAMPUNG",13,150,41,191
https://kawalpemilu.org#24907,"TRIMULYO, TEGINENENG, PESAWARAN, LAMPUNG",14,165,27,192
https://kawalpemilu.org#24907,"TRIMULYO, TEGINENENG, PESAWARAN, LAMPUNG",15,149,63,212
https://kawalpemilu.org#24907,"TRIMULYO, TEGINENENG, PESAWARAN, LAMPUNG",16,152,53,205
https://kawalpemilu.org#24907,"TRIMULYO, TEGINENENG, PESAWARAN, LAMPUNG",17,197,28,225
https://kawalpemilu.org#24907,"TRIMULYO, TEGINENENG, PESAWARAN, LAMPUNG",18,157,89,246
https://kawalpemilu.org#87348,"SRIWEDARI, TEGINENENG, PESAWARAN, LAMPUNG",1,178,7,185
https://kawalpemilu.org#87348,"SRIWEDARI, TEGINENENG, PESAWARAN, LAMPUNG",2,187,24,211
https://kawalpemilu.org#87348,"SRIWEDARI, TEGINENENG, PESAWARAN, LAMPUNG",3,92,82,174
https://kawalpemilu.org#87348,"SRIWEDARI, TEGINENENG, PESAWARAN, LAMPUNG",4,148,58,206
https://kawalpemilu.org#87348,"SRIWEDARI, TEGINENENG, PESAWARAN, LAMPUNG",5,108,81,189
https://kawalpemilu.org#87348,"SRIWEDARI, TEGINENENG, PESAWARAN, LAMPUNG",6,101,101,202
https://kawalpemilu.org#87348,"SRIWEDARI, TEGINENENG, PESAWARAN, LAMPUNG",7,117,54,171
https://kawalpemilu.org#87348,"SRIWEDARI, TEGINENENG, PESAWARAN, LAMPUNG",8,139,38,177
https://kawalpemilu.org#24909,"PADANG MANIS, WAY LIMA, PESAWARAN, LAMPUNG",1,29,130,159
https://kawalpemilu.org#24909,"PADANG MANIS, WAY LIMA, PESAWARAN, LAMPUNG",2,16,92,108
https://kawalpemilu.org#24909,"PADANG MANIS, WAY LIMA, PESAWARAN, LAMPUNG",3,40,107,147
https://kawalpemilu.org#24909,"PADANG MANIS, WAY LIMA, PESAWARAN, LAMPUNG",5,17,58,75
https://kawalpemilu.org#24909,"PADANG MANIS, WAY LIMA, PESAWARAN, LAMPUNG",7,16,140,156
https://kawalpemilu.org#24910,"BANJAR NEGERI, WAY LIMA, PESAWARAN, LAMPUNG",1,59,177,236
https://kawalpemilu.org#24910,"BANJAR NEGERI, WAY LIMA, PESAWARAN, LAMPUNG",2,62,128,190
https://kawalpemilu.org#24910,"BANJAR NEGERI, WAY LIMA, PESAWARAN, LAMPUNG",3,31,137,168
https://kawalpemilu.org#24910,"BANJAR NEGERI, WAY LIMA, PESAWARAN, LAMPUNG",4,53,85,138
https://kawalpemilu.org#24910,"BANJAR NEGERI, WAY LIMA, PESAWARAN, LAMPUNG",5,41,99,140
https://kawalpemilu.org#24910,"BANJAR NEGERI, WAY LIMA, PESAWARAN, LAMPUNG",6,46,98,144
https://kawalpemilu.org#24910,"BANJAR NEGERI, WAY LIMA, PESAWARAN, LAMPUNG",7,85,113,198
https://kawalpemilu.org#24910,"BANJAR NEGERI, WAY LIMA, PESAWARAN, LAMPUNG",8,32,148,180
https://kawalpemilu.org#24910,"BANJAR NEGERI, WAY LIMA, PESAWARAN, LAMPUNG",9,0,0,0
https://kawalpemilu.org#24910,"BANJAR NEGERI, WAY LIMA, PESAWARAN, LAMPUNG",10,33,93,126
https://kawalpemilu.org#24910,"BANJAR NEGERI, WAY LIMA, PESAWARAN, LAMPUNG",11,78,46,124
https://kawalpemilu.org#24910,"BANJAR NEGERI, WAY LIMA, PESAWARAN, LAMPUNG",12,43,78,121
https://kawalpemilu.org#24911,"SIDODADI, WAY LIMA, PESAWARAN, LAMPUNG",1,134,72,206
https://kawalpemilu.org#24911,"SIDODADI, WAY LIMA, PESAWARAN, LAMPUNG",2,121,43,164
https://kawalpemilu.org#24911,"SIDODADI, WAY LIMA, PESAWARAN, LAMPUNG",3,131,72,203
https://kawalpemilu.org#24911,"SIDODADI, WAY LIMA, PESAWARAN, LAMPUNG",4,141,46,187
https://kawalpemilu.org#24911,"SIDODADI, WAY LIMA, PESAWARAN, LAMPUNG",5,154,49,203
https://kawalpemilu.org#24911,"SIDODADI, WAY LIMA, PESAWARAN, LAMPUNG",6,148,42,190
https://kawalpemilu.org#24911,"SIDODADI, WAY LIMA, PESAWARAN, LAMPUNG",7,133,54,187
https://kawalpemilu.org#24911,"SIDODADI, WAY LIMA, PESAWARAN, LAMPUNG",8,122,59,181
https://kawalpemilu.org#24911,"SIDODADI, WAY LIMA, PESAWARAN, LAMPUNG",9,184,33,217
https://kawalpemilu.org#24911,"SIDODADI, WAY LIMA, PESAWARAN, LAMPUNG",11,97,30,127
https://kawalpemilu.org#24911,"SIDODADI, WAY LIMA, PESAWARAN, LAMPUNG",12,91,34,125
https://kawalpemilu.org#24911,"SIDODADI, WAY LIMA, PESAWARAN, LAMPUNG",13,113,36,149
https://kawalpemilu.org#24911,"SIDODADI, WAY LIMA, PESAWARAN, LAMPUNG",14,121,43,164
https://kawalpemilu.org#24912,"PEKONDOH GEDUNG, WAY LIMA, PESAWARAN, LAMPUNG",1,82,116,198
https://kawalpemilu.org#24912,"PEKONDOH GEDUNG, WAY LIMA, PESAWARAN, LAMPUNG",2,115,117,232
https://kawalpemilu.org#24912,"PEKONDOH GEDUNG, WAY LIMA, PESAWARAN, LAMPUNG",3,117,131,248
https://kawalpemilu.org#24912,"PEKONDOH GEDUNG, WAY LIMA, PESAWARAN, LAMPUNG",4,73,104,177
https://kawalpemilu.org#24912,"PEKONDOH GEDUNG, WAY LIMA, PESAWARAN, LAMPUNG",5,102,54,156
https://kawalpemilu.org#24913,"PEKONDOH, WAY LIMA, PESAWARAN, LAMPUNG",1,58,122,180
https://kawalpemilu.org#24913,"PEKONDOH, WAY LIMA, PESAWARAN, LAMPUNG",2,29,137,166
https://kawalpemilu.org#24913,"PEKONDOH, WAY LIMA, PESAWARAN, LAMPUNG",3,27,112,139
https://kawalpemilu.org#24913,"PEKONDOH, WAY LIMA, PESAWARAN, LAMPUNG",4,129,93,222
https://kawalpemilu.org#24913,"PEKONDOH, WAY LIMA, PESAWARAN, LAMPUNG",5,97,80,177
https://kawalpemilu.org#24913,"PEKONDOH, WAY LIMA, PESAWARAN, LAMPUNG",6,58,88,146
https://kawalpemilu.org#24914,"KOTA DALAM, WAY LIMA, PESAWARAN, LAMPUNG",1,60,134,194
https://kawalpemilu.org#24914,"KOTA DALAM, WAY LIMA, PESAWARAN, LAMPUNG",2,70,140,210
https://kawalpemilu.org#24914,"KOTA DALAM, WAY LIMA, PESAWARAN, LAMPUNG",3,57,117,174
https://kawalpemilu.org#24914,"KOTA DALAM, WAY LIMA, PESAWARAN, LAMPUNG",4,58,135,193
https://kawalpemilu.org#24914,"KOTA DALAM, WAY LIMA, PESAWARAN, LAMPUNG",5,47,120,167
https://kawalpemilu.org#24914,"KOTA DALAM, WAY LIMA, PESAWARAN, LAMPUNG",6,116,46,162
https://kawalpemilu.org#24915,"TANJUNG AGUNG, WAY LIMA, PESAWARAN, LAMPUNG",1,49,172,221
https://kawalpemilu.org#24915,"TANJUNG AGUNG, WAY LIMA, PESAWARAN, LAMPUNG",2,52,189,241
https://kawalpemilu.org#24915,"TANJUNG AGUNG, WAY LIMA, PESAWARAN, LAMPUNG",3,72,158,230
https://kawalpemilu.org#24915,"TANJUNG AGUNG, WAY LIMA, PESAWARAN, LAMPUNG",4,0,0,0
https://kawalpemilu.org#24915,"TANJUNG AGUNG, WAY LIMA, PESAWARAN, LAMPUNG",5,81,167,248
https://kawalpemilu.org#24915,"TANJUNG AGUNG, WAY LIMA, PESAWARAN, LAMPUNG",6,53,89,142
https://kawalpemilu.org#24915,"TANJUNG AGUNG, WAY LIMA, PESAWARAN, LAMPUNG",7,117,60,177
https://kawalpemilu.org#24915,"TANJUNG AGUNG, WAY LIMA, PESAWARAN, LAMPUNG",8,43,163,206
https://kawalpemilu.org#24915,"TANJUNG AGUNG, WAY LIMA, PESAWARAN, LAMPUNG",9,75,90,165
https://kawalpemilu.org#24916,"GEDONG DALOM, WAY LIMA, PESAWARAN, LAMPUNG",1,35,195,230
https://kawalpemilu.org#24916,"GEDONG DALOM, WAY LIMA, PESAWARAN, LAMPUNG",2,54,154,208
https://kawalpemilu.org#24916,"GEDONG DALOM, WAY LIMA, PESAWARAN, LAMPUNG",3,115,100,215
https://kawalpemilu.org#24916,"GEDONG DALOM, WAY LIMA, PESAWARAN, LAMPUNG",4,47,156,203
https://kawalpemilu.org#24916,"GEDONG DALOM, WAY LIMA, PESAWARAN, LAMPUNG",5,102,153,255
https://kawalpemilu.org#24917,"SINDANG GARUT, WAY LIMA, PESAWARAN, LAMPUNG",1,72,132,204
https://kawalpemilu.org#24917,"SINDANG GARUT, WAY LIMA, PESAWARAN, LAMPUNG",2,146,101,247
https://kawalpemilu.org#24917,"SINDANG GARUT, WAY LIMA, PESAWARAN, LAMPUNG",3,106,109,215
https://kawalpemilu.org#24917,"SINDANG GARUT, WAY LIMA, PESAWARAN, LAMPUNG",4,140,54,194
https://kawalpemilu.org#24917,"SINDANG GARUT, WAY LIMA, PESAWARAN, LAMPUNG",5,111,12,123
https://kawalpemilu.org#24917,"SINDANG GARUT, WAY LIMA, PESAWARAN, LAMPUNG",6,48,102,151
https://kawalpemilu.org#24917,"SINDANG GARUT, WAY LIMA, PESAWARAN, LAMPUNG",7,112,58,170
https://kawalpemilu.org#24917,"SINDANG GARUT, WAY LIMA, PESAWARAN, LAMPUNG",8,105,8,113
https://kawalpemilu.org#24918,"BATU RAJA, WAY LIMA, PESAWARAN, LAMPUNG",1,28,204,232
https://kawalpemilu.org#24918,"BATU RAJA, WAY LIMA, PESAWARAN, LAMPUNG",2,19,233,252
https://kawalpemilu.org#24918,"BATU RAJA, WAY LIMA, PESAWARAN, LAMPUNG",3,81,181,262
https://kawalpemilu.org#24918,"BATU RAJA, WAY LIMA, PESAWARAN, LAMPUNG",4,55,178,233
https://kawalpemilu.org#24918,"BATU RAJA, WAY LIMA, PESAWARAN, LAMPUNG",5,31,120,151
https://kawalpemilu.org#24918,"BATU RAJA, WAY LIMA, PESAWARAN, LAMPUNG",6,14,162,176
https://kawalpemilu.org#24919,"WAY HARONG, WAY LIMA, PESAWARAN, LAMPUNG",1,66,52,118
https://kawalpemilu.org#24919,"WAY HARONG, WAY LIMA, PESAWARAN, LAMPUNG",2,37,80,117
https://kawalpemilu.org#24919,"WAY HARONG, WAY LIMA, PESAWARAN, LAMPUNG",3,90,124,214
https://kawalpemilu.org#24919,"WAY HARONG, WAY LIMA, PESAWARAN, LAMPUNG",4,27,156,183
https://kawalpemilu.org#24919,"WAY HARONG, WAY LIMA, PESAWARAN, LAMPUNG",5,52,148,200
https://kawalpemilu.org#24919,"WAY HARONG, WAY LIMA, PESAWARAN, LAMPUNG",6,70,50,120
https://kawalpemilu.org#24919,"WAY HARONG, WAY LIMA, PESAWARAN, LAMPUNG",7,117,139,256
https://kawalpemilu.org#24919,"WAY HARONG, WAY LIMA, PESAWARAN, LAMPUNG",8,130,60,190
https://kawalpemilu.org#24919,"WAY HARONG, WAY LIMA, PESAWARAN, LAMPUNG",9,144,59,203
https://kawalpemilu.org#24919,"WAY HARONG, WAY LIMA, PESAWARAN, LAMPUNG",10,119,113,232
https://kawalpemilu.org#24919,"WAY HARONG, WAY LIMA, PESAWARAN, LAMPUNG",11,109,92,201
https://kawalpemilu.org#24919,"WAY HARONG, WAY LIMA, PESAWARAN, LAMPUNG",12,64,89,153
https://kawalpemilu.org#24919,"WAY HARONG, WAY LIMA, PESAWARAN, LAMPUNG",13,44,109,153
https://kawalpemilu.org#24919,"WAY HARONG, WAY LIMA, PESAWARAN, LAMPUNG",14,117,90,207
https://kawalpemilu.org#24919,"WAY HARONG, WAY LIMA, PESAWARAN, LAMPUNG",15,92,88,180
https://kawalpemilu.org#24919,"WAY HARONG, WAY LIMA, PESAWARAN, LAMPUNG",16,109,63,172
https://kawalpemilu.org#24919,"WAY HARONG, WAY LIMA, PESAWARAN, LAMPUNG",17,109,49,158
https://kawalpemilu.org#24919,"WAY HARONG, WAY LIMA, PESAWARAN, LAMPUNG",18,83,136,219
https://kawalpemilu.org#24920,"GUNUNG REJO, WAY LIMA, PESAWARAN, LAMPUNG",1,115,60,175
https://kawalpemilu.org#24920,"GUNUNG REJO, WAY LIMA, PESAWARAN, LAMPUNG",2,124,64,188
https://kawalpemilu.org#24920,"GUNUNG REJO, WAY LIMA, PESAWARAN, LAMPUNG",3,122,71,193
https://kawalpemilu.org#24920,"GUNUNG REJO, WAY LIMA, PESAWARAN, LAMPUNG",4,104,58,162
https://kawalpemilu.org#24920,"GUNUNG REJO, WAY LIMA, PESAWARAN, LAMPUNG",5,89,62,151
https://kawalpemilu.org#24920,"GUNUNG REJO, WAY LIMA, PESAWARAN, LAMPUNG",6,48,65,113
https://kawalpemilu.org#24920,"GUNUNG REJO, WAY LIMA, PESAWARAN, LAMPUNG",7,45,56,101
https://kawalpemilu.org#24920,"GUNUNG REJO, WAY LIMA, PESAWARAN, LAMPUNG",8,73,70,143
https://kawalpemilu.org#24921,"MARGODADI, WAY LIMA, PESAWARAN, LAMPUNG",1,158,36,194
https://kawalpemilu.org#24921,"MARGODADI, WAY LIMA, PESAWARAN, LAMPUNG",2,146,33,179
https://kawalpemilu.org#24921,"MARGODADI, WAY LIMA, PESAWARAN, LAMPUNG",3,118,31,149
https://kawalpemilu.org#24921,"MARGODADI, WAY LIMA, PESAWARAN, LAMPUNG",4,179,27,200
https://kawalpemilu.org#24921,"MARGODADI, WAY LIMA, PESAWARAN, LAMPUNG",6,124,48,172
https://kawalpemilu.org#24921,"MARGODADI, WAY LIMA, PESAWARAN, LAMPUNG",7,116,27,143
https://kawalpemilu.org#24921,"MARGODADI, WAY LIMA, PESAWARAN, LAMPUNG",8,166,53,219
https://kawalpemilu.org#24922,"CIMANUK, WAY LIMA, PESAWARAN, LAMPUNG",1,36,135,171
https://kawalpemilu.org#24922,"CIMANUK, WAY LIMA, PESAWARAN, LAMPUNG",2,60,68,128
https://kawalpemilu.org#24922,"CIMANUK, WAY LIMA, PESAWARAN, LAMPUNG",3,78,153,231
https://kawalpemilu.org#24922,"CIMANUK, WAY LIMA, PESAWARAN, LAMPUNG",4,56,97,153
https://kawalpemilu.org#24922,"CIMANUK, WAY LIMA, PESAWARAN, LAMPUNG",5,56,139,195
https://kawalpemilu.org#24922,"CIMANUK, WAY LIMA, PESAWARAN, LAMPUNG",6,58,77,135
https://kawalpemilu.org#24922,"CIMANUK, WAY LIMA, PESAWARAN, LAMPUNG",7,50,97,147
https://kawalpemilu.org#24922,"CIMANUK, WAY LIMA, PESAWARAN, LAMPUNG",8,34,106,140
https://kawalpemilu.org#24922,"CIMANUK, WAY LIMA, PESAWARAN, LAMPUNG",9,76,76,152
https://kawalpemilu.org#24923,"SUKAMANDI, WAY LIMA, PESAWARAN, LAMPUNG",1,57,180,237
https://kawalpemilu.org#24923,"SUKAMANDI, WAY LIMA, PESAWARAN, LAMPUNG",2,73,60,133
https://kawalpemilu.org#24923,"SUKAMANDI, WAY LIMA, PESAWARAN, LAMPUNG",3,59,93,152
https://kawalpemilu.org#24923,"SUKAMANDI, WAY LIMA, PESAWARAN, LAMPUNG",4,95,72,167
https://kawalpemilu.org#24923,"SUKAMANDI, WAY LIMA, PESAWARAN, LAMPUNG",5,81,105,186
https://kawalpemilu.org#24924,"PAGUYUBAN, WAY LIMA, PESAWARAN, LAMPUNG",1,86,69,155
https://kawalpemilu.org#24924,"PAGUYUBAN, WAY LIMA, PESAWARAN, LAMPUNG",2,69,147,216
https://kawalpemilu.org#24924,"PAGUYUBAN, WAY LIMA, PESAWARAN, LAMPUNG",3,102,66,168
https://kawalpemilu.org#24924,"PAGUYUBAN, WAY LIMA, PESAWARAN, LAMPUNG",4,164,80,244
https://kawalpemilu.org#24924,"PAGUYUBAN, WAY LIMA, PESAWARAN, LAMPUNG",5,87,42,129
https://kawalpemilu.org#24924,"PAGUYUBAN, WAY LIMA, PESAWARAN, LAMPUNG",6,101,62,163
https://kawalpemilu.org#24924,"PAGUYUBAN, WAY LIMA, PESAWARAN, LAMPUNG",7,109,56,165
https://kawalpemilu.org#24926,"BANJARAN, PADANG CERMIN, PESAWARAN, LAMPUNG",1,124,23,147
https://kawalpemilu.org#24926,"BANJARAN, PADANG CERMIN, PESAWARAN, LAMPUNG",2,169,51,220
https://kawalpemilu.org#24926,"BANJARAN, PADANG CERMIN, PESAWARAN, LAMPUNG",3,83,92,175
https://kawalpemilu.org#24926,"BANJARAN, PADANG CERMIN, PESAWARAN, LAMPUNG",4,149,42,191
https://kawalpemilu.org#24926,"BANJARAN, PADANG CERMIN, PESAWARAN, LAMPUNG",5,147,32,179
https://kawalpemilu.org#24926,"BANJARAN, PADANG CERMIN, PESAWARAN, LAMPUNG",6,122,11,133
https://kawalpemilu.org#24926,"BANJARAN, PADANG CERMIN, PESAWARAN, LAMPUNG",7,155,62,217
https://kawalpemilu.org#24926,"BANJARAN, PADANG CERMIN, PESAWARAN, LAMPUNG",8,104,23,127
https://kawalpemilu.org#24926,"BANJARAN, PADANG CERMIN, PESAWARAN, LAMPUNG",9,179,39,218
https://kawalpemilu.org#24926,"BANJARAN, PADANG CERMIN, PESAWARAN, LAMPUNG",10,152,68,220
https://kawalpemilu.org#24926,"BANJARAN, PADANG CERMIN, PESAWARAN, LAMPUNG",11,107,50,157
https://kawalpemilu.org#24926,"BANJARAN, PADANG CERMIN, PESAWARAN, LAMPUNG",12,104,22,126
https://kawalpemilu.org#24926,"BANJARAN, PADANG CERMIN, PESAWARAN, LAMPUNG",13,135,11,146
https://kawalpemilu.org#24929,"DURIAN, PADANG CERMIN, PESAWARAN, LAMPUNG",1,92,87,179
https://kawalpemilu.org#24929,"DURIAN, PADANG CERMIN, PESAWARAN, LAMPUNG",2,128,89,217
https://kawalpemilu.org#24929,"DURIAN, PADANG CERMIN, PESAWARAN, LAMPUNG",3,105,38,143
https://kawalpemilu.org#24929,"DURIAN, PADANG CERMIN, PESAWARAN, LAMPUNG",4,97,46,143
https://kawalpemilu.org#24929,"DURIAN, PADANG CERMIN, PESAWARAN, LAMPUNG",5,67,63,130
https://kawalpemilu.org#24929,"DURIAN, PADANG CERMIN, PESAWARAN, LAMPUNG",6,84,32,116
https://kawalpemilu.org#24929,"DURIAN, PADANG CERMIN, PESAWARAN, LAMPUNG",7,110,53,163
https://kawalpemilu.org#24934,"HANAU BERAK, PADANG CERMIN, PESAWARAN, LAMPUNG",1,88,103,191
https://kawalpemilu.org#24934,"HANAU BERAK, PADANG CERMIN, PESAWARAN, LAMPUNG",2,136,76,212
https://kawalpemilu.org#24934,"HANAU BERAK, PADANG CERMIN, PESAWARAN, LAMPUNG",3,186,30,216
https://kawalpemilu.org#24934,"HANAU BERAK, PADANG CERMIN, PESAWARAN, LAMPUNG",4,160,36,196
https://kawalpemilu.org#24934,"HANAU BERAK, PADANG CERMIN, PESAWARAN, LAMPUNG",5,118,65,183
https://kawalpemilu.org#24934,"HANAU BERAK, PADANG CERMIN, PESAWARAN, LAMPUNG",6,143,27,170
https://kawalpemilu.org#24935,"PAYA, PADANG CERMIN, PESAWARAN, LAMPUNG",1,76,51,127
https://kawalpemilu.org#24935,"PAYA, PADANG CERMIN, PESAWARAN, LAMPUNG",2,123,10,133
https://kawalpemilu.org#24935,"PAYA, PADANG CERMIN, PESAWARAN, LAMPUNG",3,117,10,127
https://kawalpemilu.org#24935,"PAYA, PADANG CERMIN, PESAWARAN, LAMPUNG",4,92,41,133
https://kawalpemilu.org#24936,"PADANG CERMIN, PADANG CERMIN, PESAWARAN, LAMPUNG",1,119,23,142
https://kawalpemilu.org#24936,"PADANG CERMIN, PADANG CERMIN, PESAWARAN, LAMPUNG",2,167,55,222
https://kawalpemilu.org#24936,"PADANG CERMIN, PADANG CERMIN, PESAWARAN, LAMPUNG",3,87,107,194
https://kawalpemilu.org#24936,"PADANG CERMIN, PADANG CERMIN, PESAWARAN, LAMPUNG",4,175,39,214
https://kawalpemilu.org#24936,"PADANG CERMIN, PADANG CERMIN, PESAWARAN, LAMPUNG",5,102,113,215
https://kawalpemilu.org#24936,"PADANG CERMIN, PADANG CERMIN, PESAWARAN, LAMPUNG",6,82,105,187
https://kawalpemilu.org#24936,"PADANG CERMIN, PADANG CERMIN, PESAWARAN, LAMPUNG",7,119,82,201
https://kawalpemilu.org#24936,"PADANG CERMIN, PADANG CERMIN, PESAWARAN, LAMPUNG",8,96,73,169
https://kawalpemilu.org#24936,"PADANG CERMIN, PADANG CERMIN, PESAWARAN, LAMPUNG",9,116,116,232
https://kawalpemilu.org#24936,"PADANG CERMIN, PADANG CERMIN, PESAWARAN, LAMPUNG",10,91,118,209
https://kawalpemilu.org#24936,"PADANG CERMIN, PADANG CERMIN, PESAWARAN, LAMPUNG",11,125,48,173
https://kawalpemilu.org#24936,"PADANG CERMIN, PADANG CERMIN, PESAWARAN, LAMPUNG",12,105,73,178
https://kawalpemilu.org#24936,"PADANG CERMIN, PADANG CERMIN, PESAWARAN, LAMPUNG",13,165,28,193
https://kawalpemilu.org#24936,"PADANG CERMIN, PADANG CERMIN, PESAWARAN, LAMPUNG",14,161,26,191
https://kawalpemilu.org#24936,"PADANG CERMIN, PADANG CERMIN, PESAWARAN, LAMPUNG",15,175,25,200
https://kawalpemilu.org#24936,"PADANG CERMIN, PADANG CERMIN, PESAWARAN, LAMPUNG",16,183,4,187
https://kawalpemilu.org#24936,"PADANG CERMIN, PADANG CERMIN, PESAWARAN, LAMPUNG",17,175,27,202
https://kawalpemilu.org#24936,"PADANG CERMIN, PADANG CERMIN, PESAWARAN, LAMPUNG",18,190,10,200
https://kawalpemilu.org#24936,"PADANG CERMIN, PADANG CERMIN, PESAWARAN, LAMPUNG",19,217,26,243
https://kawalpemilu.org#24936,"PADANG CERMIN, PADANG CERMIN, PESAWARAN, LAMPUNG",20,197,31,228
https://kawalpemilu.org#24936,"PADANG CERMIN, PADANG CERMIN, PESAWARAN, LAMPUNG",21,130,30,160
https://kawalpemilu.org#24936,"PADANG CERMIN, PADANG CERMIN, PESAWARAN, LAMPUNG",22,58,61,119
https://kawalpemilu.org#24936,"PADANG CERMIN, PADANG CERMIN, PESAWARAN, LAMPUNG",23,135,19,154
https://kawalpemilu.org#24936,"PADANG CERMIN, PADANG CERMIN, PESAWARAN, LAMPUNG",24,56,42,98
https://kawalpemilu.org#24936,"PADANG CERMIN, PADANG CERMIN, PESAWARAN, LAMPUNG",25,138,36,174
https://kawalpemilu.org#24936,"PADANG CERMIN, PADANG CERMIN, PESAWARAN, LAMPUNG",26,113,65,178
https://kawalpemilu.org#24936,"PADANG CERMIN, PADANG CERMIN, PESAWARAN, LAMPUNG",27,128,56,184
https://kawalpemilu.org#24936,"PADANG CERMIN, PADANG CERMIN, PESAWARAN, LAMPUNG",28,150,20,170
https://kawalpemilu.org#24936,"PADANG CERMIN, PADANG CERMIN, PESAWARAN, LAMPUNG",29,122,27,149
https://kawalpemilu.org#24937,"SANGGI, PADANG CERMIN, PESAWARAN, LAMPUNG",2,167,71,238
https://kawalpemilu.org#24937,"SANGGI, PADANG CERMIN, PESAWARAN, LAMPUNG",3,128,76,204
https://kawalpemilu.org#24937,"SANGGI, PADANG CERMIN, PESAWARAN, LAMPUNG",4,149,73,222
https://kawalpemilu.org#24937,"SANGGI, PADANG CERMIN, PESAWARAN, LAMPUNG",5,133,48,181
https://kawalpemilu.org#24937,"SANGGI, PADANG CERMIN, PESAWARAN, LAMPUNG",6,139,48,187
https://kawalpemilu.org#24937,"SANGGI, PADANG CERMIN, PESAWARAN, LAMPUNG",7,55,40,95
https://kawalpemilu.org#24937,"SANGGI, PADANG CERMIN, PESAWARAN, LAMPUNG",8,125,41,166
https://kawalpemilu.org#24941,"TAMBANGAN, PADANG CERMIN, PESAWARAN, LAMPUNG",1,69,144,213
https://kawalpemilu.org#24941,"TAMBANGAN, PADANG CERMIN, PESAWARAN, LAMPUNG",2,123,27,150
https://kawalpemilu.org#24941,"TAMBANGAN, PADANG CERMIN, PESAWARAN, LAMPUNG",3,96,109,205
https://kawalpemilu.org#24942,"WAY URANG, PADANG CERMIN, PESAWARAN, LAMPUNG",1,60,130,190
https://kawalpemilu.org#24942,"WAY URANG, PADANG CERMIN, PESAWARAN, LAMPUNG",2,41,133,174
https://kawalpemilu.org#24942,"WAY URANG, PADANG CERMIN, PESAWARAN, LAMPUNG",3,135,37,172
https://kawalpemilu.org#24942,"WAY URANG, PADANG CERMIN, PESAWARAN, LAMPUNG",5,113,28,141
https://kawalpemilu.org#87861,"KHEPONG JAYA, PADANG CERMIN, PESAWARAN, LAMPUNG",1,91,122,213
https://kawalpemilu.org#87861,"KHEPONG JAYA, PADANG CERMIN, PESAWARAN, LAMPUNG",2,124,71,195
https://kawalpemilu.org#87861,"KHEPONG JAYA, PADANG CERMIN, PESAWARAN, LAMPUNG",3,122,74,196
https://kawalpemilu.org#87862,"TRIMULYO, PADANG CERMIN, PESAWARAN, LAMPUNG",1,135,24,159
https://kawalpemilu.org#87862,"TRIMULYO, PADANG CERMIN, PESAWARAN, LAMPUNG",2,207,18,225
https://kawalpemilu.org#87862,"TRIMULYO, PADANG CERMIN, PESAWARAN, LAMPUNG",3,92,22,114
https://kawalpemilu.org#927497,"GAYAU, PADANG CERMIN, PESAWARAN, LAMPUNG",1,155,30,185
https://kawalpemilu.org#927497,"GAYAU, PADANG CERMIN, PESAWARAN, LAMPUNG",2,147,71,218
https://kawalpemilu.org#927497,"GAYAU, PADANG CERMIN, PESAWARAN, LAMPUNG",3,163,34,197
https://kawalpemilu.org#927497,"GAYAU, PADANG CERMIN, PESAWARAN, LAMPUNG",4,123,27,150
https://kawalpemilu.org#927497,"GAYAU, PADANG CERMIN, PESAWARAN, LAMPUNG",5,147,54,201
https://kawalpemilu.org#24950,"BAWANG, PUNDUH PIDADA, PESAWARAN, LAMPUNG",1,60,52,112
https://kawalpemilu.org#24950,"BAWANG, PUNDUH PIDADA, PESAWARAN, LAMPUNG",2,150,80,230
https://kawalpemilu.org#24950,"BAWANG, PUNDUH PIDADA, PESAWARAN, LAMPUNG",3,156,26,182
https://kawalpemilu.org#24950,"BAWANG, PUNDUH PIDADA, PESAWARAN, LAMPUNG",4,192,44,236
https://kawalpemilu.org#24950,"BAWANG, PUNDUH PIDADA, PESAWARAN, LAMPUNG",5,114,41,155
https://kawalpemilu.org#24951,"BANDING AGUNG, PUNDUH PIDADA, PESAWARAN, LAMPUNG",1,78,116,194
https://kawalpemilu.org#24951,"BANDING AGUNG, PUNDUH PIDADA, PESAWARAN, LAMPUNG",2,50,119,169
https://kawalpemilu.org#24951,"BANDING AGUNG, PUNDUH PIDADA, PESAWARAN, LAMPUNG",3,107,29,136
https://kawalpemilu.org#24952,"BATU RAJA, PUNDUH PIDADA, PESAWARAN, LAMPUNG",1,26,126,152
https://kawalpemilu.org#24952,"BATU RAJA, PUNDUH PIDADA, PESAWARAN, LAMPUNG",3,53,45,98
https://kawalpemilu.org#24952,"BATU RAJA, PUNDUH PIDADA, PESAWARAN, LAMPUNG",4,136,40,176
https://kawalpemilu.org#24952,"BATU RAJA, PUNDUH PIDADA, PESAWARAN, LAMPUNG",5,96,27,123
https://kawalpemilu.org#24952,"BATU RAJA, PUNDUH PIDADA, PESAWARAN, LAMPUNG",6,106,59,165
https://kawalpemilu.org#24953,"SUKAJAYA PIDADA, PUNDUH PIDADA, PESAWARAN, LAMPUNG",1,40,147,187
https://kawalpemilu.org#24953,"SUKAJAYA PIDADA, PUNDUH PIDADA, PESAWARAN, LAMPUNG",2,93,55,148
https://kawalpemilu.org#24954,"RUSABA, PUNDUH PIDADA, PESAWARAN, LAMPUNG",1,41,80,121
https://kawalpemilu.org#24954,"RUSABA, PUNDUH PIDADA, PESAWARAN, LAMPUNG",2,131,13,144
https://kawalpemilu.org#24954,"RUSABA, PUNDUH PIDADA, PESAWARAN, LAMPUNG",3,37,57,94
https://kawalpemilu.org#24955,"KOTA JAWA, PUNDUH PIDADA, PESAWARAN, LAMPUNG",1,87,89,176
https://kawalpemilu.org#24955,"KOTA JAWA, PUNDUH PIDADA, PESAWARAN, LAMPUNG",2,119,71,190
https://kawalpemilu.org#24955,"KOTA JAWA, PUNDUH PIDADA, PESAWARAN, LAMPUNG",3,94,17,111
https://kawalpemilu.org#24955,"KOTA JAWA, PUNDUH PIDADA, PESAWARAN, LAMPUNG",4,46,87,133
https://kawalpemilu.org#24965,"SUKARAME, PUNDUH PIDADA, PESAWARAN, LAMPUNG",1,93,70,163
https://kawalpemilu.org#24965,"SUKARAME, PUNDUH PIDADA, PESAWARAN, LAMPUNG",2,176,38,214
https://kawalpemilu.org#24965,"SUKARAME, PUNDUH PIDADA, PESAWARAN, LAMPUNG",3,172,29,201
https://kawalpemilu.org#24965,"SUKARAME, PUNDUH PIDADA, PESAWARAN, LAMPUNG",4,94,16,110
https://kawalpemilu.org#24965,"SUKARAME, PUNDUH PIDADA, PESAWARAN, LAMPUNG",5,46,33,79
https://kawalpemilu.org#24965,"SUKARAME, PUNDUH PIDADA, PESAWARAN, LAMPUNG",6,64,20,84
https://kawalpemilu.org#24966,"PAGAR JAYA, PUNDUH PIDADA, PESAWARAN, LAMPUNG",1,131,30,161
https://kawalpemilu.org#24966,"PAGAR JAYA, PUNDUH PIDADA, PESAWARAN, LAMPUNG",3,86,21,107
https://kawalpemilu.org#24966,"PAGAR JAYA, PUNDUH PIDADA, PESAWARAN, LAMPUNG",4,160,32,192
https://kawalpemilu.org#24966,"PAGAR JAYA, PUNDUH PIDADA, PESAWARAN, LAMPUNG",5,124,25,149
https://kawalpemilu.org#24968,"PULAU LEGUNDI, PUNDUH PIDADA, PESAWARAN, LAMPUNG",1,50,148,198
https://kawalpemilu.org#24968,"PULAU LEGUNDI, PUNDUH PIDADA, PESAWARAN, LAMPUNG",2,79,90,169
https://kawalpemilu.org#24968,"PULAU LEGUNDI, PUNDUH PIDADA, PESAWARAN, LAMPUNG",3,57,96,153
https://kawalpemilu.org#24968,"PULAU LEGUNDI, PUNDUH PIDADA, PESAWARAN, LAMPUNG",4,26,58,84
https://kawalpemilu.org#24968,"PULAU LEGUNDI, PUNDUH PIDADA, PESAWARAN, LAMPUNG",5,58,63,121
https://kawalpemilu.org#24968,"PULAU LEGUNDI, PUNDUH PIDADA, PESAWARAN, LAMPUNG",6,112,37,149
https://kawalpemilu.org#24968,"PULAU LEGUNDI, PUNDUH PIDADA, PESAWARAN, LAMPUNG",7,63,98,161
https://kawalpemilu.org#24969,"SUKA MAJU, PUNDUH PIDADA, PESAWARAN, LAMPUNG",1,125,87,212
https://kawalpemilu.org#24969,"SUKA MAJU, PUNDUH PIDADA, PESAWARAN, LAMPUNG",2,148,57,205
https://kawalpemilu.org#24969,"SUKA MAJU, PUNDUH PIDADA, PESAWARAN, LAMPUNG",3,185,38,223
https://kawalpemilu.org#24969,"SUKA MAJU, PUNDUH PIDADA, PESAWARAN, LAMPUNG",4,170,41,211
https://kawalpemilu.org#24969,"SUKA MAJU, PUNDUH PIDADA, PESAWARAN, LAMPUNG",5,131,16,147
https://kawalpemilu.org#24969,"SUKA MAJU, PUNDUH PIDADA, PESAWARAN, LAMPUNG",6,45,45,90
https://kawalpemilu.org#24971,"BANGUN REJO, PUNDUH PIDADA, PESAWARAN, LAMPUNG",1,140,27,167
https://kawalpemilu.org#24971,"BANGUN REJO, PUNDUH PIDADA, PESAWARAN, LAMPUNG",2,117,41,158
https://kawalpemilu.org#24971,"BANGUN REJO, PUNDUH PIDADA, PESAWARAN, LAMPUNG",3,174,25,199
https://kawalpemilu.org#24971,"BANGUN REJO, PUNDUH PIDADA, PESAWARAN, LAMPUNG",4,115,19,134
https://kawalpemilu.org#24971,"BANGUN REJO, PUNDUH PIDADA, PESAWARAN, LAMPUNG",5,132,43,175
https://kawalpemilu.org#24971,"BANGUN REJO, PUNDUH PIDADA, PESAWARAN, LAMPUNG",6,93,49,142
https://kawalpemilu.org#24971,"BANGUN REJO, PUNDUH PIDADA, PESAWARAN, LAMPUNG",7,154,25,179
https://kawalpemilu.org#24980,"WAY KEPAYANG, KEDONDONG, PESAWARAN, LAMPUNG",1,44,156,200
https://kawalpemilu.org#24980,"WAY KEPAYANG, KEDONDONG, PESAWARAN, LAMPUNG",2,51,116,167
https://kawalpemilu.org#24980,"WAY KEPAYANG, KEDONDONG, PESAWARAN, LAMPUNG",3,93,64,157
https://kawalpemilu.org#24980,"WAY KEPAYANG, KEDONDONG, PESAWARAN, LAMPUNG",4,118,53,171
https://kawalpemilu.org#24980,"WAY KEPAYANG, KEDONDONG, PESAWARAN, LAMPUNG",5,90,94,184
https://kawalpemilu.org#24980,"WAY KEPAYANG, KEDONDONG, PESAWARAN, LAMPUNG",6,26,80,106
https://kawalpemilu.org#24980,"WAY KEPAYANG, KEDONDONG, PESAWARAN, LAMPUNG",7,59,78,137
https://kawalpemilu.org#24981,"SUKAMAJU, KEDONDONG, PESAWARAN, LAMPUNG",1,114,59,173
https://kawalpemilu.org#24981,"SUKAMAJU, KEDONDONG, PESAWARAN, LAMPUNG",2,158,68,226
https://kawalpemilu.org#24981,"SUKAMAJU, KEDONDONG, PESAWARAN, LAMPUNG",3,112,66,178
https://kawalpemilu.org#24981,"SUKAMAJU, KEDONDONG, PESAWARAN, LAMPUNG",4,144,31,175
https://kawalpemilu.org#24981,"SUKAMAJU, KEDONDONG, PESAWARAN, LAMPUNG",5,141,76,217
https://kawalpemilu.org#24981,"SUKAMAJU, KEDONDONG, PESAWARAN, LAMPUNG",6,130,106,236
https://kawalpemilu.org#24981,"SUKAMAJU, KEDONDONG, PESAWARAN, LAMPUNG",7,106,49,155
https://kawalpemilu.org#24982,"KEDONDONG, KEDONDONG, PESAWARAN, LAMPUNG",1,77,148,225
https://kawalpemilu.org#24982,"KEDONDONG, KEDONDONG, PESAWARAN, LAMPUNG",2,40,152,192
https://kawalpemilu.org#24982,"KEDONDONG, KEDONDONG, PESAWARAN, LAMPUNG",3,60,178,244
https://kawalpemilu.org#24982,"KEDONDONG, KEDONDONG, PESAWARAN, LAMPUNG",5,72,175,247
https://kawalpemilu.org#24982,"KEDONDONG, KEDONDONG, PESAWARAN, LAMPUNG",6,67,140,207
https://kawalpemilu.org#24982,"KEDONDONG, KEDONDONG, PESAWARAN, LAMPUNG",7,83,77,160
https://kawalpemilu.org#24982,"KEDONDONG, KEDONDONG, PESAWARAN, LAMPUNG",9,141,80,221
https://kawalpemilu.org#24982,"KEDONDONG, KEDONDONG, PESAWARAN, LAMPUNG",10,128,31,159
https://kawalpemilu.org#24982,"KEDONDONG, KEDONDONG, PESAWARAN, LAMPUNG",11,160,28,188
https://kawalpemilu.org#24982,"KEDONDONG, KEDONDONG, PESAWARAN, LAMPUNG",13,72,83,155
https://kawalpemilu.org#24982,"KEDONDONG, KEDONDONG, PESAWARAN, LAMPUNG",14,49,37,86
https://kawalpemilu.org#24983,"PASAR BARU, KEDONDONG, PESAWARAN, LAMPUNG",1,94,82,176
https://kawalpemilu.org#24983,"PASAR BARU, KEDONDONG, PESAWARAN, LAMPUNG",2,44,65,109
https://kawalpemilu.org#24983,"PASAR BARU, KEDONDONG, PESAWARAN, LAMPUNG",3,86,121,207
https://kawalpemilu.org#24983,"PASAR BARU, KEDONDONG, PESAWARAN, LAMPUNG",4,46,79,125
https://kawalpemilu.org#24983,"PASAR BARU, KEDONDONG, PESAWARAN, LAMPUNG",5,77,84,161
https://kawalpemilu.org#24983,"PASAR BARU, KEDONDONG, PESAWARAN, LAMPUNG",6,80,89,169
https://kawalpemilu.org#24983,"PASAR BARU, KEDONDONG, PESAWARAN, LAMPUNG",7,21,103,194
https://kawalpemilu.org#24983,"PASAR BARU, KEDONDONG, PESAWARAN, LAMPUNG",8,54,84,138
https://kawalpemilu.org#24983,"PASAR BARU, KEDONDONG, PESAWARAN, LAMPUNG",9,50,64,114
https://kawalpemilu.org#24983,"PASAR BARU, KEDONDONG, PESAWARAN, LAMPUNG",10,36,91,127
https://kawalpemilu.org#24983,"PASAR BARU, KEDONDONG, PESAWARAN, LAMPUNG",11,72,113,185
https://kawalpemilu.org#24983,"PASAR BARU, KEDONDONG, PESAWARAN, LAMPUNG",12,48,112,160
https://kawalpemilu.org#24983,"PASAR BARU, KEDONDONG, PESAWARAN, LAMPUNG",13,80,89,169
https://kawalpemilu.org#24983,"PASAR BARU, KEDONDONG, PESAWARAN, LAMPUNG",14,53,87,143
https://kawalpemilu.org#24983,"PASAR BARU, KEDONDONG, PESAWARAN, LAMPUNG",15,35,120,155
https://kawalpemilu.org#24983,"PASAR BARU, KEDONDONG, PESAWARAN, LAMPUNG",16,23,125,148
https://kawalpemilu.org#24983,"PASAR BARU, KEDONDONG, PESAWARAN, LAMPUNG",17,72,76,0
https://kawalpemilu.org#24983,"PASAR BARU, KEDONDONG, PESAWARAN, LAMPUNG",18,39,84,123
https://kawalpemilu.org#24984,"TEMPEL REJO, KEDONDONG, PESAWARAN, LAMPUNG",1,128,54,182
https://kawalpemilu.org#24984,"TEMPEL REJO, KEDONDONG, PESAWARAN, LAMPUNG",2,96,92,188
https://kawalpemilu.org#24984,"TEMPEL REJO, KEDONDONG, PESAWARAN, LAMPUNG",3,115,41,156
https://kawalpemilu.org#24984,"TEMPEL REJO, KEDONDONG, PESAWARAN, LAMPUNG",4,50,134,184
https://kawalpemilu.org#24984,"TEMPEL REJO, KEDONDONG, PESAWARAN, LAMPUNG",5,152,47,199
https://kawalpemilu.org#24984,"TEMPEL REJO, KEDONDONG, PESAWARAN, LAMPUNG",6,94,65,159
https://kawalpemilu.org#24984,"TEMPEL REJO, KEDONDONG, PESAWARAN, LAMPUNG",7,76,58,134
https://kawalpemilu.org#24984,"TEMPEL REJO, KEDONDONG, PESAWARAN, LAMPUNG",8,108,55,163
https://kawalpemilu.org#24984,"TEMPEL REJO, KEDONDONG, PESAWARAN, LAMPUNG",9,131,59,190
https://kawalpemilu.org#24984,"TEMPEL REJO, KEDONDONG, PESAWARAN, LAMPUNG",10,111,31,142
https://kawalpemilu.org#24984,"TEMPEL REJO, KEDONDONG, PESAWARAN, LAMPUNG",11,112,26,138
https://kawalpemilu.org#24984,"TEMPEL REJO, KEDONDONG, PESAWARAN, LAMPUNG",12,103,82,185
https://kawalpemilu.org#24984,"TEMPEL REJO, KEDONDONG, PESAWARAN, LAMPUNG",13,99,42,141
https://kawalpemilu.org#24984,"TEMPEL REJO, KEDONDONG, PESAWARAN, LAMPUNG",14,94,65,159
https://kawalpemilu.org#24984,"TEMPEL REJO, KEDONDONG, PESAWARAN, LAMPUNG",15,77,60,137
https://kawalpemilu.org#24985,"KERTA SANA, KEDONDONG, PESAWARAN, LAMPUNG",1,38,173,211
https://kawalpemilu.org#24985,"KERTA SANA, KEDONDONG, PESAWARAN, LAMPUNG",2,32,142,174
https://kawalpemilu.org#24985,"KERTA SANA, KEDONDONG, PESAWARAN, LAMPUNG",3,108,80,188
https://kawalpemilu.org#24985,"KERTA SANA, KEDONDONG, PESAWARAN, LAMPUNG",4,113,93,206
https://kawalpemilu.org#24985,"KERTA SANA, KEDONDONG, PESAWARAN, LAMPUNG",5,110,71,181
https://kawalpemilu.org#24985,"KERTA SANA, KEDONDONG, PESAWARAN, LAMPUNG",6,41,91,132
https://kawalpemilu.org#24986,"GUNUNG SUGIH, KEDONDONG, PESAWARAN, LAMPUNG",1,77,127,204
https://kawalpemilu.org#24986,"GUNUNG SUGIH, KEDONDONG, PESAWARAN, LAMPUNG",2,52,172,224
https://kawalpemilu.org#24986,"GUNUNG SUGIH, KEDONDONG, PESAWARAN, LAMPUNG",3,90,127,217
https://kawalpemilu.org#24986,"GUNUNG SUGIH, KEDONDONG, PESAWARAN, LAMPUNG",4,21,179,200
https://kawalpemilu.org#24986,"GUNUNG SUGIH, KEDONDONG, PESAWARAN, LAMPUNG",5,52,175,227
https://kawalpemilu.org#24986,"GUNUNG SUGIH, KEDONDONG, PESAWARAN, LAMPUNG",6,96,135,231
https://kawalpemilu.org#24986,"GUNUNG SUGIH, KEDONDONG, PESAWARAN, LAMPUNG",7,40,92,132
https://kawalpemilu.org#24989,"SINAR HARAPAN, KEDONDONG, PESAWARAN, LAMPUNG",1,99,75,174
https://kawalpemilu.org#24989,"SINAR HARAPAN, KEDONDONG, PESAWARAN, LAMPUNG",2,147,30,177
https://kawalpemilu.org#24989,"SINAR HARAPAN, KEDONDONG, PESAWARAN, LAMPUNG",3,143,36,179
https://kawalpemilu.org#24989,"SINAR HARAPAN, KEDONDONG, PESAWARAN, LAMPUNG",4,184,62,246
https://kawalpemilu.org#24989,"SINAR HARAPAN, KEDONDONG, PESAWARAN, LAMPUNG",5,203,22,225
https://kawalpemilu.org#24989,"SINAR HARAPAN, KEDONDONG, PESAWARAN, LAMPUNG",6,118,85,203
https://kawalpemilu.org#24989,"SINAR HARAPAN, KEDONDONG, PESAWARAN, LAMPUNG",7,125,43,168
https://kawalpemilu.org#24989,"SINAR HARAPAN, KEDONDONG, PESAWARAN, LAMPUNG",8,118,72,190
https://kawalpemilu.org#24989,"SINAR HARAPAN, KEDONDONG, PESAWARAN, LAMPUNG",9,147,29,176
https://kawalpemilu.org#24989,"SINAR HARAPAN, KEDONDONG, PESAWARAN, LAMPUNG",10,106,94,200
https://kawalpemilu.org#24989,"SINAR HARAPAN, KEDONDONG, PESAWARAN, LAMPUNG",11,114,36,150
https://kawalpemilu.org#24989,"SINAR HARAPAN, KEDONDONG, PESAWARAN, LAMPUNG",12,176,34,210
https://kawalpemilu.org#24989,"SINAR HARAPAN, KEDONDONG, PESAWARAN, LAMPUNG",13,61,52,113
https://kawalpemilu.org#24990,"TEBA JAWA, KEDONDONG, PESAWARAN, LAMPUNG",1,73,153,226
https://kawalpemilu.org#24990,"TEBA JAWA, KEDONDONG, PESAWARAN, LAMPUNG",2,65,142,207
https://kawalpemilu.org#24990,"TEBA JAWA, KEDONDONG, PESAWARAN, LAMPUNG",3,94,97,191
https://kawalpemilu.org#24991,"BABAKAN LOA, KEDONDONG, PESAWARAN, LAMPUNG",1,211,24,235
https://kawalpemilu.org#24991,"BABAKAN LOA, KEDONDONG, PESAWARAN, LAMPUNG",2,106,38,144
https://kawalpemilu.org#24991,"BABAKAN LOA, KEDONDONG, PESAWARAN, LAMPUNG",3,180,70,250
https://kawalpemilu.org#24991,"BABAKAN LOA, KEDONDONG, PESAWARAN, LAMPUNG",4,230,54,284
https://kawalpemilu.org#24991,"BABAKAN LOA, KEDONDONG, PESAWARAN, LAMPUNG",5,194,37,231
https://kawalpemilu.org#24992,"PESAWARAN, KEDONDONG, PESAWARAN, LAMPUNG",1,103,32,135
https://kawalpemilu.org#24992,"PESAWARAN, KEDONDONG, PESAWARAN, LAMPUNG",2,51,141,192
https://kawalpemilu.org#24992,"PESAWARAN, KEDONDONG, PESAWARAN, LAMPUNG",3,122,68,190
https://kawalpemilu.org#24992,"PESAWARAN, KEDONDONG, PESAWARAN, LAMPUNG",4,108,60,168
https://kawalpemilu.org#24992,"PESAWARAN, KEDONDONG, PESAWARAN, LAMPUNG",5,189,82,271
https://kawalpemilu.org#24992,"PESAWARAN, KEDONDONG, PESAWARAN, LAMPUNG",6,159,60,219
https://kawalpemilu.org#24992,"PESAWARAN, KEDONDONG, PESAWARAN, LAMPUNG",7,164,83,247
https://kawalpemilu.org#24992,"PESAWARAN, KEDONDONG, PESAWARAN, LAMPUNG",8,97,74,171
https://kawalpemilu.org#24992,"PESAWARAN, KEDONDONG, PESAWARAN, LAMPUNG",9,69,40,109
https://kawalpemilu.org#24992,"PESAWARAN, KEDONDONG, PESAWARAN, LAMPUNG",10,94,88,182
https://kawalpemilu.org#87867,"HARAPAN JAYA, KEDONDONG, PESAWARAN, LAMPUNG",1,129,35,164
https://kawalpemilu.org#87867,"HARAPAN JAYA, KEDONDONG, PESAWARAN, LAMPUNG",2,158,42,200
https://kawalpemilu.org#87867,"HARAPAN JAYA, KEDONDONG, PESAWARAN, LAMPUNG",3,173,30,203
https://kawalpemilu.org#87867,"HARAPAN JAYA, KEDONDONG, PESAWARAN, LAMPUNG",4,93,48,141
https://kawalpemilu.org#24956,"KAMPUNG BARU, MARGA PUNDUH, PESAWARAN, LAMPUNG",1,100,28,128
https://kawalpemilu.org#24956,"KAMPUNG BARU, MARGA PUNDUH, PESAWARAN, LAMPUNG",2,77,94,171
https://kawalpemilu.org#24956,"KAMPUNG BARU, MARGA PUNDUH, PESAWARAN, LAMPUNG",3,52,127,179
https://kawalpemilu.org#24956,"KAMPUNG BARU, MARGA PUNDUH, PESAWARAN, LAMPUNG",4,103,73,176
https://kawalpemilu.org#24956,"KAMPUNG BARU, MARGA PUNDUH, PESAWARAN, LAMPUNG",5,177,30,207
https://kawalpemilu.org#24956,"KAMPUNG BARU, MARGA PUNDUH, PESAWARAN, LAMPUNG",6,60,91,151
https://kawalpemilu.org#24956,"KAMPUNG BARU, MARGA PUNDUH, PESAWARAN, LAMPUNG",7,111,88,199
https://kawalpemilu.org#24957,"KEKATANG, MARGA PUNDUH, PESAWARAN, LAMPUNG",1,43,124,167
https://kawalpemilu.org#24957,"KEKATANG, MARGA PUNDUH, PESAWARAN, LAMPUNG",2,87,81,168
https://kawalpemilu.org#24957,"KEKATANG, MARGA PUNDUH, PESAWARAN, LAMPUNG",3,80,45,125
https://kawalpemilu.org#24958,"KUNYAIAN, MARGA PUNDUH, PESAWARAN, LAMPUNG",1,105,141,246
https://kawalpemilu.org#24959,"PEKON AMPAI, MARGA PUNDUH, PESAWARAN, LAMPUNG",1,50,117,167
https://kawalpemilu.org#24959,"PEKON AMPAI, MARGA PUNDUH, PESAWARAN, LAMPUNG",2,32,154,186
https://kawalpemilu.org#24959,"PEKON AMPAI, MARGA PUNDUH, PESAWARAN, LAMPUNG",3,65,71,136
https://kawalpemilu.org#24960,"UMBUL LIMUS, MARGA PUNDUH, PESAWARAN, LAMPUNG",1,40,106,146
https://kawalpemilu.org#24960,"UMBUL LIMUS, MARGA PUNDUH, PESAWARAN, LAMPUNG",2,70,90,160
https://kawalpemilu.org#24961,"TAJUR, MARGA PUNDUH, PESAWARAN, LAMPUNG",1,42,77,119
https://kawalpemilu.org#24961,"TAJUR, MARGA PUNDUH, PESAWARAN, LAMPUNG",2,165,45,210
https://kawalpemilu.org#24961,"TAJUR, MARGA PUNDUH, PESAWARAN, LAMPUNG",3,57,53,110
https://kawalpemilu.org#24962,"MAJA, MARGA PUNDUH, PESAWARAN, LAMPUNG",1,61,66,127
https://kawalpemilu.org#24962,"MAJA, MARGA PUNDUH, PESAWARAN, LAMPUNG",2,45,64,109
https://kawalpemilu.org#24962,"MAJA, MARGA PUNDUH, PESAWARAN, LAMPUNG",3,66,69,135
https://kawalpemilu.org#24962,"MAJA, MARGA PUNDUH, PESAWARAN, LAMPUNG",4,236,39,275
https://kawalpemilu.org#24962,"MAJA, MARGA PUNDUH, PESAWARAN, LAMPUNG",5,117,48,165
https://kawalpemilu.org#24962,"MAJA, MARGA PUNDUH, PESAWARAN, LAMPUNG",6,124,6,130
https://kawalpemilu.org#24962,"MAJA, MARGA PUNDUH, PESAWARAN, LAMPUNG",7,115,45,160
https://kawalpemilu.org#24962,"MAJA, MARGA PUNDUH, PESAWARAN, LAMPUNG",8,181,19,200
https://kawalpemilu.org#24962,"MAJA, MARGA PUNDUH, PESAWARAN, LAMPUNG",9,77,51,128
https://kawalpemilu.org#24962,"MAJA, MARGA PUNDUH, PESAWARAN, LAMPUNG",10,59,71,130
https://kawalpemilu.org#24962,"MAJA, MARGA PUNDUH, PESAWARAN, LAMPUNG",11,72,63,135
https://kawalpemilu.org#24962,"MAJA, MARGA PUNDUH, PESAWARAN, LAMPUNG",12,70,80,150
https://kawalpemilu.org#24962,"MAJA, MARGA PUNDUH, PESAWARAN, LAMPUNG",13,168,36,204
https://kawalpemilu.org#24962,"MAJA, MARGA PUNDUH, PESAWARAN, LAMPUNG",14,151,27,178
https://kawalpemilu.org#24963,"PENYANDINGAN, MARGA PUNDUH, PESAWARAN, LAMPUNG",1,109,36,145
https://kawalpemilu.org#24963,"PENYANDINGAN, MARGA PUNDUH, PESAWARAN, LAMPUNG",2,142,69,211
https://kawalpemilu.org#24963,"PENYANDINGAN, MARGA PUNDUH, PESAWARAN, LAMPUNG",3,135,56,191
https://kawalpemilu.org#24963,"PENYANDINGAN, MARGA PUNDUH, PESAWARAN, LAMPUNG",4,160,21,181
https://kawalpemilu.org#24963,"PENYANDINGAN, MARGA PUNDUH, PESAWARAN, LAMPUNG",5,96,38,134
https://kawalpemilu.org#24963,"PENYANDINGAN, MARGA PUNDUH, PESAWARAN, LAMPUNG",6,126,46,172
https://kawalpemilu.org#24963,"PENYANDINGAN, MARGA PUNDUH, PESAWARAN, LAMPUNG",7,76,48,124
https://kawalpemilu.org#24964,"SUKAJAYA PUNDUH, MARGA PUNDUH, PESAWARAN, LAMPUNG",1,78,104,182
https://kawalpemilu.org#24964,"SUKAJAYA PUNDUH, MARGA PUNDUH, PESAWARAN, LAMPUNG",2,132,88,220
https://kawalpemilu.org#24964,"SUKAJAYA PUNDUH, MARGA PUNDUH, PESAWARAN, LAMPUNG",3,93,117,210
https://kawalpemilu.org#24964,"SUKAJAYA PUNDUH, MARGA PUNDUH, PESAWARAN, LAMPUNG",4,96,49,145
https://kawalpemilu.org#24964,"SUKAJAYA PUNDUH, MARGA PUNDUH, PESAWARAN, LAMPUNG",5,237,23,260
https://kawalpemilu.org#24964,"SUKAJAYA PUNDUH, MARGA PUNDUH, PESAWARAN, LAMPUNG",6,33,119,152
https://kawalpemilu.org#24964,"SUKAJAYA PUNDUH, MARGA PUNDUH, PESAWARAN, LAMPUNG",7,45,118,163
https://kawalpemilu.org#24967,"PULAU PAHAWANG, MARGA PUNDUH, PESAWARAN, LAMPUNG",1,104,32,136
https://kawalpemilu.org#24967,"PULAU PAHAWANG, MARGA PUNDUH, PESAWARAN, LAMPUNG",2,213,43,256
https://kawalpemilu.org#24967,"PULAU PAHAWANG, MARGA PUNDUH, PESAWARAN, LAMPUNG",3,122,38,160
https://kawalpemilu.org#24967,"PULAU PAHAWANG, MARGA PUNDUH, PESAWARAN, LAMPUNG",4,144,11,155
https://kawalpemilu.org#24967,"PULAU PAHAWANG, MARGA PUNDUH, PESAWARAN, LAMPUNG",5,160,28,188
https://kawalpemilu.org#24973,"PENENGAHAN, WAY KHILAU, PESAWARAN, LAMPUNG",1,98,43,141
https://kawalpemilu.org#24973,"PENENGAHAN, WAY KHILAU, PESAWARAN, LAMPUNG",2,39,86,125
https://kawalpemilu.org#24973,"PENENGAHAN, WAY KHILAU, PESAWARAN, LAMPUNG",3,44,132,176
https://kawalpemilu.org#24973,"PENENGAHAN, WAY KHILAU, PESAWARAN, LAMPUNG",4,27,103,130
https://kawalpemilu.org#24973,"PENENGAHAN, WAY KHILAU, PESAWARAN, LAMPUNG",5,20,98,118
https://kawalpemilu.org#24973,"PENENGAHAN, WAY KHILAU, PESAWARAN, LAMPUNG",6,50,86,136
https://kawalpemilu.org#24973,"PENENGAHAN, WAY KHILAU, PESAWARAN, LAMPUNG",7,38,73,111
https://kawalpemilu.org#24973,"PENENGAHAN, WAY KHILAU, PESAWARAN, LAMPUNG",8,61,43,104
https://kawalpemilu.org#24973,"PENENGAHAN, WAY KHILAU, PESAWARAN, LAMPUNG",9,54,85,139
https://kawalpemilu.org#24973,"PENENGAHAN, WAY KHILAU, PESAWARAN, LAMPUNG",10,25,106,131
https://kawalpemilu.org#24973,"PENENGAHAN, WAY KHILAU, PESAWARAN, LAMPUNG",11,33,103,136
https://kawalpemilu.org#24973,"PENENGAHAN, WAY KHILAU, PESAWARAN, LAMPUNG",12,31,112,143
https://kawalpemilu.org#24973,"PENENGAHAN, WAY KHILAU, PESAWARAN, LAMPUNG",13,28,78,106
https://kawalpemilu.org#24974,"SUKAJAYA, WAY KHILAU, PESAWARAN, LAMPUNG",1,83,158,241
https://kawalpemilu.org#24974,"SUKAJAYA, WAY KHILAU, PESAWARAN, LAMPUNG",2,43,128,171
https://kawalpemilu.org#24974,"SUKAJAYA, WAY KHILAU, PESAWARAN, LAMPUNG",3,40,157,197
https://kawalpemilu.org#24974,"SUKAJAYA, WAY KHILAU, PESAWARAN, LAMPUNG",4,74,128,202
https://kawalpemilu.org#24974,"SUKAJAYA, WAY KHILAU, PESAWARAN, LAMPUNG",5,100,102,202
https://kawalpemilu.org#24975,"PADANG CERMIN, WAY KHILAU, PESAWARAN, LAMPUNG",1,59,108,167
https://kawalpemilu.org#24975,"PADANG CERMIN, WAY KHILAU, PESAWARAN, LAMPUNG",2,72,142,214
https://kawalpemilu.org#24975,"PADANG CERMIN, WAY KHILAU, PESAWARAN, LAMPUNG",3,48,106,154
https://kawalpemilu.org#24975,"PADANG CERMIN, WAY KHILAU, PESAWARAN, LAMPUNG",4,80,138,218
https://kawalpemilu.org#24975,"PADANG CERMIN, WAY KHILAU, PESAWARAN, LAMPUNG",5,62,116,178
https://kawalpemilu.org#24975,"PADANG CERMIN, WAY KHILAU, PESAWARAN, LAMPUNG",6,65,115,180
https://kawalpemilu.org#24977,"KOTA JAWA, WAY KHILAU, PESAWARAN, LAMPUNG",1,55,150,205
https://kawalpemilu.org#24977,"KOTA JAWA, WAY KHILAU, PESAWARAN, LAMPUNG",2,40,147,187
https://kawalpemilu.org#24977,"KOTA JAWA, WAY KHILAU, PESAWARAN, LAMPUNG",3,48,177,225
https://kawalpemilu.org#24977,"KOTA JAWA, WAY KHILAU, PESAWARAN, LAMPUNG",4,53,109,162
https://kawalpemilu.org#24977,"KOTA JAWA, WAY KHILAU, PESAWARAN, LAMPUNG",5,64,100,164
https://kawalpemilu.org#24977,"KOTA JAWA, WAY KHILAU, PESAWARAN, LAMPUNG",6,60,146,206
https://kawalpemilu.org#24977,"KOTA JAWA, WAY KHILAU, PESAWARAN, LAMPUNG",7,55,78,133
https://kawalpemilu.org#24977,"KOTA JAWA, WAY KHILAU, PESAWARAN, LAMPUNG",8,78,104,182
https://kawalpemilu.org#24977,"KOTA JAWA, WAY KHILAU, PESAWARAN, LAMPUNG",9,87,68,155
https://kawalpemilu.org#24977,"KOTA JAWA, WAY KHILAU, PESAWARAN, LAMPUNG",10,68,48,116
https://kawalpemilu.org#24977,"KOTA JAWA, WAY KHILAU, PESAWARAN, LAMPUNG",11,69,59,128
https://kawalpemilu.org#24977,"KOTA JAWA, WAY KHILAU, PESAWARAN, LAMPUNG",12,110,86,196
https://kawalpemilu.org#24977,"KOTA JAWA, WAY KHILAU, PESAWARAN, LAMPUNG",13,94,92,186
https://kawalpemilu.org#24977,"KOTA JAWA, WAY KHILAU, PESAWARAN, LAMPUNG",14,109,53,162
https://kawalpemilu.org#24979,"KUBU BATU, WAY KHILAU, PESAWARAN, LAMPUNG",1,30,123,153
https://kawalpemilu.org#24979,"KUBU BATU, WAY KHILAU, PESAWARAN, LAMPUNG",2,60,138,198
https://kawalpemilu.org#24979,"KUBU BATU, WAY KHILAU, PESAWARAN, LAMPUNG",3,40,96,136
https://kawalpemilu.org#24979,"KUBU BATU, WAY KHILAU, PESAWARAN, LAMPUNG",4,94,95,189
https://kawalpemilu.org#24979,"KUBU BATU, WAY KHILAU, PESAWARAN, LAMPUNG",5,137,59,196
https://kawalpemilu.org#24979,"KUBU BATU, WAY KHILAU, PESAWARAN, LAMPUNG",6,59,89,148
https://kawalpemilu.org#24979,"KUBU BATU, WAY KHILAU, PESAWARAN, LAMPUNG",7,82,72,154
https://kawalpemilu.org#24979,"KUBU BATU, WAY KHILAU, PESAWARAN, LAMPUNG",8,20,108,128
https://kawalpemilu.org#24979,"KUBU BATU, WAY KHILAU, PESAWARAN, LAMPUNG",9,30,85,115
https://kawalpemilu.org#24979,"KUBU BATU, WAY KHILAU, PESAWARAN, LAMPUNG",10,56,114,170
https://kawalpemilu.org#24979,"KUBU BATU, WAY KHILAU, PESAWARAN, LAMPUNG",11,75,33,108
https://kawalpemilu.org#24979,"KUBU BATU, WAY KHILAU, PESAWARAN, LAMPUNG",12,70,91,61
https://kawalpemilu.org#24987,"BAYAS JAYA, WAY KHILAU, PESAWARAN, LAMPUNG",1,148,105,253
https://kawalpemilu.org#24987,"BAYAS JAYA, WAY KHILAU, PESAWARAN, LAMPUNG",2,73,137,210
https://kawalpemilu.org#24987,"BAYAS JAYA, WAY KHILAU, PESAWARAN, LAMPUNG",3,187,28,215
https://kawalpemilu.org#24987,"BAYAS JAYA, WAY KHILAU, PESAWARAN, LAMPUNG",4,182,38,220
https://kawalpemilu.org#24987,"BAYAS JAYA, WAY KHILAU, PESAWARAN, LAMPUNG",5,48,28,76
https://kawalpemilu.org#24987,"BAYAS JAYA, WAY KHILAU, PESAWARAN, LAMPUNG",6,117,18,135
https://kawalpemilu.org#24987,"BAYAS JAYA, WAY KHILAU, PESAWARAN, LAMPUNG",7,202,23,225
https://kawalpemilu.org#24987,"BAYAS JAYA, WAY KHILAU, PESAWARAN, LAMPUNG",8,37,121,158
https://kawalpemilu.org#24987,"BAYAS JAYA, WAY KHILAU, PESAWARAN, LAMPUNG",9,48,5,53
https://kawalpemilu.org#24987,"BAYAS JAYA, WAY KHILAU, PESAWARAN, LAMPUNG",10,70,23,93
https://kawalpemilu.org#24987,"BAYAS JAYA, WAY KHILAU, PESAWARAN, LAMPUNG",11,168,20,188
https://kawalpemilu.org#24988,"MADA JAYA, WAY KHILAU, PESAWARAN, LAMPUNG",1,115,81,196
https://kawalpemilu.org#24988,"MADA JAYA, WAY KHILAU, PESAWARAN, LAMPUNG",2,74,80,154
https://kawalpemilu.org#24988,"MADA JAYA, WAY KHILAU, PESAWARAN, LAMPUNG",3,97,126,223
https://kawalpemilu.org#24988,"MADA JAYA, WAY KHILAU, PESAWARAN, LAMPUNG",4,63,108,171
https://kawalpemilu.org#24988,"MADA JAYA, WAY KHILAU, PESAWARAN, LAMPUNG",5,45,80,125
https://kawalpemilu.org#24988,"MADA JAYA, WAY KHILAU, PESAWARAN, LAMPUNG",6,95,113,208
https://kawalpemilu.org#24988,"MADA JAYA, WAY KHILAU, PESAWARAN, LAMPUNG",7,86,60,146
https://kawalpemilu.org#24988,"MADA JAYA, WAY KHILAU, PESAWARAN, LAMPUNG",8,114,101,215
https://kawalpemilu.org#24988,"MADA JAYA, WAY KHILAU, PESAWARAN, LAMPUNG",9,106,92,198
https://kawalpemilu.org#24988,"MADA JAYA, WAY KHILAU, PESAWARAN, LAMPUNG",10,62,74,136
https://kawalpemilu.org#24988,"MADA JAYA, WAY KHILAU, PESAWARAN, LAMPUNG",11,42,73,115
https://kawalpemilu.org#24988,"MADA JAYA, WAY KHILAU, PESAWARAN, LAMPUNG",12,92,56,148
https://kawalpemilu.org#87858,"TANJUNGKERTA, WAY KHILAU, PESAWARAN, LAMPUNG",1,36,73,109
https://kawalpemilu.org#87858,"TANJUNGKERTA, WAY KHILAU, PESAWARAN, LAMPUNG",2,42,209,251
https://kawalpemilu.org#87858,"TANJUNGKERTA, WAY KHILAU, PESAWARAN, LAMPUNG",3,66,157,223
https://kawalpemilu.org#87858,"TANJUNGKERTA, WAY KHILAU, PESAWARAN, LAMPUNG",4,44,97,141
https://kawalpemilu.org#87858,"TANJUNGKERTA, WAY KHILAU, PESAWARAN, LAMPUNG",5,29,151,180
https://kawalpemilu.org#87858,"TANJUNGKERTA, WAY KHILAU, PESAWARAN, LAMPUNG",6,47,122,169
https://kawalpemilu.org#87859,"GUNUNGSARI, WAY KHILAU, PESAWARAN, LAMPUNG",1,170,41,211
https://kawalpemilu.org#87859,"GUNUNGSARI, WAY KHILAU, PESAWARAN, LAMPUNG",2,143,47,190
https://kawalpemilu.org#87859,"GUNUNGSARI, WAY KHILAU, PESAWARAN, LAMPUNG",3,153,82,235
https://kawalpemilu.org#87859,"GUNUNGSARI, WAY KHILAU, PESAWARAN, LAMPUNG",4,89,59,148
https://kawalpemilu.org#87859,"GUNUNGSARI, WAY KHILAU, PESAWARAN, LAMPUNG",5,127,72,199
https://kawalpemilu.org#87859,"GUNUNGSARI, WAY KHILAU, PESAWARAN, LAMPUNG",6,156,81,237
https://kawalpemilu.org#87859,"GUNUNGSARI, WAY KHILAU, PESAWARAN, LAMPUNG",7,149,89,231
https://kawalpemilu.org#87859,"GUNUNGSARI, WAY KHILAU, PESAWARAN, LAMPUNG",8,123,85,208
https://kawalpemilu.org#87859,"GUNUNGSARI, WAY KHILAU, PESAWARAN, LAMPUNG",9,181,50,131
https://kawalpemilu.org#87859,"GUNUNGSARI, WAY KHILAU, PESAWARAN, LAMPUNG",10,151,29,180
https://kawalpemilu.org#87859,"GUNUNGSARI, WAY KHILAU, PESAWARAN, LAMPUNG",11,62,29,91
https://kawalpemilu.org#927498,"TANJUNG REJO, WAY KHILAU, PESAWARAN, LAMPUNG",1,135,94,229
https://kawalpemilu.org#927498,"TANJUNG REJO, WAY KHILAU, PESAWARAN, LAMPUNG",2,144,85,229
https://kawalpemilu.org#927498,"TANJUNG REJO, WAY KHILAU, PESAWARAN, LAMPUNG",3,93,33,126
https://kawalpemilu.org#927498,"TANJUNG REJO, WAY KHILAU, PESAWARAN, LAMPUNG",4,89,30,119
https://kawalpemilu.org#927498,"TANJUNG REJO, WAY KHILAU, PESAWARAN, LAMPUNG",5,98,28,126
https://kawalpemilu.org#927498,"TANJUNG REJO, WAY KHILAU, PESAWARAN, LAMPUNG",6,104,38,142
https://kawalpemilu.org#24930,"GEBANG, TELUK PANDAN, PESAWARAN, LAMPUNG",1,167,44,211
https://kawalpemilu.org#24930,"GEBANG, TELUK PANDAN, PESAWARAN, LAMPUNG",2,130,77,207
https://kawalpemilu.org#24930,"GEBANG, TELUK PANDAN, PESAWARAN, LAMPUNG",3,172,38,210
https://kawalpemilu.org#24930,"GEBANG, TELUK PANDAN, PESAWARAN, LAMPUNG",4,161,32,193
https://kawalpemilu.org#24930,"GEBANG, TELUK PANDAN, PESAWARAN, LAMPUNG",6,45,95,140
https://kawalpemilu.org#24930,"GEBANG, TELUK PANDAN, PESAWARAN, LAMPUNG",7,140,91,231
https://kawalpemilu.org#24930,"GEBANG, TELUK PANDAN, PESAWARAN, LAMPUNG",8,80,38,118
https://kawalpemilu.org#24930,"GEBANG, TELUK PANDAN, PESAWARAN, LAMPUNG",9,51,122,173
https://kawalpemilu.org#24930,"GEBANG, TELUK PANDAN, PESAWARAN, LAMPUNG",10,91,19,110
https://kawalpemilu.org#24930,"GEBANG, TELUK PANDAN, PESAWARAN, LAMPUNG",11,47,113,160
https://kawalpemilu.org#24930,"GEBANG, TELUK PANDAN, PESAWARAN, LAMPUNG",12,139,68,207
https://kawalpemilu.org#24930,"GEBANG, TELUK PANDAN, PESAWARAN, LAMPUNG",13,134,73,207
https://kawalpemilu.org#24930,"GEBANG, TELUK PANDAN, PESAWARAN, LAMPUNG",14,144,80,224
https://kawalpemilu.org#24930,"GEBANG, TELUK PANDAN, PESAWARAN, LAMPUNG",15,154,29,183
https://kawalpemilu.org#24930,"GEBANG, TELUK PANDAN, PESAWARAN, LAMPUNG",16,60,70,130
https://kawalpemilu.org#24930,"GEBANG, TELUK PANDAN, PESAWARAN, LAMPUNG",17,43,103,146
https://kawalpemilu.org#24930,"GEBANG, TELUK PANDAN, PESAWARAN, LAMPUNG",18,41,80,121
https://kawalpemilu.org#24930,"GEBANG, TELUK PANDAN, PESAWARAN, LAMPUNG",19,82,16,98
https://kawalpemilu.org#24930,"GEBANG, TELUK PANDAN, PESAWARAN, LAMPUNG",20,96,50,146
https://kawalpemilu.org#24930,"GEBANG, TELUK PANDAN, PESAWARAN, LAMPUNG",21,133,52,185
https://kawalpemilu.org#24932,"HANURA, TELUK PANDAN, PESAWARAN, LAMPUNG",1,132,77,209
https://kawalpemilu.org#24932,"HANURA, TELUK PANDAN, PESAWARAN, LAMPUNG",2,107,82,189
https://kawalpemilu.org#24932,"HANURA, TELUK PANDAN, PESAWARAN, LAMPUNG",3,101,74,175
https://kawalpemilu.org#24932,"HANURA, TELUK PANDAN, PESAWARAN, LAMPUNG",4,73,79,152
https://kawalpemilu.org#24932,"HANURA, TELUK PANDAN, PESAWARAN, LAMPUNG",6,106,73,179
https://kawalpemilu.org#24932,"HANURA, TELUK PANDAN, PESAWARAN, LAMPUNG",7,110,63,173
https://kawalpemilu.org#24932,"HANURA, TELUK PANDAN, PESAWARAN, LAMPUNG",8,110,84,194
https://kawalpemilu.org#24932,"HANURA, TELUK PANDAN, PESAWARAN, LAMPUNG",9,151,60,211
https://kawalpemilu.org#24932,"HANURA, TELUK PANDAN, PESAWARAN, LAMPUNG",10,128,55,183
https://kawalpemilu.org#24932,"HANURA, TELUK PANDAN, PESAWARAN, LAMPUNG",11,99,95,194
https://kawalpemilu.org#24932,"HANURA, TELUK PANDAN, PESAWARAN, LAMPUNG",12,116,44,160
https://kawalpemilu.org#24932,"HANURA, TELUK PANDAN, PESAWARAN, LAMPUNG",13,113,59,172
https://kawalpemilu.org#24932,"HANURA, TELUK PANDAN, PESAWARAN, LAMPUNG",14,100,63,163
https://kawalpemilu.org#24932,"HANURA, TELUK PANDAN, PESAWARAN, LAMPUNG",15,109,88,197
https://kawalpemilu.org#24932,"HANURA, TELUK PANDAN, PESAWARAN, LAMPUNG",16,109,72,181
https://kawalpemilu.org#24932,"HANURA, TELUK PANDAN, PESAWARAN, LAMPUNG",17,126,67,193
https://kawalpemilu.org#24932,"HANURA, TELUK PANDAN, PESAWARAN, LAMPUNG",18,117,73,190
https://kawalpemilu.org#24932,"HANURA, TELUK PANDAN, PESAWARAN, LAMPUNG",19,109,63,172
https://kawalpemilu.org#24933,"HURUN, TELUK PANDAN, PESAWARAN, LAMPUNG",1,64,128,192
https://kawalpemilu.org#24933,"HURUN, TELUK PANDAN, PESAWARAN, LAMPUNG",2,77,153,230
https://kawalpemilu.org#24933,"HURUN, TELUK PANDAN, PESAWARAN, LAMPUNG",3,92,132,224
https://kawalpemilu.org#24933,"HURUN, TELUK PANDAN, PESAWARAN, LAMPUNG",4,82,63,145
https://kawalpemilu.org#24933,"HURUN, TELUK PANDAN, PESAWARAN, LAMPUNG",5,102,100,202
https://kawalpemilu.org#24933,"HURUN, TELUK PANDAN, PESAWARAN, LAMPUNG",6,71,80,151
https://kawalpemilu.org#24933,"HURUN, TELUK PANDAN, PESAWARAN, LAMPUNG",7,41,135,176
https://kawalpemilu.org#24933,"HURUN, TELUK PANDAN, PESAWARAN, LAMPUNG",8,111,82,193
https://kawalpemilu.org#24933,"HURUN, TELUK PANDAN, PESAWARAN, LAMPUNG",9,70,77,147
https://kawalpemilu.org#24938,"SIDODADI, TELUK PANDAN, PESAWARAN, LAMPUNG",1,130,52,182
https://kawalpemilu.org#24938,"SIDODADI, TELUK PANDAN, PESAWARAN, LAMPUNG",2,90,42,132
https://kawalpemilu.org#24938,"SIDODADI, TELUK PANDAN, PESAWARAN, LAMPUNG",3,96,77,173
https://kawalpemilu.org#24938,"SIDODADI, TELUK PANDAN, PESAWARAN, LAMPUNG",4,119,70,189
https://kawalpemilu.org#24938,"SIDODADI, TELUK PANDAN, PESAWARAN, LAMPUNG",5,151,74,225
https://kawalpemilu.org#24938,"SIDODADI, TELUK PANDAN, PESAWARAN, LAMPUNG",6,119,79,198
https://kawalpemilu.org#24938,"SIDODADI, TELUK PANDAN, PESAWARAN, LAMPUNG",7,171,49,220
https://kawalpemilu.org#24940,"SUKAJAYA LEMPASING, TELUK PANDAN, PESAWARAN, LAMPUNG",1,58,79,137
https://kawalpemilu.org#24940,"SUKAJAYA LEMPASING, TELUK PANDAN, PESAWARAN, LAMPUNG",2,87,118,205
https://kawalpemilu.org#24940,"SUKAJAYA LEMPASING, TELUK PANDAN, PESAWARAN, LAMPUNG",3,105,88,193
https://kawalpemilu.org#24940,"SUKAJAYA LEMPASING, TELUK PANDAN, PESAWARAN, LAMPUNG",4,101,68,169
https://kawalpemilu.org#24940,"SUKAJAYA LEMPASING, TELUK PANDAN, PESAWARAN, LAMPUNG",5,142,41,183
https://kawalpemilu.org#24940,"SUKAJAYA LEMPASING, TELUK PANDAN, PESAWARAN, LAMPUNG",7,117,74,191
https://kawalpemilu.org#24940,"SUKAJAYA LEMPASING, TELUK PANDAN, PESAWARAN, LAMPUNG",8,128,84,212
https://kawalpemilu.org#24940,"SUKAJAYA LEMPASING, TELUK PANDAN, PESAWARAN, LAMPUNG",9,70,154,224
https://kawalpemilu.org#24940,"SUKAJAYA LEMPASING, TELUK PANDAN, PESAWARAN, LAMPUNG",10,95,93,188
https://kawalpemilu.org#24940,"SUKAJAYA LEMPASING, TELUK PANDAN, PESAWARAN, LAMPUNG",11,100,122,222
https://kawalpemilu.org#24940,"SUKAJAYA LEMPASING, TELUK PANDAN, PESAWARAN, LAMPUNG",12,126,48,174
https://kawalpemilu.org#24940,"SUKAJAYA LEMPASING, TELUK PANDAN, PESAWARAN, LAMPUNG",13,59,73,132
https://kawalpemilu.org#24940,"SUKAJAYA LEMPASING, TELUK PANDAN, PESAWARAN, LAMPUNG",14,106,77,183
https://kawalpemilu.org#24940,"SUKAJAYA LEMPASING, TELUK PANDAN, PESAWARAN, LAMPUNG",15,88,69,157
https://kawalpemilu.org#24940,"SUKAJAYA LEMPASING, TELUK PANDAN, PESAWARAN, LAMPUNG",16,131,91,222
https://kawalpemilu.org#24940,"SUKAJAYA LEMPASING, TELUK PANDAN, PESAWARAN, LAMPUNG",17,107,83,190
https://kawalpemilu.org#24940,"SUKAJAYA LEMPASING, TELUK PANDAN, PESAWARAN, LAMPUNG",18,112,86,198
https://kawalpemilu.org#24940,"SUKAJAYA LEMPASING, TELUK PANDAN, PESAWARAN, LAMPUNG",19,81,127,208
https://kawalpemilu.org#24944,"TANJUNG AGUNG, TELUK PANDAN, PESAWARAN, LAMPUNG",1,133,70,203
https://kawalpemilu.org#24944,"TANJUNG AGUNG, TELUK PANDAN, PESAWARAN, LAMPUNG",2,116,73,189
https://kawalpemilu.org#24944,"TANJUNG AGUNG, TELUK PANDAN, PESAWARAN, LAMPUNG",3,134,26,160
https://kawalpemilu.org#24944,"TANJUNG AGUNG, TELUK PANDAN, PESAWARAN, LAMPUNG",4,203,28,231
https://kawalpemilu.org#24944,"TANJUNG AGUNG, TELUK PANDAN, PESAWARAN, LAMPUNG",5,138,31,169
https://kawalpemilu.org#24944,"TANJUNG AGUNG, TELUK PANDAN, PESAWARAN, LAMPUNG",6,195,57,252
https://kawalpemilu.org#24944,"TANJUNG AGUNG, TELUK PANDAN, PESAWARAN, LAMPUNG",7,214,23,237
https://kawalpemilu.org#24944,"TANJUNG AGUNG, TELUK PANDAN, PESAWARAN, LAMPUNG",8,95,68,163
https://kawalpemilu.org#24944,"TANJUNG AGUNG, TELUK PANDAN, PESAWARAN, LAMPUNG",9,107,70,177
https://kawalpemilu.org#24944,"TANJUNG AGUNG, TELUK PANDAN, PESAWARAN, LAMPUNG",10,139,64,203
https://kawalpemilu.org#24944,"TANJUNG AGUNG, TELUK PANDAN, PESAWARAN, LAMPUNG",11,150,7,157
https://kawalpemilu.org#87863,"TALANG MULYO, TELUK PANDAN, PESAWARAN, LAMPUNG",1,117,81,198
https://kawalpemilu.org#87863,"TALANG MULYO, TELUK PANDAN, PESAWARAN, LAMPUNG",2,164,63,227
https://kawalpemilu.org#87863,"TALANG MULYO, TELUK PANDAN, PESAWARAN, LAMPUNG",3,106,72,178
https://kawalpemilu.org#87863,"TALANG MULYO, TELUK PANDAN, PESAWARAN, LAMPUNG",4,158,44,202
https://kawalpemilu.org#87864,"CILIMUS, TELUK PANDAN, PESAWARAN, LAMPUNG",1,162,77,239
https://kawalpemilu.org#87864,"CILIMUS, TELUK PANDAN, PESAWARAN, LAMPUNG",2,153,70,223
https://kawalpemilu.org#87864,"CILIMUS, TELUK PANDAN, PESAWARAN, LAMPUNG",3,153,59,212
https://kawalpemilu.org#87864,"CILIMUS, TELUK PANDAN, PESAWARAN, LAMPUNG",4,173,47,220
https://kawalpemilu.org#87864,"CILIMUS, TELUK PANDAN, PESAWARAN, LAMPUNG",5,135,48,183
https://kawalpemilu.org#87864,"CILIMUS, TELUK PANDAN, PESAWARAN, LAMPUNG",6,64,64,128
https://kawalpemilu.org#87865,"MUNCA, TELUK PANDAN, PESAWARAN, LAMPUNG",1,91,53,144
https://kawalpemilu.org#87865,"MUNCA, TELUK PANDAN, PESAWARAN, LAMPUNG",2,128,51,179
https://kawalpemilu.org#87865,"MUNCA, TELUK PANDAN, PESAWARAN, LAMPUNG",3,117,26,143
https://kawalpemilu.org#87865,"MUNCA, TELUK PANDAN, PESAWARAN, LAMPUNG",4,111,24,135
https://kawalpemilu.org#87866,"BATU MENYAN, TELUK PANDAN, PESAWARAN, LAMPUNG",2,128,58,186
https://kawalpemilu.org#87866,"BATU MENYAN, TELUK PANDAN, PESAWARAN, LAMPUNG",3,57,61,118
https://kawalpemilu.org#87866,"BATU MENYAN, TELUK PANDAN, PESAWARAN, LAMPUNG",4,74,38,112
https://kawalpemilu.org#87866,"BATU MENYAN, TELUK PANDAN, PESAWARAN, LAMPUNG",5,51,161,212
https://kawalpemilu.org#87866,"BATU MENYAN, TELUK PANDAN, PESAWARAN, LAMPUNG",6,113,36,149
https://kawalpemilu.org#87866,"BATU MENYAN, TELUK PANDAN, PESAWARAN, LAMPUNG",7,83,75,158
https://kawalpemilu.org#87866,"BATU MENYAN, TELUK PANDAN, PESAWARAN, LAMPUNG",8,85,58,143
https://kawalpemilu.org#24927,"BUNUT, WAY RATAI, PESAWARAN, LAMPUNG",1,48,81,129
https://kawalpemilu.org#24927,"BUNUT, WAY RATAI, PESAWARAN, LAMPUNG",2,50,71,121
https://kawalpemilu.org#24927,"BUNUT, WAY RATAI, PESAWARAN, LAMPUNG",3,56,46,102
https://kawalpemilu.org#24927,"BUNUT, WAY RATAI, PESAWARAN, LAMPUNG",4,173,49,222
https://kawalpemilu.org#24927,"BUNUT, WAY RATAI, PESAWARAN, LAMPUNG",5,149,29,178
https://kawalpemilu.org#24927,"BUNUT, WAY RATAI, PESAWARAN, LAMPUNG",6,151,51,202
https://kawalpemilu.org#24927,"BUNUT, WAY RATAI, PESAWARAN, LAMPUNG",7,89,69,158
https://kawalpemilu.org#24927,"BUNUT, WAY RATAI, PESAWARAN, LAMPUNG",8,108,31,139
https://kawalpemilu.org#24927,"BUNUT, WAY RATAI, PESAWARAN, LAMPUNG",9,112,6,118
https://kawalpemilu.org#24927,"BUNUT, WAY RATAI, PESAWARAN, LAMPUNG",10,95,105,200
https://kawalpemilu.org#24927,"BUNUT, WAY RATAI, PESAWARAN, LAMPUNG",12,52,31,83
https://kawalpemilu.org#24927,"BUNUT, WAY RATAI, PESAWARAN, LAMPUNG",13,103,75,178
https://kawalpemilu.org#24927,"BUNUT, WAY RATAI, PESAWARAN, LAMPUNG",14,41,68,109
https://kawalpemilu.org#24927,"BUNUT, WAY RATAI, PESAWARAN, LAMPUNG",15,33,31,64
https://kawalpemilu.org#24927,"BUNUT, WAY RATAI, PESAWARAN, LAMPUNG",16,35,37,72
https://kawalpemilu.org#24928,"BUNUT SEBERANG, WAY RATAI, PESAWARAN, LAMPUNG",1,50,44,94
https://kawalpemilu.org#24928,"BUNUT SEBERANG, WAY RATAI, PESAWARAN, LAMPUNG",2,136,24,160
https://kawalpemilu.org#24928,"BUNUT SEBERANG, WAY RATAI, PESAWARAN, LAMPUNG",3,112,86,198
https://kawalpemilu.org#24928,"BUNUT SEBERANG, WAY RATAI, PESAWARAN, LAMPUNG",4,87,50,137
https://kawalpemilu.org#24928,"BUNUT SEBERANG, WAY RATAI, PESAWARAN, LAMPUNG",5,106,59,165
https://kawalpemilu.org#24928,"BUNUT SEBERANG, WAY RATAI, PESAWARAN, LAMPUNG",6,127,55,182
https://kawalpemilu.org#24928,"BUNUT SEBERANG, WAY RATAI, PESAWARAN, LAMPUNG",7,90,13,103
https://kawalpemilu.org#24928,"BUNUT SEBERANG, WAY RATAI, PESAWARAN, LAMPUNG",8,68,73,141
https://kawalpemilu.org#24928,"BUNUT SEBERANG, WAY RATAI, PESAWARAN, LAMPUNG",9,118,16,134
https://kawalpemilu.org#24928,"BUNUT SEBERANG, WAY RATAI, PESAWARAN, LAMPUNG",11,98,26,124
https://kawalpemilu.org#24931,"GUNUNG REJO, WAY RATAI, PESAWARAN, LAMPUNG",1,155,24,179
https://kawalpemilu.org#24931,"GUNUNG REJO, WAY RATAI, PESAWARAN, LAMPUNG",2,137,31,168
https://kawalpemilu.org#24931,"GUNUNG REJO, WAY RATAI, PESAWARAN, LAMPUNG",3,100,45,145
https://kawalpemilu.org#24931,"GUNUNG REJO, WAY RATAI, PESAWARAN, LAMPUNG",4,106,38,144
https://kawalpemilu.org#24931,"GUNUNG REJO, WAY RATAI, PESAWARAN, LAMPUNG",5,116,24,140
https://kawalpemilu.org#24931,"GUNUNG REJO, WAY RATAI, PESAWARAN, LAMPUNG",6,158,45,203
https://kawalpemilu.org#24931,"GUNUNG REJO, WAY RATAI, PESAWARAN, LAMPUNG",7,79,55,134
https://kawalpemilu.org#24931,"GUNUNG REJO, WAY RATAI, PESAWARAN, LAMPUNG",8,87,35,122
https://kawalpemilu.org#24931,"GUNUNG REJO, WAY RATAI, PESAWARAN, LAMPUNG",9,110,26,136
https://kawalpemilu.org#24931,"GUNUNG REJO, WAY RATAI, PESAWARAN, LAMPUNG",10,94,33,127
https://kawalpemilu.org#24931,"GUNUNG REJO, WAY RATAI, PESAWARAN, LAMPUNG",11,90,16,106
https://kawalpemilu.org#24931,"GUNUNG REJO, WAY RATAI, PESAWARAN, LAMPUNG",12,32,16,48
https://kawalpemilu.org#24931,"GUNUNG REJO, WAY RATAI, PESAWARAN, LAMPUNG",13,87,34,121
https://kawalpemilu.org#24939,"SUMBER JAYA, WAY RATAI, PESAWARAN, LAMPUNG",1,18,158,176
https://kawalpemilu.org#24939,"SUMBER JAYA, WAY RATAI, PESAWARAN, LAMPUNG",2,161,28,189
https://kawalpemilu.org#24939,"SUMBER JAYA, WAY RATAI, PESAWARAN, LAMPUNG",3,41,122,163
https://kawalpemilu.org#24939,"SUMBER JAYA, WAY RATAI, PESAWARAN, LAMPUNG",4,129,76,205
https://kawalpemilu.org#24939,"SUMBER JAYA, WAY RATAI, PESAWARAN, LAMPUNG",5,44,1,45
https://kawalpemilu.org#24939,"SUMBER JAYA, WAY RATAI, PESAWARAN, LAMPUNG",6,124,33,157
https://kawalpemilu.org#24939,"SUMBER JAYA, WAY RATAI, PESAWARAN, LAMPUNG",7,94,95,189
https://kawalpemilu.org#24939,"SUMBER JAYA, WAY RATAI, PESAWARAN, LAMPUNG",8,186,55,241
https://kawalpemilu.org#24939,"SUMBER JAYA, WAY RATAI, PESAWARAN, LAMPUNG",9,106,95,201
https://kawalpemilu.org#24939,"SUMBER JAYA, WAY RATAI, PESAWARAN, LAMPUNG",10,9,97,106
https://kawalpemilu.org#24939,"SUMBER JAYA, WAY RATAI, PESAWARAN, LAMPUNG",11,134,13,147
https://kawalpemilu.org#24939,"SUMBER JAYA, WAY RATAI, PESAWARAN, LAMPUNG",12,70,100,170
https://kawalpemilu.org#24939,"SUMBER JAYA, WAY RATAI, PESAWARAN, LAMPUNG",13,58,33,91
https://kawalpemilu.org#24939,"SUMBER JAYA, WAY RATAI, PESAWARAN, LAMPUNG",14,115,36,151
https://kawalpemilu.org#24939,"SUMBER JAYA, WAY RATAI, PESAWARAN, LAMPUNG",15,4,194,198
https://kawalpemilu.org#24939,"SUMBER JAYA, WAY RATAI, PESAWARAN, LAMPUNG",16,63,21,84
https://kawalpemilu.org#24943,"WATES WAY RATAI, WAY RATAI, PESAWARAN, LAMPUNG",1,143,98,241
https://kawalpemilu.org#24943,"WATES WAY RATAI, WAY RATAI, PESAWARAN, LAMPUNG",2,91,100,191
https://kawalpemilu.org#24943,"WATES WAY RATAI, WAY RATAI, PESAWARAN, LAMPUNG",3,80,72,152
https://kawalpemilu.org#24943,"WATES WAY RATAI, WAY RATAI, PESAWARAN, LAMPUNG",4,132,50,182
https://kawalpemilu.org#24943,"WATES WAY RATAI, WAY RATAI, PESAWARAN, LAMPUNG",5,152,71,223
https://kawalpemilu.org#24943,"WATES WAY RATAI, WAY RATAI, PESAWARAN, LAMPUNG",6,71,40,111
https://kawalpemilu.org#24943,"WATES WAY RATAI, WAY RATAI, PESAWARAN, LAMPUNG",7,124,62,186
https://kawalpemilu.org#24943,"WATES WAY RATAI, WAY RATAI, PESAWARAN, LAMPUNG",8,113,46,159
https://kawalpemilu.org#24943,"WATES WAY RATAI, WAY RATAI, PESAWARAN, LAMPUNG",9,103,99,202
https://kawalpemilu.org#24943,"WATES WAY RATAI, WAY RATAI, PESAWARAN, LAMPUNG",10,118,30,148
https://kawalpemilu.org#24943,"WATES WAY RATAI, WAY RATAI, PESAWARAN, LAMPUNG",11,102,20,122
https://kawalpemilu.org#24943,"WATES WAY RATAI, WAY RATAI, PESAWARAN, LAMPUNG",12,168,47,215
https://kawalpemilu.org#24943,"WATES WAY RATAI, WAY RATAI, PESAWARAN, LAMPUNG",13,114,69,183
https://kawalpemilu.org#24943,"WATES WAY RATAI, WAY RATAI, PESAWARAN, LAMPUNG",14,136,108,244
https://kawalpemilu.org#24943,"WATES WAY RATAI, WAY RATAI, PESAWARAN, LAMPUNG",15,164,47,211
https://kawalpemilu.org#24943,"WATES WAY RATAI, WAY RATAI, PESAWARAN, LAMPUNG",16,125,47,172
https://kawalpemilu.org#24943,"WATES WAY RATAI, WAY RATAI, PESAWARAN, LAMPUNG",17,91,79,170
https://kawalpemilu.org#24943,"WATES WAY RATAI, WAY RATAI, PESAWARAN, LAMPUNG",18,61,51,112
https://kawalpemilu.org#24943,"WATES WAY RATAI, WAY RATAI, PESAWARAN, LAMPUNG",19,108,53,161
https://kawalpemilu.org#24943,"WATES WAY RATAI, WAY RATAI, PESAWARAN, LAMPUNG",20,92,30,122
https://kawalpemilu.org#24943,"WATES WAY RATAI, WAY RATAI, PESAWARAN, LAMPUNG",21,77,31,108
https://kawalpemilu.org#24943,"WATES WAY RATAI, WAY RATAI, PESAWARAN, LAMPUNG",22,59,23,82
https://kawalpemilu.org#24943,"WATES WAY RATAI, WAY RATAI, PESAWARAN, LAMPUNG",23,67,35,102
https://kawalpemilu.org#24943,"WATES WAY RATAI, WAY RATAI, PESAWARAN, LAMPUNG",24,93,22,115
https://kawalpemilu.org#24945,"PESAWARAN INDAH, WAY RATAI, PESAWARAN, LAMPUNG",1,123,34,157
https://kawalpemilu.org#24945,"PESAWARAN INDAH, WAY RATAI, PESAWARAN, LAMPUNG",2,106,18,124
https://kawalpemilu.org#24945,"PESAWARAN INDAH, WAY RATAI, PESAWARAN, LAMPUNG",3,98,119,217
https://kawalpemilu.org#24945,"PESAWARAN INDAH, WAY RATAI, PESAWARAN, LAMPUNG",4,24,94,118
https://kawalpemilu.org#24945,"PESAWARAN INDAH, WAY RATAI, PESAWARAN, LAMPUNG",5,104,16,120
https://kawalpemilu.org#24945,"PESAWARAN INDAH, WAY RATAI, PESAWARAN, LAMPUNG",6,92,49,141
https://kawalpemilu.org#24945,"PESAWARAN INDAH, WAY RATAI, PESAWARAN, LAMPUNG",8,133,41,174
https://kawalpemilu.org#24945,"PESAWARAN INDAH, WAY RATAI, PESAWARAN, LAMPUNG",9,78,23,101
https://kawalpemilu.org#24945,"PESAWARAN INDAH, WAY RATAI, PESAWARAN, LAMPUNG",10,146,31,177
https://kawalpemilu.org#24945,"PESAWARAN INDAH, WAY RATAI, PESAWARAN, LAMPUNG",11,24,114,138
https://kawalpemilu.org#24945,"PESAWARAN INDAH, WAY RATAI, PESAWARAN, LAMPUNG",12,48,63,111
https://kawalpemilu.org#24945,"PESAWARAN INDAH, WAY RATAI, PESAWARAN, LAMPUNG",13,105,30,135
https://kawalpemilu.org#24945,"PESAWARAN INDAH, WAY RATAI, PESAWARAN, LAMPUNG",14,78,31,109
https://kawalpemilu.org#24946,"PONCOREJO, WAY RATAI, PESAWARAN, LAMPUNG",1,97,23,120
https://kawalpemilu.org#24946,"PONCOREJO, WAY RATAI, PESAWARAN, LAMPUNG",2,192,16,208
https://kawalpemilu.org#24946,"PONCOREJO, WAY RATAI, PESAWARAN, LAMPUNG",3,158,34,192
https://kawalpemilu.org#24946,"PONCOREJO, WAY RATAI, PESAWARAN, LAMPUNG",4,124,31,155
https://kawalpemilu.org#24946,"PONCOREJO, WAY RATAI, PESAWARAN, LAMPUNG",5,171,47,218
https://kawalpemilu.org#24946,"PONCOREJO, WAY RATAI, PESAWARAN, LAMPUNG",6,101,28,129
https://kawalpemilu.org#24947,"HARAPAN JAYA, WAY RATAI, PESAWARAN, LAMPUNG",1,113,27,140
https://kawalpemilu.org#24947,"HARAPAN JAYA, WAY RATAI, PESAWARAN, LAMPUNG",2,111,29,140
https://kawalpemilu.org#24947,"HARAPAN JAYA, WAY RATAI, PESAWARAN, LAMPUNG",3,136,7,143
https://kawalpemilu.org#24947,"HARAPAN JAYA, WAY RATAI, PESAWARAN, LAMPUNG",4,111,16,127
https://kawalpemilu.org#24947,"HARAPAN JAYA, WAY RATAI, PESAWARAN, LAMPUNG",5,150,41,191
https://kawalpemilu.org#24947,"HARAPAN JAYA, WAY RATAI, PESAWARAN, LAMPUNG",6,56,36,92
https://kawalpemilu.org#24947,"HARAPAN JAYA, WAY RATAI, PESAWARAN, LAMPUNG",7,121,23,144
https://kawalpemilu.org#24947,"HARAPAN JAYA, WAY RATAI, PESAWARAN, LAMPUNG",8,85,10,95
https://kawalpemilu.org#24947,"HARAPAN JAYA, WAY RATAI, PESAWARAN, LAMPUNG",9,75,12,87
https://kawalpemilu.org#24947,"HARAPAN JAYA, WAY RATAI, PESAWARAN, LAMPUNG",10,66,28,94
https://kawalpemilu.org#24947,"HARAPAN JAYA, WAY RATAI, PESAWARAN, LAMPUNG",11,103,41,144
https://kawalpemilu.org#24948,"MULYOSARI, WAY RATAI, PESAWARAN, LAMPUNG",1,143,62,205
https://kawalpemilu.org#24948,"MULYOSARI, WAY RATAI, PESAWARAN, LAMPUNG",2,165,42,207
https://kawalpemilu.org#24948,"MULYOSARI, WAY RATAI, PESAWARAN, LAMPUNG",3,143,39,182
https://kawalpemilu.org#24948,"MULYOSARI, WAY RATAI, PESAWARAN, LAMPUNG",4,139,45,184
https://kawalpemilu.org#24948,"MULYOSARI, WAY RATAI, PESAWARAN, LAMPUNG",5,131,47,178
https://kawalpemilu.org#24948,"MULYOSARI, WAY RATAI, PESAWARAN, LAMPUNG",6,79,7,86
https://kawalpemilu.org#24948,"MULYOSARI, WAY RATAI, PESAWARAN, LAMPUNG",7,188,41,229
https://kawalpemilu.org#24948,"MULYOSARI, WAY RATAI, PESAWARAN, LAMPUNG",8,126,31,157
https://kawalpemilu.org#24948,"MULYOSARI, WAY RATAI, PESAWARAN, LAMPUNG",9,79,38,117
https://kawalpemilu.org#24948,"MULYOSARI, WAY RATAI, PESAWARAN, LAMPUNG",10,85,13,98
https://kawalpemilu.org#87860,"CERINGIN SARI, WAY RATAI, PESAWARAN, LAMPUNG",1,147,34,181
https://kawalpemilu.org#87860,"CERINGIN SARI, WAY RATAI, PESAWARAN, LAMPUNG",2,165,39,204
https://kawalpemilu.org#87860,"CERINGIN SARI, WAY RATAI, PESAWARAN, LAMPUNG",3,93,17,110
https://kawalpemilu.org#87860,"CERINGIN SARI, WAY RATAI, PESAWARAN, LAMPUNG",4,146,64,210
https://kawalpemilu.org#87860,"CERINGIN SARI, WAY RATAI, PESAWARAN, LAMPUNG",5,171,39,210
https://kawalpemilu.org#87860,"CERINGIN SARI, WAY RATAI, PESAWARAN, LAMPUNG",6,126,64,190
https://kawalpemilu.org#87860,"CERINGIN SARI, WAY RATAI, PESAWARAN, LAMPUNG",7,65,20,85
https://kawalpemilu.org#87860,"CERINGIN SARI, WAY RATAI, PESAWARAN, LAMPUNG",8,94,28,122
https://kawalpemilu.org#87860,"CERINGIN SARI, WAY RATAI, PESAWARAN, LAMPUNG",9,123,27,150
https://kawalpemilu.org#23462,"NEGERI RATU TENUMBANG, PESISIR SELATAN, PESISIR BARAT, LAMPUNG",1,151,65,216
https://kawalpemilu.org#23462,"NEGERI RATU TENUMBANG, PESISIR SELATAN, PESISIR BARAT, LAMPUNG",2,115,72,187
https://kawalpemilu.org#23462,"NEGERI RATU TENUMBANG, PESISIR SELATAN, PESISIR BARAT, LAMPUNG",3,67,65,132
https://kawalpemilu.org#23462,"NEGERI RATU TENUMBANG, PESISIR SELATAN, PESISIR BARAT, LAMPUNG",4,94,97,191
https://kawalpemilu.org#23463,"SUKARAME, PESISIR SELATAN, PESISIR BARAT, LAMPUNG",1,112,55,167
https://kawalpemilu.org#23463,"SUKARAME, PESISIR SELATAN, PESISIR BARAT, LAMPUNG",3,76,59,135
https://kawalpemilu.org#23464,"PELITA JAYA, PESISIR SELATAN, PESISIR BARAT, LAMPUNG",1,118,103,221
https://kawalpemilu.org#23464,"PELITA JAYA, PESISIR SELATAN, PESISIR BARAT, LAMPUNG",2,90,116,206
https://kawalpemilu.org#23464,"PELITA JAYA, PESISIR SELATAN, PESISIR BARAT, LAMPUNG",3,107,75,182
https://kawalpemilu.org#23465,"SUMUR JAYA, PESISIR SELATAN, PESISIR BARAT, LAMPUNG",1,120,71,191
https://kawalpemilu.org#23465,"SUMUR JAYA, PESISIR SELATAN, PESISIR BARAT, LAMPUNG",2,117,95,176
https://kawalpemilu.org#23465,"SUMUR JAYA, PESISIR SELATAN, PESISIR BARAT, LAMPUNG",3,120,58,178
https://kawalpemilu.org#23465,"SUMUR JAYA, PESISIR SELATAN, PESISIR BARAT, LAMPUNG",4,115,55,170
https://kawalpemilu.org#23466,"TANJUNG JATI, PESISIR SELATAN, PESISIR BARAT, LAMPUNG",1,25,82,107
https://kawalpemilu.org#23466,"TANJUNG JATI, PESISIR SELATAN, PESISIR BARAT, LAMPUNG",2,17,62,79
https://kawalpemilu.org#23467,"PAGAR DALAM, PESISIR SELATAN, PESISIR BARAT, LAMPUNG",1,108,54,162
https://kawalpemilu.org#23467,"PAGAR DALAM, PESISIR SELATAN, PESISIR BARAT, LAMPUNG",2,72,61,133
https://kawalpemilu.org#23468,"TANJUNG SETIA, PESISIR SELATAN, PESISIR BARAT, LAMPUNG",1,76,145,221
https://kawalpemilu.org#23468,"TANJUNG SETIA, PESISIR SELATAN, PESISIR BARAT, LAMPUNG",2,66,117,183
https://kawalpemilu.org#23468,"TANJUNG SETIA, PESISIR SELATAN, PESISIR BARAT, LAMPUNG",3,91,69,160
https://kawalpemilu.org#23468,"TANJUNG SETIA, PESISIR SELATAN, PESISIR BARAT, LAMPUNG",4,84,98,182
https://kawalpemilu.org#23468,"TANJUNG SETIA, PESISIR SELATAN, PESISIR BARAT, LAMPUNG",5,81,125,206
https://kawalpemilu.org#23468,"TANJUNG SETIA, PESISIR SELATAN, PESISIR BARAT, LAMPUNG",6,59,44,103
https://kawalpemilu.org#23469,"BIHA, PESISIR SELATAN, PESISIR BARAT, LAMPUNG",1,160,74,234
https://kawalpemilu.org#23469,"BIHA, PESISIR SELATAN, PESISIR BARAT, LAMPUNG",2,125,66,191
https://kawalpemilu.org#23469,"BIHA, PESISIR SELATAN, PESISIR BARAT, LAMPUNG",3,139,84,223
https://kawalpemilu.org#23469,"BIHA, PESISIR SELATAN, PESISIR BARAT, LAMPUNG",4,96,110,206
https://kawalpemilu.org#23469,"BIHA, PESISIR SELATAN, PESISIR BARAT, LAMPUNG",5,115,105,220
https://kawalpemilu.org#23469,"BIHA, PESISIR SELATAN, PESISIR BARAT, LAMPUNG",6,80,136,216
https://kawalpemilu.org#23469,"BIHA, PESISIR SELATAN, PESISIR BARAT, LAMPUNG",7,70,151,221
https://kawalpemilu.org#23469,"BIHA, PESISIR SELATAN, PESISIR BARAT, LAMPUNG",8,66,80,146
https://kawalpemilu.org#23470,"WAY JAMBU, PESISIR SELATAN, PESISIR BARAT, LAMPUNG",1,107,94,201
https://kawalpemilu.org#23470,"WAY JAMBU, PESISIR SELATAN, PESISIR BARAT, LAMPUNG",2,103,52,155
https://kawalpemilu.org#23470,"WAY JAMBU, PESISIR SELATAN, PESISIR BARAT, LAMPUNG",3,128,32,160
https://kawalpemilu.org#23470,"WAY JAMBU, PESISIR SELATAN, PESISIR BARAT, LAMPUNG",4,117,64,181
https://kawalpemilu.org#23470,"WAY JAMBU, PESISIR SELATAN, PESISIR BARAT, LAMPUNG",5,145,81,226
https://kawalpemilu.org#23471,"MARANG, PESISIR SELATAN, PESISIR BARAT, LAMPUNG",1,76,141,217
https://kawalpemilu.org#23471,"MARANG, PESISIR SELATAN, PESISIR BARAT, LAMPUNG",2,85,132,217
https://kawalpemilu.org#23471,"MARANG, PESISIR SELATAN, PESISIR BARAT, LAMPUNG",3,104,109,213
https://kawalpemilu.org#23471,"MARANG, PESISIR SELATAN, PESISIR BARAT, LAMPUNG",4,175,44,219
https://kawalpemilu.org#23471,"MARANG, PESISIR SELATAN, PESISIR BARAT, LAMPUNG",5,160,57,217
https://kawalpemilu.org#23471,"MARANG, PESISIR SELATAN, PESISIR BARAT, LAMPUNG",6,157,99,256
https://kawalpemilu.org#23471,"MARANG, PESISIR SELATAN, PESISIR BARAT, LAMPUNG",7,175,70,245
https://kawalpemilu.org#23471,"MARANG, PESISIR SELATAN, PESISIR BARAT, LAMPUNG",8,102,81,183
https://kawalpemilu.org#23471,"MARANG, PESISIR SELATAN, PESISIR BARAT, LAMPUNG",9,131,90,221
https://kawalpemilu.org#23471,"MARANG, PESISIR SELATAN, PESISIR BARAT, LAMPUNG",10,169,45,214
https://kawalpemilu.org#23471,"MARANG, PESISIR SELATAN, PESISIR BARAT, LAMPUNG",11,183,25,208
https://kawalpemilu.org#23471,"MARANG, PESISIR SELATAN, PESISIR BARAT, LAMPUNG",12,174,74,248
https://kawalpemilu.org#23471,"MARANG, PESISIR SELATAN, PESISIR BARAT, LAMPUNG",13,105,122,227
https://kawalpemilu.org#23471,"MARANG, PESISIR SELATAN, PESISIR BARAT, LAMPUNG",14,117,68,185
https://kawalpemilu.org#23471,"MARANG, PESISIR SELATAN, PESISIR BARAT, LAMPUNG",15,47,91,138
https://kawalpemilu.org#23471,"MARANG, PESISIR SELATAN, PESISIR BARAT, LAMPUNG",16,114,26,140
https://kawalpemilu.org#23471,"MARANG, PESISIR SELATAN, PESISIR BARAT, LAMPUNG",17,132,13,145
https://kawalpemilu.org#23472,"TANJUNG RAYA, PESISIR SELATAN, PESISIR BARAT, LAMPUNG",1,144,76,220
https://kawalpemilu.org#23472,"TANJUNG RAYA, PESISIR SELATAN, PESISIR BARAT, LAMPUNG",2,98,60,158
https://kawalpemilu.org#23472,"TANJUNG RAYA, PESISIR SELATAN, PESISIR BARAT, LAMPUNG",3,114,82,136
https://kawalpemilu.org#23473,"BANGUN NEGARA, PESISIR SELATAN, PESISIR BARAT, LAMPUNG",1,90,142,232
https://kawalpemilu.org#23473,"BANGUN NEGARA, PESISIR SELATAN, PESISIR BARAT, LAMPUNG",2,74,129,203
https://kawalpemilu.org#23473,"BANGUN NEGARA, PESISIR SELATAN, PESISIR BARAT, LAMPUNG",3,98,125,223
https://kawalpemilu.org#23473,"BANGUN NEGARA, PESISIR SELATAN, PESISIR BARAT, LAMPUNG",4,112,89,211
https://kawalpemilu.org#23473,"BANGUN NEGARA, PESISIR SELATAN, PESISIR BARAT, LAMPUNG",5,187,47,234
https://kawalpemilu.org#23473,"BANGUN NEGARA, PESISIR SELATAN, PESISIR BARAT, LAMPUNG",6,70,66,136
https://kawalpemilu.org#23474,"ULOK MANIK, PESISIR SELATAN, PESISIR BARAT, LAMPUNG",1,116,103,219
https://kawalpemilu.org#23474,"ULOK MANIK, PESISIR SELATAN, PESISIR BARAT, LAMPUNG",2,124,85,209
https://kawalpemilu.org#23474,"ULOK MANIK, PESISIR SELATAN, PESISIR BARAT, LAMPUNG",3,98,91,189
https://kawalpemilu.org#23475,"PAKU NEGARA, PESISIR SELATAN, PESISIR BARAT, LAMPUNG",1,177,48,225
https://kawalpemilu.org#23475,"PAKU NEGARA, PESISIR SELATAN, PESISIR BARAT, LAMPUNG",2,180,50,230
https://kawalpemilu.org#23475,"PAKU NEGARA, PESISIR SELATAN, PESISIR BARAT, LAMPUNG",3,124,74,198
https://kawalpemilu.org#23475,"PAKU NEGARA, PESISIR SELATAN, PESISIR BARAT, LAMPUNG",4,114,100,214
https://kawalpemilu.org#23475,"PAKU NEGARA, PESISIR SELATAN, PESISIR BARAT, LAMPUNG",5,125,75,200
https://kawalpemilu.org#23475,"PAKU NEGARA, PESISIR SELATAN, PESISIR BARAT, LAMPUNG",6,92,16,108
https://kawalpemilu.org#23476,"TULUNG BAMBAN, PESISIR SELATAN, PESISIR BARAT, LAMPUNG",2,118,98,216
https://kawalpemilu.org#23476,"TULUNG BAMBAN, PESISIR SELATAN, PESISIR BARAT, LAMPUNG",3,116,37,153
https://kawalpemilu.org#23478,"WAY REDAK, PESISIR TENGAH, PESISIR BARAT, LAMPUNG",1,94,69,163
https://kawalpemilu.org#23478,"WAY REDAK, PESISIR TENGAH, PESISIR BARAT, LAMPUNG",2,85,100,185
https://kawalpemilu.org#23478,"WAY REDAK, PESISIR TENGAH, PESISIR BARAT, LAMPUNG",3,101,98,199
https://kawalpemilu.org#23479,"SERAY, PESISIR TENGAH, PESISIR BARAT, LAMPUNG",1,107,134,241
https://kawalpemilu.org#23479,"SERAY, PESISIR TENGAH, PESISIR BARAT, LAMPUNG",2,102,104,206
https://kawalpemilu.org#23479,"SERAY, PESISIR TENGAH, PESISIR BARAT, LAMPUNG",3,66,128,194
https://kawalpemilu.org#23479,"SERAY, PESISIR TENGAH, PESISIR BARAT, LAMPUNG",4,71,108,179
https://kawalpemilu.org#23479,"SERAY, PESISIR TENGAH, PESISIR BARAT, LAMPUNG",5,78,80,158
https://kawalpemilu.org#23479,"SERAY, PESISIR TENGAH, PESISIR BARAT, LAMPUNG",6,77,104,181
https://kawalpemilu.org#23480,"KAMPUNG JAWA, PESISIR TENGAH, PESISIR BARAT, LAMPUNG",1,64,129,193
https://kawalpemilu.org#23480,"KAMPUNG JAWA, PESISIR TENGAH, PESISIR BARAT, LAMPUNG",2,36,133,169
https://kawalpemilu.org#23480,"KAMPUNG JAWA, PESISIR TENGAH, PESISIR BARAT, LAMPUNG",3,46,107,153
https://kawalpemilu.org#23480,"KAMPUNG JAWA, PESISIR TENGAH, PESISIR BARAT, LAMPUNG",4,59,128,187
https://kawalpemilu.org#23480,"KAMPUNG JAWA, PESISIR TENGAH, PESISIR BARAT, LAMPUNG",5,84,122,206
https://kawalpemilu.org#23480,"KAMPUNG JAWA, PESISIR TENGAH, PESISIR BARAT, LAMPUNG",6,72,120,192
https://kawalpemilu.org#23480,"KAMPUNG JAWA, PESISIR TENGAH, PESISIR BARAT, LAMPUNG",7,56,149,205
https://kawalpemilu.org#23481,"RAWAS, PESISIR TENGAH, PESISIR BARAT, LAMPUNG",1,79,126,205
https://kawalpemilu.org#23481,"RAWAS, PESISIR TENGAH, PESISIR BARAT, LAMPUNG",2,82,128,210
https://kawalpemilu.org#23481,"RAWAS, PESISIR TENGAH, PESISIR BARAT, LAMPUNG",3,109,131,240
https://kawalpemilu.org#23481,"RAWAS, PESISIR TENGAH, PESISIR BARAT, LAMPUNG",4,89,120,209
https://kawalpemilu.org#23481,"RAWAS, PESISIR TENGAH, PESISIR BARAT, LAMPUNG",5,90,126,216
https://kawalpemilu.org#23481,"RAWAS, PESISIR TENGAH, PESISIR BARAT, LAMPUNG",6,105,85,190
https://kawalpemilu.org#23481,"RAWAS, PESISIR TENGAH, PESISIR BARAT, LAMPUNG",7,76,98,174
https://kawalpemilu.org#23482,"PASAR KRUI, PESISIR TENGAH, PESISIR BARAT, LAMPUNG",1,0,0,0
https://kawalpemilu.org#23482,"PASAR KRUI, PESISIR TENGAH, PESISIR BARAT, LAMPUNG",2,73,146,219
https://kawalpemilu.org#23482,"PASAR KRUI, PESISIR TENGAH, PESISIR BARAT, LAMPUNG",3,92,138,230
https://kawalpemilu.org#23482,"PASAR KRUI, PESISIR TENGAH, PESISIR BARAT, LAMPUNG",4,67,142,209
https://kawalpemilu.org#23482,"PASAR KRUI, PESISIR TENGAH, PESISIR BARAT, LAMPUNG",6,87,138,225
https://kawalpemilu.org#23482,"PASAR KRUI, PESISIR TENGAH, PESISIR BARAT, LAMPUNG",7,57,120,177
https://kawalpemilu.org#23482,"PASAR KRUI, PESISIR TENGAH, PESISIR BARAT, LAMPUNG",8,111,138,249
https://kawalpemilu.org#23482,"PASAR KRUI, PESISIR TENGAH, PESISIR BARAT, LAMPUNG",9,112,132,244
https://kawalpemilu.org#23482,"PASAR KRUI, PESISIR TENGAH, PESISIR BARAT, LAMPUNG",10,97,103,200
https://kawalpemilu.org#23482,"PASAR KRUI, PESISIR TENGAH, PESISIR BARAT, LAMPUNG",11,54,76,130
https://kawalpemilu.org#23482,"PASAR KRUI, PESISIR TENGAH, PESISIR BARAT, LAMPUNG",12,58,140,198
https://kawalpemilu.org#23482,"PASAR KRUI, PESISIR TENGAH, PESISIR BARAT, LAMPUNG",13,59,116,175
https://kawalpemilu.org#23482,"PASAR KRUI, PESISIR TENGAH, PESISIR BARAT, LAMPUNG",14,63,117,180
https://kawalpemilu.org#23482,"PASAR KRUI, PESISIR TENGAH, PESISIR BARAT, LAMPUNG",15,94,143,237
https://kawalpemilu.org#23482,"PASAR KRUI, PESISIR TENGAH, PESISIR BARAT, LAMPUNG",16,101,134,235
https://kawalpemilu.org#23483,"SUKA NEGARA, PESISIR TENGAH, PESISIR BARAT, LAMPUNG",1,41,105,146
https://kawalpemilu.org#23483,"SUKA NEGARA, PESISIR TENGAH, PESISIR BARAT, LAMPUNG",2,31,93,124
https://kawalpemilu.org#23483,"SUKA NEGARA, PESISIR TENGAH, PESISIR BARAT, LAMPUNG",3,50,103,153
https://kawalpemilu.org#23483,"SUKA NEGARA, PESISIR TENGAH, PESISIR BARAT, LAMPUNG",4,36,101,137
https://kawalpemilu.org#23484,"PAHMUNGAN, PESISIR TENGAH, PESISIR BARAT, LAMPUNG",1,78,88,166
https://kawalpemilu.org#23484,"PAHMUNGAN, PESISIR TENGAH, PESISIR BARAT, LAMPUNG",2,68,76,144
https://kawalpemilu.org#23484,"PAHMUNGAN, PESISIR TENGAH, PESISIR BARAT, LAMPUNG",3,87,85,172
https://kawalpemilu.org#23484,"PAHMUNGAN, PESISIR TENGAH, PESISIR BARAT, LAMPUNG",4,71,126,197
https://kawalpemilu.org#23485,"PASAR KOTA KRUI, PESISIR TENGAH, PESISIR BARAT, LAMPUNG",1,72,127,199
https://kawalpemilu.org#23485,"PASAR KOTA KRUI, PESISIR TENGAH, PESISIR BARAT, LAMPUNG",2,83,160,243
https://kawalpemilu.org#23485,"PASAR KOTA KRUI, PESISIR TENGAH, PESISIR BARAT, LAMPUNG",3,70,94,164
https://kawalpemilu.org#23485,"PASAR KOTA KRUI, PESISIR TENGAH, PESISIR BARAT, LAMPUNG",4,87,105,192
https://kawalpemilu.org#23485,"PASAR KOTA KRUI, PESISIR TENGAH, PESISIR BARAT, LAMPUNG",5,61,87,148
https://kawalpemilu.org#23485,"PASAR KOTA KRUI, PESISIR TENGAH, PESISIR BARAT, LAMPUNG",6,71,100,171
https://kawalpemilu.org#23485,"PASAR KOTA KRUI, PESISIR TENGAH, PESISIR BARAT, LAMPUNG",7,63,71,134
https://kawalpemilu.org#23485,"PASAR KOTA KRUI, PESISIR TENGAH, PESISIR BARAT, LAMPUNG",8,93,93,186
https://kawalpemilu.org#23485,"PASAR KOTA KRUI, PESISIR TENGAH, PESISIR BARAT, LAMPUNG",9,51,95,146
https://kawalpemilu.org#23485,"PASAR KOTA KRUI, PESISIR TENGAH, PESISIR BARAT, LAMPUNG",10,81,80,161
https://kawalpemilu.org#23488,"KURIPAN, PESISIR UTARA, PESISIR BARAT, LAMPUNG",1,51,103,154
https://kawalpemilu.org#23488,"KURIPAN, PESISIR UTARA, PESISIR BARAT, LAMPUNG",2,47,120,167
https://kawalpemilu.org#23488,"KURIPAN, PESISIR UTARA, PESISIR BARAT, LAMPUNG",3,35,112,147
https://kawalpemilu.org#23489,"PADANG RINDU, PESISIR UTARA, PESISIR BARAT, LAMPUNG",1,92,130,222
https://kawalpemilu.org#23489,"PADANG RINDU, PESISIR UTARA, PESISIR BARAT, LAMPUNG",2,87,121,208
https://kawalpemilu.org#23490,"NEGERI RATU, PESISIR UTARA, PESISIR BARAT, LAMPUNG",1,45,173,218
https://kawalpemilu.org#23490,"NEGERI RATU, PESISIR UTARA, PESISIR BARAT, LAMPUNG",2,87,109,196
https://kawalpemilu.org#23490,"NEGERI RATU, PESISIR UTARA, PESISIR BARAT, LAMPUNG",3,34,102,136
https://kawalpemilu.org#23491,"KERBANG DALAM, PESISIR UTARA, PESISIR BARAT, LAMPUNG",1,38,123,161
https://kawalpemilu.org#23491,"KERBANG DALAM, PESISIR UTARA, PESISIR BARAT, LAMPUNG",2,38,88,126
https://kawalpemilu.org#23492,"KOTA KARANG, PESISIR UTARA, PESISIR BARAT, LAMPUNG",1,78,105,183
https://kawalpemilu.org#23492,"KOTA KARANG, PESISIR UTARA, PESISIR BARAT, LAMPUNG",2,111,99,210
https://kawalpemilu.org#23494,"BALAM, PESISIR UTARA, PESISIR BARAT, LAMPUNG",1,59,105,164
https://kawalpemilu.org#23494,"BALAM, PESISIR UTARA, PESISIR BARAT, LAMPUNG",2,53,106,159
https://kawalpemilu.org#23495,"WAY NARTA, PESISIR UTARA, PESISIR BARAT, LAMPUNG",1,43,87,130
https://kawalpemilu.org#23495,"WAY NARTA, PESISIR UTARA, PESISIR BARAT, LAMPUNG",2,39,74,113
https://kawalpemilu.org#23500,"KERBANG LANGGAR, PESISIR UTARA, PESISIR BARAT, LAMPUNG",1,35,101,136
https://kawalpemilu.org#23500,"KERBANG LANGGAR, PESISIR UTARA, PESISIR BARAT, LAMPUNG",2,23,85,108
https://kawalpemilu.org#23501,"WALUR, PESISIR UTARA, PESISIR BARAT, LAMPUNG",1,30,121,151
https://kawalpemilu.org#23501,"WALUR, PESISIR UTARA, PESISIR BARAT, LAMPUNG",2,59,111,170
https://kawalpemilu.org#23501,"WALUR, PESISIR UTARA, PESISIR BARAT, LAMPUNG",3,48,101,149
https://kawalpemilu.org#23501,"WALUR, PESISIR UTARA, PESISIR BARAT, LAMPUNG",4,99,27,126
https://kawalpemilu.org#23502,"BATU RAJA, PESISIR UTARA, PESISIR BARAT, LAMPUNG",1,44,192,236
https://kawalpemilu.org#23502,"BATU RAJA, PESISIR UTARA, PESISIR BARAT, LAMPUNG",2,79,74,153
https://kawalpemilu.org#23503,"PEMANCAR, PESISIR UTARA, PESISIR BARAT, LAMPUNG",1,56,104,160
https://kawalpemilu.org#23503,"PEMANCAR, PESISIR UTARA, PESISIR BARAT, LAMPUNG",2,66,144,210
https://kawalpemilu.org#23504,"GEDAU, PESISIR UTARA, PESISIR BARAT, LAMPUNG",1,64,84,148
https://kawalpemilu.org#23504,"GEDAU, PESISIR UTARA, PESISIR BARAT, LAMPUNG",2,61,79,140
https://kawalpemilu.org#23585,"KEBUAYAN, KARYA PENGGAWA, PESISIR BARAT, LAMPUNG",1,89,94,183
https://kawalpemilu.org#23585,"KEBUAYAN, KARYA PENGGAWA, PESISIR BARAT, LAMPUNG",2,79,115,194
https://kawalpemilu.org#23585,"KEBUAYAN, KARYA PENGGAWA, PESISIR BARAT, LAMPUNG",3,74,110,184
https://kawalpemilu.org#23586,"WAY NUKAK, KARYA PENGGAWA, PESISIR BARAT, LAMPUNG",1,111,89,200
https://kawalpemilu.org#23586,"WAY NUKAK, KARYA PENGGAWA, PESISIR BARAT, LAMPUNG",2,100,95,195
https://kawalpemilu.org#23586,"WAY NUKAK, KARYA PENGGAWA, PESISIR BARAT, LAMPUNG",3,81,125,206
https://kawalpemilu.org#23586,"WAY NUKAK, KARYA PENGGAWA, PESISIR BARAT, LAMPUNG",4,79,96,175
https://kawalpemilu.org#23587,"WAY SINDI, KARYA PENGGAWA, PESISIR BARAT, LAMPUNG",1,118,74,192
https://kawalpemilu.org#23587,"WAY SINDI, KARYA PENGGAWA, PESISIR BARAT, LAMPUNG",2,110,65,175
https://kawalpemilu.org#23587,"WAY SINDI, KARYA PENGGAWA, PESISIR BARAT, LAMPUNG",3,127,90,217
https://kawalpemilu.org#23587,"WAY SINDI, KARYA PENGGAWA, PESISIR BARAT, LAMPUNG",4,91,91,182
https://kawalpemilu.org#23587,"WAY SINDI, KARYA PENGGAWA, PESISIR BARAT, LAMPUNG",5,152,51,203
https://kawalpemilu.org#23587,"WAY SINDI, KARYA PENGGAWA, PESISIR BARAT, LAMPUNG",6,150,54,205
https://kawalpemilu.org#23588,"PENENGAHAN, KARYA PENGGAWA, PESISIR BARAT, LAMPUNG",1,108,126,234
https://kawalpemilu.org#23588,"PENENGAHAN, KARYA PENGGAWA, PESISIR BARAT, LAMPUNG",2,111,117,228
https://kawalpemilu.org#23588,"PENENGAHAN, KARYA PENGGAWA, PESISIR BARAT, LAMPUNG",3,78,160,238
https://kawalpemilu.org#23588,"PENENGAHAN, KARYA PENGGAWA, PESISIR BARAT, LAMPUNG",4,108,94,202
https://kawalpemilu.org#23588,"PENENGAHAN, KARYA PENGGAWA, PESISIR BARAT, LAMPUNG",5,148,92,240
https://kawalpemilu.org#23588,"PENENGAHAN, KARYA PENGGAWA, PESISIR BARAT, LAMPUNG",6,95,129,224
https://kawalpemilu.org#23588,"PENENGAHAN, KARYA PENGGAWA, PESISIR BARAT, LAMPUNG",7,83,121,204
https://kawalpemilu.org#23589,"MENYANCANG, KARYA PENGGAWA, PESISIR BARAT, LAMPUNG",1,82,89,171
https://kawalpemilu.org#23589,"MENYANCANG, KARYA PENGGAWA, PESISIR BARAT, LAMPUNG",2,70,161,231
https://kawalpemilu.org#23589,"MENYANCANG, KARYA PENGGAWA, PESISIR BARAT, LAMPUNG",3,78,135,213
https://kawalpemilu.org#23589,"MENYANCANG, KARYA PENGGAWA, PESISIR BARAT, LAMPUNG",4,42,95,137
https://kawalpemilu.org#23590,"LA'AY, KARYA PENGGAWA, PESISIR BARAT, LAMPUNG",1,69,111,180
https://kawalpemilu.org#23590,"LA'AY, KARYA PENGGAWA, PESISIR BARAT, LAMPUNG",2,48,102,150
https://kawalpemilu.org#23590,"LA'AY, KARYA PENGGAWA, PESISIR BARAT, LAMPUNG",3,89,108,197
https://kawalpemilu.org#23590,"LA'AY, KARYA PENGGAWA, PESISIR BARAT, LAMPUNG",4,62,122,184
https://kawalpemilu.org#23591,"PENGGAWA V ULU, KARYA PENGGAWA, PESISIR BARAT, LAMPUNG",1,69,167,236
https://kawalpemilu.org#23591,"PENGGAWA V ULU, KARYA PENGGAWA, PESISIR BARAT, LAMPUNG",2,64,160,224
https://kawalpemilu.org#23591,"PENGGAWA V ULU, KARYA PENGGAWA, PESISIR BARAT, LAMPUNG",3,120,139,259
https://kawalpemilu.org#23591,"PENGGAWA V ULU, KARYA PENGGAWA, PESISIR BARAT, LAMPUNG",4,123,109,232
https://kawalpemilu.org#23592,"PENGGAWA V TENGAH, KARYA PENGGAWA, PESISIR BARAT, LAMPUNG",1,77,161,238
https://kawalpemilu.org#23592,"PENGGAWA V TENGAH, KARYA PENGGAWA, PESISIR BARAT, LAMPUNG",2,68,124,192
https://kawalpemilu.org#23592,"PENGGAWA V TENGAH, KARYA PENGGAWA, PESISIR BARAT, LAMPUNG",3,98,136,234
https://kawalpemilu.org#23593,"WAY SINDI UTARA, KARYA PENGGAWA, PESISIR BARAT, LAMPUNG",1,69,95,164
https://kawalpemilu.org#23594,"TEMBAKAK WAY SINDI, KARYA PENGGAWA, PESISIR BARAT, LAMPUNG",1,66,62,128
https://kawalpemilu.org#23594,"TEMBAKAK WAY SINDI, KARYA PENGGAWA, PESISIR BARAT, LAMPUNG",2,58,83,141
https://kawalpemilu.org#23594,"TEMBAKAK WAY SINDI, KARYA PENGGAWA, PESISIR BARAT, LAMPUNG",3,54,77,131
https://kawalpemilu.org#23595,"WAY SINDI HANUAN, KARYA PENGGAWA, PESISIR BARAT, LAMPUNG",1,131,104,235
https://kawalpemilu.org#23595,"WAY SINDI HANUAN, KARYA PENGGAWA, PESISIR BARAT, LAMPUNG",2,164,73,137
https://kawalpemilu.org#23595,"WAY SINDI HANUAN, KARYA PENGGAWA, PESISIR BARAT, LAMPUNG",3,138,104,242
https://kawalpemilu.org#23596,"ASAHAN WAY SINDI, KARYA PENGGAWA, PESISIR BARAT, LAMPUNG",1,32,94,126
https://kawalpemilu.org#23596,"ASAHAN WAY SINDI, KARYA PENGGAWA, PESISIR BARAT, LAMPUNG",2,89,96,185
https://kawalpemilu.org#23598,"TANJUNG JATI, LEMONG, PESISIR BARAT, LAMPUNG",1,49,128,177
https://kawalpemilu.org#23599,"TANJUNG SAKTI, LEMONG, PESISIR BARAT, LAMPUNG",1,36,76,112
https://kawalpemilu.org#23600,"WAY BATANG, LEMONG, PESISIR BARAT, LAMPUNG",1,73,150,223
https://kawalpemilu.org#23600,"WAY BATANG, LEMONG, PESISIR BARAT, LAMPUNG",2,63,157,220
https://kawalpemilu.org#23601,"LEMONG, LEMONG, PESISIR BARAT, LAMPUNG",1,62,79,142
https://kawalpemilu.org#23601,"LEMONG, LEMONG, PESISIR BARAT, LAMPUNG",2,46,73,119
https://kawalpemilu.org#23601,"LEMONG, LEMONG, PESISIR BARAT, LAMPUNG",3,57,39,96
https://kawalpemilu.org#23601,"LEMONG, LEMONG, PESISIR BARAT, LAMPUNG",4,51,53,104
https://kawalpemilu.org#23601,"LEMONG, LEMONG, PESISIR BARAT, LAMPUNG",5,52,56,108
https://kawalpemilu.org#23601,"LEMONG, LEMONG, PESISIR BARAT, LAMPUNG",6,92,99,191
https://kawalpemilu.org#23601,"LEMONG, LEMONG, PESISIR BARAT, LAMPUNG",7,150,42,192
https://kawalpemilu.org#23601,"LEMONG, LEMONG, PESISIR BARAT, LAMPUNG",8,70,40,110
https://kawalpemilu.org#23602,"CAHAYA NEGERI, LEMONG, PESISIR BARAT, LAMPUNG",1,71,94,165
https://kawalpemilu.org#23602,"CAHAYA NEGERI, LEMONG, PESISIR BARAT, LAMPUNG",2,47,55,102
https://kawalpemilu.org#23603,"MALAYA, LEMONG, PESISIR BARAT, LAMPUNG",1,67,61,128
https://kawalpemilu.org#23603,"MALAYA, LEMONG, PESISIR BARAT, LAMPUNG",2,54,57,111
https://kawalpemilu.org#23603,"MALAYA, LEMONG, PESISIR BARAT, LAMPUNG",3,88,74,162
https://kawalpemilu.org#23603,"MALAYA, LEMONG, PESISIR BARAT, LAMPUNG",4,63,73,136
https://kawalpemilu.org#23603,"MALAYA, LEMONG, PESISIR BARAT, LAMPUNG",5,211,22,233
https://kawalpemilu.org#23603,"MALAYA, LEMONG, PESISIR BARAT, LAMPUNG",6,166,20,186
https://kawalpemilu.org#23604,"BAMBANG, LEMONG, PESISIR BARAT, LAMPUNG",1,40,99,139
https://kawalpemilu.org#23604,"BAMBANG, LEMONG, PESISIR BARAT, LAMPUNG",2,44,88,132
https://kawalpemilu.org#23604,"BAMBANG, LEMONG, PESISIR BARAT, LAMPUNG",3,126,22,148
https://kawalpemilu.org#23605,"PAGAR DALAM, LEMONG, PESISIR BARAT, LAMPUNG",1,40,85,125
https://kawalpemilu.org#23605,"PAGAR DALAM, LEMONG, PESISIR BARAT, LAMPUNG",2,37,81,118
https://kawalpemilu.org#23605,"PAGAR DALAM, LEMONG, PESISIR BARAT, LAMPUNG",3,129,26,155
https://kawalpemilu.org#23605,"PAGAR DALAM, LEMONG, PESISIR BARAT, LAMPUNG",4,145,37,182
https://kawalpemilu.org#23606,"BANDAR PUGUNG, LEMONG, PESISIR BARAT, LAMPUNG",1,67,158,225
https://kawalpemilu.org#23606,"BANDAR PUGUNG, LEMONG, PESISIR BARAT, LAMPUNG",2,42,145,187
https://kawalpemilu.org#23607,"PENENGAHAN, LEMONG, PESISIR BARAT, LAMPUNG",1,96,88,184
https://kawalpemilu.org#23607,"PENENGAHAN, LEMONG, PESISIR BARAT, LAMPUNG",2,64,84,148
https://kawalpemilu.org#23607,"PENENGAHAN, LEMONG, PESISIR BARAT, LAMPUNG",3,76,48,124
https://kawalpemilu.org#23607,"PENENGAHAN, LEMONG, PESISIR BARAT, LAMPUNG",4,83,127,210
https://kawalpemilu.org#23607,"PENENGAHAN, LEMONG, PESISIR BARAT, LAMPUNG",5,59,79,138
https://kawalpemilu.org#23607,"PENENGAHAN, LEMONG, PESISIR BARAT, LAMPUNG",6,74,28,102
https://kawalpemilu.org#23607,"PENENGAHAN, LEMONG, PESISIR BARAT, LAMPUNG",7,131,19,150
https://kawalpemilu.org#23607,"PENENGAHAN, LEMONG, PESISIR BARAT, LAMPUNG",8,74,19,93
https://kawalpemilu.org#23608,"RATA AGUNG, LEMONG, PESISIR BARAT, LAMPUNG",1,98,52,150
https://kawalpemilu.org#23608,"RATA AGUNG, LEMONG, PESISIR BARAT, LAMPUNG",2,83,64,147
https://kawalpemilu.org#23608,"RATA AGUNG, LEMONG, PESISIR BARAT, LAMPUNG",3,110,32,142
https://kawalpemilu.org#23608,"RATA AGUNG, LEMONG, PESISIR BARAT, LAMPUNG",4,97,38,135
https://kawalpemilu.org#23608,"RATA AGUNG, LEMONG, PESISIR BARAT, LAMPUNG",5,97,29,126
https://kawalpemilu.org#23608,"RATA AGUNG, LEMONG, PESISIR BARAT, LAMPUNG",6,92,55,147
https://kawalpemilu.org#23608,"RATA AGUNG, LEMONG, PESISIR BARAT, LAMPUNG",7,45,29,74
https://kawalpemilu.org#23609,"SUKAMULYA, LEMONG, PESISIR BARAT, LAMPUNG",1,110,46,156
https://kawalpemilu.org#23609,"SUKAMULYA, LEMONG, PESISIR BARAT, LAMPUNG",2,89,33,122
https://kawalpemilu.org#23609,"SUKAMULYA, LEMONG, PESISIR BARAT, LAMPUNG",3,86,59,145
https://kawalpemilu.org#23609,"SUKAMULYA, LEMONG, PESISIR BARAT, LAMPUNG",4,84,36,120
https://kawalpemilu.org#23610,"PARDA HAGA, LEMONG, PESISIR BARAT, LAMPUNG",1,66,167,233
https://kawalpemilu.org#23610,"PARDA HAGA, LEMONG, PESISIR BARAT, LAMPUNG",2,41,94,135
https://kawalpemilu.org#23612,"NEGERI RATU NGARAS, NGARAS, PESISIR BARAT, LAMPUNG",1,51,129,180
https://kawalpemilu.org#23612,"NEGERI RATU NGARAS, NGARAS, PESISIR BARAT, LAMPUNG",2,63,116,179
https://kawalpemilu.org#23612,"NEGERI RATU NGARAS, NGARAS, PESISIR BARAT, LAMPUNG",3,88,15,106
https://kawalpemilu.org#23614,"KOTA BATU, NGARAS, PESISIR BARAT, LAMPUNG",1,72,113,185
https://kawalpemilu.org#23614,"KOTA BATU, NGARAS, PESISIR BARAT, LAMPUNG",2,83,144,227
https://kawalpemilu.org#23615,"MULANG MAYA, NGARAS, PESISIR BARAT, LAMPUNG",1,41,119,160
https://kawalpemilu.org#23615,"MULANG MAYA, NGARAS, PESISIR BARAT, LAMPUNG",2,26,113,139
https://kawalpemilu.org#23615,"MULANG MAYA, NGARAS, PESISIR BARAT, LAMPUNG",3,92,57,149
https://kawalpemilu.org#23615,"MULANG MAYA, NGARAS, PESISIR BARAT, LAMPUNG",4,55,56,111
https://kawalpemilu.org#23616,"RAJABASA, NGARAS, PESISIR BARAT, LAMPUNG",1,66,102,168
https://kawalpemilu.org#23616,"RAJABASA, NGARAS, PESISIR BARAT, LAMPUNG",2,46,123,169
https://kawalpemilu.org#23616,"RAJABASA, NGARAS, PESISIR BARAT, LAMPUNG",3,107,101,208
https://kawalpemilu.org#23617,"PADANG DALAM, NGARAS, PESISIR BARAT, LAMPUNG",1,75,130,205
https://kawalpemilu.org#23617,"PADANG DALAM, NGARAS, PESISIR BARAT, LAMPUNG",2,64,111,175
https://kawalpemilu.org#23618,"SUKA MAJU, NGARAS, PESISIR BARAT, LAMPUNG",1,198,63,261
https://kawalpemilu.org#23618,"SUKA MAJU, NGARAS, PESISIR BARAT, LAMPUNG",2,154,32,186
https://kawalpemilu.org#23618,"SUKA MAJU, NGARAS, PESISIR BARAT, LAMPUNG",3,85,47,132
https://kawalpemilu.org#23618,"SUKA MAJU, NGARAS, PESISIR BARAT, LAMPUNG",4,129,15,144
https://kawalpemilu.org#23618,"SUKA MAJU, NGARAS, PESISIR BARAT, LAMPUNG",5,192,47,239
https://kawalpemilu.org#23619,"SUKARAME, NGARAS, PESISIR BARAT, LAMPUNG",1,109,129,238
https://kawalpemilu.org#23619,"SUKARAME, NGARAS, PESISIR BARAT, LAMPUNG",2,141,93,234
https://kawalpemilu.org#23619,"SUKARAME, NGARAS, PESISIR BARAT, LAMPUNG",3,149,74,223
https://kawalpemilu.org#23620,"PARDASUKA, NGARAS, PESISIR BARAT, LAMPUNG",1,88,134,222
https://kawalpemilu.org#23620,"PARDASUKA, NGARAS, PESISIR BARAT, LAMPUNG",2,70,93,163
https://kawalpemilu.org#23620,"PARDASUKA, NGARAS, PESISIR BARAT, LAMPUNG",3,171,72,243
https://kawalpemilu.org#84006,"BANDAR JAYA, NGARAS, PESISIR BARAT, LAMPUNG",1,31,136,167
https://kawalpemilu.org#84006,"BANDAR JAYA, NGARAS, PESISIR BARAT, LAMPUNG",2,34,126,160
https://kawalpemilu.org#23628,"SUMBER AGUNG, NGAMBUR, PESISIR BARAT, LAMPUNG",1,79,109,188
https://kawalpemilu.org#23628,"SUMBER AGUNG, NGAMBUR, PESISIR BARAT, LAMPUNG",2,57,46,103
https://kawalpemilu.org#23628,"SUMBER AGUNG, NGAMBUR, PESISIR BARAT, LAMPUNG",3,127,35,162
https://kawalpemilu.org#23628,"SUMBER AGUNG, NGAMBUR, PESISIR BARAT, LAMPUNG",4,85,6,91
https://kawalpemilu.org#23628,"SUMBER AGUNG, NGAMBUR, PESISIR BARAT, LAMPUNG",5,85,106,191
https://kawalpemilu.org#23628,"SUMBER AGUNG, NGAMBUR, PESISIR BARAT, LAMPUNG",6,134,85,219
https://kawalpemilu.org#23628,"SUMBER AGUNG, NGAMBUR, PESISIR BARAT, LAMPUNG",7,100,52,152
https://kawalpemilu.org#23628,"SUMBER AGUNG, NGAMBUR, PESISIR BARAT, LAMPUNG",8,101,19,120
https://kawalpemilu.org#23629,"ULOK MUKTI, NGAMBUR, PESISIR BARAT, LAMPUNG",1,126,117,243
https://kawalpemilu.org#23629,"ULOK MUKTI, NGAMBUR, PESISIR BARAT, LAMPUNG",2,121,66,187
https://kawalpemilu.org#23629,"ULOK MUKTI, NGAMBUR, PESISIR BARAT, LAMPUNG",3,96,54,142
https://kawalpemilu.org#23629,"ULOK MUKTI, NGAMBUR, PESISIR BARAT, LAMPUNG",4,144,40,184
https://kawalpemilu.org#23629,"ULOK MUKTI, NGAMBUR, PESISIR BARAT, LAMPUNG",5,81,42,123
https://kawalpemilu.org#23629,"ULOK MUKTI, NGAMBUR, PESISIR BARAT, LAMPUNG",6,168,36,204
https://kawalpemilu.org#23629,"ULOK MUKTI, NGAMBUR, PESISIR BARAT, LAMPUNG",7,77,27,104
https://kawalpemilu.org#23629,"ULOK MUKTI, NGAMBUR, PESISIR BARAT, LAMPUNG",8,106,48,154
https://kawalpemilu.org#23629,"ULOK MUKTI, NGAMBUR, PESISIR BARAT, LAMPUNG",9,118,33,154
https://kawalpemilu.org#23629,"ULOK MUKTI, NGAMBUR, PESISIR BARAT, LAMPUNG",10,109,42,151
https://kawalpemilu.org#23630,"NEGERI RATU NGAMBUR, NGAMBUR, PESISIR BARAT, LAMPUNG",1,67,117,184
https://kawalpemilu.org#23630,"NEGERI RATU NGAMBUR, NGAMBUR, PESISIR BARAT, LAMPUNG",2,82,97,179
https://kawalpemilu.org#23630,"NEGERI RATU NGAMBUR, NGAMBUR, PESISIR BARAT, LAMPUNG",3,170,65,235
https://kawalpemilu.org#23630,"NEGERI RATU NGAMBUR, NGAMBUR, PESISIR BARAT, LAMPUNG",4,154,68,222
https://kawalpemilu.org#23630,"NEGERI RATU NGAMBUR, NGAMBUR, PESISIR BARAT, LAMPUNG",5,75,154,229
https://kawalpemilu.org#23630,"NEGERI RATU NGAMBUR, NGAMBUR, PESISIR BARAT, LAMPUNG",6,132,37,169
https://kawalpemilu.org#23630,"NEGERI RATU NGAMBUR, NGAMBUR, PESISIR BARAT, LAMPUNG",7,107,35,142
https://kawalpemilu.org#23630,"NEGERI RATU NGAMBUR, NGAMBUR, PESISIR BARAT, LAMPUNG",8,67,14,81
https://kawalpemilu.org#23631,"PEKON MON, NGAMBUR, PESISIR BARAT, LAMPUNG",1,69,110,179
https://kawalpemilu.org#23631,"PEKON MON, NGAMBUR, PESISIR BARAT, LAMPUNG",2,101,60,161
https://kawalpemilu.org#23631,"PEKON MON, NGAMBUR, PESISIR BARAT, LAMPUNG",3,187,53,240
https://kawalpemilu.org#23631,"PEKON MON, NGAMBUR, PESISIR BARAT, LAMPUNG",4,137,50,187
https://kawalpemilu.org#23631,"PEKON MON, NGAMBUR, PESISIR BARAT, LAMPUNG",5,154,23,177
https://kawalpemilu.org#23631,"PEKON MON, NGAMBUR, PESISIR BARAT, LAMPUNG",6,96,111,207
https://kawalpemilu.org#23631,"PEKON MON, NGAMBUR, PESISIR BARAT, LAMPUNG",7,73,30,103
https://kawalpemilu.org#23631,"PEKON MON, NGAMBUR, PESISIR BARAT, LAMPUNG",8,182,51,233
https://kawalpemilu.org#23631,"PEKON MON, NGAMBUR, PESISIR BARAT, LAMPUNG",9,137,23,160
https://kawalpemilu.org#23632,"GEDUNG CAHYA KUNINGAN, NGAMBUR, PESISIR BARAT, LAMPUNG",1,47,69,116
https://kawalpemilu.org#23632,"GEDUNG CAHYA KUNINGAN, NGAMBUR, PESISIR BARAT, LAMPUNG",2,80,114,194
https://kawalpemilu.org#23632,"GEDUNG CAHYA KUNINGAN, NGAMBUR, PESISIR BARAT, LAMPUNG",3,82,46,128
https://kawalpemilu.org#23632,"GEDUNG CAHYA KUNINGAN, NGAMBUR, PESISIR BARAT, LAMPUNG",4,164,46,210
https://kawalpemilu.org#23632,"GEDUNG CAHYA KUNINGAN, NGAMBUR, PESISIR BARAT, LAMPUNG",5,227,29,256
https://kawalpemilu.org#23632,"GEDUNG CAHYA KUNINGAN, NGAMBUR, PESISIR BARAT, LAMPUNG",6,171,40,211
https://kawalpemilu.org#23632,"GEDUNG CAHYA KUNINGAN, NGAMBUR, PESISIR BARAT, LAMPUNG",7,104,71,175
https://kawalpemilu.org#23632,"GEDUNG CAHYA KUNINGAN, NGAMBUR, PESISIR BARAT, LAMPUNG",9,125,69,194
https://kawalpemilu.org#23632,"GEDUNG CAHYA KUNINGAN, NGAMBUR, PESISIR BARAT, LAMPUNG",10,79,20,99
https://kawalpemilu.org#23633,"SUKA BANJAR, NGAMBUR, PESISIR BARAT, LAMPUNG",1,164,66,230
https://kawalpemilu.org#23633,"SUKA BANJAR, NGAMBUR, PESISIR BARAT, LAMPUNG",2,212,70,282
https://kawalpemilu.org#23633,"SUKA BANJAR, NGAMBUR, PESISIR BARAT, LAMPUNG",3,149,35,184
https://kawalpemilu.org#23633,"SUKA BANJAR, NGAMBUR, PESISIR BARAT, LAMPUNG",4,169,92,261
https://kawalpemilu.org#23633,"SUKA BANJAR, NGAMBUR, PESISIR BARAT, LAMPUNG",5,114,34,148
https://kawalpemilu.org#23633,"SUKA BANJAR, NGAMBUR, PESISIR BARAT, LAMPUNG",6,114,30,144
https://kawalpemilu.org#23633,"SUKA BANJAR, NGAMBUR, PESISIR BARAT, LAMPUNG",7,189,46,235
https://kawalpemilu.org#23634,"SUKA NEGARA, NGAMBUR, PESISIR BARAT, LAMPUNG",1,72,98,170
https://kawalpemilu.org#23634,"SUKA NEGARA, NGAMBUR, PESISIR BARAT, LAMPUNG",2,164,25,189
https://kawalpemilu.org#23634,"SUKA NEGARA, NGAMBUR, PESISIR BARAT, LAMPUNG",3,120,62,182
https://kawalpemilu.org#23634,"SUKA NEGARA, NGAMBUR, PESISIR BARAT, LAMPUNG",4,85,89,174
https://kawalpemilu.org#23634,"SUKA NEGARA, NGAMBUR, PESISIR BARAT, LAMPUNG",5,98,48,146
https://kawalpemilu.org#23635,"MUARA TEMBULIH, NGAMBUR, PESISIR BARAT, LAMPUNG",1,88,167,255
https://kawalpemilu.org#23635,"MUARA TEMBULIH, NGAMBUR, PESISIR BARAT, LAMPUNG",2,135,118,253
https://kawalpemilu.org#23636,"BUMI RATU, NGAMBUR, PESISIR BARAT, LAMPUNG",1,173,29,202
https://kawalpemilu.org#23636,"BUMI RATU, NGAMBUR, PESISIR BARAT, LAMPUNG",2,153,72,225
https://kawalpemilu.org#23636,"BUMI RATU, NGAMBUR, PESISIR BARAT, LAMPUNG",3,159,50,209
https://kawalpemilu.org#23636,"BUMI RATU, NGAMBUR, PESISIR BARAT, LAMPUNG",4,156,49,205
https://kawalpemilu.org#23636,"BUMI RATU, NGAMBUR, PESISIR BARAT, LAMPUNG",5,163,41,204
https://kawalpemilu.org#23636,"BUMI RATU, NGAMBUR, PESISIR BARAT, LAMPUNG",6,187,34,221
https://kawalpemilu.org#23638,"PAGAR BUKIT, BANGKUNAT, PESISIR BARAT, LAMPUNG",1,200,43,243
https://kawalpemilu.org#23638,"PAGAR BUKIT, BANGKUNAT, PESISIR BARAT, LAMPUNG",2,154,80,234
https://kawalpemilu.org#23638,"PAGAR BUKIT, BANGKUNAT, PESISIR BARAT, LAMPUNG",3,198,54,252
https://kawalpemilu.org#23638,"PAGAR BUKIT, BANGKUNAT, PESISIR BARAT, LAMPUNG",4,163,25,188
https://kawalpemilu.org#23638,"PAGAR BUKIT, BANGKUNAT, PESISIR BARAT, LAMPUNG",5,158,35,193
https://kawalpemilu.org#23638,"PAGAR BUKIT, BANGKUNAT, PESISIR BARAT, LAMPUNG",6,150,45,195
https://kawalpemilu.org#23638,"PAGAR BUKIT, BANGKUNAT, PESISIR BARAT, LAMPUNG",7,163,28,191
https://kawalpemilu.org#23638,"PAGAR BUKIT, BANGKUNAT, PESISIR BARAT, LAMPUNG",8,157,47,204
https://kawalpemilu.org#23638,"PAGAR BUKIT, BANGKUNAT, PESISIR BARAT, LAMPUNG",9,172,53,225
https://kawalpemilu.org#23638,"PAGAR BUKIT, BANGKUNAT, PESISIR BARAT, LAMPUNG",10,143,37,180
https://kawalpemilu.org#23638,"PAGAR BUKIT, BANGKUNAT, PESISIR BARAT, LAMPUNG",11,173,28,201
https://kawalpemilu.org#23638,"PAGAR BUKIT, BANGKUNAT, PESISIR BARAT, LAMPUNG",12,139,29,168
https://kawalpemilu.org#23639,"TANJUNG KEMALA, BANGKUNAT, PESISIR BARAT, LAMPUNG",1,18,173,191
https://kawalpemilu.org#23639,"TANJUNG KEMALA, BANGKUNAT, PESISIR BARAT, LAMPUNG",2,57,137,194
https://kawalpemilu.org#23639,"TANJUNG KEMALA, BANGKUNAT, PESISIR BARAT, LAMPUNG",3,54,76,130
https://kawalpemilu.org#23640,"SUKAMARGA, BANGKUNAT, PESISIR BARAT, LAMPUNG",1,26,237,263
https://kawalpemilu.org#23640,"SUKAMARGA, BANGKUNAT, PESISIR BARAT, LAMPUNG",2,15,220,235
https://kawalpemilu.org#23640,"SUKAMARGA, BANGKUNAT, PESISIR BARAT, LAMPUNG",3,60,186,246
https://kawalpemilu.org#23640,"SUKAMARGA, BANGKUNAT, PESISIR BARAT, LAMPUNG",4,84,155,239
https://kawalpemilu.org#23640,"SUKAMARGA, BANGKUNAT, PESISIR BARAT, LAMPUNG",5,130,82,212
https://kawalpemilu.org#23640,"SUKAMARGA, BANGKUNAT, PESISIR BARAT, LAMPUNG",6,125,47,172
https://kawalpemilu.org#23640,"SUKAMARGA, BANGKUNAT, PESISIR BARAT, LAMPUNG",7,92,25,117
https://kawalpemilu.org#23641,"KOTA JAWA, BANGKUNAT, PESISIR BARAT, LAMPUNG",1,16,184,200
https://kawalpemilu.org#23641,"KOTA JAWA, BANGKUNAT, PESISIR BARAT, LAMPUNG",2,27,172,199
https://kawalpemilu.org#23641,"KOTA JAWA, BANGKUNAT, PESISIR BARAT, LAMPUNG",3,160,24,184
https://kawalpemilu.org#23641,"KOTA JAWA, BANGKUNAT, PESISIR BARAT, LAMPUNG",4,161,63,224
https://kawalpemilu.org#23641,"KOTA JAWA, BANGKUNAT, PESISIR BARAT, LAMPUNG",5,96,139,235
https://kawalpemilu.org#23641,"KOTA JAWA, BANGKUNAT, PESISIR BARAT, LAMPUNG",6,217,83,300
https://kawalpemilu.org#23641,"KOTA JAWA, BANGKUNAT, PESISIR BARAT, LAMPUNG",7,187,36,223
https://kawalpemilu.org#23642,"PENYANDINGAN, BANGKUNAT, PESISIR BARAT, LAMPUNG",1,104,133,237
https://kawalpemilu.org#23642,"PENYANDINGAN, BANGKUNAT, PESISIR BARAT, LAMPUNG",2,90,200,290
https://kawalpemilu.org#23642,"PENYANDINGAN, BANGKUNAT, PESISIR BARAT, LAMPUNG",3,118,134,252
https://kawalpemilu.org#23642,"PENYANDINGAN, BANGKUNAT, PESISIR BARAT, LAMPUNG",4,64,166,230
https://kawalpemilu.org#23643,"BANDAR DALAM, BANGKUNAT, PESISIR BARAT, LAMPUNG",1,175,33,208
https://kawalpemilu.org#23643,"BANDAR DALAM, BANGKUNAT, PESISIR BARAT, LAMPUNG",2,153,68,221
https://kawalpemilu.org#23643,"BANDAR DALAM, BANGKUNAT, PESISIR BARAT, LAMPUNG",3,69,195,264
https://kawalpemilu.org#23643,"BANDAR DALAM, BANGKUNAT, PESISIR BARAT, LAMPUNG",4,171,29,200
https://kawalpemilu.org#23643,"BANDAR DALAM, BANGKUNAT, PESISIR BARAT, LAMPUNG",5,124,86,210
https://kawalpemilu.org#23643,"BANDAR DALAM, BANGKUNAT, PESISIR BARAT, LAMPUNG",6,99,62,161
https://kawalpemilu.org#23643,"BANDAR DALAM, BANGKUNAT, PESISIR BARAT, LAMPUNG",7,77,140,217
https://kawalpemilu.org#23644,"WAY HARU, BANGKUNAT, PESISIR BARAT, LAMPUNG",1,17,268,285
https://kawalpemilu.org#23644,"WAY HARU, BANGKUNAT, PESISIR BARAT, LAMPUNG",2,193,53,246
https://kawalpemilu.org#23644,"WAY HARU, BANGKUNAT, PESISIR BARAT, LAMPUNG",3,115,89,204
https://kawalpemilu.org#23644,"WAY HARU, BANGKUNAT, PESISIR BARAT, LAMPUNG",4,172,18,190
https://kawalpemilu.org#23644,"WAY HARU, BANGKUNAT, PESISIR BARAT, LAMPUNG",5,72,44,116
https://kawalpemilu.org#23645,"PEMERIHAN, BANGKUNAT, PESISIR BARAT, LAMPUNG",1,149,119,268
https://kawalpemilu.org#23645,"PEMERIHAN, BANGKUNAT, PESISIR BARAT, LAMPUNG",2,136,109,245
https://kawalpemilu.org#23645,"PEMERIHAN, BANGKUNAT, PESISIR BARAT, LAMPUNG",3,123,81,204
https://kawalpemilu.org#23645,"PEMERIHAN, BANGKUNAT, PESISIR BARAT, LAMPUNG",4,130,81,219
https://kawalpemilu.org#23645,"PEMERIHAN, BANGKUNAT, PESISIR BARAT, LAMPUNG",5,103,104,207
https://kawalpemilu.org#23645,"PEMERIHAN, BANGKUNAT, PESISIR BARAT, LAMPUNG",6,108,61,169
https://kawalpemilu.org#23646,"SUKANEGERI, BANGKUNAT, PESISIR BARAT, LAMPUNG",1,59,170,229
https://kawalpemilu.org#23646,"SUKANEGERI, BANGKUNAT, PESISIR BARAT, LAMPUNG",2,179,17,196
https://kawalpemilu.org#23646,"SUKANEGERI, BANGKUNAT, PESISIR BARAT, LAMPUNG",3,102,86,188
https://kawalpemilu.org#23646,"SUKANEGERI, BANGKUNAT, PESISIR BARAT, LAMPUNG",4,164,49,213
https://kawalpemilu.org#23647,"SUMBEREJO, BANGKUNAT, PESISIR BARAT, LAMPUNG",1,200,73,273
https://kawalpemilu.org#23647,"SUMBEREJO, BANGKUNAT, PESISIR BARAT, LAMPUNG",2,163,64,227
https://kawalpemilu.org#23647,"SUMBEREJO, BANGKUNAT, PESISIR BARAT, LAMPUNG",3,192,50,242
https://kawalpemilu.org#23647,"SUMBEREJO, BANGKUNAT, PESISIR BARAT, LAMPUNG",4,108,56,164
https://kawalpemilu.org#23648,"SIRING GADING, BANGKUNAT, PESISIR BARAT, LAMPUNG",1,86,173,259
https://kawalpemilu.org#23648,"SIRING GADING, BANGKUNAT, PESISIR BARAT, LAMPUNG",2,89,122,211
https://kawalpemilu.org#23648,"SIRING GADING, BANGKUNAT, PESISIR BARAT, LAMPUNG",3,51,55,106
https://kawalpemilu.org#23649,"WAY TIAS, BANGKUNAT, PESISIR BARAT, LAMPUNG",1,29,110,139
https://kawalpemilu.org#23649,"WAY TIAS, BANGKUNAT, PESISIR BARAT, LAMPUNG",2,161,39,200
https://kawalpemilu.org#23649,"WAY TIAS, BANGKUNAT, PESISIR BARAT, LAMPUNG",3,34,61,95
https://kawalpemilu.org#23649,"WAY TIAS, BANGKUNAT, PESISIR BARAT, LAMPUNG",4,32,97,129
https://kawalpemilu.org#23650,"TANJUNG REJO, BANGKUNAT, PESISIR BARAT, LAMPUNG",1,63,150,213
https://kawalpemilu.org#23650,"TANJUNG REJO, BANGKUNAT, PESISIR BARAT, LAMPUNG",2,171,98,269
https://kawalpemilu.org#23650,"TANJUNG REJO, BANGKUNAT, PESISIR BARAT, LAMPUNG",3,159,68,227
https://kawalpemilu.org#23650,"TANJUNG REJO, BANGKUNAT, PESISIR BARAT, LAMPUNG",4,126,55,181
https://kawalpemilu.org#23650,"TANJUNG REJO, BANGKUNAT, PESISIR BARAT, LAMPUNG",5,159,66,225
https://kawalpemilu.org#23650,"TANJUNG REJO, BANGKUNAT, PESISIR BARAT, LAMPUNG",6,161,77,238
https://kawalpemilu.org#84003,"PAGAR BUKIT INDUK, BANGKUNAT, PESISIR BARAT, LAMPUNG",1,23,150,173
https://kawalpemilu.org#84003,"PAGAR BUKIT INDUK, BANGKUNAT, PESISIR BARAT, LAMPUNG",2,41,135,176
https://kawalpemilu.org#84003,"PAGAR BUKIT INDUK, BANGKUNAT, PESISIR BARAT, LAMPUNG",3,49,127,176
https://kawalpemilu.org#23652,"BALAI KENCANA, KRUI SELATAN, PESISIR BARAT, LAMPUNG",1,95,106,201
https://kawalpemilu.org#23652,"BALAI KENCANA, KRUI SELATAN, PESISIR BARAT, LAMPUNG",2,185,0,185
https://kawalpemilu.org#23652,"BALAI KENCANA, KRUI SELATAN, PESISIR BARAT, LAMPUNG",3,106,90,196
https://kawalpemilu.org#23652,"BALAI KENCANA, KRUI SELATAN, PESISIR BARAT, LAMPUNG",4,82,101,183
https://kawalpemilu.org#23652,"BALAI KENCANA, KRUI SELATAN, PESISIR BARAT, LAMPUNG",5,101,75,176
https://kawalpemilu.org#23653,"WAY SULUH, KRUI SELATAN, PESISIR BARAT, LAMPUNG",1,76,108,184
https://kawalpemilu.org#23653,"WAY SULUH, KRUI SELATAN, PESISIR BARAT, LAMPUNG",2,91,108,199
https://kawalpemilu.org#23653,"WAY SULUH, KRUI SELATAN, PESISIR BARAT, LAMPUNG",3,63,70,133
https://kawalpemilu.org#23654,"WAY NAPAL, KRUI SELATAN, PESISIR BARAT, LAMPUNG",1,98,84,182
https://kawalpemilu.org#23655,"PADANG HALUAN, KRUI SELATAN, PESISIR BARAT, LAMPUNG",1,96,58,154
https://kawalpemilu.org#23655,"PADANG HALUAN, KRUI SELATAN, PESISIR BARAT, LAMPUNG",2,110,81,191
https://kawalpemilu.org#23655,"PADANG HALUAN, KRUI SELATAN, PESISIR BARAT, LAMPUNG",3,105,83,188
https://kawalpemilu.org#23656,"LINTIK, KRUI SELATAN, PESISIR BARAT, LAMPUNG",1,131,104,235
https://kawalpemilu.org#23656,"LINTIK, KRUI SELATAN, PESISIR BARAT, LAMPUNG",2,147,60,207
https://kawalpemilu.org#23657,"WALUR, KRUI SELATAN, PESISIR BARAT, LAMPUNG",1,65,101,166
https://kawalpemilu.org#23657,"WALUR, KRUI SELATAN, PESISIR BARAT, LAMPUNG",2,54,119,173
https://kawalpemilu.org#23657,"WALUR, KRUI SELATAN, PESISIR BARAT, LAMPUNG",3,63,100,163
https://kawalpemilu.org#23658,"PEMERIHAN, KRUI SELATAN, PESISIR BARAT, LAMPUNG",1,87,132,219
https://kawalpemilu.org#23658,"PEMERIHAN, KRUI SELATAN, PESISIR BARAT, LAMPUNG",2,87,54,141
https://kawalpemilu.org#23658,"PEMERIHAN, KRUI SELATAN, PESISIR BARAT, LAMPUNG",3,100,50,150
https://kawalpemilu.org#23659,"MANDIRI SEJATI, KRUI SELATAN, PESISIR BARAT, LAMPUNG",1,75,68,143
https://kawalpemilu.org#23659,"MANDIRI SEJATI, KRUI SELATAN, PESISIR BARAT, LAMPUNG",2,71,61,132
https://kawalpemilu.org#23660,"PADANG RAYA, KRUI SELATAN, PESISIR BARAT, LAMPUNG",1,139,79,218
https://kawalpemilu.org#23660,"PADANG RAYA, KRUI SELATAN, PESISIR BARAT, LAMPUNG",2,123,92,215
https://kawalpemilu.org#23661,"SUKA JADI, KRUI SELATAN, PESISIR BARAT, LAMPUNG",1,118,101,219
https://kawalpemilu.org#23661,"SUKA JADI, KRUI SELATAN, PESISIR BARAT, LAMPUNG",2,138,100,238
https://kawalpemilu.org#23663,"PAJAR BULAN, WAY KRUI, PESISIR BARAT, LAMPUNG",1,72,84,156
https://kawalpemilu.org#23663,"PAJAR BULAN, WAY KRUI, PESISIR BARAT, LAMPUNG",2,69,88,157
https://kawalpemilu.org#23664,"BUMI WARAS, WAY KRUI, PESISIR BARAT, LAMPUNG",1,49,180,229
https://kawalpemilu.org#23665,"PENGGAWA V ILIR, WAY KRUI, PESISIR BARAT, LAMPUNG",1,57,155,212
https://kawalpemilu.org#23665,"PENGGAWA V ILIR, WAY KRUI, PESISIR BARAT, LAMPUNG",2,0,0,0
https://kawalpemilu.org#23665,"PENGGAWA V ILIR, WAY KRUI, PESISIR BARAT, LAMPUNG",3,45,83,128
https://kawalpemilu.org#23666,"BANJAR AGUNG, WAY KRUI, PESISIR BARAT, LAMPUNG",1,27,126,153
https://kawalpemilu.org#23666,"BANJAR AGUNG, WAY KRUI, PESISIR BARAT, LAMPUNG",2,29,84,113
https://kawalpemilu.org#23667,"ULU KRUI, WAY KRUI, PESISIR BARAT, LAMPUNG",1,66,143,209
https://kawalpemilu.org#23667,"ULU KRUI, WAY KRUI, PESISIR BARAT, LAMPUNG",2,96,126,222
https://kawalpemilu.org#23667,"ULU KRUI, WAY KRUI, PESISIR BARAT, LAMPUNG",3,92,131,223
https://kawalpemilu.org#23667,"ULU KRUI, WAY KRUI, PESISIR BARAT, LAMPUNG",4,102,38,140
https://kawalpemilu.org#23668,"GUNUNG KEMALA, WAY KRUI, PESISIR BARAT, LAMPUNG",1,62,128,190
https://kawalpemilu.org#23668,"GUNUNG KEMALA, WAY KRUI, PESISIR BARAT, LAMPUNG",2,78,165,243
https://kawalpemilu.org#23668,"GUNUNG KEMALA, WAY KRUI, PESISIR BARAT, LAMPUNG",3,104,105,209
https://kawalpemilu.org#23668,"GUNUNG KEMALA, WAY KRUI, PESISIR BARAT, LAMPUNG",4,102,140,242
https://kawalpemilu.org#23669,"SUKA BARU, WAY KRUI, PESISIR BARAT, LAMPUNG",1,87,124,211
https://kawalpemilu.org#23669,"SUKA BARU, WAY KRUI, PESISIR BARAT, LAMPUNG",2,77,139,216
https://kawalpemilu.org#23669,"SUKA BARU, WAY KRUI, PESISIR BARAT, LAMPUNG",3,75,124,199
https://kawalpemilu.org#23670,"LABUHAN MANDI, WAY KRUI, PESISIR BARAT, LAMPUNG",1,46,147,193
https://kawalpemilu.org#23670,"LABUHAN MANDI, WAY KRUI, PESISIR BARAT, LAMPUNG",2,58,167,225
https://kawalpemilu.org#23670,"LABUHAN MANDI, WAY KRUI, PESISIR BARAT, LAMPUNG",3,48,44,92
https://kawalpemilu.org#23671,"GUNUNG KEMALA TIMUR, WAY KRUI, PESISIR BARAT, LAMPUNG",1,112,87,199
https://kawalpemilu.org#23671,"GUNUNG KEMALA TIMUR, WAY KRUI, PESISIR BARAT, LAMPUNG",2,73,104,177
https://kawalpemilu.org#23671,"GUNUNG KEMALA TIMUR, WAY KRUI, PESISIR BARAT, LAMPUNG",3,53,122,175
https://kawalpemilu.org#23672,"PENGGAWA LIMA, WAY KRUI, PESISIR BARAT, LAMPUNG",1,45,77,122
https://kawalpemilu.org#23672,"PENGGAWA LIMA, WAY KRUI, PESISIR BARAT, LAMPUNG",2,66,98,164
https://kawalpemilu.org#84010,"SUKA MARGA, PULAUPISANG, PESISIR BARAT, LAMPUNG",1,27,17,44
https://kawalpemilu.org#84012,"PEKON LOK, PULAUPISANG, PESISIR BARAT, LAMPUNG",1,18,30,48
https://kawalpemilu.org#84015,"BANDAR DALAM, PULAUPISANG, PESISIR BARAT, LAMPUNG",1,21,50,71
https://kawalpemilu.org#84018,"PASAR PULAU PISANG, PULAUPISANG, PESISIR BARAT, LAMPUNG",1,70,94,164
https://kawalpemilu.org#84018,"PASAR PULAU PISANG, PULAUPISANG, PESISIR BARAT, LAMPUNG",2,80,90,170
https://kawalpemilu.org#84019,"SUKADANA, PULAUPISANG, PESISIR BARAT, LAMPUNG",1,61,86,147
https://kawalpemilu.org#84020,"LABUHAN, PULAUPISANG, PESISIR BARAT, LAMPUNG",1,52,129,181
