Link KawalPemilu,Nama Kelurahan,Nomor TPS,Suara 01,Suara 02,Suara Sah
https://kawalpemilu.org#55097,"BOKONUSAN, SEMAU, KUPANG, NUSA TENGGARA TIMUR",1,192,4,196
https://kawalpemilu.org#55097,"BOKONUSAN, SEMAU, KUPANG, NUSA TENGGARA TIMUR",3,217,4,221
https://kawalpemilu.org#55098,"OTAN, SEMAU, KUPANG, NUSA TENGGARA TIMUR",1,135,3,138
https://kawalpemilu.org#55098,"OTAN, SEMAU, KUPANG, NUSA TENGGARA TIMUR",2,222,6,228
https://kawalpemilu.org#55098,"OTAN, SEMAU, KUPANG, NUSA TENGGARA TIMUR",3,178,2,180
https://kawalpemilu.org#55099,"UITAO, SEMAU, KUPANG, NUSA TENGGARA TIMUR",1,233,3,236
https://kawalpemilu.org#55099,"UITAO, SEMAU, KUPANG, NUSA TENGGARA TIMUR",2,261,7,268
https://kawalpemilu.org#55100,"UIASA, SEMAU, KUPANG, NUSA TENGGARA TIMUR",1,186,3,189
https://kawalpemilu.org#55100,"UIASA, SEMAU, KUPANG, NUSA TENGGARA TIMUR",2,203,4,207
https://kawalpemilu.org#55102,"HANSISI, SEMAU, KUPANG, NUSA TENGGARA TIMUR",1,221,4,225
https://kawalpemilu.org#55102,"HANSISI, SEMAU, KUPANG, NUSA TENGGARA TIMUR",2,209,3,212
https://kawalpemilu.org#55102,"HANSISI, SEMAU, KUPANG, NUSA TENGGARA TIMUR",3,253,4,257
https://kawalpemilu.org#55102,"HANSISI, SEMAU, KUPANG, NUSA TENGGARA TIMUR",4,126,4,130
https://kawalpemilu.org#55103,"HUILELOT, SEMAU, KUPANG, NUSA TENGGARA TIMUR",1,234,2,236
https://kawalpemilu.org#55103,"HUILELOT, SEMAU, KUPANG, NUSA TENGGARA TIMUR",2,232,2,234
https://kawalpemilu.org#55105,"LETBAUN, SEMAU, KUPANG, NUSA TENGGARA TIMUR",1,121,2,123
https://kawalpemilu.org#55105,"LETBAUN, SEMAU, KUPANG, NUSA TENGGARA TIMUR",2,143,5,148
https://kawalpemilu.org#55106,"BATUINAN, SEMAU, KUPANG, NUSA TENGGARA TIMUR",1,223,1,224
https://kawalpemilu.org#55108,"OENESU, KUPANG BARAT, KUPANG, NUSA TENGGARA TIMUR",1,220,7,227
https://kawalpemilu.org#55108,"OENESU, KUPANG BARAT, KUPANG, NUSA TENGGARA TIMUR",2,209,2,211
https://kawalpemilu.org#55108,"OENESU, KUPANG BARAT, KUPANG, NUSA TENGGARA TIMUR",3,201,10,211
https://kawalpemilu.org#55109,"BATAKTE, KUPANG BARAT, KUPANG, NUSA TENGGARA TIMUR",1,201,12,213
https://kawalpemilu.org#55109,"BATAKTE, KUPANG BARAT, KUPANG, NUSA TENGGARA TIMUR",2,193,23,216
https://kawalpemilu.org#55109,"BATAKTE, KUPANG BARAT, KUPANG, NUSA TENGGARA TIMUR",3,168,19,187
https://kawalpemilu.org#55109,"BATAKTE, KUPANG BARAT, KUPANG, NUSA TENGGARA TIMUR",4,203,4,207
https://kawalpemilu.org#55110,"MANULAI I, KUPANG BARAT, KUPANG, NUSA TENGGARA TIMUR",1,198,4,202
https://kawalpemilu.org#55110,"MANULAI I, KUPANG BARAT, KUPANG, NUSA TENGGARA TIMUR",2,177,17,194
https://kawalpemilu.org#55110,"MANULAI I, KUPANG BARAT, KUPANG, NUSA TENGGARA TIMUR",3,180,16,196
https://kawalpemilu.org#55110,"MANULAI I, KUPANG BARAT, KUPANG, NUSA TENGGARA TIMUR",4,213,7,220
https://kawalpemilu.org#55111,"SUMLILI, KUPANG BARAT, KUPANG, NUSA TENGGARA TIMUR",1,271,4,275
https://kawalpemilu.org#55111,"SUMLILI, KUPANG BARAT, KUPANG, NUSA TENGGARA TIMUR",2,251,11,262
https://kawalpemilu.org#55111,"SUMLILI, KUPANG BARAT, KUPANG, NUSA TENGGARA TIMUR",3,203,2,205
https://kawalpemilu.org#55111,"SUMLILI, KUPANG BARAT, KUPANG, NUSA TENGGARA TIMUR",4,251,1,252
https://kawalpemilu.org#55112,"LIFULEO, KUPANG BARAT, KUPANG, NUSA TENGGARA TIMUR",1,139,4,143
https://kawalpemilu.org#55112,"LIFULEO, KUPANG BARAT, KUPANG, NUSA TENGGARA TIMUR",2,152,4,156
https://kawalpemilu.org#55112,"LIFULEO, KUPANG BARAT, KUPANG, NUSA TENGGARA TIMUR",3,150,10,160
https://kawalpemilu.org#55112,"LIFULEO, KUPANG BARAT, KUPANG, NUSA TENGGARA TIMUR",4,167,6,173
https://kawalpemilu.org#55113,"TESABELA, KUPANG BARAT, KUPANG, NUSA TENGGARA TIMUR",1,134,5,139
https://kawalpemilu.org#55113,"TESABELA, KUPANG BARAT, KUPANG, NUSA TENGGARA TIMUR",2,187,8,195
https://kawalpemilu.org#55113,"TESABELA, KUPANG BARAT, KUPANG, NUSA TENGGARA TIMUR",3,117,16,133
https://kawalpemilu.org#55113,"TESABELA, KUPANG BARAT, KUPANG, NUSA TENGGARA TIMUR",4,118,2,120
https://kawalpemilu.org#55114,"OEMATNUNU, KUPANG BARAT, KUPANG, NUSA TENGGARA TIMUR",1,272,12,284
https://kawalpemilu.org#55114,"OEMATNUNU, KUPANG BARAT, KUPANG, NUSA TENGGARA TIMUR",2,246,9,255
https://kawalpemilu.org#55114,"OEMATNUNU, KUPANG BARAT, KUPANG, NUSA TENGGARA TIMUR",3,266,2,268
https://kawalpemilu.org#55114,"OEMATNUNU, KUPANG BARAT, KUPANG, NUSA TENGGARA TIMUR",4,124,93,217
https://kawalpemilu.org#55114,"OEMATNUNU, KUPANG BARAT, KUPANG, NUSA TENGGARA TIMUR",5,172,26,198
https://kawalpemilu.org#55115,"KUANHEUN, KUPANG BARAT, KUPANG, NUSA TENGGARA TIMUR",1,262,3,265
https://kawalpemilu.org#55115,"KUANHEUN, KUPANG BARAT, KUPANG, NUSA TENGGARA TIMUR",2,259,6,265
https://kawalpemilu.org#55115,"KUANHEUN, KUPANG BARAT, KUPANG, NUSA TENGGARA TIMUR",3,272,4,276
https://kawalpemilu.org#55115,"KUANHEUN, KUPANG BARAT, KUPANG, NUSA TENGGARA TIMUR",4,140,2,142
https://kawalpemilu.org#55116,"NITNEO, KUPANG BARAT, KUPANG, NUSA TENGGARA TIMUR",1,254,7,261
https://kawalpemilu.org#55116,"NITNEO, KUPANG BARAT, KUPANG, NUSA TENGGARA TIMUR",2,214,5,219
https://kawalpemilu.org#55116,"NITNEO, KUPANG BARAT, KUPANG, NUSA TENGGARA TIMUR",3,181,5,186
https://kawalpemilu.org#55117,"BOLOK, KUPANG BARAT, KUPANG, NUSA TENGGARA TIMUR",1,249,7,256
https://kawalpemilu.org#55117,"BOLOK, KUPANG BARAT, KUPANG, NUSA TENGGARA TIMUR",2,266,1,267
https://kawalpemilu.org#55117,"BOLOK, KUPANG BARAT, KUPANG, NUSA TENGGARA TIMUR",3,250,3,253
https://kawalpemilu.org#55117,"BOLOK, KUPANG BARAT, KUPANG, NUSA TENGGARA TIMUR",4,269,0,269
https://kawalpemilu.org#55117,"BOLOK, KUPANG BARAT, KUPANG, NUSA TENGGARA TIMUR",6,243,17,260
https://kawalpemilu.org#55118,"TABLOLONG, KUPANG BARAT, KUPANG, NUSA TENGGARA TIMUR",1,122,114,236
https://kawalpemilu.org#55118,"TABLOLONG, KUPANG BARAT, KUPANG, NUSA TENGGARA TIMUR",2,229,7,236
https://kawalpemilu.org#55118,"TABLOLONG, KUPANG BARAT, KUPANG, NUSA TENGGARA TIMUR",3,215,13,228
https://kawalpemilu.org#55119,"OENAEK, KUPANG BARAT, KUPANG, NUSA TENGGARA TIMUR",1,278,7,285
https://kawalpemilu.org#55119,"OENAEK, KUPANG BARAT, KUPANG, NUSA TENGGARA TIMUR",2,115,1,116
https://kawalpemilu.org#55121,"BABAU, KUPANG TIMUR, KUPANG, NUSA TENGGARA TIMUR",1,249,19,268
https://kawalpemilu.org#55121,"BABAU, KUPANG TIMUR, KUPANG, NUSA TENGGARA TIMUR",2,214,25,239
https://kawalpemilu.org#55121,"BABAU, KUPANG TIMUR, KUPANG, NUSA TENGGARA TIMUR",3,225,10,235
https://kawalpemilu.org#55121,"BABAU, KUPANG TIMUR, KUPANG, NUSA TENGGARA TIMUR",4,257,9,266
https://kawalpemilu.org#55121,"BABAU, KUPANG TIMUR, KUPANG, NUSA TENGGARA TIMUR",5,234,7,241
https://kawalpemilu.org#55121,"BABAU, KUPANG TIMUR, KUPANG, NUSA TENGGARA TIMUR",6,249,9,258
https://kawalpemilu.org#55121,"BABAU, KUPANG TIMUR, KUPANG, NUSA TENGGARA TIMUR",7,248,7,255
https://kawalpemilu.org#55121,"BABAU, KUPANG TIMUR, KUPANG, NUSA TENGGARA TIMUR",8,213,7,220
https://kawalpemilu.org#55121,"BABAU, KUPANG TIMUR, KUPANG, NUSA TENGGARA TIMUR",9,210,6,216
https://kawalpemilu.org#55122,"NAIBONAT, KUPANG TIMUR, KUPANG, NUSA TENGGARA TIMUR",1,251,4,255
https://kawalpemilu.org#55122,"NAIBONAT, KUPANG TIMUR, KUPANG, NUSA TENGGARA TIMUR",2,247,13,260
https://kawalpemilu.org#55122,"NAIBONAT, KUPANG TIMUR, KUPANG, NUSA TENGGARA TIMUR",3,258,12,270
https://kawalpemilu.org#55122,"NAIBONAT, KUPANG TIMUR, KUPANG, NUSA TENGGARA TIMUR",4,211,21,232
https://kawalpemilu.org#55122,"NAIBONAT, KUPANG TIMUR, KUPANG, NUSA TENGGARA TIMUR",5,163,32,195
https://kawalpemilu.org#55122,"NAIBONAT, KUPANG TIMUR, KUPANG, NUSA TENGGARA TIMUR",6,81,112,193
https://kawalpemilu.org#55122,"NAIBONAT, KUPANG TIMUR, KUPANG, NUSA TENGGARA TIMUR",7,110,63,173
https://kawalpemilu.org#55122,"NAIBONAT, KUPANG TIMUR, KUPANG, NUSA TENGGARA TIMUR",8,125,93,218
https://kawalpemilu.org#55122,"NAIBONAT, KUPANG TIMUR, KUPANG, NUSA TENGGARA TIMUR",9,78,152,230
https://kawalpemilu.org#55122,"NAIBONAT, KUPANG TIMUR, KUPANG, NUSA TENGGARA TIMUR",10,118,128,246
https://kawalpemilu.org#55122,"NAIBONAT, KUPANG TIMUR, KUPANG, NUSA TENGGARA TIMUR",11,18,157,175
https://kawalpemilu.org#55122,"NAIBONAT, KUPANG TIMUR, KUPANG, NUSA TENGGARA TIMUR",12,16,144,160
https://kawalpemilu.org#55122,"NAIBONAT, KUPANG TIMUR, KUPANG, NUSA TENGGARA TIMUR",13,25,107,132
https://kawalpemilu.org#55122,"NAIBONAT, KUPANG TIMUR, KUPANG, NUSA TENGGARA TIMUR",14,142,33,175
https://kawalpemilu.org#55122,"NAIBONAT, KUPANG TIMUR, KUPANG, NUSA TENGGARA TIMUR",15,88,99,187
https://kawalpemilu.org#55122,"NAIBONAT, KUPANG TIMUR, KUPANG, NUSA TENGGARA TIMUR",16,53,134,187
https://kawalpemilu.org#55122,"NAIBONAT, KUPANG TIMUR, KUPANG, NUSA TENGGARA TIMUR",17,25,220,245
https://kawalpemilu.org#55122,"NAIBONAT, KUPANG TIMUR, KUPANG, NUSA TENGGARA TIMUR",18,30,198,228
https://kawalpemilu.org#55122,"NAIBONAT, KUPANG TIMUR, KUPANG, NUSA TENGGARA TIMUR",19,37,202,239
https://kawalpemilu.org#55122,"NAIBONAT, KUPANG TIMUR, KUPANG, NUSA TENGGARA TIMUR",20,109,133,242
https://kawalpemilu.org#55122,"NAIBONAT, KUPANG TIMUR, KUPANG, NUSA TENGGARA TIMUR",21,174,36,210
https://kawalpemilu.org#55122,"NAIBONAT, KUPANG TIMUR, KUPANG, NUSA TENGGARA TIMUR",22,51,136,187
https://kawalpemilu.org#55122,"NAIBONAT, KUPANG TIMUR, KUPANG, NUSA TENGGARA TIMUR",23,117,95,212
https://kawalpemilu.org#55122,"NAIBONAT, KUPANG TIMUR, KUPANG, NUSA TENGGARA TIMUR",24,182,35,217
https://kawalpemilu.org#55122,"NAIBONAT, KUPANG TIMUR, KUPANG, NUSA TENGGARA TIMUR",25,210,40,250
https://kawalpemilu.org#55123,"KEL. OESAO, KUPANG TIMUR, KUPANG, NUSA TENGGARA TIMUR",1,191,9,200
https://kawalpemilu.org#55123,"KEL. OESAO, KUPANG TIMUR, KUPANG, NUSA TENGGARA TIMUR",2,207,11,218
https://kawalpemilu.org#55123,"KEL. OESAO, KUPANG TIMUR, KUPANG, NUSA TENGGARA TIMUR",3,181,11,192
https://kawalpemilu.org#55123,"KEL. OESAO, KUPANG TIMUR, KUPANG, NUSA TENGGARA TIMUR",4,235,8,243
https://kawalpemilu.org#55123,"KEL. OESAO, KUPANG TIMUR, KUPANG, NUSA TENGGARA TIMUR",5,181,19,200
https://kawalpemilu.org#55123,"KEL. OESAO, KUPANG TIMUR, KUPANG, NUSA TENGGARA TIMUR",6,195,30,225
https://kawalpemilu.org#55123,"KEL. OESAO, KUPANG TIMUR, KUPANG, NUSA TENGGARA TIMUR",7,177,21,198
https://kawalpemilu.org#55123,"KEL. OESAO, KUPANG TIMUR, KUPANG, NUSA TENGGARA TIMUR",8,194,16,210
https://kawalpemilu.org#55123,"KEL. OESAO, KUPANG TIMUR, KUPANG, NUSA TENGGARA TIMUR",9,247,5,252
https://kawalpemilu.org#55123,"KEL. OESAO, KUPANG TIMUR, KUPANG, NUSA TENGGARA TIMUR",10,233,21,254
https://kawalpemilu.org#55123,"KEL. OESAO, KUPANG TIMUR, KUPANG, NUSA TENGGARA TIMUR",11,210,8,218
https://kawalpemilu.org#55123,"KEL. OESAO, KUPANG TIMUR, KUPANG, NUSA TENGGARA TIMUR",12,203,7,210
https://kawalpemilu.org#55123,"KEL. OESAO, KUPANG TIMUR, KUPANG, NUSA TENGGARA TIMUR",13,220,20,240
https://kawalpemilu.org#55123,"KEL. OESAO, KUPANG TIMUR, KUPANG, NUSA TENGGARA TIMUR",14,212,5,217
https://kawalpemilu.org#55123,"KEL. OESAO, KUPANG TIMUR, KUPANG, NUSA TENGGARA TIMUR",15,98,7,105
https://kawalpemilu.org#55124,"MERDEKA, KUPANG TIMUR, KUPANG, NUSA TENGGARA TIMUR",1,207,19,226
https://kawalpemilu.org#55124,"MERDEKA, KUPANG TIMUR, KUPANG, NUSA TENGGARA TIMUR",2,184,24,208
https://kawalpemilu.org#55124,"MERDEKA, KUPANG TIMUR, KUPANG, NUSA TENGGARA TIMUR",3,216,21,237
https://kawalpemilu.org#55124,"MERDEKA, KUPANG TIMUR, KUPANG, NUSA TENGGARA TIMUR",4,209,20,229
https://kawalpemilu.org#55124,"MERDEKA, KUPANG TIMUR, KUPANG, NUSA TENGGARA TIMUR",5,70,142,212
https://kawalpemilu.org#55124,"MERDEKA, KUPANG TIMUR, KUPANG, NUSA TENGGARA TIMUR",6,223,4,227
https://kawalpemilu.org#55124,"MERDEKA, KUPANG TIMUR, KUPANG, NUSA TENGGARA TIMUR",7,236,4,240
https://kawalpemilu.org#55125,"TUATUKA, KUPANG TIMUR, KUPANG, NUSA TENGGARA TIMUR",1,202,5,207
https://kawalpemilu.org#55125,"TUATUKA, KUPANG TIMUR, KUPANG, NUSA TENGGARA TIMUR",2,224,8,232
https://kawalpemilu.org#55125,"TUATUKA, KUPANG TIMUR, KUPANG, NUSA TENGGARA TIMUR",4,200,7,207
https://kawalpemilu.org#55125,"TUATUKA, KUPANG TIMUR, KUPANG, NUSA TENGGARA TIMUR",5,201,5,206
https://kawalpemilu.org#55125,"TUATUKA, KUPANG TIMUR, KUPANG, NUSA TENGGARA TIMUR",6,190,2,192
https://kawalpemilu.org#55125,"TUATUKA, KUPANG TIMUR, KUPANG, NUSA TENGGARA TIMUR",7,240,1,241
https://kawalpemilu.org#55126,"NUNKURUS, KUPANG TIMUR, KUPANG, NUSA TENGGARA TIMUR",1,230,2,232
https://kawalpemilu.org#55126,"NUNKURUS, KUPANG TIMUR, KUPANG, NUSA TENGGARA TIMUR",2,221,1,222
https://kawalpemilu.org#55126,"NUNKURUS, KUPANG TIMUR, KUPANG, NUSA TENGGARA TIMUR",3,217,9,226
https://kawalpemilu.org#55126,"NUNKURUS, KUPANG TIMUR, KUPANG, NUSA TENGGARA TIMUR",4,241,5,246
https://kawalpemilu.org#55126,"NUNKURUS, KUPANG TIMUR, KUPANG, NUSA TENGGARA TIMUR",5,185,3,188
https://kawalpemilu.org#55126,"NUNKURUS, KUPANG TIMUR, KUPANG, NUSA TENGGARA TIMUR",6,220,2,222
https://kawalpemilu.org#55126,"NUNKURUS, KUPANG TIMUR, KUPANG, NUSA TENGGARA TIMUR",7,194,5,199
https://kawalpemilu.org#55127,"TUAPUKAN, KUPANG TIMUR, KUPANG, NUSA TENGGARA TIMUR",1,224,7,231
https://kawalpemilu.org#55127,"TUAPUKAN, KUPANG TIMUR, KUPANG, NUSA TENGGARA TIMUR",2,231,7,238
https://kawalpemilu.org#55127,"TUAPUKAN, KUPANG TIMUR, KUPANG, NUSA TENGGARA TIMUR",3,253,3,256
https://kawalpemilu.org#55127,"TUAPUKAN, KUPANG TIMUR, KUPANG, NUSA TENGGARA TIMUR",4,198,2,200
https://kawalpemilu.org#55127,"TUAPUKAN, KUPANG TIMUR, KUPANG, NUSA TENGGARA TIMUR",5,140,73,213
https://kawalpemilu.org#55127,"TUAPUKAN, KUPANG TIMUR, KUPANG, NUSA TENGGARA TIMUR",6,31,186,217
https://kawalpemilu.org#55127,"TUAPUKAN, KUPANG TIMUR, KUPANG, NUSA TENGGARA TIMUR",7,85,91,176
https://kawalpemilu.org#55128,"OEFAFI, KUPANG TIMUR, KUPANG, NUSA TENGGARA TIMUR",1,237,4,241
https://kawalpemilu.org#55128,"OEFAFI, KUPANG TIMUR, KUPANG, NUSA TENGGARA TIMUR",2,223,11,234
https://kawalpemilu.org#55128,"OEFAFI, KUPANG TIMUR, KUPANG, NUSA TENGGARA TIMUR",3,196,8,204
https://kawalpemilu.org#55128,"OEFAFI, KUPANG TIMUR, KUPANG, NUSA TENGGARA TIMUR",4,224,43,267
https://kawalpemilu.org#55128,"OEFAFI, KUPANG TIMUR, KUPANG, NUSA TENGGARA TIMUR",5,52,179,231
https://kawalpemilu.org#55128,"OEFAFI, KUPANG TIMUR, KUPANG, NUSA TENGGARA TIMUR",6,85,9,94
https://kawalpemilu.org#55131,"PUKDALE, KUPANG TIMUR, KUPANG, NUSA TENGGARA TIMUR",1,214,3,217
https://kawalpemilu.org#55131,"PUKDALE, KUPANG TIMUR, KUPANG, NUSA TENGGARA TIMUR",2,196,5,201
https://kawalpemilu.org#55131,"PUKDALE, KUPANG TIMUR, KUPANG, NUSA TENGGARA TIMUR",3,189,4,193
https://kawalpemilu.org#55131,"PUKDALE, KUPANG TIMUR, KUPANG, NUSA TENGGARA TIMUR",4,145,5,150
https://kawalpemilu.org#55131,"PUKDALE, KUPANG TIMUR, KUPANG, NUSA TENGGARA TIMUR",5,220,0,220
https://kawalpemilu.org#55131,"PUKDALE, KUPANG TIMUR, KUPANG, NUSA TENGGARA TIMUR",6,222,1,223
https://kawalpemilu.org#55131,"PUKDALE, KUPANG TIMUR, KUPANG, NUSA TENGGARA TIMUR",7,249,2,251
https://kawalpemilu.org#55135,"TANAH PUTIH, KUPANG TIMUR, KUPANG, NUSA TENGGARA TIMUR",1,200,11,211
https://kawalpemilu.org#55135,"TANAH PUTIH, KUPANG TIMUR, KUPANG, NUSA TENGGARA TIMUR",2,195,10,205
https://kawalpemilu.org#55135,"TANAH PUTIH, KUPANG TIMUR, KUPANG, NUSA TENGGARA TIMUR",3,219,3,222
https://kawalpemilu.org#55135,"TANAH PUTIH, KUPANG TIMUR, KUPANG, NUSA TENGGARA TIMUR",4,201,4,205
https://kawalpemilu.org#55136,"MANUSAK, KUPANG TIMUR, KUPANG, NUSA TENGGARA TIMUR",1,177,36,213
https://kawalpemilu.org#55136,"MANUSAK, KUPANG TIMUR, KUPANG, NUSA TENGGARA TIMUR",2,85,113,198
https://kawalpemilu.org#55136,"MANUSAK, KUPANG TIMUR, KUPANG, NUSA TENGGARA TIMUR",3,139,56,195
https://kawalpemilu.org#55136,"MANUSAK, KUPANG TIMUR, KUPANG, NUSA TENGGARA TIMUR",4,55,109,164
https://kawalpemilu.org#55136,"MANUSAK, KUPANG TIMUR, KUPANG, NUSA TENGGARA TIMUR",5,30,195,225
https://kawalpemilu.org#55136,"MANUSAK, KUPANG TIMUR, KUPANG, NUSA TENGGARA TIMUR",6,68,134,202
https://kawalpemilu.org#55136,"MANUSAK, KUPANG TIMUR, KUPANG, NUSA TENGGARA TIMUR",7,35,161,196
https://kawalpemilu.org#55136,"MANUSAK, KUPANG TIMUR, KUPANG, NUSA TENGGARA TIMUR",8,59,91,150
https://kawalpemilu.org#55136,"MANUSAK, KUPANG TIMUR, KUPANG, NUSA TENGGARA TIMUR",9,48,109,157
https://kawalpemilu.org#55136,"MANUSAK, KUPANG TIMUR, KUPANG, NUSA TENGGARA TIMUR",10,142,46,188
https://kawalpemilu.org#55136,"MANUSAK, KUPANG TIMUR, KUPANG, NUSA TENGGARA TIMUR",11,23,178,201
https://kawalpemilu.org#55136,"MANUSAK, KUPANG TIMUR, KUPANG, NUSA TENGGARA TIMUR",12,13,52,65
https://kawalpemilu.org#55137,"OELATIMO, KUPANG TIMUR, KUPANG, NUSA TENGGARA TIMUR",1,221,5,226
https://kawalpemilu.org#55137,"OELATIMO, KUPANG TIMUR, KUPANG, NUSA TENGGARA TIMUR",2,229,3,232
https://kawalpemilu.org#55137,"OELATIMO, KUPANG TIMUR, KUPANG, NUSA TENGGARA TIMUR",3,232,10,242
https://kawalpemilu.org#92102,"OESAO, KUPANG TIMUR, KUPANG, NUSA TENGGARA TIMUR",1,224,22,246
https://kawalpemilu.org#92102,"OESAO, KUPANG TIMUR, KUPANG, NUSA TENGGARA TIMUR",2,227,5,232
https://kawalpemilu.org#92102,"OESAO, KUPANG TIMUR, KUPANG, NUSA TENGGARA TIMUR",3,233,4,237
https://kawalpemilu.org#55139,"SULAMU, SULAMU, KUPANG, NUSA TENGGARA TIMUR",1,50,131,181
https://kawalpemilu.org#55139,"SULAMU, SULAMU, KUPANG, NUSA TENGGARA TIMUR",2,57,131,188
https://kawalpemilu.org#55139,"SULAMU, SULAMU, KUPANG, NUSA TENGGARA TIMUR",3,64,101,165
https://kawalpemilu.org#55139,"SULAMU, SULAMU, KUPANG, NUSA TENGGARA TIMUR",4,45,123,168
https://kawalpemilu.org#55139,"SULAMU, SULAMU, KUPANG, NUSA TENGGARA TIMUR",5,260,6,266
https://kawalpemilu.org#55139,"SULAMU, SULAMU, KUPANG, NUSA TENGGARA TIMUR",6,200,6,206
https://kawalpemilu.org#55139,"SULAMU, SULAMU, KUPANG, NUSA TENGGARA TIMUR",7,196,6,202
https://kawalpemilu.org#55139,"SULAMU, SULAMU, KUPANG, NUSA TENGGARA TIMUR",8,221,1,222
https://kawalpemilu.org#55139,"SULAMU, SULAMU, KUPANG, NUSA TENGGARA TIMUR",9,180,12,192
https://kawalpemilu.org#55139,"SULAMU, SULAMU, KUPANG, NUSA TENGGARA TIMUR",10,160,14,174
https://kawalpemilu.org#55139,"SULAMU, SULAMU, KUPANG, NUSA TENGGARA TIMUR",12,137,26,163
https://kawalpemilu.org#55139,"SULAMU, SULAMU, KUPANG, NUSA TENGGARA TIMUR",13,141,16,157
https://kawalpemilu.org#55139,"SULAMU, SULAMU, KUPANG, NUSA TENGGARA TIMUR",14,150,20,170
https://kawalpemilu.org#55139,"SULAMU, SULAMU, KUPANG, NUSA TENGGARA TIMUR",15,60,103,163
https://kawalpemilu.org#55140,"PITAY, SULAMU, KUPANG, NUSA TENGGARA TIMUR",1,180,1,181
https://kawalpemilu.org#55140,"PITAY, SULAMU, KUPANG, NUSA TENGGARA TIMUR",2,160,5,165
https://kawalpemilu.org#55140,"PITAY, SULAMU, KUPANG, NUSA TENGGARA TIMUR",3,181,4,185
https://kawalpemilu.org#55141,"PARITI, SULAMU, KUPANG, NUSA TENGGARA TIMUR",1,223,6,229
https://kawalpemilu.org#55141,"PARITI, SULAMU, KUPANG, NUSA TENGGARA TIMUR",2,249,5,254
https://kawalpemilu.org#55141,"PARITI, SULAMU, KUPANG, NUSA TENGGARA TIMUR",3,232,5,237
https://kawalpemilu.org#55141,"PARITI, SULAMU, KUPANG, NUSA TENGGARA TIMUR",4,221,4,225
https://kawalpemilu.org#55141,"PARITI, SULAMU, KUPANG, NUSA TENGGARA TIMUR",5,202,4,206
https://kawalpemilu.org#55141,"PARITI, SULAMU, KUPANG, NUSA TENGGARA TIMUR",6,198,9,207
https://kawalpemilu.org#55141,"PARITI, SULAMU, KUPANG, NUSA TENGGARA TIMUR",7,216,9,225
https://kawalpemilu.org#55141,"PARITI, SULAMU, KUPANG, NUSA TENGGARA TIMUR",8,214,16,230
https://kawalpemilu.org#55142,"OETETA, SULAMU, KUPANG, NUSA TENGGARA TIMUR",1,235,4,239
https://kawalpemilu.org#55142,"OETETA, SULAMU, KUPANG, NUSA TENGGARA TIMUR",2,201,17,218
https://kawalpemilu.org#55142,"OETETA, SULAMU, KUPANG, NUSA TENGGARA TIMUR",3,115,6,121
https://kawalpemilu.org#55142,"OETETA, SULAMU, KUPANG, NUSA TENGGARA TIMUR",4,138,18,156
https://kawalpemilu.org#55142,"OETETA, SULAMU, KUPANG, NUSA TENGGARA TIMUR",5,139,15,154
https://kawalpemilu.org#55142,"OETETA, SULAMU, KUPANG, NUSA TENGGARA TIMUR",6,143,4,147
https://kawalpemilu.org#55142,"OETETA, SULAMU, KUPANG, NUSA TENGGARA TIMUR",8,162,6,168
https://kawalpemilu.org#55143,"BIPOLO, SULAMU, KUPANG, NUSA TENGGARA TIMUR",1,188,20,208
https://kawalpemilu.org#55143,"BIPOLO, SULAMU, KUPANG, NUSA TENGGARA TIMUR",2,206,17,223
https://kawalpemilu.org#55143,"BIPOLO, SULAMU, KUPANG, NUSA TENGGARA TIMUR",3,185,15,200
https://kawalpemilu.org#55143,"BIPOLO, SULAMU, KUPANG, NUSA TENGGARA TIMUR",4,218,9,227
https://kawalpemilu.org#55143,"BIPOLO, SULAMU, KUPANG, NUSA TENGGARA TIMUR",5,222,7,229
https://kawalpemilu.org#55144,"PANTAI BERINGIN, SULAMU, KUPANG, NUSA TENGGARA TIMUR",1,171,2,173
https://kawalpemilu.org#55144,"PANTAI BERINGIN, SULAMU, KUPANG, NUSA TENGGARA TIMUR",2,167,4,171
https://kawalpemilu.org#55145,"PANTULAN, SULAMU, KUPANG, NUSA TENGGARA TIMUR",1,146,2,148
https://kawalpemilu.org#55145,"PANTULAN, SULAMU, KUPANG, NUSA TENGGARA TIMUR",2,185,19,204
https://kawalpemilu.org#55145,"PANTULAN, SULAMU, KUPANG, NUSA TENGGARA TIMUR",3,129,7,136
https://kawalpemilu.org#55147,"TARUS, KUPANG TENGAH, KUPANG, NUSA TENGGARA TIMUR",1,249,13,262
https://kawalpemilu.org#55147,"TARUS, KUPANG TENGAH, KUPANG, NUSA TENGGARA TIMUR",2,234,14,248
https://kawalpemilu.org#55147,"TARUS, KUPANG TENGAH, KUPANG, NUSA TENGGARA TIMUR",3,239,3,242
https://kawalpemilu.org#55147,"TARUS, KUPANG TENGAH, KUPANG, NUSA TENGGARA TIMUR",4,221,3,224
https://kawalpemilu.org#55147,"TARUS, KUPANG TENGAH, KUPANG, NUSA TENGGARA TIMUR",5,237,10,247
https://kawalpemilu.org#55147,"TARUS, KUPANG TENGAH, KUPANG, NUSA TENGGARA TIMUR",6,231,9,240
https://kawalpemilu.org#55147,"TARUS, KUPANG TENGAH, KUPANG, NUSA TENGGARA TIMUR",7,229,18,247
https://kawalpemilu.org#55147,"TARUS, KUPANG TENGAH, KUPANG, NUSA TENGGARA TIMUR",8,232,26,258
https://kawalpemilu.org#55147,"TARUS, KUPANG TENGAH, KUPANG, NUSA TENGGARA TIMUR",9,238,13,251
https://kawalpemilu.org#55147,"TARUS, KUPANG TENGAH, KUPANG, NUSA TENGGARA TIMUR",10,226,10,236
https://kawalpemilu.org#55153,"OELNASI, KUPANG TENGAH, KUPANG, NUSA TENGGARA TIMUR",1,212,8,220
https://kawalpemilu.org#55153,"OELNASI, KUPANG TENGAH, KUPANG, NUSA TENGGARA TIMUR",2,185,13,198
https://kawalpemilu.org#55153,"OELNASI, KUPANG TENGAH, KUPANG, NUSA TENGGARA TIMUR",3,159,6,165
https://kawalpemilu.org#55153,"OELNASI, KUPANG TENGAH, KUPANG, NUSA TENGGARA TIMUR",4,134,2,136
https://kawalpemilu.org#55153,"OELNASI, KUPANG TENGAH, KUPANG, NUSA TENGGARA TIMUR",5,228,10,238
https://kawalpemilu.org#55153,"OELNASI, KUPANG TENGAH, KUPANG, NUSA TENGGARA TIMUR",6,227,15,242
https://kawalpemilu.org#55154,"NOELBAKI, KUPANG TENGAH, KUPANG, NUSA TENGGARA TIMUR",1,187,4,191
https://kawalpemilu.org#55154,"NOELBAKI, KUPANG TENGAH, KUPANG, NUSA TENGGARA TIMUR",2,174,10,184
https://kawalpemilu.org#55154,"NOELBAKI, KUPANG TENGAH, KUPANG, NUSA TENGGARA TIMUR",3,166,1,167
https://kawalpemilu.org#55154,"NOELBAKI, KUPANG TENGAH, KUPANG, NUSA TENGGARA TIMUR",4,175,24,199
https://kawalpemilu.org#55154,"NOELBAKI, KUPANG TENGAH, KUPANG, NUSA TENGGARA TIMUR",6,67,110,177
https://kawalpemilu.org#55154,"NOELBAKI, KUPANG TENGAH, KUPANG, NUSA TENGGARA TIMUR",7,87,115,202
https://kawalpemilu.org#55154,"NOELBAKI, KUPANG TENGAH, KUPANG, NUSA TENGGARA TIMUR",8,199,10,209
https://kawalpemilu.org#55154,"NOELBAKI, KUPANG TENGAH, KUPANG, NUSA TENGGARA TIMUR",9,98,48,146
https://kawalpemilu.org#55154,"NOELBAKI, KUPANG TENGAH, KUPANG, NUSA TENGGARA TIMUR",10,191,7,198
https://kawalpemilu.org#55154,"NOELBAKI, KUPANG TENGAH, KUPANG, NUSA TENGGARA TIMUR",11,166,13,179
https://kawalpemilu.org#55154,"NOELBAKI, KUPANG TENGAH, KUPANG, NUSA TENGGARA TIMUR",12,181,10,191
https://kawalpemilu.org#55154,"NOELBAKI, KUPANG TENGAH, KUPANG, NUSA TENGGARA TIMUR",13,189,8,197
https://kawalpemilu.org#55154,"NOELBAKI, KUPANG TENGAH, KUPANG, NUSA TENGGARA TIMUR",14,180,11,191
https://kawalpemilu.org#55154,"NOELBAKI, KUPANG TENGAH, KUPANG, NUSA TENGGARA TIMUR",15,174,16,190
https://kawalpemilu.org#55154,"NOELBAKI, KUPANG TENGAH, KUPANG, NUSA TENGGARA TIMUR",16,187,3,190
https://kawalpemilu.org#55154,"NOELBAKI, KUPANG TENGAH, KUPANG, NUSA TENGGARA TIMUR",17,166,10,176
https://kawalpemilu.org#55154,"NOELBAKI, KUPANG TENGAH, KUPANG, NUSA TENGGARA TIMUR",18,164,3,167
https://kawalpemilu.org#55154,"NOELBAKI, KUPANG TENGAH, KUPANG, NUSA TENGGARA TIMUR",19,162,14,176
https://kawalpemilu.org#55154,"NOELBAKI, KUPANG TENGAH, KUPANG, NUSA TENGGARA TIMUR",20,198,10,208
https://kawalpemilu.org#55154,"NOELBAKI, KUPANG TENGAH, KUPANG, NUSA TENGGARA TIMUR",21,187,5,192
https://kawalpemilu.org#55154,"NOELBAKI, KUPANG TENGAH, KUPANG, NUSA TENGGARA TIMUR",22,199,10,209
https://kawalpemilu.org#55154,"NOELBAKI, KUPANG TENGAH, KUPANG, NUSA TENGGARA TIMUR",23,187,14,201
https://kawalpemilu.org#55154,"NOELBAKI, KUPANG TENGAH, KUPANG, NUSA TENGGARA TIMUR",24,175,12,187
https://kawalpemilu.org#55154,"NOELBAKI, KUPANG TENGAH, KUPANG, NUSA TENGGARA TIMUR",25,260,14,274
https://kawalpemilu.org#55155,"OELPUAH, KUPANG TENGAH, KUPANG, NUSA TENGGARA TIMUR",1,199,13,212
https://kawalpemilu.org#55155,"OELPUAH, KUPANG TENGAH, KUPANG, NUSA TENGGARA TIMUR",2,170,10,180
https://kawalpemilu.org#55155,"OELPUAH, KUPANG TENGAH, KUPANG, NUSA TENGGARA TIMUR",3,183,25,208
https://kawalpemilu.org#55155,"OELPUAH, KUPANG TENGAH, KUPANG, NUSA TENGGARA TIMUR",4,142,5,147
https://kawalpemilu.org#55156,"OEBELO, KUPANG TENGAH, KUPANG, NUSA TENGGARA TIMUR",1,198,7,205
https://kawalpemilu.org#55156,"OEBELO, KUPANG TENGAH, KUPANG, NUSA TENGGARA TIMUR",2,174,6,180
https://kawalpemilu.org#55156,"OEBELO, KUPANG TENGAH, KUPANG, NUSA TENGGARA TIMUR",3,222,12,234
https://kawalpemilu.org#55156,"OEBELO, KUPANG TENGAH, KUPANG, NUSA TENGGARA TIMUR",4,56,128,184
https://kawalpemilu.org#55156,"OEBELO, KUPANG TENGAH, KUPANG, NUSA TENGGARA TIMUR",5,101,77,178
https://kawalpemilu.org#55156,"OEBELO, KUPANG TENGAH, KUPANG, NUSA TENGGARA TIMUR",6,28,177,205
https://kawalpemilu.org#55156,"OEBELO, KUPANG TENGAH, KUPANG, NUSA TENGGARA TIMUR",7,184,24,208
https://kawalpemilu.org#55156,"OEBELO, KUPANG TENGAH, KUPANG, NUSA TENGGARA TIMUR",8,34,178,212
https://kawalpemilu.org#55156,"OEBELO, KUPANG TENGAH, KUPANG, NUSA TENGGARA TIMUR",9,78,169,247
https://kawalpemilu.org#55156,"OEBELO, KUPANG TENGAH, KUPANG, NUSA TENGGARA TIMUR",10,115,101,216
https://kawalpemilu.org#55156,"OEBELO, KUPANG TENGAH, KUPANG, NUSA TENGGARA TIMUR",11,127,41,168
https://kawalpemilu.org#55156,"OEBELO, KUPANG TENGAH, KUPANG, NUSA TENGGARA TIMUR",12,149,65,214
https://kawalpemilu.org#55157,"MATA AIR, KUPANG TENGAH, KUPANG, NUSA TENGGARA TIMUR",1,189,7,196
https://kawalpemilu.org#55157,"MATA AIR, KUPANG TENGAH, KUPANG, NUSA TENGGARA TIMUR",3,212,15,227
https://kawalpemilu.org#55157,"MATA AIR, KUPANG TENGAH, KUPANG, NUSA TENGGARA TIMUR",4,208,12,220
https://kawalpemilu.org#55157,"MATA AIR, KUPANG TENGAH, KUPANG, NUSA TENGGARA TIMUR",5,222,12,234
https://kawalpemilu.org#55157,"MATA AIR, KUPANG TENGAH, KUPANG, NUSA TENGGARA TIMUR",6,173,7,180
https://kawalpemilu.org#55157,"MATA AIR, KUPANG TENGAH, KUPANG, NUSA TENGGARA TIMUR",7,177,7,184
https://kawalpemilu.org#55157,"MATA AIR, KUPANG TENGAH, KUPANG, NUSA TENGGARA TIMUR",8,191,11,202
https://kawalpemilu.org#55157,"MATA AIR, KUPANG TENGAH, KUPANG, NUSA TENGGARA TIMUR",9,207,9,216
https://kawalpemilu.org#55157,"MATA AIR, KUPANG TENGAH, KUPANG, NUSA TENGGARA TIMUR",10,215,8,223
https://kawalpemilu.org#55157,"MATA AIR, KUPANG TENGAH, KUPANG, NUSA TENGGARA TIMUR",11,219,8,227
https://kawalpemilu.org#55157,"MATA AIR, KUPANG TENGAH, KUPANG, NUSA TENGGARA TIMUR",12,217,7,224
https://kawalpemilu.org#55157,"MATA AIR, KUPANG TENGAH, KUPANG, NUSA TENGGARA TIMUR",13,225,4,229
https://kawalpemilu.org#55157,"MATA AIR, KUPANG TENGAH, KUPANG, NUSA TENGGARA TIMUR",14,155,6,161
https://kawalpemilu.org#55158,"TANAH MERAH, KUPANG TENGAH, KUPANG, NUSA TENGGARA TIMUR",1,184,6,190
https://kawalpemilu.org#55158,"TANAH MERAH, KUPANG TENGAH, KUPANG, NUSA TENGGARA TIMUR",2,191,10,201
https://kawalpemilu.org#55158,"TANAH MERAH, KUPANG TENGAH, KUPANG, NUSA TENGGARA TIMUR",3,184,14,198
https://kawalpemilu.org#55158,"TANAH MERAH, KUPANG TENGAH, KUPANG, NUSA TENGGARA TIMUR",4,186,12,198
https://kawalpemilu.org#55158,"TANAH MERAH, KUPANG TENGAH, KUPANG, NUSA TENGGARA TIMUR",5,188,11,199
https://kawalpemilu.org#55158,"TANAH MERAH, KUPANG TENGAH, KUPANG, NUSA TENGGARA TIMUR",6,213,7,220
https://kawalpemilu.org#55158,"TANAH MERAH, KUPANG TENGAH, KUPANG, NUSA TENGGARA TIMUR",7,172,68,240
https://kawalpemilu.org#55158,"TANAH MERAH, KUPANG TENGAH, KUPANG, NUSA TENGGARA TIMUR",8,170,13,183
https://kawalpemilu.org#55158,"TANAH MERAH, KUPANG TENGAH, KUPANG, NUSA TENGGARA TIMUR",9,171,3,174
https://kawalpemilu.org#55159,"PENFUI TIMUR, KUPANG TENGAH, KUPANG, NUSA TENGGARA TIMUR",1,189,10,199
https://kawalpemilu.org#55159,"PENFUI TIMUR, KUPANG TENGAH, KUPANG, NUSA TENGGARA TIMUR",2,192,11,203
https://kawalpemilu.org#55159,"PENFUI TIMUR, KUPANG TENGAH, KUPANG, NUSA TENGGARA TIMUR",3,200,16,216
https://kawalpemilu.org#55159,"PENFUI TIMUR, KUPANG TENGAH, KUPANG, NUSA TENGGARA TIMUR",4,132,18,150
https://kawalpemilu.org#55159,"PENFUI TIMUR, KUPANG TENGAH, KUPANG, NUSA TENGGARA TIMUR",5,180,10,190
https://kawalpemilu.org#55159,"PENFUI TIMUR, KUPANG TENGAH, KUPANG, NUSA TENGGARA TIMUR",6,113,17,130
https://kawalpemilu.org#55159,"PENFUI TIMUR, KUPANG TENGAH, KUPANG, NUSA TENGGARA TIMUR",7,170,15,185
https://kawalpemilu.org#55159,"PENFUI TIMUR, KUPANG TENGAH, KUPANG, NUSA TENGGARA TIMUR",8,182,5,187
https://kawalpemilu.org#55159,"PENFUI TIMUR, KUPANG TENGAH, KUPANG, NUSA TENGGARA TIMUR",9,227,12,239
https://kawalpemilu.org#55159,"PENFUI TIMUR, KUPANG TENGAH, KUPANG, NUSA TENGGARA TIMUR",10,235,10,245
https://kawalpemilu.org#55159,"PENFUI TIMUR, KUPANG TENGAH, KUPANG, NUSA TENGGARA TIMUR",11,174,5,179
https://kawalpemilu.org#55159,"PENFUI TIMUR, KUPANG TENGAH, KUPANG, NUSA TENGGARA TIMUR",12,194,12,206
https://kawalpemilu.org#55159,"PENFUI TIMUR, KUPANG TENGAH, KUPANG, NUSA TENGGARA TIMUR",13,200,21,221
https://kawalpemilu.org#55159,"PENFUI TIMUR, KUPANG TENGAH, KUPANG, NUSA TENGGARA TIMUR",14,126,3,129
https://kawalpemilu.org#55159,"PENFUI TIMUR, KUPANG TENGAH, KUPANG, NUSA TENGGARA TIMUR",15,251,22,273
https://kawalpemilu.org#55159,"PENFUI TIMUR, KUPANG TENGAH, KUPANG, NUSA TENGGARA TIMUR",16,136,5,141
https://kawalpemilu.org#55159,"PENFUI TIMUR, KUPANG TENGAH, KUPANG, NUSA TENGGARA TIMUR",17,161,4,165
https://kawalpemilu.org#55159,"PENFUI TIMUR, KUPANG TENGAH, KUPANG, NUSA TENGGARA TIMUR",18,209,6,215
https://kawalpemilu.org#55161,"NONBES, AMARASI, KUPANG, NUSA TENGGARA TIMUR",1,192,29,221
https://kawalpemilu.org#55161,"NONBES, AMARASI, KUPANG, NUSA TENGGARA TIMUR",2,206,16,222
https://kawalpemilu.org#55161,"NONBES, AMARASI, KUPANG, NUSA TENGGARA TIMUR",3,203,9,212
https://kawalpemilu.org#55161,"NONBES, AMARASI, KUPANG, NUSA TENGGARA TIMUR",4,220,8,228
https://kawalpemilu.org#55161,"NONBES, AMARASI, KUPANG, NUSA TENGGARA TIMUR",6,214,7,221
https://kawalpemilu.org#55161,"NONBES, AMARASI, KUPANG, NUSA TENGGARA TIMUR",7,200,11,211
https://kawalpemilu.org#55161,"NONBES, AMARASI, KUPANG, NUSA TENGGARA TIMUR",8,191,13,204
https://kawalpemilu.org#55161,"NONBES, AMARASI, KUPANG, NUSA TENGGARA TIMUR",9,57,3,60
https://kawalpemilu.org#55162,"OESENA, AMARASI, KUPANG, NUSA TENGGARA TIMUR",1,253,4,257
https://kawalpemilu.org#55162,"OESENA, AMARASI, KUPANG, NUSA TENGGARA TIMUR",2,222,10,232
https://kawalpemilu.org#55162,"OESENA, AMARASI, KUPANG, NUSA TENGGARA TIMUR",3,219,8,227
https://kawalpemilu.org#55162,"OESENA, AMARASI, KUPANG, NUSA TENGGARA TIMUR",4,155,2,157
https://kawalpemilu.org#55163,"PONAIN, AMARASI, KUPANG, NUSA TENGGARA TIMUR",1,195,20,215
https://kawalpemilu.org#55163,"PONAIN, AMARASI, KUPANG, NUSA TENGGARA TIMUR",2,163,10,173
https://kawalpemilu.org#55163,"PONAIN, AMARASI, KUPANG, NUSA TENGGARA TIMUR",3,183,16,199
https://kawalpemilu.org#55163,"PONAIN, AMARASI, KUPANG, NUSA TENGGARA TIMUR",4,197,10,207
https://kawalpemilu.org#55163,"PONAIN, AMARASI, KUPANG, NUSA TENGGARA TIMUR",5,205,15,220
https://kawalpemilu.org#55163,"PONAIN, AMARASI, KUPANG, NUSA TENGGARA TIMUR",6,116,6,122
https://kawalpemilu.org#55164,"KOTABES, AMARASI, KUPANG, NUSA TENGGARA TIMUR",1,255,7,262
https://kawalpemilu.org#55164,"KOTABES, AMARASI, KUPANG, NUSA TENGGARA TIMUR",2,230,14,244
https://kawalpemilu.org#55164,"KOTABES, AMARASI, KUPANG, NUSA TENGGARA TIMUR",3,240,7,247
https://kawalpemilu.org#55164,"KOTABES, AMARASI, KUPANG, NUSA TENGGARA TIMUR",4,243,17,260
https://kawalpemilu.org#55165,"TESBATAN, AMARASI, KUPANG, NUSA TENGGARA TIMUR",1,232,9,241
https://kawalpemilu.org#55165,"TESBATAN, AMARASI, KUPANG, NUSA TENGGARA TIMUR",2,62,192,254
https://kawalpemilu.org#55165,"TESBATAN, AMARASI, KUPANG, NUSA TENGGARA TIMUR",3,110,14,124
https://kawalpemilu.org#55165,"TESBATAN, AMARASI, KUPANG, NUSA TENGGARA TIMUR",4,128,51,179
https://kawalpemilu.org#55165,"TESBATAN, AMARASI, KUPANG, NUSA TENGGARA TIMUR",5,117,3,120
https://kawalpemilu.org#55166,"OENONI, AMARASI, KUPANG, NUSA TENGGARA TIMUR",1,218,7,225
https://kawalpemilu.org#55166,"OENONI, AMARASI, KUPANG, NUSA TENGGARA TIMUR",2,222,8,230
https://kawalpemilu.org#55166,"OENONI, AMARASI, KUPANG, NUSA TENGGARA TIMUR",3,222,8,230
https://kawalpemilu.org#55166,"OENONI, AMARASI, KUPANG, NUSA TENGGARA TIMUR",4,100,4,104
https://kawalpemilu.org#55167,"APREN, AMARASI, KUPANG, NUSA TENGGARA TIMUR",2,213,8,221
https://kawalpemilu.org#55167,"APREN, AMARASI, KUPANG, NUSA TENGGARA TIMUR",3,207,15,222
https://kawalpemilu.org#55167,"APREN, AMARASI, KUPANG, NUSA TENGGARA TIMUR",4,199,1,200
https://kawalpemilu.org#55167,"APREN, AMARASI, KUPANG, NUSA TENGGARA TIMUR",5,115,4,119
https://kawalpemilu.org#55168,"TESBATAN II, AMARASI, KUPANG, NUSA TENGGARA TIMUR",1,234,14,248
https://kawalpemilu.org#55168,"TESBATAN II, AMARASI, KUPANG, NUSA TENGGARA TIMUR",2,237,12,249
https://kawalpemilu.org#55168,"TESBATAN II, AMARASI, KUPANG, NUSA TENGGARA TIMUR",3,153,2,155
https://kawalpemilu.org#55168,"TESBATAN II, AMARASI, KUPANG, NUSA TENGGARA TIMUR",4,77,4,81
https://kawalpemilu.org#55169,"OENONI II, AMARASI, KUPANG, NUSA TENGGARA TIMUR",1,225,26,251
https://kawalpemilu.org#55169,"OENONI II, AMARASI, KUPANG, NUSA TENGGARA TIMUR",2,245,9,254
https://kawalpemilu.org#55169,"OENONI II, AMARASI, KUPANG, NUSA TENGGARA TIMUR",3,172,14,186
https://kawalpemilu.org#55171,"CAMPLONG I, FATULEU, KUPANG, NUSA TENGGARA TIMUR",1,213,7,220
https://kawalpemilu.org#55171,"CAMPLONG I, FATULEU, KUPANG, NUSA TENGGARA TIMUR",2,203,33,236
https://kawalpemilu.org#55171,"CAMPLONG I, FATULEU, KUPANG, NUSA TENGGARA TIMUR",4,253,8,261
https://kawalpemilu.org#55171,"CAMPLONG I, FATULEU, KUPANG, NUSA TENGGARA TIMUR",5,215,23,238
https://kawalpemilu.org#55171,"CAMPLONG I, FATULEU, KUPANG, NUSA TENGGARA TIMUR",6,248,16,264
https://kawalpemilu.org#55171,"CAMPLONG I, FATULEU, KUPANG, NUSA TENGGARA TIMUR",7,215,28,243
https://kawalpemilu.org#55171,"CAMPLONG I, FATULEU, KUPANG, NUSA TENGGARA TIMUR",8,128,12,140
https://kawalpemilu.org#55171,"CAMPLONG I, FATULEU, KUPANG, NUSA TENGGARA TIMUR",9,176,20,196
https://kawalpemilu.org#55171,"CAMPLONG I, FATULEU, KUPANG, NUSA TENGGARA TIMUR",10,180,11,191
https://kawalpemilu.org#55171,"CAMPLONG I, FATULEU, KUPANG, NUSA TENGGARA TIMUR",11,175,27,202
https://kawalpemilu.org#55177,"CAMPLONG II, FATULEU, KUPANG, NUSA TENGGARA TIMUR",1,237,11,248
https://kawalpemilu.org#55177,"CAMPLONG II, FATULEU, KUPANG, NUSA TENGGARA TIMUR",2,205,13,218
https://kawalpemilu.org#55177,"CAMPLONG II, FATULEU, KUPANG, NUSA TENGGARA TIMUR",3,110,9,119
https://kawalpemilu.org#55177,"CAMPLONG II, FATULEU, KUPANG, NUSA TENGGARA TIMUR",4,189,30,219
https://kawalpemilu.org#55177,"CAMPLONG II, FATULEU, KUPANG, NUSA TENGGARA TIMUR",5,131,15,146
https://kawalpemilu.org#55177,"CAMPLONG II, FATULEU, KUPANG, NUSA TENGGARA TIMUR",6,157,3,160
https://kawalpemilu.org#55177,"CAMPLONG II, FATULEU, KUPANG, NUSA TENGGARA TIMUR",7,246,11,257
https://kawalpemilu.org#55177,"CAMPLONG II, FATULEU, KUPANG, NUSA TENGGARA TIMUR",8,188,13,201
https://kawalpemilu.org#55177,"CAMPLONG II, FATULEU, KUPANG, NUSA TENGGARA TIMUR",9,95,1,96
https://kawalpemilu.org#55178,"NAUNU, FATULEU, KUPANG, NUSA TENGGARA TIMUR",1,223,17,240
https://kawalpemilu.org#55178,"NAUNU, FATULEU, KUPANG, NUSA TENGGARA TIMUR",2,187,12,199
https://kawalpemilu.org#55178,"NAUNU, FATULEU, KUPANG, NUSA TENGGARA TIMUR",3,178,6,184
https://kawalpemilu.org#55178,"NAUNU, FATULEU, KUPANG, NUSA TENGGARA TIMUR",4,62,47,109
https://kawalpemilu.org#55178,"NAUNU, FATULEU, KUPANG, NUSA TENGGARA TIMUR",6,75,124,199
https://kawalpemilu.org#55179,"OEBOLA, FATULEU, KUPANG, NUSA TENGGARA TIMUR",1,238,13,251
https://kawalpemilu.org#55179,"OEBOLA, FATULEU, KUPANG, NUSA TENGGARA TIMUR",2,235,11,246
https://kawalpemilu.org#55179,"OEBOLA, FATULEU, KUPANG, NUSA TENGGARA TIMUR",3,224,17,241
https://kawalpemilu.org#55179,"OEBOLA, FATULEU, KUPANG, NUSA TENGGARA TIMUR",4,76,0,76
https://kawalpemilu.org#55179,"OEBOLA, FATULEU, KUPANG, NUSA TENGGARA TIMUR",5,121,2,123
https://kawalpemilu.org#55180,"SILLU, FATULEU, KUPANG, NUSA TENGGARA TIMUR",1,241,11,252
https://kawalpemilu.org#55180,"SILLU, FATULEU, KUPANG, NUSA TENGGARA TIMUR",2,246,16,262
https://kawalpemilu.org#55180,"SILLU, FATULEU, KUPANG, NUSA TENGGARA TIMUR",3,240,7,247
https://kawalpemilu.org#55180,"SILLU, FATULEU, KUPANG, NUSA TENGGARA TIMUR",4,241,5,246
https://kawalpemilu.org#55180,"SILLU, FATULEU, KUPANG, NUSA TENGGARA TIMUR",5,240,5,245
https://kawalpemilu.org#55180,"SILLU, FATULEU, KUPANG, NUSA TENGGARA TIMUR",6,220,10,230
https://kawalpemilu.org#55180,"SILLU, FATULEU, KUPANG, NUSA TENGGARA TIMUR",7,155,2,157
https://kawalpemilu.org#55180,"SILLU, FATULEU, KUPANG, NUSA TENGGARA TIMUR",8,182,5,187
https://kawalpemilu.org#55180,"SILLU, FATULEU, KUPANG, NUSA TENGGARA TIMUR",9,190,8,198
https://kawalpemilu.org#55181,"EKATETA, FATULEU, KUPANG, NUSA TENGGARA TIMUR",1,162,6,168
https://kawalpemilu.org#55181,"EKATETA, FATULEU, KUPANG, NUSA TENGGARA TIMUR",2,224,11,235
https://kawalpemilu.org#55181,"EKATETA, FATULEU, KUPANG, NUSA TENGGARA TIMUR",3,216,21,237
https://kawalpemilu.org#55181,"EKATETA, FATULEU, KUPANG, NUSA TENGGARA TIMUR",5,165,0,165
https://kawalpemilu.org#55182,"KUIMASI, FATULEU, KUPANG, NUSA TENGGARA TIMUR",1,121,18,139
https://kawalpemilu.org#55182,"KUIMASI, FATULEU, KUPANG, NUSA TENGGARA TIMUR",2,149,22,171
https://kawalpemilu.org#55182,"KUIMASI, FATULEU, KUPANG, NUSA TENGGARA TIMUR",3,174,44,218
https://kawalpemilu.org#55182,"KUIMASI, FATULEU, KUPANG, NUSA TENGGARA TIMUR",4,165,30,195
https://kawalpemilu.org#55182,"KUIMASI, FATULEU, KUPANG, NUSA TENGGARA TIMUR",5,83,18,101
https://kawalpemilu.org#55182,"KUIMASI, FATULEU, KUPANG, NUSA TENGGARA TIMUR",6,145,6,151
https://kawalpemilu.org#55182,"KUIMASI, FATULEU, KUPANG, NUSA TENGGARA TIMUR",7,110,7,117
https://kawalpemilu.org#55183,"TOLNAKU, FATULEU, KUPANG, NUSA TENGGARA TIMUR",1,159,18,177
https://kawalpemilu.org#55183,"TOLNAKU, FATULEU, KUPANG, NUSA TENGGARA TIMUR",2,114,37,151
https://kawalpemilu.org#55183,"TOLNAKU, FATULEU, KUPANG, NUSA TENGGARA TIMUR",3,186,9,195
https://kawalpemilu.org#55185,"OEBOLA DALAM, FATULEU, KUPANG, NUSA TENGGARA TIMUR",1,161,3,164
https://kawalpemilu.org#55185,"OEBOLA DALAM, FATULEU, KUPANG, NUSA TENGGARA TIMUR",3,153,3,156
https://kawalpemilu.org#92115,"KIUONI, FATULEU, KUPANG, NUSA TENGGARA TIMUR",1,137,28,165
https://kawalpemilu.org#92115,"KIUONI, FATULEU, KUPANG, NUSA TENGGARA TIMUR",2,138,10,148
https://kawalpemilu.org#92115,"KIUONI, FATULEU, KUPANG, NUSA TENGGARA TIMUR",3,105,8,113
https://kawalpemilu.org#92115,"KIUONI, FATULEU, KUPANG, NUSA TENGGARA TIMUR",4,130,15,145
https://kawalpemilu.org#55187,"TAKARI, TAKARI, KUPANG, NUSA TENGGARA TIMUR",1,203,4,207
https://kawalpemilu.org#55187,"TAKARI, TAKARI, KUPANG, NUSA TENGGARA TIMUR",2,173,32,205
https://kawalpemilu.org#55187,"TAKARI, TAKARI, KUPANG, NUSA TENGGARA TIMUR",3,108,58,166
https://kawalpemilu.org#55187,"TAKARI, TAKARI, KUPANG, NUSA TENGGARA TIMUR",4,109,59,168
https://kawalpemilu.org#55187,"TAKARI, TAKARI, KUPANG, NUSA TENGGARA TIMUR",8,171,14,185
https://kawalpemilu.org#55187,"TAKARI, TAKARI, KUPANG, NUSA TENGGARA TIMUR",9,170,26,196
https://kawalpemilu.org#55188,"NOELMINA, TAKARI, KUPANG, NUSA TENGGARA TIMUR",1,161,4,165
https://kawalpemilu.org#55188,"NOELMINA, TAKARI, KUPANG, NUSA TENGGARA TIMUR",2,146,3,149
https://kawalpemilu.org#55188,"NOELMINA, TAKARI, KUPANG, NUSA TENGGARA TIMUR",3,199,2,201
https://kawalpemilu.org#55188,"NOELMINA, TAKARI, KUPANG, NUSA TENGGARA TIMUR",4,128,6,134
https://kawalpemilu.org#55188,"NOELMINA, TAKARI, KUPANG, NUSA TENGGARA TIMUR",5,118,3,121
https://kawalpemilu.org#55188,"NOELMINA, TAKARI, KUPANG, NUSA TENGGARA TIMUR",6,126,0,126
https://kawalpemilu.org#55188,"NOELMINA, TAKARI, KUPANG, NUSA TENGGARA TIMUR",7,87,0,87
https://kawalpemilu.org#55189,"BENU, TAKARI, KUPANG, NUSA TENGGARA TIMUR",1,174,7,181
https://kawalpemilu.org#55189,"BENU, TAKARI, KUPANG, NUSA TENGGARA TIMUR",2,143,13,156
https://kawalpemilu.org#55189,"BENU, TAKARI, KUPANG, NUSA TENGGARA TIMUR",3,125,5,130
https://kawalpemilu.org#55189,"BENU, TAKARI, KUPANG, NUSA TENGGARA TIMUR",4,172,9,181
https://kawalpemilu.org#55189,"BENU, TAKARI, KUPANG, NUSA TENGGARA TIMUR",5,175,5,180
https://kawalpemilu.org#55189,"BENU, TAKARI, KUPANG, NUSA TENGGARA TIMUR",6,161,2,163
https://kawalpemilu.org#55189,"BENU, TAKARI, KUPANG, NUSA TENGGARA TIMUR",7,127,4,131
https://kawalpemilu.org#55190,"HUEKNUTU, TAKARI, KUPANG, NUSA TENGGARA TIMUR",1,134,1,135
https://kawalpemilu.org#55190,"HUEKNUTU, TAKARI, KUPANG, NUSA TENGGARA TIMUR",2,136,6,142
https://kawalpemilu.org#55190,"HUEKNUTU, TAKARI, KUPANG, NUSA TENGGARA TIMUR",3,206,14,220
https://kawalpemilu.org#55190,"HUEKNUTU, TAKARI, KUPANG, NUSA TENGGARA TIMUR",4,177,11,188
https://kawalpemilu.org#55190,"HUEKNUTU, TAKARI, KUPANG, NUSA TENGGARA TIMUR",6,63,4,67
https://kawalpemilu.org#55190,"HUEKNUTU, TAKARI, KUPANG, NUSA TENGGARA TIMUR",7,205,13,218
https://kawalpemilu.org#55191,"OELNAINENO, TAKARI, KUPANG, NUSA TENGGARA TIMUR",1,241,13,254
https://kawalpemilu.org#55191,"OELNAINENO, TAKARI, KUPANG, NUSA TENGGARA TIMUR",2,251,10,261
https://kawalpemilu.org#55191,"OELNAINENO, TAKARI, KUPANG, NUSA TENGGARA TIMUR",3,190,8,198
https://kawalpemilu.org#55191,"OELNAINENO, TAKARI, KUPANG, NUSA TENGGARA TIMUR",4,240,11,251
https://kawalpemilu.org#55191,"OELNAINENO, TAKARI, KUPANG, NUSA TENGGARA TIMUR",5,250,7,257
https://kawalpemilu.org#55191,"OELNAINENO, TAKARI, KUPANG, NUSA TENGGARA TIMUR",6,187,8,195
https://kawalpemilu.org#55192,"TANINI, TAKARI, KUPANG, NUSA TENGGARA TIMUR",1,199,14,213
https://kawalpemilu.org#55192,"TANINI, TAKARI, KUPANG, NUSA TENGGARA TIMUR",2,203,28,231
https://kawalpemilu.org#55192,"TANINI, TAKARI, KUPANG, NUSA TENGGARA TIMUR",3,157,7,164
https://kawalpemilu.org#55192,"TANINI, TAKARI, KUPANG, NUSA TENGGARA TIMUR",4,147,10,157
https://kawalpemilu.org#55192,"TANINI, TAKARI, KUPANG, NUSA TENGGARA TIMUR",5,219,17,236
https://kawalpemilu.org#55192,"TANINI, TAKARI, KUPANG, NUSA TENGGARA TIMUR",6,182,19,201
https://kawalpemilu.org#55193,"KAUNIKI, TAKARI, KUPANG, NUSA TENGGARA TIMUR",1,196,13,209
https://kawalpemilu.org#55193,"KAUNIKI, TAKARI, KUPANG, NUSA TENGGARA TIMUR",2,173,32,205
https://kawalpemilu.org#55193,"KAUNIKI, TAKARI, KUPANG, NUSA TENGGARA TIMUR",3,177,17,194
https://kawalpemilu.org#55193,"KAUNIKI, TAKARI, KUPANG, NUSA TENGGARA TIMUR",4,124,14,138
https://kawalpemilu.org#55193,"KAUNIKI, TAKARI, KUPANG, NUSA TENGGARA TIMUR",5,126,5,131
https://kawalpemilu.org#55193,"KAUNIKI, TAKARI, KUPANG, NUSA TENGGARA TIMUR",6,238,13,251
https://kawalpemilu.org#55193,"KAUNIKI, TAKARI, KUPANG, NUSA TENGGARA TIMUR",7,204,15,219
https://kawalpemilu.org#55194,"OESUSU, TAKARI, KUPANG, NUSA TENGGARA TIMUR",1,190,8,198
https://kawalpemilu.org#55194,"OESUSU, TAKARI, KUPANG, NUSA TENGGARA TIMUR",2,160,23,183
https://kawalpemilu.org#55194,"OESUSU, TAKARI, KUPANG, NUSA TENGGARA TIMUR",3,198,5,203
https://kawalpemilu.org#55194,"OESUSU, TAKARI, KUPANG, NUSA TENGGARA TIMUR",4,176,3,179
https://kawalpemilu.org#55194,"OESUSU, TAKARI, KUPANG, NUSA TENGGARA TIMUR",5,152,10,162
https://kawalpemilu.org#55195,"FATUKONA, TAKARI, KUPANG, NUSA TENGGARA TIMUR",1,158,5,163
https://kawalpemilu.org#55195,"FATUKONA, TAKARI, KUPANG, NUSA TENGGARA TIMUR",2,242,12,254
https://kawalpemilu.org#55195,"FATUKONA, TAKARI, KUPANG, NUSA TENGGARA TIMUR",3,168,8,176
https://kawalpemilu.org#55195,"FATUKONA, TAKARI, KUPANG, NUSA TENGGARA TIMUR",4,226,9,235
https://kawalpemilu.org#55196,"TUAPANAF, TAKARI, KUPANG, NUSA TENGGARA TIMUR",1,171,7,178
https://kawalpemilu.org#55196,"TUAPANAF, TAKARI, KUPANG, NUSA TENGGARA TIMUR",2,146,3,149
https://kawalpemilu.org#55196,"TUAPANAF, TAKARI, KUPANG, NUSA TENGGARA TIMUR",3,166,30,196
https://kawalpemilu.org#55196,"TUAPANAF, TAKARI, KUPANG, NUSA TENGGARA TIMUR",4,118,3,121
https://kawalpemilu.org#55196,"TUAPANAF, TAKARI, KUPANG, NUSA TENGGARA TIMUR",5,151,3,154
https://kawalpemilu.org#55196,"TUAPANAF, TAKARI, KUPANG, NUSA TENGGARA TIMUR",6,134,3,137
https://kawalpemilu.org#55198,"LELOGAMA, AMFOANG SELATAN, KUPANG, NUSA TENGGARA TIMUR",1,142,11,153
https://kawalpemilu.org#55198,"LELOGAMA, AMFOANG SELATAN, KUPANG, NUSA TENGGARA TIMUR",2,133,11,144
https://kawalpemilu.org#55198,"LELOGAMA, AMFOANG SELATAN, KUPANG, NUSA TENGGARA TIMUR",3,147,10,157
https://kawalpemilu.org#55198,"LELOGAMA, AMFOANG SELATAN, KUPANG, NUSA TENGGARA TIMUR",4,160,3,163
https://kawalpemilu.org#55198,"LELOGAMA, AMFOANG SELATAN, KUPANG, NUSA TENGGARA TIMUR",5,157,4,161
https://kawalpemilu.org#55198,"LELOGAMA, AMFOANG SELATAN, KUPANG, NUSA TENGGARA TIMUR",6,172,6,178
https://kawalpemilu.org#55198,"LELOGAMA, AMFOANG SELATAN, KUPANG, NUSA TENGGARA TIMUR",7,165,17,182
https://kawalpemilu.org#55199,"FATUSUKI, AMFOANG SELATAN, KUPANG, NUSA TENGGARA TIMUR",1,143,10,153
https://kawalpemilu.org#55199,"FATUSUKI, AMFOANG SELATAN, KUPANG, NUSA TENGGARA TIMUR",2,151,7,158
https://kawalpemilu.org#55200,"OELBANU, AMFOANG SELATAN, KUPANG, NUSA TENGGARA TIMUR",1,170,1,171
https://kawalpemilu.org#55200,"OELBANU, AMFOANG SELATAN, KUPANG, NUSA TENGGARA TIMUR",2,145,6,151
https://kawalpemilu.org#55200,"OELBANU, AMFOANG SELATAN, KUPANG, NUSA TENGGARA TIMUR",3,143,6,149
https://kawalpemilu.org#55200,"OELBANU, AMFOANG SELATAN, KUPANG, NUSA TENGGARA TIMUR",4,147,7,154
https://kawalpemilu.org#55200,"OELBANU, AMFOANG SELATAN, KUPANG, NUSA TENGGARA TIMUR",5,136,5,141
https://kawalpemilu.org#55201,"FATUMETAN, AMFOANG SELATAN, KUPANG, NUSA TENGGARA TIMUR",1,154,8,162
https://kawalpemilu.org#55201,"FATUMETAN, AMFOANG SELATAN, KUPANG, NUSA TENGGARA TIMUR",2,154,9,163
https://kawalpemilu.org#55202,"OH'AEM, AMFOANG SELATAN, KUPANG, NUSA TENGGARA TIMUR",1,163,8,171
https://kawalpemilu.org#55202,"OH'AEM, AMFOANG SELATAN, KUPANG, NUSA TENGGARA TIMUR",2,169,6,175
https://kawalpemilu.org#55202,"OH'AEM, AMFOANG SELATAN, KUPANG, NUSA TENGGARA TIMUR",3,148,6,154
https://kawalpemilu.org#55202,"OH'AEM, AMFOANG SELATAN, KUPANG, NUSA TENGGARA TIMUR",4,129,8,137
https://kawalpemilu.org#55202,"OH'AEM, AMFOANG SELATAN, KUPANG, NUSA TENGGARA TIMUR",5,140,11,151
https://kawalpemilu.org#55202,"OH'AEM, AMFOANG SELATAN, KUPANG, NUSA TENGGARA TIMUR",6,114,11,125
https://kawalpemilu.org#55202,"OH'AEM, AMFOANG SELATAN, KUPANG, NUSA TENGGARA TIMUR",7,112,9,121
https://kawalpemilu.org#55205,"LELOBOKO, AMFOANG SELATAN, KUPANG, NUSA TENGGARA TIMUR",1,148,7,155
https://kawalpemilu.org#55205,"LELOBOKO, AMFOANG SELATAN, KUPANG, NUSA TENGGARA TIMUR",2,162,6,168
https://kawalpemilu.org#55205,"LELOBOKO, AMFOANG SELATAN, KUPANG, NUSA TENGGARA TIMUR",3,147,4,151
https://kawalpemilu.org#55205,"LELOBOKO, AMFOANG SELATAN, KUPANG, NUSA TENGGARA TIMUR",4,147,8,155
https://kawalpemilu.org#55208,"OH'AEM II, AMFOANG SELATAN, KUPANG, NUSA TENGGARA TIMUR",1,138,15,153
https://kawalpemilu.org#55208,"OH'AEM II, AMFOANG SELATAN, KUPANG, NUSA TENGGARA TIMUR",2,125,20,145
https://kawalpemilu.org#55208,"OH'AEM II, AMFOANG SELATAN, KUPANG, NUSA TENGGARA TIMUR",3,139,14,153
https://kawalpemilu.org#55210,"NAIKLIU, AMFOANG UTARA, KUPANG, NUSA TENGGARA TIMUR",1,157,25,182
https://kawalpemilu.org#55210,"NAIKLIU, AMFOANG UTARA, KUPANG, NUSA TENGGARA TIMUR",2,135,19,154
https://kawalpemilu.org#55210,"NAIKLIU, AMFOANG UTARA, KUPANG, NUSA TENGGARA TIMUR",3,107,11,118
https://kawalpemilu.org#55210,"NAIKLIU, AMFOANG UTARA, KUPANG, NUSA TENGGARA TIMUR",4,150,2,152
https://kawalpemilu.org#55210,"NAIKLIU, AMFOANG UTARA, KUPANG, NUSA TENGGARA TIMUR",5,111,2,113
https://kawalpemilu.org#55211,"AFOAN, AMFOANG UTARA, KUPANG, NUSA TENGGARA TIMUR",1,179,10,189
https://kawalpemilu.org#55211,"AFOAN, AMFOANG UTARA, KUPANG, NUSA TENGGARA TIMUR",2,185,13,198
https://kawalpemilu.org#55211,"AFOAN, AMFOANG UTARA, KUPANG, NUSA TENGGARA TIMUR",3,176,14,190
https://kawalpemilu.org#55212,"FATUNAUS, AMFOANG UTARA, KUPANG, NUSA TENGGARA TIMUR",1,101,20,121
https://kawalpemilu.org#55212,"FATUNAUS, AMFOANG UTARA, KUPANG, NUSA TENGGARA TIMUR",2,120,6,126
https://kawalpemilu.org#55212,"FATUNAUS, AMFOANG UTARA, KUPANG, NUSA TENGGARA TIMUR",3,100,29,129
https://kawalpemilu.org#55212,"FATUNAUS, AMFOANG UTARA, KUPANG, NUSA TENGGARA TIMUR",4,105,10,115
https://kawalpemilu.org#55212,"FATUNAUS, AMFOANG UTARA, KUPANG, NUSA TENGGARA TIMUR",5,90,8,98
https://kawalpemilu.org#55212,"FATUNAUS, AMFOANG UTARA, KUPANG, NUSA TENGGARA TIMUR",6,111,11,122
https://kawalpemilu.org#55213,"KOLABE, AMFOANG UTARA, KUPANG, NUSA TENGGARA TIMUR",1,183,13,196
https://kawalpemilu.org#55213,"KOLABE, AMFOANG UTARA, KUPANG, NUSA TENGGARA TIMUR",2,175,6,181
https://kawalpemilu.org#55213,"KOLABE, AMFOANG UTARA, KUPANG, NUSA TENGGARA TIMUR",3,185,10,195
https://kawalpemilu.org#55213,"KOLABE, AMFOANG UTARA, KUPANG, NUSA TENGGARA TIMUR",4,87,4,91
https://kawalpemilu.org#55214,"BAKUIN, AMFOANG UTARA, KUPANG, NUSA TENGGARA TIMUR",1,161,13,174
https://kawalpemilu.org#55214,"BAKUIN, AMFOANG UTARA, KUPANG, NUSA TENGGARA TIMUR",2,158,14,172
https://kawalpemilu.org#55214,"BAKUIN, AMFOANG UTARA, KUPANG, NUSA TENGGARA TIMUR",3,194,14,208
https://kawalpemilu.org#55219,"LILMUS, AMFOANG UTARA, KUPANG, NUSA TENGGARA TIMUR",1,183,12,195
https://kawalpemilu.org#55219,"LILMUS, AMFOANG UTARA, KUPANG, NUSA TENGGARA TIMUR",2,164,16,180
https://kawalpemilu.org#55238,"OELOMIN, NEKAMESE, KUPANG, NUSA TENGGARA TIMUR",1,234,12,246
https://kawalpemilu.org#55238,"OELOMIN, NEKAMESE, KUPANG, NUSA TENGGARA TIMUR",2,202,3,205
https://kawalpemilu.org#55238,"OELOMIN, NEKAMESE, KUPANG, NUSA TENGGARA TIMUR",3,203,14,217
https://kawalpemilu.org#55238,"OELOMIN, NEKAMESE, KUPANG, NUSA TENGGARA TIMUR",4,207,8,215
https://kawalpemilu.org#55239,"TASIKONA, NEKAMESE, KUPANG, NUSA TENGGARA TIMUR",1,133,4,137
https://kawalpemilu.org#55239,"TASIKONA, NEKAMESE, KUPANG, NUSA TENGGARA TIMUR",2,82,1,83
https://kawalpemilu.org#55240,"OEMASI, NEKAMESE, KUPANG, NUSA TENGGARA TIMUR",1,194,7,201
https://kawalpemilu.org#55240,"OEMASI, NEKAMESE, KUPANG, NUSA TENGGARA TIMUR",2,187,6,193
https://kawalpemilu.org#55240,"OEMASI, NEKAMESE, KUPANG, NUSA TENGGARA TIMUR",3,184,27,211
https://kawalpemilu.org#55241,"USAPI SONBAI, NEKAMESE, KUPANG, NUSA TENGGARA TIMUR",1,213,10,223
https://kawalpemilu.org#55241,"USAPI SONBAI, NEKAMESE, KUPANG, NUSA TENGGARA TIMUR",2,204,12,216
https://kawalpemilu.org#55242,"OENIF, NEKAMESE, KUPANG, NUSA TENGGARA TIMUR",1,218,8,226
https://kawalpemilu.org#55242,"OENIF, NEKAMESE, KUPANG, NUSA TENGGARA TIMUR",2,159,15,174
https://kawalpemilu.org#55243,"TUNFEU, NEKAMESE, KUPANG, NUSA TENGGARA TIMUR",1,223,18,241
https://kawalpemilu.org#55243,"TUNFEU, NEKAMESE, KUPANG, NUSA TENGGARA TIMUR",2,184,22,206
https://kawalpemilu.org#55243,"TUNFEU, NEKAMESE, KUPANG, NUSA TENGGARA TIMUR",3,157,2,159
https://kawalpemilu.org#55243,"TUNFEU, NEKAMESE, KUPANG, NUSA TENGGARA TIMUR",4,123,28,151
https://kawalpemilu.org#55243,"TUNFEU, NEKAMESE, KUPANG, NUSA TENGGARA TIMUR",5,168,11,179
https://kawalpemilu.org#55244,"OEPAHA, NEKAMESE, KUPANG, NUSA TENGGARA TIMUR",1,184,20,204
https://kawalpemilu.org#55244,"OEPAHA, NEKAMESE, KUPANG, NUSA TENGGARA TIMUR",2,89,2,91
https://kawalpemilu.org#55245,"BONE, NEKAMESE, KUPANG, NUSA TENGGARA TIMUR",1,150,3,153
https://kawalpemilu.org#55245,"BONE, NEKAMESE, KUPANG, NUSA TENGGARA TIMUR",2,159,3,162
https://kawalpemilu.org#55245,"BONE, NEKAMESE, KUPANG, NUSA TENGGARA TIMUR",3,155,7,162
https://kawalpemilu.org#55245,"BONE, NEKAMESE, KUPANG, NUSA TENGGARA TIMUR",4,186,3,189
https://kawalpemilu.org#55246,"TALOETAN, NEKAMESE, KUPANG, NUSA TENGGARA TIMUR",1,214,4,218
https://kawalpemilu.org#55246,"TALOETAN, NEKAMESE, KUPANG, NUSA TENGGARA TIMUR",2,100,1,101
https://kawalpemilu.org#55246,"TALOETAN, NEKAMESE, KUPANG, NUSA TENGGARA TIMUR",3,168,1,169
https://kawalpemilu.org#55247,"OBEN, NEKAMESE, KUPANG, NUSA TENGGARA TIMUR",1,205,4,209
https://kawalpemilu.org#55247,"OBEN, NEKAMESE, KUPANG, NUSA TENGGARA TIMUR",2,189,11,200
https://kawalpemilu.org#55247,"OBEN, NEKAMESE, KUPANG, NUSA TENGGARA TIMUR",3,198,2,200
https://kawalpemilu.org#55247,"OBEN, NEKAMESE, KUPANG, NUSA TENGGARA TIMUR",4,180,8,188
https://kawalpemilu.org#55248,"BISMARAK, NEKAMESE, KUPANG, NUSA TENGGARA TIMUR",1,167,8,175
https://kawalpemilu.org#55248,"BISMARAK, NEKAMESE, KUPANG, NUSA TENGGARA TIMUR",2,156,6,162
https://kawalpemilu.org#55248,"BISMARAK, NEKAMESE, KUPANG, NUSA TENGGARA TIMUR",3,159,11,170
https://kawalpemilu.org#55251,"TEUNBAUN, AMARASI BARAT, KUPANG, NUSA TENGGARA TIMUR",1,170,29,199
https://kawalpemilu.org#55251,"TEUNBAUN, AMARASI BARAT, KUPANG, NUSA TENGGARA TIMUR",2,206,22,228
https://kawalpemilu.org#55251,"TEUNBAUN, AMARASI BARAT, KUPANG, NUSA TENGGARA TIMUR",3,195,34,229
https://kawalpemilu.org#55251,"TEUNBAUN, AMARASI BARAT, KUPANG, NUSA TENGGARA TIMUR",4,181,23,204
https://kawalpemilu.org#55251,"TEUNBAUN, AMARASI BARAT, KUPANG, NUSA TENGGARA TIMUR",5,203,10,213
https://kawalpemilu.org#55251,"TEUNBAUN, AMARASI BARAT, KUPANG, NUSA TENGGARA TIMUR",6,182,15,197
https://kawalpemilu.org#55252,"SOBA, AMARASI BARAT, KUPANG, NUSA TENGGARA TIMUR",1,171,6,177
https://kawalpemilu.org#55252,"SOBA, AMARASI BARAT, KUPANG, NUSA TENGGARA TIMUR",2,170,15,185
https://kawalpemilu.org#55252,"SOBA, AMARASI BARAT, KUPANG, NUSA TENGGARA TIMUR",3,178,14,192
https://kawalpemilu.org#55252,"SOBA, AMARASI BARAT, KUPANG, NUSA TENGGARA TIMUR",4,164,10,174
https://kawalpemilu.org#55252,"SOBA, AMARASI BARAT, KUPANG, NUSA TENGGARA TIMUR",5,163,8,171
https://kawalpemilu.org#55253,"TOOBAUN, AMARASI BARAT, KUPANG, NUSA TENGGARA TIMUR",1,174,15,189
https://kawalpemilu.org#55253,"TOOBAUN, AMARASI BARAT, KUPANG, NUSA TENGGARA TIMUR",2,190,11,201
https://kawalpemilu.org#55253,"TOOBAUN, AMARASI BARAT, KUPANG, NUSA TENGGARA TIMUR",3,155,8,163
https://kawalpemilu.org#55253,"TOOBAUN, AMARASI BARAT, KUPANG, NUSA TENGGARA TIMUR",4,187,7,194
https://kawalpemilu.org#55253,"TOOBAUN, AMARASI BARAT, KUPANG, NUSA TENGGARA TIMUR",5,155,7,162
https://kawalpemilu.org#55254,"NIUKBAUN, AMARASI BARAT, KUPANG, NUSA TENGGARA TIMUR",1,183,13,196
https://kawalpemilu.org#55254,"NIUKBAUN, AMARASI BARAT, KUPANG, NUSA TENGGARA TIMUR",2,180,14,194
https://kawalpemilu.org#55254,"NIUKBAUN, AMARASI BARAT, KUPANG, NUSA TENGGARA TIMUR",3,193,18,211
https://kawalpemilu.org#55254,"NIUKBAUN, AMARASI BARAT, KUPANG, NUSA TENGGARA TIMUR",4,185,7,192
https://kawalpemilu.org#55255,"TUNBAUN, AMARASI BARAT, KUPANG, NUSA TENGGARA TIMUR",1,201,24,225
https://kawalpemilu.org#55255,"TUNBAUN, AMARASI BARAT, KUPANG, NUSA TENGGARA TIMUR",2,225,38,263
https://kawalpemilu.org#55255,"TUNBAUN, AMARASI BARAT, KUPANG, NUSA TENGGARA TIMUR",3,219,19,238
https://kawalpemilu.org#55255,"TUNBAUN, AMARASI BARAT, KUPANG, NUSA TENGGARA TIMUR",4,221,16,237
https://kawalpemilu.org#55255,"TUNBAUN, AMARASI BARAT, KUPANG, NUSA TENGGARA TIMUR",5,186,13,199
https://kawalpemilu.org#55255,"TUNBAUN, AMARASI BARAT, KUPANG, NUSA TENGGARA TIMUR",6,212,7,219
https://kawalpemilu.org#55255,"TUNBAUN, AMARASI BARAT, KUPANG, NUSA TENGGARA TIMUR",7,212,22,234
https://kawalpemilu.org#55256,"NEKBAUN, AMARASI BARAT, KUPANG, NUSA TENGGARA TIMUR",1,182,18,200
https://kawalpemilu.org#55256,"NEKBAUN, AMARASI BARAT, KUPANG, NUSA TENGGARA TIMUR",2,188,14,202
https://kawalpemilu.org#55256,"NEKBAUN, AMARASI BARAT, KUPANG, NUSA TENGGARA TIMUR",3,197,6,203
https://kawalpemilu.org#55256,"NEKBAUN, AMARASI BARAT, KUPANG, NUSA TENGGARA TIMUR",4,180,14,194
https://kawalpemilu.org#55256,"NEKBAUN, AMARASI BARAT, KUPANG, NUSA TENGGARA TIMUR",5,188,6,194
https://kawalpemilu.org#55257,"MERBAUN, AMARASI BARAT, KUPANG, NUSA TENGGARA TIMUR",1,238,8,246
https://kawalpemilu.org#55257,"MERBAUN, AMARASI BARAT, KUPANG, NUSA TENGGARA TIMUR",2,235,10,245
https://kawalpemilu.org#55257,"MERBAUN, AMARASI BARAT, KUPANG, NUSA TENGGARA TIMUR",3,256,7,263
https://kawalpemilu.org#55257,"MERBAUN, AMARASI BARAT, KUPANG, NUSA TENGGARA TIMUR",4,261,9,270
https://kawalpemilu.org#55257,"MERBAUN, AMARASI BARAT, KUPANG, NUSA TENGGARA TIMUR",5,229,16,245
https://kawalpemilu.org#55258,"ERBAUN, AMARASI BARAT, KUPANG, NUSA TENGGARA TIMUR",1,216,8,224
https://kawalpemilu.org#55258,"ERBAUN, AMARASI BARAT, KUPANG, NUSA TENGGARA TIMUR",2,227,7,234
https://kawalpemilu.org#55258,"ERBAUN, AMARASI BARAT, KUPANG, NUSA TENGGARA TIMUR",3,208,8,216
https://kawalpemilu.org#55258,"ERBAUN, AMARASI BARAT, KUPANG, NUSA TENGGARA TIMUR",4,177,17,194
https://kawalpemilu.org#55260,"BURAEN, AMARASI SELATAN, KUPANG, NUSA TENGGARA TIMUR",1,228,4,232
https://kawalpemilu.org#55260,"BURAEN, AMARASI SELATAN, KUPANG, NUSA TENGGARA TIMUR",2,205,5,210
https://kawalpemilu.org#55260,"BURAEN, AMARASI SELATAN, KUPANG, NUSA TENGGARA TIMUR",3,175,14,189
https://kawalpemilu.org#55260,"BURAEN, AMARASI SELATAN, KUPANG, NUSA TENGGARA TIMUR",4,194,2,196
https://kawalpemilu.org#55260,"BURAEN, AMARASI SELATAN, KUPANG, NUSA TENGGARA TIMUR",5,169,3,172
https://kawalpemilu.org#55260,"BURAEN, AMARASI SELATAN, KUPANG, NUSA TENGGARA TIMUR",6,194,7,201
https://kawalpemilu.org#55260,"BURAEN, AMARASI SELATAN, KUPANG, NUSA TENGGARA TIMUR",7,209,3,212
https://kawalpemilu.org#55260,"BURAEN, AMARASI SELATAN, KUPANG, NUSA TENGGARA TIMUR",8,166,16,182
https://kawalpemilu.org#55261,"SONRAEN, AMARASI SELATAN, KUPANG, NUSA TENGGARA TIMUR",1,188,3,191
https://kawalpemilu.org#55261,"SONRAEN, AMARASI SELATAN, KUPANG, NUSA TENGGARA TIMUR",2,177,8,185
https://kawalpemilu.org#55261,"SONRAEN, AMARASI SELATAN, KUPANG, NUSA TENGGARA TIMUR",4,191,11,202
https://kawalpemilu.org#55261,"SONRAEN, AMARASI SELATAN, KUPANG, NUSA TENGGARA TIMUR",5,150,7,157
https://kawalpemilu.org#55261,"SONRAEN, AMARASI SELATAN, KUPANG, NUSA TENGGARA TIMUR",6,158,4,162
https://kawalpemilu.org#55262,"NEKMESE, AMARASI SELATAN, KUPANG, NUSA TENGGARA TIMUR",1,243,1,244
https://kawalpemilu.org#55262,"NEKMESE, AMARASI SELATAN, KUPANG, NUSA TENGGARA TIMUR",2,247,4,251
https://kawalpemilu.org#55262,"NEKMESE, AMARASI SELATAN, KUPANG, NUSA TENGGARA TIMUR",3,237,8,245
https://kawalpemilu.org#55262,"NEKMESE, AMARASI SELATAN, KUPANG, NUSA TENGGARA TIMUR",4,234,7,241
https://kawalpemilu.org#55262,"NEKMESE, AMARASI SELATAN, KUPANG, NUSA TENGGARA TIMUR",5,228,12,240
https://kawalpemilu.org#55263,"RETRAEN, AMARASI SELATAN, KUPANG, NUSA TENGGARA TIMUR",1,199,5,204
https://kawalpemilu.org#55263,"RETRAEN, AMARASI SELATAN, KUPANG, NUSA TENGGARA TIMUR",2,185,18,203
https://kawalpemilu.org#55263,"RETRAEN, AMARASI SELATAN, KUPANG, NUSA TENGGARA TIMUR",3,182,10,192
https://kawalpemilu.org#55263,"RETRAEN, AMARASI SELATAN, KUPANG, NUSA TENGGARA TIMUR",4,186,3,189
https://kawalpemilu.org#55263,"RETRAEN, AMARASI SELATAN, KUPANG, NUSA TENGGARA TIMUR",5,179,14,193
https://kawalpemilu.org#55263,"RETRAEN, AMARASI SELATAN, KUPANG, NUSA TENGGARA TIMUR",6,90,1,91
https://kawalpemilu.org#55264,"SAHRAEN, AMARASI SELATAN, KUPANG, NUSA TENGGARA TIMUR",1,226,22,248
https://kawalpemilu.org#55264,"SAHRAEN, AMARASI SELATAN, KUPANG, NUSA TENGGARA TIMUR",2,219,14,233
https://kawalpemilu.org#55264,"SAHRAEN, AMARASI SELATAN, KUPANG, NUSA TENGGARA TIMUR",3,230,18,248
https://kawalpemilu.org#55264,"SAHRAEN, AMARASI SELATAN, KUPANG, NUSA TENGGARA TIMUR",4,194,25,219
https://kawalpemilu.org#55264,"SAHRAEN, AMARASI SELATAN, KUPANG, NUSA TENGGARA TIMUR",5,203,19,222
https://kawalpemilu.org#55266,"OEBESI, AMARASI TIMUR, KUPANG, NUSA TENGGARA TIMUR",1,110,19,129
https://kawalpemilu.org#55266,"OEBESI, AMARASI TIMUR, KUPANG, NUSA TENGGARA TIMUR",2,113,21,134
https://kawalpemilu.org#55266,"OEBESI, AMARASI TIMUR, KUPANG, NUSA TENGGARA TIMUR",4,185,19,204
https://kawalpemilu.org#55266,"OEBESI, AMARASI TIMUR, KUPANG, NUSA TENGGARA TIMUR",5,197,21,218
https://kawalpemilu.org#55266,"OEBESI, AMARASI TIMUR, KUPANG, NUSA TENGGARA TIMUR",6,137,5,142
https://kawalpemilu.org#55266,"OEBESI, AMARASI TIMUR, KUPANG, NUSA TENGGARA TIMUR",7,114,3,117
https://kawalpemilu.org#55267,"PAKUBAUN, AMARASI TIMUR, KUPANG, NUSA TENGGARA TIMUR",1,136,7,143
https://kawalpemilu.org#55267,"PAKUBAUN, AMARASI TIMUR, KUPANG, NUSA TENGGARA TIMUR",2,147,8,155
https://kawalpemilu.org#55267,"PAKUBAUN, AMARASI TIMUR, KUPANG, NUSA TENGGARA TIMUR",3,188,7,195
https://kawalpemilu.org#55267,"PAKUBAUN, AMARASI TIMUR, KUPANG, NUSA TENGGARA TIMUR",4,143,15,158
https://kawalpemilu.org#55267,"PAKUBAUN, AMARASI TIMUR, KUPANG, NUSA TENGGARA TIMUR",5,147,8,150
https://kawalpemilu.org#55267,"PAKUBAUN, AMARASI TIMUR, KUPANG, NUSA TENGGARA TIMUR",6,179,11,190
https://kawalpemilu.org#55267,"PAKUBAUN, AMARASI TIMUR, KUPANG, NUSA TENGGARA TIMUR",7,203,11,214
https://kawalpemilu.org#55268,"RABEKA, AMARASI TIMUR, KUPANG, NUSA TENGGARA TIMUR",1,148,10,158
https://kawalpemilu.org#55268,"RABEKA, AMARASI TIMUR, KUPANG, NUSA TENGGARA TIMUR",2,194,8,202
https://kawalpemilu.org#55268,"RABEKA, AMARASI TIMUR, KUPANG, NUSA TENGGARA TIMUR",3,187,22,209
https://kawalpemilu.org#55268,"RABEKA, AMARASI TIMUR, KUPANG, NUSA TENGGARA TIMUR",4,129,4,133
https://kawalpemilu.org#55268,"RABEKA, AMARASI TIMUR, KUPANG, NUSA TENGGARA TIMUR",5,115,1,116
https://kawalpemilu.org#55269,"ENORAEN, AMARASI TIMUR, KUPANG, NUSA TENGGARA TIMUR",1,194,5,199
https://kawalpemilu.org#55269,"ENORAEN, AMARASI TIMUR, KUPANG, NUSA TENGGARA TIMUR",2,141,8,149
https://kawalpemilu.org#55269,"ENORAEN, AMARASI TIMUR, KUPANG, NUSA TENGGARA TIMUR",3,177,3,180
https://kawalpemilu.org#55269,"ENORAEN, AMARASI TIMUR, KUPANG, NUSA TENGGARA TIMUR",4,141,5,146
https://kawalpemilu.org#55269,"ENORAEN, AMARASI TIMUR, KUPANG, NUSA TENGGARA TIMUR",5,148,3,151
https://kawalpemilu.org#55271,"SEKI, AMABI OEFETO TIMUR, KUPANG, NUSA TENGGARA TIMUR",1,194,4,198
https://kawalpemilu.org#55271,"SEKI, AMABI OEFETO TIMUR, KUPANG, NUSA TENGGARA TIMUR",2,205,7,212
https://kawalpemilu.org#55272,"OEMOFA, AMABI OEFETO TIMUR, KUPANG, NUSA TENGGARA TIMUR",1,182,13,195
https://kawalpemilu.org#55272,"OEMOFA, AMABI OEFETO TIMUR, KUPANG, NUSA TENGGARA TIMUR",2,178,16,194
https://kawalpemilu.org#55272,"OEMOFA, AMABI OEFETO TIMUR, KUPANG, NUSA TENGGARA TIMUR",3,206,16,222
https://kawalpemilu.org#55272,"OEMOFA, AMABI OEFETO TIMUR, KUPANG, NUSA TENGGARA TIMUR",4,209,11,220
https://kawalpemilu.org#55272,"OEMOFA, AMABI OEFETO TIMUR, KUPANG, NUSA TENGGARA TIMUR",5,191,13,204
https://kawalpemilu.org#55272,"OEMOFA, AMABI OEFETO TIMUR, KUPANG, NUSA TENGGARA TIMUR",6,92,2,94
https://kawalpemilu.org#55273,"NUNMAFO, AMABI OEFETO TIMUR, KUPANG, NUSA TENGGARA TIMUR",1,206,5,211
https://kawalpemilu.org#55273,"NUNMAFO, AMABI OEFETO TIMUR, KUPANG, NUSA TENGGARA TIMUR",2,199,11,210
https://kawalpemilu.org#55273,"NUNMAFO, AMABI OEFETO TIMUR, KUPANG, NUSA TENGGARA TIMUR",3,205,8,213
https://kawalpemilu.org#55273,"NUNMAFO, AMABI OEFETO TIMUR, KUPANG, NUSA TENGGARA TIMUR",4,172,11,183
https://kawalpemilu.org#55273,"NUNMAFO, AMABI OEFETO TIMUR, KUPANG, NUSA TENGGARA TIMUR",5,171,8,179
https://kawalpemilu.org#55274,"MUKE, AMABI OEFETO TIMUR, KUPANG, NUSA TENGGARA TIMUR",1,179,8,187
https://kawalpemilu.org#55274,"MUKE, AMABI OEFETO TIMUR, KUPANG, NUSA TENGGARA TIMUR",2,185,13,198
https://kawalpemilu.org#55274,"MUKE, AMABI OEFETO TIMUR, KUPANG, NUSA TENGGARA TIMUR",3,199,17,216
https://kawalpemilu.org#55274,"MUKE, AMABI OEFETO TIMUR, KUPANG, NUSA TENGGARA TIMUR",4,213,17,230
https://kawalpemilu.org#55275,"PATHAU, AMABI OEFETO TIMUR, KUPANG, NUSA TENGGARA TIMUR",1,235,11,246
https://kawalpemilu.org#55275,"PATHAU, AMABI OEFETO TIMUR, KUPANG, NUSA TENGGARA TIMUR",2,183,6,189
https://kawalpemilu.org#55275,"PATHAU, AMABI OEFETO TIMUR, KUPANG, NUSA TENGGARA TIMUR",3,164,4,168
https://kawalpemilu.org#55275,"PATHAU, AMABI OEFETO TIMUR, KUPANG, NUSA TENGGARA TIMUR",4,144,0,144
https://kawalpemilu.org#55276,"OENIKO, AMABI OEFETO TIMUR, KUPANG, NUSA TENGGARA TIMUR",1,150,1,151
https://kawalpemilu.org#55276,"OENIKO, AMABI OEFETO TIMUR, KUPANG, NUSA TENGGARA TIMUR",2,147,1,148
https://kawalpemilu.org#55276,"OENIKO, AMABI OEFETO TIMUR, KUPANG, NUSA TENGGARA TIMUR",3,178,5,183
https://kawalpemilu.org#55277,"OENUNTONO, AMABI OEFETO TIMUR, KUPANG, NUSA TENGGARA TIMUR",1,215,14,229
https://kawalpemilu.org#55277,"OENUNTONO, AMABI OEFETO TIMUR, KUPANG, NUSA TENGGARA TIMUR",2,176,7,183
https://kawalpemilu.org#55277,"OENUNTONO, AMABI OEFETO TIMUR, KUPANG, NUSA TENGGARA TIMUR",3,205,17,222
https://kawalpemilu.org#55277,"OENUNTONO, AMABI OEFETO TIMUR, KUPANG, NUSA TENGGARA TIMUR",4,60,3,63
https://kawalpemilu.org#55278,"OEMOLO, AMABI OEFETO TIMUR, KUPANG, NUSA TENGGARA TIMUR",1,217,12,229
https://kawalpemilu.org#55278,"OEMOLO, AMABI OEFETO TIMUR, KUPANG, NUSA TENGGARA TIMUR",2,227,5,232
https://kawalpemilu.org#55278,"OEMOLO, AMABI OEFETO TIMUR, KUPANG, NUSA TENGGARA TIMUR",3,200,10,210
https://kawalpemilu.org#55279,"ENOLANAN, AMABI OEFETO TIMUR, KUPANG, NUSA TENGGARA TIMUR",1,192,11,203
https://kawalpemilu.org#55279,"ENOLANAN, AMABI OEFETO TIMUR, KUPANG, NUSA TENGGARA TIMUR",2,208,7,215
https://kawalpemilu.org#55279,"ENOLANAN, AMABI OEFETO TIMUR, KUPANG, NUSA TENGGARA TIMUR",3,140,3,143
https://kawalpemilu.org#55280,"OENAUNU, AMABI OEFETO TIMUR, KUPANG, NUSA TENGGARA TIMUR",1,206,3,209
https://kawalpemilu.org#55280,"OENAUNU, AMABI OEFETO TIMUR, KUPANG, NUSA TENGGARA TIMUR",2,135,7,142
https://kawalpemilu.org#55280,"OENAUNU, AMABI OEFETO TIMUR, KUPANG, NUSA TENGGARA TIMUR",3,95,7,102
https://kawalpemilu.org#55282,"MANUBELON, AMFOANG BARAT DAYA, KUPANG, NUSA TENGGARA TIMUR",1,174,7,181
https://kawalpemilu.org#55282,"MANUBELON, AMFOANG BARAT DAYA, KUPANG, NUSA TENGGARA TIMUR",2,205,14,219
https://kawalpemilu.org#55282,"MANUBELON, AMFOANG BARAT DAYA, KUPANG, NUSA TENGGARA TIMUR",3,227,14,241
https://kawalpemilu.org#55282,"MANUBELON, AMFOANG BARAT DAYA, KUPANG, NUSA TENGGARA TIMUR",4,235,9,244
https://kawalpemilu.org#55282,"MANUBELON, AMFOANG BARAT DAYA, KUPANG, NUSA TENGGARA TIMUR",6,99,7,106
https://kawalpemilu.org#55282,"MANUBELON, AMFOANG BARAT DAYA, KUPANG, NUSA TENGGARA TIMUR",7,151,32,183
https://kawalpemilu.org#55283,"LETKOLE, AMFOANG BARAT DAYA, KUPANG, NUSA TENGGARA TIMUR",1,187,18,205
https://kawalpemilu.org#55283,"LETKOLE, AMFOANG BARAT DAYA, KUPANG, NUSA TENGGARA TIMUR",2,109,10,119
https://kawalpemilu.org#55283,"LETKOLE, AMFOANG BARAT DAYA, KUPANG, NUSA TENGGARA TIMUR",3,81,2,83
https://kawalpemilu.org#55284,"NEFONEUT, AMFOANG BARAT DAYA, KUPANG, NUSA TENGGARA TIMUR",1,138,11,149
https://kawalpemilu.org#55284,"NEFONEUT, AMFOANG BARAT DAYA, KUPANG, NUSA TENGGARA TIMUR",2,154,13,167
https://kawalpemilu.org#55285,"BIOBA BARU, AMFOANG BARAT DAYA, KUPANG, NUSA TENGGARA TIMUR",1,173,18,191
https://kawalpemilu.org#55285,"BIOBA BARU, AMFOANG BARAT DAYA, KUPANG, NUSA TENGGARA TIMUR",2,199,14,213
https://kawalpemilu.org#55287,"SOLIU, AMFOANG BARAT LAUT, KUPANG, NUSA TENGGARA TIMUR",1,178,5,183
https://kawalpemilu.org#55287,"SOLIU, AMFOANG BARAT LAUT, KUPANG, NUSA TENGGARA TIMUR",2,157,1,158
https://kawalpemilu.org#55287,"SOLIU, AMFOANG BARAT LAUT, KUPANG, NUSA TENGGARA TIMUR",3,185,9,194
https://kawalpemilu.org#55287,"SOLIU, AMFOANG BARAT LAUT, KUPANG, NUSA TENGGARA TIMUR",4,161,15,176
https://kawalpemilu.org#55288,"SAUKIBE, AMFOANG BARAT LAUT, KUPANG, NUSA TENGGARA TIMUR",1,214,19,233
https://kawalpemilu.org#55288,"SAUKIBE, AMFOANG BARAT LAUT, KUPANG, NUSA TENGGARA TIMUR",2,205,17,222
https://kawalpemilu.org#55288,"SAUKIBE, AMFOANG BARAT LAUT, KUPANG, NUSA TENGGARA TIMUR",3,207,21,228
https://kawalpemilu.org#55288,"SAUKIBE, AMFOANG BARAT LAUT, KUPANG, NUSA TENGGARA TIMUR",4,219,15,234
https://kawalpemilu.org#55289,"OELFATU, AMFOANG BARAT LAUT, KUPANG, NUSA TENGGARA TIMUR",1,209,12,221
https://kawalpemilu.org#55289,"OELFATU, AMFOANG BARAT LAUT, KUPANG, NUSA TENGGARA TIMUR",2,205,23,228
https://kawalpemilu.org#55289,"OELFATU, AMFOANG BARAT LAUT, KUPANG, NUSA TENGGARA TIMUR",4,122,5,127
https://kawalpemilu.org#55289,"OELFATU, AMFOANG BARAT LAUT, KUPANG, NUSA TENGGARA TIMUR",5,204,8,212
https://kawalpemilu.org#55290,"TIMAU, AMFOANG BARAT LAUT, KUPANG, NUSA TENGGARA TIMUR",1,179,16,195
https://kawalpemilu.org#55290,"TIMAU, AMFOANG BARAT LAUT, KUPANG, NUSA TENGGARA TIMUR",2,182,5,187
https://kawalpemilu.org#55290,"TIMAU, AMFOANG BARAT LAUT, KUPANG, NUSA TENGGARA TIMUR",3,156,6,162
https://kawalpemilu.org#55290,"TIMAU, AMFOANG BARAT LAUT, KUPANG, NUSA TENGGARA TIMUR",4,141,4,145
https://kawalpemilu.org#55291,"HONUK, AMFOANG BARAT LAUT, KUPANG, NUSA TENGGARA TIMUR",1,148,5,153
https://kawalpemilu.org#55291,"HONUK, AMFOANG BARAT LAUT, KUPANG, NUSA TENGGARA TIMUR",2,158,6,164
https://kawalpemilu.org#55291,"HONUK, AMFOANG BARAT LAUT, KUPANG, NUSA TENGGARA TIMUR",3,147,6,153
https://kawalpemilu.org#55291,"HONUK, AMFOANG BARAT LAUT, KUPANG, NUSA TENGGARA TIMUR",4,163,13,176
https://kawalpemilu.org#55291,"HONUK, AMFOANG BARAT LAUT, KUPANG, NUSA TENGGARA TIMUR",5,148,2,150
https://kawalpemilu.org#55292,"FAUMES, AMFOANG BARAT LAUT, KUPANG, NUSA TENGGARA TIMUR",1,267,8,275
https://kawalpemilu.org#55292,"FAUMES, AMFOANG BARAT LAUT, KUPANG, NUSA TENGGARA TIMUR",2,255,1,256
https://kawalpemilu.org#55292,"FAUMES, AMFOANG BARAT LAUT, KUPANG, NUSA TENGGARA TIMUR",3,239,7,246
https://kawalpemilu.org#55294,"AKLE, SEMAU SELATAN, KUPANG, NUSA TENGGARA TIMUR",1,144,1,145
https://kawalpemilu.org#55294,"AKLE, SEMAU SELATAN, KUPANG, NUSA TENGGARA TIMUR",2,127,93,220
https://kawalpemilu.org#55294,"AKLE, SEMAU SELATAN, KUPANG, NUSA TENGGARA TIMUR",3,152,1,153
https://kawalpemilu.org#55295,"UITIUH ANA, SEMAU SELATAN, KUPANG, NUSA TENGGARA TIMUR",1,161,2,163
https://kawalpemilu.org#55295,"UITIUH ANA, SEMAU SELATAN, KUPANG, NUSA TENGGARA TIMUR",2,196,8,204
https://kawalpemilu.org#55295,"UITIUH ANA, SEMAU SELATAN, KUPANG, NUSA TENGGARA TIMUR",3,199,10,209
https://kawalpemilu.org#55295,"UITIUH ANA, SEMAU SELATAN, KUPANG, NUSA TENGGARA TIMUR",4,192,10,202
https://kawalpemilu.org#55295,"UITIUH ANA, SEMAU SELATAN, KUPANG, NUSA TENGGARA TIMUR",5,135,3,138
https://kawalpemilu.org#55296,"ONANSILA, SEMAU SELATAN, KUPANG, NUSA TENGGARA TIMUR",1,129,1,130
https://kawalpemilu.org#55296,"ONANSILA, SEMAU SELATAN, KUPANG, NUSA TENGGARA TIMUR",2,133,7,140
https://kawalpemilu.org#55297,"UITIUH TUAN, SEMAU SELATAN, KUPANG, NUSA TENGGARA TIMUR",1,214,4,218
https://kawalpemilu.org#55297,"UITIUH TUAN, SEMAU SELATAN, KUPANG, NUSA TENGGARA TIMUR",2,185,5,190
https://kawalpemilu.org#55298,"NAIKEAN, SEMAU SELATAN, KUPANG, NUSA TENGGARA TIMUR",1,189,9,198
https://kawalpemilu.org#55298,"NAIKEAN, SEMAU SELATAN, KUPANG, NUSA TENGGARA TIMUR",2,196,5,201
https://kawalpemilu.org#55299,"UIBOA, SEMAU SELATAN, KUPANG, NUSA TENGGARA TIMUR",1,141,4,145
https://kawalpemilu.org#55299,"UIBOA, SEMAU SELATAN, KUPANG, NUSA TENGGARA TIMUR",2,145,3,148
https://kawalpemilu.org#55299,"UIBOA, SEMAU SELATAN, KUPANG, NUSA TENGGARA TIMUR",3,114,2,116
https://kawalpemilu.org#55299,"UIBOA, SEMAU SELATAN, KUPANG, NUSA TENGGARA TIMUR",4,107,2,109
https://kawalpemilu.org#55301,"OELTUA, TAEBENU, KUPANG, NUSA TENGGARA TIMUR",1,237,7,244
https://kawalpemilu.org#55301,"OELTUA, TAEBENU, KUPANG, NUSA TENGGARA TIMUR",2,250,10,260
https://kawalpemilu.org#55301,"OELTUA, TAEBENU, KUPANG, NUSA TENGGARA TIMUR",3,234,6,240
https://kawalpemilu.org#55301,"OELTUA, TAEBENU, KUPANG, NUSA TENGGARA TIMUR",4,209,2,211
https://kawalpemilu.org#55301,"OELTUA, TAEBENU, KUPANG, NUSA TENGGARA TIMUR",5,204,12,216
https://kawalpemilu.org#55301,"OELTUA, TAEBENU, KUPANG, NUSA TENGGARA TIMUR",6,232,6,238
https://kawalpemilu.org#55301,"OELTUA, TAEBENU, KUPANG, NUSA TENGGARA TIMUR",7,217,12,229
https://kawalpemilu.org#55301,"OELTUA, TAEBENU, KUPANG, NUSA TENGGARA TIMUR",8,234,12,246
https://kawalpemilu.org#55302,"BAUMATA, TAEBENU, KUPANG, NUSA TENGGARA TIMUR",1,240,9,249
https://kawalpemilu.org#55302,"BAUMATA, TAEBENU, KUPANG, NUSA TENGGARA TIMUR",2,204,7,211
https://kawalpemilu.org#55302,"BAUMATA, TAEBENU, KUPANG, NUSA TENGGARA TIMUR",3,207,6,213
https://kawalpemilu.org#55302,"BAUMATA, TAEBENU, KUPANG, NUSA TENGGARA TIMUR",4,237,7,244
https://kawalpemilu.org#55302,"BAUMATA, TAEBENU, KUPANG, NUSA TENGGARA TIMUR",5,163,7,170
https://kawalpemilu.org#55302,"BAUMATA, TAEBENU, KUPANG, NUSA TENGGARA TIMUR",6,153,2,155
https://kawalpemilu.org#55303,"KUAKLALO, TAEBENU, KUPANG, NUSA TENGGARA TIMUR",1,144,6,150
https://kawalpemilu.org#55303,"KUAKLALO, TAEBENU, KUPANG, NUSA TENGGARA TIMUR",2,153,6,159
https://kawalpemilu.org#55304,"OELETSALA, TAEBENU, KUPANG, NUSA TENGGARA TIMUR",1,179,27,206
https://kawalpemilu.org#55304,"OELETSALA, TAEBENU, KUPANG, NUSA TENGGARA TIMUR",2,210,16,226
https://kawalpemilu.org#55304,"OELETSALA, TAEBENU, KUPANG, NUSA TENGGARA TIMUR",3,192,6,198
https://kawalpemilu.org#55304,"OELETSALA, TAEBENU, KUPANG, NUSA TENGGARA TIMUR",4,133,21,154
https://kawalpemilu.org#55305,"BOKONG, TAEBENU, KUPANG, NUSA TENGGARA TIMUR",1,169,3,172
https://kawalpemilu.org#55305,"BOKONG, TAEBENU, KUPANG, NUSA TENGGARA TIMUR",2,178,3,181
https://kawalpemilu.org#55305,"BOKONG, TAEBENU, KUPANG, NUSA TENGGARA TIMUR",3,169,3,172
https://kawalpemilu.org#55305,"BOKONG, TAEBENU, KUPANG, NUSA TENGGARA TIMUR",4,246,5,251
https://kawalpemilu.org#55305,"BOKONG, TAEBENU, KUPANG, NUSA TENGGARA TIMUR",5,244,3,247
https://kawalpemilu.org#55305,"BOKONG, TAEBENU, KUPANG, NUSA TENGGARA TIMUR",6,251,3,254
https://kawalpemilu.org#55306,"BAUMATA UTARA, TAEBENU, KUPANG, NUSA TENGGARA TIMUR",1,186,5,191
https://kawalpemilu.org#55306,"BAUMATA UTARA, TAEBENU, KUPANG, NUSA TENGGARA TIMUR",2,207,7,214
https://kawalpemilu.org#55306,"BAUMATA UTARA, TAEBENU, KUPANG, NUSA TENGGARA TIMUR",3,155,7,162
https://kawalpemilu.org#55306,"BAUMATA UTARA, TAEBENU, KUPANG, NUSA TENGGARA TIMUR",4,154,2,156
https://kawalpemilu.org#55307,"BAUMATA TIMUR, TAEBENU, KUPANG, NUSA TENGGARA TIMUR",1,253,6,259
https://kawalpemilu.org#55307,"BAUMATA TIMUR, TAEBENU, KUPANG, NUSA TENGGARA TIMUR",2,239,8,247
https://kawalpemilu.org#55307,"BAUMATA TIMUR, TAEBENU, KUPANG, NUSA TENGGARA TIMUR",3,200,70,265
https://kawalpemilu.org#55307,"BAUMATA TIMUR, TAEBENU, KUPANG, NUSA TENGGARA TIMUR",4,203,3,206
https://kawalpemilu.org#55307,"BAUMATA TIMUR, TAEBENU, KUPANG, NUSA TENGGARA TIMUR",5,176,7,183
https://kawalpemilu.org#55307,"BAUMATA TIMUR, TAEBENU, KUPANG, NUSA TENGGARA TIMUR",6,186,3,189
https://kawalpemilu.org#55308,"BAUMATA BARAT, TAEBENU, KUPANG, NUSA TENGGARA TIMUR",1,216,27,243
https://kawalpemilu.org#55308,"BAUMATA BARAT, TAEBENU, KUPANG, NUSA TENGGARA TIMUR",3,202,20,222
https://kawalpemilu.org#55308,"BAUMATA BARAT, TAEBENU, KUPANG, NUSA TENGGARA TIMUR",4,181,16,197
https://kawalpemilu.org#55308,"BAUMATA BARAT, TAEBENU, KUPANG, NUSA TENGGARA TIMUR",6,87,18,105
https://kawalpemilu.org#55310,"FATUKANUTU, AMABI OEFETO, KUPANG, NUSA TENGGARA TIMUR",1,202,11,213
https://kawalpemilu.org#55310,"FATUKANUTU, AMABI OEFETO, KUPANG, NUSA TENGGARA TIMUR",2,196,5,201
https://kawalpemilu.org#55310,"FATUKANUTU, AMABI OEFETO, KUPANG, NUSA TENGGARA TIMUR",3,205,6,211
https://kawalpemilu.org#55310,"FATUKANUTU, AMABI OEFETO, KUPANG, NUSA TENGGARA TIMUR",4,192,6,198
https://kawalpemilu.org#55310,"FATUKANUTU, AMABI OEFETO, KUPANG, NUSA TENGGARA TIMUR",5,227,12,239
https://kawalpemilu.org#55311,"KAIRANE, AMABI OEFETO, KUPANG, NUSA TENGGARA TIMUR",1,171,3,174
https://kawalpemilu.org#55311,"KAIRANE, AMABI OEFETO, KUPANG, NUSA TENGGARA TIMUR",2,174,0,174
https://kawalpemilu.org#55312,"RAKNAMO, AMABI OEFETO, KUPANG, NUSA TENGGARA TIMUR",1,232,10,242
https://kawalpemilu.org#55312,"RAKNAMO, AMABI OEFETO, KUPANG, NUSA TENGGARA TIMUR",2,223,2,225
https://kawalpemilu.org#55312,"RAKNAMO, AMABI OEFETO, KUPANG, NUSA TENGGARA TIMUR",3,154,56,210
https://kawalpemilu.org#55312,"RAKNAMO, AMABI OEFETO, KUPANG, NUSA TENGGARA TIMUR",4,41,134,175
https://kawalpemilu.org#55312,"RAKNAMO, AMABI OEFETO, KUPANG, NUSA TENGGARA TIMUR",5,65,100,165
https://kawalpemilu.org#55312,"RAKNAMO, AMABI OEFETO, KUPANG, NUSA TENGGARA TIMUR",6,55,117,172
https://kawalpemilu.org#55312,"RAKNAMO, AMABI OEFETO, KUPANG, NUSA TENGGARA TIMUR",7,27,39,66
https://kawalpemilu.org#55313,"KUANHEUM, AMABI OEFETO, KUPANG, NUSA TENGGARA TIMUR",1,221,5,226
https://kawalpemilu.org#55313,"KUANHEUM, AMABI OEFETO, KUPANG, NUSA TENGGARA TIMUR",2,227,9,236
https://kawalpemilu.org#55313,"KUANHEUM, AMABI OEFETO, KUPANG, NUSA TENGGARA TIMUR",3,217,4,221
https://kawalpemilu.org#55314,"FATUTETA, AMABI OEFETO, KUPANG, NUSA TENGGARA TIMUR",1,198,6,204
https://kawalpemilu.org#55314,"FATUTETA, AMABI OEFETO, KUPANG, NUSA TENGGARA TIMUR",2,190,2,192
https://kawalpemilu.org#55315,"OEFETO, AMABI OEFETO, KUPANG, NUSA TENGGARA TIMUR",1,166,14,180
https://kawalpemilu.org#55315,"OEFETO, AMABI OEFETO, KUPANG, NUSA TENGGARA TIMUR",2,138,34,172
https://kawalpemilu.org#55316,"NIUNBAUN, AMABI OEFETO, KUPANG, NUSA TENGGARA TIMUR",1,155,2,157
https://kawalpemilu.org#55316,"NIUNBAUN, AMABI OEFETO, KUPANG, NUSA TENGGARA TIMUR",2,183,4,187
https://kawalpemilu.org#55215,"NUNUANAH, AMFOANG TIMUR, KUPANG, NUSA TENGGARA TIMUR",1,183,5,188
https://kawalpemilu.org#55215,"NUNUANAH, AMFOANG TIMUR, KUPANG, NUSA TENGGARA TIMUR",2,198,11,209
https://kawalpemilu.org#55215,"NUNUANAH, AMFOANG TIMUR, KUPANG, NUSA TENGGARA TIMUR",3,183,12,195
https://kawalpemilu.org#55215,"NUNUANAH, AMFOANG TIMUR, KUPANG, NUSA TENGGARA TIMUR",4,162,7,169
https://kawalpemilu.org#55216,"KIFU, AMFOANG TIMUR, KUPANG, NUSA TENGGARA TIMUR",1,196,5,201
https://kawalpemilu.org#55216,"KIFU, AMFOANG TIMUR, KUPANG, NUSA TENGGARA TIMUR",2,196,7,203
https://kawalpemilu.org#55216,"KIFU, AMFOANG TIMUR, KUPANG, NUSA TENGGARA TIMUR",3,114,6,120
https://kawalpemilu.org#55320,"NETEMNANU SELATAN, AMFOANG TIMUR, KUPANG, NUSA TENGGARA TIMUR",1,178,6,184
https://kawalpemilu.org#55320,"NETEMNANU SELATAN, AMFOANG TIMUR, KUPANG, NUSA TENGGARA TIMUR",2,168,5,173
https://kawalpemilu.org#55320,"NETEMNANU SELATAN, AMFOANG TIMUR, KUPANG, NUSA TENGGARA TIMUR",3,198,1,199
https://kawalpemilu.org#55320,"NETEMNANU SELATAN, AMFOANG TIMUR, KUPANG, NUSA TENGGARA TIMUR",4,198,6,204
https://kawalpemilu.org#55320,"NETEMNANU SELATAN, AMFOANG TIMUR, KUPANG, NUSA TENGGARA TIMUR",5,113,3,116
https://kawalpemilu.org#55320,"NETEMNANU SELATAN, AMFOANG TIMUR, KUPANG, NUSA TENGGARA TIMUR",6,122,7,129
https://kawalpemilu.org#55321,"NETEMNANU UTARA, AMFOANG TIMUR, KUPANG, NUSA TENGGARA TIMUR",1,221,3,224
https://kawalpemilu.org#55321,"NETEMNANU UTARA, AMFOANG TIMUR, KUPANG, NUSA TENGGARA TIMUR",2,160,7,167
https://kawalpemilu.org#55321,"NETEMNANU UTARA, AMFOANG TIMUR, KUPANG, NUSA TENGGARA TIMUR",3,237,13,250
https://kawalpemilu.org#55321,"NETEMNANU UTARA, AMFOANG TIMUR, KUPANG, NUSA TENGGARA TIMUR",4,168,8,176
https://kawalpemilu.org#55321,"NETEMNANU UTARA, AMFOANG TIMUR, KUPANG, NUSA TENGGARA TIMUR",5,208,2,210
https://kawalpemilu.org#55322,"NETEMNANU, AMFOANG TIMUR, KUPANG, NUSA TENGGARA TIMUR",1,222,15,237
https://kawalpemilu.org#55322,"NETEMNANU, AMFOANG TIMUR, KUPANG, NUSA TENGGARA TIMUR",2,102,6,108
https://kawalpemilu.org#55322,"NETEMNANU, AMFOANG TIMUR, KUPANG, NUSA TENGGARA TIMUR",3,108,7,115
https://kawalpemilu.org#55172,"POTO, FATULEU BARAT, KUPANG, NUSA TENGGARA TIMUR",1,158,12,170
https://kawalpemilu.org#55172,"POTO, FATULEU BARAT, KUPANG, NUSA TENGGARA TIMUR",2,165,16,181
https://kawalpemilu.org#55172,"POTO, FATULEU BARAT, KUPANG, NUSA TENGGARA TIMUR",3,159,16,175
https://kawalpemilu.org#55172,"POTO, FATULEU BARAT, KUPANG, NUSA TENGGARA TIMUR",4,170,8,178
https://kawalpemilu.org#55172,"POTO, FATULEU BARAT, KUPANG, NUSA TENGGARA TIMUR",5,154,4,158
https://kawalpemilu.org#55172,"POTO, FATULEU BARAT, KUPANG, NUSA TENGGARA TIMUR",6,166,7,173
https://kawalpemilu.org#55172,"POTO, FATULEU BARAT, KUPANG, NUSA TENGGARA TIMUR",7,153,9,162
https://kawalpemilu.org#55172,"POTO, FATULEU BARAT, KUPANG, NUSA TENGGARA TIMUR",8,158,7,165
https://kawalpemilu.org#55172,"POTO, FATULEU BARAT, KUPANG, NUSA TENGGARA TIMUR",9,143,11,153
https://kawalpemilu.org#55173,"NUATAUS, FATULEU BARAT, KUPANG, NUSA TENGGARA TIMUR",1,134,18,152
https://kawalpemilu.org#55173,"NUATAUS, FATULEU BARAT, KUPANG, NUSA TENGGARA TIMUR",2,156,16,172
https://kawalpemilu.org#55173,"NUATAUS, FATULEU BARAT, KUPANG, NUSA TENGGARA TIMUR",3,127,6,133
https://kawalpemilu.org#55173,"NUATAUS, FATULEU BARAT, KUPANG, NUSA TENGGARA TIMUR",4,178,2,180
https://kawalpemilu.org#55173,"NUATAUS, FATULEU BARAT, KUPANG, NUSA TENGGARA TIMUR",5,183,13,196
https://kawalpemilu.org#55326,"KALALI, FATULEU BARAT, KUPANG, NUSA TENGGARA TIMUR",1,228,12,240
https://kawalpemilu.org#55326,"KALALI, FATULEU BARAT, KUPANG, NUSA TENGGARA TIMUR",2,212,7,219
https://kawalpemilu.org#55326,"KALALI, FATULEU BARAT, KUPANG, NUSA TENGGARA TIMUR",3,186,12,198
https://kawalpemilu.org#55327,"TUAKAU, FATULEU BARAT, KUPANG, NUSA TENGGARA TIMUR",1,146,5,151
https://kawalpemilu.org#55327,"TUAKAU, FATULEU BARAT, KUPANG, NUSA TENGGARA TIMUR",2,153,4,157
https://kawalpemilu.org#55327,"TUAKAU, FATULEU BARAT, KUPANG, NUSA TENGGARA TIMUR",3,198,3,201
https://kawalpemilu.org#55327,"TUAKAU, FATULEU BARAT, KUPANG, NUSA TENGGARA TIMUR",4,144,4,148
https://kawalpemilu.org#55328,"NAITAE, FATULEU BARAT, KUPANG, NUSA TENGGARA TIMUR",1,178,17,195
https://kawalpemilu.org#55328,"NAITAE, FATULEU BARAT, KUPANG, NUSA TENGGARA TIMUR",2,182,8,190
https://kawalpemilu.org#55328,"NAITAE, FATULEU BARAT, KUPANG, NUSA TENGGARA TIMUR",3,186,12,198
https://kawalpemilu.org#55328,"NAITAE, FATULEU BARAT, KUPANG, NUSA TENGGARA TIMUR",4,165,9,174
https://kawalpemilu.org#55174,"OELBITENO, FATULEU TENGAH, KUPANG, NUSA TENGGARA TIMUR",1,237,4,241
https://kawalpemilu.org#55174,"OELBITENO, FATULEU TENGAH, KUPANG, NUSA TENGGARA TIMUR",2,221,13,234
https://kawalpemilu.org#55174,"OELBITENO, FATULEU TENGAH, KUPANG, NUSA TENGGARA TIMUR",3,197,4,201
https://kawalpemilu.org#55175,"NONBAUN, FATULEU TENGAH, KUPANG, NUSA TENGGARA TIMUR",1,199,5,204
https://kawalpemilu.org#55175,"NONBAUN, FATULEU TENGAH, KUPANG, NUSA TENGGARA TIMUR",2,189,5,194
https://kawalpemilu.org#55175,"NONBAUN, FATULEU TENGAH, KUPANG, NUSA TENGGARA TIMUR",3,149,4,153
https://kawalpemilu.org#55176,"NUNSAEN, FATULEU TENGAH, KUPANG, NUSA TENGGARA TIMUR",1,180,42,222
https://kawalpemilu.org#55176,"NUNSAEN, FATULEU TENGAH, KUPANG, NUSA TENGGARA TIMUR",2,193,3,196
https://kawalpemilu.org#55176,"NUNSAEN, FATULEU TENGAH, KUPANG, NUSA TENGGARA TIMUR",3,202,4,206
https://kawalpemilu.org#55176,"NUNSAEN, FATULEU TENGAH, KUPANG, NUSA TENGGARA TIMUR",4,195,10,205
https://kawalpemilu.org#55176,"NUNSAEN, FATULEU TENGAH, KUPANG, NUSA TENGGARA TIMUR",5,186,17,203
https://kawalpemilu.org#55176,"NUNSAEN, FATULEU TENGAH, KUPANG, NUSA TENGGARA TIMUR",6,187,10,197
https://kawalpemilu.org#55333,"PASSI, FATULEU TENGAH, KUPANG, NUSA TENGGARA TIMUR",1,141,11,152
https://kawalpemilu.org#55333,"PASSI, FATULEU TENGAH, KUPANG, NUSA TENGGARA TIMUR",2,151,5,156
https://kawalpemilu.org#55333,"PASSI, FATULEU TENGAH, KUPANG, NUSA TENGGARA TIMUR",3,201,6,207
https://kawalpemilu.org#55203,"BINAFUN, AMFOANG TENGAH, KUPANG, NUSA TENGGARA TIMUR",2,150,5,155
https://kawalpemilu.org#55203,"BINAFUN, AMFOANG TENGAH, KUPANG, NUSA TENGGARA TIMUR",3,174,3,177
https://kawalpemilu.org#55203,"BINAFUN, AMFOANG TENGAH, KUPANG, NUSA TENGGARA TIMUR",4,206,10,216
https://kawalpemilu.org#55204,"FATUMONAS, AMFOANG TENGAH, KUPANG, NUSA TENGGARA TIMUR",1,162,14,176
https://kawalpemilu.org#55204,"FATUMONAS, AMFOANG TENGAH, KUPANG, NUSA TENGGARA TIMUR",2,199,6,205
https://kawalpemilu.org#55204,"FATUMONAS, AMFOANG TENGAH, KUPANG, NUSA TENGGARA TIMUR",3,163,20,183
https://kawalpemilu.org#55204,"FATUMONAS, AMFOANG TENGAH, KUPANG, NUSA TENGGARA TIMUR",4,177,21,198
https://kawalpemilu.org#55204,"FATUMONAS, AMFOANG TENGAH, KUPANG, NUSA TENGGARA TIMUR",5,147,5,152
https://kawalpemilu.org#55204,"FATUMONAS, AMFOANG TENGAH, KUPANG, NUSA TENGGARA TIMUR",6,139,11,150
https://kawalpemilu.org#55206,"BITOBE, AMFOANG TENGAH, KUPANG, NUSA TENGGARA TIMUR",1,181,13,194
https://kawalpemilu.org#55206,"BITOBE, AMFOANG TENGAH, KUPANG, NUSA TENGGARA TIMUR",2,180,8,188
https://kawalpemilu.org#55206,"BITOBE, AMFOANG TENGAH, KUPANG, NUSA TENGGARA TIMUR",3,212,9,221
https://kawalpemilu.org#55206,"BITOBE, AMFOANG TENGAH, KUPANG, NUSA TENGGARA TIMUR",4,180,6,186
https://kawalpemilu.org#55207,"BONMUTI, AMFOANG TENGAH, KUPANG, NUSA TENGGARA TIMUR",1,165,3,168
https://kawalpemilu.org#55207,"BONMUTI, AMFOANG TENGAH, KUPANG, NUSA TENGGARA TIMUR",2,179,7,186
https://kawalpemilu.org#55207,"BONMUTI, AMFOANG TENGAH, KUPANG, NUSA TENGGARA TIMUR",3,138,13,151
https://kawalpemilu.org#55349,"SOE, KOTA SOE, TIMOR TENGAH SELATAN, NUSA TENGGARA TIMUR",1,203,51,254
https://kawalpemilu.org#55349,"SOE, KOTA SOE, TIMOR TENGAH SELATAN, NUSA TENGGARA TIMUR",2,242,23,265
https://kawalpemilu.org#55349,"SOE, KOTA SOE, TIMOR TENGAH SELATAN, NUSA TENGGARA TIMUR",3,195,30,225
https://kawalpemilu.org#55349,"SOE, KOTA SOE, TIMOR TENGAH SELATAN, NUSA TENGGARA TIMUR",4,219,16,235
https://kawalpemilu.org#55349,"SOE, KOTA SOE, TIMOR TENGAH SELATAN, NUSA TENGGARA TIMUR",5,241,29,270
https://kawalpemilu.org#55349,"SOE, KOTA SOE, TIMOR TENGAH SELATAN, NUSA TENGGARA TIMUR",6,235,17,252
https://kawalpemilu.org#55349,"SOE, KOTA SOE, TIMOR TENGAH SELATAN, NUSA TENGGARA TIMUR",7,205,23,228
https://kawalpemilu.org#55349,"SOE, KOTA SOE, TIMOR TENGAH SELATAN, NUSA TENGGARA TIMUR",8,258,11,269
https://kawalpemilu.org#55350,"CENDANA, KOTA SOE, TIMOR TENGAH SELATAN, NUSA TENGGARA TIMUR",1,213,21,234
https://kawalpemilu.org#55350,"CENDANA, KOTA SOE, TIMOR TENGAH SELATAN, NUSA TENGGARA TIMUR",2,189,35,224
https://kawalpemilu.org#55350,"CENDANA, KOTA SOE, TIMOR TENGAH SELATAN, NUSA TENGGARA TIMUR",3,205,38,243
https://kawalpemilu.org#55350,"CENDANA, KOTA SOE, TIMOR TENGAH SELATAN, NUSA TENGGARA TIMUR",4,195,13,208
https://kawalpemilu.org#55350,"CENDANA, KOTA SOE, TIMOR TENGAH SELATAN, NUSA TENGGARA TIMUR",5,180,64,244
https://kawalpemilu.org#55350,"CENDANA, KOTA SOE, TIMOR TENGAH SELATAN, NUSA TENGGARA TIMUR",6,171,47,218
https://kawalpemilu.org#55350,"CENDANA, KOTA SOE, TIMOR TENGAH SELATAN, NUSA TENGGARA TIMUR",7,170,6,176
https://kawalpemilu.org#55350,"CENDANA, KOTA SOE, TIMOR TENGAH SELATAN, NUSA TENGGARA TIMUR",8,201,4,205
https://kawalpemilu.org#55351,"OEBESA, KOTA SOE, TIMOR TENGAH SELATAN, NUSA TENGGARA TIMUR",1,173,14,187
https://kawalpemilu.org#55351,"OEBESA, KOTA SOE, TIMOR TENGAH SELATAN, NUSA TENGGARA TIMUR",2,160,24,184
https://kawalpemilu.org#55351,"OEBESA, KOTA SOE, TIMOR TENGAH SELATAN, NUSA TENGGARA TIMUR",3,148,18,166
https://kawalpemilu.org#55351,"OEBESA, KOTA SOE, TIMOR TENGAH SELATAN, NUSA TENGGARA TIMUR",4,166,19,185
https://kawalpemilu.org#55351,"OEBESA, KOTA SOE, TIMOR TENGAH SELATAN, NUSA TENGGARA TIMUR",5,161,22,183
https://kawalpemilu.org#55351,"OEBESA, KOTA SOE, TIMOR TENGAH SELATAN, NUSA TENGGARA TIMUR",6,199,18,217
https://kawalpemilu.org#55351,"OEBESA, KOTA SOE, TIMOR TENGAH SELATAN, NUSA TENGGARA TIMUR",7,170,35,205
https://kawalpemilu.org#55351,"OEBESA, KOTA SOE, TIMOR TENGAH SELATAN, NUSA TENGGARA TIMUR",8,148,17,165
https://kawalpemilu.org#55351,"OEBESA, KOTA SOE, TIMOR TENGAH SELATAN, NUSA TENGGARA TIMUR",9,137,20,157
https://kawalpemilu.org#55352,"TAUBNENO, KOTA SOE, TIMOR TENGAH SELATAN, NUSA TENGGARA TIMUR",1,146,36,182
https://kawalpemilu.org#55352,"TAUBNENO, KOTA SOE, TIMOR TENGAH SELATAN, NUSA TENGGARA TIMUR",2,138,72,210
https://kawalpemilu.org#55352,"TAUBNENO, KOTA SOE, TIMOR TENGAH SELATAN, NUSA TENGGARA TIMUR",3,227,21,248
https://kawalpemilu.org#55352,"TAUBNENO, KOTA SOE, TIMOR TENGAH SELATAN, NUSA TENGGARA TIMUR",4,198,16,214
https://kawalpemilu.org#55352,"TAUBNENO, KOTA SOE, TIMOR TENGAH SELATAN, NUSA TENGGARA TIMUR",5,178,36,214
https://kawalpemilu.org#55352,"TAUBNENO, KOTA SOE, TIMOR TENGAH SELATAN, NUSA TENGGARA TIMUR",6,178,33,211
https://kawalpemilu.org#55352,"TAUBNENO, KOTA SOE, TIMOR TENGAH SELATAN, NUSA TENGGARA TIMUR",7,98,41,139
https://kawalpemilu.org#55353,"NONOHONIS, KOTA SOE, TIMOR TENGAH SELATAN, NUSA TENGGARA TIMUR",1,232,13,245
https://kawalpemilu.org#55353,"NONOHONIS, KOTA SOE, TIMOR TENGAH SELATAN, NUSA TENGGARA TIMUR",2,216,12,228
https://kawalpemilu.org#55353,"NONOHONIS, KOTA SOE, TIMOR TENGAH SELATAN, NUSA TENGGARA TIMUR",3,166,8,174
https://kawalpemilu.org#55353,"NONOHONIS, KOTA SOE, TIMOR TENGAH SELATAN, NUSA TENGGARA TIMUR",4,114,11,125
https://kawalpemilu.org#55353,"NONOHONIS, KOTA SOE, TIMOR TENGAH SELATAN, NUSA TENGGARA TIMUR",5,121,11,132
https://kawalpemilu.org#55353,"NONOHONIS, KOTA SOE, TIMOR TENGAH SELATAN, NUSA TENGGARA TIMUR",6,168,12,180
https://kawalpemilu.org#55353,"NONOHONIS, KOTA SOE, TIMOR TENGAH SELATAN, NUSA TENGGARA TIMUR",7,142,10,152
https://kawalpemilu.org#55353,"NONOHONIS, KOTA SOE, TIMOR TENGAH SELATAN, NUSA TENGGARA TIMUR",8,115,16,131
https://kawalpemilu.org#55353,"NONOHONIS, KOTA SOE, TIMOR TENGAH SELATAN, NUSA TENGGARA TIMUR",9,151,18,169
https://kawalpemilu.org#55353,"NONOHONIS, KOTA SOE, TIMOR TENGAH SELATAN, NUSA TENGGARA TIMUR",10,212,17,229
https://kawalpemilu.org#55353,"NONOHONIS, KOTA SOE, TIMOR TENGAH SELATAN, NUSA TENGGARA TIMUR",11,142,21,163
https://kawalpemilu.org#55353,"NONOHONIS, KOTA SOE, TIMOR TENGAH SELATAN, NUSA TENGGARA TIMUR",12,133,17,150
https://kawalpemilu.org#55353,"NONOHONIS, KOTA SOE, TIMOR TENGAH SELATAN, NUSA TENGGARA TIMUR",13,168,16,184
https://kawalpemilu.org#55353,"NONOHONIS, KOTA SOE, TIMOR TENGAH SELATAN, NUSA TENGGARA TIMUR",14,211,9,220
https://kawalpemilu.org#55354,"KARANG SIRIH, KOTA SOE, TIMOR TENGAH SELATAN, NUSA TENGGARA TIMUR",1,211,27,238
https://kawalpemilu.org#55354,"KARANG SIRIH, KOTA SOE, TIMOR TENGAH SELATAN, NUSA TENGGARA TIMUR",2,168,23,191
https://kawalpemilu.org#55354,"KARANG SIRIH, KOTA SOE, TIMOR TENGAH SELATAN, NUSA TENGGARA TIMUR",3,192,13,205
https://kawalpemilu.org#55354,"KARANG SIRIH, KOTA SOE, TIMOR TENGAH SELATAN, NUSA TENGGARA TIMUR",4,230,13,243
https://kawalpemilu.org#55354,"KARANG SIRIH, KOTA SOE, TIMOR TENGAH SELATAN, NUSA TENGGARA TIMUR",5,208,9,217
https://kawalpemilu.org#55354,"KARANG SIRIH, KOTA SOE, TIMOR TENGAH SELATAN, NUSA TENGGARA TIMUR",6,138,8,146
https://kawalpemilu.org#55354,"KARANG SIRIH, KOTA SOE, TIMOR TENGAH SELATAN, NUSA TENGGARA TIMUR",7,150,13,163
https://kawalpemilu.org#55354,"KARANG SIRIH, KOTA SOE, TIMOR TENGAH SELATAN, NUSA TENGGARA TIMUR",8,203,21,224
https://kawalpemilu.org#55354,"KARANG SIRIH, KOTA SOE, TIMOR TENGAH SELATAN, NUSA TENGGARA TIMUR",9,204,18,222
https://kawalpemilu.org#55354,"KARANG SIRIH, KOTA SOE, TIMOR TENGAH SELATAN, NUSA TENGGARA TIMUR",10,184,24,208
https://kawalpemilu.org#55354,"KARANG SIRIH, KOTA SOE, TIMOR TENGAH SELATAN, NUSA TENGGARA TIMUR",11,198,32,230
https://kawalpemilu.org#55354,"KARANG SIRIH, KOTA SOE, TIMOR TENGAH SELATAN, NUSA TENGGARA TIMUR",12,120,16,136
https://kawalpemilu.org#55354,"KARANG SIRIH, KOTA SOE, TIMOR TENGAH SELATAN, NUSA TENGGARA TIMUR",13,114,14,128
https://kawalpemilu.org#55355,"NUNUMEU, KOTA SOE, TIMOR TENGAH SELATAN, NUSA TENGGARA TIMUR",1,224,38,262
https://kawalpemilu.org#55355,"NUNUMEU, KOTA SOE, TIMOR TENGAH SELATAN, NUSA TENGGARA TIMUR",2,224,28,252
https://kawalpemilu.org#55355,"NUNUMEU, KOTA SOE, TIMOR TENGAH SELATAN, NUSA TENGGARA TIMUR",3,226,30,256
https://kawalpemilu.org#55355,"NUNUMEU, KOTA SOE, TIMOR TENGAH SELATAN, NUSA TENGGARA TIMUR",4,204,29,233
https://kawalpemilu.org#55355,"NUNUMEU, KOTA SOE, TIMOR TENGAH SELATAN, NUSA TENGGARA TIMUR",5,211,24,235
https://kawalpemilu.org#55355,"NUNUMEU, KOTA SOE, TIMOR TENGAH SELATAN, NUSA TENGGARA TIMUR",6,208,11,219
https://kawalpemilu.org#55355,"NUNUMEU, KOTA SOE, TIMOR TENGAH SELATAN, NUSA TENGGARA TIMUR",7,228,9,237
https://kawalpemilu.org#55355,"NUNUMEU, KOTA SOE, TIMOR TENGAH SELATAN, NUSA TENGGARA TIMUR",8,188,10,198
https://kawalpemilu.org#55355,"NUNUMEU, KOTA SOE, TIMOR TENGAH SELATAN, NUSA TENGGARA TIMUR",9,189,8,197
https://kawalpemilu.org#55355,"NUNUMEU, KOTA SOE, TIMOR TENGAH SELATAN, NUSA TENGGARA TIMUR",10,202,7,209
https://kawalpemilu.org#55355,"NUNUMEU, KOTA SOE, TIMOR TENGAH SELATAN, NUSA TENGGARA TIMUR",11,187,8,195
https://kawalpemilu.org#55356,"KOBEKAMUSA, KOTA SOE, TIMOR TENGAH SELATAN, NUSA TENGGARA TIMUR",1,236,26,262
https://kawalpemilu.org#55356,"KOBEKAMUSA, KOTA SOE, TIMOR TENGAH SELATAN, NUSA TENGGARA TIMUR",2,168,15,183
https://kawalpemilu.org#55356,"KOBEKAMUSA, KOTA SOE, TIMOR TENGAH SELATAN, NUSA TENGGARA TIMUR",3,159,29,188
https://kawalpemilu.org#55356,"KOBEKAMUSA, KOTA SOE, TIMOR TENGAH SELATAN, NUSA TENGGARA TIMUR",4,217,4,221
https://kawalpemilu.org#55357,"OE KEFAN, KOTA SOE, TIMOR TENGAH SELATAN, NUSA TENGGARA TIMUR",1,132,44,176
https://kawalpemilu.org#55357,"OE KEFAN, KOTA SOE, TIMOR TENGAH SELATAN, NUSA TENGGARA TIMUR",2,131,35,166
https://kawalpemilu.org#55357,"OE KEFAN, KOTA SOE, TIMOR TENGAH SELATAN, NUSA TENGGARA TIMUR",3,195,21,216
https://kawalpemilu.org#55357,"OE KEFAN, KOTA SOE, TIMOR TENGAH SELATAN, NUSA TENGGARA TIMUR",4,167,29,196
https://kawalpemilu.org#55357,"OE KEFAN, KOTA SOE, TIMOR TENGAH SELATAN, NUSA TENGGARA TIMUR",5,144,40,184
https://kawalpemilu.org#55357,"OE KEFAN, KOTA SOE, TIMOR TENGAH SELATAN, NUSA TENGGARA TIMUR",6,145,55,200
https://kawalpemilu.org#55357,"OE KEFAN, KOTA SOE, TIMOR TENGAH SELATAN, NUSA TENGGARA TIMUR",7,99,58,157
https://kawalpemilu.org#55357,"OE KEFAN, KOTA SOE, TIMOR TENGAH SELATAN, NUSA TENGGARA TIMUR",8,144,30,174
https://kawalpemilu.org#55357,"OE KEFAN, KOTA SOE, TIMOR TENGAH SELATAN, NUSA TENGGARA TIMUR",9,125,10,135
https://kawalpemilu.org#55357,"OE KEFAN, KOTA SOE, TIMOR TENGAH SELATAN, NUSA TENGGARA TIMUR",10,127,12,139
https://kawalpemilu.org#55357,"OE KEFAN, KOTA SOE, TIMOR TENGAH SELATAN, NUSA TENGGARA TIMUR",11,83,44,127
https://kawalpemilu.org#55358,"KOTA BARU, KOTA SOE, TIMOR TENGAH SELATAN, NUSA TENGGARA TIMUR",1,230,33,263
https://kawalpemilu.org#55358,"KOTA BARU, KOTA SOE, TIMOR TENGAH SELATAN, NUSA TENGGARA TIMUR",2,177,60,237
https://kawalpemilu.org#55358,"KOTA BARU, KOTA SOE, TIMOR TENGAH SELATAN, NUSA TENGGARA TIMUR",3,170,39,209
https://kawalpemilu.org#55358,"KOTA BARU, KOTA SOE, TIMOR TENGAH SELATAN, NUSA TENGGARA TIMUR",4,110,74,184
https://kawalpemilu.org#55359,"KAMPUNG BARU, KOTA SOE, TIMOR TENGAH SELATAN, NUSA TENGGARA TIMUR",1,220,26,246
https://kawalpemilu.org#55359,"KAMPUNG BARU, KOTA SOE, TIMOR TENGAH SELATAN, NUSA TENGGARA TIMUR",2,167,19,186
https://kawalpemilu.org#55359,"KAMPUNG BARU, KOTA SOE, TIMOR TENGAH SELATAN, NUSA TENGGARA TIMUR",3,247,9,256
https://kawalpemilu.org#55360,"KUATAE, KOTA SOE, TIMOR TENGAH SELATAN, NUSA TENGGARA TIMUR",1,168,13,181
https://kawalpemilu.org#55360,"KUATAE, KOTA SOE, TIMOR TENGAH SELATAN, NUSA TENGGARA TIMUR",2,181,16,197
https://kawalpemilu.org#55360,"KUATAE, KOTA SOE, TIMOR TENGAH SELATAN, NUSA TENGGARA TIMUR",3,176,10,186
https://kawalpemilu.org#55360,"KUATAE, KOTA SOE, TIMOR TENGAH SELATAN, NUSA TENGGARA TIMUR",4,180,6,186
https://kawalpemilu.org#55361,"NOEMETO, KOTA SOE, TIMOR TENGAH SELATAN, NUSA TENGGARA TIMUR",1,227,6,233
https://kawalpemilu.org#55361,"NOEMETO, KOTA SOE, TIMOR TENGAH SELATAN, NUSA TENGGARA TIMUR",2,229,11,240
https://kawalpemilu.org#55361,"NOEMETO, KOTA SOE, TIMOR TENGAH SELATAN, NUSA TENGGARA TIMUR",3,246,9,255
https://kawalpemilu.org#55361,"NOEMETO, KOTA SOE, TIMOR TENGAH SELATAN, NUSA TENGGARA TIMUR",4,170,4,174
https://kawalpemilu.org#55363,"BILOTO, MOLLO SELATAN, TIMOR TENGAH SELATAN, NUSA TENGGARA TIMUR",1,175,2,177
https://kawalpemilu.org#55363,"BILOTO, MOLLO SELATAN, TIMOR TENGAH SELATAN, NUSA TENGGARA TIMUR",2,150,8,158
https://kawalpemilu.org#55363,"BILOTO, MOLLO SELATAN, TIMOR TENGAH SELATAN, NUSA TENGGARA TIMUR",3,156,4,160
https://kawalpemilu.org#55363,"BILOTO, MOLLO SELATAN, TIMOR TENGAH SELATAN, NUSA TENGGARA TIMUR",4,143,7,150
https://kawalpemilu.org#55363,"BILOTO, MOLLO SELATAN, TIMOR TENGAH SELATAN, NUSA TENGGARA TIMUR",5,176,5,181
https://kawalpemilu.org#55363,"BILOTO, MOLLO SELATAN, TIMOR TENGAH SELATAN, NUSA TENGGARA TIMUR",6,175,3,178
https://kawalpemilu.org#55364,"KESETNANA, MOLLO SELATAN, TIMOR TENGAH SELATAN, NUSA TENGGARA TIMUR",1,123,23,146
https://kawalpemilu.org#55364,"KESETNANA, MOLLO SELATAN, TIMOR TENGAH SELATAN, NUSA TENGGARA TIMUR",2,112,18,130
https://kawalpemilu.org#55364,"KESETNANA, MOLLO SELATAN, TIMOR TENGAH SELATAN, NUSA TENGGARA TIMUR",3,164,12,176
https://kawalpemilu.org#55364,"KESETNANA, MOLLO SELATAN, TIMOR TENGAH SELATAN, NUSA TENGGARA TIMUR",4,177,11,188
https://kawalpemilu.org#55364,"KESETNANA, MOLLO SELATAN, TIMOR TENGAH SELATAN, NUSA TENGGARA TIMUR",5,85,98,183
https://kawalpemilu.org#55364,"KESETNANA, MOLLO SELATAN, TIMOR TENGAH SELATAN, NUSA TENGGARA TIMUR",6,141,44,185
https://kawalpemilu.org#55364,"KESETNANA, MOLLO SELATAN, TIMOR TENGAH SELATAN, NUSA TENGGARA TIMUR",7,100,12,112
https://kawalpemilu.org#55364,"KESETNANA, MOLLO SELATAN, TIMOR TENGAH SELATAN, NUSA TENGGARA TIMUR",8,116,13,129
https://kawalpemilu.org#55364,"KESETNANA, MOLLO SELATAN, TIMOR TENGAH SELATAN, NUSA TENGGARA TIMUR",9,147,21,168
https://kawalpemilu.org#55364,"KESETNANA, MOLLO SELATAN, TIMOR TENGAH SELATAN, NUSA TENGGARA TIMUR",10,157,16,173
https://kawalpemilu.org#55364,"KESETNANA, MOLLO SELATAN, TIMOR TENGAH SELATAN, NUSA TENGGARA TIMUR",11,166,17,183
https://kawalpemilu.org#55364,"KESETNANA, MOLLO SELATAN, TIMOR TENGAH SELATAN, NUSA TENGGARA TIMUR",12,195,19,214
https://kawalpemilu.org#55364,"KESETNANA, MOLLO SELATAN, TIMOR TENGAH SELATAN, NUSA TENGGARA TIMUR",13,152,24,176
https://kawalpemilu.org#55364,"KESETNANA, MOLLO SELATAN, TIMOR TENGAH SELATAN, NUSA TENGGARA TIMUR",14,178,14,192
https://kawalpemilu.org#55364,"KESETNANA, MOLLO SELATAN, TIMOR TENGAH SELATAN, NUSA TENGGARA TIMUR",15,110,10,120
https://kawalpemilu.org#55364,"KESETNANA, MOLLO SELATAN, TIMOR TENGAH SELATAN, NUSA TENGGARA TIMUR",17,176,7,183
https://kawalpemilu.org#55364,"KESETNANA, MOLLO SELATAN, TIMOR TENGAH SELATAN, NUSA TENGGARA TIMUR",18,198,38,236
https://kawalpemilu.org#55364,"KESETNANA, MOLLO SELATAN, TIMOR TENGAH SELATAN, NUSA TENGGARA TIMUR",19,178,19,197
https://kawalpemilu.org#55365,"TUASENE, MOLLO SELATAN, TIMOR TENGAH SELATAN, NUSA TENGGARA TIMUR",1,145,2,147
https://kawalpemilu.org#55365,"TUASENE, MOLLO SELATAN, TIMOR TENGAH SELATAN, NUSA TENGGARA TIMUR",2,123,2,125
https://kawalpemilu.org#55365,"TUASENE, MOLLO SELATAN, TIMOR TENGAH SELATAN, NUSA TENGGARA TIMUR",3,112,3,115
https://kawalpemilu.org#55365,"TUASENE, MOLLO SELATAN, TIMOR TENGAH SELATAN, NUSA TENGGARA TIMUR",4,121,2,123
https://kawalpemilu.org#55365,"TUASENE, MOLLO SELATAN, TIMOR TENGAH SELATAN, NUSA TENGGARA TIMUR",5,184,13,197
https://kawalpemilu.org#55366,"OINLASI, MOLLO SELATAN, TIMOR TENGAH SELATAN, NUSA TENGGARA TIMUR",1,152,20,172
https://kawalpemilu.org#55366,"OINLASI, MOLLO SELATAN, TIMOR TENGAH SELATAN, NUSA TENGGARA TIMUR",2,107,13,120
https://kawalpemilu.org#55366,"OINLASI, MOLLO SELATAN, TIMOR TENGAH SELATAN, NUSA TENGGARA TIMUR",3,121,12,133
https://kawalpemilu.org#55366,"OINLASI, MOLLO SELATAN, TIMOR TENGAH SELATAN, NUSA TENGGARA TIMUR",4,108,21,129
https://kawalpemilu.org#55366,"OINLASI, MOLLO SELATAN, TIMOR TENGAH SELATAN, NUSA TENGGARA TIMUR",5,158,27,185
https://kawalpemilu.org#55366,"OINLASI, MOLLO SELATAN, TIMOR TENGAH SELATAN, NUSA TENGGARA TIMUR",6,67,13,80
https://kawalpemilu.org#55366,"OINLASI, MOLLO SELATAN, TIMOR TENGAH SELATAN, NUSA TENGGARA TIMUR",7,117,33,150
https://kawalpemilu.org#55366,"OINLASI, MOLLO SELATAN, TIMOR TENGAH SELATAN, NUSA TENGGARA TIMUR",8,55,38,93
https://kawalpemilu.org#55366,"OINLASI, MOLLO SELATAN, TIMOR TENGAH SELATAN, NUSA TENGGARA TIMUR",9,150,17,167
https://kawalpemilu.org#55366,"OINLASI, MOLLO SELATAN, TIMOR TENGAH SELATAN, NUSA TENGGARA TIMUR",10,178,20,198
https://kawalpemilu.org#55366,"OINLASI, MOLLO SELATAN, TIMOR TENGAH SELATAN, NUSA TENGGARA TIMUR",12,117,10,127
https://kawalpemilu.org#55366,"OINLASI, MOLLO SELATAN, TIMOR TENGAH SELATAN, NUSA TENGGARA TIMUR",13,111,27,138
https://kawalpemilu.org#55367,"BISENE, MOLLO SELATAN, TIMOR TENGAH SELATAN, NUSA TENGGARA TIMUR",1,177,9,186
https://kawalpemilu.org#55367,"BISENE, MOLLO SELATAN, TIMOR TENGAH SELATAN, NUSA TENGGARA TIMUR",2,181,16,197
https://kawalpemilu.org#55368,"NOINBILA, MOLLO SELATAN, TIMOR TENGAH SELATAN, NUSA TENGGARA TIMUR",1,172,7,179
https://kawalpemilu.org#55368,"NOINBILA, MOLLO SELATAN, TIMOR TENGAH SELATAN, NUSA TENGGARA TIMUR",2,163,14,177
https://kawalpemilu.org#55368,"NOINBILA, MOLLO SELATAN, TIMOR TENGAH SELATAN, NUSA TENGGARA TIMUR",3,178,14,192
https://kawalpemilu.org#55368,"NOINBILA, MOLLO SELATAN, TIMOR TENGAH SELATAN, NUSA TENGGARA TIMUR",4,190,16,206
https://kawalpemilu.org#55368,"NOINBILA, MOLLO SELATAN, TIMOR TENGAH SELATAN, NUSA TENGGARA TIMUR",5,173,31,204
https://kawalpemilu.org#55369,"BIKEKNENO, MOLLO SELATAN, TIMOR TENGAH SELATAN, NUSA TENGGARA TIMUR",1,187,6,193
https://kawalpemilu.org#55369,"BIKEKNENO, MOLLO SELATAN, TIMOR TENGAH SELATAN, NUSA TENGGARA TIMUR",2,146,3,149
https://kawalpemilu.org#55369,"BIKEKNENO, MOLLO SELATAN, TIMOR TENGAH SELATAN, NUSA TENGGARA TIMUR",3,117,6,123
https://kawalpemilu.org#55371,"O'BESI, MOLLO UTARA, TIMOR TENGAH SELATAN, NUSA TENGGARA TIMUR",1,206,15,221
https://kawalpemilu.org#55371,"O'BESI, MOLLO UTARA, TIMOR TENGAH SELATAN, NUSA TENGGARA TIMUR",2,195,37,232
https://kawalpemilu.org#55371,"O'BESI, MOLLO UTARA, TIMOR TENGAH SELATAN, NUSA TENGGARA TIMUR",3,172,3,175
https://kawalpemilu.org#55371,"O'BESI, MOLLO UTARA, TIMOR TENGAH SELATAN, NUSA TENGGARA TIMUR",4,206,43,249
https://kawalpemilu.org#55372,"EONBESI, MOLLO UTARA, TIMOR TENGAH SELATAN, NUSA TENGGARA TIMUR",1,219,12,231
https://kawalpemilu.org#55372,"EONBESI, MOLLO UTARA, TIMOR TENGAH SELATAN, NUSA TENGGARA TIMUR",2,186,7,193
https://kawalpemilu.org#55372,"EONBESI, MOLLO UTARA, TIMOR TENGAH SELATAN, NUSA TENGGARA TIMUR",3,109,2,111
https://kawalpemilu.org#55372,"EONBESI, MOLLO UTARA, TIMOR TENGAH SELATAN, NUSA TENGGARA TIMUR",4,174,5,179
https://kawalpemilu.org#55372,"EONBESI, MOLLO UTARA, TIMOR TENGAH SELATAN, NUSA TENGGARA TIMUR",5,186,7,193
https://kawalpemilu.org#55373,"BOSEN, MOLLO UTARA, TIMOR TENGAH SELATAN, NUSA TENGGARA TIMUR",1,145,2,147
https://kawalpemilu.org#55373,"BOSEN, MOLLO UTARA, TIMOR TENGAH SELATAN, NUSA TENGGARA TIMUR",2,114,11,125
https://kawalpemilu.org#55373,"BOSEN, MOLLO UTARA, TIMOR TENGAH SELATAN, NUSA TENGGARA TIMUR",3,197,7,204
https://kawalpemilu.org#55373,"BOSEN, MOLLO UTARA, TIMOR TENGAH SELATAN, NUSA TENGGARA TIMUR",4,114,1,115
https://kawalpemilu.org#55373,"BOSEN, MOLLO UTARA, TIMOR TENGAH SELATAN, NUSA TENGGARA TIMUR",5,100,5,105
https://kawalpemilu.org#55374,"SEBOT, MOLLO UTARA, TIMOR TENGAH SELATAN, NUSA TENGGARA TIMUR",2,222,6,228
https://kawalpemilu.org#55374,"SEBOT, MOLLO UTARA, TIMOR TENGAH SELATAN, NUSA TENGGARA TIMUR",3,138,2,140
https://kawalpemilu.org#55374,"SEBOT, MOLLO UTARA, TIMOR TENGAH SELATAN, NUSA TENGGARA TIMUR",4,108,4,112
https://kawalpemilu.org#55375,"AJAOBAKI, MOLLO UTARA, TIMOR TENGAH SELATAN, NUSA TENGGARA TIMUR",1,228,17,245
https://kawalpemilu.org#55375,"AJAOBAKI, MOLLO UTARA, TIMOR TENGAH SELATAN, NUSA TENGGARA TIMUR",2,255,3,258
https://kawalpemilu.org#55375,"AJAOBAKI, MOLLO UTARA, TIMOR TENGAH SELATAN, NUSA TENGGARA TIMUR",3,204,7,211
https://kawalpemilu.org#55375,"AJAOBAKI, MOLLO UTARA, TIMOR TENGAH SELATAN, NUSA TENGGARA TIMUR",4,161,8,169
https://kawalpemilu.org#55375,"AJAOBAKI, MOLLO UTARA, TIMOR TENGAH SELATAN, NUSA TENGGARA TIMUR",5,156,3,159
https://kawalpemilu.org#55376,"NETPALA, MOLLO UTARA, TIMOR TENGAH SELATAN, NUSA TENGGARA TIMUR",1,219,3,222
https://kawalpemilu.org#55376,"NETPALA, MOLLO UTARA, TIMOR TENGAH SELATAN, NUSA TENGGARA TIMUR",2,215,9,224
https://kawalpemilu.org#55376,"NETPALA, MOLLO UTARA, TIMOR TENGAH SELATAN, NUSA TENGGARA TIMUR",3,171,19,190
https://kawalpemilu.org#55376,"NETPALA, MOLLO UTARA, TIMOR TENGAH SELATAN, NUSA TENGGARA TIMUR",4,177,16,193
https://kawalpemilu.org#55377,"TUNUA, MOLLO UTARA, TIMOR TENGAH SELATAN, NUSA TENGGARA TIMUR",1,164,9,173
https://kawalpemilu.org#55377,"TUNUA, MOLLO UTARA, TIMOR TENGAH SELATAN, NUSA TENGGARA TIMUR",2,201,7,208
https://kawalpemilu.org#55377,"TUNUA, MOLLO UTARA, TIMOR TENGAH SELATAN, NUSA TENGGARA TIMUR",3,195,2,197
https://kawalpemilu.org#55377,"TUNUA, MOLLO UTARA, TIMOR TENGAH SELATAN, NUSA TENGGARA TIMUR",4,175,22,197
https://kawalpemilu.org#55377,"TUNUA, MOLLO UTARA, TIMOR TENGAH SELATAN, NUSA TENGGARA TIMUR",5,164,9,173
https://kawalpemilu.org#55378,"BIJAEPUNU, MOLLO UTARA, TIMOR TENGAH SELATAN, NUSA TENGGARA TIMUR",1,209,0,209
https://kawalpemilu.org#55378,"BIJAEPUNU, MOLLO UTARA, TIMOR TENGAH SELATAN, NUSA TENGGARA TIMUR",2,187,3,190
https://kawalpemilu.org#55378,"BIJAEPUNU, MOLLO UTARA, TIMOR TENGAH SELATAN, NUSA TENGGARA TIMUR",3,129,5,134
https://kawalpemilu.org#55378,"BIJAEPUNU, MOLLO UTARA, TIMOR TENGAH SELATAN, NUSA TENGGARA TIMUR",4,190,3,193
https://kawalpemilu.org#55379,"NEFOKOKO, MOLLO UTARA, TIMOR TENGAH SELATAN, NUSA TENGGARA TIMUR",1,189,4,193
https://kawalpemilu.org#55379,"NEFOKOKO, MOLLO UTARA, TIMOR TENGAH SELATAN, NUSA TENGGARA TIMUR",2,210,11,221
https://kawalpemilu.org#55379,"NEFOKOKO, MOLLO UTARA, TIMOR TENGAH SELATAN, NUSA TENGGARA TIMUR",3,198,11,209
https://kawalpemilu.org#55380,"LELOBOKO, MOLLO UTARA, TIMOR TENGAH SELATAN, NUSA TENGGARA TIMUR",1,151,13,164
https://kawalpemilu.org#55380,"LELOBOKO, MOLLO UTARA, TIMOR TENGAH SELATAN, NUSA TENGGARA TIMUR",2,116,15,131
https://kawalpemilu.org#55380,"LELOBOKO, MOLLO UTARA, TIMOR TENGAH SELATAN, NUSA TENGGARA TIMUR",3,99,6,105
https://kawalpemilu.org#55381,"LELOBATAN, MOLLO UTARA, TIMOR TENGAH SELATAN, NUSA TENGGARA TIMUR",1,210,6,216
https://kawalpemilu.org#55381,"LELOBATAN, MOLLO UTARA, TIMOR TENGAH SELATAN, NUSA TENGGARA TIMUR",2,129,0,129
https://kawalpemilu.org#55381,"LELOBATAN, MOLLO UTARA, TIMOR TENGAH SELATAN, NUSA TENGGARA TIMUR",3,224,10,234
https://kawalpemilu.org#55382,"HALMEI, MOLLO UTARA, TIMOR TENGAH SELATAN, NUSA TENGGARA TIMUR",1,156,12,168
https://kawalpemilu.org#55382,"HALMEI, MOLLO UTARA, TIMOR TENGAH SELATAN, NUSA TENGGARA TIMUR",2,100,2,102
https://kawalpemilu.org#55383,"FATUKOTO, MOLLO UTARA, TIMOR TENGAH SELATAN, NUSA TENGGARA TIMUR",1,190,4,194
https://kawalpemilu.org#55383,"FATUKOTO, MOLLO UTARA, TIMOR TENGAH SELATAN, NUSA TENGGARA TIMUR",2,207,10,217
https://kawalpemilu.org#55383,"FATUKOTO, MOLLO UTARA, TIMOR TENGAH SELATAN, NUSA TENGGARA TIMUR",3,234,9,243
https://kawalpemilu.org#55383,"FATUKOTO, MOLLO UTARA, TIMOR TENGAH SELATAN, NUSA TENGGARA TIMUR",4,175,5,180
https://kawalpemilu.org#55383,"FATUKOTO, MOLLO UTARA, TIMOR TENGAH SELATAN, NUSA TENGGARA TIMUR",5,117,3,120
https://kawalpemilu.org#91065,"KOKFE'U, MOLLO UTARA, TIMOR TENGAH SELATAN, NUSA TENGGARA TIMUR",1,146,1,147
https://kawalpemilu.org#91065,"KOKFE'U, MOLLO UTARA, TIMOR TENGAH SELATAN, NUSA TENGGARA TIMUR",2,156,3,159
https://kawalpemilu.org#91066,"TO'FEN, MOLLO UTARA, TIMOR TENGAH SELATAN, NUSA TENGGARA TIMUR",2,143,5,148
https://kawalpemilu.org#91067,"TAIFTOB, MOLLO UTARA, TIMOR TENGAH SELATAN, NUSA TENGGARA TIMUR",1,191,6,197
https://kawalpemilu.org#91067,"TAIFTOB, MOLLO UTARA, TIMOR TENGAH SELATAN, NUSA TENGGARA TIMUR",2,146,5,151
https://kawalpemilu.org#91067,"TAIFTOB, MOLLO UTARA, TIMOR TENGAH SELATAN, NUSA TENGGARA TIMUR",3,138,7,145
https://kawalpemilu.org#91067,"TAIFTOB, MOLLO UTARA, TIMOR TENGAH SELATAN, NUSA TENGGARA TIMUR",4,127,8,135
https://kawalpemilu.org#91068,"IUSMOLO, MOLLO UTARA, TIMOR TENGAH SELATAN, NUSA TENGGARA TIMUR",1,176,8,184
https://kawalpemilu.org#91068,"IUSMOLO, MOLLO UTARA, TIMOR TENGAH SELATAN, NUSA TENGGARA TIMUR",2,187,4,191
https://kawalpemilu.org#91069,"TO'MANAT, MOLLO UTARA, TIMOR TENGAH SELATAN, NUSA TENGGARA TIMUR",1,205,4,209
https://kawalpemilu.org#91069,"TO'MANAT, MOLLO UTARA, TIMOR TENGAH SELATAN, NUSA TENGGARA TIMUR",2,151,4,155
https://kawalpemilu.org#55385,"BILLA, AMANUBAN TIMUR, TIMOR TENGAH SELATAN, NUSA TENGGARA TIMUR",1,232,16,248
https://kawalpemilu.org#55385,"BILLA, AMANUBAN TIMUR, TIMOR TENGAH SELATAN, NUSA TENGGARA TIMUR",2,219,28,247
https://kawalpemilu.org#55385,"BILLA, AMANUBAN TIMUR, TIMOR TENGAH SELATAN, NUSA TENGGARA TIMUR",3,226,24,250
https://kawalpemilu.org#55385,"BILLA, AMANUBAN TIMUR, TIMOR TENGAH SELATAN, NUSA TENGGARA TIMUR",4,178,74,252
https://kawalpemilu.org#55386,"OELET, AMANUBAN TIMUR, TIMOR TENGAH SELATAN, NUSA TENGGARA TIMUR",1,175,51,226
https://kawalpemilu.org#55386,"OELET, AMANUBAN TIMUR, TIMOR TENGAH SELATAN, NUSA TENGGARA TIMUR",2,171,19,190
https://kawalpemilu.org#55386,"OELET, AMANUBAN TIMUR, TIMOR TENGAH SELATAN, NUSA TENGGARA TIMUR",3,194,15,209
https://kawalpemilu.org#55386,"OELET, AMANUBAN TIMUR, TIMOR TENGAH SELATAN, NUSA TENGGARA TIMUR",4,206,4,210
https://kawalpemilu.org#55387,"PISAN, AMANUBAN TIMUR, TIMOR TENGAH SELATAN, NUSA TENGGARA TIMUR",1,201,27,228
https://kawalpemilu.org#55387,"PISAN, AMANUBAN TIMUR, TIMOR TENGAH SELATAN, NUSA TENGGARA TIMUR",2,199,13,212
https://kawalpemilu.org#55387,"PISAN, AMANUBAN TIMUR, TIMOR TENGAH SELATAN, NUSA TENGGARA TIMUR",3,116,5,121
https://kawalpemilu.org#55387,"PISAN, AMANUBAN TIMUR, TIMOR TENGAH SELATAN, NUSA TENGGARA TIMUR",4,175,12,187
https://kawalpemilu.org#55388,"MAULEUM, AMANUBAN TIMUR, TIMOR TENGAH SELATAN, NUSA TENGGARA TIMUR",1,65,150,215
https://kawalpemilu.org#55388,"MAULEUM, AMANUBAN TIMUR, TIMOR TENGAH SELATAN, NUSA TENGGARA TIMUR",2,152,54,206
https://kawalpemilu.org#55388,"MAULEUM, AMANUBAN TIMUR, TIMOR TENGAH SELATAN, NUSA TENGGARA TIMUR",3,153,49,202
https://kawalpemilu.org#55388,"MAULEUM, AMANUBAN TIMUR, TIMOR TENGAH SELATAN, NUSA TENGGARA TIMUR",4,129,44,173
https://kawalpemilu.org#55388,"MAULEUM, AMANUBAN TIMUR, TIMOR TENGAH SELATAN, NUSA TENGGARA TIMUR",5,134,44,178
https://kawalpemilu.org#55389,"NIFUKIU, AMANUBAN TIMUR, TIMOR TENGAH SELATAN, NUSA TENGGARA TIMUR",1,173,6,179
https://kawalpemilu.org#55389,"NIFUKIU, AMANUBAN TIMUR, TIMOR TENGAH SELATAN, NUSA TENGGARA TIMUR",2,181,9,190
https://kawalpemilu.org#55389,"NIFUKIU, AMANUBAN TIMUR, TIMOR TENGAH SELATAN, NUSA TENGGARA TIMUR",3,200,8,208
https://kawalpemilu.org#55390,"MNELAANEN, AMANUBAN TIMUR, TIMOR TENGAH SELATAN, NUSA TENGGARA TIMUR",1,210,11,221
https://kawalpemilu.org#55390,"MNELAANEN, AMANUBAN TIMUR, TIMOR TENGAH SELATAN, NUSA TENGGARA TIMUR",2,153,41,194
https://kawalpemilu.org#55390,"MNELAANEN, AMANUBAN TIMUR, TIMOR TENGAH SELATAN, NUSA TENGGARA TIMUR",3,201,5,206
https://kawalpemilu.org#55390,"MNELAANEN, AMANUBAN TIMUR, TIMOR TENGAH SELATAN, NUSA TENGGARA TIMUR",4,161,12,173
https://kawalpemilu.org#55390,"MNELAANEN, AMANUBAN TIMUR, TIMOR TENGAH SELATAN, NUSA TENGGARA TIMUR",5,102,10,112
https://kawalpemilu.org#55390,"MNELAANEN, AMANUBAN TIMUR, TIMOR TENGAH SELATAN, NUSA TENGGARA TIMUR",6,89,50,139
https://kawalpemilu.org#55391,"TELUK, AMANUBAN TIMUR, TIMOR TENGAH SELATAN, NUSA TENGGARA TIMUR",1,237,24,261
https://kawalpemilu.org#55391,"TELUK, AMANUBAN TIMUR, TIMOR TENGAH SELATAN, NUSA TENGGARA TIMUR",2,158,4,162
https://kawalpemilu.org#55392,"OE'EKAM, AMANUBAN TIMUR, TIMOR TENGAH SELATAN, NUSA TENGGARA TIMUR",1,188,49,237
https://kawalpemilu.org#55392,"OE'EKAM, AMANUBAN TIMUR, TIMOR TENGAH SELATAN, NUSA TENGGARA TIMUR",2,217,47,264
https://kawalpemilu.org#55392,"OE'EKAM, AMANUBAN TIMUR, TIMOR TENGAH SELATAN, NUSA TENGGARA TIMUR",3,157,13,170
https://kawalpemilu.org#55392,"OE'EKAM, AMANUBAN TIMUR, TIMOR TENGAH SELATAN, NUSA TENGGARA TIMUR",4,195,41,236
https://kawalpemilu.org#55392,"OE'EKAM, AMANUBAN TIMUR, TIMOR TENGAH SELATAN, NUSA TENGGARA TIMUR",5,226,15,241
https://kawalpemilu.org#55392,"OE'EKAM, AMANUBAN TIMUR, TIMOR TENGAH SELATAN, NUSA TENGGARA TIMUR",6,207,8,215
https://kawalpemilu.org#55393,"SINI, AMANUBAN TIMUR, TIMOR TENGAH SELATAN, NUSA TENGGARA TIMUR",1,112,7,119
https://kawalpemilu.org#55393,"SINI, AMANUBAN TIMUR, TIMOR TENGAH SELATAN, NUSA TENGGARA TIMUR",2,126,5,131
https://kawalpemilu.org#55394,"TLIU, AMANUBAN TIMUR, TIMOR TENGAH SELATAN, NUSA TENGGARA TIMUR",1,178,41,219
https://kawalpemilu.org#55394,"TLIU, AMANUBAN TIMUR, TIMOR TENGAH SELATAN, NUSA TENGGARA TIMUR",2,122,27,149
https://kawalpemilu.org#55396,"NIKI-NIKI, AMANUBAN TENGAH, TIMOR TENGAH SELATAN, NUSA TENGGARA TIMUR",1,219,15,234
https://kawalpemilu.org#55396,"NIKI-NIKI, AMANUBAN TENGAH, TIMOR TENGAH SELATAN, NUSA TENGGARA TIMUR",2,213,19,232
https://kawalpemilu.org#55396,"NIKI-NIKI, AMANUBAN TENGAH, TIMOR TENGAH SELATAN, NUSA TENGGARA TIMUR",3,225,26,251
https://kawalpemilu.org#55396,"NIKI-NIKI, AMANUBAN TENGAH, TIMOR TENGAH SELATAN, NUSA TENGGARA TIMUR",4,212,15,227
https://kawalpemilu.org#55396,"NIKI-NIKI, AMANUBAN TENGAH, TIMOR TENGAH SELATAN, NUSA TENGGARA TIMUR",5,168,76,244
https://kawalpemilu.org#55396,"NIKI-NIKI, AMANUBAN TENGAH, TIMOR TENGAH SELATAN, NUSA TENGGARA TIMUR",6,204,35,239
https://kawalpemilu.org#55396,"NIKI-NIKI, AMANUBAN TENGAH, TIMOR TENGAH SELATAN, NUSA TENGGARA TIMUR",7,202,2,204
https://kawalpemilu.org#55397,"TAEBESA, AMANUBAN TENGAH, TIMOR TENGAH SELATAN, NUSA TENGGARA TIMUR",1,223,12,235
https://kawalpemilu.org#55397,"TAEBESA, AMANUBAN TENGAH, TIMOR TENGAH SELATAN, NUSA TENGGARA TIMUR",2,202,6,208
https://kawalpemilu.org#55398,"NAKFUNU, AMANUBAN TENGAH, TIMOR TENGAH SELATAN, NUSA TENGGARA TIMUR",1,229,4,233
https://kawalpemilu.org#55398,"NAKFUNU, AMANUBAN TENGAH, TIMOR TENGAH SELATAN, NUSA TENGGARA TIMUR",2,199,1,200
https://kawalpemilu.org#55399,"OE'EKAM, AMANUBAN TENGAH, TIMOR TENGAH SELATAN, NUSA TENGGARA TIMUR",1,181,14,195
https://kawalpemilu.org#55399,"OE'EKAM, AMANUBAN TENGAH, TIMOR TENGAH SELATAN, NUSA TENGGARA TIMUR",2,192,3,195
https://kawalpemilu.org#55400,"BAKI, AMANUBAN TENGAH, TIMOR TENGAH SELATAN, NUSA TENGGARA TIMUR",1,193,12,205
https://kawalpemilu.org#55400,"BAKI, AMANUBAN TENGAH, TIMOR TENGAH SELATAN, NUSA TENGGARA TIMUR",2,207,7,214
https://kawalpemilu.org#55401,"TUMU, AMANUBAN TENGAH, TIMOR TENGAH SELATAN, NUSA TENGGARA TIMUR",1,194,20,214
https://kawalpemilu.org#55401,"TUMU, AMANUBAN TENGAH, TIMOR TENGAH SELATAN, NUSA TENGGARA TIMUR",2,162,3,165
https://kawalpemilu.org#55401,"TUMU, AMANUBAN TENGAH, TIMOR TENGAH SELATAN, NUSA TENGGARA TIMUR",3,161,29,190
https://kawalpemilu.org#55401,"TUMU, AMANUBAN TENGAH, TIMOR TENGAH SELATAN, NUSA TENGGARA TIMUR",4,149,8,157
https://kawalpemilu.org#55402,"NOEBESA, AMANUBAN TENGAH, TIMOR TENGAH SELATAN, NUSA TENGGARA TIMUR",1,183,10,193
https://kawalpemilu.org#55402,"NOEBESA, AMANUBAN TENGAH, TIMOR TENGAH SELATAN, NUSA TENGGARA TIMUR",2,159,5,164
https://kawalpemilu.org#55403,"NOBI-NOBI, AMANUBAN TENGAH, TIMOR TENGAH SELATAN, NUSA TENGGARA TIMUR",1,242,20,262
https://kawalpemilu.org#55403,"NOBI-NOBI, AMANUBAN TENGAH, TIMOR TENGAH SELATAN, NUSA TENGGARA TIMUR",2,177,19,196
https://kawalpemilu.org#55403,"NOBI-NOBI, AMANUBAN TENGAH, TIMOR TENGAH SELATAN, NUSA TENGGARA TIMUR",3,152,6,158
https://kawalpemilu.org#55403,"NOBI-NOBI, AMANUBAN TENGAH, TIMOR TENGAH SELATAN, NUSA TENGGARA TIMUR",4,173,6,179
https://kawalpemilu.org#55403,"NOBI-NOBI, AMANUBAN TENGAH, TIMOR TENGAH SELATAN, NUSA TENGGARA TIMUR",5,232,25,257
https://kawalpemilu.org#55403,"NOBI-NOBI, AMANUBAN TENGAH, TIMOR TENGAH SELATAN, NUSA TENGGARA TIMUR",6,224,19,243
https://kawalpemilu.org#55403,"NOBI-NOBI, AMANUBAN TENGAH, TIMOR TENGAH SELATAN, NUSA TENGGARA TIMUR",7,214,18,232
https://kawalpemilu.org#55403,"NOBI-NOBI, AMANUBAN TENGAH, TIMOR TENGAH SELATAN, NUSA TENGGARA TIMUR",8,201,9,210
https://kawalpemilu.org#55404,"SOPO, AMANUBAN TENGAH, TIMOR TENGAH SELATAN, NUSA TENGGARA TIMUR",1,197,2,199
https://kawalpemilu.org#55404,"SOPO, AMANUBAN TENGAH, TIMOR TENGAH SELATAN, NUSA TENGGARA TIMUR",2,207,6,213
https://kawalpemilu.org#55404,"SOPO, AMANUBAN TENGAH, TIMOR TENGAH SELATAN, NUSA TENGGARA TIMUR",3,213,5,218
https://kawalpemilu.org#55404,"SOPO, AMANUBAN TENGAH, TIMOR TENGAH SELATAN, NUSA TENGGARA TIMUR",4,170,4,174
https://kawalpemilu.org#55405,"BONE, AMANUBAN TENGAH, TIMOR TENGAH SELATAN, NUSA TENGGARA TIMUR",1,167,8,175
https://kawalpemilu.org#55405,"BONE, AMANUBAN TENGAH, TIMOR TENGAH SELATAN, NUSA TENGGARA TIMUR",2,160,3,163
https://kawalpemilu.org#55405,"BONE, AMANUBAN TENGAH, TIMOR TENGAH SELATAN, NUSA TENGGARA TIMUR",3,170,2,172
https://kawalpemilu.org#55406,"MAUNUM NIKI-NIKI, AMANUBAN TENGAH, TIMOR TENGAH SELATAN, NUSA TENGGARA TIMUR",1,203,7,210
https://kawalpemilu.org#55406,"MAUNUM NIKI-NIKI, AMANUBAN TENGAH, TIMOR TENGAH SELATAN, NUSA TENGGARA TIMUR",2,224,4,228
https://kawalpemilu.org#55406,"MAUNUM NIKI-NIKI, AMANUBAN TENGAH, TIMOR TENGAH SELATAN, NUSA TENGGARA TIMUR",3,186,4,190
https://kawalpemilu.org#55406,"MAUNUM NIKI-NIKI, AMANUBAN TENGAH, TIMOR TENGAH SELATAN, NUSA TENGGARA TIMUR",4,175,1,176
https://kawalpemilu.org#55406,"MAUNUM NIKI-NIKI, AMANUBAN TENGAH, TIMOR TENGAH SELATAN, NUSA TENGGARA TIMUR",5,174,10,184
https://kawalpemilu.org#55408,"POLLO, AMANUBAN SELATAN, TIMOR TENGAH SELATAN, NUSA TENGGARA TIMUR",1,238,18,256
https://kawalpemilu.org#55408,"POLLO, AMANUBAN SELATAN, TIMOR TENGAH SELATAN, NUSA TENGGARA TIMUR",2,210,35,245
https://kawalpemilu.org#55408,"POLLO, AMANUBAN SELATAN, TIMOR TENGAH SELATAN, NUSA TENGGARA TIMUR",3,247,8,255
https://kawalpemilu.org#55408,"POLLO, AMANUBAN SELATAN, TIMOR TENGAH SELATAN, NUSA TENGGARA TIMUR",4,217,16,233
https://kawalpemilu.org#55408,"POLLO, AMANUBAN SELATAN, TIMOR TENGAH SELATAN, NUSA TENGGARA TIMUR",5,203,11,214
https://kawalpemilu.org#55408,"POLLO, AMANUBAN SELATAN, TIMOR TENGAH SELATAN, NUSA TENGGARA TIMUR",6,212,4,216
https://kawalpemilu.org#55408,"POLLO, AMANUBAN SELATAN, TIMOR TENGAH SELATAN, NUSA TENGGARA TIMUR",7,233,10,243
https://kawalpemilu.org#55408,"POLLO, AMANUBAN SELATAN, TIMOR TENGAH SELATAN, NUSA TENGGARA TIMUR",8,180,15,195
https://kawalpemilu.org#55408,"POLLO, AMANUBAN SELATAN, TIMOR TENGAH SELATAN, NUSA TENGGARA TIMUR",9,243,13,256
https://kawalpemilu.org#55408,"POLLO, AMANUBAN SELATAN, TIMOR TENGAH SELATAN, NUSA TENGGARA TIMUR",10,160,7,167
https://kawalpemilu.org#55409,"OEKIU, AMANUBAN SELATAN, TIMOR TENGAH SELATAN, NUSA TENGGARA TIMUR",1,207,4,211
https://kawalpemilu.org#55409,"OEKIU, AMANUBAN SELATAN, TIMOR TENGAH SELATAN, NUSA TENGGARA TIMUR",2,221,20,241
https://kawalpemilu.org#55409,"OEKIU, AMANUBAN SELATAN, TIMOR TENGAH SELATAN, NUSA TENGGARA TIMUR",3,198,7,205
https://kawalpemilu.org#55410,"OEBELO, AMANUBAN SELATAN, TIMOR TENGAH SELATAN, NUSA TENGGARA TIMUR",1,225,20,245
https://kawalpemilu.org#55410,"OEBELO, AMANUBAN SELATAN, TIMOR TENGAH SELATAN, NUSA TENGGARA TIMUR",2,216,15,231
https://kawalpemilu.org#55410,"OEBELO, AMANUBAN SELATAN, TIMOR TENGAH SELATAN, NUSA TENGGARA TIMUR",3,226,5,231
https://kawalpemilu.org#55410,"OEBELO, AMANUBAN SELATAN, TIMOR TENGAH SELATAN, NUSA TENGGARA TIMUR",4,231,5,236
https://kawalpemilu.org#55410,"OEBELO, AMANUBAN SELATAN, TIMOR TENGAH SELATAN, NUSA TENGGARA TIMUR",5,191,8,199
https://kawalpemilu.org#55410,"OEBELO, AMANUBAN SELATAN, TIMOR TENGAH SELATAN, NUSA TENGGARA TIMUR",6,212,18,230
https://kawalpemilu.org#55410,"OEBELO, AMANUBAN SELATAN, TIMOR TENGAH SELATAN, NUSA TENGGARA TIMUR",7,222,10,232
https://kawalpemilu.org#55410,"OEBELO, AMANUBAN SELATAN, TIMOR TENGAH SELATAN, NUSA TENGGARA TIMUR",8,223,8,231
https://kawalpemilu.org#55411,"NOEMUKE, AMANUBAN SELATAN, TIMOR TENGAH SELATAN, NUSA TENGGARA TIMUR",1,218,7,225
https://kawalpemilu.org#55411,"NOEMUKE, AMANUBAN SELATAN, TIMOR TENGAH SELATAN, NUSA TENGGARA TIMUR",2,221,2,223
https://kawalpemilu.org#55411,"NOEMUKE, AMANUBAN SELATAN, TIMOR TENGAH SELATAN, NUSA TENGGARA TIMUR",3,208,20,228
https://kawalpemilu.org#55411,"NOEMUKE, AMANUBAN SELATAN, TIMOR TENGAH SELATAN, NUSA TENGGARA TIMUR",4,190,3,193
https://kawalpemilu.org#55411,"NOEMUKE, AMANUBAN SELATAN, TIMOR TENGAH SELATAN, NUSA TENGGARA TIMUR",6,165,4,169
https://kawalpemilu.org#55411,"NOEMUKE, AMANUBAN SELATAN, TIMOR TENGAH SELATAN, NUSA TENGGARA TIMUR",7,117,1,118
https://kawalpemilu.org#55412,"KIUBAAT, AMANUBAN SELATAN, TIMOR TENGAH SELATAN, NUSA TENGGARA TIMUR",1,224,9,233
https://kawalpemilu.org#55412,"KIUBAAT, AMANUBAN SELATAN, TIMOR TENGAH SELATAN, NUSA TENGGARA TIMUR",2,207,9,216
https://kawalpemilu.org#55412,"KIUBAAT, AMANUBAN SELATAN, TIMOR TENGAH SELATAN, NUSA TENGGARA TIMUR",3,203,3,206
https://kawalpemilu.org#55412,"KIUBAAT, AMANUBAN SELATAN, TIMOR TENGAH SELATAN, NUSA TENGGARA TIMUR",4,209,3,212
https://kawalpemilu.org#55413,"LINAMNUTU, AMANUBAN SELATAN, TIMOR TENGAH SELATAN, NUSA TENGGARA TIMUR",1,199,13,212
https://kawalpemilu.org#55413,"LINAMNUTU, AMANUBAN SELATAN, TIMOR TENGAH SELATAN, NUSA TENGGARA TIMUR",2,206,9,215
https://kawalpemilu.org#55413,"LINAMNUTU, AMANUBAN SELATAN, TIMOR TENGAH SELATAN, NUSA TENGGARA TIMUR",3,212,1,213
https://kawalpemilu.org#55413,"LINAMNUTU, AMANUBAN SELATAN, TIMOR TENGAH SELATAN, NUSA TENGGARA TIMUR",4,172,20,192
https://kawalpemilu.org#55413,"LINAMNUTU, AMANUBAN SELATAN, TIMOR TENGAH SELATAN, NUSA TENGGARA TIMUR",5,143,12,155
https://kawalpemilu.org#55413,"LINAMNUTU, AMANUBAN SELATAN, TIMOR TENGAH SELATAN, NUSA TENGGARA TIMUR",6,178,8,186
https://kawalpemilu.org#55414,"MIO, AMANUBAN SELATAN, TIMOR TENGAH SELATAN, NUSA TENGGARA TIMUR",1,207,18,225
https://kawalpemilu.org#55414,"MIO, AMANUBAN SELATAN, TIMOR TENGAH SELATAN, NUSA TENGGARA TIMUR",2,162,4,166
https://kawalpemilu.org#55414,"MIO, AMANUBAN SELATAN, TIMOR TENGAH SELATAN, NUSA TENGGARA TIMUR",3,155,7,162
https://kawalpemilu.org#55414,"MIO, AMANUBAN SELATAN, TIMOR TENGAH SELATAN, NUSA TENGGARA TIMUR",4,121,2,123
https://kawalpemilu.org#55414,"MIO, AMANUBAN SELATAN, TIMOR TENGAH SELATAN, NUSA TENGGARA TIMUR",5,124,2,126
https://kawalpemilu.org#55415,"BATNUN, AMANUBAN SELATAN, TIMOR TENGAH SELATAN, NUSA TENGGARA TIMUR",1,209,5,214
https://kawalpemilu.org#55415,"BATNUN, AMANUBAN SELATAN, TIMOR TENGAH SELATAN, NUSA TENGGARA TIMUR",2,217,13,230
https://kawalpemilu.org#55415,"BATNUN, AMANUBAN SELATAN, TIMOR TENGAH SELATAN, NUSA TENGGARA TIMUR",3,155,10,165
https://kawalpemilu.org#55415,"BATNUN, AMANUBAN SELATAN, TIMOR TENGAH SELATAN, NUSA TENGGARA TIMUR",4,159,4,163
https://kawalpemilu.org#55415,"BATNUN, AMANUBAN SELATAN, TIMOR TENGAH SELATAN, NUSA TENGGARA TIMUR",5,220,7,227
https://kawalpemilu.org#55415,"BATNUN, AMANUBAN SELATAN, TIMOR TENGAH SELATAN, NUSA TENGGARA TIMUR",6,212,8,220
https://kawalpemilu.org#55416,"BENA, AMANUBAN SELATAN, TIMOR TENGAH SELATAN, NUSA TENGGARA TIMUR",1,176,31,207
https://kawalpemilu.org#55416,"BENA, AMANUBAN SELATAN, TIMOR TENGAH SELATAN, NUSA TENGGARA TIMUR",2,269,9,278
https://kawalpemilu.org#55416,"BENA, AMANUBAN SELATAN, TIMOR TENGAH SELATAN, NUSA TENGGARA TIMUR",3,263,12,275
https://kawalpemilu.org#55416,"BENA, AMANUBAN SELATAN, TIMOR TENGAH SELATAN, NUSA TENGGARA TIMUR",4,230,6,236
https://kawalpemilu.org#55416,"BENA, AMANUBAN SELATAN, TIMOR TENGAH SELATAN, NUSA TENGGARA TIMUR",5,193,8,201
https://kawalpemilu.org#55416,"BENA, AMANUBAN SELATAN, TIMOR TENGAH SELATAN, NUSA TENGGARA TIMUR",6,197,11,208
https://kawalpemilu.org#55416,"BENA, AMANUBAN SELATAN, TIMOR TENGAH SELATAN, NUSA TENGGARA TIMUR",7,148,2,150
https://kawalpemilu.org#55416,"BENA, AMANUBAN SELATAN, TIMOR TENGAH SELATAN, NUSA TENGGARA TIMUR",8,173,5,178
https://kawalpemilu.org#55417,"ENO NETEN, AMANUBAN SELATAN, TIMOR TENGAH SELATAN, NUSA TENGGARA TIMUR",1,229,10,239
https://kawalpemilu.org#55417,"ENO NETEN, AMANUBAN SELATAN, TIMOR TENGAH SELATAN, NUSA TENGGARA TIMUR",2,125,3,128
https://kawalpemilu.org#55417,"ENO NETEN, AMANUBAN SELATAN, TIMOR TENGAH SELATAN, NUSA TENGGARA TIMUR",3,125,3,128
https://kawalpemilu.org#55417,"ENO NETEN, AMANUBAN SELATAN, TIMOR TENGAH SELATAN, NUSA TENGGARA TIMUR",4,169,9,178
https://kawalpemilu.org#55419,"TUBLOPO, AMANUBAN BARAT, TIMOR TENGAH SELATAN, NUSA TENGGARA TIMUR",1,207,4,211
https://kawalpemilu.org#55419,"TUBLOPO, AMANUBAN BARAT, TIMOR TENGAH SELATAN, NUSA TENGGARA TIMUR",2,204,7,211
https://kawalpemilu.org#55419,"TUBLOPO, AMANUBAN BARAT, TIMOR TENGAH SELATAN, NUSA TENGGARA TIMUR",3,202,7,209
https://kawalpemilu.org#55419,"TUBLOPO, AMANUBAN BARAT, TIMOR TENGAH SELATAN, NUSA TENGGARA TIMUR",4,215,9,224
https://kawalpemilu.org#55419,"TUBLOPO, AMANUBAN BARAT, TIMOR TENGAH SELATAN, NUSA TENGGARA TIMUR",6,154,6,160
https://kawalpemilu.org#55420,"NULE, AMANUBAN BARAT, TIMOR TENGAH SELATAN, NUSA TENGGARA TIMUR",1,183,28,211
https://kawalpemilu.org#55420,"NULE, AMANUBAN BARAT, TIMOR TENGAH SELATAN, NUSA TENGGARA TIMUR",2,190,15,205
https://kawalpemilu.org#55420,"NULE, AMANUBAN BARAT, TIMOR TENGAH SELATAN, NUSA TENGGARA TIMUR",3,148,28,176
https://kawalpemilu.org#55420,"NULE, AMANUBAN BARAT, TIMOR TENGAH SELATAN, NUSA TENGGARA TIMUR",4,155,39,194
https://kawalpemilu.org#55420,"NULE, AMANUBAN BARAT, TIMOR TENGAH SELATAN, NUSA TENGGARA TIMUR",5,47,180,227
https://kawalpemilu.org#55420,"NULE, AMANUBAN BARAT, TIMOR TENGAH SELATAN, NUSA TENGGARA TIMUR",6,225,11,236
https://kawalpemilu.org#55420,"NULE, AMANUBAN BARAT, TIMOR TENGAH SELATAN, NUSA TENGGARA TIMUR",7,212,10,222
https://kawalpemilu.org#55420,"NULE, AMANUBAN BARAT, TIMOR TENGAH SELATAN, NUSA TENGGARA TIMUR",8,116,79,195
https://kawalpemilu.org#55420,"NULE, AMANUBAN BARAT, TIMOR TENGAH SELATAN, NUSA TENGGARA TIMUR",9,149,71,220
https://kawalpemilu.org#55420,"NULE, AMANUBAN BARAT, TIMOR TENGAH SELATAN, NUSA TENGGARA TIMUR",10,218,5,223
https://kawalpemilu.org#55421,"NUSA, AMANUBAN BARAT, TIMOR TENGAH SELATAN, NUSA TENGGARA TIMUR",1,203,8,211
https://kawalpemilu.org#55421,"NUSA, AMANUBAN BARAT, TIMOR TENGAH SELATAN, NUSA TENGGARA TIMUR",2,231,1,232
https://kawalpemilu.org#55421,"NUSA, AMANUBAN BARAT, TIMOR TENGAH SELATAN, NUSA TENGGARA TIMUR",3,215,10,225
https://kawalpemilu.org#55421,"NUSA, AMANUBAN BARAT, TIMOR TENGAH SELATAN, NUSA TENGGARA TIMUR",4,218,4,222
https://kawalpemilu.org#55421,"NUSA, AMANUBAN BARAT, TIMOR TENGAH SELATAN, NUSA TENGGARA TIMUR",5,193,3,196
https://kawalpemilu.org#55422,"MNELALETE, AMANUBAN BARAT, TIMOR TENGAH SELATAN, NUSA TENGGARA TIMUR",2,224,27,251
https://kawalpemilu.org#55422,"MNELALETE, AMANUBAN BARAT, TIMOR TENGAH SELATAN, NUSA TENGGARA TIMUR",3,199,11,210
https://kawalpemilu.org#55422,"MNELALETE, AMANUBAN BARAT, TIMOR TENGAH SELATAN, NUSA TENGGARA TIMUR",4,219,16,235
https://kawalpemilu.org#55422,"MNELALETE, AMANUBAN BARAT, TIMOR TENGAH SELATAN, NUSA TENGGARA TIMUR",5,192,24,216
https://kawalpemilu.org#55422,"MNELALETE, AMANUBAN BARAT, TIMOR TENGAH SELATAN, NUSA TENGGARA TIMUR",6,161,2,163
https://kawalpemilu.org#55422,"MNELALETE, AMANUBAN BARAT, TIMOR TENGAH SELATAN, NUSA TENGGARA TIMUR",7,172,27,199
https://kawalpemilu.org#55422,"MNELALETE, AMANUBAN BARAT, TIMOR TENGAH SELATAN, NUSA TENGGARA TIMUR",8,240,10,250
https://kawalpemilu.org#55422,"MNELALETE, AMANUBAN BARAT, TIMOR TENGAH SELATAN, NUSA TENGGARA TIMUR",9,216,15,231
https://kawalpemilu.org#55422,"MNELALETE, AMANUBAN BARAT, TIMOR TENGAH SELATAN, NUSA TENGGARA TIMUR",10,200,15,215
https://kawalpemilu.org#55422,"MNELALETE, AMANUBAN BARAT, TIMOR TENGAH SELATAN, NUSA TENGGARA TIMUR",11,162,9,171
https://kawalpemilu.org#55422,"MNELALETE, AMANUBAN BARAT, TIMOR TENGAH SELATAN, NUSA TENGGARA TIMUR",12,214,9,223
https://kawalpemilu.org#55422,"MNELALETE, AMANUBAN BARAT, TIMOR TENGAH SELATAN, NUSA TENGGARA TIMUR",13,208,14,222
https://kawalpemilu.org#55422,"MNELALETE, AMANUBAN BARAT, TIMOR TENGAH SELATAN, NUSA TENGGARA TIMUR",14,170,7,177
https://kawalpemilu.org#55422,"MNELALETE, AMANUBAN BARAT, TIMOR TENGAH SELATAN, NUSA TENGGARA TIMUR",15,187,28,215
https://kawalpemilu.org#55422,"MNELALETE, AMANUBAN BARAT, TIMOR TENGAH SELATAN, NUSA TENGGARA TIMUR",16,231,27,258
https://kawalpemilu.org#55422,"MNELALETE, AMANUBAN BARAT, TIMOR TENGAH SELATAN, NUSA TENGGARA TIMUR",17,190,24,214
https://kawalpemilu.org#55423,"PUSU, AMANUBAN BARAT, TIMOR TENGAH SELATAN, NUSA TENGGARA TIMUR",1,196,20,216
https://kawalpemilu.org#55423,"PUSU, AMANUBAN BARAT, TIMOR TENGAH SELATAN, NUSA TENGGARA TIMUR",2,189,8,197
https://kawalpemilu.org#55423,"PUSU, AMANUBAN BARAT, TIMOR TENGAH SELATAN, NUSA TENGGARA TIMUR",3,204,17,221
https://kawalpemilu.org#55423,"PUSU, AMANUBAN BARAT, TIMOR TENGAH SELATAN, NUSA TENGGARA TIMUR",4,200,7,207
https://kawalpemilu.org#55423,"PUSU, AMANUBAN BARAT, TIMOR TENGAH SELATAN, NUSA TENGGARA TIMUR",5,187,5,192
https://kawalpemilu.org#55424,"TUBUHUE, AMANUBAN BARAT, TIMOR TENGAH SELATAN, NUSA TENGGARA TIMUR",1,243,9,252
https://kawalpemilu.org#55424,"TUBUHUE, AMANUBAN BARAT, TIMOR TENGAH SELATAN, NUSA TENGGARA TIMUR",2,229,11,240
https://kawalpemilu.org#55424,"TUBUHUE, AMANUBAN BARAT, TIMOR TENGAH SELATAN, NUSA TENGGARA TIMUR",3,223,18,241
https://kawalpemilu.org#55424,"TUBUHUE, AMANUBAN BARAT, TIMOR TENGAH SELATAN, NUSA TENGGARA TIMUR",4,231,11,242
https://kawalpemilu.org#55424,"TUBUHUE, AMANUBAN BARAT, TIMOR TENGAH SELATAN, NUSA TENGGARA TIMUR",5,0,0,0
https://kawalpemilu.org#55424,"TUBUHUE, AMANUBAN BARAT, TIMOR TENGAH SELATAN, NUSA TENGGARA TIMUR",6,234,21,255
https://kawalpemilu.org#55424,"TUBUHUE, AMANUBAN BARAT, TIMOR TENGAH SELATAN, NUSA TENGGARA TIMUR",7,175,16,191
https://kawalpemilu.org#55425,"HAUMENI BAKI, AMANUBAN BARAT, TIMOR TENGAH SELATAN, NUSA TENGGARA TIMUR",1,221,9,230
https://kawalpemilu.org#55425,"HAUMENI BAKI, AMANUBAN BARAT, TIMOR TENGAH SELATAN, NUSA TENGGARA TIMUR",2,181,13,194
https://kawalpemilu.org#55425,"HAUMENI BAKI, AMANUBAN BARAT, TIMOR TENGAH SELATAN, NUSA TENGGARA TIMUR",3,201,2,203
https://kawalpemilu.org#91062,"NIFUKANI, AMANUBAN BARAT, TIMOR TENGAH SELATAN, NUSA TENGGARA TIMUR",1,201,19,220
https://kawalpemilu.org#91062,"NIFUKANI, AMANUBAN BARAT, TIMOR TENGAH SELATAN, NUSA TENGGARA TIMUR",2,203,17,220
https://kawalpemilu.org#91062,"NIFUKANI, AMANUBAN BARAT, TIMOR TENGAH SELATAN, NUSA TENGGARA TIMUR",3,237,5,242
https://kawalpemilu.org#91062,"NIFUKANI, AMANUBAN BARAT, TIMOR TENGAH SELATAN, NUSA TENGGARA TIMUR",4,237,16,253
https://kawalpemilu.org#91062,"NIFUKANI, AMANUBAN BARAT, TIMOR TENGAH SELATAN, NUSA TENGGARA TIMUR",5,191,2,193
https://kawalpemilu.org#55427,"OINLASI, AMANATUN SELATAN, TIMOR TENGAH SELATAN, NUSA TENGGARA TIMUR",1,125,16,141
https://kawalpemilu.org#55427,"OINLASI, AMANATUN SELATAN, TIMOR TENGAH SELATAN, NUSA TENGGARA TIMUR",2,95,14,109
https://kawalpemilu.org#55427,"OINLASI, AMANATUN SELATAN, TIMOR TENGAH SELATAN, NUSA TENGGARA TIMUR",3,221,12,233
https://kawalpemilu.org#55427,"OINLASI, AMANATUN SELATAN, TIMOR TENGAH SELATAN, NUSA TENGGARA TIMUR",4,183,9,192
https://kawalpemilu.org#55427,"OINLASI, AMANATUN SELATAN, TIMOR TENGAH SELATAN, NUSA TENGGARA TIMUR",5,195,28,223
https://kawalpemilu.org#55427,"OINLASI, AMANATUN SELATAN, TIMOR TENGAH SELATAN, NUSA TENGGARA TIMUR",6,93,10,103
https://kawalpemilu.org#55427,"OINLASI, AMANATUN SELATAN, TIMOR TENGAH SELATAN, NUSA TENGGARA TIMUR",7,95,3,98
https://kawalpemilu.org#55428,"NUNLEU, AMANATUN SELATAN, TIMOR TENGAH SELATAN, NUSA TENGGARA TIMUR",1,214,12,226
https://kawalpemilu.org#55428,"NUNLEU, AMANATUN SELATAN, TIMOR TENGAH SELATAN, NUSA TENGGARA TIMUR",2,211,7,218
https://kawalpemilu.org#55428,"NUNLEU, AMANATUN SELATAN, TIMOR TENGAH SELATAN, NUSA TENGGARA TIMUR",3,199,6,205
https://kawalpemilu.org#55428,"NUNLEU, AMANATUN SELATAN, TIMOR TENGAH SELATAN, NUSA TENGGARA TIMUR",4,149,8,157
https://kawalpemilu.org#55428,"NUNLEU, AMANATUN SELATAN, TIMOR TENGAH SELATAN, NUSA TENGGARA TIMUR",5,123,11,134
https://kawalpemilu.org#55428,"NUNLEU, AMANATUN SELATAN, TIMOR TENGAH SELATAN, NUSA TENGGARA TIMUR",6,66,3,69
https://kawalpemilu.org#55429,"KOKOI, AMANATUN SELATAN, TIMOR TENGAH SELATAN, NUSA TENGGARA TIMUR",1,231,11,242
https://kawalpemilu.org#55429,"KOKOI, AMANATUN SELATAN, TIMOR TENGAH SELATAN, NUSA TENGGARA TIMUR",2,196,15,211
https://kawalpemilu.org#55429,"KOKOI, AMANATUN SELATAN, TIMOR TENGAH SELATAN, NUSA TENGGARA TIMUR",3,145,4,149
https://kawalpemilu.org#55429,"KOKOI, AMANATUN SELATAN, TIMOR TENGAH SELATAN, NUSA TENGGARA TIMUR",4,77,4,81
https://kawalpemilu.org#55430,"FENUN, AMANATUN SELATAN, TIMOR TENGAH SELATAN, NUSA TENGGARA TIMUR",1,174,10,184
https://kawalpemilu.org#55430,"FENUN, AMANATUN SELATAN, TIMOR TENGAH SELATAN, NUSA TENGGARA TIMUR",2,159,8,167
https://kawalpemilu.org#55430,"FENUN, AMANATUN SELATAN, TIMOR TENGAH SELATAN, NUSA TENGGARA TIMUR",3,176,4,180
https://kawalpemilu.org#55430,"FENUN, AMANATUN SELATAN, TIMOR TENGAH SELATAN, NUSA TENGGARA TIMUR",4,161,6,167
https://kawalpemilu.org#55430,"FENUN, AMANATUN SELATAN, TIMOR TENGAH SELATAN, NUSA TENGGARA TIMUR",5,121,12,133
https://kawalpemilu.org#55431,"KUALEU, AMANATUN SELATAN, TIMOR TENGAH SELATAN, NUSA TENGGARA TIMUR",1,210,5,215
https://kawalpemilu.org#55431,"KUALEU, AMANATUN SELATAN, TIMOR TENGAH SELATAN, NUSA TENGGARA TIMUR",2,178,4,182
https://kawalpemilu.org#55431,"KUALEU, AMANATUN SELATAN, TIMOR TENGAH SELATAN, NUSA TENGGARA TIMUR",3,165,6,171
https://kawalpemilu.org#55431,"KUALEU, AMANATUN SELATAN, TIMOR TENGAH SELATAN, NUSA TENGGARA TIMUR",4,189,0,189
https://kawalpemilu.org#55432,"LANU, AMANATUN SELATAN, TIMOR TENGAH SELATAN, NUSA TENGGARA TIMUR",1,164,1,165
https://kawalpemilu.org#55432,"LANU, AMANATUN SELATAN, TIMOR TENGAH SELATAN, NUSA TENGGARA TIMUR",2,172,7,179
https://kawalpemilu.org#55432,"LANU, AMANATUN SELATAN, TIMOR TENGAH SELATAN, NUSA TENGGARA TIMUR",3,155,6,161
https://kawalpemilu.org#55433,"SUNU, AMANATUN SELATAN, TIMOR TENGAH SELATAN, NUSA TENGGARA TIMUR",1,225,12,237
https://kawalpemilu.org#55433,"SUNU, AMANATUN SELATAN, TIMOR TENGAH SELATAN, NUSA TENGGARA TIMUR",2,115,3,118
https://kawalpemilu.org#55433,"SUNU, AMANATUN SELATAN, TIMOR TENGAH SELATAN, NUSA TENGGARA TIMUR",3,200,10,210
https://kawalpemilu.org#55433,"SUNU, AMANATUN SELATAN, TIMOR TENGAH SELATAN, NUSA TENGGARA TIMUR",4,102,4,106
https://kawalpemilu.org#55434,"ANIN, AMANATUN SELATAN, TIMOR TENGAH SELATAN, NUSA TENGGARA TIMUR",1,226,13,239
https://kawalpemilu.org#55434,"ANIN, AMANATUN SELATAN, TIMOR TENGAH SELATAN, NUSA TENGGARA TIMUR",2,217,14,231
https://kawalpemilu.org#55434,"ANIN, AMANATUN SELATAN, TIMOR TENGAH SELATAN, NUSA TENGGARA TIMUR",3,130,3,133
https://kawalpemilu.org#55434,"ANIN, AMANATUN SELATAN, TIMOR TENGAH SELATAN, NUSA TENGGARA TIMUR",4,91,4,95
https://kawalpemilu.org#55435,"TO'I, AMANATUN SELATAN, TIMOR TENGAH SELATAN, NUSA TENGGARA TIMUR",1,182,23,205
https://kawalpemilu.org#55435,"TO'I, AMANATUN SELATAN, TIMOR TENGAH SELATAN, NUSA TENGGARA TIMUR",2,162,14,176
https://kawalpemilu.org#55435,"TO'I, AMANATUN SELATAN, TIMOR TENGAH SELATAN, NUSA TENGGARA TIMUR",3,94,5,99
https://kawalpemilu.org#55436,"NIFULEO, AMANATUN SELATAN, TIMOR TENGAH SELATAN, NUSA TENGGARA TIMUR",1,148,18,166
https://kawalpemilu.org#55436,"NIFULEO, AMANATUN SELATAN, TIMOR TENGAH SELATAN, NUSA TENGGARA TIMUR",2,165,15,180
https://kawalpemilu.org#55436,"NIFULEO, AMANATUN SELATAN, TIMOR TENGAH SELATAN, NUSA TENGGARA TIMUR",3,167,5,172
https://kawalpemilu.org#55437,"FATULUNU, AMANATUN SELATAN, TIMOR TENGAH SELATAN, NUSA TENGGARA TIMUR",1,175,5,180
https://kawalpemilu.org#55437,"FATULUNU, AMANATUN SELATAN, TIMOR TENGAH SELATAN, NUSA TENGGARA TIMUR",2,203,5,208
https://kawalpemilu.org#55437,"FATULUNU, AMANATUN SELATAN, TIMOR TENGAH SELATAN, NUSA TENGGARA TIMUR",3,181,1,182
https://kawalpemilu.org#55438,"FAE, AMANATUN SELATAN, TIMOR TENGAH SELATAN, NUSA TENGGARA TIMUR",1,228,8,236
https://kawalpemilu.org#55438,"FAE, AMANATUN SELATAN, TIMOR TENGAH SELATAN, NUSA TENGGARA TIMUR",2,143,3,146
https://kawalpemilu.org#55439,"NETUTNANA, AMANATUN SELATAN, TIMOR TENGAH SELATAN, NUSA TENGGARA TIMUR",1,150,3,153
https://kawalpemilu.org#55439,"NETUTNANA, AMANATUN SELATAN, TIMOR TENGAH SELATAN, NUSA TENGGARA TIMUR",2,163,17,180
https://kawalpemilu.org#55439,"NETUTNANA, AMANATUN SELATAN, TIMOR TENGAH SELATAN, NUSA TENGGARA TIMUR",3,165,8,173
https://kawalpemilu.org#55441,"LILO, AMANATUN UTARA, TIMOR TENGAH SELATAN, NUSA TENGGARA TIMUR",1,148,5,153
https://kawalpemilu.org#55441,"LILO, AMANATUN UTARA, TIMOR TENGAH SELATAN, NUSA TENGGARA TIMUR",2,99,17,116
https://kawalpemilu.org#55441,"LILO, AMANATUN UTARA, TIMOR TENGAH SELATAN, NUSA TENGGARA TIMUR",3,145,15,160
https://kawalpemilu.org#55441,"LILO, AMANATUN UTARA, TIMOR TENGAH SELATAN, NUSA TENGGARA TIMUR",4,116,6,122
https://kawalpemilu.org#55441,"LILO, AMANATUN UTARA, TIMOR TENGAH SELATAN, NUSA TENGGARA TIMUR",5,136,14,150
https://kawalpemilu.org#55441,"LILO, AMANATUN UTARA, TIMOR TENGAH SELATAN, NUSA TENGGARA TIMUR",6,80,17,97
https://kawalpemilu.org#55442,"FOTILO, AMANATUN UTARA, TIMOR TENGAH SELATAN, NUSA TENGGARA TIMUR",1,134,8,142
https://kawalpemilu.org#55442,"FOTILO, AMANATUN UTARA, TIMOR TENGAH SELATAN, NUSA TENGGARA TIMUR",3,167,8,175
https://kawalpemilu.org#55442,"FOTILO, AMANATUN UTARA, TIMOR TENGAH SELATAN, NUSA TENGGARA TIMUR",4,128,6,134
https://kawalpemilu.org#55442,"FOTILO, AMANATUN UTARA, TIMOR TENGAH SELATAN, NUSA TENGGARA TIMUR",5,141,4,145
https://kawalpemilu.org#55442,"FOTILO, AMANATUN UTARA, TIMOR TENGAH SELATAN, NUSA TENGGARA TIMUR",6,116,4,120
https://kawalpemilu.org#55443,"NASI, AMANATUN UTARA, TIMOR TENGAH SELATAN, NUSA TENGGARA TIMUR",1,159,23,182
https://kawalpemilu.org#55443,"NASI, AMANATUN UTARA, TIMOR TENGAH SELATAN, NUSA TENGGARA TIMUR",2,142,11,153
https://kawalpemilu.org#55443,"NASI, AMANATUN UTARA, TIMOR TENGAH SELATAN, NUSA TENGGARA TIMUR",3,176,3,179
https://kawalpemilu.org#55443,"NASI, AMANATUN UTARA, TIMOR TENGAH SELATAN, NUSA TENGGARA TIMUR",4,150,10,160
https://kawalpemilu.org#55443,"NASI, AMANATUN UTARA, TIMOR TENGAH SELATAN, NUSA TENGGARA TIMUR",5,137,5,142
https://kawalpemilu.org#55444,"SNOK, AMANATUN UTARA, TIMOR TENGAH SELATAN, NUSA TENGGARA TIMUR",1,124,11,135
https://kawalpemilu.org#55444,"SNOK, AMANATUN UTARA, TIMOR TENGAH SELATAN, NUSA TENGGARA TIMUR",2,125,12,137
https://kawalpemilu.org#55444,"SNOK, AMANATUN UTARA, TIMOR TENGAH SELATAN, NUSA TENGGARA TIMUR",3,136,9,145
https://kawalpemilu.org#55444,"SNOK, AMANATUN UTARA, TIMOR TENGAH SELATAN, NUSA TENGGARA TIMUR",4,98,15,113
https://kawalpemilu.org#55444,"SNOK, AMANATUN UTARA, TIMOR TENGAH SELATAN, NUSA TENGGARA TIMUR",5,107,70,177
https://kawalpemilu.org#55444,"SNOK, AMANATUN UTARA, TIMOR TENGAH SELATAN, NUSA TENGGARA TIMUR",6,139,14,153
https://kawalpemilu.org#55444,"SNOK, AMANATUN UTARA, TIMOR TENGAH SELATAN, NUSA TENGGARA TIMUR",7,104,33,137
https://kawalpemilu.org#55445,"TUMU, AMANATUN UTARA, TIMOR TENGAH SELATAN, NUSA TENGGARA TIMUR",1,171,27,198
https://kawalpemilu.org#55445,"TUMU, AMANATUN UTARA, TIMOR TENGAH SELATAN, NUSA TENGGARA TIMUR",2,121,30,151
https://kawalpemilu.org#55445,"TUMU, AMANATUN UTARA, TIMOR TENGAH SELATAN, NUSA TENGGARA TIMUR",3,102,15,117
https://kawalpemilu.org#55445,"TUMU, AMANATUN UTARA, TIMOR TENGAH SELATAN, NUSA TENGGARA TIMUR",4,102,21,123
https://kawalpemilu.org#55445,"TUMU, AMANATUN UTARA, TIMOR TENGAH SELATAN, NUSA TENGGARA TIMUR",5,80,23,103
https://kawalpemilu.org#55445,"TUMU, AMANATUN UTARA, TIMOR TENGAH SELATAN, NUSA TENGGARA TIMUR",6,179,9,188
https://kawalpemilu.org#55445,"TUMU, AMANATUN UTARA, TIMOR TENGAH SELATAN, NUSA TENGGARA TIMUR",7,112,5,117
https://kawalpemilu.org#55445,"TUMU, AMANATUN UTARA, TIMOR TENGAH SELATAN, NUSA TENGGARA TIMUR",8,120,6,126
https://kawalpemilu.org#55446,"FATU ONI, AMANATUN UTARA, TIMOR TENGAH SELATAN, NUSA TENGGARA TIMUR",1,70,36,106
https://kawalpemilu.org#55446,"FATU ONI, AMANATUN UTARA, TIMOR TENGAH SELATAN, NUSA TENGGARA TIMUR",2,89,12,101
https://kawalpemilu.org#55446,"FATU ONI, AMANATUN UTARA, TIMOR TENGAH SELATAN, NUSA TENGGARA TIMUR",3,146,13,159
https://kawalpemilu.org#55446,"FATU ONI, AMANATUN UTARA, TIMOR TENGAH SELATAN, NUSA TENGGARA TIMUR",4,167,18,185
https://kawalpemilu.org#55446,"FATU ONI, AMANATUN UTARA, TIMOR TENGAH SELATAN, NUSA TENGGARA TIMUR",5,88,11,99
https://kawalpemilu.org#55446,"FATU ONI, AMANATUN UTARA, TIMOR TENGAH SELATAN, NUSA TENGGARA TIMUR",6,159,3,162
https://kawalpemilu.org#55447,"SONO, AMANATUN UTARA, TIMOR TENGAH SELATAN, NUSA TENGGARA TIMUR",1,127,16,143
https://kawalpemilu.org#55447,"SONO, AMANATUN UTARA, TIMOR TENGAH SELATAN, NUSA TENGGARA TIMUR",2,144,10,154
https://kawalpemilu.org#55447,"SONO, AMANATUN UTARA, TIMOR TENGAH SELATAN, NUSA TENGGARA TIMUR",3,125,13,138
https://kawalpemilu.org#55447,"SONO, AMANATUN UTARA, TIMOR TENGAH SELATAN, NUSA TENGGARA TIMUR",4,142,5,147
https://kawalpemilu.org#55447,"SONO, AMANATUN UTARA, TIMOR TENGAH SELATAN, NUSA TENGGARA TIMUR",5,148,23,171
https://kawalpemilu.org#55447,"SONO, AMANATUN UTARA, TIMOR TENGAH SELATAN, NUSA TENGGARA TIMUR",6,98,12,110
https://kawalpemilu.org#55447,"SONO, AMANATUN UTARA, TIMOR TENGAH SELATAN, NUSA TENGGARA TIMUR",7,87,14,101
https://kawalpemilu.org#55447,"SONO, AMANATUN UTARA, TIMOR TENGAH SELATAN, NUSA TENGGARA TIMUR",8,89,9,98
https://kawalpemilu.org#55447,"SONO, AMANATUN UTARA, TIMOR TENGAH SELATAN, NUSA TENGGARA TIMUR",9,87,9,96
https://kawalpemilu.org#55447,"SONO, AMANATUN UTARA, TIMOR TENGAH SELATAN, NUSA TENGGARA TIMUR",10,84,8,92
https://kawalpemilu.org#55448,"TAUANAS, AMANATUN UTARA, TIMOR TENGAH SELATAN, NUSA TENGGARA TIMUR",1,124,8,132
https://kawalpemilu.org#55448,"TAUANAS, AMANATUN UTARA, TIMOR TENGAH SELATAN, NUSA TENGGARA TIMUR",2,119,3,122
https://kawalpemilu.org#55448,"TAUANAS, AMANATUN UTARA, TIMOR TENGAH SELATAN, NUSA TENGGARA TIMUR",3,143,3,146
https://kawalpemilu.org#91061,"MUNA, AMANATUN UTARA, TIMOR TENGAH SELATAN, NUSA TENGGARA TIMUR",1,197,12,209
https://kawalpemilu.org#91061,"MUNA, AMANATUN UTARA, TIMOR TENGAH SELATAN, NUSA TENGGARA TIMUR",2,161,19,180
https://kawalpemilu.org#91061,"MUNA, AMANATUN UTARA, TIMOR TENGAH SELATAN, NUSA TENGGARA TIMUR",3,148,9,157
https://kawalpemilu.org#55450,"PILLI, KI'E, TIMOR TENGAH SELATAN, NUSA TENGGARA TIMUR",1,231,1,232
https://kawalpemilu.org#55450,"PILLI, KI'E, TIMOR TENGAH SELATAN, NUSA TENGGARA TIMUR",2,186,3,189
https://kawalpemilu.org#55450,"PILLI, KI'E, TIMOR TENGAH SELATAN, NUSA TENGGARA TIMUR",3,180,41,221
https://kawalpemilu.org#55450,"PILLI, KI'E, TIMOR TENGAH SELATAN, NUSA TENGGARA TIMUR",4,134,1,135
https://kawalpemilu.org#55451,"FALAS, KI'E, TIMOR TENGAH SELATAN, NUSA TENGGARA TIMUR",1,187,9,196
https://kawalpemilu.org#55451,"FALAS, KI'E, TIMOR TENGAH SELATAN, NUSA TENGGARA TIMUR",2,169,5,174
https://kawalpemilu.org#55451,"FALAS, KI'E, TIMOR TENGAH SELATAN, NUSA TENGGARA TIMUR",3,190,12,202
https://kawalpemilu.org#55451,"FALAS, KI'E, TIMOR TENGAH SELATAN, NUSA TENGGARA TIMUR",4,206,17,223
https://kawalpemilu.org#55451,"FALAS, KI'E, TIMOR TENGAH SELATAN, NUSA TENGGARA TIMUR",5,166,27,193
https://kawalpemilu.org#55452,"OENAI, KI'E, TIMOR TENGAH SELATAN, NUSA TENGGARA TIMUR",1,197,12,209
https://kawalpemilu.org#55452,"OENAI, KI'E, TIMOR TENGAH SELATAN, NUSA TENGGARA TIMUR",2,221,14,235
https://kawalpemilu.org#55452,"OENAI, KI'E, TIMOR TENGAH SELATAN, NUSA TENGGARA TIMUR",3,233,4,237
https://kawalpemilu.org#55452,"OENAI, KI'E, TIMOR TENGAH SELATAN, NUSA TENGGARA TIMUR",4,156,10,166
https://kawalpemilu.org#55452,"OENAI, KI'E, TIMOR TENGAH SELATAN, NUSA TENGGARA TIMUR",5,170,5,175
https://kawalpemilu.org#55453,"BELLE, KI'E, TIMOR TENGAH SELATAN, NUSA TENGGARA TIMUR",1,258,3,261
https://kawalpemilu.org#55453,"BELLE, KI'E, TIMOR TENGAH SELATAN, NUSA TENGGARA TIMUR",2,181,6,187
https://kawalpemilu.org#55453,"BELLE, KI'E, TIMOR TENGAH SELATAN, NUSA TENGGARA TIMUR",3,236,4,240
https://kawalpemilu.org#55453,"BELLE, KI'E, TIMOR TENGAH SELATAN, NUSA TENGGARA TIMUR",4,177,9,186
https://kawalpemilu.org#55453,"BELLE, KI'E, TIMOR TENGAH SELATAN, NUSA TENGGARA TIMUR",5,179,2,181
https://kawalpemilu.org#55454,"NAPI, KI'E, TIMOR TENGAH SELATAN, NUSA TENGGARA TIMUR",1,241,19,260
https://kawalpemilu.org#55454,"NAPI, KI'E, TIMOR TENGAH SELATAN, NUSA TENGGARA TIMUR",2,236,23,259
https://kawalpemilu.org#55454,"NAPI, KI'E, TIMOR TENGAH SELATAN, NUSA TENGGARA TIMUR",3,141,13,154
https://kawalpemilu.org#55454,"NAPI, KI'E, TIMOR TENGAH SELATAN, NUSA TENGGARA TIMUR",4,206,4,210
https://kawalpemilu.org#55455,"BOTI, KI'E, TIMOR TENGAH SELATAN, NUSA TENGGARA TIMUR",1,191,20,211
https://kawalpemilu.org#55455,"BOTI, KI'E, TIMOR TENGAH SELATAN, NUSA TENGGARA TIMUR",2,211,12,223
https://kawalpemilu.org#55455,"BOTI, KI'E, TIMOR TENGAH SELATAN, NUSA TENGGARA TIMUR",3,196,8,204
https://kawalpemilu.org#55455,"BOTI, KI'E, TIMOR TENGAH SELATAN, NUSA TENGGARA TIMUR",4,197,13,210
https://kawalpemilu.org#55455,"BOTI, KI'E, TIMOR TENGAH SELATAN, NUSA TENGGARA TIMUR",5,176,5,181
https://kawalpemilu.org#55456,"FATUULAN, KI'E, TIMOR TENGAH SELATAN, NUSA TENGGARA TIMUR",1,256,4,260
https://kawalpemilu.org#55456,"FATUULAN, KI'E, TIMOR TENGAH SELATAN, NUSA TENGGARA TIMUR",2,240,7,247
https://kawalpemilu.org#55456,"FATUULAN, KI'E, TIMOR TENGAH SELATAN, NUSA TENGGARA TIMUR",3,144,6,150
https://kawalpemilu.org#55456,"FATUULAN, KI'E, TIMOR TENGAH SELATAN, NUSA TENGGARA TIMUR",4,143,4,147
https://kawalpemilu.org#55457,"TESIAYOFANU, KI'E, TIMOR TENGAH SELATAN, NUSA TENGGARA TIMUR",1,219,5,224
https://kawalpemilu.org#55457,"TESIAYOFANU, KI'E, TIMOR TENGAH SELATAN, NUSA TENGGARA TIMUR",2,175,17,192
https://kawalpemilu.org#55457,"TESIAYOFANU, KI'E, TIMOR TENGAH SELATAN, NUSA TENGGARA TIMUR",3,236,8,244
https://kawalpemilu.org#55457,"TESIAYOFANU, KI'E, TIMOR TENGAH SELATAN, NUSA TENGGARA TIMUR",4,155,12,167
https://kawalpemilu.org#55457,"TESIAYOFANU, KI'E, TIMOR TENGAH SELATAN, NUSA TENGGARA TIMUR",5,155,7,162
https://kawalpemilu.org#55458,"OINLASI, KI'E, TIMOR TENGAH SELATAN, NUSA TENGGARA TIMUR",1,216,4,220
https://kawalpemilu.org#55458,"OINLASI, KI'E, TIMOR TENGAH SELATAN, NUSA TENGGARA TIMUR",2,206,3,209
https://kawalpemilu.org#55458,"OINLASI, KI'E, TIMOR TENGAH SELATAN, NUSA TENGGARA TIMUR",3,178,14,192
https://kawalpemilu.org#55458,"OINLASI, KI'E, TIMOR TENGAH SELATAN, NUSA TENGGARA TIMUR",4,178,9,187
https://kawalpemilu.org#55458,"OINLASI, KI'E, TIMOR TENGAH SELATAN, NUSA TENGGARA TIMUR",5,197,19,216
https://kawalpemilu.org#55459,"NEKMESE, KI'E, TIMOR TENGAH SELATAN, NUSA TENGGARA TIMUR",1,199,10,209
https://kawalpemilu.org#55459,"NEKMESE, KI'E, TIMOR TENGAH SELATAN, NUSA TENGGARA TIMUR",2,188,28,216
https://kawalpemilu.org#55459,"NEKMESE, KI'E, TIMOR TENGAH SELATAN, NUSA TENGGARA TIMUR",3,215,4,219
https://kawalpemilu.org#55459,"NEKMESE, KI'E, TIMOR TENGAH SELATAN, NUSA TENGGARA TIMUR",4,144,1,145
https://kawalpemilu.org#55460,"ENO NAPI, KI'E, TIMOR TENGAH SELATAN, NUSA TENGGARA TIMUR",1,256,5,261
https://kawalpemilu.org#55460,"ENO NAPI, KI'E, TIMOR TENGAH SELATAN, NUSA TENGGARA TIMUR",2,250,10,260
https://kawalpemilu.org#55460,"ENO NAPI, KI'E, TIMOR TENGAH SELATAN, NUSA TENGGARA TIMUR",3,172,8,180
https://kawalpemilu.org#91087,"FATUKUSI, KI'E, TIMOR TENGAH SELATAN, NUSA TENGGARA TIMUR",1,95,3,98
https://kawalpemilu.org#91087,"FATUKUSI, KI'E, TIMOR TENGAH SELATAN, NUSA TENGGARA TIMUR",2,194,7,201
https://kawalpemilu.org#91088,"NAILE'U, KI'E, TIMOR TENGAH SELATAN, NUSA TENGGARA TIMUR",1,207,6,213
https://kawalpemilu.org#91088,"NAILE'U, KI'E, TIMOR TENGAH SELATAN, NUSA TENGGARA TIMUR",2,160,5,165
https://kawalpemilu.org#55462,"OLAIS, KUANFATU, TIMOR TENGAH SELATAN, NUSA TENGGARA TIMUR",1,209,8,217
https://kawalpemilu.org#55462,"OLAIS, KUANFATU, TIMOR TENGAH SELATAN, NUSA TENGGARA TIMUR",2,204,17,221
https://kawalpemilu.org#55462,"OLAIS, KUANFATU, TIMOR TENGAH SELATAN, NUSA TENGGARA TIMUR",3,149,10,159
https://kawalpemilu.org#55462,"OLAIS, KUANFATU, TIMOR TENGAH SELATAN, NUSA TENGGARA TIMUR",4,90,0,90
https://kawalpemilu.org#55463,"LASI, KUANFATU, TIMOR TENGAH SELATAN, NUSA TENGGARA TIMUR",1,192,2,194
https://kawalpemilu.org#55463,"LASI, KUANFATU, TIMOR TENGAH SELATAN, NUSA TENGGARA TIMUR",2,194,5,199
https://kawalpemilu.org#55463,"LASI, KUANFATU, TIMOR TENGAH SELATAN, NUSA TENGGARA TIMUR",3,163,4,167
https://kawalpemilu.org#55463,"LASI, KUANFATU, TIMOR TENGAH SELATAN, NUSA TENGGARA TIMUR",4,117,4,121
https://kawalpemilu.org#55463,"LASI, KUANFATU, TIMOR TENGAH SELATAN, NUSA TENGGARA TIMUR",5,168,5,173
https://kawalpemilu.org#55463,"LASI, KUANFATU, TIMOR TENGAH SELATAN, NUSA TENGGARA TIMUR",6,133,6,139
https://kawalpemilu.org#55464,"KAKAN, KUANFATU, TIMOR TENGAH SELATAN, NUSA TENGGARA TIMUR",1,137,0,137
https://kawalpemilu.org#55464,"KAKAN, KUANFATU, TIMOR TENGAH SELATAN, NUSA TENGGARA TIMUR",2,170,3,173
https://kawalpemilu.org#55464,"KAKAN, KUANFATU, TIMOR TENGAH SELATAN, NUSA TENGGARA TIMUR",3,152,3,155
https://kawalpemilu.org#55464,"KAKAN, KUANFATU, TIMOR TENGAH SELATAN, NUSA TENGGARA TIMUR",4,101,5,106
https://kawalpemilu.org#55464,"KAKAN, KUANFATU, TIMOR TENGAH SELATAN, NUSA TENGGARA TIMUR",5,149,7,156
https://kawalpemilu.org#55464,"KAKAN, KUANFATU, TIMOR TENGAH SELATAN, NUSA TENGGARA TIMUR",6,193,6,199
https://kawalpemilu.org#55465,"BASMUTI, KUANFATU, TIMOR TENGAH SELATAN, NUSA TENGGARA TIMUR",1,225,9,234
https://kawalpemilu.org#55465,"BASMUTI, KUANFATU, TIMOR TENGAH SELATAN, NUSA TENGGARA TIMUR",2,230,7,237
https://kawalpemilu.org#55465,"BASMUTI, KUANFATU, TIMOR TENGAH SELATAN, NUSA TENGGARA TIMUR",3,204,5,209
https://kawalpemilu.org#55465,"BASMUTI, KUANFATU, TIMOR TENGAH SELATAN, NUSA TENGGARA TIMUR",4,218,2,220
https://kawalpemilu.org#55465,"BASMUTI, KUANFATU, TIMOR TENGAH SELATAN, NUSA TENGGARA TIMUR",5,188,0,188
https://kawalpemilu.org#55465,"BASMUTI, KUANFATU, TIMOR TENGAH SELATAN, NUSA TENGGARA TIMUR",6,166,0,166
https://kawalpemilu.org#55465,"BASMUTI, KUANFATU, TIMOR TENGAH SELATAN, NUSA TENGGARA TIMUR",7,137,0,137
https://kawalpemilu.org#55465,"BASMUTI, KUANFATU, TIMOR TENGAH SELATAN, NUSA TENGGARA TIMUR",8,165,0,165
https://kawalpemilu.org#55465,"BASMUTI, KUANFATU, TIMOR TENGAH SELATAN, NUSA TENGGARA TIMUR",9,140,3,143
https://kawalpemilu.org#55466,"KUSI, KUANFATU, TIMOR TENGAH SELATAN, NUSA TENGGARA TIMUR",1,168,7,175
https://kawalpemilu.org#55466,"KUSI, KUANFATU, TIMOR TENGAH SELATAN, NUSA TENGGARA TIMUR",2,156,2,158
https://kawalpemilu.org#55466,"KUSI, KUANFATU, TIMOR TENGAH SELATAN, NUSA TENGGARA TIMUR",3,108,10,118
https://kawalpemilu.org#55466,"KUSI, KUANFATU, TIMOR TENGAH SELATAN, NUSA TENGGARA TIMUR",4,190,4,194
https://kawalpemilu.org#55466,"KUSI, KUANFATU, TIMOR TENGAH SELATAN, NUSA TENGGARA TIMUR",5,99,2,101
https://kawalpemilu.org#55467,"KUANFATU, KUANFATU, TIMOR TENGAH SELATAN, NUSA TENGGARA TIMUR",1,201,17,218
https://kawalpemilu.org#55467,"KUANFATU, KUANFATU, TIMOR TENGAH SELATAN, NUSA TENGGARA TIMUR",2,202,10,212
https://kawalpemilu.org#55467,"KUANFATU, KUANFATU, TIMOR TENGAH SELATAN, NUSA TENGGARA TIMUR",3,151,10,161
https://kawalpemilu.org#55467,"KUANFATU, KUANFATU, TIMOR TENGAH SELATAN, NUSA TENGGARA TIMUR",4,156,7,163
https://kawalpemilu.org#55467,"KUANFATU, KUANFATU, TIMOR TENGAH SELATAN, NUSA TENGGARA TIMUR",5,167,9,176
https://kawalpemilu.org#55467,"KUANFATU, KUANFATU, TIMOR TENGAH SELATAN, NUSA TENGGARA TIMUR",6,223,3,226
https://kawalpemilu.org#55467,"KUANFATU, KUANFATU, TIMOR TENGAH SELATAN, NUSA TENGGARA TIMUR",7,184,20,204
https://kawalpemilu.org#55467,"KUANFATU, KUANFATU, TIMOR TENGAH SELATAN, NUSA TENGGARA TIMUR",8,171,17,188
https://kawalpemilu.org#55468,"KELLE, KUANFATU, TIMOR TENGAH SELATAN, NUSA TENGGARA TIMUR",1,185,0,185
https://kawalpemilu.org#55468,"KELLE, KUANFATU, TIMOR TENGAH SELATAN, NUSA TENGGARA TIMUR",2,177,1,178
https://kawalpemilu.org#55468,"KELLE, KUANFATU, TIMOR TENGAH SELATAN, NUSA TENGGARA TIMUR",3,197,5,202
https://kawalpemilu.org#55468,"KELLE, KUANFATU, TIMOR TENGAH SELATAN, NUSA TENGGARA TIMUR",4,187,5,192
https://kawalpemilu.org#91081,"TAUPI, KUANFATU, TIMOR TENGAH SELATAN, NUSA TENGGARA TIMUR",1,181,4,185
https://kawalpemilu.org#91081,"TAUPI, KUANFATU, TIMOR TENGAH SELATAN, NUSA TENGGARA TIMUR",2,186,6,192
https://kawalpemilu.org#91082,"OEBO, KUANFATU, TIMOR TENGAH SELATAN, NUSA TENGGARA TIMUR",1,191,5,196
https://kawalpemilu.org#91083,"KUSI UTARA, KUANFATU, TIMOR TENGAH SELATAN, NUSA TENGGARA TIMUR",1,171,7,178
https://kawalpemilu.org#91083,"KUSI UTARA, KUANFATU, TIMOR TENGAH SELATAN, NUSA TENGGARA TIMUR",2,110,12,122
https://kawalpemilu.org#91083,"KUSI UTARA, KUANFATU, TIMOR TENGAH SELATAN, NUSA TENGGARA TIMUR",3,171,0,171
https://kawalpemilu.org#91084,"KELLE TUNAN, KUANFATU, TIMOR TENGAH SELATAN, NUSA TENGGARA TIMUR",1,191,3,194
https://kawalpemilu.org#91084,"KELLE TUNAN, KUANFATU, TIMOR TENGAH SELATAN, NUSA TENGGARA TIMUR",2,158,7,165
https://kawalpemilu.org#91085,"NOEBEBA, KUANFATU, TIMOR TENGAH SELATAN, NUSA TENGGARA TIMUR",1,161,8,169
https://kawalpemilu.org#91085,"NOEBEBA, KUANFATU, TIMOR TENGAH SELATAN, NUSA TENGGARA TIMUR",2,147,7,154
https://kawalpemilu.org#91086,"OEHAN, KUANFATU, TIMOR TENGAH SELATAN, NUSA TENGGARA TIMUR",1,130,8,138
https://kawalpemilu.org#91086,"OEHAN, KUANFATU, TIMOR TENGAH SELATAN, NUSA TENGGARA TIMUR",2,141,2,143
https://kawalpemilu.org#55470,"NENAS, FATUMNASI, TIMOR TENGAH SELATAN, NUSA TENGGARA TIMUR",1,239,12,251
https://kawalpemilu.org#55470,"NENAS, FATUMNASI, TIMOR TENGAH SELATAN, NUSA TENGGARA TIMUR",2,213,1,214
https://kawalpemilu.org#55470,"NENAS, FATUMNASI, TIMOR TENGAH SELATAN, NUSA TENGGARA TIMUR",3,218,3,221
https://kawalpemilu.org#55471,"FATUMNASI, FATUMNASI, TIMOR TENGAH SELATAN, NUSA TENGGARA TIMUR",1,140,8,148
https://kawalpemilu.org#55471,"FATUMNASI, FATUMNASI, TIMOR TENGAH SELATAN, NUSA TENGGARA TIMUR",2,219,7,226
https://kawalpemilu.org#55471,"FATUMNASI, FATUMNASI, TIMOR TENGAH SELATAN, NUSA TENGGARA TIMUR",3,214,6,220
https://kawalpemilu.org#55471,"FATUMNASI, FATUMNASI, TIMOR TENGAH SELATAN, NUSA TENGGARA TIMUR",5,109,2,111
https://kawalpemilu.org#55471,"FATUMNASI, FATUMNASI, TIMOR TENGAH SELATAN, NUSA TENGGARA TIMUR",6,133,3,136
https://kawalpemilu.org#55472,"NUAPIN, FATUMNASI, TIMOR TENGAH SELATAN, NUSA TENGGARA TIMUR",1,122,4,126
https://kawalpemilu.org#55472,"NUAPIN, FATUMNASI, TIMOR TENGAH SELATAN, NUSA TENGGARA TIMUR",2,127,3,130
https://kawalpemilu.org#55472,"NUAPIN, FATUMNASI, TIMOR TENGAH SELATAN, NUSA TENGGARA TIMUR",3,144,2,146
https://kawalpemilu.org#55472,"NUAPIN, FATUMNASI, TIMOR TENGAH SELATAN, NUSA TENGGARA TIMUR",4,145,7,152
https://kawalpemilu.org#55472,"NUAPIN, FATUMNASI, TIMOR TENGAH SELATAN, NUSA TENGGARA TIMUR",5,142,7,149
https://kawalpemilu.org#55472,"NUAPIN, FATUMNASI, TIMOR TENGAH SELATAN, NUSA TENGGARA TIMUR",6,236,2,238
https://kawalpemilu.org#55473,"KUANOEL, FATUMNASI, TIMOR TENGAH SELATAN, NUSA TENGGARA TIMUR",1,183,8,191
https://kawalpemilu.org#55473,"KUANOEL, FATUMNASI, TIMOR TENGAH SELATAN, NUSA TENGGARA TIMUR",2,186,1,187
https://kawalpemilu.org#55473,"KUANOEL, FATUMNASI, TIMOR TENGAH SELATAN, NUSA TENGGARA TIMUR",3,144,3,147
https://kawalpemilu.org#55473,"KUANOEL, FATUMNASI, TIMOR TENGAH SELATAN, NUSA TENGGARA TIMUR",4,137,1,138
https://kawalpemilu.org#91080,"MUTIS, FATUMNASI, TIMOR TENGAH SELATAN, NUSA TENGGARA TIMUR",1,174,4,178
https://kawalpemilu.org#91080,"MUTIS, FATUMNASI, TIMOR TENGAH SELATAN, NUSA TENGGARA TIMUR",2,102,4,106
https://kawalpemilu.org#55475,"KONBAKI, POLEN, TIMOR TENGAH SELATAN, NUSA TENGGARA TIMUR",1,177,10,187
https://kawalpemilu.org#55475,"KONBAKI, POLEN, TIMOR TENGAH SELATAN, NUSA TENGGARA TIMUR",3,178,6,184
https://kawalpemilu.org#55475,"KONBAKI, POLEN, TIMOR TENGAH SELATAN, NUSA TENGGARA TIMUR",4,125,2,127
https://kawalpemilu.org#55475,"KONBAKI, POLEN, TIMOR TENGAH SELATAN, NUSA TENGGARA TIMUR",5,130,3,133
https://kawalpemilu.org#55475,"KONBAKI, POLEN, TIMOR TENGAH SELATAN, NUSA TENGGARA TIMUR",6,133,4,137
https://kawalpemilu.org#55476,"FATUMNUTU, POLEN, TIMOR TENGAH SELATAN, NUSA TENGGARA TIMUR",1,195,8,203
https://kawalpemilu.org#55476,"FATUMNUTU, POLEN, TIMOR TENGAH SELATAN, NUSA TENGGARA TIMUR",2,196,11,207
https://kawalpemilu.org#55476,"FATUMNUTU, POLEN, TIMOR TENGAH SELATAN, NUSA TENGGARA TIMUR",3,199,12,211
https://kawalpemilu.org#55476,"FATUMNUTU, POLEN, TIMOR TENGAH SELATAN, NUSA TENGGARA TIMUR",4,190,10,200
https://kawalpemilu.org#55477,"BIJELI, POLEN, TIMOR TENGAH SELATAN, NUSA TENGGARA TIMUR",1,158,6,164
https://kawalpemilu.org#55477,"BIJELI, POLEN, TIMOR TENGAH SELATAN, NUSA TENGGARA TIMUR",2,174,3,177
https://kawalpemilu.org#55477,"BIJELI, POLEN, TIMOR TENGAH SELATAN, NUSA TENGGARA TIMUR",3,126,8,134
https://kawalpemilu.org#55477,"BIJELI, POLEN, TIMOR TENGAH SELATAN, NUSA TENGGARA TIMUR",4,122,15,137
https://kawalpemilu.org#55477,"BIJELI, POLEN, TIMOR TENGAH SELATAN, NUSA TENGGARA TIMUR",5,124,15,139
https://kawalpemilu.org#55478,"LOLI, POLEN, TIMOR TENGAH SELATAN, NUSA TENGGARA TIMUR",1,170,9,179
https://kawalpemilu.org#55478,"LOLI, POLEN, TIMOR TENGAH SELATAN, NUSA TENGGARA TIMUR",2,146,20,166
https://kawalpemilu.org#55478,"LOLI, POLEN, TIMOR TENGAH SELATAN, NUSA TENGGARA TIMUR",3,137,15,152
https://kawalpemilu.org#55478,"LOLI, POLEN, TIMOR TENGAH SELATAN, NUSA TENGGARA TIMUR",4,148,12,160
https://kawalpemilu.org#55478,"LOLI, POLEN, TIMOR TENGAH SELATAN, NUSA TENGGARA TIMUR",5,113,17,130
https://kawalpemilu.org#55479,"USAPIMNASI, POLEN, TIMOR TENGAH SELATAN, NUSA TENGGARA TIMUR",1,182,9,191
https://kawalpemilu.org#55479,"USAPIMNASI, POLEN, TIMOR TENGAH SELATAN, NUSA TENGGARA TIMUR",2,139,17,156
https://kawalpemilu.org#55480,"MNESATBUBUK, POLEN, TIMOR TENGAH SELATAN, NUSA TENGGARA TIMUR",1,152,22,174
https://kawalpemilu.org#55480,"MNESATBUBUK, POLEN, TIMOR TENGAH SELATAN, NUSA TENGGARA TIMUR",2,153,4,157
https://kawalpemilu.org#55480,"MNESATBUBUK, POLEN, TIMOR TENGAH SELATAN, NUSA TENGGARA TIMUR",3,155,4,159
https://kawalpemilu.org#55480,"MNESATBUBUK, POLEN, TIMOR TENGAH SELATAN, NUSA TENGGARA TIMUR",4,163,8,171
https://kawalpemilu.org#55481,"PUNA, POLEN, TIMOR TENGAH SELATAN, NUSA TENGGARA TIMUR",1,210,24,234
https://kawalpemilu.org#55481,"PUNA, POLEN, TIMOR TENGAH SELATAN, NUSA TENGGARA TIMUR",2,182,4,186
https://kawalpemilu.org#55481,"PUNA, POLEN, TIMOR TENGAH SELATAN, NUSA TENGGARA TIMUR",3,271,23,294
https://kawalpemilu.org#55481,"PUNA, POLEN, TIMOR TENGAH SELATAN, NUSA TENGGARA TIMUR",4,242,12,254
https://kawalpemilu.org#55482,"LAOB, POLEN, TIMOR TENGAH SELATAN, NUSA TENGGARA TIMUR",1,185,6,191
https://kawalpemilu.org#55482,"LAOB, POLEN, TIMOR TENGAH SELATAN, NUSA TENGGARA TIMUR",2,183,3,186
https://kawalpemilu.org#55482,"LAOB, POLEN, TIMOR TENGAH SELATAN, NUSA TENGGARA TIMUR",3,177,2,179
https://kawalpemilu.org#55483,"OELNUNUH, POLEN, TIMOR TENGAH SELATAN, NUSA TENGGARA TIMUR",1,203,9,212
https://kawalpemilu.org#55483,"OELNUNUH, POLEN, TIMOR TENGAH SELATAN, NUSA TENGGARA TIMUR",2,162,20,182
https://kawalpemilu.org#55484,"BALU, POLEN, TIMOR TENGAH SELATAN, NUSA TENGGARA TIMUR",1,167,5,172
https://kawalpemilu.org#55484,"BALU, POLEN, TIMOR TENGAH SELATAN, NUSA TENGGARA TIMUR",2,162,3,165
https://kawalpemilu.org#91079,"SAINONI, POLEN, TIMOR TENGAH SELATAN, NUSA TENGGARA TIMUR",1,210,3,213
https://kawalpemilu.org#91079,"SAINONI, POLEN, TIMOR TENGAH SELATAN, NUSA TENGGARA TIMUR",2,158,3,161
https://kawalpemilu.org#55486,"BENLUTU, BATU PUTIH, TIMOR TENGAH SELATAN, NUSA TENGGARA TIMUR",1,183,3,186
https://kawalpemilu.org#55486,"BENLUTU, BATU PUTIH, TIMOR TENGAH SELATAN, NUSA TENGGARA TIMUR",2,178,8,186
https://kawalpemilu.org#55486,"BENLUTU, BATU PUTIH, TIMOR TENGAH SELATAN, NUSA TENGGARA TIMUR",3,194,18,212
https://kawalpemilu.org#55486,"BENLUTU, BATU PUTIH, TIMOR TENGAH SELATAN, NUSA TENGGARA TIMUR",4,139,13,152
https://kawalpemilu.org#55486,"BENLUTU, BATU PUTIH, TIMOR TENGAH SELATAN, NUSA TENGGARA TIMUR",5,227,14,241
https://kawalpemilu.org#55486,"BENLUTU, BATU PUTIH, TIMOR TENGAH SELATAN, NUSA TENGGARA TIMUR",6,137,8,145
https://kawalpemilu.org#55486,"BENLUTU, BATU PUTIH, TIMOR TENGAH SELATAN, NUSA TENGGARA TIMUR",7,149,13,162
https://kawalpemilu.org#55487,"BOENTUKA, BATU PUTIH, TIMOR TENGAH SELATAN, NUSA TENGGARA TIMUR",1,266,4,270
https://kawalpemilu.org#55487,"BOENTUKA, BATU PUTIH, TIMOR TENGAH SELATAN, NUSA TENGGARA TIMUR",2,247,10,257
https://kawalpemilu.org#55487,"BOENTUKA, BATU PUTIH, TIMOR TENGAH SELATAN, NUSA TENGGARA TIMUR",3,228,14,242
https://kawalpemilu.org#55487,"BOENTUKA, BATU PUTIH, TIMOR TENGAH SELATAN, NUSA TENGGARA TIMUR",4,203,13,216
https://kawalpemilu.org#55488,"HANE, BATU PUTIH, TIMOR TENGAH SELATAN, NUSA TENGGARA TIMUR",1,224,10,234
https://kawalpemilu.org#55488,"HANE, BATU PUTIH, TIMOR TENGAH SELATAN, NUSA TENGGARA TIMUR",2,163,12,175
https://kawalpemilu.org#55488,"HANE, BATU PUTIH, TIMOR TENGAH SELATAN, NUSA TENGGARA TIMUR",3,210,6,216
https://kawalpemilu.org#55488,"HANE, BATU PUTIH, TIMOR TENGAH SELATAN, NUSA TENGGARA TIMUR",4,174,3,177
https://kawalpemilu.org#55488,"HANE, BATU PUTIH, TIMOR TENGAH SELATAN, NUSA TENGGARA TIMUR",5,211,2,213
https://kawalpemilu.org#55488,"HANE, BATU PUTIH, TIMOR TENGAH SELATAN, NUSA TENGGARA TIMUR",6,220,5,225
https://kawalpemilu.org#55489,"OEBOBO, BATU PUTIH, TIMOR TENGAH SELATAN, NUSA TENGGARA TIMUR",1,215,38,253
https://kawalpemilu.org#55489,"OEBOBO, BATU PUTIH, TIMOR TENGAH SELATAN, NUSA TENGGARA TIMUR",2,226,11,237
https://kawalpemilu.org#55489,"OEBOBO, BATU PUTIH, TIMOR TENGAH SELATAN, NUSA TENGGARA TIMUR",3,230,10,240
https://kawalpemilu.org#55489,"OEBOBO, BATU PUTIH, TIMOR TENGAH SELATAN, NUSA TENGGARA TIMUR",4,207,7,214
https://kawalpemilu.org#55489,"OEBOBO, BATU PUTIH, TIMOR TENGAH SELATAN, NUSA TENGGARA TIMUR",5,234,8,242
https://kawalpemilu.org#55489,"OEBOBO, BATU PUTIH, TIMOR TENGAH SELATAN, NUSA TENGGARA TIMUR",6,206,8,214
https://kawalpemilu.org#55489,"OEBOBO, BATU PUTIH, TIMOR TENGAH SELATAN, NUSA TENGGARA TIMUR",7,216,3,219
https://kawalpemilu.org#55490,"TUPAN, BATU PUTIH, TIMOR TENGAH SELATAN, NUSA TENGGARA TIMUR",1,253,9,262
https://kawalpemilu.org#55490,"TUPAN, BATU PUTIH, TIMOR TENGAH SELATAN, NUSA TENGGARA TIMUR",2,216,20,236
https://kawalpemilu.org#55490,"TUPAN, BATU PUTIH, TIMOR TENGAH SELATAN, NUSA TENGGARA TIMUR",3,227,7,234
https://kawalpemilu.org#55491,"TUAKOLE, BATU PUTIH, TIMOR TENGAH SELATAN, NUSA TENGGARA TIMUR",1,244,10,254
https://kawalpemilu.org#55491,"TUAKOLE, BATU PUTIH, TIMOR TENGAH SELATAN, NUSA TENGGARA TIMUR",2,224,1,225
https://kawalpemilu.org#55492,"OEHELA, BATU PUTIH, TIMOR TENGAH SELATAN, NUSA TENGGARA TIMUR",1,198,5,203
https://kawalpemilu.org#55492,"OEHELA, BATU PUTIH, TIMOR TENGAH SELATAN, NUSA TENGGARA TIMUR",2,132,3,135
https://kawalpemilu.org#55492,"OEHELA, BATU PUTIH, TIMOR TENGAH SELATAN, NUSA TENGGARA TIMUR",3,184,5,189
https://kawalpemilu.org#55494,"SABUN, BOKING, TIMOR TENGAH SELATAN, NUSA TENGGARA TIMUR",1,147,5,152
https://kawalpemilu.org#55494,"SABUN, BOKING, TIMOR TENGAH SELATAN, NUSA TENGGARA TIMUR",2,132,19,151
https://kawalpemilu.org#55494,"SABUN, BOKING, TIMOR TENGAH SELATAN, NUSA TENGGARA TIMUR",3,169,3,172
https://kawalpemilu.org#55494,"SABUN, BOKING, TIMOR TENGAH SELATAN, NUSA TENGGARA TIMUR",4,160,7,167
https://kawalpemilu.org#55494,"SABUN, BOKING, TIMOR TENGAH SELATAN, NUSA TENGGARA TIMUR",5,101,13,114
https://kawalpemilu.org#55495,"NANO, BOKING, TIMOR TENGAH SELATAN, NUSA TENGGARA TIMUR",1,208,10,218
https://kawalpemilu.org#55495,"NANO, BOKING, TIMOR TENGAH SELATAN, NUSA TENGGARA TIMUR",2,158,2,160
https://kawalpemilu.org#55495,"NANO, BOKING, TIMOR TENGAH SELATAN, NUSA TENGGARA TIMUR",3,140,5,145
https://kawalpemilu.org#55496,"BOKING, BOKING, TIMOR TENGAH SELATAN, NUSA TENGGARA TIMUR",1,212,12,224
https://kawalpemilu.org#55496,"BOKING, BOKING, TIMOR TENGAH SELATAN, NUSA TENGGARA TIMUR",2,183,31,214
https://kawalpemilu.org#55496,"BOKING, BOKING, TIMOR TENGAH SELATAN, NUSA TENGGARA TIMUR",3,161,16,177
https://kawalpemilu.org#55496,"BOKING, BOKING, TIMOR TENGAH SELATAN, NUSA TENGGARA TIMUR",4,180,13,193
https://kawalpemilu.org#55496,"BOKING, BOKING, TIMOR TENGAH SELATAN, NUSA TENGGARA TIMUR",5,176,6,182
https://kawalpemilu.org#55497,"BAUS, BOKING, TIMOR TENGAH SELATAN, NUSA TENGGARA TIMUR",1,185,12,197
https://kawalpemilu.org#55497,"BAUS, BOKING, TIMOR TENGAH SELATAN, NUSA TENGGARA TIMUR",2,131,6,137
https://kawalpemilu.org#55497,"BAUS, BOKING, TIMOR TENGAH SELATAN, NUSA TENGGARA TIMUR",3,201,5,206
https://kawalpemilu.org#55497,"BAUS, BOKING, TIMOR TENGAH SELATAN, NUSA TENGGARA TIMUR",4,145,6,151
https://kawalpemilu.org#55497,"BAUS, BOKING, TIMOR TENGAH SELATAN, NUSA TENGGARA TIMUR",5,146,13,159
https://kawalpemilu.org#55498,"MEUSIN, BOKING, TIMOR TENGAH SELATAN, NUSA TENGGARA TIMUR",1,164,14,178
https://kawalpemilu.org#55498,"MEUSIN, BOKING, TIMOR TENGAH SELATAN, NUSA TENGGARA TIMUR",2,170,11,181
https://kawalpemilu.org#55498,"MEUSIN, BOKING, TIMOR TENGAH SELATAN, NUSA TENGGARA TIMUR",3,178,15,193
https://kawalpemilu.org#55498,"MEUSIN, BOKING, TIMOR TENGAH SELATAN, NUSA TENGGARA TIMUR",4,118,20,138
https://kawalpemilu.org#55499,"LEONMENI, BOKING, TIMOR TENGAH SELATAN, NUSA TENGGARA TIMUR",1,174,2,176
https://kawalpemilu.org#55499,"LEONMENI, BOKING, TIMOR TENGAH SELATAN, NUSA TENGGARA TIMUR",2,123,7,130
https://kawalpemilu.org#91078,"FATU MANUFUI, BOKING, TIMOR TENGAH SELATAN, NUSA TENGGARA TIMUR",1,167,15,182
https://kawalpemilu.org#91078,"FATU MANUFUI, BOKING, TIMOR TENGAH SELATAN, NUSA TENGGARA TIMUR",2,136,12,148
https://kawalpemilu.org#91078,"FATU MANUFUI, BOKING, TIMOR TENGAH SELATAN, NUSA TENGGARA TIMUR",3,158,3,161
https://kawalpemilu.org#91078,"FATU MANUFUI, BOKING, TIMOR TENGAH SELATAN, NUSA TENGGARA TIMUR",4,146,10,156
https://kawalpemilu.org#55501,"TOIANAS, TOIANAS, TIMOR TENGAH SELATAN, NUSA TENGGARA TIMUR",1,127,45,172
https://kawalpemilu.org#55501,"TOIANAS, TOIANAS, TIMOR TENGAH SELATAN, NUSA TENGGARA TIMUR",2,184,27,211
https://kawalpemilu.org#55501,"TOIANAS, TOIANAS, TIMOR TENGAH SELATAN, NUSA TENGGARA TIMUR",3,210,14,224
https://kawalpemilu.org#55501,"TOIANAS, TOIANAS, TIMOR TENGAH SELATAN, NUSA TENGGARA TIMUR",4,176,10,186
https://kawalpemilu.org#55501,"TOIANAS, TOIANAS, TIMOR TENGAH SELATAN, NUSA TENGGARA TIMUR",5,208,19,227
https://kawalpemilu.org#55502,"SKINU, TOIANAS, TIMOR TENGAH SELATAN, NUSA TENGGARA TIMUR",1,162,20,182
https://kawalpemilu.org#55502,"SKINU, TOIANAS, TIMOR TENGAH SELATAN, NUSA TENGGARA TIMUR",2,152,19,171
https://kawalpemilu.org#55502,"SKINU, TOIANAS, TIMOR TENGAH SELATAN, NUSA TENGGARA TIMUR",3,137,37,174
https://kawalpemilu.org#55502,"SKINU, TOIANAS, TIMOR TENGAH SELATAN, NUSA TENGGARA TIMUR",4,182,13,195
https://kawalpemilu.org#55502,"SKINU, TOIANAS, TIMOR TENGAH SELATAN, NUSA TENGGARA TIMUR",5,165,33,198
https://kawalpemilu.org#55503,"OELEU, TOIANAS, TIMOR TENGAH SELATAN, NUSA TENGGARA TIMUR",1,138,8,146
https://kawalpemilu.org#55503,"OELEU, TOIANAS, TIMOR TENGAH SELATAN, NUSA TENGGARA TIMUR",2,220,27,247
https://kawalpemilu.org#55503,"OELEU, TOIANAS, TIMOR TENGAH SELATAN, NUSA TENGGARA TIMUR",3,205,23,228
https://kawalpemilu.org#55504,"SANBET, TOIANAS, TIMOR TENGAH SELATAN, NUSA TENGGARA TIMUR",1,136,5,141
https://kawalpemilu.org#55504,"SANBET, TOIANAS, TIMOR TENGAH SELATAN, NUSA TENGGARA TIMUR",2,165,11,176
https://kawalpemilu.org#55504,"SANBET, TOIANAS, TIMOR TENGAH SELATAN, NUSA TENGGARA TIMUR",3,178,9,187
https://kawalpemilu.org#55504,"SANBET, TOIANAS, TIMOR TENGAH SELATAN, NUSA TENGGARA TIMUR",4,155,17,172
https://kawalpemilu.org#55504,"SANBET, TOIANAS, TIMOR TENGAH SELATAN, NUSA TENGGARA TIMUR",5,131,9,140
https://kawalpemilu.org#55505,"BOKONG, TOIANAS, TIMOR TENGAH SELATAN, NUSA TENGGARA TIMUR",1,117,15,132
https://kawalpemilu.org#55505,"BOKONG, TOIANAS, TIMOR TENGAH SELATAN, NUSA TENGGARA TIMUR",2,134,12,146
https://kawalpemilu.org#55505,"BOKONG, TOIANAS, TIMOR TENGAH SELATAN, NUSA TENGGARA TIMUR",3,139,4,143
https://kawalpemilu.org#55506,"TUATAUM, TOIANAS, TIMOR TENGAH SELATAN, NUSA TENGGARA TIMUR",1,202,14,216
https://kawalpemilu.org#55506,"TUATAUM, TOIANAS, TIMOR TENGAH SELATAN, NUSA TENGGARA TIMUR",2,174,8,182
https://kawalpemilu.org#55506,"TUATAUM, TOIANAS, TIMOR TENGAH SELATAN, NUSA TENGGARA TIMUR",3,152,26,178
https://kawalpemilu.org#55506,"TUATAUM, TOIANAS, TIMOR TENGAH SELATAN, NUSA TENGGARA TIMUR",4,149,16,165
https://kawalpemilu.org#55507,"LOBUS, TOIANAS, TIMOR TENGAH SELATAN, NUSA TENGGARA TIMUR",1,168,10,178
https://kawalpemilu.org#55507,"LOBUS, TOIANAS, TIMOR TENGAH SELATAN, NUSA TENGGARA TIMUR",2,142,5,147
https://kawalpemilu.org#91076,"NOEOLIN, TOIANAS, TIMOR TENGAH SELATAN, NUSA TENGGARA TIMUR",1,98,7,105
https://kawalpemilu.org#91076,"NOEOLIN, TOIANAS, TIMOR TENGAH SELATAN, NUSA TENGGARA TIMUR",2,166,5,171
https://kawalpemilu.org#91077,"MILLI, TOIANAS, TIMOR TENGAH SELATAN, NUSA TENGGARA TIMUR",1,147,9,156
https://kawalpemilu.org#91077,"MILLI, TOIANAS, TIMOR TENGAH SELATAN, NUSA TENGGARA TIMUR",2,123,13,136
https://kawalpemilu.org#91077,"MILLI, TOIANAS, TIMOR TENGAH SELATAN, NUSA TENGGARA TIMUR",3,86,37,123
https://kawalpemilu.org#55509,"OP, NUNKOLO, TIMOR TENGAH SELATAN, NUSA TENGGARA TIMUR",1,241,9,250
https://kawalpemilu.org#55509,"OP, NUNKOLO, TIMOR TENGAH SELATAN, NUSA TENGGARA TIMUR",2,242,6,248
https://kawalpemilu.org#55509,"OP, NUNKOLO, TIMOR TENGAH SELATAN, NUSA TENGGARA TIMUR",3,135,14,149
https://kawalpemilu.org#55509,"OP, NUNKOLO, TIMOR TENGAH SELATAN, NUSA TENGGARA TIMUR",4,118,6,124
https://kawalpemilu.org#55510,"SAHAN, NUNKOLO, TIMOR TENGAH SELATAN, NUSA TENGGARA TIMUR",1,108,4,112
https://kawalpemilu.org#55510,"SAHAN, NUNKOLO, TIMOR TENGAH SELATAN, NUSA TENGGARA TIMUR",3,208,2,210
https://kawalpemilu.org#55510,"SAHAN, NUNKOLO, TIMOR TENGAH SELATAN, NUSA TENGGARA TIMUR",4,211,7,218
https://kawalpemilu.org#55510,"SAHAN, NUNKOLO, TIMOR TENGAH SELATAN, NUSA TENGGARA TIMUR",5,138,2,140
https://kawalpemilu.org#55510,"SAHAN, NUNKOLO, TIMOR TENGAH SELATAN, NUSA TENGGARA TIMUR",6,112,3,115
https://kawalpemilu.org#55511,"NENOAT, NUNKOLO, TIMOR TENGAH SELATAN, NUSA TENGGARA TIMUR",1,151,10,161
https://kawalpemilu.org#55511,"NENOAT, NUNKOLO, TIMOR TENGAH SELATAN, NUSA TENGGARA TIMUR",2,166,10,176
https://kawalpemilu.org#55511,"NENOAT, NUNKOLO, TIMOR TENGAH SELATAN, NUSA TENGGARA TIMUR",3,221,16,237
https://kawalpemilu.org#55511,"NENOAT, NUNKOLO, TIMOR TENGAH SELATAN, NUSA TENGGARA TIMUR",4,141,12,153
https://kawalpemilu.org#55511,"NENOAT, NUNKOLO, TIMOR TENGAH SELATAN, NUSA TENGGARA TIMUR",5,155,10,165
https://kawalpemilu.org#55512,"HAINENO, NUNKOLO, TIMOR TENGAH SELATAN, NUSA TENGGARA TIMUR",1,143,11,154
https://kawalpemilu.org#55512,"HAINENO, NUNKOLO, TIMOR TENGAH SELATAN, NUSA TENGGARA TIMUR",2,148,5,153
https://kawalpemilu.org#55512,"HAINENO, NUNKOLO, TIMOR TENGAH SELATAN, NUSA TENGGARA TIMUR",3,118,5,123
https://kawalpemilu.org#55512,"HAINENO, NUNKOLO, TIMOR TENGAH SELATAN, NUSA TENGGARA TIMUR",4,111,13,124
https://kawalpemilu.org#55512,"HAINENO, NUNKOLO, TIMOR TENGAH SELATAN, NUSA TENGGARA TIMUR",5,111,5,116
https://kawalpemilu.org#55512,"HAINENO, NUNKOLO, TIMOR TENGAH SELATAN, NUSA TENGGARA TIMUR",6,104,8,112
https://kawalpemilu.org#55512,"HAINENO, NUNKOLO, TIMOR TENGAH SELATAN, NUSA TENGGARA TIMUR",7,126,6,132
https://kawalpemilu.org#55512,"HAINENO, NUNKOLO, TIMOR TENGAH SELATAN, NUSA TENGGARA TIMUR",8,107,5,112
https://kawalpemilu.org#55513,"NUNKOLO, NUNKOLO, TIMOR TENGAH SELATAN, NUSA TENGGARA TIMUR",1,104,9,113
https://kawalpemilu.org#55513,"NUNKOLO, NUNKOLO, TIMOR TENGAH SELATAN, NUSA TENGGARA TIMUR",2,164,14,178
https://kawalpemilu.org#55513,"NUNKOLO, NUNKOLO, TIMOR TENGAH SELATAN, NUSA TENGGARA TIMUR",3,201,19,220
https://kawalpemilu.org#55513,"NUNKOLO, NUNKOLO, TIMOR TENGAH SELATAN, NUSA TENGGARA TIMUR",4,113,7,120
https://kawalpemilu.org#55514,"SAENAM, NUNKOLO, TIMOR TENGAH SELATAN, NUSA TENGGARA TIMUR",1,217,5,222
https://kawalpemilu.org#55514,"SAENAM, NUNKOLO, TIMOR TENGAH SELATAN, NUSA TENGGARA TIMUR",2,150,8,158
https://kawalpemilu.org#55514,"SAENAM, NUNKOLO, TIMOR TENGAH SELATAN, NUSA TENGGARA TIMUR",3,145,8,153
https://kawalpemilu.org#55515,"FAT, NUNKOLO, TIMOR TENGAH SELATAN, NUSA TENGGARA TIMUR",1,209,7,216
https://kawalpemilu.org#55515,"FAT, NUNKOLO, TIMOR TENGAH SELATAN, NUSA TENGGARA TIMUR",2,177,4,181
https://kawalpemilu.org#55516,"HAUMENI, NUNKOLO, TIMOR TENGAH SELATAN, NUSA TENGGARA TIMUR",1,134,3,137
https://kawalpemilu.org#55516,"HAUMENI, NUNKOLO, TIMOR TENGAH SELATAN, NUSA TENGGARA TIMUR",2,100,2,102
https://kawalpemilu.org#55516,"HAUMENI, NUNKOLO, TIMOR TENGAH SELATAN, NUSA TENGGARA TIMUR",3,125,11,136
https://kawalpemilu.org#55516,"HAUMENI, NUNKOLO, TIMOR TENGAH SELATAN, NUSA TENGGARA TIMUR",4,137,1,138
https://kawalpemilu.org#55516,"HAUMENI, NUNKOLO, TIMOR TENGAH SELATAN, NUSA TENGGARA TIMUR",5,139,4,143
https://kawalpemilu.org#55517,"PUTUN, NUNKOLO, TIMOR TENGAH SELATAN, NUSA TENGGARA TIMUR",1,189,23,212
https://kawalpemilu.org#55517,"PUTUN, NUNKOLO, TIMOR TENGAH SELATAN, NUSA TENGGARA TIMUR",2,192,10,202
https://kawalpemilu.org#55517,"PUTUN, NUNKOLO, TIMOR TENGAH SELATAN, NUSA TENGGARA TIMUR",3,121,10,131
https://kawalpemilu.org#55517,"PUTUN, NUNKOLO, TIMOR TENGAH SELATAN, NUSA TENGGARA TIMUR",4,146,8,154
https://kawalpemilu.org#55519,"NEKE, OENINO, TIMOR TENGAH SELATAN, NUSA TENGGARA TIMUR",1,176,10,186
https://kawalpemilu.org#55519,"NEKE, OENINO, TIMOR TENGAH SELATAN, NUSA TENGGARA TIMUR",2,186,2,188
https://kawalpemilu.org#55519,"NEKE, OENINO, TIMOR TENGAH SELATAN, NUSA TENGGARA TIMUR",3,209,5,214
https://kawalpemilu.org#55519,"NEKE, OENINO, TIMOR TENGAH SELATAN, NUSA TENGGARA TIMUR",4,134,3,137
https://kawalpemilu.org#55520,"PENE UTARA, OENINO, TIMOR TENGAH SELATAN, NUSA TENGGARA TIMUR",1,131,11,142
https://kawalpemilu.org#55520,"PENE UTARA, OENINO, TIMOR TENGAH SELATAN, NUSA TENGGARA TIMUR",2,163,3,166
https://kawalpemilu.org#55520,"PENE UTARA, OENINO, TIMOR TENGAH SELATAN, NUSA TENGGARA TIMUR",3,158,9,167
https://kawalpemilu.org#55520,"PENE UTARA, OENINO, TIMOR TENGAH SELATAN, NUSA TENGGARA TIMUR",4,137,6,143
https://kawalpemilu.org#55520,"PENE UTARA, OENINO, TIMOR TENGAH SELATAN, NUSA TENGGARA TIMUR",5,147,3,150
https://kawalpemilu.org#55520,"PENE UTARA, OENINO, TIMOR TENGAH SELATAN, NUSA TENGGARA TIMUR",6,166,16,182
https://kawalpemilu.org#55520,"PENE UTARA, OENINO, TIMOR TENGAH SELATAN, NUSA TENGGARA TIMUR",7,152,2,154
https://kawalpemilu.org#55521,"NOENONI, OENINO, TIMOR TENGAH SELATAN, NUSA TENGGARA TIMUR",1,194,11,205
https://kawalpemilu.org#55521,"NOENONI, OENINO, TIMOR TENGAH SELATAN, NUSA TENGGARA TIMUR",2,160,11,171
https://kawalpemilu.org#55521,"NOENONI, OENINO, TIMOR TENGAH SELATAN, NUSA TENGGARA TIMUR",3,170,9,179
https://kawalpemilu.org#55521,"NOENONI, OENINO, TIMOR TENGAH SELATAN, NUSA TENGGARA TIMUR",4,122,8,130
https://kawalpemilu.org#55521,"NOENONI, OENINO, TIMOR TENGAH SELATAN, NUSA TENGGARA TIMUR",5,100,6,106
https://kawalpemilu.org#55522,"HOI, OENINO, TIMOR TENGAH SELATAN, NUSA TENGGARA TIMUR",1,153,6,159
https://kawalpemilu.org#55522,"HOI, OENINO, TIMOR TENGAH SELATAN, NUSA TENGGARA TIMUR",2,190,3,193
https://kawalpemilu.org#55522,"HOI, OENINO, TIMOR TENGAH SELATAN, NUSA TENGGARA TIMUR",3,170,7,177
https://kawalpemilu.org#55522,"HOI, OENINO, TIMOR TENGAH SELATAN, NUSA TENGGARA TIMUR",4,181,5,186
https://kawalpemilu.org#55522,"HOI, OENINO, TIMOR TENGAH SELATAN, NUSA TENGGARA TIMUR",5,170,3,173
https://kawalpemilu.org#55522,"HOI, OENINO, TIMOR TENGAH SELATAN, NUSA TENGGARA TIMUR",6,155,12,167
https://kawalpemilu.org#55522,"HOI, OENINO, TIMOR TENGAH SELATAN, NUSA TENGGARA TIMUR",7,149,4,153
https://kawalpemilu.org#55523,"NIKI NIKI UN, OENINO, TIMOR TENGAH SELATAN, NUSA TENGGARA TIMUR",1,168,6,174
https://kawalpemilu.org#55523,"NIKI NIKI UN, OENINO, TIMOR TENGAH SELATAN, NUSA TENGGARA TIMUR",2,155,4,159
https://kawalpemilu.org#55523,"NIKI NIKI UN, OENINO, TIMOR TENGAH SELATAN, NUSA TENGGARA TIMUR",3,166,14,180
https://kawalpemilu.org#55524,"OENINO, OENINO, TIMOR TENGAH SELATAN, NUSA TENGGARA TIMUR",1,212,7,219
https://kawalpemilu.org#55524,"OENINO, OENINO, TIMOR TENGAH SELATAN, NUSA TENGGARA TIMUR",2,210,5,215
https://kawalpemilu.org#55524,"OENINO, OENINO, TIMOR TENGAH SELATAN, NUSA TENGGARA TIMUR",3,209,13,222
https://kawalpemilu.org#55525,"ABI, OENINO, TIMOR TENGAH SELATAN, NUSA TENGGARA TIMUR",1,149,3,152
https://kawalpemilu.org#55525,"ABI, OENINO, TIMOR TENGAH SELATAN, NUSA TENGGARA TIMUR",2,132,11,143
https://kawalpemilu.org#55525,"ABI, OENINO, TIMOR TENGAH SELATAN, NUSA TENGGARA TIMUR",3,111,7,118
https://kawalpemilu.org#55525,"ABI, OENINO, TIMOR TENGAH SELATAN, NUSA TENGGARA TIMUR",4,143,5,148
https://kawalpemilu.org#55527,"KOLBANO, KOLBANO, TIMOR TENGAH SELATAN, NUSA TENGGARA TIMUR",2,200,11,211
https://kawalpemilu.org#55527,"KOLBANO, KOLBANO, TIMOR TENGAH SELATAN, NUSA TENGGARA TIMUR",3,201,8,209
https://kawalpemilu.org#55527,"KOLBANO, KOLBANO, TIMOR TENGAH SELATAN, NUSA TENGGARA TIMUR",4,195,17,212
https://kawalpemilu.org#55527,"KOLBANO, KOLBANO, TIMOR TENGAH SELATAN, NUSA TENGGARA TIMUR",5,179,12,191
https://kawalpemilu.org#55528,"NOESIU, KOLBANO, TIMOR TENGAH SELATAN, NUSA TENGGARA TIMUR",1,154,2,156
https://kawalpemilu.org#55528,"NOESIU, KOLBANO, TIMOR TENGAH SELATAN, NUSA TENGGARA TIMUR",2,144,5,149
https://kawalpemilu.org#55529,"PENE SELATAN, KOLBANO, TIMOR TENGAH SELATAN, NUSA TENGGARA TIMUR",1,161,3,164
https://kawalpemilu.org#55529,"PENE SELATAN, KOLBANO, TIMOR TENGAH SELATAN, NUSA TENGGARA TIMUR",2,147,18,165
https://kawalpemilu.org#55529,"PENE SELATAN, KOLBANO, TIMOR TENGAH SELATAN, NUSA TENGGARA TIMUR",3,168,10,178
https://kawalpemilu.org#55529,"PENE SELATAN, KOLBANO, TIMOR TENGAH SELATAN, NUSA TENGGARA TIMUR",4,209,5,214
https://kawalpemilu.org#55529,"PENE SELATAN, KOLBANO, TIMOR TENGAH SELATAN, NUSA TENGGARA TIMUR",5,117,5,122
https://kawalpemilu.org#55530,"OETUKE, KOLBANO, TIMOR TENGAH SELATAN, NUSA TENGGARA TIMUR",1,143,0,143
https://kawalpemilu.org#55530,"OETUKE, KOLBANO, TIMOR TENGAH SELATAN, NUSA TENGGARA TIMUR",2,111,8,119
https://kawalpemilu.org#55530,"OETUKE, KOLBANO, TIMOR TENGAH SELATAN, NUSA TENGGARA TIMUR",3,171,4,175
https://kawalpemilu.org#55530,"OETUKE, KOLBANO, TIMOR TENGAH SELATAN, NUSA TENGGARA TIMUR",4,128,0,128
https://kawalpemilu.org#55530,"OETUKE, KOLBANO, TIMOR TENGAH SELATAN, NUSA TENGGARA TIMUR",5,107,0,107
https://kawalpemilu.org#55531,"BABUIN, KOLBANO, TIMOR TENGAH SELATAN, NUSA TENGGARA TIMUR",1,226,8,234
https://kawalpemilu.org#55531,"BABUIN, KOLBANO, TIMOR TENGAH SELATAN, NUSA TENGGARA TIMUR",2,206,0,206
https://kawalpemilu.org#55531,"BABUIN, KOLBANO, TIMOR TENGAH SELATAN, NUSA TENGGARA TIMUR",3,222,3,225
https://kawalpemilu.org#55531,"BABUIN, KOLBANO, TIMOR TENGAH SELATAN, NUSA TENGGARA TIMUR",4,216,5,221
https://kawalpemilu.org#55531,"BABUIN, KOLBANO, TIMOR TENGAH SELATAN, NUSA TENGGARA TIMUR",5,151,5,156
https://kawalpemilu.org#55532,"OELEU, KOLBANO, TIMOR TENGAH SELATAN, NUSA TENGGARA TIMUR",1,241,2,243
https://kawalpemilu.org#55532,"OELEU, KOLBANO, TIMOR TENGAH SELATAN, NUSA TENGGARA TIMUR",2,229,8,237
https://kawalpemilu.org#55532,"OELEU, KOLBANO, TIMOR TENGAH SELATAN, NUSA TENGGARA TIMUR",3,228,7,235
https://kawalpemilu.org#55532,"OELEU, KOLBANO, TIMOR TENGAH SELATAN, NUSA TENGGARA TIMUR",4,221,10,231
https://kawalpemilu.org#55532,"OELEU, KOLBANO, TIMOR TENGAH SELATAN, NUSA TENGGARA TIMUR",5,167,13,180
https://kawalpemilu.org#55532,"OELEU, KOLBANO, TIMOR TENGAH SELATAN, NUSA TENGGARA TIMUR",6,163,11,174
https://kawalpemilu.org#55533,"SE'I, KOLBANO, TIMOR TENGAH SELATAN, NUSA TENGGARA TIMUR",1,218,15,233
https://kawalpemilu.org#55533,"SE'I, KOLBANO, TIMOR TENGAH SELATAN, NUSA TENGGARA TIMUR",2,201,12,213
https://kawalpemilu.org#55533,"SE'I, KOLBANO, TIMOR TENGAH SELATAN, NUSA TENGGARA TIMUR",3,225,11,236
https://kawalpemilu.org#55533,"SE'I, KOLBANO, TIMOR TENGAH SELATAN, NUSA TENGGARA TIMUR",4,207,12,219
https://kawalpemilu.org#55533,"SE'I, KOLBANO, TIMOR TENGAH SELATAN, NUSA TENGGARA TIMUR",5,108,9,117
https://kawalpemilu.org#55534,"NUNUNAMAT, KOLBANO, TIMOR TENGAH SELATAN, NUSA TENGGARA TIMUR",1,188,8,196
https://kawalpemilu.org#55534,"NUNUNAMAT, KOLBANO, TIMOR TENGAH SELATAN, NUSA TENGGARA TIMUR",2,204,2,206
https://kawalpemilu.org#55534,"NUNUNAMAT, KOLBANO, TIMOR TENGAH SELATAN, NUSA TENGGARA TIMUR",3,98,5,103
https://kawalpemilu.org#55534,"NUNUNAMAT, KOLBANO, TIMOR TENGAH SELATAN, NUSA TENGGARA TIMUR",4,215,11,226
https://kawalpemilu.org#55534,"NUNUNAMAT, KOLBANO, TIMOR TENGAH SELATAN, NUSA TENGGARA TIMUR",5,154,1,155
https://kawalpemilu.org#55534,"NUNUNAMAT, KOLBANO, TIMOR TENGAH SELATAN, NUSA TENGGARA TIMUR",6,240,18,258
https://kawalpemilu.org#55535,"PANA, KOLBANO, TIMOR TENGAH SELATAN, NUSA TENGGARA TIMUR",1,212,9,221
https://kawalpemilu.org#55535,"PANA, KOLBANO, TIMOR TENGAH SELATAN, NUSA TENGGARA TIMUR",2,243,8,251
https://kawalpemilu.org#55535,"PANA, KOLBANO, TIMOR TENGAH SELATAN, NUSA TENGGARA TIMUR",3,209,1,210
https://kawalpemilu.org#55535,"PANA, KOLBANO, TIMOR TENGAH SELATAN, NUSA TENGGARA TIMUR",4,182,11,193
https://kawalpemilu.org#55536,"HAUNOBENAK, KOLBANO, TIMOR TENGAH SELATAN, NUSA TENGGARA TIMUR",1,190,5,195
https://kawalpemilu.org#55536,"HAUNOBENAK, KOLBANO, TIMOR TENGAH SELATAN, NUSA TENGGARA TIMUR",2,161,10,171
https://kawalpemilu.org#55536,"HAUNOBENAK, KOLBANO, TIMOR TENGAH SELATAN, NUSA TENGGARA TIMUR",3,116,18,134
https://kawalpemilu.org#55537,"OFU, KOLBANO, TIMOR TENGAH SELATAN, NUSA TENGGARA TIMUR",1,201,14,215
https://kawalpemilu.org#55537,"OFU, KOLBANO, TIMOR TENGAH SELATAN, NUSA TENGGARA TIMUR",2,195,7,202
https://kawalpemilu.org#55537,"OFU, KOLBANO, TIMOR TENGAH SELATAN, NUSA TENGGARA TIMUR",3,158,0,158
https://kawalpemilu.org#55537,"OFU, KOLBANO, TIMOR TENGAH SELATAN, NUSA TENGGARA TIMUR",4,166,8,174
https://kawalpemilu.org#55537,"OFU, KOLBANO, TIMOR TENGAH SELATAN, NUSA TENGGARA TIMUR",5,186,9,195
https://kawalpemilu.org#91075,"SPAHA, KOLBANO, TIMOR TENGAH SELATAN, NUSA TENGGARA TIMUR",1,161,14,175
https://kawalpemilu.org#91075,"SPAHA, KOLBANO, TIMOR TENGAH SELATAN, NUSA TENGGARA TIMUR",2,164,8,172
https://kawalpemilu.org#91075,"SPAHA, KOLBANO, TIMOR TENGAH SELATAN, NUSA TENGGARA TIMUR",3,109,2,111
https://kawalpemilu.org#55539,"KOT'OLIN, KOT OLIN, TIMOR TENGAH SELATAN, NUSA TENGGARA TIMUR",1,153,2,155
https://kawalpemilu.org#55539,"KOT'OLIN, KOT OLIN, TIMOR TENGAH SELATAN, NUSA TENGGARA TIMUR",2,146,3,149
https://kawalpemilu.org#55539,"KOT'OLIN, KOT OLIN, TIMOR TENGAH SELATAN, NUSA TENGGARA TIMUR",3,126,6,132
https://kawalpemilu.org#55539,"KOT'OLIN, KOT OLIN, TIMOR TENGAH SELATAN, NUSA TENGGARA TIMUR",4,136,3,139
https://kawalpemilu.org#55539,"KOT'OLIN, KOT OLIN, TIMOR TENGAH SELATAN, NUSA TENGGARA TIMUR",5,95,6,101
https://kawalpemilu.org#55539,"KOT'OLIN, KOT OLIN, TIMOR TENGAH SELATAN, NUSA TENGGARA TIMUR",6,130,5,135
https://kawalpemilu.org#55539,"KOT'OLIN, KOT OLIN, TIMOR TENGAH SELATAN, NUSA TENGGARA TIMUR",7,139,1,140
https://kawalpemilu.org#55539,"KOT'OLIN, KOT OLIN, TIMOR TENGAH SELATAN, NUSA TENGGARA TIMUR",9,107,15,122
https://kawalpemilu.org#55540,"NUNBENA, KOT OLIN, TIMOR TENGAH SELATAN, NUSA TENGGARA TIMUR",1,145,4,149
https://kawalpemilu.org#55540,"NUNBENA, KOT OLIN, TIMOR TENGAH SELATAN, NUSA TENGGARA TIMUR",2,146,23,169
https://kawalpemilu.org#55540,"NUNBENA, KOT OLIN, TIMOR TENGAH SELATAN, NUSA TENGGARA TIMUR",3,190,5,195
https://kawalpemilu.org#55541,"FATUAT, KOT OLIN, TIMOR TENGAH SELATAN, NUSA TENGGARA TIMUR",1,205,6,211
https://kawalpemilu.org#55541,"FATUAT, KOT OLIN, TIMOR TENGAH SELATAN, NUSA TENGGARA TIMUR",2,192,6,198
https://kawalpemilu.org#55541,"FATUAT, KOT OLIN, TIMOR TENGAH SELATAN, NUSA TENGGARA TIMUR",3,139,4,143
https://kawalpemilu.org#55541,"FATUAT, KOT OLIN, TIMOR TENGAH SELATAN, NUSA TENGGARA TIMUR",4,142,6,148
https://kawalpemilu.org#55542,"HOIBETI, KOT OLIN, TIMOR TENGAH SELATAN, NUSA TENGGARA TIMUR",1,209,8,217
https://kawalpemilu.org#55542,"HOIBETI, KOT OLIN, TIMOR TENGAH SELATAN, NUSA TENGGARA TIMUR",2,154,9,163
https://kawalpemilu.org#55542,"HOIBETI, KOT OLIN, TIMOR TENGAH SELATAN, NUSA TENGGARA TIMUR",3,76,3,79
https://kawalpemilu.org#55542,"HOIBETI, KOT OLIN, TIMOR TENGAH SELATAN, NUSA TENGGARA TIMUR",4,119,5,124
https://kawalpemilu.org#55542,"HOIBETI, KOT OLIN, TIMOR TENGAH SELATAN, NUSA TENGGARA TIMUR",5,111,13,124
https://kawalpemilu.org#55542,"HOIBETI, KOT OLIN, TIMOR TENGAH SELATAN, NUSA TENGGARA TIMUR",6,118,4,122
https://kawalpemilu.org#55542,"HOIBETI, KOT OLIN, TIMOR TENGAH SELATAN, NUSA TENGGARA TIMUR",7,129,7,136
https://kawalpemilu.org#55542,"HOIBETI, KOT OLIN, TIMOR TENGAH SELATAN, NUSA TENGGARA TIMUR",8,115,2,117
https://kawalpemilu.org#55543,"NUALUNAT, KOT OLIN, TIMOR TENGAH SELATAN, NUSA TENGGARA TIMUR",1,161,13,174
https://kawalpemilu.org#55543,"NUALUNAT, KOT OLIN, TIMOR TENGAH SELATAN, NUSA TENGGARA TIMUR",2,222,12,234
https://kawalpemilu.org#55543,"NUALUNAT, KOT OLIN, TIMOR TENGAH SELATAN, NUSA TENGGARA TIMUR",3,155,4,159
https://kawalpemilu.org#55543,"NUALUNAT, KOT OLIN, TIMOR TENGAH SELATAN, NUSA TENGGARA TIMUR",4,115,13,128
https://kawalpemilu.org#55544,"PONITE, KOT OLIN, TIMOR TENGAH SELATAN, NUSA TENGGARA TIMUR",1,151,2,153
https://kawalpemilu.org#55544,"PONITE, KOT OLIN, TIMOR TENGAH SELATAN, NUSA TENGGARA TIMUR",2,129,1,130
https://kawalpemilu.org#55544,"PONITE, KOT OLIN, TIMOR TENGAH SELATAN, NUSA TENGGARA TIMUR",3,122,0,122
https://kawalpemilu.org#55545,"BINENOK, KOT OLIN, TIMOR TENGAH SELATAN, NUSA TENGGARA TIMUR",1,112,4,116
https://kawalpemilu.org#55545,"BINENOK, KOT OLIN, TIMOR TENGAH SELATAN, NUSA TENGGARA TIMUR",2,116,3,119
https://kawalpemilu.org#55545,"BINENOK, KOT OLIN, TIMOR TENGAH SELATAN, NUSA TENGGARA TIMUR",3,135,4,139
https://kawalpemilu.org#55545,"BINENOK, KOT OLIN, TIMOR TENGAH SELATAN, NUSA TENGGARA TIMUR",4,123,3,126
https://kawalpemilu.org#55546,"O'OBIBI, KOT OLIN, TIMOR TENGAH SELATAN, NUSA TENGGARA TIMUR",1,204,1,205
https://kawalpemilu.org#55546,"O'OBIBI, KOT OLIN, TIMOR TENGAH SELATAN, NUSA TENGGARA TIMUR",2,173,3,176
https://kawalpemilu.org#55546,"O'OBIBI, KOT OLIN, TIMOR TENGAH SELATAN, NUSA TENGGARA TIMUR",3,135,2,137
https://kawalpemilu.org#55546,"O'OBIBI, KOT OLIN, TIMOR TENGAH SELATAN, NUSA TENGGARA TIMUR",4,91,0,91
https://kawalpemilu.org#55548,"KUALIN, KUALIN, TIMOR TENGAH SELATAN, NUSA TENGGARA TIMUR",1,151,13,164
https://kawalpemilu.org#55548,"KUALIN, KUALIN, TIMOR TENGAH SELATAN, NUSA TENGGARA TIMUR",2,147,7,154
https://kawalpemilu.org#55548,"KUALIN, KUALIN, TIMOR TENGAH SELATAN, NUSA TENGGARA TIMUR",3,220,30,250
https://kawalpemilu.org#55548,"KUALIN, KUALIN, TIMOR TENGAH SELATAN, NUSA TENGGARA TIMUR",4,164,6,170
https://kawalpemilu.org#55548,"KUALIN, KUALIN, TIMOR TENGAH SELATAN, NUSA TENGGARA TIMUR",5,146,1,147
https://kawalpemilu.org#55548,"KUALIN, KUALIN, TIMOR TENGAH SELATAN, NUSA TENGGARA TIMUR",6,193,8,201
https://kawalpemilu.org#55549,"ONI, KUALIN, TIMOR TENGAH SELATAN, NUSA TENGGARA TIMUR",1,211,15,226
https://kawalpemilu.org#55549,"ONI, KUALIN, TIMOR TENGAH SELATAN, NUSA TENGGARA TIMUR",2,160,8,168
https://kawalpemilu.org#55549,"ONI, KUALIN, TIMOR TENGAH SELATAN, NUSA TENGGARA TIMUR",3,152,7,159
https://kawalpemilu.org#55549,"ONI, KUALIN, TIMOR TENGAH SELATAN, NUSA TENGGARA TIMUR",4,206,1,207
https://kawalpemilu.org#55549,"ONI, KUALIN, TIMOR TENGAH SELATAN, NUSA TENGGARA TIMUR",5,167,5,172
https://kawalpemilu.org#55550,"NUNUSUNU, KUALIN, TIMOR TENGAH SELATAN, NUSA TENGGARA TIMUR",1,181,4,185
https://kawalpemilu.org#55550,"NUNUSUNU, KUALIN, TIMOR TENGAH SELATAN, NUSA TENGGARA TIMUR",2,110,7,117
https://kawalpemilu.org#55550,"NUNUSUNU, KUALIN, TIMOR TENGAH SELATAN, NUSA TENGGARA TIMUR",3,188,10,198
https://kawalpemilu.org#55550,"NUNUSUNU, KUALIN, TIMOR TENGAH SELATAN, NUSA TENGGARA TIMUR",4,153,5,158
https://kawalpemilu.org#55550,"NUNUSUNU, KUALIN, TIMOR TENGAH SELATAN, NUSA TENGGARA TIMUR",5,138,4,142
https://kawalpemilu.org#55550,"NUNUSUNU, KUALIN, TIMOR TENGAH SELATAN, NUSA TENGGARA TIMUR",6,167,1,168
https://kawalpemilu.org#55550,"NUNUSUNU, KUALIN, TIMOR TENGAH SELATAN, NUSA TENGGARA TIMUR",7,218,8,226
https://kawalpemilu.org#55550,"NUNUSUNU, KUALIN, TIMOR TENGAH SELATAN, NUSA TENGGARA TIMUR",8,208,7,215
https://kawalpemilu.org#55550,"NUNUSUNU, KUALIN, TIMOR TENGAH SELATAN, NUSA TENGGARA TIMUR",9,235,0,235
https://kawalpemilu.org#55550,"NUNUSUNU, KUALIN, TIMOR TENGAH SELATAN, NUSA TENGGARA TIMUR",10,208,10,218
https://kawalpemilu.org#55551,"TUAPAKAS, KUALIN, TIMOR TENGAH SELATAN, NUSA TENGGARA TIMUR",1,230,9,239
https://kawalpemilu.org#55551,"TUAPAKAS, KUALIN, TIMOR TENGAH SELATAN, NUSA TENGGARA TIMUR",2,218,5,223
https://kawalpemilu.org#55551,"TUAPAKAS, KUALIN, TIMOR TENGAH SELATAN, NUSA TENGGARA TIMUR",3,230,14,244
https://kawalpemilu.org#55551,"TUAPAKAS, KUALIN, TIMOR TENGAH SELATAN, NUSA TENGGARA TIMUR",4,210,6,216
https://kawalpemilu.org#55551,"TUAPAKAS, KUALIN, TIMOR TENGAH SELATAN, NUSA TENGGARA TIMUR",5,221,14,235
https://kawalpemilu.org#55551,"TUAPAKAS, KUALIN, TIMOR TENGAH SELATAN, NUSA TENGGARA TIMUR",6,85,3,88
https://kawalpemilu.org#55552,"TOINEKE, KUALIN, TIMOR TENGAH SELATAN, NUSA TENGGARA TIMUR",1,222,17,239
https://kawalpemilu.org#55552,"TOINEKE, KUALIN, TIMOR TENGAH SELATAN, NUSA TENGGARA TIMUR",2,208,9,217
https://kawalpemilu.org#55552,"TOINEKE, KUALIN, TIMOR TENGAH SELATAN, NUSA TENGGARA TIMUR",3,236,5,241
https://kawalpemilu.org#55552,"TOINEKE, KUALIN, TIMOR TENGAH SELATAN, NUSA TENGGARA TIMUR",4,237,12,249
https://kawalpemilu.org#55552,"TOINEKE, KUALIN, TIMOR TENGAH SELATAN, NUSA TENGGARA TIMUR",5,210,17,227
https://kawalpemilu.org#55552,"TOINEKE, KUALIN, TIMOR TENGAH SELATAN, NUSA TENGGARA TIMUR",6,196,10,206
https://kawalpemilu.org#55553,"TUAFANU, KUALIN, TIMOR TENGAH SELATAN, NUSA TENGGARA TIMUR",1,244,13,257
https://kawalpemilu.org#55553,"TUAFANU, KUALIN, TIMOR TENGAH SELATAN, NUSA TENGGARA TIMUR",2,240,9,249
https://kawalpemilu.org#55553,"TUAFANU, KUALIN, TIMOR TENGAH SELATAN, NUSA TENGGARA TIMUR",3,197,6,203
https://kawalpemilu.org#55553,"TUAFANU, KUALIN, TIMOR TENGAH SELATAN, NUSA TENGGARA TIMUR",4,230,2,232
https://kawalpemilu.org#55553,"TUAFANU, KUALIN, TIMOR TENGAH SELATAN, NUSA TENGGARA TIMUR",5,200,10,210
https://kawalpemilu.org#55553,"TUAFANU, KUALIN, TIMOR TENGAH SELATAN, NUSA TENGGARA TIMUR",6,209,4,213
https://kawalpemilu.org#55553,"TUAFANU, KUALIN, TIMOR TENGAH SELATAN, NUSA TENGGARA TIMUR",7,149,4,153
https://kawalpemilu.org#55553,"TUAFANU, KUALIN, TIMOR TENGAH SELATAN, NUSA TENGGARA TIMUR",8,132,2,134
https://kawalpemilu.org#55554,"KIUFATU, KUALIN, TIMOR TENGAH SELATAN, NUSA TENGGARA TIMUR",1,160,15,175
https://kawalpemilu.org#55554,"KIUFATU, KUALIN, TIMOR TENGAH SELATAN, NUSA TENGGARA TIMUR",2,209,7,216
https://kawalpemilu.org#55554,"KIUFATU, KUALIN, TIMOR TENGAH SELATAN, NUSA TENGGARA TIMUR",3,179,5,184
https://kawalpemilu.org#55554,"KIUFATU, KUALIN, TIMOR TENGAH SELATAN, NUSA TENGGARA TIMUR",4,194,8,202
https://kawalpemilu.org#55554,"KIUFATU, KUALIN, TIMOR TENGAH SELATAN, NUSA TENGGARA TIMUR",5,211,7,218
https://kawalpemilu.org#55554,"KIUFATU, KUALIN, TIMOR TENGAH SELATAN, NUSA TENGGARA TIMUR",6,193,9,202
https://kawalpemilu.org#55554,"KIUFATU, KUALIN, TIMOR TENGAH SELATAN, NUSA TENGGARA TIMUR",7,153,10,163
https://kawalpemilu.org#55554,"KIUFATU, KUALIN, TIMOR TENGAH SELATAN, NUSA TENGGARA TIMUR",8,188,21,209
https://kawalpemilu.org#91074,"OEMAMAN, KUALIN, TIMOR TENGAH SELATAN, NUSA TENGGARA TIMUR",1,146,7,153
https://kawalpemilu.org#91074,"OEMAMAN, KUALIN, TIMOR TENGAH SELATAN, NUSA TENGGARA TIMUR",2,183,6,189
https://kawalpemilu.org#91074,"OEMAMAN, KUALIN, TIMOR TENGAH SELATAN, NUSA TENGGARA TIMUR",3,184,3,187
https://kawalpemilu.org#55556,"BESANA, MOLLO BARAT, TIMOR TENGAH SELATAN, NUSA TENGGARA TIMUR",1,131,22,153
https://kawalpemilu.org#55556,"BESANA, MOLLO BARAT, TIMOR TENGAH SELATAN, NUSA TENGGARA TIMUR",2,221,11,232
https://kawalpemilu.org#55556,"BESANA, MOLLO BARAT, TIMOR TENGAH SELATAN, NUSA TENGGARA TIMUR",3,244,4,248
https://kawalpemilu.org#55556,"BESANA, MOLLO BARAT, TIMOR TENGAH SELATAN, NUSA TENGGARA TIMUR",4,246,16,262
https://kawalpemilu.org#55557,"FATUKOKO, MOLLO BARAT, TIMOR TENGAH SELATAN, NUSA TENGGARA TIMUR",1,197,2,199
https://kawalpemilu.org#55557,"FATUKOKO, MOLLO BARAT, TIMOR TENGAH SELATAN, NUSA TENGGARA TIMUR",2,186,13,199
https://kawalpemilu.org#55557,"FATUKOKO, MOLLO BARAT, TIMOR TENGAH SELATAN, NUSA TENGGARA TIMUR",3,139,5,144
https://kawalpemilu.org#55557,"FATUKOKO, MOLLO BARAT, TIMOR TENGAH SELATAN, NUSA TENGGARA TIMUR",4,158,5,163
https://kawalpemilu.org#55558,"KOA, MOLLO BARAT, TIMOR TENGAH SELATAN, NUSA TENGGARA TIMUR",1,140,18,158
https://kawalpemilu.org#55558,"KOA, MOLLO BARAT, TIMOR TENGAH SELATAN, NUSA TENGGARA TIMUR",2,170,2,172
https://kawalpemilu.org#55558,"KOA, MOLLO BARAT, TIMOR TENGAH SELATAN, NUSA TENGGARA TIMUR",3,108,51,159
https://kawalpemilu.org#55558,"KOA, MOLLO BARAT, TIMOR TENGAH SELATAN, NUSA TENGGARA TIMUR",4,69,120,189
https://kawalpemilu.org#55558,"KOA, MOLLO BARAT, TIMOR TENGAH SELATAN, NUSA TENGGARA TIMUR",5,138,16,154
https://kawalpemilu.org#55558,"KOA, MOLLO BARAT, TIMOR TENGAH SELATAN, NUSA TENGGARA TIMUR",6,212,12,224
https://kawalpemilu.org#55559,"OEL UBAN, MOLLO BARAT, TIMOR TENGAH SELATAN, NUSA TENGGARA TIMUR",1,194,26,220
https://kawalpemilu.org#55559,"OEL UBAN, MOLLO BARAT, TIMOR TENGAH SELATAN, NUSA TENGGARA TIMUR",2,215,23,238
https://kawalpemilu.org#55559,"OEL UBAN, MOLLO BARAT, TIMOR TENGAH SELATAN, NUSA TENGGARA TIMUR",3,152,18,170
https://kawalpemilu.org#55559,"OEL UBAN, MOLLO BARAT, TIMOR TENGAH SELATAN, NUSA TENGGARA TIMUR",4,174,10,184
https://kawalpemilu.org#55560,"SALBAIT, MOLLO BARAT, TIMOR TENGAH SELATAN, NUSA TENGGARA TIMUR",1,176,27,203
https://kawalpemilu.org#55560,"SALBAIT, MOLLO BARAT, TIMOR TENGAH SELATAN, NUSA TENGGARA TIMUR",2,190,20,210
https://kawalpemilu.org#55560,"SALBAIT, MOLLO BARAT, TIMOR TENGAH SELATAN, NUSA TENGGARA TIMUR",3,199,7,206
https://kawalpemilu.org#55562,"LOTAS, KOK BAUN, TIMOR TENGAH SELATAN, NUSA TENGGARA TIMUR",1,161,6,167
https://kawalpemilu.org#55563,"SABNALA, KOK BAUN, TIMOR TENGAH SELATAN, NUSA TENGGARA TIMUR",1,157,4,161
https://kawalpemilu.org#55563,"SABNALA, KOK BAUN, TIMOR TENGAH SELATAN, NUSA TENGGARA TIMUR",2,162,7,169
https://kawalpemilu.org#55563,"SABNALA, KOK BAUN, TIMOR TENGAH SELATAN, NUSA TENGGARA TIMUR",3,174,7,181
https://kawalpemilu.org#55564,"KOLOTO, KOK BAUN, TIMOR TENGAH SELATAN, NUSA TENGGARA TIMUR",1,182,2,184
https://kawalpemilu.org#55565,"OBAKI, KOK BAUN, TIMOR TENGAH SELATAN, NUSA TENGGARA TIMUR",1,150,14,164
https://kawalpemilu.org#55566,"NITI, KOK BAUN, TIMOR TENGAH SELATAN, NUSA TENGGARA TIMUR",1,183,7,190
https://kawalpemilu.org#55566,"NITI, KOK BAUN, TIMOR TENGAH SELATAN, NUSA TENGGARA TIMUR",2,143,5,148
https://kawalpemilu.org#55567,"BENEHE, KOK BAUN, TIMOR TENGAH SELATAN, NUSA TENGGARA TIMUR",1,128,12,140
https://kawalpemilu.org#55569,"NOEBANA, NOEBANA, TIMOR TENGAH SELATAN, NUSA TENGGARA TIMUR",1,174,1,175
https://kawalpemilu.org#55569,"NOEBANA, NOEBANA, TIMOR TENGAH SELATAN, NUSA TENGGARA TIMUR",2,155,8,163
https://kawalpemilu.org#55569,"NOEBANA, NOEBANA, TIMOR TENGAH SELATAN, NUSA TENGGARA TIMUR",3,157,7,164
https://kawalpemilu.org#55570,"FATUMNASI, NOEBANA, TIMOR TENGAH SELATAN, NUSA TENGGARA TIMUR",1,253,4,257
https://kawalpemilu.org#55570,"FATUMNASI, NOEBANA, TIMOR TENGAH SELATAN, NUSA TENGGARA TIMUR",2,130,10,140
https://kawalpemilu.org#55570,"FATUMNASI, NOEBANA, TIMOR TENGAH SELATAN, NUSA TENGGARA TIMUR",3,201,10,211
https://kawalpemilu.org#55571,"SUNI, NOEBANA, TIMOR TENGAH SELATAN, NUSA TENGGARA TIMUR",1,167,3,170
https://kawalpemilu.org#55571,"SUNI, NOEBANA, TIMOR TENGAH SELATAN, NUSA TENGGARA TIMUR",2,157,5,162
https://kawalpemilu.org#55572,"MELLA, NOEBANA, TIMOR TENGAH SELATAN, NUSA TENGGARA TIMUR",1,196,26,222
https://kawalpemilu.org#55572,"MELLA, NOEBANA, TIMOR TENGAH SELATAN, NUSA TENGGARA TIMUR",2,202,10,212
https://kawalpemilu.org#55572,"MELLA, NOEBANA, TIMOR TENGAH SELATAN, NUSA TENGGARA TIMUR",3,160,5,165
https://kawalpemilu.org#91073,"MNELAPETU, NOEBANA, TIMOR TENGAH SELATAN, NUSA TENGGARA TIMUR",1,106,10,116
https://kawalpemilu.org#91073,"MNELAPETU, NOEBANA, TIMOR TENGAH SELATAN, NUSA TENGGARA TIMUR",2,90,4,94
https://kawalpemilu.org#55574,"SANTIAN, SANTIAN, TIMOR TENGAH SELATAN, NUSA TENGGARA TIMUR",1,199,27,226
https://kawalpemilu.org#55574,"SANTIAN, SANTIAN, TIMOR TENGAH SELATAN, NUSA TENGGARA TIMUR",2,163,32,195
https://kawalpemilu.org#55575,"POLI, SANTIAN, TIMOR TENGAH SELATAN, NUSA TENGGARA TIMUR",1,218,5,223
https://kawalpemilu.org#55575,"POLI, SANTIAN, TIMOR TENGAH SELATAN, NUSA TENGGARA TIMUR",3,118,5,123
https://kawalpemilu.org#55575,"POLI, SANTIAN, TIMOR TENGAH SELATAN, NUSA TENGGARA TIMUR",4,113,3,116
https://kawalpemilu.org#55575,"POLI, SANTIAN, TIMOR TENGAH SELATAN, NUSA TENGGARA TIMUR",5,192,3,195
https://kawalpemilu.org#55575,"POLI, SANTIAN, TIMOR TENGAH SELATAN, NUSA TENGGARA TIMUR",6,149,1,150
https://kawalpemilu.org#55575,"POLI, SANTIAN, TIMOR TENGAH SELATAN, NUSA TENGGARA TIMUR",7,147,8,155
https://kawalpemilu.org#55576,"MANUFUI, SANTIAN, TIMOR TENGAH SELATAN, NUSA TENGGARA TIMUR",1,114,20,134
https://kawalpemilu.org#55576,"MANUFUI, SANTIAN, TIMOR TENGAH SELATAN, NUSA TENGGARA TIMUR",2,162,10,172
https://kawalpemilu.org#55576,"MANUFUI, SANTIAN, TIMOR TENGAH SELATAN, NUSA TENGGARA TIMUR",3,140,18,158
https://kawalpemilu.org#55576,"MANUFUI, SANTIAN, TIMOR TENGAH SELATAN, NUSA TENGGARA TIMUR",4,132,23,155
https://kawalpemilu.org#55576,"MANUFUI, SANTIAN, TIMOR TENGAH SELATAN, NUSA TENGGARA TIMUR",5,132,6,138
https://kawalpemilu.org#55576,"MANUFUI, SANTIAN, TIMOR TENGAH SELATAN, NUSA TENGGARA TIMUR",6,133,17,150
https://kawalpemilu.org#55576,"MANUFUI, SANTIAN, TIMOR TENGAH SELATAN, NUSA TENGGARA TIMUR",7,108,9,117
https://kawalpemilu.org#55576,"MANUFUI, SANTIAN, TIMOR TENGAH SELATAN, NUSA TENGGARA TIMUR",8,83,3,86
https://kawalpemilu.org#55577,"NENOTES, SANTIAN, TIMOR TENGAH SELATAN, NUSA TENGGARA TIMUR",1,114,2,116
https://kawalpemilu.org#55577,"NENOTES, SANTIAN, TIMOR TENGAH SELATAN, NUSA TENGGARA TIMUR",2,166,18,184
https://kawalpemilu.org#55577,"NENOTES, SANTIAN, TIMOR TENGAH SELATAN, NUSA TENGGARA TIMUR",3,108,10,118
https://kawalpemilu.org#91072,"NAIFATU, SANTIAN, TIMOR TENGAH SELATAN, NUSA TENGGARA TIMUR",1,187,6,193
https://kawalpemilu.org#55579,"NAIP, NOEBEBA, TIMOR TENGAH SELATAN, NUSA TENGGARA TIMUR",1,220,3,223
https://kawalpemilu.org#55579,"NAIP, NOEBEBA, TIMOR TENGAH SELATAN, NUSA TENGGARA TIMUR",2,225,1,226
https://kawalpemilu.org#55580,"FATUTNANA, NOEBEBA, TIMOR TENGAH SELATAN, NUSA TENGGARA TIMUR",1,166,1,167
https://kawalpemilu.org#55580,"FATUTNANA, NOEBEBA, TIMOR TENGAH SELATAN, NUSA TENGGARA TIMUR",2,142,1,143
https://kawalpemilu.org#55580,"FATUTNANA, NOEBEBA, TIMOR TENGAH SELATAN, NUSA TENGGARA TIMUR",3,143,5,148
https://kawalpemilu.org#55581,"OEPLIKI, NOEBEBA, TIMOR TENGAH SELATAN, NUSA TENGGARA TIMUR",1,180,6,186
https://kawalpemilu.org#55581,"OEPLIKI, NOEBEBA, TIMOR TENGAH SELATAN, NUSA TENGGARA TIMUR",2,155,11,166
https://kawalpemilu.org#55581,"OEPLIKI, NOEBEBA, TIMOR TENGAH SELATAN, NUSA TENGGARA TIMUR",3,183,8,191
https://kawalpemilu.org#55581,"OEPLIKI, NOEBEBA, TIMOR TENGAH SELATAN, NUSA TENGGARA TIMUR",4,170,7,177
https://kawalpemilu.org#55581,"OEPLIKI, NOEBEBA, TIMOR TENGAH SELATAN, NUSA TENGGARA TIMUR",5,150,4,154
https://kawalpemilu.org#55581,"OEPLIKI, NOEBEBA, TIMOR TENGAH SELATAN, NUSA TENGGARA TIMUR",6,110,5,115
https://kawalpemilu.org#55581,"OEPLIKI, NOEBEBA, TIMOR TENGAH SELATAN, NUSA TENGGARA TIMUR",7,117,5,122
https://kawalpemilu.org#55582,"OE'EKAM, NOEBEBA, TIMOR TENGAH SELATAN, NUSA TENGGARA TIMUR",1,220,5,225
https://kawalpemilu.org#55582,"OE'EKAM, NOEBEBA, TIMOR TENGAH SELATAN, NUSA TENGGARA TIMUR",2,217,8,225
https://kawalpemilu.org#55582,"OE'EKAM, NOEBEBA, TIMOR TENGAH SELATAN, NUSA TENGGARA TIMUR",3,263,4,267
https://kawalpemilu.org#55582,"OE'EKAM, NOEBEBA, TIMOR TENGAH SELATAN, NUSA TENGGARA TIMUR",4,227,12,239
https://kawalpemilu.org#55582,"OE'EKAM, NOEBEBA, TIMOR TENGAH SELATAN, NUSA TENGGARA TIMUR",5,182,7,189
https://kawalpemilu.org#55582,"OE'EKAM, NOEBEBA, TIMOR TENGAH SELATAN, NUSA TENGGARA TIMUR",6,229,4,233
https://kawalpemilu.org#55583,"TEAS, NOEBEBA, TIMOR TENGAH SELATAN, NUSA TENGGARA TIMUR",1,189,21,210
https://kawalpemilu.org#55583,"TEAS, NOEBEBA, TIMOR TENGAH SELATAN, NUSA TENGGARA TIMUR",2,198,16,214
https://kawalpemilu.org#55583,"TEAS, NOEBEBA, TIMOR TENGAH SELATAN, NUSA TENGGARA TIMUR",3,208,20,228
https://kawalpemilu.org#55583,"TEAS, NOEBEBA, TIMOR TENGAH SELATAN, NUSA TENGGARA TIMUR",4,207,15,222
https://kawalpemilu.org#55583,"TEAS, NOEBEBA, TIMOR TENGAH SELATAN, NUSA TENGGARA TIMUR",5,170,2,172
https://kawalpemilu.org#55583,"TEAS, NOEBEBA, TIMOR TENGAH SELATAN, NUSA TENGGARA TIMUR",6,198,5,203
https://kawalpemilu.org#55584,"OEBAKI, NOEBEBA, TIMOR TENGAH SELATAN, NUSA TENGGARA TIMUR",1,140,7,147
https://kawalpemilu.org#55584,"OEBAKI, NOEBEBA, TIMOR TENGAH SELATAN, NUSA TENGGARA TIMUR",2,128,16,144
https://kawalpemilu.org#55584,"OEBAKI, NOEBEBA, TIMOR TENGAH SELATAN, NUSA TENGGARA TIMUR",3,131,6,137
https://kawalpemilu.org#55584,"OEBAKI, NOEBEBA, TIMOR TENGAH SELATAN, NUSA TENGGARA TIMUR",4,180,5,185
https://kawalpemilu.org#55584,"OEBAKI, NOEBEBA, TIMOR TENGAH SELATAN, NUSA TENGGARA TIMUR",5,158,8,166
https://kawalpemilu.org#55584,"OEBAKI, NOEBEBA, TIMOR TENGAH SELATAN, NUSA TENGGARA TIMUR",6,171,13,184
https://kawalpemilu.org#91071,"ENO NABUASA, NOEBEBA, TIMOR TENGAH SELATAN, NUSA TENGGARA TIMUR",1,155,12,167
https://kawalpemilu.org#91071,"ENO NABUASA, NOEBEBA, TIMOR TENGAH SELATAN, NUSA TENGGARA TIMUR",2,164,4,168
https://kawalpemilu.org#91071,"ENO NABUASA, NOEBEBA, TIMOR TENGAH SELATAN, NUSA TENGGARA TIMUR",3,168,0,168
https://kawalpemilu.org#55586,"TETAF, KUATNANA, TIMOR TENGAH SELATAN, NUSA TENGGARA TIMUR",1,213,3,216
https://kawalpemilu.org#55586,"TETAF, KUATNANA, TIMOR TENGAH SELATAN, NUSA TENGGARA TIMUR",2,186,14,200
https://kawalpemilu.org#55586,"TETAF, KUATNANA, TIMOR TENGAH SELATAN, NUSA TENGGARA TIMUR",3,186,12,198
https://kawalpemilu.org#55586,"TETAF, KUATNANA, TIMOR TENGAH SELATAN, NUSA TENGGARA TIMUR",4,206,1,207
https://kawalpemilu.org#55586,"TETAF, KUATNANA, TIMOR TENGAH SELATAN, NUSA TENGGARA TIMUR",5,211,15,226
https://kawalpemilu.org#55586,"TETAF, KUATNANA, TIMOR TENGAH SELATAN, NUSA TENGGARA TIMUR",6,184,26,210
https://kawalpemilu.org#55586,"TETAF, KUATNANA, TIMOR TENGAH SELATAN, NUSA TENGGARA TIMUR",7,188,23,211
https://kawalpemilu.org#55586,"TETAF, KUATNANA, TIMOR TENGAH SELATAN, NUSA TENGGARA TIMUR",8,183,3,186
https://kawalpemilu.org#55586,"TETAF, KUATNANA, TIMOR TENGAH SELATAN, NUSA TENGGARA TIMUR",9,177,4,181
https://kawalpemilu.org#55586,"TETAF, KUATNANA, TIMOR TENGAH SELATAN, NUSA TENGGARA TIMUR",10,160,1,161
https://kawalpemilu.org#55587,"NAUKAE, KUATNANA, TIMOR TENGAH SELATAN, NUSA TENGGARA TIMUR",1,199,12,211
https://kawalpemilu.org#55587,"NAUKAE, KUATNANA, TIMOR TENGAH SELATAN, NUSA TENGGARA TIMUR",2,183,10,193
https://kawalpemilu.org#55587,"NAUKAE, KUATNANA, TIMOR TENGAH SELATAN, NUSA TENGGARA TIMUR",3,152,3,155
https://kawalpemilu.org#55587,"NAUKAE, KUATNANA, TIMOR TENGAH SELATAN, NUSA TENGGARA TIMUR",4,224,6,230
https://kawalpemilu.org#55587,"NAUKAE, KUATNANA, TIMOR TENGAH SELATAN, NUSA TENGGARA TIMUR",5,215,1,216
https://kawalpemilu.org#55588,"SUPUL, KUATNANA, TIMOR TENGAH SELATAN, NUSA TENGGARA TIMUR",1,187,9,196
https://kawalpemilu.org#55588,"SUPUL, KUATNANA, TIMOR TENGAH SELATAN, NUSA TENGGARA TIMUR",2,212,17,229
https://kawalpemilu.org#55588,"SUPUL, KUATNANA, TIMOR TENGAH SELATAN, NUSA TENGGARA TIMUR",3,189,17,206
https://kawalpemilu.org#55588,"SUPUL, KUATNANA, TIMOR TENGAH SELATAN, NUSA TENGGARA TIMUR",4,114,2,116
https://kawalpemilu.org#55588,"SUPUL, KUATNANA, TIMOR TENGAH SELATAN, NUSA TENGGARA TIMUR",5,171,6,177
https://kawalpemilu.org#55589,"LAKAT, KUATNANA, TIMOR TENGAH SELATAN, NUSA TENGGARA TIMUR",1,229,25,254
https://kawalpemilu.org#55589,"LAKAT, KUATNANA, TIMOR TENGAH SELATAN, NUSA TENGGARA TIMUR",2,236,4,240
https://kawalpemilu.org#55589,"LAKAT, KUATNANA, TIMOR TENGAH SELATAN, NUSA TENGGARA TIMUR",3,215,8,223
https://kawalpemilu.org#55589,"LAKAT, KUATNANA, TIMOR TENGAH SELATAN, NUSA TENGGARA TIMUR",4,171,7,178
https://kawalpemilu.org#55589,"LAKAT, KUATNANA, TIMOR TENGAH SELATAN, NUSA TENGGARA TIMUR",5,173,0,173
https://kawalpemilu.org#55589,"LAKAT, KUATNANA, TIMOR TENGAH SELATAN, NUSA TENGGARA TIMUR",6,89,1,90
https://kawalpemilu.org#55590,"ENONEONTES, KUATNANA, TIMOR TENGAH SELATAN, NUSA TENGGARA TIMUR",1,207,8,215
https://kawalpemilu.org#55590,"ENONEONTES, KUATNANA, TIMOR TENGAH SELATAN, NUSA TENGGARA TIMUR",2,230,3,233
https://kawalpemilu.org#55590,"ENONEONTES, KUATNANA, TIMOR TENGAH SELATAN, NUSA TENGGARA TIMUR",3,168,12,180
https://kawalpemilu.org#55590,"ENONEONTES, KUATNANA, TIMOR TENGAH SELATAN, NUSA TENGGARA TIMUR",4,175,2,177
https://kawalpemilu.org#55591,"O'OF, KUATNANA, TIMOR TENGAH SELATAN, NUSA TENGGARA TIMUR",1,215,3,218
https://kawalpemilu.org#55591,"O'OF, KUATNANA, TIMOR TENGAH SELATAN, NUSA TENGGARA TIMUR",2,194,2,196
https://kawalpemilu.org#55591,"O'OF, KUATNANA, TIMOR TENGAH SELATAN, NUSA TENGGARA TIMUR",3,167,4,171
https://kawalpemilu.org#55591,"O'OF, KUATNANA, TIMOR TENGAH SELATAN, NUSA TENGGARA TIMUR",4,229,11,240
https://kawalpemilu.org#55591,"O'OF, KUATNANA, TIMOR TENGAH SELATAN, NUSA TENGGARA TIMUR",5,190,4,194
https://kawalpemilu.org#55592,"TUBMONAS, KUATNANA, TIMOR TENGAH SELATAN, NUSA TENGGARA TIMUR",1,183,2,185
https://kawalpemilu.org#55592,"TUBMONAS, KUATNANA, TIMOR TENGAH SELATAN, NUSA TENGGARA TIMUR",2,176,3,179
https://kawalpemilu.org#55592,"TUBMONAS, KUATNANA, TIMOR TENGAH SELATAN, NUSA TENGGARA TIMUR",3,148,4,152
https://kawalpemilu.org#55592,"TUBMONAS, KUATNANA, TIMOR TENGAH SELATAN, NUSA TENGGARA TIMUR",4,175,5,180
https://kawalpemilu.org#91070,"OE OE, KUATNANA, TIMOR TENGAH SELATAN, NUSA TENGGARA TIMUR",1,171,8,179
https://kawalpemilu.org#91070,"OE OE, KUATNANA, TIMOR TENGAH SELATAN, NUSA TENGGARA TIMUR",2,154,4,158
https://kawalpemilu.org#91070,"OE OE, KUATNANA, TIMOR TENGAH SELATAN, NUSA TENGGARA TIMUR",3,147,0,147
https://kawalpemilu.org#55594,"SILLU, FAUTMOLO, TIMOR TENGAH SELATAN, NUSA TENGGARA TIMUR",1,197,7,204
https://kawalpemilu.org#55594,"SILLU, FAUTMOLO, TIMOR TENGAH SELATAN, NUSA TENGGARA TIMUR",2,192,5,197
https://kawalpemilu.org#55595,"NUNUKHNITI, FAUTMOLO, TIMOR TENGAH SELATAN, NUSA TENGGARA TIMUR",1,218,19,237
https://kawalpemilu.org#55595,"NUNUKHNITI, FAUTMOLO, TIMOR TENGAH SELATAN, NUSA TENGGARA TIMUR",2,197,15,212
https://kawalpemilu.org#55595,"NUNUKHNITI, FAUTMOLO, TIMOR TENGAH SELATAN, NUSA TENGGARA TIMUR",3,112,4,116
https://kawalpemilu.org#55596,"KAENENO, FAUTMOLO, TIMOR TENGAH SELATAN, NUSA TENGGARA TIMUR",1,222,7,229
https://kawalpemilu.org#55596,"KAENENO, FAUTMOLO, TIMOR TENGAH SELATAN, NUSA TENGGARA TIMUR",2,203,6,209
https://kawalpemilu.org#55596,"KAENENO, FAUTMOLO, TIMOR TENGAH SELATAN, NUSA TENGGARA TIMUR",3,177,7,184
https://kawalpemilu.org#55597,"OELEON, FAUTMOLO, TIMOR TENGAH SELATAN, NUSA TENGGARA TIMUR",1,211,14,225
https://kawalpemilu.org#55597,"OELEON, FAUTMOLO, TIMOR TENGAH SELATAN, NUSA TENGGARA TIMUR",2,211,13,224
https://kawalpemilu.org#55597,"OELEON, FAUTMOLO, TIMOR TENGAH SELATAN, NUSA TENGGARA TIMUR",3,135,0,135
https://kawalpemilu.org#91098,"TUNIS, FAUTMOLO, TIMOR TENGAH SELATAN, NUSA TENGGARA TIMUR",1,202,4,206
https://kawalpemilu.org#91098,"TUNIS, FAUTMOLO, TIMOR TENGAH SELATAN, NUSA TENGGARA TIMUR",2,197,11,208
https://kawalpemilu.org#91098,"TUNIS, FAUTMOLO, TIMOR TENGAH SELATAN, NUSA TENGGARA TIMUR",3,210,13,223
https://kawalpemilu.org#91099,"BILEON, FAUTMOLO, TIMOR TENGAH SELATAN, NUSA TENGGARA TIMUR",1,143,13,156
https://kawalpemilu.org#91099,"BILEON, FAUTMOLO, TIMOR TENGAH SELATAN, NUSA TENGGARA TIMUR",2,169,10,179
https://kawalpemilu.org#91099,"BILEON, FAUTMOLO, TIMOR TENGAH SELATAN, NUSA TENGGARA TIMUR",3,124,33,157
https://kawalpemilu.org#91100,"BESLE'U, FAUTMOLO, TIMOR TENGAH SELATAN, NUSA TENGGARA TIMUR",1,154,8,162
https://kawalpemilu.org#91100,"BESLE'U, FAUTMOLO, TIMOR TENGAH SELATAN, NUSA TENGGARA TIMUR",2,131,62,193
https://kawalpemilu.org#55599,"FATUKOPA, FATUKOPA, TIMOR TENGAH SELATAN, NUSA TENGGARA TIMUR",1,138,5,143
https://kawalpemilu.org#55599,"FATUKOPA, FATUKOPA, TIMOR TENGAH SELATAN, NUSA TENGGARA TIMUR",2,186,5,191
https://kawalpemilu.org#55599,"FATUKOPA, FATUKOPA, TIMOR TENGAH SELATAN, NUSA TENGGARA TIMUR",3,138,3,141
https://kawalpemilu.org#55599,"FATUKOPA, FATUKOPA, TIMOR TENGAH SELATAN, NUSA TENGGARA TIMUR",4,163,7,170
https://kawalpemilu.org#55599,"FATUKOPA, FATUKOPA, TIMOR TENGAH SELATAN, NUSA TENGGARA TIMUR",5,132,8,140
https://kawalpemilu.org#55599,"FATUKOPA, FATUKOPA, TIMOR TENGAH SELATAN, NUSA TENGGARA TIMUR",6,114,7,121
https://kawalpemilu.org#55599,"FATUKOPA, FATUKOPA, TIMOR TENGAH SELATAN, NUSA TENGGARA TIMUR",7,119,11,130
https://kawalpemilu.org#55600,"BESNAM, FATUKOPA, TIMOR TENGAH SELATAN, NUSA TENGGARA TIMUR",1,173,7,180
https://kawalpemilu.org#55601,"TAEBONE, FATUKOPA, TIMOR TENGAH SELATAN, NUSA TENGGARA TIMUR",1,162,19,181
https://kawalpemilu.org#55601,"TAEBONE, FATUKOPA, TIMOR TENGAH SELATAN, NUSA TENGGARA TIMUR",2,155,6,161
https://kawalpemilu.org#55601,"TAEBONE, FATUKOPA, TIMOR TENGAH SELATAN, NUSA TENGGARA TIMUR",3,137,5,142
https://kawalpemilu.org#55602,"NUNFUTU, FATUKOPA, TIMOR TENGAH SELATAN, NUSA TENGGARA TIMUR",1,196,10,206
https://kawalpemilu.org#55602,"NUNFUTU, FATUKOPA, TIMOR TENGAH SELATAN, NUSA TENGGARA TIMUR",2,116,4,120
https://kawalpemilu.org#91095,"KIKI, FATUKOPA, TIMOR TENGAH SELATAN, NUSA TENGGARA TIMUR",1,219,17,236
https://kawalpemilu.org#91095,"KIKI, FATUKOPA, TIMOR TENGAH SELATAN, NUSA TENGGARA TIMUR",2,118,6,124
https://kawalpemilu.org#91096,"ELLO, FATUKOPA, TIMOR TENGAH SELATAN, NUSA TENGGARA TIMUR",1,197,15,212
https://kawalpemilu.org#91097,"NIFULINAH, FATUKOPA, TIMOR TENGAH SELATAN, NUSA TENGGARA TIMUR",1,201,12,213
https://kawalpemilu.org#55604,"OELBUBUK, MOLLO TENGAH, TIMOR TENGAH SELATAN, NUSA TENGGARA TIMUR",1,132,8,140
https://kawalpemilu.org#55604,"OELBUBUK, MOLLO TENGAH, TIMOR TENGAH SELATAN, NUSA TENGGARA TIMUR",2,164,8,172
https://kawalpemilu.org#55604,"OELBUBUK, MOLLO TENGAH, TIMOR TENGAH SELATAN, NUSA TENGGARA TIMUR",3,206,9,215
https://kawalpemilu.org#55604,"OELBUBUK, MOLLO TENGAH, TIMOR TENGAH SELATAN, NUSA TENGGARA TIMUR",4,229,12,241
https://kawalpemilu.org#55604,"OELBUBUK, MOLLO TENGAH, TIMOR TENGAH SELATAN, NUSA TENGGARA TIMUR",5,229,4,233
https://kawalpemilu.org#55605,"NEKEMUNIFETO, MOLLO TENGAH, TIMOR TENGAH SELATAN, NUSA TENGGARA TIMUR",1,169,3,172
https://kawalpemilu.org#55605,"NEKEMUNIFETO, MOLLO TENGAH, TIMOR TENGAH SELATAN, NUSA TENGGARA TIMUR",2,166,15,181
https://kawalpemilu.org#55606,"BINAUS, MOLLO TENGAH, TIMOR TENGAH SELATAN, NUSA TENGGARA TIMUR",1,207,31,238
https://kawalpemilu.org#55606,"BINAUS, MOLLO TENGAH, TIMOR TENGAH SELATAN, NUSA TENGGARA TIMUR",2,181,9,190
https://kawalpemilu.org#55606,"BINAUS, MOLLO TENGAH, TIMOR TENGAH SELATAN, NUSA TENGGARA TIMUR",3,165,8,173
https://kawalpemilu.org#55607,"OEL'EKAM, MOLLO TENGAH, TIMOR TENGAH SELATAN, NUSA TENGGARA TIMUR",1,152,5,157
https://kawalpemilu.org#55607,"OEL'EKAM, MOLLO TENGAH, TIMOR TENGAH SELATAN, NUSA TENGGARA TIMUR",2,203,8,211
https://kawalpemilu.org#55607,"OEL'EKAM, MOLLO TENGAH, TIMOR TENGAH SELATAN, NUSA TENGGARA TIMUR",3,257,6,263
https://kawalpemilu.org#55608,"KUALEU, MOLLO TENGAH, TIMOR TENGAH SELATAN, NUSA TENGGARA TIMUR",1,185,11,196
https://kawalpemilu.org#55608,"KUALEU, MOLLO TENGAH, TIMOR TENGAH SELATAN, NUSA TENGGARA TIMUR",2,202,4,206
https://kawalpemilu.org#55608,"KUALEU, MOLLO TENGAH, TIMOR TENGAH SELATAN, NUSA TENGGARA TIMUR",3,180,2,182
https://kawalpemilu.org#55608,"KUALEU, MOLLO TENGAH, TIMOR TENGAH SELATAN, NUSA TENGGARA TIMUR",4,170,6,176
https://kawalpemilu.org#55609,"PIKA, MOLLO TENGAH, TIMOR TENGAH SELATAN, NUSA TENGGARA TIMUR",1,173,13,186
https://kawalpemilu.org#55609,"PIKA, MOLLO TENGAH, TIMOR TENGAH SELATAN, NUSA TENGGARA TIMUR",2,185,20,205
https://kawalpemilu.org#55609,"PIKA, MOLLO TENGAH, TIMOR TENGAH SELATAN, NUSA TENGGARA TIMUR",3,134,12,146
https://kawalpemilu.org#55609,"PIKA, MOLLO TENGAH, TIMOR TENGAH SELATAN, NUSA TENGGARA TIMUR",4,135,10,145
https://kawalpemilu.org#55611,"TOBU, TOBU, TIMOR TENGAH SELATAN, NUSA TENGGARA TIMUR",1,226,3,229
https://kawalpemilu.org#55611,"TOBU, TOBU, TIMOR TENGAH SELATAN, NUSA TENGGARA TIMUR",2,215,1,216
https://kawalpemilu.org#55611,"TOBU, TOBU, TIMOR TENGAH SELATAN, NUSA TENGGARA TIMUR",3,219,5,224
https://kawalpemilu.org#55611,"TOBU, TOBU, TIMOR TENGAH SELATAN, NUSA TENGGARA TIMUR",4,160,0,160
https://kawalpemilu.org#55611,"TOBU, TOBU, TIMOR TENGAH SELATAN, NUSA TENGGARA TIMUR",5,256,8,264
https://kawalpemilu.org#55612,"TUTEM, TOBU, TIMOR TENGAH SELATAN, NUSA TENGGARA TIMUR",1,242,4,246
https://kawalpemilu.org#55612,"TUTEM, TOBU, TIMOR TENGAH SELATAN, NUSA TENGGARA TIMUR",2,162,2,164
https://kawalpemilu.org#55612,"TUTEM, TOBU, TIMOR TENGAH SELATAN, NUSA TENGGARA TIMUR",3,152,0,152
https://kawalpemilu.org#55612,"TUTEM, TOBU, TIMOR TENGAH SELATAN, NUSA TENGGARA TIMUR",4,163,9,172
https://kawalpemilu.org#55613,"TUNE, TOBU, TIMOR TENGAH SELATAN, NUSA TENGGARA TIMUR",1,188,2,190
https://kawalpemilu.org#55613,"TUNE, TOBU, TIMOR TENGAH SELATAN, NUSA TENGGARA TIMUR",2,181,4,185
https://kawalpemilu.org#55613,"TUNE, TOBU, TIMOR TENGAH SELATAN, NUSA TENGGARA TIMUR",3,206,5,211
https://kawalpemilu.org#55614,"BONLEU, TOBU, TIMOR TENGAH SELATAN, NUSA TENGGARA TIMUR",1,186,15,201
https://kawalpemilu.org#55614,"BONLEU, TOBU, TIMOR TENGAH SELATAN, NUSA TENGGARA TIMUR",2,240,4,244
https://kawalpemilu.org#55614,"BONLEU, TOBU, TIMOR TENGAH SELATAN, NUSA TENGGARA TIMUR",3,220,4,224
https://kawalpemilu.org#55614,"BONLEU, TOBU, TIMOR TENGAH SELATAN, NUSA TENGGARA TIMUR",4,167,11,178
https://kawalpemilu.org#55614,"BONLEU, TOBU, TIMOR TENGAH SELATAN, NUSA TENGGARA TIMUR",5,191,13,204
https://kawalpemilu.org#91091,"PUBASU, TOBU, TIMOR TENGAH SELATAN, NUSA TENGGARA TIMUR",1,214,4,218
https://kawalpemilu.org#91091,"PUBASU, TOBU, TIMOR TENGAH SELATAN, NUSA TENGGARA TIMUR",2,160,6,166
https://kawalpemilu.org#91092,"HUETALAN, TOBU, TIMOR TENGAH SELATAN, NUSA TENGGARA TIMUR",1,152,4,156
https://kawalpemilu.org#91092,"HUETALAN, TOBU, TIMOR TENGAH SELATAN, NUSA TENGGARA TIMUR",2,142,4,146
https://kawalpemilu.org#91093,"SAUBALAN, TOBU, TIMOR TENGAH SELATAN, NUSA TENGGARA TIMUR",1,100,1,101
https://kawalpemilu.org#91093,"SAUBALAN, TOBU, TIMOR TENGAH SELATAN, NUSA TENGGARA TIMUR",2,113,6,119
https://kawalpemilu.org#91094,"BESTOBE, TOBU, TIMOR TENGAH SELATAN, NUSA TENGGARA TIMUR",1,235,2,237
https://kawalpemilu.org#91094,"BESTOBE, TOBU, TIMOR TENGAH SELATAN, NUSA TENGGARA TIMUR",2,185,6,191
https://kawalpemilu.org#55616,"LILL ANA, NUNBENA, TIMOR TENGAH SELATAN, NUSA TENGGARA TIMUR",1,141,4,145
https://kawalpemilu.org#55616,"LILL ANA, NUNBENA, TIMOR TENGAH SELATAN, NUSA TENGGARA TIMUR",2,134,8,142
https://kawalpemilu.org#55617,"NUNBENA, NUNBENA, TIMOR TENGAH SELATAN, NUSA TENGGARA TIMUR",1,151,2,153
https://kawalpemilu.org#55617,"NUNBENA, NUNBENA, TIMOR TENGAH SELATAN, NUSA TENGGARA TIMUR",2,182,6,188
https://kawalpemilu.org#55617,"NUNBENA, NUNBENA, TIMOR TENGAH SELATAN, NUSA TENGGARA TIMUR",3,200,4,204
https://kawalpemilu.org#55618,"NOEBESI, NUNBENA, TIMOR TENGAH SELATAN, NUSA TENGGARA TIMUR",1,224,10,234
https://kawalpemilu.org#55618,"NOEBESI, NUNBENA, TIMOR TENGAH SELATAN, NUSA TENGGARA TIMUR",2,100,5,105
https://kawalpemilu.org#55618,"NOEBESI, NUNBENA, TIMOR TENGAH SELATAN, NUSA TENGGARA TIMUR",3,97,0,97
https://kawalpemilu.org#55618,"NOEBESI, NUNBENA, TIMOR TENGAH SELATAN, NUSA TENGGARA TIMUR",4,176,9,185
https://kawalpemilu.org#55619,"TANEOTOB, NUNBENA, TIMOR TENGAH SELATAN, NUSA TENGGARA TIMUR",1,109,4,113
https://kawalpemilu.org#55619,"TANEOTOB, NUNBENA, TIMOR TENGAH SELATAN, NUSA TENGGARA TIMUR",2,128,1,129
https://kawalpemilu.org#55619,"TANEOTOB, NUNBENA, TIMOR TENGAH SELATAN, NUSA TENGGARA TIMUR",3,190,6,196
https://kawalpemilu.org#55619,"TANEOTOB, NUNBENA, TIMOR TENGAH SELATAN, NUSA TENGGARA TIMUR",4,110,0,110
https://kawalpemilu.org#91089,"FETO MONE, NUNBENA, TIMOR TENGAH SELATAN, NUSA TENGGARA TIMUR",1,147,3,150
https://kawalpemilu.org#91089,"FETO MONE, NUNBENA, TIMOR TENGAH SELATAN, NUSA TENGGARA TIMUR",2,183,4,187
https://kawalpemilu.org#91090,"TUNBES, NUNBENA, TIMOR TENGAH SELATAN, NUSA TENGGARA TIMUR",1,218,8,226
https://kawalpemilu.org#91090,"TUNBES, NUNBENA, TIMOR TENGAH SELATAN, NUSA TENGGARA TIMUR",2,207,10,217
https://kawalpemilu.org#55622,"BITEFA, MIOMAFO TIMUR, TIMOR TENGAH UTARA, NUSA TENGGARA TIMUR",1,209,23,232
https://kawalpemilu.org#55622,"BITEFA, MIOMAFO TIMUR, TIMOR TENGAH UTARA, NUSA TENGGARA TIMUR",2,170,9,179
https://kawalpemilu.org#55622,"BITEFA, MIOMAFO TIMUR, TIMOR TENGAH UTARA, NUSA TENGGARA TIMUR",3,196,13,209
https://kawalpemilu.org#55622,"BITEFA, MIOMAFO TIMUR, TIMOR TENGAH UTARA, NUSA TENGGARA TIMUR",4,174,8,182
https://kawalpemilu.org#55623,"OESENA, MIOMAFO TIMUR, TIMOR TENGAH UTARA, NUSA TENGGARA TIMUR",1,212,4,216
https://kawalpemilu.org#55623,"OESENA, MIOMAFO TIMUR, TIMOR TENGAH UTARA, NUSA TENGGARA TIMUR",2,202,17,219
https://kawalpemilu.org#55623,"OESENA, MIOMAFO TIMUR, TIMOR TENGAH UTARA, NUSA TENGGARA TIMUR",3,215,17,232
https://kawalpemilu.org#55623,"OESENA, MIOMAFO TIMUR, TIMOR TENGAH UTARA, NUSA TENGGARA TIMUR",4,189,18,207
https://kawalpemilu.org#55623,"OESENA, MIOMAFO TIMUR, TIMOR TENGAH UTARA, NUSA TENGGARA TIMUR",5,172,31,203
https://kawalpemilu.org#55623,"OESENA, MIOMAFO TIMUR, TIMOR TENGAH UTARA, NUSA TENGGARA TIMUR",6,224,24,248
https://kawalpemilu.org#55623,"OESENA, MIOMAFO TIMUR, TIMOR TENGAH UTARA, NUSA TENGGARA TIMUR",7,190,34,224
https://kawalpemilu.org#55623,"OESENA, MIOMAFO TIMUR, TIMOR TENGAH UTARA, NUSA TENGGARA TIMUR",8,205,17,222
https://kawalpemilu.org#55624,"BOKON, MIOMAFO TIMUR, TIMOR TENGAH UTARA, NUSA TENGGARA TIMUR",1,125,7,132
https://kawalpemilu.org#55624,"BOKON, MIOMAFO TIMUR, TIMOR TENGAH UTARA, NUSA TENGGARA TIMUR",2,117,9,126
https://kawalpemilu.org#55625,"KAENBAUN, MIOMAFO TIMUR, TIMOR TENGAH UTARA, NUSA TENGGARA TIMUR",1,163,11,174
https://kawalpemilu.org#55625,"KAENBAUN, MIOMAFO TIMUR, TIMOR TENGAH UTARA, NUSA TENGGARA TIMUR",2,142,10,152
https://kawalpemilu.org#55626,"AMOL, MIOMAFO TIMUR, TIMOR TENGAH UTARA, NUSA TENGGARA TIMUR",1,170,13,183
https://kawalpemilu.org#55626,"AMOL, MIOMAFO TIMUR, TIMOR TENGAH UTARA, NUSA TENGGARA TIMUR",2,200,11,211
https://kawalpemilu.org#55626,"AMOL, MIOMAFO TIMUR, TIMOR TENGAH UTARA, NUSA TENGGARA TIMUR",3,103,4,107
https://kawalpemilu.org#55626,"AMOL, MIOMAFO TIMUR, TIMOR TENGAH UTARA, NUSA TENGGARA TIMUR",4,118,11,129
https://kawalpemilu.org#55627,"FATUSENE, MIOMAFO TIMUR, TIMOR TENGAH UTARA, NUSA TENGGARA TIMUR",1,142,13,155
https://kawalpemilu.org#55627,"FATUSENE, MIOMAFO TIMUR, TIMOR TENGAH UTARA, NUSA TENGGARA TIMUR",2,129,12,141
https://kawalpemilu.org#55628,"JAK, MIOMAFO TIMUR, TIMOR TENGAH UTARA, NUSA TENGGARA TIMUR",1,184,6,190
https://kawalpemilu.org#55628,"JAK, MIOMAFO TIMUR, TIMOR TENGAH UTARA, NUSA TENGGARA TIMUR",2,179,4,183
https://kawalpemilu.org#55629,"TUNTUN, MIOMAFO TIMUR, TIMOR TENGAH UTARA, NUSA TENGGARA TIMUR",1,193,12,205
https://kawalpemilu.org#55629,"TUNTUN, MIOMAFO TIMUR, TIMOR TENGAH UTARA, NUSA TENGGARA TIMUR",2,207,4,211
https://kawalpemilu.org#55630,"TUNOE, MIOMAFO TIMUR, TIMOR TENGAH UTARA, NUSA TENGGARA TIMUR",1,172,3,175
https://kawalpemilu.org#55630,"TUNOE, MIOMAFO TIMUR, TIMOR TENGAH UTARA, NUSA TENGGARA TIMUR",2,142,14,156
https://kawalpemilu.org#55630,"TUNOE, MIOMAFO TIMUR, TIMOR TENGAH UTARA, NUSA TENGGARA TIMUR",3,148,10,158
https://kawalpemilu.org#55631,"FEMNASI, MIOMAFO TIMUR, TIMOR TENGAH UTARA, NUSA TENGGARA TIMUR",1,233,15,248
https://kawalpemilu.org#55631,"FEMNASI, MIOMAFO TIMUR, TIMOR TENGAH UTARA, NUSA TENGGARA TIMUR",2,229,11,240
https://kawalpemilu.org#55632,"TAEKAS, MIOMAFO TIMUR, TIMOR TENGAH UTARA, NUSA TENGGARA TIMUR",1,165,33,198
https://kawalpemilu.org#55632,"TAEKAS, MIOMAFO TIMUR, TIMOR TENGAH UTARA, NUSA TENGGARA TIMUR",2,203,22,225
https://kawalpemilu.org#55632,"TAEKAS, MIOMAFO TIMUR, TIMOR TENGAH UTARA, NUSA TENGGARA TIMUR",3,161,26,187
https://kawalpemilu.org#55632,"TAEKAS, MIOMAFO TIMUR, TIMOR TENGAH UTARA, NUSA TENGGARA TIMUR",4,165,20,185
https://kawalpemilu.org#55632,"TAEKAS, MIOMAFO TIMUR, TIMOR TENGAH UTARA, NUSA TENGGARA TIMUR",5,142,3,145
https://kawalpemilu.org#55634,"EBAN, MIOMAFO BARAT, TIMOR TENGAH UTARA, NUSA TENGGARA TIMUR",1,208,5,213
https://kawalpemilu.org#55634,"EBAN, MIOMAFO BARAT, TIMOR TENGAH UTARA, NUSA TENGGARA TIMUR",2,198,6,204
https://kawalpemilu.org#55634,"EBAN, MIOMAFO BARAT, TIMOR TENGAH UTARA, NUSA TENGGARA TIMUR",3,198,6,204
https://kawalpemilu.org#55634,"EBAN, MIOMAFO BARAT, TIMOR TENGAH UTARA, NUSA TENGGARA TIMUR",4,136,5,141
https://kawalpemilu.org#55634,"EBAN, MIOMAFO BARAT, TIMOR TENGAH UTARA, NUSA TENGGARA TIMUR",5,211,8,219
https://kawalpemilu.org#55634,"EBAN, MIOMAFO BARAT, TIMOR TENGAH UTARA, NUSA TENGGARA TIMUR",6,152,11,163
https://kawalpemilu.org#55634,"EBAN, MIOMAFO BARAT, TIMOR TENGAH UTARA, NUSA TENGGARA TIMUR",7,151,31,182
https://kawalpemilu.org#55635,"SALLU, MIOMAFO BARAT, TIMOR TENGAH UTARA, NUSA TENGGARA TIMUR",1,188,11,199
https://kawalpemilu.org#55635,"SALLU, MIOMAFO BARAT, TIMOR TENGAH UTARA, NUSA TENGGARA TIMUR",2,205,15,220
https://kawalpemilu.org#55635,"SALLU, MIOMAFO BARAT, TIMOR TENGAH UTARA, NUSA TENGGARA TIMUR",3,190,7,197
https://kawalpemilu.org#55635,"SALLU, MIOMAFO BARAT, TIMOR TENGAH UTARA, NUSA TENGGARA TIMUR",4,166,2,168
https://kawalpemilu.org#55635,"SALLU, MIOMAFO BARAT, TIMOR TENGAH UTARA, NUSA TENGGARA TIMUR",5,150,5,155
https://kawalpemilu.org#55635,"SALLU, MIOMAFO BARAT, TIMOR TENGAH UTARA, NUSA TENGGARA TIMUR",6,154,4,158
https://kawalpemilu.org#55636,"NOEPESU, MIOMAFO BARAT, TIMOR TENGAH UTARA, NUSA TENGGARA TIMUR",1,144,7,151
https://kawalpemilu.org#55636,"NOEPESU, MIOMAFO BARAT, TIMOR TENGAH UTARA, NUSA TENGGARA TIMUR",2,179,8,187
https://kawalpemilu.org#55636,"NOEPESU, MIOMAFO BARAT, TIMOR TENGAH UTARA, NUSA TENGGARA TIMUR",3,174,8,182
https://kawalpemilu.org#55636,"NOEPESU, MIOMAFO BARAT, TIMOR TENGAH UTARA, NUSA TENGGARA TIMUR",4,157,14,171
https://kawalpemilu.org#55636,"NOEPESU, MIOMAFO BARAT, TIMOR TENGAH UTARA, NUSA TENGGARA TIMUR",5,181,11,192
https://kawalpemilu.org#55637,"FATUNENO, MIOMAFO BARAT, TIMOR TENGAH UTARA, NUSA TENGGARA TIMUR",1,197,8,205
https://kawalpemilu.org#55637,"FATUNENO, MIOMAFO BARAT, TIMOR TENGAH UTARA, NUSA TENGGARA TIMUR",2,170,12,182
https://kawalpemilu.org#55637,"FATUNENO, MIOMAFO BARAT, TIMOR TENGAH UTARA, NUSA TENGGARA TIMUR",3,177,13,190
https://kawalpemilu.org#55637,"FATUNENO, MIOMAFO BARAT, TIMOR TENGAH UTARA, NUSA TENGGARA TIMUR",4,212,9,221
https://kawalpemilu.org#55638,"SUANAE, MIOMAFO BARAT, TIMOR TENGAH UTARA, NUSA TENGGARA TIMUR",1,177,4,181
https://kawalpemilu.org#55638,"SUANAE, MIOMAFO BARAT, TIMOR TENGAH UTARA, NUSA TENGGARA TIMUR",2,151,4,155
https://kawalpemilu.org#55638,"SUANAE, MIOMAFO BARAT, TIMOR TENGAH UTARA, NUSA TENGGARA TIMUR",3,188,5,193
https://kawalpemilu.org#55640,"FATUNISUAN, MIOMAFO BARAT, TIMOR TENGAH UTARA, NUSA TENGGARA TIMUR",1,118,12,130
https://kawalpemilu.org#55640,"FATUNISUAN, MIOMAFO BARAT, TIMOR TENGAH UTARA, NUSA TENGGARA TIMUR",2,157,16,173
https://kawalpemilu.org#55640,"FATUNISUAN, MIOMAFO BARAT, TIMOR TENGAH UTARA, NUSA TENGGARA TIMUR",3,148,15,163
https://kawalpemilu.org#55640,"FATUNISUAN, MIOMAFO BARAT, TIMOR TENGAH UTARA, NUSA TENGGARA TIMUR",4,184,5,189
https://kawalpemilu.org#55640,"FATUNISUAN, MIOMAFO BARAT, TIMOR TENGAH UTARA, NUSA TENGGARA TIMUR",5,170,1,171
https://kawalpemilu.org#55641,"HAULASI, MIOMAFO BARAT, TIMOR TENGAH UTARA, NUSA TENGGARA TIMUR",1,172,3,175
https://kawalpemilu.org#55641,"HAULASI, MIOMAFO BARAT, TIMOR TENGAH UTARA, NUSA TENGGARA TIMUR",2,175,6,181
https://kawalpemilu.org#55641,"HAULASI, MIOMAFO BARAT, TIMOR TENGAH UTARA, NUSA TENGGARA TIMUR",3,173,13,186
https://kawalpemilu.org#55642,"NEOTOKO, MIOMAFO BARAT, TIMOR TENGAH UTARA, NUSA TENGGARA TIMUR",1,172,4,176
https://kawalpemilu.org#55642,"NEOTOKO, MIOMAFO BARAT, TIMOR TENGAH UTARA, NUSA TENGGARA TIMUR",2,150,4,154
https://kawalpemilu.org#55643,"FATUTASU, MIOMAFO BARAT, TIMOR TENGAH UTARA, NUSA TENGGARA TIMUR",1,179,4,183
https://kawalpemilu.org#55643,"FATUTASU, MIOMAFO BARAT, TIMOR TENGAH UTARA, NUSA TENGGARA TIMUR",2,184,2,186
https://kawalpemilu.org#55643,"FATUTASU, MIOMAFO BARAT, TIMOR TENGAH UTARA, NUSA TENGGARA TIMUR",3,162,5,167
https://kawalpemilu.org#55644,"MANUSASI, MIOMAFO BARAT, TIMOR TENGAH UTARA, NUSA TENGGARA TIMUR",1,174,18,192
https://kawalpemilu.org#55644,"MANUSASI, MIOMAFO BARAT, TIMOR TENGAH UTARA, NUSA TENGGARA TIMUR",2,136,14,150
https://kawalpemilu.org#55644,"MANUSASI, MIOMAFO BARAT, TIMOR TENGAH UTARA, NUSA TENGGARA TIMUR",3,134,6,140
https://kawalpemilu.org#55645,"SAENAM, MIOMAFO BARAT, TIMOR TENGAH UTARA, NUSA TENGGARA TIMUR",1,190,9,199
https://kawalpemilu.org#55645,"SAENAM, MIOMAFO BARAT, TIMOR TENGAH UTARA, NUSA TENGGARA TIMUR",2,178,5,183
https://kawalpemilu.org#928455,"SA'TAB, MIOMAFO BARAT, TIMOR TENGAH UTARA, NUSA TENGGARA TIMUR",1,159,1,160
https://kawalpemilu.org#55647,"UP FAON, BIBOKI SELATAN, TIMOR TENGAH UTARA, NUSA TENGGARA TIMUR",1,164,23,187
https://kawalpemilu.org#55647,"UP FAON, BIBOKI SELATAN, TIMOR TENGAH UTARA, NUSA TENGGARA TIMUR",2,155,15,170
https://kawalpemilu.org#55647,"UP FAON, BIBOKI SELATAN, TIMOR TENGAH UTARA, NUSA TENGGARA TIMUR",3,157,12,169
https://kawalpemilu.org#55647,"UP FAON, BIBOKI SELATAN, TIMOR TENGAH UTARA, NUSA TENGGARA TIMUR",4,131,20,151
https://kawalpemilu.org#55647,"UP FAON, BIBOKI SELATAN, TIMOR TENGAH UTARA, NUSA TENGGARA TIMUR",5,141,22,163
https://kawalpemilu.org#55647,"UP FAON, BIBOKI SELATAN, TIMOR TENGAH UTARA, NUSA TENGGARA TIMUR",6,175,8,183
https://kawalpemilu.org#55648,"SUPUN, BIBOKI SELATAN, TIMOR TENGAH UTARA, NUSA TENGGARA TIMUR",1,144,16,160
https://kawalpemilu.org#55648,"SUPUN, BIBOKI SELATAN, TIMOR TENGAH UTARA, NUSA TENGGARA TIMUR",2,160,7,167
https://kawalpemilu.org#55648,"SUPUN, BIBOKI SELATAN, TIMOR TENGAH UTARA, NUSA TENGGARA TIMUR",3,165,11,176
https://kawalpemilu.org#55648,"SUPUN, BIBOKI SELATAN, TIMOR TENGAH UTARA, NUSA TENGGARA TIMUR",4,179,2,181
https://kawalpemilu.org#55649,"PANTAE, BIBOKI SELATAN, TIMOR TENGAH UTARA, NUSA TENGGARA TIMUR",1,177,8,185
https://kawalpemilu.org#55649,"PANTAE, BIBOKI SELATAN, TIMOR TENGAH UTARA, NUSA TENGGARA TIMUR",2,224,3,227
https://kawalpemilu.org#55649,"PANTAE, BIBOKI SELATAN, TIMOR TENGAH UTARA, NUSA TENGGARA TIMUR",3,94,16,110
https://kawalpemilu.org#55650,"OENAEM, BIBOKI SELATAN, TIMOR TENGAH UTARA, NUSA TENGGARA TIMUR",1,94,8,102
https://kawalpemilu.org#55650,"OENAEM, BIBOKI SELATAN, TIMOR TENGAH UTARA, NUSA TENGGARA TIMUR",2,179,27,206
https://kawalpemilu.org#55651,"TAUTPAH, BIBOKI SELATAN, TIMOR TENGAH UTARA, NUSA TENGGARA TIMUR",1,131,13,144
https://kawalpemilu.org#55651,"TAUTPAH, BIBOKI SELATAN, TIMOR TENGAH UTARA, NUSA TENGGARA TIMUR",2,149,10,159
https://kawalpemilu.org#55651,"TAUTPAH, BIBOKI SELATAN, TIMOR TENGAH UTARA, NUSA TENGGARA TIMUR",3,134,8,142
https://kawalpemilu.org#55651,"TAUTPAH, BIBOKI SELATAN, TIMOR TENGAH UTARA, NUSA TENGGARA TIMUR",4,116,8,124
https://kawalpemilu.org#55652,"TOKBESI, BIBOKI SELATAN, TIMOR TENGAH UTARA, NUSA TENGGARA TIMUR",1,132,6,138
https://kawalpemilu.org#55652,"TOKBESI, BIBOKI SELATAN, TIMOR TENGAH UTARA, NUSA TENGGARA TIMUR",2,138,9,147
https://kawalpemilu.org#55652,"TOKBESI, BIBOKI SELATAN, TIMOR TENGAH UTARA, NUSA TENGGARA TIMUR",3,143,10,153
https://kawalpemilu.org#55653,"SAINIUP, BIBOKI SELATAN, TIMOR TENGAH UTARA, NUSA TENGGARA TIMUR",1,166,18,184
https://kawalpemilu.org#55653,"SAINIUP, BIBOKI SELATAN, TIMOR TENGAH UTARA, NUSA TENGGARA TIMUR",2,153,5,158
https://kawalpemilu.org#55653,"SAINIUP, BIBOKI SELATAN, TIMOR TENGAH UTARA, NUSA TENGGARA TIMUR",3,162,10,172
https://kawalpemilu.org#55654,"TUNBAEN, BIBOKI SELATAN, TIMOR TENGAH UTARA, NUSA TENGGARA TIMUR",1,166,6,172
https://kawalpemilu.org#55654,"TUNBAEN, BIBOKI SELATAN, TIMOR TENGAH UTARA, NUSA TENGGARA TIMUR",2,173,8,181
https://kawalpemilu.org#55654,"TUNBAEN, BIBOKI SELATAN, TIMOR TENGAH UTARA, NUSA TENGGARA TIMUR",3,166,11,177
https://kawalpemilu.org#55656,"OENAK, NOEMUTI, TIMOR TENGAH UTARA, NUSA TENGGARA TIMUR",1,148,15,163
https://kawalpemilu.org#55656,"OENAK, NOEMUTI, TIMOR TENGAH UTARA, NUSA TENGGARA TIMUR",2,149,9,158
https://kawalpemilu.org#55656,"OENAK, NOEMUTI, TIMOR TENGAH UTARA, NUSA TENGGARA TIMUR",3,157,7,164
https://kawalpemilu.org#55656,"OENAK, NOEMUTI, TIMOR TENGAH UTARA, NUSA TENGGARA TIMUR",4,93,2,95
https://kawalpemilu.org#55657,"NIFUBOKE, NOEMUTI, TIMOR TENGAH UTARA, NUSA TENGGARA TIMUR",1,111,8,119
https://kawalpemilu.org#55657,"NIFUBOKE, NOEMUTI, TIMOR TENGAH UTARA, NUSA TENGGARA TIMUR",2,161,8,169
https://kawalpemilu.org#55657,"NIFUBOKE, NOEMUTI, TIMOR TENGAH UTARA, NUSA TENGGARA TIMUR",3,161,3,164
https://kawalpemilu.org#55657,"NIFUBOKE, NOEMUTI, TIMOR TENGAH UTARA, NUSA TENGGARA TIMUR",4,129,6,135
https://kawalpemilu.org#55657,"NIFUBOKE, NOEMUTI, TIMOR TENGAH UTARA, NUSA TENGGARA TIMUR",5,133,5,138
https://kawalpemilu.org#55658,"NOEMUTI, NOEMUTI, TIMOR TENGAH UTARA, NUSA TENGGARA TIMUR",1,149,17,166
https://kawalpemilu.org#55658,"NOEMUTI, NOEMUTI, TIMOR TENGAH UTARA, NUSA TENGGARA TIMUR",2,161,23,184
https://kawalpemilu.org#55659,"FATUMUTI, NOEMUTI, TIMOR TENGAH UTARA, NUSA TENGGARA TIMUR",1,112,12,124
https://kawalpemilu.org#55659,"FATUMUTI, NOEMUTI, TIMOR TENGAH UTARA, NUSA TENGGARA TIMUR",2,90,11,101
https://kawalpemilu.org#55659,"FATUMUTI, NOEMUTI, TIMOR TENGAH UTARA, NUSA TENGGARA TIMUR",3,97,29,126
https://kawalpemilu.org#55659,"FATUMUTI, NOEMUTI, TIMOR TENGAH UTARA, NUSA TENGGARA TIMUR",4,79,27,106
https://kawalpemilu.org#55659,"FATUMUTI, NOEMUTI, TIMOR TENGAH UTARA, NUSA TENGGARA TIMUR",5,187,23,210
https://kawalpemilu.org#55660,"KIUOLA, NOEMUTI, TIMOR TENGAH UTARA, NUSA TENGGARA TIMUR",1,106,12,118
https://kawalpemilu.org#55660,"KIUOLA, NOEMUTI, TIMOR TENGAH UTARA, NUSA TENGGARA TIMUR",2,90,9,99
https://kawalpemilu.org#55660,"KIUOLA, NOEMUTI, TIMOR TENGAH UTARA, NUSA TENGGARA TIMUR",3,140,38,178
https://kawalpemilu.org#55660,"KIUOLA, NOEMUTI, TIMOR TENGAH UTARA, NUSA TENGGARA TIMUR",4,138,15,153
https://kawalpemilu.org#55661,"BIJELI, NOEMUTI, TIMOR TENGAH UTARA, NUSA TENGGARA TIMUR",1,159,25,184
https://kawalpemilu.org#55661,"BIJELI, NOEMUTI, TIMOR TENGAH UTARA, NUSA TENGGARA TIMUR",2,216,16,232
https://kawalpemilu.org#55662,"NOEBAUN, NOEMUTI, TIMOR TENGAH UTARA, NUSA TENGGARA TIMUR",1,139,22,161
https://kawalpemilu.org#55662,"NOEBAUN, NOEMUTI, TIMOR TENGAH UTARA, NUSA TENGGARA TIMUR",2,128,16,144
https://kawalpemilu.org#55662,"NOEBAUN, NOEMUTI, TIMOR TENGAH UTARA, NUSA TENGGARA TIMUR",3,119,9,128
https://kawalpemilu.org#55662,"NOEBAUN, NOEMUTI, TIMOR TENGAH UTARA, NUSA TENGGARA TIMUR",4,114,29,143
https://kawalpemilu.org#55662,"NOEBAUN, NOEMUTI, TIMOR TENGAH UTARA, NUSA TENGGARA TIMUR",5,82,4,86
https://kawalpemilu.org#55662,"NOEBAUN, NOEMUTI, TIMOR TENGAH UTARA, NUSA TENGGARA TIMUR",6,102,6,108
https://kawalpemilu.org#55663,"SEO, NOEMUTI, TIMOR TENGAH UTARA, NUSA TENGGARA TIMUR",1,138,22,160
https://kawalpemilu.org#55663,"SEO, NOEMUTI, TIMOR TENGAH UTARA, NUSA TENGGARA TIMUR",2,152,9,161
https://kawalpemilu.org#55664,"POPNAM, NOEMUTI, TIMOR TENGAH UTARA, NUSA TENGGARA TIMUR",1,158,6,164
https://kawalpemilu.org#55664,"POPNAM, NOEMUTI, TIMOR TENGAH UTARA, NUSA TENGGARA TIMUR",2,153,12,165
https://kawalpemilu.org#55664,"POPNAM, NOEMUTI, TIMOR TENGAH UTARA, NUSA TENGGARA TIMUR",3,157,21,178
https://kawalpemilu.org#55664,"POPNAM, NOEMUTI, TIMOR TENGAH UTARA, NUSA TENGGARA TIMUR",4,180,30,210
https://kawalpemilu.org#55664,"POPNAM, NOEMUTI, TIMOR TENGAH UTARA, NUSA TENGGARA TIMUR",5,101,8,109
https://kawalpemilu.org#55665,"NIBAAF, NOEMUTI, TIMOR TENGAH UTARA, NUSA TENGGARA TIMUR",1,112,10,122
https://kawalpemilu.org#55665,"NIBAAF, NOEMUTI, TIMOR TENGAH UTARA, NUSA TENGGARA TIMUR",2,129,4,133
https://kawalpemilu.org#55665,"NIBAAF, NOEMUTI, TIMOR TENGAH UTARA, NUSA TENGGARA TIMUR",3,141,6,147
https://kawalpemilu.org#55665,"NIBAAF, NOEMUTI, TIMOR TENGAH UTARA, NUSA TENGGARA TIMUR",4,100,3,103
https://kawalpemilu.org#55666,"BANFANU, NOEMUTI, TIMOR TENGAH UTARA, NUSA TENGGARA TIMUR",1,194,11,205
https://kawalpemilu.org#55666,"BANFANU, NOEMUTI, TIMOR TENGAH UTARA, NUSA TENGGARA TIMUR",2,166,8,174
https://kawalpemilu.org#55666,"BANFANU, NOEMUTI, TIMOR TENGAH UTARA, NUSA TENGGARA TIMUR",3,213,6,219
https://kawalpemilu.org#55666,"BANFANU, NOEMUTI, TIMOR TENGAH UTARA, NUSA TENGGARA TIMUR",4,79,27,106
https://kawalpemilu.org#55667,"OEPERIGI, NOEMUTI, TIMOR TENGAH UTARA, NUSA TENGGARA TIMUR",1,176,18,194
https://kawalpemilu.org#55669,"KEFAMENANU UTARA, KOTA KEFAMENANU, TIMOR TENGAH UTARA, NUSA TENGGARA TIMUR",1,210,21,231
https://kawalpemilu.org#55669,"KEFAMENANU UTARA, KOTA KEFAMENANU, TIMOR TENGAH UTARA, NUSA TENGGARA TIMUR",2,242,18,260
https://kawalpemilu.org#55669,"KEFAMENANU UTARA, KOTA KEFAMENANU, TIMOR TENGAH UTARA, NUSA TENGGARA TIMUR",3,209,10,219
https://kawalpemilu.org#55669,"KEFAMENANU UTARA, KOTA KEFAMENANU, TIMOR TENGAH UTARA, NUSA TENGGARA TIMUR",4,204,11,215
https://kawalpemilu.org#55669,"KEFAMENANU UTARA, KOTA KEFAMENANU, TIMOR TENGAH UTARA, NUSA TENGGARA TIMUR",5,176,4,180
https://kawalpemilu.org#55669,"KEFAMENANU UTARA, KOTA KEFAMENANU, TIMOR TENGAH UTARA, NUSA TENGGARA TIMUR",6,178,12,190
https://kawalpemilu.org#55669,"KEFAMENANU UTARA, KOTA KEFAMENANU, TIMOR TENGAH UTARA, NUSA TENGGARA TIMUR",7,159,8,167
https://kawalpemilu.org#55670,"APLASI, KOTA KEFAMENANU, TIMOR TENGAH UTARA, NUSA TENGGARA TIMUR",1,216,8,224
https://kawalpemilu.org#55670,"APLASI, KOTA KEFAMENANU, TIMOR TENGAH UTARA, NUSA TENGGARA TIMUR",2,142,23,165
https://kawalpemilu.org#55670,"APLASI, KOTA KEFAMENANU, TIMOR TENGAH UTARA, NUSA TENGGARA TIMUR",3,175,24,199
https://kawalpemilu.org#55670,"APLASI, KOTA KEFAMENANU, TIMOR TENGAH UTARA, NUSA TENGGARA TIMUR",4,187,15,202
https://kawalpemilu.org#55670,"APLASI, KOTA KEFAMENANU, TIMOR TENGAH UTARA, NUSA TENGGARA TIMUR",5,198,21,219
https://kawalpemilu.org#55670,"APLASI, KOTA KEFAMENANU, TIMOR TENGAH UTARA, NUSA TENGGARA TIMUR",6,192,27,219
https://kawalpemilu.org#55670,"APLASI, KOTA KEFAMENANU, TIMOR TENGAH UTARA, NUSA TENGGARA TIMUR",7,180,17,197
https://kawalpemilu.org#55671,"KEFAMENANU TENGAH, KOTA KEFAMENANU, TIMOR TENGAH UTARA, NUSA TENGGARA TIMUR",1,180,40,220
https://kawalpemilu.org#55671,"KEFAMENANU TENGAH, KOTA KEFAMENANU, TIMOR TENGAH UTARA, NUSA TENGGARA TIMUR",2,162,23,185
https://kawalpemilu.org#55671,"KEFAMENANU TENGAH, KOTA KEFAMENANU, TIMOR TENGAH UTARA, NUSA TENGGARA TIMUR",3,187,21,208
https://kawalpemilu.org#55671,"KEFAMENANU TENGAH, KOTA KEFAMENANU, TIMOR TENGAH UTARA, NUSA TENGGARA TIMUR",4,122,11,133
https://kawalpemilu.org#55671,"KEFAMENANU TENGAH, KOTA KEFAMENANU, TIMOR TENGAH UTARA, NUSA TENGGARA TIMUR",5,223,17,240
https://kawalpemilu.org#55671,"KEFAMENANU TENGAH, KOTA KEFAMENANU, TIMOR TENGAH UTARA, NUSA TENGGARA TIMUR",6,132,26,158
https://kawalpemilu.org#55671,"KEFAMENANU TENGAH, KOTA KEFAMENANU, TIMOR TENGAH UTARA, NUSA TENGGARA TIMUR",7,118,15,133
https://kawalpemilu.org#55671,"KEFAMENANU TENGAH, KOTA KEFAMENANU, TIMOR TENGAH UTARA, NUSA TENGGARA TIMUR",8,141,47,188
https://kawalpemilu.org#55671,"KEFAMENANU TENGAH, KOTA KEFAMENANU, TIMOR TENGAH UTARA, NUSA TENGGARA TIMUR",9,132,43,175
https://kawalpemilu.org#55671,"KEFAMENANU TENGAH, KOTA KEFAMENANU, TIMOR TENGAH UTARA, NUSA TENGGARA TIMUR",10,144,25,169
https://kawalpemilu.org#55671,"KEFAMENANU TENGAH, KOTA KEFAMENANU, TIMOR TENGAH UTARA, NUSA TENGGARA TIMUR",11,142,15,157
https://kawalpemilu.org#55671,"KEFAMENANU TENGAH, KOTA KEFAMENANU, TIMOR TENGAH UTARA, NUSA TENGGARA TIMUR",12,174,9,183
https://kawalpemilu.org#55671,"KEFAMENANU TENGAH, KOTA KEFAMENANU, TIMOR TENGAH UTARA, NUSA TENGGARA TIMUR",13,172,15,187
https://kawalpemilu.org#55671,"KEFAMENANU TENGAH, KOTA KEFAMENANU, TIMOR TENGAH UTARA, NUSA TENGGARA TIMUR",14,155,25,180
https://kawalpemilu.org#55671,"KEFAMENANU TENGAH, KOTA KEFAMENANU, TIMOR TENGAH UTARA, NUSA TENGGARA TIMUR",15,204,17,221
https://kawalpemilu.org#55671,"KEFAMENANU TENGAH, KOTA KEFAMENANU, TIMOR TENGAH UTARA, NUSA TENGGARA TIMUR",16,136,20,156
https://kawalpemilu.org#55671,"KEFAMENANU TENGAH, KOTA KEFAMENANU, TIMOR TENGAH UTARA, NUSA TENGGARA TIMUR",17,119,34,153
https://kawalpemilu.org#55671,"KEFAMENANU TENGAH, KOTA KEFAMENANU, TIMOR TENGAH UTARA, NUSA TENGGARA TIMUR",18,171,17,188
https://kawalpemilu.org#55672,"BANSONE, KOTA KEFAMENANU, TIMOR TENGAH UTARA, NUSA TENGGARA TIMUR",1,193,21,214
https://kawalpemilu.org#55672,"BANSONE, KOTA KEFAMENANU, TIMOR TENGAH UTARA, NUSA TENGGARA TIMUR",2,218,13,231
https://kawalpemilu.org#55672,"BANSONE, KOTA KEFAMENANU, TIMOR TENGAH UTARA, NUSA TENGGARA TIMUR",3,170,20,190
https://kawalpemilu.org#55672,"BANSONE, KOTA KEFAMENANU, TIMOR TENGAH UTARA, NUSA TENGGARA TIMUR",4,222,17,239
https://kawalpemilu.org#55672,"BANSONE, KOTA KEFAMENANU, TIMOR TENGAH UTARA, NUSA TENGGARA TIMUR",5,156,22,178
https://kawalpemilu.org#55672,"BANSONE, KOTA KEFAMENANU, TIMOR TENGAH UTARA, NUSA TENGGARA TIMUR",6,216,28,244
https://kawalpemilu.org#55672,"BANSONE, KOTA KEFAMENANU, TIMOR TENGAH UTARA, NUSA TENGGARA TIMUR",7,177,33,210
https://kawalpemilu.org#55672,"BANSONE, KOTA KEFAMENANU, TIMOR TENGAH UTARA, NUSA TENGGARA TIMUR",8,201,5,206
https://kawalpemilu.org#55672,"BANSONE, KOTA KEFAMENANU, TIMOR TENGAH UTARA, NUSA TENGGARA TIMUR",9,168,16,184
https://kawalpemilu.org#55673,"BENPASI, KOTA KEFAMENANU, TIMOR TENGAH UTARA, NUSA TENGGARA TIMUR",1,110,31,141
https://kawalpemilu.org#55673,"BENPASI, KOTA KEFAMENANU, TIMOR TENGAH UTARA, NUSA TENGGARA TIMUR",2,137,21,158
https://kawalpemilu.org#55673,"BENPASI, KOTA KEFAMENANU, TIMOR TENGAH UTARA, NUSA TENGGARA TIMUR",3,192,38,230
https://kawalpemilu.org#55673,"BENPASI, KOTA KEFAMENANU, TIMOR TENGAH UTARA, NUSA TENGGARA TIMUR",4,109,23,132
https://kawalpemilu.org#55673,"BENPASI, KOTA KEFAMENANU, TIMOR TENGAH UTARA, NUSA TENGGARA TIMUR",5,125,31,156
https://kawalpemilu.org#55673,"BENPASI, KOTA KEFAMENANU, TIMOR TENGAH UTARA, NUSA TENGGARA TIMUR",6,124,3,157
https://kawalpemilu.org#55673,"BENPASI, KOTA KEFAMENANU, TIMOR TENGAH UTARA, NUSA TENGGARA TIMUR",7,138,15,153
https://kawalpemilu.org#55673,"BENPASI, KOTA KEFAMENANU, TIMOR TENGAH UTARA, NUSA TENGGARA TIMUR",8,171,37,208
https://kawalpemilu.org#55673,"BENPASI, KOTA KEFAMENANU, TIMOR TENGAH UTARA, NUSA TENGGARA TIMUR",10,145,31,176
https://kawalpemilu.org#55673,"BENPASI, KOTA KEFAMENANU, TIMOR TENGAH UTARA, NUSA TENGGARA TIMUR",11,148,19,167
https://kawalpemilu.org#55673,"BENPASI, KOTA KEFAMENANU, TIMOR TENGAH UTARA, NUSA TENGGARA TIMUR",12,155,46,201
https://kawalpemilu.org#55673,"BENPASI, KOTA KEFAMENANU, TIMOR TENGAH UTARA, NUSA TENGGARA TIMUR",13,125,37,162
https://kawalpemilu.org#55673,"BENPASI, KOTA KEFAMENANU, TIMOR TENGAH UTARA, NUSA TENGGARA TIMUR",14,178,28,206
https://kawalpemilu.org#55673,"BENPASI, KOTA KEFAMENANU, TIMOR TENGAH UTARA, NUSA TENGGARA TIMUR",15,202,26,228
https://kawalpemilu.org#55673,"BENPASI, KOTA KEFAMENANU, TIMOR TENGAH UTARA, NUSA TENGGARA TIMUR",16,132,17,149
https://kawalpemilu.org#55673,"BENPASI, KOTA KEFAMENANU, TIMOR TENGAH UTARA, NUSA TENGGARA TIMUR",17,75,6,81
https://kawalpemilu.org#55674,"KEFAMENANU SELATAN, KOTA KEFAMENANU, TIMOR TENGAH UTARA, NUSA TENGGARA TIMUR",1,203,39,242
https://kawalpemilu.org#55674,"KEFAMENANU SELATAN, KOTA KEFAMENANU, TIMOR TENGAH UTARA, NUSA TENGGARA TIMUR",2,192,31,223
https://kawalpemilu.org#55674,"KEFAMENANU SELATAN, KOTA KEFAMENANU, TIMOR TENGAH UTARA, NUSA TENGGARA TIMUR",3,222,24,246
https://kawalpemilu.org#55674,"KEFAMENANU SELATAN, KOTA KEFAMENANU, TIMOR TENGAH UTARA, NUSA TENGGARA TIMUR",4,178,32,210
https://kawalpemilu.org#55674,"KEFAMENANU SELATAN, KOTA KEFAMENANU, TIMOR TENGAH UTARA, NUSA TENGGARA TIMUR",5,202,43,245
https://kawalpemilu.org#55674,"KEFAMENANU SELATAN, KOTA KEFAMENANU, TIMOR TENGAH UTARA, NUSA TENGGARA TIMUR",6,127,22,149
https://kawalpemilu.org#55674,"KEFAMENANU SELATAN, KOTA KEFAMENANU, TIMOR TENGAH UTARA, NUSA TENGGARA TIMUR",7,40,134,174
https://kawalpemilu.org#55674,"KEFAMENANU SELATAN, KOTA KEFAMENANU, TIMOR TENGAH UTARA, NUSA TENGGARA TIMUR",8,144,45,189
https://kawalpemilu.org#55674,"KEFAMENANU SELATAN, KOTA KEFAMENANU, TIMOR TENGAH UTARA, NUSA TENGGARA TIMUR",9,102,46,148
https://kawalpemilu.org#55674,"KEFAMENANU SELATAN, KOTA KEFAMENANU, TIMOR TENGAH UTARA, NUSA TENGGARA TIMUR",10,121,49,170
https://kawalpemilu.org#55674,"KEFAMENANU SELATAN, KOTA KEFAMENANU, TIMOR TENGAH UTARA, NUSA TENGGARA TIMUR",11,160,56,216
https://kawalpemilu.org#55674,"KEFAMENANU SELATAN, KOTA KEFAMENANU, TIMOR TENGAH UTARA, NUSA TENGGARA TIMUR",12,141,34,175
https://kawalpemilu.org#55674,"KEFAMENANU SELATAN, KOTA KEFAMENANU, TIMOR TENGAH UTARA, NUSA TENGGARA TIMUR",13,198,23,221
https://kawalpemilu.org#55674,"KEFAMENANU SELATAN, KOTA KEFAMENANU, TIMOR TENGAH UTARA, NUSA TENGGARA TIMUR",14,205,36,241
https://kawalpemilu.org#55674,"KEFAMENANU SELATAN, KOTA KEFAMENANU, TIMOR TENGAH UTARA, NUSA TENGGARA TIMUR",15,195,73,268
https://kawalpemilu.org#55674,"KEFAMENANU SELATAN, KOTA KEFAMENANU, TIMOR TENGAH UTARA, NUSA TENGGARA TIMUR",16,195,49,244
https://kawalpemilu.org#55674,"KEFAMENANU SELATAN, KOTA KEFAMENANU, TIMOR TENGAH UTARA, NUSA TENGGARA TIMUR",17,176,44,220
https://kawalpemilu.org#55674,"KEFAMENANU SELATAN, KOTA KEFAMENANU, TIMOR TENGAH UTARA, NUSA TENGGARA TIMUR",18,229,50,279
https://kawalpemilu.org#55674,"KEFAMENANU SELATAN, KOTA KEFAMENANU, TIMOR TENGAH UTARA, NUSA TENGGARA TIMUR",19,183,42,225
https://kawalpemilu.org#55674,"KEFAMENANU SELATAN, KOTA KEFAMENANU, TIMOR TENGAH UTARA, NUSA TENGGARA TIMUR",20,227,50,277
https://kawalpemilu.org#55674,"KEFAMENANU SELATAN, KOTA KEFAMENANU, TIMOR TENGAH UTARA, NUSA TENGGARA TIMUR",21,210,13,223
https://kawalpemilu.org#55674,"KEFAMENANU SELATAN, KOTA KEFAMENANU, TIMOR TENGAH UTARA, NUSA TENGGARA TIMUR",22,80,11,91
https://kawalpemilu.org#55675,"TUBUHUE, KOTA KEFAMENANU, TIMOR TENGAH UTARA, NUSA TENGGARA TIMUR",1,213,39,252
https://kawalpemilu.org#55675,"TUBUHUE, KOTA KEFAMENANU, TIMOR TENGAH UTARA, NUSA TENGGARA TIMUR",2,212,37,249
https://kawalpemilu.org#55675,"TUBUHUE, KOTA KEFAMENANU, TIMOR TENGAH UTARA, NUSA TENGGARA TIMUR",3,180,63,243
https://kawalpemilu.org#55675,"TUBUHUE, KOTA KEFAMENANU, TIMOR TENGAH UTARA, NUSA TENGGARA TIMUR",4,212,43,255
https://kawalpemilu.org#55675,"TUBUHUE, KOTA KEFAMENANU, TIMOR TENGAH UTARA, NUSA TENGGARA TIMUR",5,188,44,232
https://kawalpemilu.org#55675,"TUBUHUE, KOTA KEFAMENANU, TIMOR TENGAH UTARA, NUSA TENGGARA TIMUR",6,139,32,171
https://kawalpemilu.org#55675,"TUBUHUE, KOTA KEFAMENANU, TIMOR TENGAH UTARA, NUSA TENGGARA TIMUR",7,177,50,227
https://kawalpemilu.org#55675,"TUBUHUE, KOTA KEFAMENANU, TIMOR TENGAH UTARA, NUSA TENGGARA TIMUR",8,198,33,231
https://kawalpemilu.org#55675,"TUBUHUE, KOTA KEFAMENANU, TIMOR TENGAH UTARA, NUSA TENGGARA TIMUR",9,195,19,214
https://kawalpemilu.org#55675,"TUBUHUE, KOTA KEFAMENANU, TIMOR TENGAH UTARA, NUSA TENGGARA TIMUR",10,143,27,170
https://kawalpemilu.org#55675,"TUBUHUE, KOTA KEFAMENANU, TIMOR TENGAH UTARA, NUSA TENGGARA TIMUR",11,177,7,184
https://kawalpemilu.org#55675,"TUBUHUE, KOTA KEFAMENANU, TIMOR TENGAH UTARA, NUSA TENGGARA TIMUR",12,156,4,160
https://kawalpemilu.org#55676,"MAUBELI, KOTA KEFAMENANU, TIMOR TENGAH UTARA, NUSA TENGGARA TIMUR",1,216,15,231
https://kawalpemilu.org#55676,"MAUBELI, KOTA KEFAMENANU, TIMOR TENGAH UTARA, NUSA TENGGARA TIMUR",2,231,20,251
https://kawalpemilu.org#55676,"MAUBELI, KOTA KEFAMENANU, TIMOR TENGAH UTARA, NUSA TENGGARA TIMUR",3,229,28,257
https://kawalpemilu.org#55676,"MAUBELI, KOTA KEFAMENANU, TIMOR TENGAH UTARA, NUSA TENGGARA TIMUR",4,236,45,281
https://kawalpemilu.org#55676,"MAUBELI, KOTA KEFAMENANU, TIMOR TENGAH UTARA, NUSA TENGGARA TIMUR",5,187,52,239
https://kawalpemilu.org#55676,"MAUBELI, KOTA KEFAMENANU, TIMOR TENGAH UTARA, NUSA TENGGARA TIMUR",6,201,20,221
https://kawalpemilu.org#55676,"MAUBELI, KOTA KEFAMENANU, TIMOR TENGAH UTARA, NUSA TENGGARA TIMUR",7,203,24,227
https://kawalpemilu.org#55676,"MAUBELI, KOTA KEFAMENANU, TIMOR TENGAH UTARA, NUSA TENGGARA TIMUR",8,190,39,229
https://kawalpemilu.org#55676,"MAUBELI, KOTA KEFAMENANU, TIMOR TENGAH UTARA, NUSA TENGGARA TIMUR",9,223,37,260
https://kawalpemilu.org#55676,"MAUBELI, KOTA KEFAMENANU, TIMOR TENGAH UTARA, NUSA TENGGARA TIMUR",10,192,34,226
https://kawalpemilu.org#55676,"MAUBELI, KOTA KEFAMENANU, TIMOR TENGAH UTARA, NUSA TENGGARA TIMUR",11,186,36,222
https://kawalpemilu.org#55676,"MAUBELI, KOTA KEFAMENANU, TIMOR TENGAH UTARA, NUSA TENGGARA TIMUR",12,186,45,231
https://kawalpemilu.org#55676,"MAUBELI, KOTA KEFAMENANU, TIMOR TENGAH UTARA, NUSA TENGGARA TIMUR",13,218,23,241
https://kawalpemilu.org#55676,"MAUBELI, KOTA KEFAMENANU, TIMOR TENGAH UTARA, NUSA TENGGARA TIMUR",14,177,41,218
https://kawalpemilu.org#55677,"SASI, KOTA KEFAMENANU, TIMOR TENGAH UTARA, NUSA TENGGARA TIMUR",1,223,18,241
https://kawalpemilu.org#55677,"SASI, KOTA KEFAMENANU, TIMOR TENGAH UTARA, NUSA TENGGARA TIMUR",2,223,25,248
https://kawalpemilu.org#55677,"SASI, KOTA KEFAMENANU, TIMOR TENGAH UTARA, NUSA TENGGARA TIMUR",3,237,11,248
https://kawalpemilu.org#55677,"SASI, KOTA KEFAMENANU, TIMOR TENGAH UTARA, NUSA TENGGARA TIMUR",4,239,26,265
https://kawalpemilu.org#55677,"SASI, KOTA KEFAMENANU, TIMOR TENGAH UTARA, NUSA TENGGARA TIMUR",5,234,15,249
https://kawalpemilu.org#55677,"SASI, KOTA KEFAMENANU, TIMOR TENGAH UTARA, NUSA TENGGARA TIMUR",6,190,18,208
https://kawalpemilu.org#55677,"SASI, KOTA KEFAMENANU, TIMOR TENGAH UTARA, NUSA TENGGARA TIMUR",7,242,17,259
https://kawalpemilu.org#55677,"SASI, KOTA KEFAMENANU, TIMOR TENGAH UTARA, NUSA TENGGARA TIMUR",8,216,25,241
https://kawalpemilu.org#55677,"SASI, KOTA KEFAMENANU, TIMOR TENGAH UTARA, NUSA TENGGARA TIMUR",9,224,16,224
https://kawalpemilu.org#55679,"BORONUBAEN, BIBOKI UTARA, TIMOR TENGAH UTARA, NUSA TENGGARA TIMUR",1,175,24,199
https://kawalpemilu.org#55679,"BORONUBAEN, BIBOKI UTARA, TIMOR TENGAH UTARA, NUSA TENGGARA TIMUR",2,168,25,193
https://kawalpemilu.org#55679,"BORONUBAEN, BIBOKI UTARA, TIMOR TENGAH UTARA, NUSA TENGGARA TIMUR",3,210,13,223
https://kawalpemilu.org#55679,"BORONUBAEN, BIBOKI UTARA, TIMOR TENGAH UTARA, NUSA TENGGARA TIMUR",4,171,27,198
https://kawalpemilu.org#55680,"HAUTAES, BIBOKI UTARA, TIMOR TENGAH UTARA, NUSA TENGGARA TIMUR",1,206,24,230
https://kawalpemilu.org#55680,"HAUTAES, BIBOKI UTARA, TIMOR TENGAH UTARA, NUSA TENGGARA TIMUR",2,168,32,200
https://kawalpemilu.org#55680,"HAUTAES, BIBOKI UTARA, TIMOR TENGAH UTARA, NUSA TENGGARA TIMUR",3,130,7,137
https://kawalpemilu.org#55681,"TUALENA, BIBOKI UTARA, TIMOR TENGAH UTARA, NUSA TENGGARA TIMUR",1,210,15,225
https://kawalpemilu.org#55681,"TUALENA, BIBOKI UTARA, TIMOR TENGAH UTARA, NUSA TENGGARA TIMUR",2,214,8,222
https://kawalpemilu.org#55681,"TUALENA, BIBOKI UTARA, TIMOR TENGAH UTARA, NUSA TENGGARA TIMUR",3,182,10,192
https://kawalpemilu.org#55681,"TUALENA, BIBOKI UTARA, TIMOR TENGAH UTARA, NUSA TENGGARA TIMUR",4,195,12,207
https://kawalpemilu.org#55681,"TUALENA, BIBOKI UTARA, TIMOR TENGAH UTARA, NUSA TENGGARA TIMUR",5,151,30,181
https://kawalpemilu.org#55682,"BILOE, BIBOKI UTARA, TIMOR TENGAH UTARA, NUSA TENGGARA TIMUR",1,152,40,192
https://kawalpemilu.org#55682,"BILOE, BIBOKI UTARA, TIMOR TENGAH UTARA, NUSA TENGGARA TIMUR",2,181,10,191
https://kawalpemilu.org#55682,"BILOE, BIBOKI UTARA, TIMOR TENGAH UTARA, NUSA TENGGARA TIMUR",3,133,12,145
https://kawalpemilu.org#55683,"TAUNBAEN, BIBOKI UTARA, TIMOR TENGAH UTARA, NUSA TENGGARA TIMUR",1,211,32,243
https://kawalpemilu.org#55683,"TAUNBAEN, BIBOKI UTARA, TIMOR TENGAH UTARA, NUSA TENGGARA TIMUR",2,158,6,164
https://kawalpemilu.org#55684,"SAPAEN, BIBOKI UTARA, TIMOR TENGAH UTARA, NUSA TENGGARA TIMUR",1,150,14,164
https://kawalpemilu.org#55684,"SAPAEN, BIBOKI UTARA, TIMOR TENGAH UTARA, NUSA TENGGARA TIMUR",2,193,20,213
https://kawalpemilu.org#55685,"LOKOMEA, BIBOKI UTARA, TIMOR TENGAH UTARA, NUSA TENGGARA TIMUR",1,163,11,174
https://kawalpemilu.org#55685,"LOKOMEA, BIBOKI UTARA, TIMOR TENGAH UTARA, NUSA TENGGARA TIMUR",2,176,19,195
https://kawalpemilu.org#55685,"LOKOMEA, BIBOKI UTARA, TIMOR TENGAH UTARA, NUSA TENGGARA TIMUR",3,135,10,145
https://kawalpemilu.org#928456,"BORONUBAEN TIMUR, BIBOKI UTARA, TIMOR TENGAH UTARA, NUSA TENGGARA TIMUR",1,147,18,165
https://kawalpemilu.org#928456,"BORONUBAEN TIMUR, BIBOKI UTARA, TIMOR TENGAH UTARA, NUSA TENGGARA TIMUR",2,175,12,187
https://kawalpemilu.org#928457,"TAUNBAEN TIMUR, BIBOKI UTARA, TIMOR TENGAH UTARA, NUSA TENGGARA TIMUR",1,156,22,178
https://kawalpemilu.org#928458,"HAUTEAS BARAT, BIBOKI UTARA, TIMOR TENGAH UTARA, NUSA TENGGARA TIMUR",1,171,23,194
https://kawalpemilu.org#928458,"HAUTEAS BARAT, BIBOKI UTARA, TIMOR TENGAH UTARA, NUSA TENGGARA TIMUR",2,158,24,182
https://kawalpemilu.org#55687,"PONU, BIBOKI ANLEU, TIMOR TENGAH UTARA, NUSA TENGGARA TIMUR",1,225,46,271
https://kawalpemilu.org#55687,"PONU, BIBOKI ANLEU, TIMOR TENGAH UTARA, NUSA TENGGARA TIMUR",2,206,54,260
https://kawalpemilu.org#55687,"PONU, BIBOKI ANLEU, TIMOR TENGAH UTARA, NUSA TENGGARA TIMUR",3,239,14,253
https://kawalpemilu.org#55687,"PONU, BIBOKI ANLEU, TIMOR TENGAH UTARA, NUSA TENGGARA TIMUR",4,211,8,219
https://kawalpemilu.org#55687,"PONU, BIBOKI ANLEU, TIMOR TENGAH UTARA, NUSA TENGGARA TIMUR",5,232,12,244
https://kawalpemilu.org#55687,"PONU, BIBOKI ANLEU, TIMOR TENGAH UTARA, NUSA TENGGARA TIMUR",6,198,10,208
https://kawalpemilu.org#55687,"PONU, BIBOKI ANLEU, TIMOR TENGAH UTARA, NUSA TENGGARA TIMUR",7,189,18,207
https://kawalpemilu.org#55687,"PONU, BIBOKI ANLEU, TIMOR TENGAH UTARA, NUSA TENGGARA TIMUR",8,172,21,193
https://kawalpemilu.org#55687,"PONU, BIBOKI ANLEU, TIMOR TENGAH UTARA, NUSA TENGGARA TIMUR",9,229,37,266
https://kawalpemilu.org#55687,"PONU, BIBOKI ANLEU, TIMOR TENGAH UTARA, NUSA TENGGARA TIMUR",10,233,25,258
https://kawalpemilu.org#55687,"PONU, BIBOKI ANLEU, TIMOR TENGAH UTARA, NUSA TENGGARA TIMUR",11,214,31,245
https://kawalpemilu.org#55688,"MOTADIK, BIBOKI ANLEU, TIMOR TENGAH UTARA, NUSA TENGGARA TIMUR",1,232,9,241
https://kawalpemilu.org#55688,"MOTADIK, BIBOKI ANLEU, TIMOR TENGAH UTARA, NUSA TENGGARA TIMUR",2,228,7,235
https://kawalpemilu.org#55688,"MOTADIK, BIBOKI ANLEU, TIMOR TENGAH UTARA, NUSA TENGGARA TIMUR",3,221,8,229
https://kawalpemilu.org#55688,"MOTADIK, BIBOKI ANLEU, TIMOR TENGAH UTARA, NUSA TENGGARA TIMUR",4,212,6,218
https://kawalpemilu.org#55689,"NONOTBATAN, BIBOKI ANLEU, TIMOR TENGAH UTARA, NUSA TENGGARA TIMUR",1,195,18,213
https://kawalpemilu.org#55689,"NONOTBATAN, BIBOKI ANLEU, TIMOR TENGAH UTARA, NUSA TENGGARA TIMUR",2,152,3,155
https://kawalpemilu.org#55689,"NONOTBATAN, BIBOKI ANLEU, TIMOR TENGAH UTARA, NUSA TENGGARA TIMUR",3,183,13,196
https://kawalpemilu.org#55689,"NONOTBATAN, BIBOKI ANLEU, TIMOR TENGAH UTARA, NUSA TENGGARA TIMUR",4,180,1,181
https://kawalpemilu.org#55690,"SIFANIHA, BIBOKI ANLEU, TIMOR TENGAH UTARA, NUSA TENGGARA TIMUR",1,185,10,195
https://kawalpemilu.org#55690,"SIFANIHA, BIBOKI ANLEU, TIMOR TENGAH UTARA, NUSA TENGGARA TIMUR",2,165,7,172
https://kawalpemilu.org#55690,"SIFANIHA, BIBOKI ANLEU, TIMOR TENGAH UTARA, NUSA TENGGARA TIMUR",3,118,12,130
https://kawalpemilu.org#55691,"MAUKABATAN, BIBOKI ANLEU, TIMOR TENGAH UTARA, NUSA TENGGARA TIMUR",1,234,15,249
https://kawalpemilu.org#55691,"MAUKABATAN, BIBOKI ANLEU, TIMOR TENGAH UTARA, NUSA TENGGARA TIMUR",3,138,15,153
https://kawalpemilu.org#55692,"KOTAFOUN, BIBOKI ANLEU, TIMOR TENGAH UTARA, NUSA TENGGARA TIMUR",1,203,7,210
https://kawalpemilu.org#55692,"KOTAFOUN, BIBOKI ANLEU, TIMOR TENGAH UTARA, NUSA TENGGARA TIMUR",2,192,5,197
https://kawalpemilu.org#55692,"KOTAFOUN, BIBOKI ANLEU, TIMOR TENGAH UTARA, NUSA TENGGARA TIMUR",3,187,6,193
https://kawalpemilu.org#55692,"KOTAFOUN, BIBOKI ANLEU, TIMOR TENGAH UTARA, NUSA TENGGARA TIMUR",4,170,15,185
https://kawalpemilu.org#55693,"TUAMESE, BIBOKI ANLEU, TIMOR TENGAH UTARA, NUSA TENGGARA TIMUR",1,207,20,227
https://kawalpemilu.org#55693,"TUAMESE, BIBOKI ANLEU, TIMOR TENGAH UTARA, NUSA TENGGARA TIMUR",2,206,12,218
https://kawalpemilu.org#55693,"TUAMESE, BIBOKI ANLEU, TIMOR TENGAH UTARA, NUSA TENGGARA TIMUR",3,164,6,170
https://kawalpemilu.org#55694,"OEMANU, BIBOKI ANLEU, TIMOR TENGAH UTARA, NUSA TENGGARA TIMUR",1,177,23,200
https://kawalpemilu.org#55694,"OEMANU, BIBOKI ANLEU, TIMOR TENGAH UTARA, NUSA TENGGARA TIMUR",2,164,35,199
https://kawalpemilu.org#55695,"NIFUTASI, BIBOKI ANLEU, TIMOR TENGAH UTARA, NUSA TENGGARA TIMUR",1,173,22,195
https://kawalpemilu.org#55695,"NIFUTASI, BIBOKI ANLEU, TIMOR TENGAH UTARA, NUSA TENGGARA TIMUR",2,93,27,120
https://kawalpemilu.org#55695,"NIFUTASI, BIBOKI ANLEU, TIMOR TENGAH UTARA, NUSA TENGGARA TIMUR",3,114,27,141
https://kawalpemilu.org#55695,"NIFUTASI, BIBOKI ANLEU, TIMOR TENGAH UTARA, NUSA TENGGARA TIMUR",4,98,15,113
https://kawalpemilu.org#55697,"AINIUT, INSANA, TIMOR TENGAH UTARA, NUSA TENGGARA TIMUR",1,202,28,230
https://kawalpemilu.org#55697,"AINIUT, INSANA, TIMOR TENGAH UTARA, NUSA TENGGARA TIMUR",2,214,14,228
https://kawalpemilu.org#55697,"AINIUT, INSANA, TIMOR TENGAH UTARA, NUSA TENGGARA TIMUR",3,193,8,201
https://kawalpemilu.org#55698,"NUNMAFO, INSANA, TIMOR TENGAH UTARA, NUSA TENGGARA TIMUR",1,139,35,174
https://kawalpemilu.org#55698,"NUNMAFO, INSANA, TIMOR TENGAH UTARA, NUSA TENGGARA TIMUR",2,175,0,175
https://kawalpemilu.org#55698,"NUNMAFO, INSANA, TIMOR TENGAH UTARA, NUSA TENGGARA TIMUR",3,133,12,145
https://kawalpemilu.org#55698,"NUNMAFO, INSANA, TIMOR TENGAH UTARA, NUSA TENGGARA TIMUR",4,179,13,192
https://kawalpemilu.org#55698,"NUNMAFO, INSANA, TIMOR TENGAH UTARA, NUSA TENGGARA TIMUR",5,159,15,174
https://kawalpemilu.org#55698,"NUNMAFO, INSANA, TIMOR TENGAH UTARA, NUSA TENGGARA TIMUR",6,154,8,162
https://kawalpemilu.org#55699,"OINBIT, INSANA, TIMOR TENGAH UTARA, NUSA TENGGARA TIMUR",1,200,2,202
https://kawalpemilu.org#55699,"OINBIT, INSANA, TIMOR TENGAH UTARA, NUSA TENGGARA TIMUR",2,154,6,160
https://kawalpemilu.org#55699,"OINBIT, INSANA, TIMOR TENGAH UTARA, NUSA TENGGARA TIMUR",3,177,5,182
https://kawalpemilu.org#55699,"OINBIT, INSANA, TIMOR TENGAH UTARA, NUSA TENGGARA TIMUR",4,151,13,164
https://kawalpemilu.org#55699,"OINBIT, INSANA, TIMOR TENGAH UTARA, NUSA TENGGARA TIMUR",5,170,7,177
https://kawalpemilu.org#55699,"OINBIT, INSANA, TIMOR TENGAH UTARA, NUSA TENGGARA TIMUR",6,148,5,153
https://kawalpemilu.org#55699,"OINBIT, INSANA, TIMOR TENGAH UTARA, NUSA TENGGARA TIMUR",7,131,4,135
https://kawalpemilu.org#55700,"MANUNAIN A, INSANA, TIMOR TENGAH UTARA, NUSA TENGGARA TIMUR",1,189,15,204
https://kawalpemilu.org#55700,"MANUNAIN A, INSANA, TIMOR TENGAH UTARA, NUSA TENGGARA TIMUR",2,206,11,217
https://kawalpemilu.org#55700,"MANUNAIN A, INSANA, TIMOR TENGAH UTARA, NUSA TENGGARA TIMUR",3,183,16,199
https://kawalpemilu.org#55700,"MANUNAIN A, INSANA, TIMOR TENGAH UTARA, NUSA TENGGARA TIMUR",4,181,21,202
https://kawalpemilu.org#55701,"FATOIN, INSANA, TIMOR TENGAH UTARA, NUSA TENGGARA TIMUR",1,212,23,235
https://kawalpemilu.org#55701,"FATOIN, INSANA, TIMOR TENGAH UTARA, NUSA TENGGARA TIMUR",2,210,27,237
https://kawalpemilu.org#55701,"FATOIN, INSANA, TIMOR TENGAH UTARA, NUSA TENGGARA TIMUR",3,184,17,201
https://kawalpemilu.org#55701,"FATOIN, INSANA, TIMOR TENGAH UTARA, NUSA TENGGARA TIMUR",4,112,7,119
https://kawalpemilu.org#55702,"NANSAEN, INSANA, TIMOR TENGAH UTARA, NUSA TENGGARA TIMUR",1,133,9,142
https://kawalpemilu.org#55702,"NANSAEN, INSANA, TIMOR TENGAH UTARA, NUSA TENGGARA TIMUR",2,145,6,151
https://kawalpemilu.org#55702,"NANSAEN, INSANA, TIMOR TENGAH UTARA, NUSA TENGGARA TIMUR",3,121,8,129
https://kawalpemilu.org#55703,"SUSULAKU, INSANA, TIMOR TENGAH UTARA, NUSA TENGGARA TIMUR",1,218,13,231
https://kawalpemilu.org#55703,"SUSULAKU, INSANA, TIMOR TENGAH UTARA, NUSA TENGGARA TIMUR",2,127,51,178
https://kawalpemilu.org#55703,"SUSULAKU, INSANA, TIMOR TENGAH UTARA, NUSA TENGGARA TIMUR",3,115,20,135
https://kawalpemilu.org#55704,"LOERAM, INSANA, TIMOR TENGAH UTARA, NUSA TENGGARA TIMUR",1,198,19,217
https://kawalpemilu.org#55704,"LOERAM, INSANA, TIMOR TENGAH UTARA, NUSA TENGGARA TIMUR",2,196,14,210
https://kawalpemilu.org#55704,"LOERAM, INSANA, TIMOR TENGAH UTARA, NUSA TENGGARA TIMUR",3,204,9,213
https://kawalpemilu.org#55705,"MANUNAIN B, INSANA, TIMOR TENGAH UTARA, NUSA TENGGARA TIMUR",1,185,6,191
https://kawalpemilu.org#55705,"MANUNAIN B, INSANA, TIMOR TENGAH UTARA, NUSA TENGGARA TIMUR",2,151,1,152
https://kawalpemilu.org#55705,"MANUNAIN B, INSANA, TIMOR TENGAH UTARA, NUSA TENGGARA TIMUR",3,155,4,159
https://kawalpemilu.org#55706,"TAPENPAH, INSANA, TIMOR TENGAH UTARA, NUSA TENGGARA TIMUR",1,183,31,214
https://kawalpemilu.org#55706,"TAPENPAH, INSANA, TIMOR TENGAH UTARA, NUSA TENGGARA TIMUR",2,143,30,173
https://kawalpemilu.org#55706,"TAPENPAH, INSANA, TIMOR TENGAH UTARA, NUSA TENGGARA TIMUR",3,157,29,186
https://kawalpemilu.org#55707,"SEKON, INSANA, TIMOR TENGAH UTARA, NUSA TENGGARA TIMUR",1,152,29,181
https://kawalpemilu.org#55707,"SEKON, INSANA, TIMOR TENGAH UTARA, NUSA TENGGARA TIMUR",2,150,7,157
https://kawalpemilu.org#55707,"SEKON, INSANA, TIMOR TENGAH UTARA, NUSA TENGGARA TIMUR",3,151,20,171
https://kawalpemilu.org#55709,"KEUN, INSANA, TIMOR TENGAH UTARA, NUSA TENGGARA TIMUR",1,123,40,163
https://kawalpemilu.org#55709,"KEUN, INSANA, TIMOR TENGAH UTARA, NUSA TENGGARA TIMUR",2,132,46,178
https://kawalpemilu.org#55709,"KEUN, INSANA, TIMOR TENGAH UTARA, NUSA TENGGARA TIMUR",3,124,26,150
https://kawalpemilu.org#92130,"SUSULAKU B, INSANA, TIMOR TENGAH UTARA, NUSA TENGGARA TIMUR",1,182,14,196
https://kawalpemilu.org#92130,"SUSULAKU B, INSANA, TIMOR TENGAH UTARA, NUSA TENGGARA TIMUR",2,160,4,164
https://kawalpemilu.org#928459,"BITAUNI, INSANA, TIMOR TENGAH UTARA, NUSA TENGGARA TIMUR",1,166,15,181
https://kawalpemilu.org#928459,"BITAUNI, INSANA, TIMOR TENGAH UTARA, NUSA TENGGARA TIMUR",2,80,12,92
https://kawalpemilu.org#928459,"BITAUNI, INSANA, TIMOR TENGAH UTARA, NUSA TENGGARA TIMUR",3,179,12,191
https://kawalpemilu.org#928460,"FATU'ANA, INSANA, TIMOR TENGAH UTARA, NUSA TENGGARA TIMUR",1,194,12,206
https://kawalpemilu.org#928460,"FATU'ANA, INSANA, TIMOR TENGAH UTARA, NUSA TENGGARA TIMUR",2,164,3,167
https://kawalpemilu.org#928461,"BOTOF, INSANA, TIMOR TENGAH UTARA, NUSA TENGGARA TIMUR",1,139,21,160
https://kawalpemilu.org#928461,"BOTOF, INSANA, TIMOR TENGAH UTARA, NUSA TENGGARA TIMUR",2,154,20,174
https://kawalpemilu.org#928462,"NANSEAN TIMUR, INSANA, TIMOR TENGAH UTARA, NUSA TENGGARA TIMUR",1,84,14,98
https://kawalpemilu.org#928462,"NANSEAN TIMUR, INSANA, TIMOR TENGAH UTARA, NUSA TENGGARA TIMUR",2,116,6,122
https://kawalpemilu.org#55711,"HUMUSU A, INSANA UTARA, TIMOR TENGAH UTARA, NUSA TENGGARA TIMUR",1,172,18,190
https://kawalpemilu.org#55711,"HUMUSU A, INSANA UTARA, TIMOR TENGAH UTARA, NUSA TENGGARA TIMUR",2,208,11,219
https://kawalpemilu.org#55711,"HUMUSU A, INSANA UTARA, TIMOR TENGAH UTARA, NUSA TENGGARA TIMUR",3,160,12,172
https://kawalpemilu.org#55712,"HUMUSU B, INSANA UTARA, TIMOR TENGAH UTARA, NUSA TENGGARA TIMUR",1,193,12,205
https://kawalpemilu.org#55712,"HUMUSU B, INSANA UTARA, TIMOR TENGAH UTARA, NUSA TENGGARA TIMUR",2,194,11,205
https://kawalpemilu.org#55712,"HUMUSU B, INSANA UTARA, TIMOR TENGAH UTARA, NUSA TENGGARA TIMUR",3,172,9,181
https://kawalpemilu.org#55712,"HUMUSU B, INSANA UTARA, TIMOR TENGAH UTARA, NUSA TENGGARA TIMUR",4,197,21,218
https://kawalpemilu.org#55712,"HUMUSU B, INSANA UTARA, TIMOR TENGAH UTARA, NUSA TENGGARA TIMUR",5,152,15,167
https://kawalpemilu.org#55712,"HUMUSU B, INSANA UTARA, TIMOR TENGAH UTARA, NUSA TENGGARA TIMUR",6,156,7,163
https://kawalpemilu.org#55713,"HUMUSU WINI, INSANA UTARA, TIMOR TENGAH UTARA, NUSA TENGGARA TIMUR",1,191,14,205
https://kawalpemilu.org#55713,"HUMUSU WINI, INSANA UTARA, TIMOR TENGAH UTARA, NUSA TENGGARA TIMUR",2,214,13,227
https://kawalpemilu.org#55713,"HUMUSU WINI, INSANA UTARA, TIMOR TENGAH UTARA, NUSA TENGGARA TIMUR",3,215,10,225
https://kawalpemilu.org#55713,"HUMUSU WINI, INSANA UTARA, TIMOR TENGAH UTARA, NUSA TENGGARA TIMUR",4,202,16,218
https://kawalpemilu.org#55713,"HUMUSU WINI, INSANA UTARA, TIMOR TENGAH UTARA, NUSA TENGGARA TIMUR",6,249,24,273
https://kawalpemilu.org#55713,"HUMUSU WINI, INSANA UTARA, TIMOR TENGAH UTARA, NUSA TENGGARA TIMUR",7,221,18,239
https://kawalpemilu.org#55713,"HUMUSU WINI, INSANA UTARA, TIMOR TENGAH UTARA, NUSA TENGGARA TIMUR",8,203,34,237
https://kawalpemilu.org#55713,"HUMUSU WINI, INSANA UTARA, TIMOR TENGAH UTARA, NUSA TENGGARA TIMUR",9,161,3,164
https://kawalpemilu.org#55713,"HUMUSU WINI, INSANA UTARA, TIMOR TENGAH UTARA, NUSA TENGGARA TIMUR",10,196,3,199
https://kawalpemilu.org#55714,"FATUMTASA, INSANA UTARA, TIMOR TENGAH UTARA, NUSA TENGGARA TIMUR",1,149,28,177
https://kawalpemilu.org#55714,"FATUMTASA, INSANA UTARA, TIMOR TENGAH UTARA, NUSA TENGGARA TIMUR",2,180,14,194
https://kawalpemilu.org#55714,"FATUMTASA, INSANA UTARA, TIMOR TENGAH UTARA, NUSA TENGGARA TIMUR",3,163,10,173
https://kawalpemilu.org#55715,"OESOKO, INSANA UTARA, TIMOR TENGAH UTARA, NUSA TENGGARA TIMUR",1,215,7,222
https://kawalpemilu.org#55715,"OESOKO, INSANA UTARA, TIMOR TENGAH UTARA, NUSA TENGGARA TIMUR",2,212,12,224
https://kawalpemilu.org#55715,"OESOKO, INSANA UTARA, TIMOR TENGAH UTARA, NUSA TENGGARA TIMUR",3,203,2,205
https://kawalpemilu.org#55717,"NAOB, NOEMUTI TIMUR, TIMOR TENGAH UTARA, NUSA TENGGARA TIMUR",1,202,23,225
https://kawalpemilu.org#55717,"NAOB, NOEMUTI TIMUR, TIMOR TENGAH UTARA, NUSA TENGGARA TIMUR",2,184,16,200
https://kawalpemilu.org#55717,"NAOB, NOEMUTI TIMUR, TIMOR TENGAH UTARA, NUSA TENGGARA TIMUR",3,164,34,198
https://kawalpemilu.org#55717,"NAOB, NOEMUTI TIMUR, TIMOR TENGAH UTARA, NUSA TENGGARA TIMUR",4,66,5,71
https://kawalpemilu.org#55718,"HAEKTO, NOEMUTI TIMUR, TIMOR TENGAH UTARA, NUSA TENGGARA TIMUR",1,192,25,217
https://kawalpemilu.org#55718,"HAEKTO, NOEMUTI TIMUR, TIMOR TENGAH UTARA, NUSA TENGGARA TIMUR",2,217,19,236
https://kawalpemilu.org#55718,"HAEKTO, NOEMUTI TIMUR, TIMOR TENGAH UTARA, NUSA TENGGARA TIMUR",3,139,18,157
https://kawalpemilu.org#55719,"MANIKIN, NOEMUTI TIMUR, TIMOR TENGAH UTARA, NUSA TENGGARA TIMUR",1,188,17,205
https://kawalpemilu.org#55719,"MANIKIN, NOEMUTI TIMUR, TIMOR TENGAH UTARA, NUSA TENGGARA TIMUR",2,195,14,209
https://kawalpemilu.org#55719,"MANIKIN, NOEMUTI TIMUR, TIMOR TENGAH UTARA, NUSA TENGGARA TIMUR",3,87,5,92
https://kawalpemilu.org#55720,"KUAKEN, NOEMUTI TIMUR, TIMOR TENGAH UTARA, NUSA TENGGARA TIMUR",1,197,27,224
https://kawalpemilu.org#55720,"KUAKEN, NOEMUTI TIMUR, TIMOR TENGAH UTARA, NUSA TENGGARA TIMUR",2,104,12,116
https://kawalpemilu.org#55722,"TUABATAN, MIOMAFFO TENGAH, TIMOR TENGAH UTARA, NUSA TENGGARA TIMUR",1,156,18,174
https://kawalpemilu.org#55722,"TUABATAN, MIOMAFFO TENGAH, TIMOR TENGAH UTARA, NUSA TENGGARA TIMUR",2,156,18,174
https://kawalpemilu.org#55723,"AKOMI, MIOMAFFO TENGAH, TIMOR TENGAH UTARA, NUSA TENGGARA TIMUR",1,119,3,122
https://kawalpemilu.org#55723,"AKOMI, MIOMAFFO TENGAH, TIMOR TENGAH UTARA, NUSA TENGGARA TIMUR",2,120,0,120
https://kawalpemilu.org#55723,"AKOMI, MIOMAFFO TENGAH, TIMOR TENGAH UTARA, NUSA TENGGARA TIMUR",3,209,2,211
https://kawalpemilu.org#55724,"BIJAEPASU, MIOMAFFO TENGAH, TIMOR TENGAH UTARA, NUSA TENGGARA TIMUR",1,197,30,227
https://kawalpemilu.org#55724,"BIJAEPASU, MIOMAFFO TENGAH, TIMOR TENGAH UTARA, NUSA TENGGARA TIMUR",2,125,10,135
https://kawalpemilu.org#55724,"BIJAEPASU, MIOMAFFO TENGAH, TIMOR TENGAH UTARA, NUSA TENGGARA TIMUR",3,141,31,172
https://kawalpemilu.org#55724,"BIJAEPASU, MIOMAFFO TENGAH, TIMOR TENGAH UTARA, NUSA TENGGARA TIMUR",4,165,39,204
https://kawalpemilu.org#55725,"NEONASI, MIOMAFFO TENGAH, TIMOR TENGAH UTARA, NUSA TENGGARA TIMUR",1,106,15,121
https://kawalpemilu.org#55725,"NEONASI, MIOMAFFO TENGAH, TIMOR TENGAH UTARA, NUSA TENGGARA TIMUR",2,117,10,127
https://kawalpemilu.org#55726,"N I A N, MIOMAFFO TENGAH, TIMOR TENGAH UTARA, NUSA TENGGARA TIMUR",1,89,8,97
https://kawalpemilu.org#55726,"N I A N, MIOMAFFO TENGAH, TIMOR TENGAH UTARA, NUSA TENGGARA TIMUR",2,178,35,213
https://kawalpemilu.org#55726,"N I A N, MIOMAFFO TENGAH, TIMOR TENGAH UTARA, NUSA TENGGARA TIMUR",3,201,7,208
https://kawalpemilu.org#55726,"N I A N, MIOMAFFO TENGAH, TIMOR TENGAH UTARA, NUSA TENGGARA TIMUR",4,219,12,231
https://kawalpemilu.org#55726,"N I A N, MIOMAFFO TENGAH, TIMOR TENGAH UTARA, NUSA TENGGARA TIMUR",5,209,6,215
https://kawalpemilu.org#928463,"TUABATAN BARAT, MIOMAFFO TENGAH, TIMOR TENGAH UTARA, NUSA TENGGARA TIMUR",1,191,32,223
https://kawalpemilu.org#928463,"TUABATAN BARAT, MIOMAFFO TENGAH, TIMOR TENGAH UTARA, NUSA TENGGARA TIMUR",2,162,9,171
https://kawalpemilu.org#55728,"OELNEKE, MUSI, TIMOR TENGAH UTARA, NUSA TENGGARA TIMUR",1,217,1,218
https://kawalpemilu.org#55728,"OELNEKE, MUSI, TIMOR TENGAH UTARA, NUSA TENGGARA TIMUR",2,193,12,205
https://kawalpemilu.org#55729,"OETULU, MUSI, TIMOR TENGAH UTARA, NUSA TENGGARA TIMUR",1,181,14,195
https://kawalpemilu.org#55729,"OETULU, MUSI, TIMOR TENGAH UTARA, NUSA TENGGARA TIMUR",2,207,10,217
https://kawalpemilu.org#55729,"OETULU, MUSI, TIMOR TENGAH UTARA, NUSA TENGGARA TIMUR",3,198,6,204
https://kawalpemilu.org#55730,"OEOLO, MUSI, TIMOR TENGAH UTARA, NUSA TENGGARA TIMUR",1,207,16,223
https://kawalpemilu.org#55730,"OEOLO, MUSI, TIMOR TENGAH UTARA, NUSA TENGGARA TIMUR",2,166,22,188
https://kawalpemilu.org#55730,"OEOLO, MUSI, TIMOR TENGAH UTARA, NUSA TENGGARA TIMUR",3,194,21,215
https://kawalpemilu.org#55731,"AINAN, MUSI, TIMOR TENGAH UTARA, NUSA TENGGARA TIMUR",1,171,4,175
https://kawalpemilu.org#55732,"BISAFE, MUSI, TIMOR TENGAH UTARA, NUSA TENGGARA TIMUR",1,174,4,178
https://kawalpemilu.org#55733,"BATNES, MUSI, TIMOR TENGAH UTARA, NUSA TENGGARA TIMUR",1,213,8,221
https://kawalpemilu.org#55733,"BATNES, MUSI, TIMOR TENGAH UTARA, NUSA TENGGARA TIMUR",2,199,8,207
https://kawalpemilu.org#55735,"TASINIFU, MUTIS, TIMOR TENGAH UTARA, NUSA TENGGARA TIMUR",1,223,18,241
https://kawalpemilu.org#55735,"TASINIFU, MUTIS, TIMOR TENGAH UTARA, NUSA TENGGARA TIMUR",2,208,16,224
https://kawalpemilu.org#55735,"TASINIFU, MUTIS, TIMOR TENGAH UTARA, NUSA TENGGARA TIMUR",3,175,33,208
https://kawalpemilu.org#55735,"TASINIFU, MUTIS, TIMOR TENGAH UTARA, NUSA TENGGARA TIMUR",4,117,24,141
https://kawalpemilu.org#55735,"TASINIFU, MUTIS, TIMOR TENGAH UTARA, NUSA TENGGARA TIMUR",5,108,21,129
https://kawalpemilu.org#55735,"TASINIFU, MUTIS, TIMOR TENGAH UTARA, NUSA TENGGARA TIMUR",7,172,12,184
https://kawalpemilu.org#55735,"TASINIFU, MUTIS, TIMOR TENGAH UTARA, NUSA TENGGARA TIMUR",8,176,9,185
https://kawalpemilu.org#55735,"TASINIFU, MUTIS, TIMOR TENGAH UTARA, NUSA TENGGARA TIMUR",9,150,4,154
https://kawalpemilu.org#55735,"TASINIFU, MUTIS, TIMOR TENGAH UTARA, NUSA TENGGARA TIMUR",10,132,5,137
https://kawalpemilu.org#55736,"NAEKAKE A, MUTIS, TIMOR TENGAH UTARA, NUSA TENGGARA TIMUR",1,206,8,214
https://kawalpemilu.org#55736,"NAEKAKE A, MUTIS, TIMOR TENGAH UTARA, NUSA TENGGARA TIMUR",2,213,8,221
https://kawalpemilu.org#55736,"NAEKAKE A, MUTIS, TIMOR TENGAH UTARA, NUSA TENGGARA TIMUR",3,182,6,188
https://kawalpemilu.org#55736,"NAEKAKE A, MUTIS, TIMOR TENGAH UTARA, NUSA TENGGARA TIMUR",4,208,12,220
https://kawalpemilu.org#55737,"NAEKAKE B, MUTIS, TIMOR TENGAH UTARA, NUSA TENGGARA TIMUR",1,133,14,147
https://kawalpemilu.org#55737,"NAEKAKE B, MUTIS, TIMOR TENGAH UTARA, NUSA TENGGARA TIMUR",2,118,12,130
https://kawalpemilu.org#55737,"NAEKAKE B, MUTIS, TIMOR TENGAH UTARA, NUSA TENGGARA TIMUR",3,122,10,132
https://kawalpemilu.org#55738,"NOELELO, MUTIS, TIMOR TENGAH UTARA, NUSA TENGGARA TIMUR",1,124,2,126
https://kawalpemilu.org#55738,"NOELELO, MUTIS, TIMOR TENGAH UTARA, NUSA TENGGARA TIMUR",2,129,7,136
https://kawalpemilu.org#55738,"NOELELO, MUTIS, TIMOR TENGAH UTARA, NUSA TENGGARA TIMUR",3,90,0,90
https://kawalpemilu.org#55740,"OELAMI, BIKOMI SELATAN, TIMOR TENGAH UTARA, NUSA TENGGARA TIMUR",1,182,14,196
https://kawalpemilu.org#55740,"OELAMI, BIKOMI SELATAN, TIMOR TENGAH UTARA, NUSA TENGGARA TIMUR",2,143,22,165
https://kawalpemilu.org#55740,"OELAMI, BIKOMI SELATAN, TIMOR TENGAH UTARA, NUSA TENGGARA TIMUR",3,199,17,216
https://kawalpemilu.org#55740,"OELAMI, BIKOMI SELATAN, TIMOR TENGAH UTARA, NUSA TENGGARA TIMUR",4,202,17,219
https://kawalpemilu.org#55740,"OELAMI, BIKOMI SELATAN, TIMOR TENGAH UTARA, NUSA TENGGARA TIMUR",5,121,12,133
https://kawalpemilu.org#55740,"OELAMI, BIKOMI SELATAN, TIMOR TENGAH UTARA, NUSA TENGGARA TIMUR",6,142,8,150
https://kawalpemilu.org#55741,"TUBLOPO, BIKOMI SELATAN, TIMOR TENGAH UTARA, NUSA TENGGARA TIMUR",1,165,6,171
https://kawalpemilu.org#55741,"TUBLOPO, BIKOMI SELATAN, TIMOR TENGAH UTARA, NUSA TENGGARA TIMUR",2,156,6,162
https://kawalpemilu.org#55741,"TUBLOPO, BIKOMI SELATAN, TIMOR TENGAH UTARA, NUSA TENGGARA TIMUR",3,158,10,168
https://kawalpemilu.org#55741,"TUBLOPO, BIKOMI SELATAN, TIMOR TENGAH UTARA, NUSA TENGGARA TIMUR",4,136,10,146
https://kawalpemilu.org#55741,"TUBLOPO, BIKOMI SELATAN, TIMOR TENGAH UTARA, NUSA TENGGARA TIMUR",5,144,4,148
https://kawalpemilu.org#55742,"KIUSILI, BIKOMI SELATAN, TIMOR TENGAH UTARA, NUSA TENGGARA TIMUR",1,202,6,208
https://kawalpemilu.org#55742,"KIUSILI, BIKOMI SELATAN, TIMOR TENGAH UTARA, NUSA TENGGARA TIMUR",2,195,8,203
https://kawalpemilu.org#55743,"NAILOLA, BIKOMI SELATAN, TIMOR TENGAH UTARA, NUSA TENGGARA TIMUR",1,170,17,187
https://kawalpemilu.org#55743,"NAILOLA, BIKOMI SELATAN, TIMOR TENGAH UTARA, NUSA TENGGARA TIMUR",2,174,15,189
https://kawalpemilu.org#55743,"NAILOLA, BIKOMI SELATAN, TIMOR TENGAH UTARA, NUSA TENGGARA TIMUR",3,184,18,202
https://kawalpemilu.org#55743,"NAILOLA, BIKOMI SELATAN, TIMOR TENGAH UTARA, NUSA TENGGARA TIMUR",4,212,5,217
https://kawalpemilu.org#55743,"NAILOLA, BIKOMI SELATAN, TIMOR TENGAH UTARA, NUSA TENGGARA TIMUR",5,200,44,244
https://kawalpemilu.org#55744,"MAURISU, BIKOMI SELATAN, TIMOR TENGAH UTARA, NUSA TENGGARA TIMUR",1,114,6,120
https://kawalpemilu.org#55744,"MAURISU, BIKOMI SELATAN, TIMOR TENGAH UTARA, NUSA TENGGARA TIMUR",2,113,2,115
https://kawalpemilu.org#55745,"OETALUS, BIKOMI SELATAN, TIMOR TENGAH UTARA, NUSA TENGGARA TIMUR",1,195,15,210
https://kawalpemilu.org#55745,"OETALUS, BIKOMI SELATAN, TIMOR TENGAH UTARA, NUSA TENGGARA TIMUR",2,115,5,120
https://kawalpemilu.org#55746,"MAURISU UTARA, BIKOMI SELATAN, TIMOR TENGAH UTARA, NUSA TENGGARA TIMUR",1,116,4,120
https://kawalpemilu.org#55746,"MAURISU UTARA, BIKOMI SELATAN, TIMOR TENGAH UTARA, NUSA TENGGARA TIMUR",2,133,4,137
https://kawalpemilu.org#55747,"MAURISU SELATAN, BIKOMI SELATAN, TIMOR TENGAH UTARA, NUSA TENGGARA TIMUR",1,152,5,157
https://kawalpemilu.org#55747,"MAURISU SELATAN, BIKOMI SELATAN, TIMOR TENGAH UTARA, NUSA TENGGARA TIMUR",2,139,0,139
https://kawalpemilu.org#928464,"MAURISU TENGAH, BIKOMI SELATAN, TIMOR TENGAH UTARA, NUSA TENGGARA TIMUR",1,166,12,178
https://kawalpemilu.org#928465,"NAIOLA TIMUR, BIKOMI SELATAN, TIMOR TENGAH UTARA, NUSA TENGGARA TIMUR",1,163,22,185
https://kawalpemilu.org#928465,"NAIOLA TIMUR, BIKOMI SELATAN, TIMOR TENGAH UTARA, NUSA TENGGARA TIMUR",2,121,8,129
https://kawalpemilu.org#928465,"NAIOLA TIMUR, BIKOMI SELATAN, TIMOR TENGAH UTARA, NUSA TENGGARA TIMUR",3,130,37,167
https://kawalpemilu.org#55749,"BUK, BIKOMI TENGAH, TIMOR TENGAH UTARA, NUSA TENGGARA TIMUR",1,192,18,210
https://kawalpemilu.org#55750,"OENENU, BIKOMI TENGAH, TIMOR TENGAH UTARA, NUSA TENGGARA TIMUR",1,163,19,182
https://kawalpemilu.org#55750,"OENENU, BIKOMI TENGAH, TIMOR TENGAH UTARA, NUSA TENGGARA TIMUR",3,161,10,171
https://kawalpemilu.org#55751,"NIMASI, BIKOMI TENGAH, TIMOR TENGAH UTARA, NUSA TENGGARA TIMUR",1,136,19,155
https://kawalpemilu.org#55751,"NIMASI, BIKOMI TENGAH, TIMOR TENGAH UTARA, NUSA TENGGARA TIMUR",2,136,7,143
https://kawalpemilu.org#55751,"NIMASI, BIKOMI TENGAH, TIMOR TENGAH UTARA, NUSA TENGGARA TIMUR",3,158,2,160
https://kawalpemilu.org#55752,"OELBONAK, BIKOMI TENGAH, TIMOR TENGAH UTARA, NUSA TENGGARA TIMUR",1,172,3,175
https://kawalpemilu.org#55752,"OELBONAK, BIKOMI TENGAH, TIMOR TENGAH UTARA, NUSA TENGGARA TIMUR",2,136,3,139
https://kawalpemilu.org#55753,"KUANEK, BIKOMI TENGAH, TIMOR TENGAH UTARA, NUSA TENGGARA TIMUR",1,203,12,215
https://kawalpemilu.org#55753,"KUANEK, BIKOMI TENGAH, TIMOR TENGAH UTARA, NUSA TENGGARA TIMUR",2,68,3,71
https://kawalpemilu.org#55754,"OENINO, BIKOMI TENGAH, TIMOR TENGAH UTARA, NUSA TENGGARA TIMUR",1,135,13,148
https://kawalpemilu.org#55754,"OENINO, BIKOMI TENGAH, TIMOR TENGAH UTARA, NUSA TENGGARA TIMUR",2,175,14,189
https://kawalpemilu.org#55754,"OENINO, BIKOMI TENGAH, TIMOR TENGAH UTARA, NUSA TENGGARA TIMUR",3,148,18,166
https://kawalpemilu.org#55755,"OENENU UTARA, BIKOMI TENGAH, TIMOR TENGAH UTARA, NUSA TENGGARA TIMUR",2,192,8,200
https://kawalpemilu.org#55755,"OENENU UTARA, BIKOMI TENGAH, TIMOR TENGAH UTARA, NUSA TENGGARA TIMUR",3,178,14,192
https://kawalpemilu.org#55756,"OENENU SELATAN, BIKOMI TENGAH, TIMOR TENGAH UTARA, NUSA TENGGARA TIMUR",1,134,12,146
https://kawalpemilu.org#55756,"OENENU SELATAN, BIKOMI TENGAH, TIMOR TENGAH UTARA, NUSA TENGGARA TIMUR",2,138,4,142
https://kawalpemilu.org#55756,"OENENU SELATAN, BIKOMI TENGAH, TIMOR TENGAH UTARA, NUSA TENGGARA TIMUR",3,160,15,175
https://kawalpemilu.org#928466,"SONO, BIKOMI TENGAH, TIMOR TENGAH UTARA, NUSA TENGGARA TIMUR",1,167,5,172
https://kawalpemilu.org#928466,"SONO, BIKOMI TENGAH, TIMOR TENGAH UTARA, NUSA TENGGARA TIMUR",2,170,8,178
https://kawalpemilu.org#55758,"INBATE, BIKOMI NILULAT, TIMOR TENGAH UTARA, NUSA TENGGARA TIMUR",1,184,21,205
https://kawalpemilu.org#55758,"INBATE, BIKOMI NILULAT, TIMOR TENGAH UTARA, NUSA TENGGARA TIMUR",2,135,12,147
https://kawalpemilu.org#55758,"INBATE, BIKOMI NILULAT, TIMOR TENGAH UTARA, NUSA TENGGARA TIMUR",3,142,13,155
https://kawalpemilu.org#55758,"INBATE, BIKOMI NILULAT, TIMOR TENGAH UTARA, NUSA TENGGARA TIMUR",4,155,11,166
https://kawalpemilu.org#55759,"SUNKAEN, BIKOMI NILULAT, TIMOR TENGAH UTARA, NUSA TENGGARA TIMUR",1,134,5,139
https://kawalpemilu.org#55759,"SUNKAEN, BIKOMI NILULAT, TIMOR TENGAH UTARA, NUSA TENGGARA TIMUR",2,129,7,136
https://kawalpemilu.org#55760,"NAINABAN, BIKOMI NILULAT, TIMOR TENGAH UTARA, NUSA TENGGARA TIMUR",1,184,7,191
https://kawalpemilu.org#55760,"NAINABAN, BIKOMI NILULAT, TIMOR TENGAH UTARA, NUSA TENGGARA TIMUR",2,201,14,215
https://kawalpemilu.org#55761,"HAUMENI ANA, BIKOMI NILULAT, TIMOR TENGAH UTARA, NUSA TENGGARA TIMUR",1,196,13,209
https://kawalpemilu.org#55761,"HAUMENI ANA, BIKOMI NILULAT, TIMOR TENGAH UTARA, NUSA TENGGARA TIMUR",2,194,6,200
https://kawalpemilu.org#55761,"HAUMENI ANA, BIKOMI NILULAT, TIMOR TENGAH UTARA, NUSA TENGGARA TIMUR",3,141,16,157
https://kawalpemilu.org#55762,"NILULAT, BIKOMI NILULAT, TIMOR TENGAH UTARA, NUSA TENGGARA TIMUR",1,159,7,166
https://kawalpemilu.org#55762,"NILULAT, BIKOMI NILULAT, TIMOR TENGAH UTARA, NUSA TENGGARA TIMUR",2,124,6,130
https://kawalpemilu.org#55763,"TUBU, BIKOMI NILULAT, TIMOR TENGAH UTARA, NUSA TENGGARA TIMUR",1,172,6,178
https://kawalpemilu.org#55763,"TUBU, BIKOMI NILULAT, TIMOR TENGAH UTARA, NUSA TENGGARA TIMUR",2,147,5,152
https://kawalpemilu.org#55765,"FAENAKE, BIKOMI UTARA, TIMOR TENGAH UTARA, NUSA TENGGARA TIMUR",1,166,3,169
https://kawalpemilu.org#55765,"FAENAKE, BIKOMI UTARA, TIMOR TENGAH UTARA, NUSA TENGGARA TIMUR",2,145,14,159
https://kawalpemilu.org#55765,"FAENAKE, BIKOMI UTARA, TIMOR TENGAH UTARA, NUSA TENGGARA TIMUR",3,214,17,231
https://kawalpemilu.org#55766,"BANAIN A, BIKOMI UTARA, TIMOR TENGAH UTARA, NUSA TENGGARA TIMUR",1,202,28,230
https://kawalpemilu.org#55766,"BANAIN A, BIKOMI UTARA, TIMOR TENGAH UTARA, NUSA TENGGARA TIMUR",2,148,22,170
https://kawalpemilu.org#55767,"BANAIN B, BIKOMI UTARA, TIMOR TENGAH UTARA, NUSA TENGGARA TIMUR",1,100,18,118
https://kawalpemilu.org#55767,"BANAIN B, BIKOMI UTARA, TIMOR TENGAH UTARA, NUSA TENGGARA TIMUR",2,103,18,121
https://kawalpemilu.org#55768,"BANAIN C, BIKOMI UTARA, TIMOR TENGAH UTARA, NUSA TENGGARA TIMUR",1,107,23,130
https://kawalpemilu.org#55768,"BANAIN C, BIKOMI UTARA, TIMOR TENGAH UTARA, NUSA TENGGARA TIMUR",2,164,19,183
https://kawalpemilu.org#55769,"SAINONI, BIKOMI UTARA, TIMOR TENGAH UTARA, NUSA TENGGARA TIMUR",1,238,15,253
https://kawalpemilu.org#55769,"SAINONI, BIKOMI UTARA, TIMOR TENGAH UTARA, NUSA TENGGARA TIMUR",2,158,11,169
https://kawalpemilu.org#55770,"TES, BIKOMI UTARA, TIMOR TENGAH UTARA, NUSA TENGGARA TIMUR",1,138,15,153
https://kawalpemilu.org#55770,"TES, BIKOMI UTARA, TIMOR TENGAH UTARA, NUSA TENGGARA TIMUR",2,186,9,195
https://kawalpemilu.org#55771,"NAPAN, BIKOMI UTARA, TIMOR TENGAH UTARA, NUSA TENGGARA TIMUR",1,217,26,243
https://kawalpemilu.org#55771,"NAPAN, BIKOMI UTARA, TIMOR TENGAH UTARA, NUSA TENGGARA TIMUR",2,208,12,220
https://kawalpemilu.org#55771,"NAPAN, BIKOMI UTARA, TIMOR TENGAH UTARA, NUSA TENGGARA TIMUR",3,163,25,188
https://kawalpemilu.org#55772,"HAUMENI, BIKOMI UTARA, TIMOR TENGAH UTARA, NUSA TENGGARA TIMUR",1,208,12,220
https://kawalpemilu.org#55772,"HAUMENI, BIKOMI UTARA, TIMOR TENGAH UTARA, NUSA TENGGARA TIMUR",2,187,7,194
https://kawalpemilu.org#55773,"BAAS, BIKOMI UTARA, TIMOR TENGAH UTARA, NUSA TENGGARA TIMUR",1,116,2,118
https://kawalpemilu.org#55773,"BAAS, BIKOMI UTARA, TIMOR TENGAH UTARA, NUSA TENGGARA TIMUR",2,100,0,100
https://kawalpemilu.org#55775,"MANAMAS, NAIBENU, TIMOR TENGAH UTARA, NUSA TENGGARA TIMUR",1,216,2,218
https://kawalpemilu.org#55775,"MANAMAS, NAIBENU, TIMOR TENGAH UTARA, NUSA TENGGARA TIMUR",2,175,10,185
https://kawalpemilu.org#55775,"MANAMAS, NAIBENU, TIMOR TENGAH UTARA, NUSA TENGGARA TIMUR",3,187,5,192
https://kawalpemilu.org#55775,"MANAMAS, NAIBENU, TIMOR TENGAH UTARA, NUSA TENGGARA TIMUR",4,206,5,211
https://kawalpemilu.org#55776,"BENUS, NAIBENU, TIMOR TENGAH UTARA, NUSA TENGGARA TIMUR",1,144,3,147
https://kawalpemilu.org#55776,"BENUS, NAIBENU, TIMOR TENGAH UTARA, NUSA TENGGARA TIMUR",2,181,11,192
https://kawalpemilu.org#55776,"BENUS, NAIBENU, TIMOR TENGAH UTARA, NUSA TENGGARA TIMUR",3,152,9,161
https://kawalpemilu.org#55777,"BAKITOLAS, NAIBENU, TIMOR TENGAH UTARA, NUSA TENGGARA TIMUR",1,172,14,186
https://kawalpemilu.org#55777,"BAKITOLAS, NAIBENU, TIMOR TENGAH UTARA, NUSA TENGGARA TIMUR",2,206,9,215
https://kawalpemilu.org#55777,"BAKITOLAS, NAIBENU, TIMOR TENGAH UTARA, NUSA TENGGARA TIMUR",3,167,21,188
https://kawalpemilu.org#55777,"BAKITOLAS, NAIBENU, TIMOR TENGAH UTARA, NUSA TENGGARA TIMUR",4,203,10,213
https://kawalpemilu.org#55778,"SUNSEA, NAIBENU, TIMOR TENGAH UTARA, NUSA TENGGARA TIMUR",1,196,9,205
https://kawalpemilu.org#55778,"SUNSEA, NAIBENU, TIMOR TENGAH UTARA, NUSA TENGGARA TIMUR",2,179,3,182
https://kawalpemilu.org#55778,"SUNSEA, NAIBENU, TIMOR TENGAH UTARA, NUSA TENGGARA TIMUR",3,160,12,172
https://kawalpemilu.org#55778,"SUNSEA, NAIBENU, TIMOR TENGAH UTARA, NUSA TENGGARA TIMUR",4,169,9,178
https://kawalpemilu.org#55780,"FAFINESU A, INSANA FAFINESU, TIMOR TENGAH UTARA, NUSA TENGGARA TIMUR",1,205,13,218
https://kawalpemilu.org#55780,"FAFINESU A, INSANA FAFINESU, TIMOR TENGAH UTARA, NUSA TENGGARA TIMUR",2,216,10,226
https://kawalpemilu.org#55780,"FAFINESU A, INSANA FAFINESU, TIMOR TENGAH UTARA, NUSA TENGGARA TIMUR",3,193,4,201
https://kawalpemilu.org#55780,"FAFINESU A, INSANA FAFINESU, TIMOR TENGAH UTARA, NUSA TENGGARA TIMUR",4,191,14,205
https://kawalpemilu.org#55781,"FAFINESU B, INSANA FAFINESU, TIMOR TENGAH UTARA, NUSA TENGGARA TIMUR",1,204,8,212
https://kawalpemilu.org#55781,"FAFINESU B, INSANA FAFINESU, TIMOR TENGAH UTARA, NUSA TENGGARA TIMUR",2,198,10,208
https://kawalpemilu.org#55781,"FAFINESU B, INSANA FAFINESU, TIMOR TENGAH UTARA, NUSA TENGGARA TIMUR",3,180,5,185
https://kawalpemilu.org#55782,"FAFINESU C, INSANA FAFINESU, TIMOR TENGAH UTARA, NUSA TENGGARA TIMUR",1,163,12,175
https://kawalpemilu.org#55782,"FAFINESU C, INSANA FAFINESU, TIMOR TENGAH UTARA, NUSA TENGGARA TIMUR",2,161,11,172
https://kawalpemilu.org#55782,"FAFINESU C, INSANA FAFINESU, TIMOR TENGAH UTARA, NUSA TENGGARA TIMUR",3,179,2,181
https://kawalpemilu.org#55783,"OENAIN, INSANA FAFINESU, TIMOR TENGAH UTARA, NUSA TENGGARA TIMUR",1,115,10,125
https://kawalpemilu.org#55783,"OENAIN, INSANA FAFINESU, TIMOR TENGAH UTARA, NUSA TENGGARA TIMUR",2,105,12,117
https://kawalpemilu.org#55784,"BAUNUAN, INSANA FAFINESU, TIMOR TENGAH UTARA, NUSA TENGGARA TIMUR",1,168,8,176
https://kawalpemilu.org#55784,"BAUNUAN, INSANA FAFINESU, TIMOR TENGAH UTARA, NUSA TENGGARA TIMUR",2,184,2,186
https://kawalpemilu.org#55785,"FAFINESU, INSANA FAFINESU, TIMOR TENGAH UTARA, NUSA TENGGARA TIMUR",1,174,6,180
https://kawalpemilu.org#55785,"FAFINESU, INSANA FAFINESU, TIMOR TENGAH UTARA, NUSA TENGGARA TIMUR",2,166,7,173
https://kawalpemilu.org#55787,"ATMEN, INSANA BARAT, TIMOR TENGAH UTARA, NUSA TENGGARA TIMUR",1,163,10,173
https://kawalpemilu.org#55787,"ATMEN, INSANA BARAT, TIMOR TENGAH UTARA, NUSA TENGGARA TIMUR",2,157,5,162
https://kawalpemilu.org#55787,"ATMEN, INSANA BARAT, TIMOR TENGAH UTARA, NUSA TENGGARA TIMUR",3,135,3,138
https://kawalpemilu.org#55788,"SUBUN, INSANA BARAT, TIMOR TENGAH UTARA, NUSA TENGGARA TIMUR",1,154,14,168
https://kawalpemilu.org#55788,"SUBUN, INSANA BARAT, TIMOR TENGAH UTARA, NUSA TENGGARA TIMUR",2,171,9,180
https://kawalpemilu.org#55789,"USAPINONOT, INSANA BARAT, TIMOR TENGAH UTARA, NUSA TENGGARA TIMUR",1,206,7,213
https://kawalpemilu.org#55789,"USAPINONOT, INSANA BARAT, TIMOR TENGAH UTARA, NUSA TENGGARA TIMUR",2,181,7,188
https://kawalpemilu.org#55790,"LAPEOM, INSANA BARAT, TIMOR TENGAH UTARA, NUSA TENGGARA TIMUR",1,166,4,170
https://kawalpemilu.org#55790,"LAPEOM, INSANA BARAT, TIMOR TENGAH UTARA, NUSA TENGGARA TIMUR",2,198,4,202
https://kawalpemilu.org#55791,"LETNEO, INSANA BARAT, TIMOR TENGAH UTARA, NUSA TENGGARA TIMUR",1,182,17,199
https://kawalpemilu.org#55791,"LETNEO, INSANA BARAT, TIMOR TENGAH UTARA, NUSA TENGGARA TIMUR",2,170,17,187
https://kawalpemilu.org#55791,"LETNEO, INSANA BARAT, TIMOR TENGAH UTARA, NUSA TENGGARA TIMUR",3,160,35,195
https://kawalpemilu.org#55792,"BANNAE, INSANA BARAT, TIMOR TENGAH UTARA, NUSA TENGGARA TIMUR",1,162,6,168
https://kawalpemilu.org#55792,"BANNAE, INSANA BARAT, TIMOR TENGAH UTARA, NUSA TENGGARA TIMUR",2,122,17,139
https://kawalpemilu.org#55792,"BANNAE, INSANA BARAT, TIMOR TENGAH UTARA, NUSA TENGGARA TIMUR",3,190,20,210
https://kawalpemilu.org#55792,"BANNAE, INSANA BARAT, TIMOR TENGAH UTARA, NUSA TENGGARA TIMUR",4,148,5,153
https://kawalpemilu.org#55792,"BANNAE, INSANA BARAT, TIMOR TENGAH UTARA, NUSA TENGGARA TIMUR",5,165,1,166
https://kawalpemilu.org#55793,"UNINI, INSANA BARAT, TIMOR TENGAH UTARA, NUSA TENGGARA TIMUR",1,167,10,177
https://kawalpemilu.org#55793,"UNINI, INSANA BARAT, TIMOR TENGAH UTARA, NUSA TENGGARA TIMUR",2,142,8,150
https://kawalpemilu.org#55793,"UNINI, INSANA BARAT, TIMOR TENGAH UTARA, NUSA TENGGARA TIMUR",3,174,15,189
https://kawalpemilu.org#55793,"UNINI, INSANA BARAT, TIMOR TENGAH UTARA, NUSA TENGGARA TIMUR",4,173,29,202
https://kawalpemilu.org#928467,"LETNEO SELATAN, INSANA BARAT, TIMOR TENGAH UTARA, NUSA TENGGARA TIMUR",1,159,14,173
https://kawalpemilu.org#928467,"LETNEO SELATAN, INSANA BARAT, TIMOR TENGAH UTARA, NUSA TENGGARA TIMUR",2,142,29,171
https://kawalpemilu.org#928468,"OABIKASE, INSANA BARAT, TIMOR TENGAH UTARA, NUSA TENGGARA TIMUR",1,172,9,181
https://kawalpemilu.org#928469,"NIFUNENAS, INSANA BARAT, TIMOR TENGAH UTARA, NUSA TENGGARA TIMUR",1,129,12,141
https://kawalpemilu.org#928469,"NIFUNENAS, INSANA BARAT, TIMOR TENGAH UTARA, NUSA TENGGARA TIMUR",2,129,8,137
https://kawalpemilu.org#928470,"SUBUN BESTOBE, INSANA BARAT, TIMOR TENGAH UTARA, NUSA TENGGARA TIMUR",1,131,11,142
https://kawalpemilu.org#928470,"SUBUN BESTOBE, INSANA BARAT, TIMOR TENGAH UTARA, NUSA TENGGARA TIMUR",2,137,5,142
https://kawalpemilu.org#928471,"SUBUN TUALELE, INSANA BARAT, TIMOR TENGAH UTARA, NUSA TENGGARA TIMUR",1,140,9,149
https://kawalpemilu.org#928471,"SUBUN TUALELE, INSANA BARAT, TIMOR TENGAH UTARA, NUSA TENGGARA TIMUR",2,150,1,151
https://kawalpemilu.org#55795,"MAUBESI, INSANA TENGAH, TIMOR TENGAH UTARA, NUSA TENGGARA TIMUR",1,157,30,187
https://kawalpemilu.org#55795,"MAUBESI, INSANA TENGAH, TIMOR TENGAH UTARA, NUSA TENGGARA TIMUR",2,163,41,204
https://kawalpemilu.org#55795,"MAUBESI, INSANA TENGAH, TIMOR TENGAH UTARA, NUSA TENGGARA TIMUR",3,83,19,102
https://kawalpemilu.org#55795,"MAUBESI, INSANA TENGAH, TIMOR TENGAH UTARA, NUSA TENGGARA TIMUR",4,130,59,189
https://kawalpemilu.org#55795,"MAUBESI, INSANA TENGAH, TIMOR TENGAH UTARA, NUSA TENGGARA TIMUR",5,165,65,230
https://kawalpemilu.org#55795,"MAUBESI, INSANA TENGAH, TIMOR TENGAH UTARA, NUSA TENGGARA TIMUR",6,71,20,91
https://kawalpemilu.org#55795,"MAUBESI, INSANA TENGAH, TIMOR TENGAH UTARA, NUSA TENGGARA TIMUR",7,145,21,166
https://kawalpemilu.org#55795,"MAUBESI, INSANA TENGAH, TIMOR TENGAH UTARA, NUSA TENGGARA TIMUR",8,153,16,169
https://kawalpemilu.org#55795,"MAUBESI, INSANA TENGAH, TIMOR TENGAH UTARA, NUSA TENGGARA TIMUR",9,160,45,205
https://kawalpemilu.org#55795,"MAUBESI, INSANA TENGAH, TIMOR TENGAH UTARA, NUSA TENGGARA TIMUR",10,142,45,187
https://kawalpemilu.org#55795,"MAUBESI, INSANA TENGAH, TIMOR TENGAH UTARA, NUSA TENGGARA TIMUR",11,111,21,132
https://kawalpemilu.org#55796,"LANAUS, INSANA TENGAH, TIMOR TENGAH UTARA, NUSA TENGGARA TIMUR",1,204,14,218
https://kawalpemilu.org#55796,"LANAUS, INSANA TENGAH, TIMOR TENGAH UTARA, NUSA TENGGARA TIMUR",2,210,7,217
https://kawalpemilu.org#55796,"LANAUS, INSANA TENGAH, TIMOR TENGAH UTARA, NUSA TENGGARA TIMUR",3,202,7,209
https://kawalpemilu.org#55796,"LANAUS, INSANA TENGAH, TIMOR TENGAH UTARA, NUSA TENGGARA TIMUR",4,176,1,177
https://kawalpemilu.org#55797,"LETMAFO, INSANA TENGAH, TIMOR TENGAH UTARA, NUSA TENGGARA TIMUR",1,191,37,228
https://kawalpemilu.org#55797,"LETMAFO, INSANA TENGAH, TIMOR TENGAH UTARA, NUSA TENGGARA TIMUR",2,181,33,214
https://kawalpemilu.org#55797,"LETMAFO, INSANA TENGAH, TIMOR TENGAH UTARA, NUSA TENGGARA TIMUR",3,165,44,209
https://kawalpemilu.org#55797,"LETMAFO, INSANA TENGAH, TIMOR TENGAH UTARA, NUSA TENGGARA TIMUR",4,144,57,201
https://kawalpemilu.org#55797,"LETMAFO, INSANA TENGAH, TIMOR TENGAH UTARA, NUSA TENGGARA TIMUR",5,162,49,211
https://kawalpemilu.org#55798,"TAINSALA, INSANA TENGAH, TIMOR TENGAH UTARA, NUSA TENGGARA TIMUR",1,190,1,191
https://kawalpemilu.org#55798,"TAINSALA, INSANA TENGAH, TIMOR TENGAH UTARA, NUSA TENGGARA TIMUR",2,199,6,205
https://kawalpemilu.org#55798,"TAINSALA, INSANA TENGAH, TIMOR TENGAH UTARA, NUSA TENGGARA TIMUR",3,205,0,205
https://kawalpemilu.org#55798,"TAINSALA, INSANA TENGAH, TIMOR TENGAH UTARA, NUSA TENGGARA TIMUR",4,239,6,245
https://kawalpemilu.org#55798,"TAINSALA, INSANA TENGAH, TIMOR TENGAH UTARA, NUSA TENGGARA TIMUR",5,155,5,160
https://kawalpemilu.org#55799,"SONE, INSANA TENGAH, TIMOR TENGAH UTARA, NUSA TENGGARA TIMUR",1,144,34,178
https://kawalpemilu.org#55799,"SONE, INSANA TENGAH, TIMOR TENGAH UTARA, NUSA TENGGARA TIMUR",2,167,13,180
https://kawalpemilu.org#928472,"LETMAFO TIMUR, INSANA TENGAH, TIMOR TENGAH UTARA, NUSA TENGGARA TIMUR",1,213,17,230
https://kawalpemilu.org#928472,"LETMAFO TIMUR, INSANA TENGAH, TIMOR TENGAH UTARA, NUSA TENGGARA TIMUR",2,180,24,204
https://kawalpemilu.org#928473,"OEHALO, INSANA TENGAH, TIMOR TENGAH UTARA, NUSA TENGGARA TIMUR",1,164,6,170
https://kawalpemilu.org#55801,"TEBA, BIBOKI TAN PAH, TIMOR TENGAH UTARA, NUSA TENGGARA TIMUR",1,181,21,202
https://kawalpemilu.org#55801,"TEBA, BIBOKI TAN PAH, TIMOR TENGAH UTARA, NUSA TENGGARA TIMUR",2,167,22,189
https://kawalpemilu.org#55801,"TEBA, BIBOKI TAN PAH, TIMOR TENGAH UTARA, NUSA TENGGARA TIMUR",3,170,15,185
https://kawalpemilu.org#55802,"OERINBESI, BIBOKI TAN PAH, TIMOR TENGAH UTARA, NUSA TENGGARA TIMUR",1,215,3,218
https://kawalpemilu.org#55802,"OERINBESI, BIBOKI TAN PAH, TIMOR TENGAH UTARA, NUSA TENGGARA TIMUR",2,216,8,224
https://kawalpemilu.org#55802,"OERINBESI, BIBOKI TAN PAH, TIMOR TENGAH UTARA, NUSA TENGGARA TIMUR",3,201,2,203
https://kawalpemilu.org#55803,"OEKOPA, BIBOKI TAN PAH, TIMOR TENGAH UTARA, NUSA TENGGARA TIMUR",1,133,16,149
https://kawalpemilu.org#55803,"OEKOPA, BIBOKI TAN PAH, TIMOR TENGAH UTARA, NUSA TENGGARA TIMUR",2,156,41,197
https://kawalpemilu.org#55803,"OEKOPA, BIBOKI TAN PAH, TIMOR TENGAH UTARA, NUSA TENGGARA TIMUR",3,130,37,167
https://kawalpemilu.org#55803,"OEKOPA, BIBOKI TAN PAH, TIMOR TENGAH UTARA, NUSA TENGGARA TIMUR",4,144,20,164
https://kawalpemilu.org#55803,"OEKOPA, BIBOKI TAN PAH, TIMOR TENGAH UTARA, NUSA TENGGARA TIMUR",5,197,26,223
https://kawalpemilu.org#55804,"T'EBA TIMUR, BIBOKI TAN PAH, TIMOR TENGAH UTARA, NUSA TENGGARA TIMUR",1,206,11,217
https://kawalpemilu.org#55804,"T'EBA TIMUR, BIBOKI TAN PAH, TIMOR TENGAH UTARA, NUSA TENGGARA TIMUR",2,170,10,180
https://kawalpemilu.org#55804,"T'EBA TIMUR, BIBOKI TAN PAH, TIMOR TENGAH UTARA, NUSA TENGGARA TIMUR",3,185,15,200
https://kawalpemilu.org#55804,"T'EBA TIMUR, BIBOKI TAN PAH, TIMOR TENGAH UTARA, NUSA TENGGARA TIMUR",4,162,20,182
https://kawalpemilu.org#55806,"TUNBES, BIBOKI MOENLEU, TIMOR TENGAH UTARA, NUSA TENGGARA TIMUR",1,146,1,147
https://kawalpemilu.org#55806,"TUNBES, BIBOKI MOENLEU, TIMOR TENGAH UTARA, NUSA TENGGARA TIMUR",2,103,4,107
https://kawalpemilu.org#55807,"LUNIUP, BIBOKI MOENLEU, TIMOR TENGAH UTARA, NUSA TENGGARA TIMUR",1,159,9,168
https://kawalpemilu.org#55807,"LUNIUP, BIBOKI MOENLEU, TIMOR TENGAH UTARA, NUSA TENGGARA TIMUR",2,167,9,176
https://kawalpemilu.org#55807,"LUNIUP, BIBOKI MOENLEU, TIMOR TENGAH UTARA, NUSA TENGGARA TIMUR",3,162,11,173
https://kawalpemilu.org#55808,"MATABESI, BIBOKI MOENLEU, TIMOR TENGAH UTARA, NUSA TENGGARA TIMUR",1,182,11,193
https://kawalpemilu.org#55809,"OEPUAH, BIBOKI MOENLEU, TIMOR TENGAH UTARA, NUSA TENGGARA TIMUR",1,183,24,207
https://kawalpemilu.org#55809,"OEPUAH, BIBOKI MOENLEU, TIMOR TENGAH UTARA, NUSA TENGGARA TIMUR",2,211,12,223
https://kawalpemilu.org#55809,"OEPUAH, BIBOKI MOENLEU, TIMOR TENGAH UTARA, NUSA TENGGARA TIMUR",3,129,9,138
https://kawalpemilu.org#55809,"OEPUAH, BIBOKI MOENLEU, TIMOR TENGAH UTARA, NUSA TENGGARA TIMUR",4,179,25,204
https://kawalpemilu.org#55809,"OEPUAH, BIBOKI MOENLEU, TIMOR TENGAH UTARA, NUSA TENGGARA TIMUR",5,216,9,225
https://kawalpemilu.org#55810,"KAUBELE, BIBOKI MOENLEU, TIMOR TENGAH UTARA, NUSA TENGGARA TIMUR",1,157,12,169
https://kawalpemilu.org#55810,"KAUBELE, BIBOKI MOENLEU, TIMOR TENGAH UTARA, NUSA TENGGARA TIMUR",2,160,13,173
https://kawalpemilu.org#55810,"KAUBELE, BIBOKI MOENLEU, TIMOR TENGAH UTARA, NUSA TENGGARA TIMUR",3,168,27,195
https://kawalpemilu.org#55811,"OEPUAH UTARA, BIBOKI MOENLEU, TIMOR TENGAH UTARA, NUSA TENGGARA TIMUR",1,230,6,236
https://kawalpemilu.org#55811,"OEPUAH UTARA, BIBOKI MOENLEU, TIMOR TENGAH UTARA, NUSA TENGGARA TIMUR",2,235,6,241
https://kawalpemilu.org#55811,"OEPUAH UTARA, BIBOKI MOENLEU, TIMOR TENGAH UTARA, NUSA TENGGARA TIMUR",3,217,7,224
https://kawalpemilu.org#55811,"OEPUAH UTARA, BIBOKI MOENLEU, TIMOR TENGAH UTARA, NUSA TENGGARA TIMUR",4,209,16,225
https://kawalpemilu.org#55812,"OEPUAH SELATAN, BIBOKI MOENLEU, TIMOR TENGAH UTARA, NUSA TENGGARA TIMUR",1,177,18,195
https://kawalpemilu.org#55812,"OEPUAH SELATAN, BIBOKI MOENLEU, TIMOR TENGAH UTARA, NUSA TENGGARA TIMUR",2,144,57,201
https://kawalpemilu.org#55812,"OEPUAH SELATAN, BIBOKI MOENLEU, TIMOR TENGAH UTARA, NUSA TENGGARA TIMUR",3,195,17,212
https://kawalpemilu.org#55814,"NAKU, BIBOKI FEOTLEU, TIMOR TENGAH UTARA, NUSA TENGGARA TIMUR",1,197,27,224
https://kawalpemilu.org#55814,"NAKU, BIBOKI FEOTLEU, TIMOR TENGAH UTARA, NUSA TENGGARA TIMUR",2,209,11,220
https://kawalpemilu.org#55814,"NAKU, BIBOKI FEOTLEU, TIMOR TENGAH UTARA, NUSA TENGGARA TIMUR",3,105,1,106
https://kawalpemilu.org#55815,"BIRUNATUN, BIBOKI FEOTLEU, TIMOR TENGAH UTARA, NUSA TENGGARA TIMUR",1,205,12,217
https://kawalpemilu.org#55815,"BIRUNATUN, BIBOKI FEOTLEU, TIMOR TENGAH UTARA, NUSA TENGGARA TIMUR",2,169,10,179
https://kawalpemilu.org#55816,"MAKUN, BIBOKI FEOTLEU, TIMOR TENGAH UTARA, NUSA TENGGARA TIMUR",1,209,10,219
https://kawalpemilu.org#55816,"MAKUN, BIBOKI FEOTLEU, TIMOR TENGAH UTARA, NUSA TENGGARA TIMUR",2,215,6,221
https://kawalpemilu.org#55816,"MAKUN, BIBOKI FEOTLEU, TIMOR TENGAH UTARA, NUSA TENGGARA TIMUR",3,42,1,43
https://kawalpemilu.org#55817,"MANUMEAN, BIBOKI FEOTLEU, TIMOR TENGAH UTARA, NUSA TENGGARA TIMUR",1,147,5,152
https://kawalpemilu.org#55817,"MANUMEAN, BIBOKI FEOTLEU, TIMOR TENGAH UTARA, NUSA TENGGARA TIMUR",2,131,1,132
https://kawalpemilu.org#55818,"KULUAN, BIBOKI FEOTLEU, TIMOR TENGAH UTARA, NUSA TENGGARA TIMUR",1,231,6,237
https://kawalpemilu.org#55818,"KULUAN, BIBOKI FEOTLEU, TIMOR TENGAH UTARA, NUSA TENGGARA TIMUR",2,188,6,194
https://kawalpemilu.org#55821,"KEWAR, LAMAKNEN, BELU, NUSA TENGGARA TIMUR",1,213,6,219
https://kawalpemilu.org#55821,"KEWAR, LAMAKNEN, BELU, NUSA TENGGARA TIMUR",2,125,2,127
https://kawalpemilu.org#55821,"KEWAR, LAMAKNEN, BELU, NUSA TENGGARA TIMUR",3,114,3,117
https://kawalpemilu.org#55821,"KEWAR, LAMAKNEN, BELU, NUSA TENGGARA TIMUR",4,124,17,141
https://kawalpemilu.org#55821,"KEWAR, LAMAKNEN, BELU, NUSA TENGGARA TIMUR",5,135,8,143
https://kawalpemilu.org#55822,"FULUR, LAMAKNEN, BELU, NUSA TENGGARA TIMUR",1,146,2,148
https://kawalpemilu.org#55822,"FULUR, LAMAKNEN, BELU, NUSA TENGGARA TIMUR",2,140,11,151
https://kawalpemilu.org#55822,"FULUR, LAMAKNEN, BELU, NUSA TENGGARA TIMUR",3,187,7,194
https://kawalpemilu.org#55822,"FULUR, LAMAKNEN, BELU, NUSA TENGGARA TIMUR",4,152,3,155
https://kawalpemilu.org#55822,"FULUR, LAMAKNEN, BELU, NUSA TENGGARA TIMUR",5,140,4,144
https://kawalpemilu.org#55822,"FULUR, LAMAKNEN, BELU, NUSA TENGGARA TIMUR",6,194,4,198
https://kawalpemilu.org#55823,"DUARATO, LAMAKNEN, BELU, NUSA TENGGARA TIMUR",1,121,11,132
https://kawalpemilu.org#55823,"DUARATO, LAMAKNEN, BELU, NUSA TENGGARA TIMUR",2,116,4,120
https://kawalpemilu.org#55824,"MAKIR, LAMAKNEN, BELU, NUSA TENGGARA TIMUR",1,143,17,160
https://kawalpemilu.org#55824,"MAKIR, LAMAKNEN, BELU, NUSA TENGGARA TIMUR",2,118,19,137
https://kawalpemilu.org#55824,"MAKIR, LAMAKNEN, BELU, NUSA TENGGARA TIMUR",3,165,32,197
https://kawalpemilu.org#55824,"MAKIR, LAMAKNEN, BELU, NUSA TENGGARA TIMUR",4,189,40,229
https://kawalpemilu.org#55824,"MAKIR, LAMAKNEN, BELU, NUSA TENGGARA TIMUR",5,137,29,166
https://kawalpemilu.org#55825,"LAMAKSENULU, LAMAKNEN, BELU, NUSA TENGGARA TIMUR",2,144,36,180
https://kawalpemilu.org#55825,"LAMAKSENULU, LAMAKNEN, BELU, NUSA TENGGARA TIMUR",3,138,22,160
https://kawalpemilu.org#55825,"LAMAKSENULU, LAMAKNEN, BELU, NUSA TENGGARA TIMUR",4,150,63,213
https://kawalpemilu.org#55826,"DIRUN, LAMAKNEN, BELU, NUSA TENGGARA TIMUR",1,182,9,191
https://kawalpemilu.org#55826,"DIRUN, LAMAKNEN, BELU, NUSA TENGGARA TIMUR",2,104,15,119
https://kawalpemilu.org#55826,"DIRUN, LAMAKNEN, BELU, NUSA TENGGARA TIMUR",3,136,14,150
https://kawalpemilu.org#55826,"DIRUN, LAMAKNEN, BELU, NUSA TENGGARA TIMUR",4,130,5,135
https://kawalpemilu.org#55826,"DIRUN, LAMAKNEN, BELU, NUSA TENGGARA TIMUR",5,183,10,193
https://kawalpemilu.org#55826,"DIRUN, LAMAKNEN, BELU, NUSA TENGGARA TIMUR",6,232,9,241
https://kawalpemilu.org#55826,"DIRUN, LAMAKNEN, BELU, NUSA TENGGARA TIMUR",7,135,31,166
https://kawalpemilu.org#55827,"LEOWALU, LAMAKNEN, BELU, NUSA TENGGARA TIMUR",1,121,11,132
https://kawalpemilu.org#55827,"LEOWALU, LAMAKNEN, BELU, NUSA TENGGARA TIMUR",2,82,3,85
https://kawalpemilu.org#55827,"LEOWALU, LAMAKNEN, BELU, NUSA TENGGARA TIMUR",3,131,9,140
https://kawalpemilu.org#55828,"MAUDEMU, LAMAKNEN, BELU, NUSA TENGGARA TIMUR",1,128,11,139
https://kawalpemilu.org#55828,"MAUDEMU, LAMAKNEN, BELU, NUSA TENGGARA TIMUR",2,167,12,179
https://kawalpemilu.org#55828,"MAUDEMU, LAMAKNEN, BELU, NUSA TENGGARA TIMUR",3,142,8,150
https://kawalpemilu.org#55828,"MAUDEMU, LAMAKNEN, BELU, NUSA TENGGARA TIMUR",4,124,5,129
https://kawalpemilu.org#55828,"MAUDEMU, LAMAKNEN, BELU, NUSA TENGGARA TIMUR",5,116,0,116
https://kawalpemilu.org#55829,"MAHUITAS, LAMAKNEN, BELU, NUSA TENGGARA TIMUR",1,148,6,154
https://kawalpemilu.org#55829,"MAHUITAS, LAMAKNEN, BELU, NUSA TENGGARA TIMUR",2,125,2,127
https://kawalpemilu.org#55831,"SILAWAN, TASIFETOTIMUR, BELU, NUSA TENGGARA TIMUR",1,209,7,216
https://kawalpemilu.org#55831,"SILAWAN, TASIFETOTIMUR, BELU, NUSA TENGGARA TIMUR",2,170,4,174
https://kawalpemilu.org#55831,"SILAWAN, TASIFETOTIMUR, BELU, NUSA TENGGARA TIMUR",3,194,6,200
https://kawalpemilu.org#55831,"SILAWAN, TASIFETOTIMUR, BELU, NUSA TENGGARA TIMUR",4,177,18,195
https://kawalpemilu.org#55831,"SILAWAN, TASIFETOTIMUR, BELU, NUSA TENGGARA TIMUR",5,143,16,159
https://kawalpemilu.org#55831,"SILAWAN, TASIFETOTIMUR, BELU, NUSA TENGGARA TIMUR",6,159,25,184
https://kawalpemilu.org#55831,"SILAWAN, TASIFETOTIMUR, BELU, NUSA TENGGARA TIMUR",7,140,22,162
https://kawalpemilu.org#55831,"SILAWAN, TASIFETOTIMUR, BELU, NUSA TENGGARA TIMUR",8,94,19,113
https://kawalpemilu.org#55831,"SILAWAN, TASIFETOTIMUR, BELU, NUSA TENGGARA TIMUR",9,140,15,155
https://kawalpemilu.org#55831,"SILAWAN, TASIFETOTIMUR, BELU, NUSA TENGGARA TIMUR",10,184,8,192
https://kawalpemilu.org#55831,"SILAWAN, TASIFETOTIMUR, BELU, NUSA TENGGARA TIMUR",11,130,4,134
https://kawalpemilu.org#55832,"TULAKADI, TASIFETOTIMUR, BELU, NUSA TENGGARA TIMUR",1,170,20,190
https://kawalpemilu.org#55832,"TULAKADI, TASIFETOTIMUR, BELU, NUSA TENGGARA TIMUR",2,118,17,135
https://kawalpemilu.org#55832,"TULAKADI, TASIFETOTIMUR, BELU, NUSA TENGGARA TIMUR",3,129,7,136
https://kawalpemilu.org#55832,"TULAKADI, TASIFETOTIMUR, BELU, NUSA TENGGARA TIMUR",4,96,12,108
https://kawalpemilu.org#55833,"SADI, TASIFETOTIMUR, BELU, NUSA TENGGARA TIMUR",1,137,11,148
https://kawalpemilu.org#55833,"SADI, TASIFETOTIMUR, BELU, NUSA TENGGARA TIMUR",2,140,19,159
https://kawalpemilu.org#55833,"SADI, TASIFETOTIMUR, BELU, NUSA TENGGARA TIMUR",3,118,20,138
https://kawalpemilu.org#55833,"SADI, TASIFETOTIMUR, BELU, NUSA TENGGARA TIMUR",4,127,6,133
https://kawalpemilu.org#55833,"SADI, TASIFETOTIMUR, BELU, NUSA TENGGARA TIMUR",5,133,13,146
https://kawalpemilu.org#55834,"UMAKLARAN, TASIFETOTIMUR, BELU, NUSA TENGGARA TIMUR",1,175,23,198
https://kawalpemilu.org#55834,"UMAKLARAN, TASIFETOTIMUR, BELU, NUSA TENGGARA TIMUR",2,181,31,212
https://kawalpemilu.org#55834,"UMAKLARAN, TASIFETOTIMUR, BELU, NUSA TENGGARA TIMUR",3,109,15,124
https://kawalpemilu.org#55834,"UMAKLARAN, TASIFETOTIMUR, BELU, NUSA TENGGARA TIMUR",4,110,8,118
https://kawalpemilu.org#55834,"UMAKLARAN, TASIFETOTIMUR, BELU, NUSA TENGGARA TIMUR",5,71,81,152
https://kawalpemilu.org#55834,"UMAKLARAN, TASIFETOTIMUR, BELU, NUSA TENGGARA TIMUR",6,148,16,164
https://kawalpemilu.org#55835,"MANLETEN, TASIFETOTIMUR, BELU, NUSA TENGGARA TIMUR",1,157,8,165
https://kawalpemilu.org#55835,"MANLETEN, TASIFETOTIMUR, BELU, NUSA TENGGARA TIMUR",2,165,1,166
https://kawalpemilu.org#55835,"MANLETEN, TASIFETOTIMUR, BELU, NUSA TENGGARA TIMUR",3,209,11,220
https://kawalpemilu.org#55835,"MANLETEN, TASIFETOTIMUR, BELU, NUSA TENGGARA TIMUR",4,187,14,201
https://kawalpemilu.org#55835,"MANLETEN, TASIFETOTIMUR, BELU, NUSA TENGGARA TIMUR",5,196,4,200
https://kawalpemilu.org#55835,"MANLETEN, TASIFETOTIMUR, BELU, NUSA TENGGARA TIMUR",6,68,3,71
https://kawalpemilu.org#55835,"MANLETEN, TASIFETOTIMUR, BELU, NUSA TENGGARA TIMUR",7,85,87,172
https://kawalpemilu.org#55835,"MANLETEN, TASIFETOTIMUR, BELU, NUSA TENGGARA TIMUR",8,69,91,160
https://kawalpemilu.org#55835,"MANLETEN, TASIFETOTIMUR, BELU, NUSA TENGGARA TIMUR",9,111,95,206
https://kawalpemilu.org#55835,"MANLETEN, TASIFETOTIMUR, BELU, NUSA TENGGARA TIMUR",10,195,14,209
https://kawalpemilu.org#55835,"MANLETEN, TASIFETOTIMUR, BELU, NUSA TENGGARA TIMUR",11,87,41,128
https://kawalpemilu.org#55835,"MANLETEN, TASIFETOTIMUR, BELU, NUSA TENGGARA TIMUR",12,116,50,166
https://kawalpemilu.org#55835,"MANLETEN, TASIFETOTIMUR, BELU, NUSA TENGGARA TIMUR",13,94,90,184
https://kawalpemilu.org#55835,"MANLETEN, TASIFETOTIMUR, BELU, NUSA TENGGARA TIMUR",14,33,49,82
https://kawalpemilu.org#55835,"MANLETEN, TASIFETOTIMUR, BELU, NUSA TENGGARA TIMUR",15,63,101,164
https://kawalpemilu.org#55835,"MANLETEN, TASIFETOTIMUR, BELU, NUSA TENGGARA TIMUR",16,72,114,186
https://kawalpemilu.org#55835,"MANLETEN, TASIFETOTIMUR, BELU, NUSA TENGGARA TIMUR",17,166,43,209
https://kawalpemilu.org#55835,"MANLETEN, TASIFETOTIMUR, BELU, NUSA TENGGARA TIMUR",18,58,42,100
https://kawalpemilu.org#55835,"MANLETEN, TASIFETOTIMUR, BELU, NUSA TENGGARA TIMUR",19,172,31,203
https://kawalpemilu.org#55835,"MANLETEN, TASIFETOTIMUR, BELU, NUSA TENGGARA TIMUR",20,134,51,185
https://kawalpemilu.org#55835,"MANLETEN, TASIFETOTIMUR, BELU, NUSA TENGGARA TIMUR",21,104,14,118
https://kawalpemilu.org#55835,"MANLETEN, TASIFETOTIMUR, BELU, NUSA TENGGARA TIMUR",22,98,69,167
https://kawalpemilu.org#55836,"FATUBA'A, TASIFETOTIMUR, BELU, NUSA TENGGARA TIMUR",1,171,5,176
https://kawalpemilu.org#55836,"FATUBA'A, TASIFETOTIMUR, BELU, NUSA TENGGARA TIMUR",2,70,99,169
https://kawalpemilu.org#55836,"FATUBA'A, TASIFETOTIMUR, BELU, NUSA TENGGARA TIMUR",3,140,8,148
https://kawalpemilu.org#55836,"FATUBA'A, TASIFETOTIMUR, BELU, NUSA TENGGARA TIMUR",4,116,5,121
https://kawalpemilu.org#55836,"FATUBA'A, TASIFETOTIMUR, BELU, NUSA TENGGARA TIMUR",5,75,36,111
https://kawalpemilu.org#55837,"DAFALA, TASIFETOTIMUR, BELU, NUSA TENGGARA TIMUR",1,127,5,132
https://kawalpemilu.org#55837,"DAFALA, TASIFETOTIMUR, BELU, NUSA TENGGARA TIMUR",2,164,1,165
https://kawalpemilu.org#55837,"DAFALA, TASIFETOTIMUR, BELU, NUSA TENGGARA TIMUR",3,164,5,169
https://kawalpemilu.org#55837,"DAFALA, TASIFETOTIMUR, BELU, NUSA TENGGARA TIMUR",4,146,0,146
https://kawalpemilu.org#55837,"DAFALA, TASIFETOTIMUR, BELU, NUSA TENGGARA TIMUR",5,101,10,111
https://kawalpemilu.org#55837,"DAFALA, TASIFETOTIMUR, BELU, NUSA TENGGARA TIMUR",6,120,1,121
https://kawalpemilu.org#55838,"TAKIRIN, TASIFETOTIMUR, BELU, NUSA TENGGARA TIMUR",1,172,12,184
https://kawalpemilu.org#55838,"TAKIRIN, TASIFETOTIMUR, BELU, NUSA TENGGARA TIMUR",2,173,4,177
https://kawalpemilu.org#55838,"TAKIRIN, TASIFETOTIMUR, BELU, NUSA TENGGARA TIMUR",3,120,5,125
https://kawalpemilu.org#55839,"BAUHO, TASIFETOTIMUR, BELU, NUSA TENGGARA TIMUR",1,175,17,192
https://kawalpemilu.org#55839,"BAUHO, TASIFETOTIMUR, BELU, NUSA TENGGARA TIMUR",2,170,15,185
https://kawalpemilu.org#55840,"SARABAU, TASIFETOTIMUR, BELU, NUSA TENGGARA TIMUR",1,196,9,205
https://kawalpemilu.org#55840,"SARABAU, TASIFETOTIMUR, BELU, NUSA TENGGARA TIMUR",2,154,8,162
https://kawalpemilu.org#55841,"TIALAI, TASIFETOTIMUR, BELU, NUSA TENGGARA TIMUR",1,193,32,225
https://kawalpemilu.org#55841,"TIALAI, TASIFETOTIMUR, BELU, NUSA TENGGARA TIMUR",2,149,31,180
https://kawalpemilu.org#55842,"HALIMODOK, TASIFETOTIMUR, BELU, NUSA TENGGARA TIMUR",1,124,2,126
https://kawalpemilu.org#55842,"HALIMODOK, TASIFETOTIMUR, BELU, NUSA TENGGARA TIMUR",2,144,3,147
https://kawalpemilu.org#55842,"HALIMODOK, TASIFETOTIMUR, BELU, NUSA TENGGARA TIMUR",3,180,7,187
https://kawalpemilu.org#55842,"HALIMODOK, TASIFETOTIMUR, BELU, NUSA TENGGARA TIMUR",4,135,2,137
https://kawalpemilu.org#55844,"ASUMANU, RAIHAT, BELU, NUSA TENGGARA TIMUR",1,119,2,121
https://kawalpemilu.org#55844,"ASUMANU, RAIHAT, BELU, NUSA TENGGARA TIMUR",2,116,0,116
https://kawalpemilu.org#55844,"ASUMANU, RAIHAT, BELU, NUSA TENGGARA TIMUR",3,105,2,107
https://kawalpemilu.org#55844,"ASUMANU, RAIHAT, BELU, NUSA TENGGARA TIMUR",4,122,3,125
https://kawalpemilu.org#55844,"ASUMANU, RAIHAT, BELU, NUSA TENGGARA TIMUR",5,111,8,119
https://kawalpemilu.org#55844,"ASUMANU, RAIHAT, BELU, NUSA TENGGARA TIMUR",6,61,2,63
https://kawalpemilu.org#55844,"ASUMANU, RAIHAT, BELU, NUSA TENGGARA TIMUR",7,118,8,126
https://kawalpemilu.org#55844,"ASUMANU, RAIHAT, BELU, NUSA TENGGARA TIMUR",8,129,10,139
https://kawalpemilu.org#55845,"TOHE, RAIHAT, BELU, NUSA TENGGARA TIMUR",1,108,9,117
https://kawalpemilu.org#55845,"TOHE, RAIHAT, BELU, NUSA TENGGARA TIMUR",2,135,30,165
https://kawalpemilu.org#55845,"TOHE, RAIHAT, BELU, NUSA TENGGARA TIMUR",3,121,39,160
https://kawalpemilu.org#55845,"TOHE, RAIHAT, BELU, NUSA TENGGARA TIMUR",4,90,61,151
https://kawalpemilu.org#55845,"TOHE, RAIHAT, BELU, NUSA TENGGARA TIMUR",5,108,48,156
https://kawalpemilu.org#55845,"TOHE, RAIHAT, BELU, NUSA TENGGARA TIMUR",6,86,40,126
https://kawalpemilu.org#55845,"TOHE, RAIHAT, BELU, NUSA TENGGARA TIMUR",8,92,71,163
https://kawalpemilu.org#55845,"TOHE, RAIHAT, BELU, NUSA TENGGARA TIMUR",9,42,152,194
https://kawalpemilu.org#55845,"TOHE, RAIHAT, BELU, NUSA TENGGARA TIMUR",10,43,119,162
https://kawalpemilu.org#55845,"TOHE, RAIHAT, BELU, NUSA TENGGARA TIMUR",11,61,150,211
https://kawalpemilu.org#55845,"TOHE, RAIHAT, BELU, NUSA TENGGARA TIMUR",12,44,116,160
https://kawalpemilu.org#55845,"TOHE, RAIHAT, BELU, NUSA TENGGARA TIMUR",13,66,177,243
https://kawalpemilu.org#55845,"TOHE, RAIHAT, BELU, NUSA TENGGARA TIMUR",14,51,122,173
https://kawalpemilu.org#55845,"TOHE, RAIHAT, BELU, NUSA TENGGARA TIMUR",15,74,90,164
https://kawalpemilu.org#55846,"MAUMUTIN, RAIHAT, BELU, NUSA TENGGARA TIMUR",1,125,33,158
https://kawalpemilu.org#55846,"MAUMUTIN, RAIHAT, BELU, NUSA TENGGARA TIMUR",2,98,46,144
https://kawalpemilu.org#55846,"MAUMUTIN, RAIHAT, BELU, NUSA TENGGARA TIMUR",3,112,52,164
https://kawalpemilu.org#55846,"MAUMUTIN, RAIHAT, BELU, NUSA TENGGARA TIMUR",4,115,71,186
https://kawalpemilu.org#55846,"MAUMUTIN, RAIHAT, BELU, NUSA TENGGARA TIMUR",5,58,27,85
https://kawalpemilu.org#55846,"MAUMUTIN, RAIHAT, BELU, NUSA TENGGARA TIMUR",6,79,48,127
https://kawalpemilu.org#55846,"MAUMUTIN, RAIHAT, BELU, NUSA TENGGARA TIMUR",7,38,34,72
https://kawalpemilu.org#55846,"MAUMUTIN, RAIHAT, BELU, NUSA TENGGARA TIMUR",8,93,47,140
https://kawalpemilu.org#55846,"MAUMUTIN, RAIHAT, BELU, NUSA TENGGARA TIMUR",9,31,113,144
https://kawalpemilu.org#55846,"MAUMUTIN, RAIHAT, BELU, NUSA TENGGARA TIMUR",10,35,87,122
https://kawalpemilu.org#55847,"RAIFATUS, RAIHAT, BELU, NUSA TENGGARA TIMUR",1,70,2,72
https://kawalpemilu.org#55847,"RAIFATUS, RAIHAT, BELU, NUSA TENGGARA TIMUR",2,89,5,94
https://kawalpemilu.org#55847,"RAIFATUS, RAIHAT, BELU, NUSA TENGGARA TIMUR",3,155,8,163
https://kawalpemilu.org#55847,"RAIFATUS, RAIHAT, BELU, NUSA TENGGARA TIMUR",4,92,10,102
https://kawalpemilu.org#55848,"AITOUN, RAIHAT, BELU, NUSA TENGGARA TIMUR",1,113,17,130
https://kawalpemilu.org#55848,"AITOUN, RAIHAT, BELU, NUSA TENGGARA TIMUR",2,101,16,117
https://kawalpemilu.org#55848,"AITOUN, RAIHAT, BELU, NUSA TENGGARA TIMUR",3,119,18,137
https://kawalpemilu.org#55848,"AITOUN, RAIHAT, BELU, NUSA TENGGARA TIMUR",4,104,17,121
https://kawalpemilu.org#55848,"AITOUN, RAIHAT, BELU, NUSA TENGGARA TIMUR",5,90,4,94
https://kawalpemilu.org#55848,"AITOUN, RAIHAT, BELU, NUSA TENGGARA TIMUR",6,80,3,83
https://kawalpemilu.org#55848,"AITOUN, RAIHAT, BELU, NUSA TENGGARA TIMUR",7,97,4,101
https://kawalpemilu.org#55848,"AITOUN, RAIHAT, BELU, NUSA TENGGARA TIMUR",8,56,2,58
https://kawalpemilu.org#55849,"TOHE LETEN, RAIHAT, BELU, NUSA TENGGARA TIMUR",1,158,4,162
https://kawalpemilu.org#55849,"TOHE LETEN, RAIHAT, BELU, NUSA TENGGARA TIMUR",2,122,5,127
https://kawalpemilu.org#55849,"TOHE LETEN, RAIHAT, BELU, NUSA TENGGARA TIMUR",3,106,5,111
https://kawalpemilu.org#55851,"TUKUNENO, TASIFETO BARAT, BELU, NUSA TENGGARA TIMUR",1,181,30,211
https://kawalpemilu.org#55851,"TUKUNENO, TASIFETO BARAT, BELU, NUSA TENGGARA TIMUR",2,176,12,188
https://kawalpemilu.org#55851,"TUKUNENO, TASIFETO BARAT, BELU, NUSA TENGGARA TIMUR",3,199,11,210
https://kawalpemilu.org#55851,"TUKUNENO, TASIFETO BARAT, BELU, NUSA TENGGARA TIMUR",4,92,4,96
https://kawalpemilu.org#55851,"TUKUNENO, TASIFETO BARAT, BELU, NUSA TENGGARA TIMUR",5,162,20,182
https://kawalpemilu.org#55851,"TUKUNENO, TASIFETO BARAT, BELU, NUSA TENGGARA TIMUR",6,150,20,170
https://kawalpemilu.org#55851,"TUKUNENO, TASIFETO BARAT, BELU, NUSA TENGGARA TIMUR",7,155,6,161
https://kawalpemilu.org#55851,"TUKUNENO, TASIFETO BARAT, BELU, NUSA TENGGARA TIMUR",8,152,3,155
https://kawalpemilu.org#55851,"TUKUNENO, TASIFETO BARAT, BELU, NUSA TENGGARA TIMUR",9,51,2,53
https://kawalpemilu.org#55851,"TUKUNENO, TASIFETO BARAT, BELU, NUSA TENGGARA TIMUR",10,174,5,179
https://kawalpemilu.org#55851,"TUKUNENO, TASIFETO BARAT, BELU, NUSA TENGGARA TIMUR",11,175,9,184
https://kawalpemilu.org#55851,"TUKUNENO, TASIFETO BARAT, BELU, NUSA TENGGARA TIMUR",12,168,24,192
https://kawalpemilu.org#55852,"NAEKASA, TASIFETO BARAT, BELU, NUSA TENGGARA TIMUR",1,98,133,231
https://kawalpemilu.org#55852,"NAEKASA, TASIFETO BARAT, BELU, NUSA TENGGARA TIMUR",2,136,65,201
https://kawalpemilu.org#55852,"NAEKASA, TASIFETO BARAT, BELU, NUSA TENGGARA TIMUR",3,83,128,211
https://kawalpemilu.org#55852,"NAEKASA, TASIFETO BARAT, BELU, NUSA TENGGARA TIMUR",4,187,26,213
https://kawalpemilu.org#55852,"NAEKASA, TASIFETO BARAT, BELU, NUSA TENGGARA TIMUR",5,106,14,120
https://kawalpemilu.org#55852,"NAEKASA, TASIFETO BARAT, BELU, NUSA TENGGARA TIMUR",6,147,25,172
https://kawalpemilu.org#55852,"NAEKASA, TASIFETO BARAT, BELU, NUSA TENGGARA TIMUR",7,194,15,209
https://kawalpemilu.org#55852,"NAEKASA, TASIFETO BARAT, BELU, NUSA TENGGARA TIMUR",8,131,11,142
https://kawalpemilu.org#55852,"NAEKASA, TASIFETO BARAT, BELU, NUSA TENGGARA TIMUR",9,109,7,116
https://kawalpemilu.org#55852,"NAEKASA, TASIFETO BARAT, BELU, NUSA TENGGARA TIMUR",10,102,8,110
https://kawalpemilu.org#55852,"NAEKASA, TASIFETO BARAT, BELU, NUSA TENGGARA TIMUR",11,104,9,113
https://kawalpemilu.org#55852,"NAEKASA, TASIFETO BARAT, BELU, NUSA TENGGARA TIMUR",12,209,11,220
https://kawalpemilu.org#55852,"NAEKASA, TASIFETO BARAT, BELU, NUSA TENGGARA TIMUR",13,131,29,160
https://kawalpemilu.org#55852,"NAEKASA, TASIFETO BARAT, BELU, NUSA TENGGARA TIMUR",14,154,29,183
https://kawalpemilu.org#55852,"NAEKASA, TASIFETO BARAT, BELU, NUSA TENGGARA TIMUR",15,81,0,81
https://kawalpemilu.org#55852,"NAEKASA, TASIFETO BARAT, BELU, NUSA TENGGARA TIMUR",16,102,10,112
https://kawalpemilu.org#55852,"NAEKASA, TASIFETO BARAT, BELU, NUSA TENGGARA TIMUR",17,104,13,117
https://kawalpemilu.org#55852,"NAEKASA, TASIFETO BARAT, BELU, NUSA TENGGARA TIMUR",18,26,159,185
https://kawalpemilu.org#55852,"NAEKASA, TASIFETO BARAT, BELU, NUSA TENGGARA TIMUR",19,120,26,146
https://kawalpemilu.org#55852,"NAEKASA, TASIFETO BARAT, BELU, NUSA TENGGARA TIMUR",20,149,18,167
https://kawalpemilu.org#55852,"NAEKASA, TASIFETO BARAT, BELU, NUSA TENGGARA TIMUR",21,67,100,167
https://kawalpemilu.org#55853,"LOOKEU, TASIFETO BARAT, BELU, NUSA TENGGARA TIMUR",1,161,5,166
https://kawalpemilu.org#55853,"LOOKEU, TASIFETO BARAT, BELU, NUSA TENGGARA TIMUR",2,141,15,156
https://kawalpemilu.org#55854,"DEROKFATURENE, TASIFETO BARAT, BELU, NUSA TENGGARA TIMUR",1,185,14,199
https://kawalpemilu.org#55854,"DEROKFATURENE, TASIFETO BARAT, BELU, NUSA TENGGARA TIMUR",2,198,12,210
https://kawalpemilu.org#55854,"DEROKFATURENE, TASIFETO BARAT, BELU, NUSA TENGGARA TIMUR",3,134,2,136
https://kawalpemilu.org#55854,"DEROKFATURENE, TASIFETO BARAT, BELU, NUSA TENGGARA TIMUR",4,156,7,163
https://kawalpemilu.org#55855,"BAKUSTULAMA, TASIFETO BARAT, BELU, NUSA TENGGARA TIMUR",1,130,21,151
https://kawalpemilu.org#55855,"BAKUSTULAMA, TASIFETO BARAT, BELU, NUSA TENGGARA TIMUR",2,181,10,191
https://kawalpemilu.org#55855,"BAKUSTULAMA, TASIFETO BARAT, BELU, NUSA TENGGARA TIMUR",3,137,27,164
https://kawalpemilu.org#55855,"BAKUSTULAMA, TASIFETO BARAT, BELU, NUSA TENGGARA TIMUR",4,208,13,221
https://kawalpemilu.org#55855,"BAKUSTULAMA, TASIFETO BARAT, BELU, NUSA TENGGARA TIMUR",5,147,13,160
https://kawalpemilu.org#55855,"BAKUSTULAMA, TASIFETO BARAT, BELU, NUSA TENGGARA TIMUR",6,152,12,164
https://kawalpemilu.org#55855,"BAKUSTULAMA, TASIFETO BARAT, BELU, NUSA TENGGARA TIMUR",7,92,102,194
https://kawalpemilu.org#55855,"BAKUSTULAMA, TASIFETO BARAT, BELU, NUSA TENGGARA TIMUR",8,207,16,223
https://kawalpemilu.org#55855,"BAKUSTULAMA, TASIFETO BARAT, BELU, NUSA TENGGARA TIMUR",9,56,60,116
https://kawalpemilu.org#55856,"RINBESIHAT, TASIFETO BARAT, BELU, NUSA TENGGARA TIMUR",1,157,20,177
https://kawalpemilu.org#55856,"RINBESIHAT, TASIFETO BARAT, BELU, NUSA TENGGARA TIMUR",2,145,6,151
https://kawalpemilu.org#55856,"RINBESIHAT, TASIFETO BARAT, BELU, NUSA TENGGARA TIMUR",3,157,7,164
https://kawalpemilu.org#55856,"RINBESIHAT, TASIFETO BARAT, BELU, NUSA TENGGARA TIMUR",4,166,18,184
https://kawalpemilu.org#55856,"RINBESIHAT, TASIFETO BARAT, BELU, NUSA TENGGARA TIMUR",5,100,26,126
https://kawalpemilu.org#55856,"RINBESIHAT, TASIFETO BARAT, BELU, NUSA TENGGARA TIMUR",6,102,7,109
https://kawalpemilu.org#55856,"RINBESIHAT, TASIFETO BARAT, BELU, NUSA TENGGARA TIMUR",7,117,19,136
https://kawalpemilu.org#55857,"NAITIMU, TASIFETO BARAT, BELU, NUSA TENGGARA TIMUR",1,141,43,184
https://kawalpemilu.org#55857,"NAITIMU, TASIFETO BARAT, BELU, NUSA TENGGARA TIMUR",2,122,35,157
https://kawalpemilu.org#55857,"NAITIMU, TASIFETO BARAT, BELU, NUSA TENGGARA TIMUR",3,175,3,178
https://kawalpemilu.org#55857,"NAITIMU, TASIFETO BARAT, BELU, NUSA TENGGARA TIMUR",4,150,14,164
https://kawalpemilu.org#55857,"NAITIMU, TASIFETO BARAT, BELU, NUSA TENGGARA TIMUR",5,145,7,152
https://kawalpemilu.org#55857,"NAITIMU, TASIFETO BARAT, BELU, NUSA TENGGARA TIMUR",6,161,8,169
https://kawalpemilu.org#55857,"NAITIMU, TASIFETO BARAT, BELU, NUSA TENGGARA TIMUR",7,154,8,162
https://kawalpemilu.org#55857,"NAITIMU, TASIFETO BARAT, BELU, NUSA TENGGARA TIMUR",8,136,2,138
https://kawalpemilu.org#55857,"NAITIMU, TASIFETO BARAT, BELU, NUSA TENGGARA TIMUR",9,101,9,110
https://kawalpemilu.org#55857,"NAITIMU, TASIFETO BARAT, BELU, NUSA TENGGARA TIMUR",10,133,22,155
https://kawalpemilu.org#55857,"NAITIMU, TASIFETO BARAT, BELU, NUSA TENGGARA TIMUR",11,126,20,146
https://kawalpemilu.org#55857,"NAITIMU, TASIFETO BARAT, BELU, NUSA TENGGARA TIMUR",12,79,20,99
https://kawalpemilu.org#55857,"NAITIMU, TASIFETO BARAT, BELU, NUSA TENGGARA TIMUR",13,155,27,182
https://kawalpemilu.org#55857,"NAITIMU, TASIFETO BARAT, BELU, NUSA TENGGARA TIMUR",14,131,31,162
https://kawalpemilu.org#92131,"LAWALUTOLUS, TASIFETO BARAT, BELU, NUSA TENGGARA TIMUR",1,180,7,187
https://kawalpemilu.org#92131,"LAWALUTOLUS, TASIFETO BARAT, BELU, NUSA TENGGARA TIMUR",2,92,5,97
https://kawalpemilu.org#92131,"LAWALUTOLUS, TASIFETO BARAT, BELU, NUSA TENGGARA TIMUR",3,158,11,169
https://kawalpemilu.org#92131,"LAWALUTOLUS, TASIFETO BARAT, BELU, NUSA TENGGARA TIMUR",4,106,14,120
https://kawalpemilu.org#55860,"FATUKETI, KAKULUK MESAK, BELU, NUSA TENGGARA TIMUR",2,121,16,137
https://kawalpemilu.org#55860,"FATUKETI, KAKULUK MESAK, BELU, NUSA TENGGARA TIMUR",3,140,10,150
https://kawalpemilu.org#55860,"FATUKETI, KAKULUK MESAK, BELU, NUSA TENGGARA TIMUR",4,89,12,101
https://kawalpemilu.org#55860,"FATUKETI, KAKULUK MESAK, BELU, NUSA TENGGARA TIMUR",5,57,105,162
https://kawalpemilu.org#55860,"FATUKETI, KAKULUK MESAK, BELU, NUSA TENGGARA TIMUR",6,173,26,199
https://kawalpemilu.org#55860,"FATUKETI, KAKULUK MESAK, BELU, NUSA TENGGARA TIMUR",7,113,13,126
https://kawalpemilu.org#55860,"FATUKETI, KAKULUK MESAK, BELU, NUSA TENGGARA TIMUR",8,61,30,91
https://kawalpemilu.org#55861,"DUALAUS, KAKULUK MESAK, BELU, NUSA TENGGARA TIMUR",1,105,96,201
https://kawalpemilu.org#55861,"DUALAUS, KAKULUK MESAK, BELU, NUSA TENGGARA TIMUR",2,140,36,176
https://kawalpemilu.org#55861,"DUALAUS, KAKULUK MESAK, BELU, NUSA TENGGARA TIMUR",3,168,17,185
https://kawalpemilu.org#55861,"DUALAUS, KAKULUK MESAK, BELU, NUSA TENGGARA TIMUR",5,129,53,182
https://kawalpemilu.org#55861,"DUALAUS, KAKULUK MESAK, BELU, NUSA TENGGARA TIMUR",6,107,68,175
https://kawalpemilu.org#55861,"DUALAUS, KAKULUK MESAK, BELU, NUSA TENGGARA TIMUR",7,83,94,177
https://kawalpemilu.org#55861,"DUALAUS, KAKULUK MESAK, BELU, NUSA TENGGARA TIMUR",8,114,49,163
https://kawalpemilu.org#55861,"DUALAUS, KAKULUK MESAK, BELU, NUSA TENGGARA TIMUR",9,114,24,138
https://kawalpemilu.org#55861,"DUALAUS, KAKULUK MESAK, BELU, NUSA TENGGARA TIMUR",10,131,29,160
https://kawalpemilu.org#55861,"DUALAUS, KAKULUK MESAK, BELU, NUSA TENGGARA TIMUR",11,128,55,183
https://kawalpemilu.org#55861,"DUALAUS, KAKULUK MESAK, BELU, NUSA TENGGARA TIMUR",12,96,78,174
https://kawalpemilu.org#55862,"JENILU, KAKULUK MESAK, BELU, NUSA TENGGARA TIMUR",1,153,14,167
https://kawalpemilu.org#55862,"JENILU, KAKULUK MESAK, BELU, NUSA TENGGARA TIMUR",2,129,19,148
https://kawalpemilu.org#55862,"JENILU, KAKULUK MESAK, BELU, NUSA TENGGARA TIMUR",3,137,9,146
https://kawalpemilu.org#55862,"JENILU, KAKULUK MESAK, BELU, NUSA TENGGARA TIMUR",4,174,10,184
https://kawalpemilu.org#55862,"JENILU, KAKULUK MESAK, BELU, NUSA TENGGARA TIMUR",5,127,38,165
https://kawalpemilu.org#55862,"JENILU, KAKULUK MESAK, BELU, NUSA TENGGARA TIMUR",6,120,41,161
https://kawalpemilu.org#55862,"JENILU, KAKULUK MESAK, BELU, NUSA TENGGARA TIMUR",7,146,44,190
https://kawalpemilu.org#55862,"JENILU, KAKULUK MESAK, BELU, NUSA TENGGARA TIMUR",8,112,65,177
https://kawalpemilu.org#55862,"JENILU, KAKULUK MESAK, BELU, NUSA TENGGARA TIMUR",9,116,57,173
https://kawalpemilu.org#55863,"KENEBIBI, KAKULUK MESAK, BELU, NUSA TENGGARA TIMUR",1,157,49,206
https://kawalpemilu.org#55863,"KENEBIBI, KAKULUK MESAK, BELU, NUSA TENGGARA TIMUR",2,184,18,202
https://kawalpemilu.org#55863,"KENEBIBI, KAKULUK MESAK, BELU, NUSA TENGGARA TIMUR",3,161,41,202
https://kawalpemilu.org#55863,"KENEBIBI, KAKULUK MESAK, BELU, NUSA TENGGARA TIMUR",4,105,82,187
https://kawalpemilu.org#55863,"KENEBIBI, KAKULUK MESAK, BELU, NUSA TENGGARA TIMUR",5,69,102,171
https://kawalpemilu.org#55863,"KENEBIBI, KAKULUK MESAK, BELU, NUSA TENGGARA TIMUR",6,126,20,146
https://kawalpemilu.org#55863,"KENEBIBI, KAKULUK MESAK, BELU, NUSA TENGGARA TIMUR",7,76,144,220
https://kawalpemilu.org#55863,"KENEBIBI, KAKULUK MESAK, BELU, NUSA TENGGARA TIMUR",8,155,19,174
https://kawalpemilu.org#55863,"KENEBIBI, KAKULUK MESAK, BELU, NUSA TENGGARA TIMUR",9,74,48,122
https://kawalpemilu.org#55864,"LEOSAMA, KAKULUK MESAK, BELU, NUSA TENGGARA TIMUR",1,144,22,166
https://kawalpemilu.org#55864,"LEOSAMA, KAKULUK MESAK, BELU, NUSA TENGGARA TIMUR",2,81,21,102
https://kawalpemilu.org#55864,"LEOSAMA, KAKULUK MESAK, BELU, NUSA TENGGARA TIMUR",3,92,23,115
https://kawalpemilu.org#55864,"LEOSAMA, KAKULUK MESAK, BELU, NUSA TENGGARA TIMUR",4,104,33,137
https://kawalpemilu.org#55864,"LEOSAMA, KAKULUK MESAK, BELU, NUSA TENGGARA TIMUR",5,120,30,150
https://kawalpemilu.org#55865,"KABUNA, KAKULUK MESAK, BELU, NUSA TENGGARA TIMUR",1,59,95,154
https://kawalpemilu.org#55865,"KABUNA, KAKULUK MESAK, BELU, NUSA TENGGARA TIMUR",2,45,115,160
https://kawalpemilu.org#55865,"KABUNA, KAKULUK MESAK, BELU, NUSA TENGGARA TIMUR",3,38,111,149
https://kawalpemilu.org#55865,"KABUNA, KAKULUK MESAK, BELU, NUSA TENGGARA TIMUR",4,93,21,114
https://kawalpemilu.org#55865,"KABUNA, KAKULUK MESAK, BELU, NUSA TENGGARA TIMUR",5,109,23,132
https://kawalpemilu.org#55865,"KABUNA, KAKULUK MESAK, BELU, NUSA TENGGARA TIMUR",6,96,76,172
https://kawalpemilu.org#55865,"KABUNA, KAKULUK MESAK, BELU, NUSA TENGGARA TIMUR",7,121,42,163
https://kawalpemilu.org#55865,"KABUNA, KAKULUK MESAK, BELU, NUSA TENGGARA TIMUR",8,138,50,188
https://kawalpemilu.org#55865,"KABUNA, KAKULUK MESAK, BELU, NUSA TENGGARA TIMUR",9,143,39,182
https://kawalpemilu.org#55865,"KABUNA, KAKULUK MESAK, BELU, NUSA TENGGARA TIMUR",10,143,35,178
https://kawalpemilu.org#55865,"KABUNA, KAKULUK MESAK, BELU, NUSA TENGGARA TIMUR",11,95,21,116
https://kawalpemilu.org#55865,"KABUNA, KAKULUK MESAK, BELU, NUSA TENGGARA TIMUR",12,75,33,108
https://kawalpemilu.org#55865,"KABUNA, KAKULUK MESAK, BELU, NUSA TENGGARA TIMUR",13,123,57,180
https://kawalpemilu.org#55865,"KABUNA, KAKULUK MESAK, BELU, NUSA TENGGARA TIMUR",14,76,67,143
https://kawalpemilu.org#55865,"KABUNA, KAKULUK MESAK, BELU, NUSA TENGGARA TIMUR",15,48,71,119
https://kawalpemilu.org#55865,"KABUNA, KAKULUK MESAK, BELU, NUSA TENGGARA TIMUR",16,148,49,197
https://kawalpemilu.org#55865,"KABUNA, KAKULUK MESAK, BELU, NUSA TENGGARA TIMUR",17,156,31,187
https://kawalpemilu.org#55865,"KABUNA, KAKULUK MESAK, BELU, NUSA TENGGARA TIMUR",18,40,32,72
https://kawalpemilu.org#55865,"KABUNA, KAKULUK MESAK, BELU, NUSA TENGGARA TIMUR",19,52,85,137
https://kawalpemilu.org#55948,"KOTA ATAMBUA, KOTA ATAMBUA, BELU, NUSA TENGGARA TIMUR",1,206,13,219
https://kawalpemilu.org#55948,"KOTA ATAMBUA, KOTA ATAMBUA, BELU, NUSA TENGGARA TIMUR",2,105,7,112
https://kawalpemilu.org#55948,"KOTA ATAMBUA, KOTA ATAMBUA, BELU, NUSA TENGGARA TIMUR",3,166,33,199
https://kawalpemilu.org#55948,"KOTA ATAMBUA, KOTA ATAMBUA, BELU, NUSA TENGGARA TIMUR",4,165,13,178
https://kawalpemilu.org#55948,"KOTA ATAMBUA, KOTA ATAMBUA, BELU, NUSA TENGGARA TIMUR",5,72,9,81
https://kawalpemilu.org#55948,"KOTA ATAMBUA, KOTA ATAMBUA, BELU, NUSA TENGGARA TIMUR",6,149,34,183
https://kawalpemilu.org#55948,"KOTA ATAMBUA, KOTA ATAMBUA, BELU, NUSA TENGGARA TIMUR",7,133,31,164
https://kawalpemilu.org#55948,"KOTA ATAMBUA, KOTA ATAMBUA, BELU, NUSA TENGGARA TIMUR",8,71,17,88
https://kawalpemilu.org#55948,"KOTA ATAMBUA, KOTA ATAMBUA, BELU, NUSA TENGGARA TIMUR",9,101,9,110
https://kawalpemilu.org#55948,"KOTA ATAMBUA, KOTA ATAMBUA, BELU, NUSA TENGGARA TIMUR",10,62,18,80
https://kawalpemilu.org#55949,"TENUKIIK, KOTA ATAMBUA, BELU, NUSA TENGGARA TIMUR",1,154,52,206
https://kawalpemilu.org#55949,"TENUKIIK, KOTA ATAMBUA, BELU, NUSA TENGGARA TIMUR",2,184,25,209
https://kawalpemilu.org#55949,"TENUKIIK, KOTA ATAMBUA, BELU, NUSA TENGGARA TIMUR",3,115,14,129
https://kawalpemilu.org#55949,"TENUKIIK, KOTA ATAMBUA, BELU, NUSA TENGGARA TIMUR",4,176,35,211
https://kawalpemilu.org#55949,"TENUKIIK, KOTA ATAMBUA, BELU, NUSA TENGGARA TIMUR",5,85,37,122
https://kawalpemilu.org#55949,"TENUKIIK, KOTA ATAMBUA, BELU, NUSA TENGGARA TIMUR",6,160,27,187
https://kawalpemilu.org#55949,"TENUKIIK, KOTA ATAMBUA, BELU, NUSA TENGGARA TIMUR",7,171,19,190
https://kawalpemilu.org#55949,"TENUKIIK, KOTA ATAMBUA, BELU, NUSA TENGGARA TIMUR",8,23,115,138
https://kawalpemilu.org#55949,"TENUKIIK, KOTA ATAMBUA, BELU, NUSA TENGGARA TIMUR",9,34,138,172
https://kawalpemilu.org#55949,"TENUKIIK, KOTA ATAMBUA, BELU, NUSA TENGGARA TIMUR",10,22,114,136
https://kawalpemilu.org#55949,"TENUKIIK, KOTA ATAMBUA, BELU, NUSA TENGGARA TIMUR",11,119,12,131
https://kawalpemilu.org#55949,"TENUKIIK, KOTA ATAMBUA, BELU, NUSA TENGGARA TIMUR",12,108,62,170
https://kawalpemilu.org#55949,"TENUKIIK, KOTA ATAMBUA, BELU, NUSA TENGGARA TIMUR",13,141,22,163
https://kawalpemilu.org#55950,"MANUMUTIN, KOTA ATAMBUA, BELU, NUSA TENGGARA TIMUR",1,147,66,213
https://kawalpemilu.org#55950,"MANUMUTIN, KOTA ATAMBUA, BELU, NUSA TENGGARA TIMUR",2,149,34,183
https://kawalpemilu.org#55950,"MANUMUTIN, KOTA ATAMBUA, BELU, NUSA TENGGARA TIMUR",3,178,35,213
https://kawalpemilu.org#55950,"MANUMUTIN, KOTA ATAMBUA, BELU, NUSA TENGGARA TIMUR",4,157,27,184
https://kawalpemilu.org#55950,"MANUMUTIN, KOTA ATAMBUA, BELU, NUSA TENGGARA TIMUR",5,136,35,171
https://kawalpemilu.org#55950,"MANUMUTIN, KOTA ATAMBUA, BELU, NUSA TENGGARA TIMUR",7,83,43,126
https://kawalpemilu.org#55950,"MANUMUTIN, KOTA ATAMBUA, BELU, NUSA TENGGARA TIMUR",8,125,62,187
https://kawalpemilu.org#55950,"MANUMUTIN, KOTA ATAMBUA, BELU, NUSA TENGGARA TIMUR",9,199,25,224
https://kawalpemilu.org#55950,"MANUMUTIN, KOTA ATAMBUA, BELU, NUSA TENGGARA TIMUR",10,175,49,224
https://kawalpemilu.org#55950,"MANUMUTIN, KOTA ATAMBUA, BELU, NUSA TENGGARA TIMUR",11,223,18,241
https://kawalpemilu.org#55950,"MANUMUTIN, KOTA ATAMBUA, BELU, NUSA TENGGARA TIMUR",12,212,44,256
https://kawalpemilu.org#55950,"MANUMUTIN, KOTA ATAMBUA, BELU, NUSA TENGGARA TIMUR",13,229,20,249
https://kawalpemilu.org#55950,"MANUMUTIN, KOTA ATAMBUA, BELU, NUSA TENGGARA TIMUR",14,109,29,138
https://kawalpemilu.org#55950,"MANUMUTIN, KOTA ATAMBUA, BELU, NUSA TENGGARA TIMUR",15,124,78,202
https://kawalpemilu.org#55950,"MANUMUTIN, KOTA ATAMBUA, BELU, NUSA TENGGARA TIMUR",16,153,63,216
https://kawalpemilu.org#55950,"MANUMUTIN, KOTA ATAMBUA, BELU, NUSA TENGGARA TIMUR",17,37,147,184
https://kawalpemilu.org#55950,"MANUMUTIN, KOTA ATAMBUA, BELU, NUSA TENGGARA TIMUR",18,70,100,170
https://kawalpemilu.org#55950,"MANUMUTIN, KOTA ATAMBUA, BELU, NUSA TENGGARA TIMUR",19,68,122,190
https://kawalpemilu.org#55950,"MANUMUTIN, KOTA ATAMBUA, BELU, NUSA TENGGARA TIMUR",20,54,101,155
https://kawalpemilu.org#55950,"MANUMUTIN, KOTA ATAMBUA, BELU, NUSA TENGGARA TIMUR",21,81,78,159
https://kawalpemilu.org#55950,"MANUMUTIN, KOTA ATAMBUA, BELU, NUSA TENGGARA TIMUR",22,71,108,179
https://kawalpemilu.org#55950,"MANUMUTIN, KOTA ATAMBUA, BELU, NUSA TENGGARA TIMUR",25,177,33,210
https://kawalpemilu.org#55950,"MANUMUTIN, KOTA ATAMBUA, BELU, NUSA TENGGARA TIMUR",26,211,11,222
https://kawalpemilu.org#55950,"MANUMUTIN, KOTA ATAMBUA, BELU, NUSA TENGGARA TIMUR",27,205,7,212
https://kawalpemilu.org#55950,"MANUMUTIN, KOTA ATAMBUA, BELU, NUSA TENGGARA TIMUR",28,137,71,208
https://kawalpemilu.org#55951,"FATUBENAO, KOTA ATAMBUA, BELU, NUSA TENGGARA TIMUR",1,221,20,241
https://kawalpemilu.org#55951,"FATUBENAO, KOTA ATAMBUA, BELU, NUSA TENGGARA TIMUR",2,188,27,215
https://kawalpemilu.org#55951,"FATUBENAO, KOTA ATAMBUA, BELU, NUSA TENGGARA TIMUR",3,144,31,175
https://kawalpemilu.org#55951,"FATUBENAO, KOTA ATAMBUA, BELU, NUSA TENGGARA TIMUR",4,214,38,252
https://kawalpemilu.org#55951,"FATUBENAO, KOTA ATAMBUA, BELU, NUSA TENGGARA TIMUR",5,174,42,216
https://kawalpemilu.org#55951,"FATUBENAO, KOTA ATAMBUA, BELU, NUSA TENGGARA TIMUR",6,165,26,191
https://kawalpemilu.org#55951,"FATUBENAO, KOTA ATAMBUA, BELU, NUSA TENGGARA TIMUR",7,184,22,206
https://kawalpemilu.org#55951,"FATUBENAO, KOTA ATAMBUA, BELU, NUSA TENGGARA TIMUR",8,182,25,207
https://kawalpemilu.org#55951,"FATUBENAO, KOTA ATAMBUA, BELU, NUSA TENGGARA TIMUR",9,168,54,222
https://kawalpemilu.org#55951,"FATUBENAO, KOTA ATAMBUA, BELU, NUSA TENGGARA TIMUR",10,107,61,168
https://kawalpemilu.org#55951,"FATUBENAO, KOTA ATAMBUA, BELU, NUSA TENGGARA TIMUR",11,65,67,132
https://kawalpemilu.org#55951,"FATUBENAO, KOTA ATAMBUA, BELU, NUSA TENGGARA TIMUR",12,73,63,136
https://kawalpemilu.org#55951,"FATUBENAO, KOTA ATAMBUA, BELU, NUSA TENGGARA TIMUR",13,98,67,165
https://kawalpemilu.org#55951,"FATUBENAO, KOTA ATAMBUA, BELU, NUSA TENGGARA TIMUR",14,103,36,139
https://kawalpemilu.org#55951,"FATUBENAO, KOTA ATAMBUA, BELU, NUSA TENGGARA TIMUR",15,122,17,139
https://kawalpemilu.org#55951,"FATUBENAO, KOTA ATAMBUA, BELU, NUSA TENGGARA TIMUR",16,204,7,211
https://kawalpemilu.org#55951,"FATUBENAO, KOTA ATAMBUA, BELU, NUSA TENGGARA TIMUR",17,165,16,181
https://kawalpemilu.org#55951,"FATUBENAO, KOTA ATAMBUA, BELU, NUSA TENGGARA TIMUR",18,190,6,196
https://kawalpemilu.org#55951,"FATUBENAO, KOTA ATAMBUA, BELU, NUSA TENGGARA TIMUR",19,186,19,205
https://kawalpemilu.org#55951,"FATUBENAO, KOTA ATAMBUA, BELU, NUSA TENGGARA TIMUR",20,94,50,144
https://kawalpemilu.org#55951,"FATUBENAO, KOTA ATAMBUA, BELU, NUSA TENGGARA TIMUR",21,127,16,143
https://kawalpemilu.org#55951,"FATUBENAO, KOTA ATAMBUA, BELU, NUSA TENGGARA TIMUR",22,97,70,167
https://kawalpemilu.org#55951,"FATUBENAO, KOTA ATAMBUA, BELU, NUSA TENGGARA TIMUR",23,114,37,151
https://kawalpemilu.org#55951,"FATUBENAO, KOTA ATAMBUA, BELU, NUSA TENGGARA TIMUR",24,171,21,192
https://kawalpemilu.org#55953,"RAIMANUS, RAIMANUK, BELU, NUSA TENGGARA TIMUR",2,163,18,181
https://kawalpemilu.org#55953,"RAIMANUS, RAIMANUK, BELU, NUSA TENGGARA TIMUR",3,100,16,116
https://kawalpemilu.org#55953,"RAIMANUS, RAIMANUK, BELU, NUSA TENGGARA TIMUR",4,153,21,174
https://kawalpemilu.org#55953,"RAIMANUS, RAIMANUK, BELU, NUSA TENGGARA TIMUR",5,122,33,155
https://kawalpemilu.org#55953,"RAIMANUS, RAIMANUK, BELU, NUSA TENGGARA TIMUR",6,68,36,104
https://kawalpemilu.org#55953,"RAIMANUS, RAIMANUK, BELU, NUSA TENGGARA TIMUR",7,54,42,96
https://kawalpemilu.org#55954,"RENRUA, RAIMANUK, BELU, NUSA TENGGARA TIMUR",1,136,7,143
https://kawalpemilu.org#55954,"RENRUA, RAIMANUK, BELU, NUSA TENGGARA TIMUR",2,137,4,141
https://kawalpemilu.org#55954,"RENRUA, RAIMANUK, BELU, NUSA TENGGARA TIMUR",3,135,8,143
https://kawalpemilu.org#55954,"RENRUA, RAIMANUK, BELU, NUSA TENGGARA TIMUR",4,125,8,133
https://kawalpemilu.org#55954,"RENRUA, RAIMANUK, BELU, NUSA TENGGARA TIMUR",5,110,8,118
https://kawalpemilu.org#55955,"DUA KORAN, RAIMANUK, BELU, NUSA TENGGARA TIMUR",1,145,10,155
https://kawalpemilu.org#55955,"DUA KORAN, RAIMANUK, BELU, NUSA TENGGARA TIMUR",2,132,10,142
https://kawalpemilu.org#55955,"DUA KORAN, RAIMANUK, BELU, NUSA TENGGARA TIMUR",3,129,19,148
https://kawalpemilu.org#55955,"DUA KORAN, RAIMANUK, BELU, NUSA TENGGARA TIMUR",4,222,8,230
https://kawalpemilu.org#55956,"MANDEU, RAIMANUK, BELU, NUSA TENGGARA TIMUR",1,105,16,121
https://kawalpemilu.org#55956,"MANDEU, RAIMANUK, BELU, NUSA TENGGARA TIMUR",2,82,5,87
https://kawalpemilu.org#55956,"MANDEU, RAIMANUK, BELU, NUSA TENGGARA TIMUR",3,114,28,142
https://kawalpemilu.org#55956,"MANDEU, RAIMANUK, BELU, NUSA TENGGARA TIMUR",4,90,9,99
https://kawalpemilu.org#55956,"MANDEU, RAIMANUK, BELU, NUSA TENGGARA TIMUR",5,158,34,192
https://kawalpemilu.org#55956,"MANDEU, RAIMANUK, BELU, NUSA TENGGARA TIMUR",6,52,111,163
https://kawalpemilu.org#55956,"MANDEU, RAIMANUK, BELU, NUSA TENGGARA TIMUR",7,41,69,110
https://kawalpemilu.org#55956,"MANDEU, RAIMANUK, BELU, NUSA TENGGARA TIMUR",8,79,19,98
https://kawalpemilu.org#55956,"MANDEU, RAIMANUK, BELU, NUSA TENGGARA TIMUR",9,66,20,86
https://kawalpemilu.org#55957,"RAFAE, RAIMANUK, BELU, NUSA TENGGARA TIMUR",1,139,29,168
https://kawalpemilu.org#55957,"RAFAE, RAIMANUK, BELU, NUSA TENGGARA TIMUR",2,67,21,88
https://kawalpemilu.org#55957,"RAFAE, RAIMANUK, BELU, NUSA TENGGARA TIMUR",3,212,2,214
https://kawalpemilu.org#55957,"RAFAE, RAIMANUK, BELU, NUSA TENGGARA TIMUR",4,194,4,198
https://kawalpemilu.org#55957,"RAFAE, RAIMANUK, BELU, NUSA TENGGARA TIMUR",5,131,17,148
https://kawalpemilu.org#55958,"FATURIKA, RAIMANUK, BELU, NUSA TENGGARA TIMUR",1,114,8,122
https://kawalpemilu.org#55958,"FATURIKA, RAIMANUK, BELU, NUSA TENGGARA TIMUR",2,146,9,155
https://kawalpemilu.org#55958,"FATURIKA, RAIMANUK, BELU, NUSA TENGGARA TIMUR",3,152,13,172
https://kawalpemilu.org#55958,"FATURIKA, RAIMANUK, BELU, NUSA TENGGARA TIMUR",4,156,18,174
https://kawalpemilu.org#55959,"LEUNTOLU, RAIMANUK, BELU, NUSA TENGGARA TIMUR",1,162,13,175
https://kawalpemilu.org#55959,"LEUNTOLU, RAIMANUK, BELU, NUSA TENGGARA TIMUR",2,170,18,188
https://kawalpemilu.org#55959,"LEUNTOLU, RAIMANUK, BELU, NUSA TENGGARA TIMUR",3,102,8,110
https://kawalpemilu.org#55959,"LEUNTOLU, RAIMANUK, BELU, NUSA TENGGARA TIMUR",4,106,14,120
https://kawalpemilu.org#55959,"LEUNTOLU, RAIMANUK, BELU, NUSA TENGGARA TIMUR",5,57,52,109
https://kawalpemilu.org#55959,"LEUNTOLU, RAIMANUK, BELU, NUSA TENGGARA TIMUR",6,97,57,154
https://kawalpemilu.org#55959,"LEUNTOLU, RAIMANUK, BELU, NUSA TENGGARA TIMUR",7,58,75,133
https://kawalpemilu.org#55959,"LEUNTOLU, RAIMANUK, BELU, NUSA TENGGARA TIMUR",8,150,31,181
https://kawalpemilu.org#55959,"LEUNTOLU, RAIMANUK, BELU, NUSA TENGGARA TIMUR",9,90,32,122
https://kawalpemilu.org#55960,"TEUN, RAIMANUK, BELU, NUSA TENGGARA TIMUR",1,158,10,168
https://kawalpemilu.org#55960,"TEUN, RAIMANUK, BELU, NUSA TENGGARA TIMUR",2,149,8,157
https://kawalpemilu.org#55960,"TEUN, RAIMANUK, BELU, NUSA TENGGARA TIMUR",3,158,5,163
https://kawalpemilu.org#55960,"TEUN, RAIMANUK, BELU, NUSA TENGGARA TIMUR",4,93,1,94
https://kawalpemilu.org#55960,"TEUN, RAIMANUK, BELU, NUSA TENGGARA TIMUR",5,134,8,142
https://kawalpemilu.org#55960,"TEUN, RAIMANUK, BELU, NUSA TENGGARA TIMUR",6,111,5,116
https://kawalpemilu.org#55960,"TEUN, RAIMANUK, BELU, NUSA TENGGARA TIMUR",7,125,9,134
https://kawalpemilu.org#55961,"TASAIN, RAIMANUK, BELU, NUSA TENGGARA TIMUR",1,147,9,156
https://kawalpemilu.org#55961,"TASAIN, RAIMANUK, BELU, NUSA TENGGARA TIMUR",2,200,7,207
https://kawalpemilu.org#55961,"TASAIN, RAIMANUK, BELU, NUSA TENGGARA TIMUR",3,148,7,155
https://kawalpemilu.org#55961,"TASAIN, RAIMANUK, BELU, NUSA TENGGARA TIMUR",4,146,15,161
https://kawalpemilu.org#56001,"LASIOLAT, LASIOLAT, BELU, NUSA TENGGARA TIMUR",1,109,4,113
https://kawalpemilu.org#56001,"LASIOLAT, LASIOLAT, BELU, NUSA TENGGARA TIMUR",2,153,15,168
https://kawalpemilu.org#56001,"LASIOLAT, LASIOLAT, BELU, NUSA TENGGARA TIMUR",3,102,8,110
https://kawalpemilu.org#56002,"MANEIKUN, LASIOLAT, BELU, NUSA TENGGARA TIMUR",1,121,2,123
https://kawalpemilu.org#56002,"MANEIKUN, LASIOLAT, BELU, NUSA TENGGARA TIMUR",2,114,9,123
https://kawalpemilu.org#56002,"MANEIKUN, LASIOLAT, BELU, NUSA TENGGARA TIMUR",3,98,4,102
https://kawalpemilu.org#56002,"MANEIKUN, LASIOLAT, BELU, NUSA TENGGARA TIMUR",4,109,3,112
https://kawalpemilu.org#56003,"LAKANMAU, LASIOLAT, BELU, NUSA TENGGARA TIMUR",1,160,3,163
https://kawalpemilu.org#56003,"LAKANMAU, LASIOLAT, BELU, NUSA TENGGARA TIMUR",2,149,4,153
https://kawalpemilu.org#56003,"LAKANMAU, LASIOLAT, BELU, NUSA TENGGARA TIMUR",3,155,3,158
https://kawalpemilu.org#56004,"DUALASI RAIULUN, LASIOLAT, BELU, NUSA TENGGARA TIMUR",1,150,14,164
https://kawalpemilu.org#56004,"DUALASI RAIULUN, LASIOLAT, BELU, NUSA TENGGARA TIMUR",2,149,5,154
https://kawalpemilu.org#56004,"DUALASI RAIULUN, LASIOLAT, BELU, NUSA TENGGARA TIMUR",3,128,7,135
https://kawalpemilu.org#56005,"DUALASI, LASIOLAT, BELU, NUSA TENGGARA TIMUR",1,141,5,146
https://kawalpemilu.org#56005,"DUALASI, LASIOLAT, BELU, NUSA TENGGARA TIMUR",2,81,2,83
https://kawalpemilu.org#56005,"DUALASI, LASIOLAT, BELU, NUSA TENGGARA TIMUR",3,88,1,89
https://kawalpemilu.org#56005,"DUALASI, LASIOLAT, BELU, NUSA TENGGARA TIMUR",4,177,7,184
https://kawalpemilu.org#56006,"FATULOTU, LASIOLAT, BELU, NUSA TENGGARA TIMUR",1,169,10,179
https://kawalpemilu.org#56006,"FATULOTU, LASIOLAT, BELU, NUSA TENGGARA TIMUR",2,170,17,187
https://kawalpemilu.org#56006,"FATULOTU, LASIOLAT, BELU, NUSA TENGGARA TIMUR",3,138,9,149
https://kawalpemilu.org#56006,"FATULOTU, LASIOLAT, BELU, NUSA TENGGARA TIMUR",4,175,5,180
https://kawalpemilu.org#56006,"FATULOTU, LASIOLAT, BELU, NUSA TENGGARA TIMUR",5,155,6,161
https://kawalpemilu.org#56006,"FATULOTU, LASIOLAT, BELU, NUSA TENGGARA TIMUR",6,129,14,143
https://kawalpemilu.org#56007,"BAUDAOK, LASIOLAT, BELU, NUSA TENGGARA TIMUR",1,71,11,82
https://kawalpemilu.org#56007,"BAUDAOK, LASIOLAT, BELU, NUSA TENGGARA TIMUR",3,103,4,107
https://kawalpemilu.org#56009,"EKIN, LAMAKNEN SELATAN, BELU, NUSA TENGGARA TIMUR",1,172,6,178
https://kawalpemilu.org#56009,"EKIN, LAMAKNEN SELATAN, BELU, NUSA TENGGARA TIMUR",2,168,9,177
https://kawalpemilu.org#56009,"EKIN, LAMAKNEN SELATAN, BELU, NUSA TENGGARA TIMUR",3,65,1,66
https://kawalpemilu.org#56010,"LOONUNA, LAMAKNEN SELATAN, BELU, NUSA TENGGARA TIMUR",1,116,7,123
https://kawalpemilu.org#56010,"LOONUNA, LAMAKNEN SELATAN, BELU, NUSA TENGGARA TIMUR",2,167,6,173
https://kawalpemilu.org#56010,"LOONUNA, LAMAKNEN SELATAN, BELU, NUSA TENGGARA TIMUR",3,127,11,138
https://kawalpemilu.org#56010,"LOONUNA, LAMAKNEN SELATAN, BELU, NUSA TENGGARA TIMUR",4,158,6,164
https://kawalpemilu.org#56010,"LOONUNA, LAMAKNEN SELATAN, BELU, NUSA TENGGARA TIMUR",5,112,5,117
https://kawalpemilu.org#56011,"NUALAIN, LAMAKNEN SELATAN, BELU, NUSA TENGGARA TIMUR",1,116,1,117
https://kawalpemilu.org#56011,"NUALAIN, LAMAKNEN SELATAN, BELU, NUSA TENGGARA TIMUR",2,139,5,144
https://kawalpemilu.org#56011,"NUALAIN, LAMAKNEN SELATAN, BELU, NUSA TENGGARA TIMUR",3,145,2,147
https://kawalpemilu.org#56012,"LAKMARAS, LAMAKNEN SELATAN, BELU, NUSA TENGGARA TIMUR",1,168,7,175
https://kawalpemilu.org#56012,"LAKMARAS, LAMAKNEN SELATAN, BELU, NUSA TENGGARA TIMUR",2,186,7,193
https://kawalpemilu.org#56012,"LAKMARAS, LAMAKNEN SELATAN, BELU, NUSA TENGGARA TIMUR",3,87,11,98
https://kawalpemilu.org#56012,"LAKMARAS, LAMAKNEN SELATAN, BELU, NUSA TENGGARA TIMUR",4,133,6,139
https://kawalpemilu.org#56013,"HENES, LAMAKNEN SELATAN, BELU, NUSA TENGGARA TIMUR",1,140,4,144
https://kawalpemilu.org#56013,"HENES, LAMAKNEN SELATAN, BELU, NUSA TENGGARA TIMUR",2,151,10,161
https://kawalpemilu.org#56014,"DEBULULIK, LAMAKNEN SELATAN, BELU, NUSA TENGGARA TIMUR",1,129,2,131
https://kawalpemilu.org#56014,"DEBULULIK, LAMAKNEN SELATAN, BELU, NUSA TENGGARA TIMUR",2,151,5,156
https://kawalpemilu.org#56014,"DEBULULIK, LAMAKNEN SELATAN, BELU, NUSA TENGGARA TIMUR",3,134,2,136
https://kawalpemilu.org#56014,"DEBULULIK, LAMAKNEN SELATAN, BELU, NUSA TENGGARA TIMUR",4,135,0,135
https://kawalpemilu.org#56015,"SISI FATUBERAL, LAMAKNEN SELATAN, BELU, NUSA TENGGARA TIMUR",1,90,8,98
https://kawalpemilu.org#56015,"SISI FATUBERAL, LAMAKNEN SELATAN, BELU, NUSA TENGGARA TIMUR",2,171,7,178
https://kawalpemilu.org#56015,"SISI FATUBERAL, LAMAKNEN SELATAN, BELU, NUSA TENGGARA TIMUR",3,125,5,130
https://kawalpemilu.org#56016,"LUTHA  RATO, LAMAKNEN SELATAN, BELU, NUSA TENGGARA TIMUR",1,138,6,144
https://kawalpemilu.org#56016,"LUTHA  RATO, LAMAKNEN SELATAN, BELU, NUSA TENGGARA TIMUR",2,149,11,160
https://kawalpemilu.org#56016,"LUTHA  RATO, LAMAKNEN SELATAN, BELU, NUSA TENGGARA TIMUR",3,191,6,197
https://kawalpemilu.org#56032,"BARDAO, ATAMBUA BARAT, BELU, NUSA TENGGARA TIMUR",1,132,15,147
https://kawalpemilu.org#56032,"BARDAO, ATAMBUA BARAT, BELU, NUSA TENGGARA TIMUR",2,162,18,180
https://kawalpemilu.org#56032,"BARDAO, ATAMBUA BARAT, BELU, NUSA TENGGARA TIMUR",3,118,39,157
https://kawalpemilu.org#56032,"BARDAO, ATAMBUA BARAT, BELU, NUSA TENGGARA TIMUR",4,111,54,165
https://kawalpemilu.org#56032,"BARDAO, ATAMBUA BARAT, BELU, NUSA TENGGARA TIMUR",5,119,50,169
https://kawalpemilu.org#56032,"BARDAO, ATAMBUA BARAT, BELU, NUSA TENGGARA TIMUR",6,100,32,132
https://kawalpemilu.org#56032,"BARDAO, ATAMBUA BARAT, BELU, NUSA TENGGARA TIMUR",7,117,23,140
https://kawalpemilu.org#56032,"BARDAO, ATAMBUA BARAT, BELU, NUSA TENGGARA TIMUR",8,103,61,164
https://kawalpemilu.org#56032,"BARDAO, ATAMBUA BARAT, BELU, NUSA TENGGARA TIMUR",9,71,75,146
https://kawalpemilu.org#56032,"BARDAO, ATAMBUA BARAT, BELU, NUSA TENGGARA TIMUR",10,155,21,176
https://kawalpemilu.org#56032,"BARDAO, ATAMBUA BARAT, BELU, NUSA TENGGARA TIMUR",11,151,49,200
https://kawalpemilu.org#56032,"BARDAO, ATAMBUA BARAT, BELU, NUSA TENGGARA TIMUR",12,84,33,117
https://kawalpemilu.org#56033,"TULAMALAE, ATAMBUA BARAT, BELU, NUSA TENGGARA TIMUR",1,170,20,190
https://kawalpemilu.org#56033,"TULAMALAE, ATAMBUA BARAT, BELU, NUSA TENGGARA TIMUR",2,121,15,136
https://kawalpemilu.org#56033,"TULAMALAE, ATAMBUA BARAT, BELU, NUSA TENGGARA TIMUR",3,145,14,159
https://kawalpemilu.org#56033,"TULAMALAE, ATAMBUA BARAT, BELU, NUSA TENGGARA TIMUR",4,163,11,174
https://kawalpemilu.org#56033,"TULAMALAE, ATAMBUA BARAT, BELU, NUSA TENGGARA TIMUR",5,190,13,203
https://kawalpemilu.org#56033,"TULAMALAE, ATAMBUA BARAT, BELU, NUSA TENGGARA TIMUR",6,155,6,161
https://kawalpemilu.org#56033,"TULAMALAE, ATAMBUA BARAT, BELU, NUSA TENGGARA TIMUR",7,204,17,221
https://kawalpemilu.org#56033,"TULAMALAE, ATAMBUA BARAT, BELU, NUSA TENGGARA TIMUR",8,183,10,193
https://kawalpemilu.org#56033,"TULAMALAE, ATAMBUA BARAT, BELU, NUSA TENGGARA TIMUR",9,186,30,216
https://kawalpemilu.org#56033,"TULAMALAE, ATAMBUA BARAT, BELU, NUSA TENGGARA TIMUR",10,196,13,209
https://kawalpemilu.org#56033,"TULAMALAE, ATAMBUA BARAT, BELU, NUSA TENGGARA TIMUR",11,174,20,194
https://kawalpemilu.org#56033,"TULAMALAE, ATAMBUA BARAT, BELU, NUSA TENGGARA TIMUR",12,149,10,159
https://kawalpemilu.org#56033,"TULAMALAE, ATAMBUA BARAT, BELU, NUSA TENGGARA TIMUR",13,197,3,200
https://kawalpemilu.org#56033,"TULAMALAE, ATAMBUA BARAT, BELU, NUSA TENGGARA TIMUR",14,113,31,144
https://kawalpemilu.org#56034,"UMANEN, ATAMBUA BARAT, BELU, NUSA TENGGARA TIMUR",1,119,30,149
https://kawalpemilu.org#56034,"UMANEN, ATAMBUA BARAT, BELU, NUSA TENGGARA TIMUR",2,109,37,146
https://kawalpemilu.org#56034,"UMANEN, ATAMBUA BARAT, BELU, NUSA TENGGARA TIMUR",3,129,27,156
https://kawalpemilu.org#56034,"UMANEN, ATAMBUA BARAT, BELU, NUSA TENGGARA TIMUR",4,124,25,149
https://kawalpemilu.org#56034,"UMANEN, ATAMBUA BARAT, BELU, NUSA TENGGARA TIMUR",5,148,39,187
https://kawalpemilu.org#56034,"UMANEN, ATAMBUA BARAT, BELU, NUSA TENGGARA TIMUR",6,121,14,135
https://kawalpemilu.org#56034,"UMANEN, ATAMBUA BARAT, BELU, NUSA TENGGARA TIMUR",7,85,38,123
https://kawalpemilu.org#56034,"UMANEN, ATAMBUA BARAT, BELU, NUSA TENGGARA TIMUR",8,79,39,118
https://kawalpemilu.org#56034,"UMANEN, ATAMBUA BARAT, BELU, NUSA TENGGARA TIMUR",9,128,19,147
https://kawalpemilu.org#56034,"UMANEN, ATAMBUA BARAT, BELU, NUSA TENGGARA TIMUR",10,103,25,128
https://kawalpemilu.org#56034,"UMANEN, ATAMBUA BARAT, BELU, NUSA TENGGARA TIMUR",11,111,30,141
https://kawalpemilu.org#56034,"UMANEN, ATAMBUA BARAT, BELU, NUSA TENGGARA TIMUR",12,117,12,129
https://kawalpemilu.org#56034,"UMANEN, ATAMBUA BARAT, BELU, NUSA TENGGARA TIMUR",13,125,21,146
https://kawalpemilu.org#56034,"UMANEN, ATAMBUA BARAT, BELU, NUSA TENGGARA TIMUR",14,97,13,110
https://kawalpemilu.org#56034,"UMANEN, ATAMBUA BARAT, BELU, NUSA TENGGARA TIMUR",15,150,19,169
https://kawalpemilu.org#56034,"UMANEN, ATAMBUA BARAT, BELU, NUSA TENGGARA TIMUR",16,164,26,190
https://kawalpemilu.org#56034,"UMANEN, ATAMBUA BARAT, BELU, NUSA TENGGARA TIMUR",17,130,36,166
https://kawalpemilu.org#56034,"UMANEN, ATAMBUA BARAT, BELU, NUSA TENGGARA TIMUR",18,178,3,181
https://kawalpemilu.org#56034,"UMANEN, ATAMBUA BARAT, BELU, NUSA TENGGARA TIMUR",19,190,14,204
https://kawalpemilu.org#56034,"UMANEN, ATAMBUA BARAT, BELU, NUSA TENGGARA TIMUR",20,159,7,166
https://kawalpemilu.org#56034,"UMANEN, ATAMBUA BARAT, BELU, NUSA TENGGARA TIMUR",21,187,17,204
https://kawalpemilu.org#56034,"UMANEN, ATAMBUA BARAT, BELU, NUSA TENGGARA TIMUR",22,180,12,192
https://kawalpemilu.org#56034,"UMANEN, ATAMBUA BARAT, BELU, NUSA TENGGARA TIMUR",23,127,12,139
https://kawalpemilu.org#56034,"UMANEN, ATAMBUA BARAT, BELU, NUSA TENGGARA TIMUR",24,113,12,125
https://kawalpemilu.org#56034,"UMANEN, ATAMBUA BARAT, BELU, NUSA TENGGARA TIMUR",25,127,11,138
https://kawalpemilu.org#56035,"BEIRAFU, ATAMBUA BARAT, BELU, NUSA TENGGARA TIMUR",1,81,69,150
https://kawalpemilu.org#56035,"BEIRAFU, ATAMBUA BARAT, BELU, NUSA TENGGARA TIMUR",2,155,53,208
https://kawalpemilu.org#56035,"BEIRAFU, ATAMBUA BARAT, BELU, NUSA TENGGARA TIMUR",3,148,65,213
https://kawalpemilu.org#56035,"BEIRAFU, ATAMBUA BARAT, BELU, NUSA TENGGARA TIMUR",4,124,59,183
https://kawalpemilu.org#56035,"BEIRAFU, ATAMBUA BARAT, BELU, NUSA TENGGARA TIMUR",5,177,45,222
https://kawalpemilu.org#56035,"BEIRAFU, ATAMBUA BARAT, BELU, NUSA TENGGARA TIMUR",6,99,23,122
https://kawalpemilu.org#56035,"BEIRAFU, ATAMBUA BARAT, BELU, NUSA TENGGARA TIMUR",7,141,16,157
https://kawalpemilu.org#56035,"BEIRAFU, ATAMBUA BARAT, BELU, NUSA TENGGARA TIMUR",8,92,18,110
https://kawalpemilu.org#56035,"BEIRAFU, ATAMBUA BARAT, BELU, NUSA TENGGARA TIMUR",9,141,23,164
https://kawalpemilu.org#56035,"BEIRAFU, ATAMBUA BARAT, BELU, NUSA TENGGARA TIMUR",10,150,21,171
https://kawalpemilu.org#56035,"BEIRAFU, ATAMBUA BARAT, BELU, NUSA TENGGARA TIMUR",11,147,31,178
https://kawalpemilu.org#56035,"BEIRAFU, ATAMBUA BARAT, BELU, NUSA TENGGARA TIMUR",12,77,22,99
https://kawalpemilu.org#56035,"BEIRAFU, ATAMBUA BARAT, BELU, NUSA TENGGARA TIMUR",13,184,25,209
https://kawalpemilu.org#56035,"BEIRAFU, ATAMBUA BARAT, BELU, NUSA TENGGARA TIMUR",14,131,19,150
https://kawalpemilu.org#56037,"MANUAMAN, ATAMBUA SELATAN, BELU, NUSA TENGGARA TIMUR",1,148,44,192
https://kawalpemilu.org#56037,"MANUAMAN, ATAMBUA SELATAN, BELU, NUSA TENGGARA TIMUR",2,173,48,221
https://kawalpemilu.org#56037,"MANUAMAN, ATAMBUA SELATAN, BELU, NUSA TENGGARA TIMUR",3,169,60,229
https://kawalpemilu.org#56037,"MANUAMAN, ATAMBUA SELATAN, BELU, NUSA TENGGARA TIMUR",4,195,11,206
https://kawalpemilu.org#56037,"MANUAMAN, ATAMBUA SELATAN, BELU, NUSA TENGGARA TIMUR",5,162,38,200
https://kawalpemilu.org#56037,"MANUAMAN, ATAMBUA SELATAN, BELU, NUSA TENGGARA TIMUR",6,181,17,198
https://kawalpemilu.org#56037,"MANUAMAN, ATAMBUA SELATAN, BELU, NUSA TENGGARA TIMUR",7,127,89,216
https://kawalpemilu.org#56037,"MANUAMAN, ATAMBUA SELATAN, BELU, NUSA TENGGARA TIMUR",8,190,25,215
https://kawalpemilu.org#56037,"MANUAMAN, ATAMBUA SELATAN, BELU, NUSA TENGGARA TIMUR",9,189,39,228
https://kawalpemilu.org#56037,"MANUAMAN, ATAMBUA SELATAN, BELU, NUSA TENGGARA TIMUR",10,164,24,188
https://kawalpemilu.org#56037,"MANUAMAN, ATAMBUA SELATAN, BELU, NUSA TENGGARA TIMUR",11,177,39,216
https://kawalpemilu.org#56037,"MANUAMAN, ATAMBUA SELATAN, BELU, NUSA TENGGARA TIMUR",12,151,35,186
https://kawalpemilu.org#56037,"MANUAMAN, ATAMBUA SELATAN, BELU, NUSA TENGGARA TIMUR",13,157,20,177
https://kawalpemilu.org#56037,"MANUAMAN, ATAMBUA SELATAN, BELU, NUSA TENGGARA TIMUR",14,167,5,172
https://kawalpemilu.org#56037,"MANUAMAN, ATAMBUA SELATAN, BELU, NUSA TENGGARA TIMUR",15,109,81,190
https://kawalpemilu.org#56037,"MANUAMAN, ATAMBUA SELATAN, BELU, NUSA TENGGARA TIMUR",16,129,45,174
https://kawalpemilu.org#56037,"MANUAMAN, ATAMBUA SELATAN, BELU, NUSA TENGGARA TIMUR",17,185,14,199
https://kawalpemilu.org#56037,"MANUAMAN, ATAMBUA SELATAN, BELU, NUSA TENGGARA TIMUR",18,124,55,179
https://kawalpemilu.org#56038,"RINBESI, ATAMBUA SELATAN, BELU, NUSA TENGGARA TIMUR",1,152,8,160
https://kawalpemilu.org#56038,"RINBESI, ATAMBUA SELATAN, BELU, NUSA TENGGARA TIMUR",2,142,24,166
https://kawalpemilu.org#56038,"RINBESI, ATAMBUA SELATAN, BELU, NUSA TENGGARA TIMUR",3,172,11,183
https://kawalpemilu.org#56038,"RINBESI, ATAMBUA SELATAN, BELU, NUSA TENGGARA TIMUR",4,161,15,176
https://kawalpemilu.org#56038,"RINBESI, ATAMBUA SELATAN, BELU, NUSA TENGGARA TIMUR",5,159,18,177
https://kawalpemilu.org#56038,"RINBESI, ATAMBUA SELATAN, BELU, NUSA TENGGARA TIMUR",6,171,20,191
https://kawalpemilu.org#56038,"RINBESI, ATAMBUA SELATAN, BELU, NUSA TENGGARA TIMUR",8,169,28,197
https://kawalpemilu.org#56038,"RINBESI, ATAMBUA SELATAN, BELU, NUSA TENGGARA TIMUR",9,195,12,207
https://kawalpemilu.org#56039,"LIDAK, ATAMBUA SELATAN, BELU, NUSA TENGGARA TIMUR",1,176,17,193
https://kawalpemilu.org#56039,"LIDAK, ATAMBUA SELATAN, BELU, NUSA TENGGARA TIMUR",2,189,10,199
https://kawalpemilu.org#56039,"LIDAK, ATAMBUA SELATAN, BELU, NUSA TENGGARA TIMUR",3,158,26,184
https://kawalpemilu.org#56039,"LIDAK, ATAMBUA SELATAN, BELU, NUSA TENGGARA TIMUR",4,132,63,195
https://kawalpemilu.org#56039,"LIDAK, ATAMBUA SELATAN, BELU, NUSA TENGGARA TIMUR",5,177,24,201
https://kawalpemilu.org#56039,"LIDAK, ATAMBUA SELATAN, BELU, NUSA TENGGARA TIMUR",6,137,22,159
https://kawalpemilu.org#56039,"LIDAK, ATAMBUA SELATAN, BELU, NUSA TENGGARA TIMUR",7,181,18,199
https://kawalpemilu.org#56039,"LIDAK, ATAMBUA SELATAN, BELU, NUSA TENGGARA TIMUR",8,193,8,201
https://kawalpemilu.org#56039,"LIDAK, ATAMBUA SELATAN, BELU, NUSA TENGGARA TIMUR",9,163,20,183
https://kawalpemilu.org#56039,"LIDAK, ATAMBUA SELATAN, BELU, NUSA TENGGARA TIMUR",10,152,16,168
https://kawalpemilu.org#56039,"LIDAK, ATAMBUA SELATAN, BELU, NUSA TENGGARA TIMUR",11,150,20,170
https://kawalpemilu.org#56039,"LIDAK, ATAMBUA SELATAN, BELU, NUSA TENGGARA TIMUR",12,168,14,182
https://kawalpemilu.org#56039,"LIDAK, ATAMBUA SELATAN, BELU, NUSA TENGGARA TIMUR",13,176,14,190
https://kawalpemilu.org#56039,"LIDAK, ATAMBUA SELATAN, BELU, NUSA TENGGARA TIMUR",14,178,10,188
https://kawalpemilu.org#56040,"FATUKBOT, ATAMBUA SELATAN, BELU, NUSA TENGGARA TIMUR",1,153,52,205
https://kawalpemilu.org#56040,"FATUKBOT, ATAMBUA SELATAN, BELU, NUSA TENGGARA TIMUR",2,160,16,176
https://kawalpemilu.org#56040,"FATUKBOT, ATAMBUA SELATAN, BELU, NUSA TENGGARA TIMUR",3,191,21,212
https://kawalpemilu.org#56040,"FATUKBOT, ATAMBUA SELATAN, BELU, NUSA TENGGARA TIMUR",4,179,14,193
https://kawalpemilu.org#56040,"FATUKBOT, ATAMBUA SELATAN, BELU, NUSA TENGGARA TIMUR",5,177,6,183
https://kawalpemilu.org#56040,"FATUKBOT, ATAMBUA SELATAN, BELU, NUSA TENGGARA TIMUR",6,175,13,188
https://kawalpemilu.org#56040,"FATUKBOT, ATAMBUA SELATAN, BELU, NUSA TENGGARA TIMUR",7,196,11,207
https://kawalpemilu.org#56040,"FATUKBOT, ATAMBUA SELATAN, BELU, NUSA TENGGARA TIMUR",8,194,12,206
https://kawalpemilu.org#56040,"FATUKBOT, ATAMBUA SELATAN, BELU, NUSA TENGGARA TIMUR",9,189,19,208
https://kawalpemilu.org#56040,"FATUKBOT, ATAMBUA SELATAN, BELU, NUSA TENGGARA TIMUR",10,50,92,142
https://kawalpemilu.org#56040,"FATUKBOT, ATAMBUA SELATAN, BELU, NUSA TENGGARA TIMUR",11,43,102,145
https://kawalpemilu.org#56040,"FATUKBOT, ATAMBUA SELATAN, BELU, NUSA TENGGARA TIMUR",12,56,96,152
https://kawalpemilu.org#56040,"FATUKBOT, ATAMBUA SELATAN, BELU, NUSA TENGGARA TIMUR",13,92,82,174
https://kawalpemilu.org#56040,"FATUKBOT, ATAMBUA SELATAN, BELU, NUSA TENGGARA TIMUR",14,155,29,184
https://kawalpemilu.org#56040,"FATUKBOT, ATAMBUA SELATAN, BELU, NUSA TENGGARA TIMUR",15,152,28,180
https://kawalpemilu.org#56040,"FATUKBOT, ATAMBUA SELATAN, BELU, NUSA TENGGARA TIMUR",16,117,75,192
https://kawalpemilu.org#56040,"FATUKBOT, ATAMBUA SELATAN, BELU, NUSA TENGGARA TIMUR",17,148,24,172
https://kawalpemilu.org#56040,"FATUKBOT, ATAMBUA SELATAN, BELU, NUSA TENGGARA TIMUR",18,187,41,228
https://kawalpemilu.org#56040,"FATUKBOT, ATAMBUA SELATAN, BELU, NUSA TENGGARA TIMUR",19,185,27,212
https://kawalpemilu.org#56040,"FATUKBOT, ATAMBUA SELATAN, BELU, NUSA TENGGARA TIMUR",20,156,45,201
https://kawalpemilu.org#56040,"FATUKBOT, ATAMBUA SELATAN, BELU, NUSA TENGGARA TIMUR",21,134,33,167
https://kawalpemilu.org#56040,"FATUKBOT, ATAMBUA SELATAN, BELU, NUSA TENGGARA TIMUR",22,72,71,143
https://kawalpemilu.org#55858,"DUBESI, NANAET DUABESI, BELU, NUSA TENGGARA TIMUR",1,107,18,125
https://kawalpemilu.org#55858,"DUBESI, NANAET DUABESI, BELU, NUSA TENGGARA TIMUR",2,123,11,134
https://kawalpemilu.org#55858,"DUBESI, NANAET DUABESI, BELU, NUSA TENGGARA TIMUR",3,104,2,106
https://kawalpemilu.org#55858,"DUBESI, NANAET DUABESI, BELU, NUSA TENGGARA TIMUR",4,106,9,115
https://kawalpemilu.org#55858,"DUBESI, NANAET DUABESI, BELU, NUSA TENGGARA TIMUR",5,117,11,128
https://kawalpemilu.org#56043,"NANAET, NANAET DUABESI, BELU, NUSA TENGGARA TIMUR",1,107,4,111
https://kawalpemilu.org#56043,"NANAET, NANAET DUABESI, BELU, NUSA TENGGARA TIMUR",2,96,5,101
https://kawalpemilu.org#56043,"NANAET, NANAET DUABESI, BELU, NUSA TENGGARA TIMUR",3,78,5,83
https://kawalpemilu.org#56043,"NANAET, NANAET DUABESI, BELU, NUSA TENGGARA TIMUR",4,118,4,122
https://kawalpemilu.org#56043,"NANAET, NANAET DUABESI, BELU, NUSA TENGGARA TIMUR",5,78,9,87
https://kawalpemilu.org#56044,"FOHOEKA, NANAET DUABESI, BELU, NUSA TENGGARA TIMUR",1,127,5,132
https://kawalpemilu.org#56044,"FOHOEKA, NANAET DUABESI, BELU, NUSA TENGGARA TIMUR",2,148,8,156
https://kawalpemilu.org#56044,"FOHOEKA, NANAET DUABESI, BELU, NUSA TENGGARA TIMUR",3,156,5,161
https://kawalpemilu.org#56044,"FOHOEKA, NANAET DUABESI, BELU, NUSA TENGGARA TIMUR",4,84,4,88
https://kawalpemilu.org#56044,"FOHOEKA, NANAET DUABESI, BELU, NUSA TENGGARA TIMUR",5,88,3,91
https://kawalpemilu.org#56045,"NANAENOE, NANAET DUABESI, BELU, NUSA TENGGARA TIMUR",1,168,9,177
https://kawalpemilu.org#56045,"NANAENOE, NANAET DUABESI, BELU, NUSA TENGGARA TIMUR",2,122,7,129
https://kawalpemilu.org#56045,"NANAENOE, NANAET DUABESI, BELU, NUSA TENGGARA TIMUR",3,131,5,136
https://kawalpemilu.org#56053,"KALABAHI BARAT, TELUK MUTIARA, ALOR, NUSA TENGGARA TIMUR",1,153,9,162
https://kawalpemilu.org#56053,"KALABAHI BARAT, TELUK MUTIARA, ALOR, NUSA TENGGARA TIMUR",2,168,60,228
https://kawalpemilu.org#56053,"KALABAHI BARAT, TELUK MUTIARA, ALOR, NUSA TENGGARA TIMUR",3,181,13,194
https://kawalpemilu.org#56053,"KALABAHI BARAT, TELUK MUTIARA, ALOR, NUSA TENGGARA TIMUR",4,206,16,224
https://kawalpemilu.org#56053,"KALABAHI BARAT, TELUK MUTIARA, ALOR, NUSA TENGGARA TIMUR",5,212,19,231
https://kawalpemilu.org#56053,"KALABAHI BARAT, TELUK MUTIARA, ALOR, NUSA TENGGARA TIMUR",6,9,161,170
https://kawalpemilu.org#56053,"KALABAHI BARAT, TELUK MUTIARA, ALOR, NUSA TENGGARA TIMUR",7,228,12,240
https://kawalpemilu.org#56053,"KALABAHI BARAT, TELUK MUTIARA, ALOR, NUSA TENGGARA TIMUR",8,153,54,207
https://kawalpemilu.org#56053,"KALABAHI BARAT, TELUK MUTIARA, ALOR, NUSA TENGGARA TIMUR",9,133,10,143
https://kawalpemilu.org#56053,"KALABAHI BARAT, TELUK MUTIARA, ALOR, NUSA TENGGARA TIMUR",10,178,16,194
https://kawalpemilu.org#56053,"KALABAHI BARAT, TELUK MUTIARA, ALOR, NUSA TENGGARA TIMUR",11,11,164,175
https://kawalpemilu.org#56054,"KALABAHI KOTA, TELUK MUTIARA, ALOR, NUSA TENGGARA TIMUR",1,144,13,157
https://kawalpemilu.org#56054,"KALABAHI KOTA, TELUK MUTIARA, ALOR, NUSA TENGGARA TIMUR",2,137,39,176
https://kawalpemilu.org#56054,"KALABAHI KOTA, TELUK MUTIARA, ALOR, NUSA TENGGARA TIMUR",3,48,141,189
https://kawalpemilu.org#56054,"KALABAHI KOTA, TELUK MUTIARA, ALOR, NUSA TENGGARA TIMUR",4,49,122,171
https://kawalpemilu.org#56054,"KALABAHI KOTA, TELUK MUTIARA, ALOR, NUSA TENGGARA TIMUR",5,58,70,128
https://kawalpemilu.org#56054,"KALABAHI KOTA, TELUK MUTIARA, ALOR, NUSA TENGGARA TIMUR",6,146,28,174
https://kawalpemilu.org#56054,"KALABAHI KOTA, TELUK MUTIARA, ALOR, NUSA TENGGARA TIMUR",8,157,15,172
https://kawalpemilu.org#56054,"KALABAHI KOTA, TELUK MUTIARA, ALOR, NUSA TENGGARA TIMUR",9,176,21,197
https://kawalpemilu.org#56055,"KALABAHI TENGAH, TELUK MUTIARA, ALOR, NUSA TENGGARA TIMUR",1,136,3,139
https://kawalpemilu.org#56055,"KALABAHI TENGAH, TELUK MUTIARA, ALOR, NUSA TENGGARA TIMUR",2,128,25,153
https://kawalpemilu.org#56055,"KALABAHI TENGAH, TELUK MUTIARA, ALOR, NUSA TENGGARA TIMUR",3,96,12,108
https://kawalpemilu.org#56055,"KALABAHI TENGAH, TELUK MUTIARA, ALOR, NUSA TENGGARA TIMUR",4,45,8,53
https://kawalpemilu.org#56055,"KALABAHI TENGAH, TELUK MUTIARA, ALOR, NUSA TENGGARA TIMUR",5,105,23,128
https://kawalpemilu.org#56055,"KALABAHI TENGAH, TELUK MUTIARA, ALOR, NUSA TENGGARA TIMUR",6,210,34,244
https://kawalpemilu.org#56055,"KALABAHI TENGAH, TELUK MUTIARA, ALOR, NUSA TENGGARA TIMUR",7,182,70,252
https://kawalpemilu.org#56055,"KALABAHI TENGAH, TELUK MUTIARA, ALOR, NUSA TENGGARA TIMUR",8,136,57,196
https://kawalpemilu.org#56055,"KALABAHI TENGAH, TELUK MUTIARA, ALOR, NUSA TENGGARA TIMUR",9,69,82,151
https://kawalpemilu.org#56055,"KALABAHI TENGAH, TELUK MUTIARA, ALOR, NUSA TENGGARA TIMUR",10,87,42,129
https://kawalpemilu.org#56055,"KALABAHI TENGAH, TELUK MUTIARA, ALOR, NUSA TENGGARA TIMUR",11,169,78,247
https://kawalpemilu.org#56055,"KALABAHI TENGAH, TELUK MUTIARA, ALOR, NUSA TENGGARA TIMUR",12,68,58,126
https://kawalpemilu.org#56055,"KALABAHI TENGAH, TELUK MUTIARA, ALOR, NUSA TENGGARA TIMUR",13,140,11,151
https://kawalpemilu.org#56055,"KALABAHI TENGAH, TELUK MUTIARA, ALOR, NUSA TENGGARA TIMUR",14,151,22,173
https://kawalpemilu.org#56055,"KALABAHI TENGAH, TELUK MUTIARA, ALOR, NUSA TENGGARA TIMUR",15,109,24,133
https://kawalpemilu.org#56055,"KALABAHI TENGAH, TELUK MUTIARA, ALOR, NUSA TENGGARA TIMUR",16,96,25,121
https://kawalpemilu.org#56055,"KALABAHI TENGAH, TELUK MUTIARA, ALOR, NUSA TENGGARA TIMUR",17,120,20,140
https://kawalpemilu.org#56055,"KALABAHI TENGAH, TELUK MUTIARA, ALOR, NUSA TENGGARA TIMUR",18,104,55,159
https://kawalpemilu.org#56055,"KALABAHI TENGAH, TELUK MUTIARA, ALOR, NUSA TENGGARA TIMUR",19,109,27,136
https://kawalpemilu.org#56055,"KALABAHI TENGAH, TELUK MUTIARA, ALOR, NUSA TENGGARA TIMUR",20,97,52,149
https://kawalpemilu.org#56056,"KALABAHI TIMUR, TELUK MUTIARA, ALOR, NUSA TENGGARA TIMUR",1,86,119,205
https://kawalpemilu.org#56056,"KALABAHI TIMUR, TELUK MUTIARA, ALOR, NUSA TENGGARA TIMUR",2,87,76,163
https://kawalpemilu.org#56056,"KALABAHI TIMUR, TELUK MUTIARA, ALOR, NUSA TENGGARA TIMUR",3,127,17,144
https://kawalpemilu.org#56056,"KALABAHI TIMUR, TELUK MUTIARA, ALOR, NUSA TENGGARA TIMUR",4,93,31,124
https://kawalpemilu.org#56056,"KALABAHI TIMUR, TELUK MUTIARA, ALOR, NUSA TENGGARA TIMUR",5,114,76,190
https://kawalpemilu.org#56056,"KALABAHI TIMUR, TELUK MUTIARA, ALOR, NUSA TENGGARA TIMUR",6,88,22,110
https://kawalpemilu.org#56056,"KALABAHI TIMUR, TELUK MUTIARA, ALOR, NUSA TENGGARA TIMUR",7,49,184,233
https://kawalpemilu.org#56056,"KALABAHI TIMUR, TELUK MUTIARA, ALOR, NUSA TENGGARA TIMUR",8,27,157,184
https://kawalpemilu.org#56056,"KALABAHI TIMUR, TELUK MUTIARA, ALOR, NUSA TENGGARA TIMUR",9,41,139,180
https://kawalpemilu.org#56056,"KALABAHI TIMUR, TELUK MUTIARA, ALOR, NUSA TENGGARA TIMUR",10,55,72,127
https://kawalpemilu.org#56056,"KALABAHI TIMUR, TELUK MUTIARA, ALOR, NUSA TENGGARA TIMUR",11,42,133,175
https://kawalpemilu.org#56056,"KALABAHI TIMUR, TELUK MUTIARA, ALOR, NUSA TENGGARA TIMUR",12,151,27,178
https://kawalpemilu.org#56056,"KALABAHI TIMUR, TELUK MUTIARA, ALOR, NUSA TENGGARA TIMUR",13,90,39,129
https://kawalpemilu.org#56056,"KALABAHI TIMUR, TELUK MUTIARA, ALOR, NUSA TENGGARA TIMUR",14,60,13,73
https://kawalpemilu.org#56056,"KALABAHI TIMUR, TELUK MUTIARA, ALOR, NUSA TENGGARA TIMUR",15,135,20,155
https://kawalpemilu.org#56056,"KALABAHI TIMUR, TELUK MUTIARA, ALOR, NUSA TENGGARA TIMUR",16,97,26,123
https://kawalpemilu.org#56056,"KALABAHI TIMUR, TELUK MUTIARA, ALOR, NUSA TENGGARA TIMUR",17,81,35,116
https://kawalpemilu.org#56056,"KALABAHI TIMUR, TELUK MUTIARA, ALOR, NUSA TENGGARA TIMUR",18,30,142,172
https://kawalpemilu.org#56056,"KALABAHI TIMUR, TELUK MUTIARA, ALOR, NUSA TENGGARA TIMUR",19,46,121,167
https://kawalpemilu.org#56056,"KALABAHI TIMUR, TELUK MUTIARA, ALOR, NUSA TENGGARA TIMUR",20,50,111,161
https://kawalpemilu.org#56057,"BINONGKO, TELUK MUTIARA, ALOR, NUSA TENGGARA TIMUR",1,86,155,241
https://kawalpemilu.org#56057,"BINONGKO, TELUK MUTIARA, ALOR, NUSA TENGGARA TIMUR",2,51,133,184
https://kawalpemilu.org#56057,"BINONGKO, TELUK MUTIARA, ALOR, NUSA TENGGARA TIMUR",3,58,171,229
https://kawalpemilu.org#56057,"BINONGKO, TELUK MUTIARA, ALOR, NUSA TENGGARA TIMUR",4,72,166,238
https://kawalpemilu.org#56057,"BINONGKO, TELUK MUTIARA, ALOR, NUSA TENGGARA TIMUR",5,40,212,252
https://kawalpemilu.org#56057,"BINONGKO, TELUK MUTIARA, ALOR, NUSA TENGGARA TIMUR",6,18,170,188
https://kawalpemilu.org#56057,"BINONGKO, TELUK MUTIARA, ALOR, NUSA TENGGARA TIMUR",7,39,133,172
https://kawalpemilu.org#56057,"BINONGKO, TELUK MUTIARA, ALOR, NUSA TENGGARA TIMUR",8,39,138,177
https://kawalpemilu.org#56058,"NUSA KENARI, TELUK MUTIARA, ALOR, NUSA TENGGARA TIMUR",1,35,108,143
https://kawalpemilu.org#56058,"NUSA KENARI, TELUK MUTIARA, ALOR, NUSA TENGGARA TIMUR",2,90,7,97
https://kawalpemilu.org#56058,"NUSA KENARI, TELUK MUTIARA, ALOR, NUSA TENGGARA TIMUR",3,129,48,177
https://kawalpemilu.org#56058,"NUSA KENARI, TELUK MUTIARA, ALOR, NUSA TENGGARA TIMUR",4,77,41,118
https://kawalpemilu.org#56058,"NUSA KENARI, TELUK MUTIARA, ALOR, NUSA TENGGARA TIMUR",5,136,26,162
https://kawalpemilu.org#56058,"NUSA KENARI, TELUK MUTIARA, ALOR, NUSA TENGGARA TIMUR",6,87,95,182
https://kawalpemilu.org#56058,"NUSA KENARI, TELUK MUTIARA, ALOR, NUSA TENGGARA TIMUR",7,112,131,243
https://kawalpemilu.org#56058,"NUSA KENARI, TELUK MUTIARA, ALOR, NUSA TENGGARA TIMUR",8,152,76,228
https://kawalpemilu.org#56058,"NUSA KENARI, TELUK MUTIARA, ALOR, NUSA TENGGARA TIMUR",9,173,46,219
https://kawalpemilu.org#56058,"NUSA KENARI, TELUK MUTIARA, ALOR, NUSA TENGGARA TIMUR",10,121,23,144
https://kawalpemilu.org#56059,"WELAI BARAT, TELUK MUTIARA, ALOR, NUSA TENGGARA TIMUR",1,129,34,163
https://kawalpemilu.org#56059,"WELAI BARAT, TELUK MUTIARA, ALOR, NUSA TENGGARA TIMUR",2,123,16,139
https://kawalpemilu.org#56059,"WELAI BARAT, TELUK MUTIARA, ALOR, NUSA TENGGARA TIMUR",3,141,61,202
https://kawalpemilu.org#56059,"WELAI BARAT, TELUK MUTIARA, ALOR, NUSA TENGGARA TIMUR",4,149,14,163
https://kawalpemilu.org#56059,"WELAI BARAT, TELUK MUTIARA, ALOR, NUSA TENGGARA TIMUR",5,153,13,166
https://kawalpemilu.org#56059,"WELAI BARAT, TELUK MUTIARA, ALOR, NUSA TENGGARA TIMUR",6,130,34,164
https://kawalpemilu.org#56059,"WELAI BARAT, TELUK MUTIARA, ALOR, NUSA TENGGARA TIMUR",7,124,22,146
https://kawalpemilu.org#56059,"WELAI BARAT, TELUK MUTIARA, ALOR, NUSA TENGGARA TIMUR",8,156,57,213
https://kawalpemilu.org#56059,"WELAI BARAT, TELUK MUTIARA, ALOR, NUSA TENGGARA TIMUR",9,152,11,163
https://kawalpemilu.org#56059,"WELAI BARAT, TELUK MUTIARA, ALOR, NUSA TENGGARA TIMUR",10,138,25,163
https://kawalpemilu.org#56060,"WELAI TIMUR, TELUK MUTIARA, ALOR, NUSA TENGGARA TIMUR",1,101,13,114
https://kawalpemilu.org#56060,"WELAI TIMUR, TELUK MUTIARA, ALOR, NUSA TENGGARA TIMUR",3,120,25,145
https://kawalpemilu.org#56060,"WELAI TIMUR, TELUK MUTIARA, ALOR, NUSA TENGGARA TIMUR",4,167,41,208
https://kawalpemilu.org#56060,"WELAI TIMUR, TELUK MUTIARA, ALOR, NUSA TENGGARA TIMUR",5,141,30,171
https://kawalpemilu.org#56060,"WELAI TIMUR, TELUK MUTIARA, ALOR, NUSA TENGGARA TIMUR",6,137,36,173
https://kawalpemilu.org#56060,"WELAI TIMUR, TELUK MUTIARA, ALOR, NUSA TENGGARA TIMUR",7,130,17,147
https://kawalpemilu.org#56060,"WELAI TIMUR, TELUK MUTIARA, ALOR, NUSA TENGGARA TIMUR",8,164,35,199
https://kawalpemilu.org#56060,"WELAI TIMUR, TELUK MUTIARA, ALOR, NUSA TENGGARA TIMUR",9,121,15,136
https://kawalpemilu.org#56060,"WELAI TIMUR, TELUK MUTIARA, ALOR, NUSA TENGGARA TIMUR",10,65,48,113
https://kawalpemilu.org#56061,"MUTIARA, TELUK MUTIARA, ALOR, NUSA TENGGARA TIMUR",1,38,92,130
https://kawalpemilu.org#56061,"MUTIARA, TELUK MUTIARA, ALOR, NUSA TENGGARA TIMUR",2,97,49,146
https://kawalpemilu.org#56061,"MUTIARA, TELUK MUTIARA, ALOR, NUSA TENGGARA TIMUR",3,135,44,179
https://kawalpemilu.org#56061,"MUTIARA, TELUK MUTIARA, ALOR, NUSA TENGGARA TIMUR",4,90,48,138
https://kawalpemilu.org#56061,"MUTIARA, TELUK MUTIARA, ALOR, NUSA TENGGARA TIMUR",5,161,17,178
https://kawalpemilu.org#56061,"MUTIARA, TELUK MUTIARA, ALOR, NUSA TENGGARA TIMUR",7,190,24,214
https://kawalpemilu.org#56061,"MUTIARA, TELUK MUTIARA, ALOR, NUSA TENGGARA TIMUR",8,159,28,187
https://kawalpemilu.org#56061,"MUTIARA, TELUK MUTIARA, ALOR, NUSA TENGGARA TIMUR",9,112,30,142
https://kawalpemilu.org#56061,"MUTIARA, TELUK MUTIARA, ALOR, NUSA TENGGARA TIMUR",10,182,43,225
https://kawalpemilu.org#56061,"MUTIARA, TELUK MUTIARA, ALOR, NUSA TENGGARA TIMUR",11,92,37,129
https://kawalpemilu.org#56061,"MUTIARA, TELUK MUTIARA, ALOR, NUSA TENGGARA TIMUR",12,84,31,115
https://kawalpemilu.org#56061,"MUTIARA, TELUK MUTIARA, ALOR, NUSA TENGGARA TIMUR",13,125,23,148
https://kawalpemilu.org#56061,"MUTIARA, TELUK MUTIARA, ALOR, NUSA TENGGARA TIMUR",14,132,21,153
https://kawalpemilu.org#56061,"MUTIARA, TELUK MUTIARA, ALOR, NUSA TENGGARA TIMUR",15,186,40,226
https://kawalpemilu.org#56062,"WETABUA, TELUK MUTIARA, ALOR, NUSA TENGGARA TIMUR",1,27,212,239
https://kawalpemilu.org#56062,"WETABUA, TELUK MUTIARA, ALOR, NUSA TENGGARA TIMUR",2,22,216,238
https://kawalpemilu.org#56062,"WETABUA, TELUK MUTIARA, ALOR, NUSA TENGGARA TIMUR",3,18,230,248
https://kawalpemilu.org#56062,"WETABUA, TELUK MUTIARA, ALOR, NUSA TENGGARA TIMUR",4,112,81,193
https://kawalpemilu.org#56062,"WETABUA, TELUK MUTIARA, ALOR, NUSA TENGGARA TIMUR",5,73,101,174
https://kawalpemilu.org#56062,"WETABUA, TELUK MUTIARA, ALOR, NUSA TENGGARA TIMUR",6,78,87,165
https://kawalpemilu.org#56063,"AIR KENARI, TELUK MUTIARA, ALOR, NUSA TENGGARA TIMUR",1,80,110,190
https://kawalpemilu.org#56063,"AIR KENARI, TELUK MUTIARA, ALOR, NUSA TENGGARA TIMUR",2,88,88,176
https://kawalpemilu.org#56063,"AIR KENARI, TELUK MUTIARA, ALOR, NUSA TENGGARA TIMUR",3,206,32,238
https://kawalpemilu.org#56063,"AIR KENARI, TELUK MUTIARA, ALOR, NUSA TENGGARA TIMUR",4,159,20,179
https://kawalpemilu.org#56063,"AIR KENARI, TELUK MUTIARA, ALOR, NUSA TENGGARA TIMUR",5,205,15,220
https://kawalpemilu.org#56063,"AIR KENARI, TELUK MUTIARA, ALOR, NUSA TENGGARA TIMUR",6,176,12,188
https://kawalpemilu.org#56064,"TELUK KENARI, TELUK MUTIARA, ALOR, NUSA TENGGARA TIMUR",1,124,7,131
https://kawalpemilu.org#56064,"TELUK KENARI, TELUK MUTIARA, ALOR, NUSA TENGGARA TIMUR",2,116,12,128
https://kawalpemilu.org#56064,"TELUK KENARI, TELUK MUTIARA, ALOR, NUSA TENGGARA TIMUR",3,108,19,127
https://kawalpemilu.org#56064,"TELUK KENARI, TELUK MUTIARA, ALOR, NUSA TENGGARA TIMUR",4,125,12,137
https://kawalpemilu.org#56065,"LENDOLA, TELUK MUTIARA, ALOR, NUSA TENGGARA TIMUR",1,38,124,162
https://kawalpemilu.org#56065,"LENDOLA, TELUK MUTIARA, ALOR, NUSA TENGGARA TIMUR",2,80,54,134
https://kawalpemilu.org#56065,"LENDOLA, TELUK MUTIARA, ALOR, NUSA TENGGARA TIMUR",4,138,16,154
https://kawalpemilu.org#56065,"LENDOLA, TELUK MUTIARA, ALOR, NUSA TENGGARA TIMUR",5,107,16,123
https://kawalpemilu.org#56065,"LENDOLA, TELUK MUTIARA, ALOR, NUSA TENGGARA TIMUR",6,189,41,230
https://kawalpemilu.org#56065,"LENDOLA, TELUK MUTIARA, ALOR, NUSA TENGGARA TIMUR",7,63,96,159
https://kawalpemilu.org#56065,"LENDOLA, TELUK MUTIARA, ALOR, NUSA TENGGARA TIMUR",8,65,76,141
https://kawalpemilu.org#56065,"LENDOLA, TELUK MUTIARA, ALOR, NUSA TENGGARA TIMUR",9,68,50,118
https://kawalpemilu.org#56065,"LENDOLA, TELUK MUTIARA, ALOR, NUSA TENGGARA TIMUR",10,123,18,141
https://kawalpemilu.org#56065,"LENDOLA, TELUK MUTIARA, ALOR, NUSA TENGGARA TIMUR",11,123,39,162
https://kawalpemilu.org#56065,"LENDOLA, TELUK MUTIARA, ALOR, NUSA TENGGARA TIMUR",12,120,27,147
https://kawalpemilu.org#56065,"LENDOLA, TELUK MUTIARA, ALOR, NUSA TENGGARA TIMUR",13,44,3,47
https://kawalpemilu.org#56065,"LENDOLA, TELUK MUTIARA, ALOR, NUSA TENGGARA TIMUR",14,51,108,159
https://kawalpemilu.org#56066,"FANATING, TELUK MUTIARA, ALOR, NUSA TENGGARA TIMUR",1,106,13,119
https://kawalpemilu.org#56066,"FANATING, TELUK MUTIARA, ALOR, NUSA TENGGARA TIMUR",2,127,12,139
https://kawalpemilu.org#56066,"FANATING, TELUK MUTIARA, ALOR, NUSA TENGGARA TIMUR",3,141,4,145
https://kawalpemilu.org#56066,"FANATING, TELUK MUTIARA, ALOR, NUSA TENGGARA TIMUR",4,177,25,202
https://kawalpemilu.org#56066,"FANATING, TELUK MUTIARA, ALOR, NUSA TENGGARA TIMUR",5,101,12,113
https://kawalpemilu.org#56066,"FANATING, TELUK MUTIARA, ALOR, NUSA TENGGARA TIMUR",6,88,15,103
https://kawalpemilu.org#56066,"FANATING, TELUK MUTIARA, ALOR, NUSA TENGGARA TIMUR",7,130,15,145
https://kawalpemilu.org#56066,"FANATING, TELUK MUTIARA, ALOR, NUSA TENGGARA TIMUR",8,75,7,82
https://kawalpemilu.org#56067,"MOTONGBANG, TELUK MUTIARA, ALOR, NUSA TENGGARA TIMUR",1,81,57,138
https://kawalpemilu.org#56067,"MOTONGBANG, TELUK MUTIARA, ALOR, NUSA TENGGARA TIMUR",2,68,102,170
https://kawalpemilu.org#56067,"MOTONGBANG, TELUK MUTIARA, ALOR, NUSA TENGGARA TIMUR",3,86,47,133
https://kawalpemilu.org#56067,"MOTONGBANG, TELUK MUTIARA, ALOR, NUSA TENGGARA TIMUR",4,103,18,121
https://kawalpemilu.org#56067,"MOTONGBANG, TELUK MUTIARA, ALOR, NUSA TENGGARA TIMUR",5,123,110,233
https://kawalpemilu.org#56067,"MOTONGBANG, TELUK MUTIARA, ALOR, NUSA TENGGARA TIMUR",6,134,14,148
https://kawalpemilu.org#56067,"MOTONGBANG, TELUK MUTIARA, ALOR, NUSA TENGGARA TIMUR",7,102,53,155
https://kawalpemilu.org#56067,"MOTONGBANG, TELUK MUTIARA, ALOR, NUSA TENGGARA TIMUR",8,43,135,178
https://kawalpemilu.org#56067,"MOTONGBANG, TELUK MUTIARA, ALOR, NUSA TENGGARA TIMUR",9,103,27,130
https://kawalpemilu.org#56068,"ADANG BUOM, TELUK MUTIARA, ALOR, NUSA TENGGARA TIMUR",1,56,88,144
https://kawalpemilu.org#56068,"ADANG BUOM, TELUK MUTIARA, ALOR, NUSA TENGGARA TIMUR",2,165,70,235
https://kawalpemilu.org#56068,"ADANG BUOM, TELUK MUTIARA, ALOR, NUSA TENGGARA TIMUR",3,194,16,210
https://kawalpemilu.org#56068,"ADANG BUOM, TELUK MUTIARA, ALOR, NUSA TENGGARA TIMUR",4,108,28,136
https://kawalpemilu.org#56068,"ADANG BUOM, TELUK MUTIARA, ALOR, NUSA TENGGARA TIMUR",5,93,50,143
https://kawalpemilu.org#56068,"ADANG BUOM, TELUK MUTIARA, ALOR, NUSA TENGGARA TIMUR",6,83,46,129
https://kawalpemilu.org#56070,"ADANG, ALOR BARAT LAUT, ALOR, NUSA TENGGARA TIMUR",1,67,89,156
https://kawalpemilu.org#56070,"ADANG, ALOR BARAT LAUT, ALOR, NUSA TENGGARA TIMUR",2,192,9,201
https://kawalpemilu.org#56070,"ADANG, ALOR BARAT LAUT, ALOR, NUSA TENGGARA TIMUR",3,54,148,202
https://kawalpemilu.org#56070,"ADANG, ALOR BARAT LAUT, ALOR, NUSA TENGGARA TIMUR",4,188,8,196
https://kawalpemilu.org#56070,"ADANG, ALOR BARAT LAUT, ALOR, NUSA TENGGARA TIMUR",5,148,5,153
https://kawalpemilu.org#56070,"ADANG, ALOR BARAT LAUT, ALOR, NUSA TENGGARA TIMUR",6,148,5,153
https://kawalpemilu.org#56070,"ADANG, ALOR BARAT LAUT, ALOR, NUSA TENGGARA TIMUR",7,136,10,146
https://kawalpemilu.org#56070,"ADANG, ALOR BARAT LAUT, ALOR, NUSA TENGGARA TIMUR",8,140,14,154
https://kawalpemilu.org#56071,"ALOR KECIL, ALOR BARAT LAUT, ALOR, NUSA TENGGARA TIMUR",1,16,193,209
https://kawalpemilu.org#56071,"ALOR KECIL, ALOR BARAT LAUT, ALOR, NUSA TENGGARA TIMUR",2,20,195,215
https://kawalpemilu.org#56071,"ALOR KECIL, ALOR BARAT LAUT, ALOR, NUSA TENGGARA TIMUR",3,8,166,174
https://kawalpemilu.org#56071,"ALOR KECIL, ALOR BARAT LAUT, ALOR, NUSA TENGGARA TIMUR",4,16,180,196
https://kawalpemilu.org#56071,"ALOR KECIL, ALOR BARAT LAUT, ALOR, NUSA TENGGARA TIMUR",5,9,126,135
https://kawalpemilu.org#56072,"ALOR BESAR, ALOR BARAT LAUT, ALOR, NUSA TENGGARA TIMUR",1,14,126,140
https://kawalpemilu.org#56072,"ALOR BESAR, ALOR BARAT LAUT, ALOR, NUSA TENGGARA TIMUR",2,25,172,197
https://kawalpemilu.org#56072,"ALOR BESAR, ALOR BARAT LAUT, ALOR, NUSA TENGGARA TIMUR",3,171,11,182
https://kawalpemilu.org#56072,"ALOR BESAR, ALOR BARAT LAUT, ALOR, NUSA TENGGARA TIMUR",4,20,121,141
https://kawalpemilu.org#56072,"ALOR BESAR, ALOR BARAT LAUT, ALOR, NUSA TENGGARA TIMUR",5,41,123,164
https://kawalpemilu.org#56073,"AMPERA, ALOR BARAT LAUT, ALOR, NUSA TENGGARA TIMUR",1,42,148,190
https://kawalpemilu.org#56073,"AMPERA, ALOR BARAT LAUT, ALOR, NUSA TENGGARA TIMUR",2,37,103,140
https://kawalpemilu.org#56074,"DULOLONG, ALOR BARAT LAUT, ALOR, NUSA TENGGARA TIMUR",1,6,162,168
https://kawalpemilu.org#56074,"DULOLONG, ALOR BARAT LAUT, ALOR, NUSA TENGGARA TIMUR",2,31,177,208
https://kawalpemilu.org#56074,"DULOLONG, ALOR BARAT LAUT, ALOR, NUSA TENGGARA TIMUR",3,17,183,200
https://kawalpemilu.org#56074,"DULOLONG, ALOR BARAT LAUT, ALOR, NUSA TENGGARA TIMUR",4,36,83,119
https://kawalpemilu.org#56074,"DULOLONG, ALOR BARAT LAUT, ALOR, NUSA TENGGARA TIMUR",5,131,9,140
https://kawalpemilu.org#56074,"DULOLONG, ALOR BARAT LAUT, ALOR, NUSA TENGGARA TIMUR",6,9,123,132
https://kawalpemilu.org#56075,"AIMOLI, ALOR BARAT LAUT, ALOR, NUSA TENGGARA TIMUR",1,200,5,205
https://kawalpemilu.org#56075,"AIMOLI, ALOR BARAT LAUT, ALOR, NUSA TENGGARA TIMUR",2,187,8,195
https://kawalpemilu.org#56075,"AIMOLI, ALOR BARAT LAUT, ALOR, NUSA TENGGARA TIMUR",3,57,67,124
https://kawalpemilu.org#56075,"AIMOLI, ALOR BARAT LAUT, ALOR, NUSA TENGGARA TIMUR",4,39,80,119
https://kawalpemilu.org#56076,"ALILA, ALOR BARAT LAUT, ALOR, NUSA TENGGARA TIMUR",1,84,111,195
https://kawalpemilu.org#56076,"ALILA, ALOR BARAT LAUT, ALOR, NUSA TENGGARA TIMUR",2,79,10,89
https://kawalpemilu.org#56076,"ALILA, ALOR BARAT LAUT, ALOR, NUSA TENGGARA TIMUR",3,15,123,138
https://kawalpemilu.org#56077,"OTVAI, ALOR BARAT LAUT, ALOR, NUSA TENGGARA TIMUR",1,179,4,183
https://kawalpemilu.org#56077,"OTVAI, ALOR BARAT LAUT, ALOR, NUSA TENGGARA TIMUR",2,249,9,258
https://kawalpemilu.org#56077,"OTVAI, ALOR BARAT LAUT, ALOR, NUSA TENGGARA TIMUR",3,182,5,187
https://kawalpemilu.org#56077,"OTVAI, ALOR BARAT LAUT, ALOR, NUSA TENGGARA TIMUR",4,75,0,75
https://kawalpemilu.org#56077,"OTVAI, ALOR BARAT LAUT, ALOR, NUSA TENGGARA TIMUR",5,90,0,90
https://kawalpemilu.org#56078,"TERNATE, ALOR BARAT LAUT, ALOR, NUSA TENGGARA TIMUR",1,13,200,213
https://kawalpemilu.org#56078,"TERNATE, ALOR BARAT LAUT, ALOR, NUSA TENGGARA TIMUR",2,16,196,212
https://kawalpemilu.org#56078,"TERNATE, ALOR BARAT LAUT, ALOR, NUSA TENGGARA TIMUR",3,55,6,61
https://kawalpemilu.org#56078,"TERNATE, ALOR BARAT LAUT, ALOR, NUSA TENGGARA TIMUR",4,15,191,206
https://kawalpemilu.org#56079,"TERNATE SELATAN, ALOR BARAT LAUT, ALOR, NUSA TENGGARA TIMUR",1,152,5,157
https://kawalpemilu.org#56079,"TERNATE SELATAN, ALOR BARAT LAUT, ALOR, NUSA TENGGARA TIMUR",2,257,5,262
https://kawalpemilu.org#56079,"TERNATE SELATAN, ALOR BARAT LAUT, ALOR, NUSA TENGGARA TIMUR",3,150,1,151
https://kawalpemilu.org#56080,"ALILA SELATAN, ALOR BARAT LAUT, ALOR, NUSA TENGGARA TIMUR",1,9,141,150
https://kawalpemilu.org#56080,"ALILA SELATAN, ALOR BARAT LAUT, ALOR, NUSA TENGGARA TIMUR",2,60,172,232
https://kawalpemilu.org#56080,"ALILA SELATAN, ALOR BARAT LAUT, ALOR, NUSA TENGGARA TIMUR",3,92,89,181
https://kawalpemilu.org#56080,"ALILA SELATAN, ALOR BARAT LAUT, ALOR, NUSA TENGGARA TIMUR",4,15,158,173
https://kawalpemilu.org#56081,"PULAU BUAYA, ALOR BARAT LAUT, ALOR, NUSA TENGGARA TIMUR",1,4,207,211
https://kawalpemilu.org#56081,"PULAU BUAYA, ALOR BARAT LAUT, ALOR, NUSA TENGGARA TIMUR",2,14,115,129
https://kawalpemilu.org#56081,"PULAU BUAYA, ALOR BARAT LAUT, ALOR, NUSA TENGGARA TIMUR",3,11,179,190
https://kawalpemilu.org#56081,"PULAU BUAYA, ALOR BARAT LAUT, ALOR, NUSA TENGGARA TIMUR",4,17,144,161
https://kawalpemilu.org#56081,"PULAU BUAYA, ALOR BARAT LAUT, ALOR, NUSA TENGGARA TIMUR",5,14,142,156
https://kawalpemilu.org#56082,"HULNANI, ALOR BARAT LAUT, ALOR, NUSA TENGGARA TIMUR",1,39,105,144
https://kawalpemilu.org#56082,"HULNANI, ALOR BARAT LAUT, ALOR, NUSA TENGGARA TIMUR",2,34,71,105
https://kawalpemilu.org#56083,"O'A MATE, ALOR BARAT LAUT, ALOR, NUSA TENGGARA TIMUR",1,212,12,224
https://kawalpemilu.org#56083,"O'A MATE, ALOR BARAT LAUT, ALOR, NUSA TENGGARA TIMUR",2,187,15,202
https://kawalpemilu.org#56083,"O'A MATE, ALOR BARAT LAUT, ALOR, NUSA TENGGARA TIMUR",3,73,9,82
https://kawalpemilu.org#56084,"ALAANG, ALOR BARAT LAUT, ALOR, NUSA TENGGARA TIMUR",1,164,19,183
https://kawalpemilu.org#56084,"ALAANG, ALOR BARAT LAUT, ALOR, NUSA TENGGARA TIMUR",2,235,16,251
https://kawalpemilu.org#56084,"ALAANG, ALOR BARAT LAUT, ALOR, NUSA TENGGARA TIMUR",3,203,16,219
https://kawalpemilu.org#56085,"LEFOKISU, ALOR BARAT LAUT, ALOR, NUSA TENGGARA TIMUR",1,22,202,224
https://kawalpemilu.org#56085,"LEFOKISU, ALOR BARAT LAUT, ALOR, NUSA TENGGARA TIMUR",2,18,110,128
https://kawalpemilu.org#56085,"LEFOKISU, ALOR BARAT LAUT, ALOR, NUSA TENGGARA TIMUR",3,9,159,168
https://kawalpemilu.org#56086,"BAMPALOLA, ALOR BARAT LAUT, ALOR, NUSA TENGGARA TIMUR",1,48,142,190
https://kawalpemilu.org#56086,"BAMPALOLA, ALOR BARAT LAUT, ALOR, NUSA TENGGARA TIMUR",2,44,164,208
https://kawalpemilu.org#56087,"LEWALU, ALOR BARAT LAUT, ALOR, NUSA TENGGARA TIMUR",1,37,123,160
https://kawalpemilu.org#56087,"LEWALU, ALOR BARAT LAUT, ALOR, NUSA TENGGARA TIMUR",2,33,142,175
https://kawalpemilu.org#56088,"DULOLONG BARAT, ALOR BARAT LAUT, ALOR, NUSA TENGGARA TIMUR",1,131,41,172
https://kawalpemilu.org#56088,"DULOLONG BARAT, ALOR BARAT LAUT, ALOR, NUSA TENGGARA TIMUR",2,137,69,206
https://kawalpemilu.org#56090,"MORU, ALOR BARAT DAYA, ALOR, NUSA TENGGARA TIMUR",1,132,54,186
https://kawalpemilu.org#56090,"MORU, ALOR BARAT DAYA, ALOR, NUSA TENGGARA TIMUR",2,140,44,184
https://kawalpemilu.org#56090,"MORU, ALOR BARAT DAYA, ALOR, NUSA TENGGARA TIMUR",3,115,54,169
https://kawalpemilu.org#56090,"MORU, ALOR BARAT DAYA, ALOR, NUSA TENGGARA TIMUR",4,171,81,252
https://kawalpemilu.org#56090,"MORU, ALOR BARAT DAYA, ALOR, NUSA TENGGARA TIMUR",5,107,72,179
https://kawalpemilu.org#56090,"MORU, ALOR BARAT DAYA, ALOR, NUSA TENGGARA TIMUR",6,189,9,198
https://kawalpemilu.org#56090,"MORU, ALOR BARAT DAYA, ALOR, NUSA TENGGARA TIMUR",7,124,35,159
https://kawalpemilu.org#56090,"MORU, ALOR BARAT DAYA, ALOR, NUSA TENGGARA TIMUR",8,167,42,209
https://kawalpemilu.org#56091,"PROBUR, ALOR BARAT DAYA, ALOR, NUSA TENGGARA TIMUR",1,156,6,162
https://kawalpemilu.org#56091,"PROBUR, ALOR BARAT DAYA, ALOR, NUSA TENGGARA TIMUR",2,172,8,180
https://kawalpemilu.org#56091,"PROBUR, ALOR BARAT DAYA, ALOR, NUSA TENGGARA TIMUR",3,104,5,109
https://kawalpemilu.org#56091,"PROBUR, ALOR BARAT DAYA, ALOR, NUSA TENGGARA TIMUR",4,202,6,208
https://kawalpemilu.org#56091,"PROBUR, ALOR BARAT DAYA, ALOR, NUSA TENGGARA TIMUR",5,157,10,167
https://kawalpemilu.org#56091,"PROBUR, ALOR BARAT DAYA, ALOR, NUSA TENGGARA TIMUR",6,201,4,205
https://kawalpemilu.org#56091,"PROBUR, ALOR BARAT DAYA, ALOR, NUSA TENGGARA TIMUR",7,188,7,195
https://kawalpemilu.org#56092,"TRIBUR, ALOR BARAT DAYA, ALOR, NUSA TENGGARA TIMUR",1,199,16,215
https://kawalpemilu.org#56092,"TRIBUR, ALOR BARAT DAYA, ALOR, NUSA TENGGARA TIMUR",2,129,15,144
https://kawalpemilu.org#56092,"TRIBUR, ALOR BARAT DAYA, ALOR, NUSA TENGGARA TIMUR",3,131,7,138
https://kawalpemilu.org#56092,"TRIBUR, ALOR BARAT DAYA, ALOR, NUSA TENGGARA TIMUR",4,75,115,190
https://kawalpemilu.org#56092,"TRIBUR, ALOR BARAT DAYA, ALOR, NUSA TENGGARA TIMUR",5,133,11,144
https://kawalpemilu.org#56092,"TRIBUR, ALOR BARAT DAYA, ALOR, NUSA TENGGARA TIMUR",6,108,13,121
https://kawalpemilu.org#56092,"TRIBUR, ALOR BARAT DAYA, ALOR, NUSA TENGGARA TIMUR",7,159,65,224
https://kawalpemilu.org#56093,"WAKAPSIR, ALOR BARAT DAYA, ALOR, NUSA TENGGARA TIMUR",1,221,13,234
https://kawalpemilu.org#56093,"WAKAPSIR, ALOR BARAT DAYA, ALOR, NUSA TENGGARA TIMUR",2,99,67,166
https://kawalpemilu.org#56094,"MORBA, ALOR BARAT DAYA, ALOR, NUSA TENGGARA TIMUR",1,238,10,248
https://kawalpemilu.org#56094,"MORBA, ALOR BARAT DAYA, ALOR, NUSA TENGGARA TIMUR",2,193,11,204
https://kawalpemilu.org#56094,"MORBA, ALOR BARAT DAYA, ALOR, NUSA TENGGARA TIMUR",3,183,6,189
https://kawalpemilu.org#56095,"PINTUMAS, ALOR BARAT DAYA, ALOR, NUSA TENGGARA TIMUR",1,208,17,225
https://kawalpemilu.org#56095,"PINTUMAS, ALOR BARAT DAYA, ALOR, NUSA TENGGARA TIMUR",2,126,13,139
https://kawalpemilu.org#56095,"PINTUMAS, ALOR BARAT DAYA, ALOR, NUSA TENGGARA TIMUR",3,233,12,245
https://kawalpemilu.org#56095,"PINTUMAS, ALOR BARAT DAYA, ALOR, NUSA TENGGARA TIMUR",4,190,5,195
https://kawalpemilu.org#56095,"PINTUMAS, ALOR BARAT DAYA, ALOR, NUSA TENGGARA TIMUR",5,156,35,191
https://kawalpemilu.org#56095,"PINTUMAS, ALOR BARAT DAYA, ALOR, NUSA TENGGARA TIMUR",6,132,9,141
https://kawalpemilu.org#56096,"WOLWAL, ALOR BARAT DAYA, ALOR, NUSA TENGGARA TIMUR",1,106,54,160
https://kawalpemilu.org#56096,"WOLWAL, ALOR BARAT DAYA, ALOR, NUSA TENGGARA TIMUR",2,151,5,156
https://kawalpemilu.org#56096,"WOLWAL, ALOR BARAT DAYA, ALOR, NUSA TENGGARA TIMUR",3,126,50,176
https://kawalpemilu.org#56096,"WOLWAL, ALOR BARAT DAYA, ALOR, NUSA TENGGARA TIMUR",4,146,9,155
https://kawalpemilu.org#56097,"HALERMAN, ALOR BARAT DAYA, ALOR, NUSA TENGGARA TIMUR",1,160,8,168
https://kawalpemilu.org#56097,"HALERMAN, ALOR BARAT DAYA, ALOR, NUSA TENGGARA TIMUR",2,133,6,139
https://kawalpemilu.org#56097,"HALERMAN, ALOR BARAT DAYA, ALOR, NUSA TENGGARA TIMUR",3,180,7,187
https://kawalpemilu.org#56097,"HALERMAN, ALOR BARAT DAYA, ALOR, NUSA TENGGARA TIMUR",4,134,5,139
https://kawalpemilu.org#56098,"KAFELULANG, ALOR BARAT DAYA, ALOR, NUSA TENGGARA TIMUR",1,145,24,169
https://kawalpemilu.org#56098,"KAFELULANG, ALOR BARAT DAYA, ALOR, NUSA TENGGARA TIMUR",2,179,9,188
https://kawalpemilu.org#56098,"KAFELULANG, ALOR BARAT DAYA, ALOR, NUSA TENGGARA TIMUR",3,167,8,175
https://kawalpemilu.org#56099,"MORAMAM, ALOR BARAT DAYA, ALOR, NUSA TENGGARA TIMUR",1,224,28,252
https://kawalpemilu.org#56099,"MORAMAM, ALOR BARAT DAYA, ALOR, NUSA TENGGARA TIMUR",2,243,16,259
https://kawalpemilu.org#56099,"MORAMAM, ALOR BARAT DAYA, ALOR, NUSA TENGGARA TIMUR",3,203,4,207
https://kawalpemilu.org#56099,"MORAMAM, ALOR BARAT DAYA, ALOR, NUSA TENGGARA TIMUR",4,222,13,235
https://kawalpemilu.org#56100,"PAILELANG, ALOR BARAT DAYA, ALOR, NUSA TENGGARA TIMUR",1,206,13,219
https://kawalpemilu.org#56100,"PAILELANG, ALOR BARAT DAYA, ALOR, NUSA TENGGARA TIMUR",2,194,13,207
https://kawalpemilu.org#56100,"PAILELANG, ALOR BARAT DAYA, ALOR, NUSA TENGGARA TIMUR",3,181,48,229
https://kawalpemilu.org#56101,"WOLWAL BARAT, ALOR BARAT DAYA, ALOR, NUSA TENGGARA TIMUR",1,159,71,230
https://kawalpemilu.org#56102,"WOLWAL TENGAH, ALOR BARAT DAYA, ALOR, NUSA TENGGARA TIMUR",1,150,44,194
https://kawalpemilu.org#56102,"WOLWAL TENGAH, ALOR BARAT DAYA, ALOR, NUSA TENGGARA TIMUR",2,114,67,181
https://kawalpemilu.org#56102,"WOLWAL TENGAH, ALOR BARAT DAYA, ALOR, NUSA TENGGARA TIMUR",3,73,90,163
https://kawalpemilu.org#56103,"WOLWAL SELATAN, ALOR BARAT DAYA, ALOR, NUSA TENGGARA TIMUR",1,274,7,281
https://kawalpemilu.org#56104,"PROBUR UTARA, ALOR BARAT DAYA, ALOR, NUSA TENGGARA TIMUR",1,46,80,126
https://kawalpemilu.org#56104,"PROBUR UTARA, ALOR BARAT DAYA, ALOR, NUSA TENGGARA TIMUR",2,234,1,235
https://kawalpemilu.org#56104,"PROBUR UTARA, ALOR BARAT DAYA, ALOR, NUSA TENGGARA TIMUR",3,149,11,160
https://kawalpemilu.org#56104,"PROBUR UTARA, ALOR BARAT DAYA, ALOR, NUSA TENGGARA TIMUR",4,218,3,221
https://kawalpemilu.org#56105,"MANATANG, ALOR BARAT DAYA, ALOR, NUSA TENGGARA TIMUR",1,186,17,203
https://kawalpemilu.org#56105,"MANATANG, ALOR BARAT DAYA, ALOR, NUSA TENGGARA TIMUR",2,141,1,142
https://kawalpemilu.org#56106,"ORGEN, ALOR BARAT DAYA, ALOR, NUSA TENGGARA TIMUR",1,186,6,192
https://kawalpemilu.org#56106,"ORGEN, ALOR BARAT DAYA, ALOR, NUSA TENGGARA TIMUR",2,152,3,155
https://kawalpemilu.org#56107,"WAKAPSIR TIMUR, ALOR BARAT DAYA, ALOR, NUSA TENGGARA TIMUR",1,179,12,191
https://kawalpemilu.org#56107,"WAKAPSIR TIMUR, ALOR BARAT DAYA, ALOR, NUSA TENGGARA TIMUR",2,177,6,183
https://kawalpemilu.org#56108,"KUIFANA, ALOR BARAT DAYA, ALOR, NUSA TENGGARA TIMUR",1,274,5,279
https://kawalpemilu.org#56108,"KUIFANA, ALOR BARAT DAYA, ALOR, NUSA TENGGARA TIMUR",2,206,7,213
https://kawalpemilu.org#56109,"MARGETA, ALOR BARAT DAYA, ALOR, NUSA TENGGARA TIMUR",1,216,4,220
https://kawalpemilu.org#56111,"KELAISI TIMUR, ALOR SELATAN, ALOR, NUSA TENGGARA TIMUR",1,127,4,131
https://kawalpemilu.org#56111,"KELAISI TIMUR, ALOR SELATAN, ALOR, NUSA TENGGARA TIMUR",2,107,10,117
https://kawalpemilu.org#56111,"KELAISI TIMUR, ALOR SELATAN, ALOR, NUSA TENGGARA TIMUR",3,103,6,109
https://kawalpemilu.org#56111,"KELAISI TIMUR, ALOR SELATAN, ALOR, NUSA TENGGARA TIMUR",4,181,7,188
https://kawalpemilu.org#56112,"KELAISI BARAT, ALOR SELATAN, ALOR, NUSA TENGGARA TIMUR",1,186,6,192
https://kawalpemilu.org#56112,"KELAISI BARAT, ALOR SELATAN, ALOR, NUSA TENGGARA TIMUR",2,194,34,228
https://kawalpemilu.org#56113,"SIDABUI, ALOR SELATAN, ALOR, NUSA TENGGARA TIMUR",1,180,13,193
https://kawalpemilu.org#56113,"SIDABUI, ALOR SELATAN, ALOR, NUSA TENGGARA TIMUR",2,147,1,148
https://kawalpemilu.org#56114,"KUNEMAN, ALOR SELATAN, ALOR, NUSA TENGGARA TIMUR",1,178,7,185
https://kawalpemilu.org#56114,"KUNEMAN, ALOR SELATAN, ALOR, NUSA TENGGARA TIMUR",2,106,8,114
https://kawalpemilu.org#56114,"KUNEMAN, ALOR SELATAN, ALOR, NUSA TENGGARA TIMUR",3,103,5,108
https://kawalpemilu.org#56115,"PADANG ALANG, ALOR SELATAN, ALOR, NUSA TENGGARA TIMUR",1,137,9,146
https://kawalpemilu.org#56115,"PADANG ALANG, ALOR SELATAN, ALOR, NUSA TENGGARA TIMUR",2,118,9,127
https://kawalpemilu.org#56115,"PADANG ALANG, ALOR SELATAN, ALOR, NUSA TENGGARA TIMUR",3,129,8,137
https://kawalpemilu.org#56115,"PADANG ALANG, ALOR SELATAN, ALOR, NUSA TENGGARA TIMUR",4,136,2,138
https://kawalpemilu.org#56116,"SILAIPUI, ALOR SELATAN, ALOR, NUSA TENGGARA TIMUR",1,185,1,186
https://kawalpemilu.org#56116,"SILAIPUI, ALOR SELATAN, ALOR, NUSA TENGGARA TIMUR",2,157,5,162
https://kawalpemilu.org#56117,"KELAISI TENGAH, ALOR SELATAN, ALOR, NUSA TENGGARA TIMUR",1,136,54,190
https://kawalpemilu.org#56117,"KELAISI TENGAH, ALOR SELATAN, ALOR, NUSA TENGGARA TIMUR",2,144,17,161
https://kawalpemilu.org#56117,"KELAISI TENGAH, ALOR SELATAN, ALOR, NUSA TENGGARA TIMUR",3,102,4,106
https://kawalpemilu.org#56118,"KIRAMAN, ALOR SELATAN, ALOR, NUSA TENGGARA TIMUR",1,161,2,163
https://kawalpemilu.org#56118,"KIRAMAN, ALOR SELATAN, ALOR, NUSA TENGGARA TIMUR",2,93,3,96
https://kawalpemilu.org#56118,"KIRAMAN, ALOR SELATAN, ALOR, NUSA TENGGARA TIMUR",3,98,0,98
https://kawalpemilu.org#56119,"MAIKANG, ALOR SELATAN, ALOR, NUSA TENGGARA TIMUR",1,186,5,191
https://kawalpemilu.org#56120,"MALAIPEA, ALOR SELATAN, ALOR, NUSA TENGGARA TIMUR",1,195,13,208
https://kawalpemilu.org#56120,"MALAIPEA, ALOR SELATAN, ALOR, NUSA TENGGARA TIMUR",2,185,3,188
https://kawalpemilu.org#56121,"TAMANAPUI, ALOR SELATAN, ALOR, NUSA TENGGARA TIMUR",1,146,0,146
https://kawalpemilu.org#56121,"TAMANAPUI, ALOR SELATAN, ALOR, NUSA TENGGARA TIMUR",2,134,9,143
https://kawalpemilu.org#56122,"LELLA, ALOR SELATAN, ALOR, NUSA TENGGARA TIMUR",1,274,13,287
https://kawalpemilu.org#56123,"MANMAS, ALOR SELATAN, ALOR, NUSA TENGGARA TIMUR",1,187,1,188
https://kawalpemilu.org#56124,"SUBO, ALOR SELATAN, ALOR, NUSA TENGGARA TIMUR",1,220,29,249
https://kawalpemilu.org#56124,"SUBO, ALOR SELATAN, ALOR, NUSA TENGGARA TIMUR",2,137,0,137
https://kawalpemilu.org#56126,"KOLANA UTARA, ALOR TIMUR, ALOR, NUSA TENGGARA TIMUR",1,212,30,242
https://kawalpemilu.org#56126,"KOLANA UTARA, ALOR TIMUR, ALOR, NUSA TENGGARA TIMUR",2,123,4,127
https://kawalpemilu.org#56126,"KOLANA UTARA, ALOR TIMUR, ALOR, NUSA TENGGARA TIMUR",3,197,14,211
https://kawalpemilu.org#56126,"KOLANA UTARA, ALOR TIMUR, ALOR, NUSA TENGGARA TIMUR",4,210,9,219
https://kawalpemilu.org#56127,"TANGLAPUI, ALOR TIMUR, ALOR, NUSA TENGGARA TIMUR",1,178,3,181
https://kawalpemilu.org#56127,"TANGLAPUI, ALOR TIMUR, ALOR, NUSA TENGGARA TIMUR",2,160,3,163
https://kawalpemilu.org#56127,"TANGLAPUI, ALOR TIMUR, ALOR, NUSA TENGGARA TIMUR",3,191,2,193
https://kawalpemilu.org#56127,"TANGLAPUI, ALOR TIMUR, ALOR, NUSA TENGGARA TIMUR",4,111,9,120
https://kawalpemilu.org#56128,"PADANG PANJANG, ALOR TIMUR, ALOR, NUSA TENGGARA TIMUR",1,207,9,216
https://kawalpemilu.org#56128,"PADANG PANJANG, ALOR TIMUR, ALOR, NUSA TENGGARA TIMUR",2,214,10,224
https://kawalpemilu.org#56129,"MARITAING, ALOR TIMUR, ALOR, NUSA TENGGARA TIMUR",1,132,22,154
https://kawalpemilu.org#56129,"MARITAING, ALOR TIMUR, ALOR, NUSA TENGGARA TIMUR",2,166,16,182
https://kawalpemilu.org#56129,"MARITAING, ALOR TIMUR, ALOR, NUSA TENGGARA TIMUR",3,149,11,160
https://kawalpemilu.org#56129,"MARITAING, ALOR TIMUR, ALOR, NUSA TENGGARA TIMUR",4,115,21,136
https://kawalpemilu.org#56130,"ELOK, ALOR TIMUR, ALOR, NUSA TENGGARA TIMUR",1,102,1,103
https://kawalpemilu.org#56130,"ELOK, ALOR TIMUR, ALOR, NUSA TENGGARA TIMUR",2,138,2,140
https://kawalpemilu.org#56130,"ELOK, ALOR TIMUR, ALOR, NUSA TENGGARA TIMUR",3,152,3,155
https://kawalpemilu.org#56131,"TANGLAPUI TIMUR, ALOR TIMUR, ALOR, NUSA TENGGARA TIMUR",1,138,7,145
https://kawalpemilu.org#56131,"TANGLAPUI TIMUR, ALOR TIMUR, ALOR, NUSA TENGGARA TIMUR",2,120,6,126
https://kawalpemilu.org#56132,"MAUSAMANG, ALOR TIMUR, ALOR, NUSA TENGGARA TIMUR",1,240,12,252
https://kawalpemilu.org#56132,"MAUSAMANG, ALOR TIMUR, ALOR, NUSA TENGGARA TIMUR",2,64,1,65
https://kawalpemilu.org#56133,"BELEMANA, ALOR TIMUR, ALOR, NUSA TENGGARA TIMUR",1,240,4,244
https://kawalpemilu.org#56134,"MAUKURU, ALOR TIMUR, ALOR, NUSA TENGGARA TIMUR",1,184,6,190
https://kawalpemilu.org#56134,"MAUKURU, ALOR TIMUR, ALOR, NUSA TENGGARA TIMUR",2,111,5,116
https://kawalpemilu.org#56135,"KOLANA SELATAN, ALOR TIMUR, ALOR, NUSA TENGGARA TIMUR",1,106,27,133
https://kawalpemilu.org#56135,"KOLANA SELATAN, ALOR TIMUR, ALOR, NUSA TENGGARA TIMUR",2,234,11,245
https://kawalpemilu.org#56135,"KOLANA SELATAN, ALOR TIMUR, ALOR, NUSA TENGGARA TIMUR",3,147,14,161
https://kawalpemilu.org#56135,"KOLANA SELATAN, ALOR TIMUR, ALOR, NUSA TENGGARA TIMUR",4,186,16,202
https://kawalpemilu.org#56137,"KABIR, PANTAR, ALOR, NUSA TENGGARA TIMUR",1,104,38,143
https://kawalpemilu.org#56137,"KABIR, PANTAR, ALOR, NUSA TENGGARA TIMUR",2,39,177,216
https://kawalpemilu.org#56137,"KABIR, PANTAR, ALOR, NUSA TENGGARA TIMUR",3,73,106,179
https://kawalpemilu.org#56137,"KABIR, PANTAR, ALOR, NUSA TENGGARA TIMUR",4,37,168,205
https://kawalpemilu.org#56137,"KABIR, PANTAR, ALOR, NUSA TENGGARA TIMUR",5,28,195,223
https://kawalpemilu.org#56137,"KABIR, PANTAR, ALOR, NUSA TENGGARA TIMUR",6,46,73,119
https://kawalpemilu.org#56137,"KABIR, PANTAR, ALOR, NUSA TENGGARA TIMUR",7,33,71,104
https://kawalpemilu.org#56137,"KABIR, PANTAR, ALOR, NUSA TENGGARA TIMUR",8,38,77,115
https://kawalpemilu.org#56138,"BANDAR, PANTAR, ALOR, NUSA TENGGARA TIMUR",1,175,8,183
https://kawalpemilu.org#56138,"BANDAR, PANTAR, ALOR, NUSA TENGGARA TIMUR",2,76,119,195
https://kawalpemilu.org#56139,"BAOLANG, PANTAR, ALOR, NUSA TENGGARA TIMUR",1,19,82,101
https://kawalpemilu.org#56139,"BAOLANG, PANTAR, ALOR, NUSA TENGGARA TIMUR",2,54,121,175
https://kawalpemilu.org#56140,"MUNASELI, PANTAR, ALOR, NUSA TENGGARA TIMUR",1,55,162,217
https://kawalpemilu.org#56140,"MUNASELI, PANTAR, ALOR, NUSA TENGGARA TIMUR",2,147,75,222
https://kawalpemilu.org#56140,"MUNASELI, PANTAR, ALOR, NUSA TENGGARA TIMUR",3,103,1,104
https://kawalpemilu.org#56140,"MUNASELI, PANTAR, ALOR, NUSA TENGGARA TIMUR",4,150,7,157
https://kawalpemilu.org#56140,"MUNASELI, PANTAR, ALOR, NUSA TENGGARA TIMUR",5,162,15,177
https://kawalpemilu.org#56140,"MUNASELI, PANTAR, ALOR, NUSA TENGGARA TIMUR",6,129,10,139
https://kawalpemilu.org#56141,"HELANGDOHI, PANTAR, ALOR, NUSA TENGGARA TIMUR",1,173,4,177
https://kawalpemilu.org#56141,"HELANGDOHI, PANTAR, ALOR, NUSA TENGGARA TIMUR",2,164,7,171
https://kawalpemilu.org#56142,"WAILAWAR, PANTAR, ALOR, NUSA TENGGARA TIMUR",1,28,137,165
https://kawalpemilu.org#56142,"WAILAWAR, PANTAR, ALOR, NUSA TENGGARA TIMUR",2,14,159,173
https://kawalpemilu.org#56143,"BANA, PANTAR, ALOR, NUSA TENGGARA TIMUR",1,47,186,233
https://kawalpemilu.org#56143,"BANA, PANTAR, ALOR, NUSA TENGGARA TIMUR",2,64,117,181
https://kawalpemilu.org#56144,"BOUWELI, PANTAR, ALOR, NUSA TENGGARA TIMUR",1,133,5,138
https://kawalpemilu.org#56144,"BOUWELI, PANTAR, ALOR, NUSA TENGGARA TIMUR",2,195,30,225
https://kawalpemilu.org#56145,"BUKIT MAS, PANTAR, ALOR, NUSA TENGGARA TIMUR",1,136,18,154
https://kawalpemilu.org#56145,"BUKIT MAS, PANTAR, ALOR, NUSA TENGGARA TIMUR",2,129,26,155
https://kawalpemilu.org#56145,"BUKIT MAS, PANTAR, ALOR, NUSA TENGGARA TIMUR",3,98,6,104
https://kawalpemilu.org#56146,"MADAR, PANTAR, ALOR, NUSA TENGGARA TIMUR",1,140,29,169
https://kawalpemilu.org#56146,"MADAR, PANTAR, ALOR, NUSA TENGGARA TIMUR",2,119,16,135
https://kawalpemilu.org#56147,"PANDAI, PANTAR, ALOR, NUSA TENGGARA TIMUR",1,176,0,176
https://kawalpemilu.org#56147,"PANDAI, PANTAR, ALOR, NUSA TENGGARA TIMUR",2,43,92,135
https://kawalpemilu.org#56147,"PANDAI, PANTAR, ALOR, NUSA TENGGARA TIMUR",3,26,118,144
https://kawalpemilu.org#56149,"LEMBUR BARAT, ALOR TENGAH UTARA, ALOR, NUSA TENGGARA TIMUR",1,113,1,114
https://kawalpemilu.org#56149,"LEMBUR BARAT, ALOR TENGAH UTARA, ALOR, NUSA TENGGARA TIMUR",2,159,8,167
https://kawalpemilu.org#56149,"LEMBUR BARAT, ALOR TENGAH UTARA, ALOR, NUSA TENGGARA TIMUR",3,189,5,194
https://kawalpemilu.org#56149,"LEMBUR BARAT, ALOR TENGAH UTARA, ALOR, NUSA TENGGARA TIMUR",4,149,6,155
https://kawalpemilu.org#56149,"LEMBUR BARAT, ALOR TENGAH UTARA, ALOR, NUSA TENGGARA TIMUR",5,83,71,154
https://kawalpemilu.org#56150,"LEMBUR TENGAH, ALOR TENGAH UTARA, ALOR, NUSA TENGGARA TIMUR",1,233,5,238
https://kawalpemilu.org#56150,"LEMBUR TENGAH, ALOR TENGAH UTARA, ALOR, NUSA TENGGARA TIMUR",2,140,4,144
https://kawalpemilu.org#56150,"LEMBUR TENGAH, ALOR TENGAH UTARA, ALOR, NUSA TENGGARA TIMUR",3,140,5,145
https://kawalpemilu.org#56150,"LEMBUR TENGAH, ALOR TENGAH UTARA, ALOR, NUSA TENGGARA TIMUR",4,57,2,59
https://kawalpemilu.org#56151,"LIKWATANG, ALOR TENGAH UTARA, ALOR, NUSA TENGGARA TIMUR",1,228,7,235
https://kawalpemilu.org#56151,"LIKWATANG, ALOR TENGAH UTARA, ALOR, NUSA TENGGARA TIMUR",2,199,20,219
https://kawalpemilu.org#56152,"FUNGAFENG, ALOR TENGAH UTARA, ALOR, NUSA TENGGARA TIMUR",1,118,6,124
https://kawalpemilu.org#56152,"FUNGAFENG, ALOR TENGAH UTARA, ALOR, NUSA TENGGARA TIMUR",2,138,8,146
https://kawalpemilu.org#56153,"NUR BENLELANG, ALOR TENGAH UTARA, ALOR, NUSA TENGGARA TIMUR",1,143,16,159
https://kawalpemilu.org#56153,"NUR BENLELANG, ALOR TENGAH UTARA, ALOR, NUSA TENGGARA TIMUR",2,208,16,224
https://kawalpemilu.org#56153,"NUR BENLELANG, ALOR TENGAH UTARA, ALOR, NUSA TENGGARA TIMUR",3,140,13,153
https://kawalpemilu.org#56154,"FUISAMA, ALOR TENGAH UTARA, ALOR, NUSA TENGGARA TIMUR",1,171,8,179
https://kawalpemilu.org#56155,"KAFAKBEKA, ALOR TENGAH UTARA, ALOR, NUSA TENGGARA TIMUR",1,203,12,215
https://kawalpemilu.org#56156,"LAKWATI, ALOR TENGAH UTARA, ALOR, NUSA TENGGARA TIMUR",1,161,21,182
https://kawalpemilu.org#56156,"LAKWATI, ALOR TENGAH UTARA, ALOR, NUSA TENGGARA TIMUR",2,181,11,192
https://kawalpemilu.org#56157,"DAPITAU, ALOR TENGAH UTARA, ALOR, NUSA TENGGARA TIMUR",1,172,15,187
https://kawalpemilu.org#56158,"ALIM MEBUNG, ALOR TENGAH UTARA, ALOR, NUSA TENGGARA TIMUR",1,133,14,147
https://kawalpemilu.org#56158,"ALIM MEBUNG, ALOR TENGAH UTARA, ALOR, NUSA TENGGARA TIMUR",2,176,24,200
https://kawalpemilu.org#56158,"ALIM MEBUNG, ALOR TENGAH UTARA, ALOR, NUSA TENGGARA TIMUR",3,218,34,252
https://kawalpemilu.org#56158,"ALIM MEBUNG, ALOR TENGAH UTARA, ALOR, NUSA TENGGARA TIMUR",4,111,17,128
https://kawalpemilu.org#56158,"ALIM MEBUNG, ALOR TENGAH UTARA, ALOR, NUSA TENGGARA TIMUR",5,130,27,130
https://kawalpemilu.org#56158,"ALIM MEBUNG, ALOR TENGAH UTARA, ALOR, NUSA TENGGARA TIMUR",6,115,6,121
https://kawalpemilu.org#56159,"PETLENG, ALOR TENGAH UTARA, ALOR, NUSA TENGGARA TIMUR",1,189,16,205
https://kawalpemilu.org#56159,"PETLENG, ALOR TENGAH UTARA, ALOR, NUSA TENGGARA TIMUR",2,161,25,186
https://kawalpemilu.org#56159,"PETLENG, ALOR TENGAH UTARA, ALOR, NUSA TENGGARA TIMUR",3,139,9,148
https://kawalpemilu.org#56159,"PETLENG, ALOR TENGAH UTARA, ALOR, NUSA TENGGARA TIMUR",4,180,14,194
https://kawalpemilu.org#56159,"PETLENG, ALOR TENGAH UTARA, ALOR, NUSA TENGGARA TIMUR",5,145,19,164
https://kawalpemilu.org#56159,"PETLENG, ALOR TENGAH UTARA, ALOR, NUSA TENGGARA TIMUR",6,211,16,227
https://kawalpemilu.org#56160,"TOMINUKU, ALOR TENGAH UTARA, ALOR, NUSA TENGGARA TIMUR",1,233,6,239
https://kawalpemilu.org#56161,"WELAI SELATAN, ALOR TENGAH UTARA, ALOR, NUSA TENGGARA TIMUR",1,166,3,169
https://kawalpemilu.org#56161,"WELAI SELATAN, ALOR TENGAH UTARA, ALOR, NUSA TENGGARA TIMUR",2,199,17,216
https://kawalpemilu.org#56162,"MANETWATI, ALOR TENGAH UTARA, ALOR, NUSA TENGGARA TIMUR",1,171,26,197
https://kawalpemilu.org#56162,"MANETWATI, ALOR TENGAH UTARA, ALOR, NUSA TENGGARA TIMUR",2,136,19,155
https://kawalpemilu.org#56164,"PIDO, ALOR TIMUR LAUT, ALOR, NUSA TENGGARA TIMUR",1,105,3,108
https://kawalpemilu.org#56164,"PIDO, ALOR TIMUR LAUT, ALOR, NUSA TENGGARA TIMUR",2,230,27,257
https://kawalpemilu.org#56164,"PIDO, ALOR TIMUR LAUT, ALOR, NUSA TENGGARA TIMUR",3,96,10,106
https://kawalpemilu.org#56165,"WAISIKA, ALOR TIMUR LAUT, ALOR, NUSA TENGGARA TIMUR",1,177,18,195
https://kawalpemilu.org#56165,"WAISIKA, ALOR TIMUR LAUT, ALOR, NUSA TENGGARA TIMUR",2,207,22,229
https://kawalpemilu.org#56165,"WAISIKA, ALOR TIMUR LAUT, ALOR, NUSA TENGGARA TIMUR",3,171,17,188
https://kawalpemilu.org#56165,"WAISIKA, ALOR TIMUR LAUT, ALOR, NUSA TENGGARA TIMUR",4,181,17,198
https://kawalpemilu.org#56165,"WAISIKA, ALOR TIMUR LAUT, ALOR, NUSA TENGGARA TIMUR",5,209,14,223
https://kawalpemilu.org#56165,"WAISIKA, ALOR TIMUR LAUT, ALOR, NUSA TENGGARA TIMUR",6,159,21,180
https://kawalpemilu.org#56165,"WAISIKA, ALOR TIMUR LAUT, ALOR, NUSA TENGGARA TIMUR",7,198,6,204
https://kawalpemilu.org#56166,"KAMOT, ALOR TIMUR LAUT, ALOR, NUSA TENGGARA TIMUR",1,194,14,208
https://kawalpemilu.org#56166,"KAMOT, ALOR TIMUR LAUT, ALOR, NUSA TENGGARA TIMUR",2,151,11,162
https://kawalpemilu.org#56166,"KAMOT, ALOR TIMUR LAUT, ALOR, NUSA TENGGARA TIMUR",3,158,12,170
https://kawalpemilu.org#56167,"TARAMANA, ALOR TIMUR LAUT, ALOR, NUSA TENGGARA TIMUR",1,121,15,136
https://kawalpemilu.org#56167,"TARAMANA, ALOR TIMUR LAUT, ALOR, NUSA TENGGARA TIMUR",2,225,14,239
https://kawalpemilu.org#56167,"TARAMANA, ALOR TIMUR LAUT, ALOR, NUSA TENGGARA TIMUR",3,136,8,144
https://kawalpemilu.org#56168,"NAILANG, ALOR TIMUR LAUT, ALOR, NUSA TENGGARA TIMUR",1,137,5,142
https://kawalpemilu.org#56168,"NAILANG, ALOR TIMUR LAUT, ALOR, NUSA TENGGARA TIMUR",2,145,13,158
https://kawalpemilu.org#56168,"NAILANG, ALOR TIMUR LAUT, ALOR, NUSA TENGGARA TIMUR",3,173,11,184
https://kawalpemilu.org#56168,"NAILANG, ALOR TIMUR LAUT, ALOR, NUSA TENGGARA TIMUR",4,198,1,199
https://kawalpemilu.org#56168,"NAILANG, ALOR TIMUR LAUT, ALOR, NUSA TENGGARA TIMUR",5,96,9,105
https://kawalpemilu.org#56169,"LIPPANG, ALOR TIMUR LAUT, ALOR, NUSA TENGGARA TIMUR",1,140,3,143
https://kawalpemilu.org#56169,"LIPPANG, ALOR TIMUR LAUT, ALOR, NUSA TENGGARA TIMUR",2,150,4,154
https://kawalpemilu.org#56170,"KENARIMBALA, ALOR TIMUR LAUT, ALOR, NUSA TENGGARA TIMUR",1,177,14,191
https://kawalpemilu.org#56170,"KENARIMBALA, ALOR TIMUR LAUT, ALOR, NUSA TENGGARA TIMUR",2,130,1,131
https://kawalpemilu.org#56170,"KENARIMBALA, ALOR TIMUR LAUT, ALOR, NUSA TENGGARA TIMUR",3,188,5,193
https://kawalpemilu.org#56171,"AIR MANCUR, ALOR TIMUR LAUT, ALOR, NUSA TENGGARA TIMUR",1,232,5,237
https://kawalpemilu.org#56171,"AIR MANCUR, ALOR TIMUR LAUT, ALOR, NUSA TENGGARA TIMUR",2,155,26,181
https://kawalpemilu.org#56173,"BARALER, PANTAR BARAT, ALOR, NUSA TENGGARA TIMUR",1,17,220,237
https://kawalpemilu.org#56173,"BARALER, PANTAR BARAT, ALOR, NUSA TENGGARA TIMUR",2,32,189,222
https://kawalpemilu.org#56174,"KALONDAMA, PANTAR BARAT, ALOR, NUSA TENGGARA TIMUR",1,222,7,229
https://kawalpemilu.org#56174,"KALONDAMA, PANTAR BARAT, ALOR, NUSA TENGGARA TIMUR",2,239,3,242
https://kawalpemilu.org#56175,"LEER, PANTAR BARAT, ALOR, NUSA TENGGARA TIMUR",1,170,9,179
https://kawalpemilu.org#56175,"LEER, PANTAR BARAT, ALOR, NUSA TENGGARA TIMUR",2,195,25,220
https://kawalpemilu.org#56175,"LEER, PANTAR BARAT, ALOR, NUSA TENGGARA TIMUR",3,208,0,208
https://kawalpemilu.org#56175,"LEER, PANTAR BARAT, ALOR, NUSA TENGGARA TIMUR",4,99,6,105
https://kawalpemilu.org#56176,"BARANUSA, PANTAR BARAT, ALOR, NUSA TENGGARA TIMUR",1,13,164,177
https://kawalpemilu.org#56176,"BARANUSA, PANTAR BARAT, ALOR, NUSA TENGGARA TIMUR",2,18,148,165
https://kawalpemilu.org#56176,"BARANUSA, PANTAR BARAT, ALOR, NUSA TENGGARA TIMUR",3,8,76,84
https://kawalpemilu.org#56176,"BARANUSA, PANTAR BARAT, ALOR, NUSA TENGGARA TIMUR",4,12,80,92
https://kawalpemilu.org#56177,"BLANG MERANG, PANTAR BARAT, ALOR, NUSA TENGGARA TIMUR",1,13,206,219
https://kawalpemilu.org#56177,"BLANG MERANG, PANTAR BARAT, ALOR, NUSA TENGGARA TIMUR",2,27,189,216
https://kawalpemilu.org#56177,"BLANG MERANG, PANTAR BARAT, ALOR, NUSA TENGGARA TIMUR",3,21,182,203
https://kawalpemilu.org#56177,"BLANG MERANG, PANTAR BARAT, ALOR, NUSA TENGGARA TIMUR",4,18,147,165
https://kawalpemilu.org#56177,"BLANG MERANG, PANTAR BARAT, ALOR, NUSA TENGGARA TIMUR",5,14,121,135
https://kawalpemilu.org#56178,"PIRINGSINA, PANTAR BARAT, ALOR, NUSA TENGGARA TIMUR",1,34,118,152
https://kawalpemilu.org#56178,"PIRINGSINA, PANTAR BARAT, ALOR, NUSA TENGGARA TIMUR",2,37,133,170
https://kawalpemilu.org#56179,"ILLU, PANTAR BARAT, ALOR, NUSA TENGGARA TIMUR",1,45,165,210
https://kawalpemilu.org#56179,"ILLU, PANTAR BARAT, ALOR, NUSA TENGGARA TIMUR",2,34,143,177
https://kawalpemilu.org#56181,"KABOLA, KABOLA, ALOR, NUSA TENGGARA TIMUR",1,191,38,229
https://kawalpemilu.org#56181,"KABOLA, KABOLA, ALOR, NUSA TENGGARA TIMUR",2,207,23,230
https://kawalpemilu.org#56181,"KABOLA, KABOLA, ALOR, NUSA TENGGARA TIMUR",3,101,95,196
https://kawalpemilu.org#56181,"KABOLA, KABOLA, ALOR, NUSA TENGGARA TIMUR",4,182,42,224
https://kawalpemilu.org#56181,"KABOLA, KABOLA, ALOR, NUSA TENGGARA TIMUR",5,166,45,211
https://kawalpemilu.org#56181,"KABOLA, KABOLA, ALOR, NUSA TENGGARA TIMUR",6,213,25,238
https://kawalpemilu.org#56181,"KABOLA, KABOLA, ALOR, NUSA TENGGARA TIMUR",7,241,20,261
https://kawalpemilu.org#56181,"KABOLA, KABOLA, ALOR, NUSA TENGGARA TIMUR",8,170,28,198
https://kawalpemilu.org#56181,"KABOLA, KABOLA, ALOR, NUSA TENGGARA TIMUR",9,195,19,214
https://kawalpemilu.org#56181,"KABOLA, KABOLA, ALOR, NUSA TENGGARA TIMUR",10,163,25,188
https://kawalpemilu.org#56182,"KOPIDIL, KABOLA, ALOR, NUSA TENGGARA TIMUR",1,208,3,211
https://kawalpemilu.org#56182,"KOPIDIL, KABOLA, ALOR, NUSA TENGGARA TIMUR",2,197,14,211
https://kawalpemilu.org#56182,"KOPIDIL, KABOLA, ALOR, NUSA TENGGARA TIMUR",3,188,9,197
https://kawalpemilu.org#56183,"PANTE DEERE, KABOLA, ALOR, NUSA TENGGARA TIMUR",1,203,29,232
https://kawalpemilu.org#56183,"PANTE DEERE, KABOLA, ALOR, NUSA TENGGARA TIMUR",2,194,21,215
https://kawalpemilu.org#56184,"LAWAHING, KABOLA, ALOR, NUSA TENGGARA TIMUR",1,118,7,125
https://kawalpemilu.org#56184,"LAWAHING, KABOLA, ALOR, NUSA TENGGARA TIMUR",2,180,22,202
https://kawalpemilu.org#56184,"LAWAHING, KABOLA, ALOR, NUSA TENGGARA TIMUR",3,100,8,108
https://kawalpemilu.org#56184,"LAWAHING, KABOLA, ALOR, NUSA TENGGARA TIMUR",4,177,7,184
https://kawalpemilu.org#56184,"LAWAHING, KABOLA, ALOR, NUSA TENGGARA TIMUR",5,161,15,176
https://kawalpemilu.org#56184,"LAWAHING, KABOLA, ALOR, NUSA TENGGARA TIMUR",6,155,9,164
https://kawalpemilu.org#56185,"ALILA TIMUR, KABOLA, ALOR, NUSA TENGGARA TIMUR",1,94,109,203
https://kawalpemilu.org#56185,"ALILA TIMUR, KABOLA, ALOR, NUSA TENGGARA TIMUR",2,22,163,185
https://kawalpemilu.org#56185,"ALILA TIMUR, KABOLA, ALOR, NUSA TENGGARA TIMUR",3,19,176,195
https://kawalpemilu.org#56187,"PURA, PULAU PURA, ALOR, NUSA TENGGARA TIMUR",1,192,12,204
https://kawalpemilu.org#56187,"PURA, PULAU PURA, ALOR, NUSA TENGGARA TIMUR",2,169,18,187
https://kawalpemilu.org#56187,"PURA, PULAU PURA, ALOR, NUSA TENGGARA TIMUR",3,221,10,231
https://kawalpemilu.org#56187,"PURA, PULAU PURA, ALOR, NUSA TENGGARA TIMUR",4,161,41,202
https://kawalpemilu.org#56188,"MARU, PULAU PURA, ALOR, NUSA TENGGARA TIMUR",1,131,0,131
https://kawalpemilu.org#56188,"MARU, PULAU PURA, ALOR, NUSA TENGGARA TIMUR",2,33,206,239
https://kawalpemilu.org#56188,"MARU, PULAU PURA, ALOR, NUSA TENGGARA TIMUR",3,141,0,141
https://kawalpemilu.org#56189,"PURA UTARA, PULAU PURA, ALOR, NUSA TENGGARA TIMUR",1,162,1,163
https://kawalpemilu.org#56189,"PURA UTARA, PULAU PURA, ALOR, NUSA TENGGARA TIMUR",2,182,7,189
https://kawalpemilu.org#56189,"PURA UTARA, PULAU PURA, ALOR, NUSA TENGGARA TIMUR",3,130,4,134
https://kawalpemilu.org#56190,"PURA SELATAN, PULAU PURA, ALOR, NUSA TENGGARA TIMUR",1,202,1,203
https://kawalpemilu.org#56190,"PURA SELATAN, PULAU PURA, ALOR, NUSA TENGGARA TIMUR",2,189,1,190
https://kawalpemilu.org#56190,"PURA SELATAN, PULAU PURA, ALOR, NUSA TENGGARA TIMUR",3,220,1,221
https://kawalpemilu.org#56191,"PURA TIMUR, PULAU PURA, ALOR, NUSA TENGGARA TIMUR",1,127,5,132
https://kawalpemilu.org#56191,"PURA TIMUR, PULAU PURA, ALOR, NUSA TENGGARA TIMUR",2,188,2,190
https://kawalpemilu.org#56192,"PURA BARAT, PULAU PURA, ALOR, NUSA TENGGARA TIMUR",1,51,37,88
https://kawalpemilu.org#56192,"PURA BARAT, PULAU PURA, ALOR, NUSA TENGGARA TIMUR",2,106,4,110
https://kawalpemilu.org#56192,"PURA BARAT, PULAU PURA, ALOR, NUSA TENGGARA TIMUR",3,128,128,256
https://kawalpemilu.org#56194,"MATARU SELATAN, MATARU, ALOR, NUSA TENGGARA TIMUR",1,212,7,219
https://kawalpemilu.org#56194,"MATARU SELATAN, MATARU, ALOR, NUSA TENGGARA TIMUR",2,237,9,246
https://kawalpemilu.org#56195,"MATARU UTARA, MATARU, ALOR, NUSA TENGGARA TIMUR",1,270,4,274
https://kawalpemilu.org#56195,"MATARU UTARA, MATARU, ALOR, NUSA TENGGARA TIMUR",2,262,8,270
https://kawalpemilu.org#56195,"MATARU UTARA, MATARU, ALOR, NUSA TENGGARA TIMUR",3,187,9,196
https://kawalpemilu.org#56196,"LAKATULI, MATARU, ALOR, NUSA TENGGARA TIMUR",1,262,12,274
https://kawalpemilu.org#56196,"LAKATULI, MATARU, ALOR, NUSA TENGGARA TIMUR",2,247,9,256
https://kawalpemilu.org#56197,"MATARU TIMUR, MATARU, ALOR, NUSA TENGGARA TIMUR",1,159,13,172
https://kawalpemilu.org#56197,"MATARU TIMUR, MATARU, ALOR, NUSA TENGGARA TIMUR",2,171,17,188
https://kawalpemilu.org#56198,"KAMAIFUI, MATARU, ALOR, NUSA TENGGARA TIMUR",1,125,17,142
https://kawalpemilu.org#56198,"KAMAIFUI, MATARU, ALOR, NUSA TENGGARA TIMUR",2,230,10,240
https://kawalpemilu.org#56199,"MATARU BARAT, MATARU, ALOR, NUSA TENGGARA TIMUR",1,141,4,145
https://kawalpemilu.org#56199,"MATARU BARAT, MATARU, ALOR, NUSA TENGGARA TIMUR",2,242,8,198
https://kawalpemilu.org#56199,"MATARU BARAT, MATARU, ALOR, NUSA TENGGARA TIMUR",3,152,4,156
https://kawalpemilu.org#56199,"MATARU BARAT, MATARU, ALOR, NUSA TENGGARA TIMUR",4,243,5,248
https://kawalpemilu.org#56200,"TAMAN MATARU, MATARU, ALOR, NUSA TENGGARA TIMUR",2,106,3,109
https://kawalpemilu.org#56200,"TAMAN MATARU, MATARU, ALOR, NUSA TENGGARA TIMUR",3,139,6,145
https://kawalpemilu.org#56202,"LANGKURU, PUREMAN, ALOR, NUSA TENGGARA TIMUR",1,169,3,172
https://kawalpemilu.org#56202,"LANGKURU, PUREMAN, ALOR, NUSA TENGGARA TIMUR",2,139,8,147
https://kawalpemilu.org#56202,"LANGKURU, PUREMAN, ALOR, NUSA TENGGARA TIMUR",3,118,3,121
https://kawalpemilu.org#56203,"PURNAMA, PUREMAN, ALOR, NUSA TENGGARA TIMUR",1,177,5,182
https://kawalpemilu.org#56203,"PURNAMA, PUREMAN, ALOR, NUSA TENGGARA TIMUR",2,181,10,191
https://kawalpemilu.org#56203,"PURNAMA, PUREMAN, ALOR, NUSA TENGGARA TIMUR",3,148,2,150
https://kawalpemilu.org#56204,"KAILESA, PUREMAN, ALOR, NUSA TENGGARA TIMUR",1,208,5,213
https://kawalpemilu.org#56204,"KAILESA, PUREMAN, ALOR, NUSA TENGGARA TIMUR",2,157,4,161
https://kawalpemilu.org#56205,"LANGKURU UTARA, PUREMAN, ALOR, NUSA TENGGARA TIMUR",1,160,6,166
https://kawalpemilu.org#56205,"LANGKURU UTARA, PUREMAN, ALOR, NUSA TENGGARA TIMUR",2,159,1,160
https://kawalpemilu.org#56205,"LANGKURU UTARA, PUREMAN, ALOR, NUSA TENGGARA TIMUR",3,146,5,151
https://kawalpemilu.org#56207,"NULE, PANTAR TIMUR, ALOR, NUSA TENGGARA TIMUR",1,41,131,172
https://kawalpemilu.org#56207,"NULE, PANTAR TIMUR, ALOR, NUSA TENGGARA TIMUR",2,211,7,218
https://kawalpemilu.org#56207,"NULE, PANTAR TIMUR, ALOR, NUSA TENGGARA TIMUR",3,211,2,213
https://kawalpemilu.org#56208,"KALEB, PANTAR TIMUR, ALOR, NUSA TENGGARA TIMUR",1,130,7,137
https://kawalpemilu.org#56208,"KALEB, PANTAR TIMUR, ALOR, NUSA TENGGARA TIMUR",2,147,7,154
https://kawalpemilu.org#56208,"KALEB, PANTAR TIMUR, ALOR, NUSA TENGGARA TIMUR",3,117,10,127
https://kawalpemilu.org#56208,"KALEB, PANTAR TIMUR, ALOR, NUSA TENGGARA TIMUR",4,183,18,201
https://kawalpemilu.org#56208,"KALEB, PANTAR TIMUR, ALOR, NUSA TENGGARA TIMUR",5,90,24,114
https://kawalpemilu.org#56208,"KALEB, PANTAR TIMUR, ALOR, NUSA TENGGARA TIMUR",6,119,6,125
https://kawalpemilu.org#56209,"BATU, PANTAR TIMUR, ALOR, NUSA TENGGARA TIMUR",1,23,141,162
https://kawalpemilu.org#56209,"BATU, PANTAR TIMUR, ALOR, NUSA TENGGARA TIMUR",2,151,9,160
https://kawalpemilu.org#56209,"BATU, PANTAR TIMUR, ALOR, NUSA TENGGARA TIMUR",3,25,185,210
https://kawalpemilu.org#56209,"BATU, PANTAR TIMUR, ALOR, NUSA TENGGARA TIMUR",4,22,145,167
https://kawalpemilu.org#56209,"BATU, PANTAR TIMUR, ALOR, NUSA TENGGARA TIMUR",5,33,120,153
https://kawalpemilu.org#56210,"KAERA, PANTAR TIMUR, ALOR, NUSA TENGGARA TIMUR",1,125,17,142
https://kawalpemilu.org#56210,"KAERA, PANTAR TIMUR, ALOR, NUSA TENGGARA TIMUR",2,106,5,111
https://kawalpemilu.org#56210,"KAERA, PANTAR TIMUR, ALOR, NUSA TENGGARA TIMUR",3,151,9,160
https://kawalpemilu.org#56210,"KAERA, PANTAR TIMUR, ALOR, NUSA TENGGARA TIMUR",4,112,10,122
https://kawalpemilu.org#56211,"MAWAR, PANTAR TIMUR, ALOR, NUSA TENGGARA TIMUR",1,185,3,188
https://kawalpemilu.org#56211,"MAWAR, PANTAR TIMUR, ALOR, NUSA TENGGARA TIMUR",2,100,6,106
https://kawalpemilu.org#56211,"MAWAR, PANTAR TIMUR, ALOR, NUSA TENGGARA TIMUR",3,216,4,220
https://kawalpemilu.org#56211,"MAWAR, PANTAR TIMUR, ALOR, NUSA TENGGARA TIMUR",4,98,10,108
https://kawalpemilu.org#56212,"MERDEKA, PANTAR TIMUR, ALOR, NUSA TENGGARA TIMUR",1,139,4,143
https://kawalpemilu.org#56212,"MERDEKA, PANTAR TIMUR, ALOR, NUSA TENGGARA TIMUR",2,152,3,155
https://kawalpemilu.org#56212,"MERDEKA, PANTAR TIMUR, ALOR, NUSA TENGGARA TIMUR",3,178,19,197
https://kawalpemilu.org#56212,"MERDEKA, PANTAR TIMUR, ALOR, NUSA TENGGARA TIMUR",4,186,5,191
https://kawalpemilu.org#56213,"OMBAY, PANTAR TIMUR, ALOR, NUSA TENGGARA TIMUR",1,8,157,165
https://kawalpemilu.org#56213,"OMBAY, PANTAR TIMUR, ALOR, NUSA TENGGARA TIMUR",2,96,21,117
https://kawalpemilu.org#56213,"OMBAY, PANTAR TIMUR, ALOR, NUSA TENGGARA TIMUR",3,5,130,135
https://kawalpemilu.org#56213,"OMBAY, PANTAR TIMUR, ALOR, NUSA TENGGARA TIMUR",4,100,17,117
https://kawalpemilu.org#56214,"LEKOM, PANTAR TIMUR, ALOR, NUSA TENGGARA TIMUR",1,158,6,164
https://kawalpemilu.org#56214,"LEKOM, PANTAR TIMUR, ALOR, NUSA TENGGARA TIMUR",2,135,12,147
https://kawalpemilu.org#56215,"BUNGABALI, PANTAR TIMUR, ALOR, NUSA TENGGARA TIMUR",1,96,7,103
https://kawalpemilu.org#56215,"BUNGABALI, PANTAR TIMUR, ALOR, NUSA TENGGARA TIMUR",2,86,5,91
https://kawalpemilu.org#56215,"BUNGABALI, PANTAR TIMUR, ALOR, NUSA TENGGARA TIMUR",3,102,8,110
https://kawalpemilu.org#56215,"BUNGABALI, PANTAR TIMUR, ALOR, NUSA TENGGARA TIMUR",4,155,9,164
https://kawalpemilu.org#56216,"TEREWENG, PANTAR TIMUR, ALOR, NUSA TENGGARA TIMUR",2,8,112,120
https://kawalpemilu.org#56216,"TEREWENG, PANTAR TIMUR, ALOR, NUSA TENGGARA TIMUR",3,12,136,148
https://kawalpemilu.org#56216,"TEREWENG, PANTAR TIMUR, ALOR, NUSA TENGGARA TIMUR",4,6,138,144
https://kawalpemilu.org#56217,"LALAFANG, PANTAR TIMUR, ALOR, NUSA TENGGARA TIMUR",1,111,14,125
https://kawalpemilu.org#56217,"LALAFANG, PANTAR TIMUR, ALOR, NUSA TENGGARA TIMUR",2,122,11,133
https://kawalpemilu.org#56219,"LEMBUR TIMUR, LEMBUR, ALOR, NUSA TENGGARA TIMUR",1,190,10,200
https://kawalpemilu.org#56219,"LEMBUR TIMUR, LEMBUR, ALOR, NUSA TENGGARA TIMUR",2,144,3,147
https://kawalpemilu.org#56219,"LEMBUR TIMUR, LEMBUR, ALOR, NUSA TENGGARA TIMUR",3,117,14,131
https://kawalpemilu.org#56219,"LEMBUR TIMUR, LEMBUR, ALOR, NUSA TENGGARA TIMUR",4,159,22,181
https://kawalpemilu.org#56220,"LUBA, LEMBUR, ALOR, NUSA TENGGARA TIMUR",1,223,19,242
https://kawalpemilu.org#56220,"LUBA, LEMBUR, ALOR, NUSA TENGGARA TIMUR",2,177,7,184
https://kawalpemilu.org#56221,"TALWAI, LEMBUR, ALOR, NUSA TENGGARA TIMUR",1,187,4,191
https://kawalpemilu.org#56221,"TALWAI, LEMBUR, ALOR, NUSA TENGGARA TIMUR",2,169,61,230
https://kawalpemilu.org#56222,"TULENG, LEMBUR, ALOR, NUSA TENGGARA TIMUR",1,168,25,193
https://kawalpemilu.org#56222,"TULENG, LEMBUR, ALOR, NUSA TENGGARA TIMUR",2,0,0,225
https://kawalpemilu.org#56223,"WAIMI, LEMBUR, ALOR, NUSA TENGGARA TIMUR",1,190,7,197
https://kawalpemilu.org#56223,"WAIMI, LEMBUR, ALOR, NUSA TENGGARA TIMUR",2,268,20,288
https://kawalpemilu.org#56224,"TASI, LEMBUR, ALOR, NUSA TENGGARA TIMUR",1,154,13,167
https://kawalpemilu.org#56224,"TASI, LEMBUR, ALOR, NUSA TENGGARA TIMUR",2,119,9,128
https://kawalpemilu.org#56226,"TUDE, PANTAR TENGAH, ALOR, NUSA TENGGARA TIMUR",1,165,4,169
https://kawalpemilu.org#56226,"TUDE, PANTAR TENGAH, ALOR, NUSA TENGGARA TIMUR",2,184,16,200
https://kawalpemilu.org#56226,"TUDE, PANTAR TENGAH, ALOR, NUSA TENGGARA TIMUR",3,90,11,101
https://kawalpemilu.org#56226,"TUDE, PANTAR TENGAH, ALOR, NUSA TENGGARA TIMUR",4,170,7,177
https://kawalpemilu.org#56227,"MAUTA, PANTAR TENGAH, ALOR, NUSA TENGGARA TIMUR",1,197,4,201
https://kawalpemilu.org#56227,"MAUTA, PANTAR TENGAH, ALOR, NUSA TENGGARA TIMUR",2,109,16,125
https://kawalpemilu.org#56227,"MAUTA, PANTAR TENGAH, ALOR, NUSA TENGGARA TIMUR",3,133,14,147
https://kawalpemilu.org#56227,"MAUTA, PANTAR TENGAH, ALOR, NUSA TENGGARA TIMUR",4,112,4,116
https://kawalpemilu.org#56227,"MAUTA, PANTAR TENGAH, ALOR, NUSA TENGGARA TIMUR",5,157,4,161
https://kawalpemilu.org#56227,"MAUTA, PANTAR TENGAH, ALOR, NUSA TENGGARA TIMUR",6,42,9,51
https://kawalpemilu.org#56227,"MAUTA, PANTAR TENGAH, ALOR, NUSA TENGGARA TIMUR",7,142,11,153
https://kawalpemilu.org#56227,"MAUTA, PANTAR TENGAH, ALOR, NUSA TENGGARA TIMUR",8,106,10,116
https://kawalpemilu.org#56228,"MURIABANG, PANTAR TENGAH, ALOR, NUSA TENGGARA TIMUR",1,85,41,126
https://kawalpemilu.org#56228,"MURIABANG, PANTAR TENGAH, ALOR, NUSA TENGGARA TIMUR",2,100,32,132
https://kawalpemilu.org#56228,"MURIABANG, PANTAR TENGAH, ALOR, NUSA TENGGARA TIMUR",3,131,20,151
https://kawalpemilu.org#56228,"MURIABANG, PANTAR TENGAH, ALOR, NUSA TENGGARA TIMUR",4,95,36,131
https://kawalpemilu.org#56228,"MURIABANG, PANTAR TENGAH, ALOR, NUSA TENGGARA TIMUR",5,99,22,121
https://kawalpemilu.org#56229,"TUBBE, PANTAR TENGAH, ALOR, NUSA TENGGARA TIMUR",1,195,16,211
https://kawalpemilu.org#56229,"TUBBE, PANTAR TENGAH, ALOR, NUSA TENGGARA TIMUR",2,135,11,146
https://kawalpemilu.org#56230,"TAMAKH, PANTAR TENGAH, ALOR, NUSA TENGGARA TIMUR",1,111,13,124
https://kawalpemilu.org#56230,"TAMAKH, PANTAR TENGAH, ALOR, NUSA TENGGARA TIMUR",2,119,12,131
https://kawalpemilu.org#56230,"TAMAKH, PANTAR TENGAH, ALOR, NUSA TENGGARA TIMUR",3,141,7,148
https://kawalpemilu.org#56230,"TAMAKH, PANTAR TENGAH, ALOR, NUSA TENGGARA TIMUR",4,119,8,127
https://kawalpemilu.org#56230,"TAMAKH, PANTAR TENGAH, ALOR, NUSA TENGGARA TIMUR",5,94,23,117
https://kawalpemilu.org#56230,"TAMAKH, PANTAR TENGAH, ALOR, NUSA TENGGARA TIMUR",6,125,20,145
https://kawalpemilu.org#56231,"BAGANG, PANTAR TENGAH, ALOR, NUSA TENGGARA TIMUR",1,26,116,142
https://kawalpemilu.org#56231,"BAGANG, PANTAR TENGAH, ALOR, NUSA TENGGARA TIMUR",2,181,46,227
https://kawalpemilu.org#56232,"TOANG, PANTAR TENGAH, ALOR, NUSA TENGGARA TIMUR",1,81,168,249
https://kawalpemilu.org#56233,"EKA JAYA, PANTAR TENGAH, ALOR, NUSA TENGGARA TIMUR",1,132,16,148
https://kawalpemilu.org#56233,"EKA JAYA, PANTAR TENGAH, ALOR, NUSA TENGGARA TIMUR",2,201,7,208
https://kawalpemilu.org#56234,"ARAMABA, PANTAR TENGAH, ALOR, NUSA TENGGARA TIMUR",1,141,15,156
https://kawalpemilu.org#56234,"ARAMABA, PANTAR TENGAH, ALOR, NUSA TENGGARA TIMUR",2,193,27,220
https://kawalpemilu.org#56234,"ARAMABA, PANTAR TENGAH, ALOR, NUSA TENGGARA TIMUR",3,204,22,226
https://kawalpemilu.org#56234,"ARAMABA, PANTAR TENGAH, ALOR, NUSA TENGGARA TIMUR",4,104,4,108
https://kawalpemilu.org#56235,"DELAKI, PANTAR TENGAH, ALOR, NUSA TENGGARA TIMUR",1,222,21,243
https://kawalpemilu.org#56235,"DELAKI, PANTAR TENGAH, ALOR, NUSA TENGGARA TIMUR",2,105,26,131
https://kawalpemilu.org#56235,"DELAKI, PANTAR TENGAH, ALOR, NUSA TENGGARA TIMUR",3,139,11,150
https://kawalpemilu.org#56237,"KAYANG, PANTAR BARAT LAUT, ALOR, NUSA TENGGARA TIMUR",1,66,117,183
https://kawalpemilu.org#56237,"KAYANG, PANTAR BARAT LAUT, ALOR, NUSA TENGGARA TIMUR",2,27,158,185
https://kawalpemilu.org#56237,"KAYANG, PANTAR BARAT LAUT, ALOR, NUSA TENGGARA TIMUR",3,22,85,107
https://kawalpemilu.org#56238,"MARISA, PANTAR BARAT LAUT, ALOR, NUSA TENGGARA TIMUR",1,19,195,214
https://kawalpemilu.org#56238,"MARISA, PANTAR BARAT LAUT, ALOR, NUSA TENGGARA TIMUR",2,10,206,216
https://kawalpemilu.org#56238,"MARISA, PANTAR BARAT LAUT, ALOR, NUSA TENGGARA TIMUR",3,9,200,209
https://kawalpemilu.org#56239,"LAMMA, PANTAR BARAT LAUT, ALOR, NUSA TENGGARA TIMUR",1,153,8,161
https://kawalpemilu.org#56239,"LAMMA, PANTAR BARAT LAUT, ALOR, NUSA TENGGARA TIMUR",2,78,3,81
https://kawalpemilu.org#56240,"ALLUMANG, PANTAR BARAT LAUT, ALOR, NUSA TENGGARA TIMUR",1,168,5,173
https://kawalpemilu.org#56240,"ALLUMANG, PANTAR BARAT LAUT, ALOR, NUSA TENGGARA TIMUR",2,178,8,186
https://kawalpemilu.org#56241,"BEANGONONG, PANTAR BARAT LAUT, ALOR, NUSA TENGGARA TIMUR",1,147,55,202
https://kawalpemilu.org#56241,"BEANGONONG, PANTAR BARAT LAUT, ALOR, NUSA TENGGARA TIMUR",2,178,67,245
https://kawalpemilu.org#56242,"KALONDAMA BARAT, PANTAR BARAT LAUT, ALOR, NUSA TENGGARA TIMUR",1,133,4,137
https://kawalpemilu.org#56242,"KALONDAMA BARAT, PANTAR BARAT LAUT, ALOR, NUSA TENGGARA TIMUR",2,136,3,139
https://kawalpemilu.org#56243,"KALONDAMA TENGAH, PANTAR BARAT LAUT, ALOR, NUSA TENGGARA TIMUR",1,122,4,126
https://kawalpemilu.org#56243,"KALONDAMA TENGAH, PANTAR BARAT LAUT, ALOR, NUSA TENGGARA TIMUR",2,156,2,156
https://kawalpemilu.org#56246,"OJAN DETUN, WULANGGITANG, FLORES TIMUR, NUSA TENGGARA TIMUR",1,135,3,138
https://kawalpemilu.org#56246,"OJAN DETUN, WULANGGITANG, FLORES TIMUR, NUSA TENGGARA TIMUR",2,130,2,132
https://kawalpemilu.org#56247,"HEWA, WULANGGITANG, FLORES TIMUR, NUSA TENGGARA TIMUR",1,245,9,254
https://kawalpemilu.org#56247,"HEWA, WULANGGITANG, FLORES TIMUR, NUSA TENGGARA TIMUR",2,229,12,241
https://kawalpemilu.org#56247,"HEWA, WULANGGITANG, FLORES TIMUR, NUSA TENGGARA TIMUR",3,231,12,243
https://kawalpemilu.org#56248,"WAIULA, WULANGGITANG, FLORES TIMUR, NUSA TENGGARA TIMUR",1,226,4,230
https://kawalpemilu.org#56248,"WAIULA, WULANGGITANG, FLORES TIMUR, NUSA TENGGARA TIMUR",2,226,4,230
https://kawalpemilu.org#56248,"WAIULA, WULANGGITANG, FLORES TIMUR, NUSA TENGGARA TIMUR",3,175,10,185
https://kawalpemilu.org#56249,"NAWOKOTE, WULANGGITANG, FLORES TIMUR, NUSA TENGGARA TIMUR",1,235,15,250
https://kawalpemilu.org#56249,"NAWOKOTE, WULANGGITANG, FLORES TIMUR, NUSA TENGGARA TIMUR",2,250,8,258
https://kawalpemilu.org#56249,"NAWOKOTE, WULANGGITANG, FLORES TIMUR, NUSA TENGGARA TIMUR",3,242,2,244
https://kawalpemilu.org#56250,"BORU, WULANGGITANG, FLORES TIMUR, NUSA TENGGARA TIMUR",1,197,10,207
https://kawalpemilu.org#56250,"BORU, WULANGGITANG, FLORES TIMUR, NUSA TENGGARA TIMUR",2,212,15,227
https://kawalpemilu.org#56250,"BORU, WULANGGITANG, FLORES TIMUR, NUSA TENGGARA TIMUR",3,228,9,237
https://kawalpemilu.org#56250,"BORU, WULANGGITANG, FLORES TIMUR, NUSA TENGGARA TIMUR",4,215,3,218
https://kawalpemilu.org#56250,"BORU, WULANGGITANG, FLORES TIMUR, NUSA TENGGARA TIMUR",5,204,14,218
https://kawalpemilu.org#56250,"BORU, WULANGGITANG, FLORES TIMUR, NUSA TENGGARA TIMUR",6,163,28,191
https://kawalpemilu.org#56250,"BORU, WULANGGITANG, FLORES TIMUR, NUSA TENGGARA TIMUR",7,212,8,220
https://kawalpemilu.org#56251,"PULULERA, WULANGGITANG, FLORES TIMUR, NUSA TENGGARA TIMUR",1,192,3,195
https://kawalpemilu.org#56251,"PULULERA, WULANGGITANG, FLORES TIMUR, NUSA TENGGARA TIMUR",2,189,4,193
https://kawalpemilu.org#56251,"PULULERA, WULANGGITANG, FLORES TIMUR, NUSA TENGGARA TIMUR",3,174,6,180
https://kawalpemilu.org#56251,"PULULERA, WULANGGITANG, FLORES TIMUR, NUSA TENGGARA TIMUR",4,186,5,191
https://kawalpemilu.org#56252,"NILEKNOHENG, WULANGGITANG, FLORES TIMUR, NUSA TENGGARA TIMUR",1,133,2,135
https://kawalpemilu.org#56252,"NILEKNOHENG, WULANGGITANG, FLORES TIMUR, NUSA TENGGARA TIMUR",2,127,6,133
https://kawalpemilu.org#56253,"HOKENG JAYA, WULANGGITANG, FLORES TIMUR, NUSA TENGGARA TIMUR",1,250,13,263
https://kawalpemilu.org#56253,"HOKENG JAYA, WULANGGITANG, FLORES TIMUR, NUSA TENGGARA TIMUR",2,147,8,155
https://kawalpemilu.org#56253,"HOKENG JAYA, WULANGGITANG, FLORES TIMUR, NUSA TENGGARA TIMUR",3,175,6,181
https://kawalpemilu.org#56253,"HOKENG JAYA, WULANGGITANG, FLORES TIMUR, NUSA TENGGARA TIMUR",4,206,4,210
https://kawalpemilu.org#56254,"PANTAI OA, WULANGGITANG, FLORES TIMUR, NUSA TENGGARA TIMUR",1,136,14,150
https://kawalpemilu.org#56254,"PANTAI OA, WULANGGITANG, FLORES TIMUR, NUSA TENGGARA TIMUR",2,136,5,141
https://kawalpemilu.org#56255,"BORU KEDANG, WULANGGITANG, FLORES TIMUR, NUSA TENGGARA TIMUR",1,210,7,217
https://kawalpemilu.org#56255,"BORU KEDANG, WULANGGITANG, FLORES TIMUR, NUSA TENGGARA TIMUR",2,206,3,209
https://kawalpemilu.org#56255,"BORU KEDANG, WULANGGITANG, FLORES TIMUR, NUSA TENGGARA TIMUR",3,173,0,173
https://kawalpemilu.org#85129,"KLATANLO, WULANGGITANG, FLORES TIMUR, NUSA TENGGARA TIMUR",1,204,6,210
https://kawalpemilu.org#85129,"KLATANLO, WULANGGITANG, FLORES TIMUR, NUSA TENGGARA TIMUR",2,206,0,206
https://kawalpemilu.org#85129,"KLATANLO, WULANGGITANG, FLORES TIMUR, NUSA TENGGARA TIMUR",3,204,2,206
https://kawalpemilu.org#56257,"KOBASOMA, TITEHENA, FLORES TIMUR, NUSA TENGGARA TIMUR",1,209,3,212
https://kawalpemilu.org#56257,"KOBASOMA, TITEHENA, FLORES TIMUR, NUSA TENGGARA TIMUR",2,215,9,224
https://kawalpemilu.org#56258,"LEWOLAGA, TITEHENA, FLORES TIMUR, NUSA TENGGARA TIMUR",1,204,19,223
https://kawalpemilu.org#56258,"LEWOLAGA, TITEHENA, FLORES TIMUR, NUSA TENGGARA TIMUR",2,197,3,200
https://kawalpemilu.org#56258,"LEWOLAGA, TITEHENA, FLORES TIMUR, NUSA TENGGARA TIMUR",3,225,17,242
https://kawalpemilu.org#56259,"LEWOINGU, TITEHENA, FLORES TIMUR, NUSA TENGGARA TIMUR",1,219,18,237
https://kawalpemilu.org#56259,"LEWOINGU, TITEHENA, FLORES TIMUR, NUSA TENGGARA TIMUR",2,193,3,196
https://kawalpemilu.org#56260,"TUAKEPA, TITEHENA, FLORES TIMUR, NUSA TENGGARA TIMUR",1,239,14,253
https://kawalpemilu.org#56260,"TUAKEPA, TITEHENA, FLORES TIMUR, NUSA TENGGARA TIMUR",2,201,9,210
https://kawalpemilu.org#56260,"TUAKEPA, TITEHENA, FLORES TIMUR, NUSA TENGGARA TIMUR",3,118,6,124
https://kawalpemilu.org#56261,"TENAWAHANG, TITEHENA, FLORES TIMUR, NUSA TENGGARA TIMUR",1,141,22,163
https://kawalpemilu.org#56261,"TENAWAHANG, TITEHENA, FLORES TIMUR, NUSA TENGGARA TIMUR",2,202,13,215
https://kawalpemilu.org#56261,"TENAWAHANG, TITEHENA, FLORES TIMUR, NUSA TENGGARA TIMUR",3,168,16,184
https://kawalpemilu.org#56262,"LERABOLENG, TITEHENA, FLORES TIMUR, NUSA TENGGARA TIMUR",1,192,5,197
https://kawalpemilu.org#56262,"LERABOLENG, TITEHENA, FLORES TIMUR, NUSA TENGGARA TIMUR",2,212,7,219
https://kawalpemilu.org#56262,"LERABOLENG, TITEHENA, FLORES TIMUR, NUSA TENGGARA TIMUR",3,177,9,186
https://kawalpemilu.org#56262,"LERABOLENG, TITEHENA, FLORES TIMUR, NUSA TENGGARA TIMUR",4,161,5,166
https://kawalpemilu.org#56263,"SERINUHO, TITEHENA, FLORES TIMUR, NUSA TENGGARA TIMUR",1,217,23,240
https://kawalpemilu.org#56263,"SERINUHO, TITEHENA, FLORES TIMUR, NUSA TENGGARA TIMUR",2,168,7,175
https://kawalpemilu.org#56264,"WATOWARA, TITEHENA, FLORES TIMUR, NUSA TENGGARA TIMUR",1,180,45,225
https://kawalpemilu.org#56264,"WATOWARA, TITEHENA, FLORES TIMUR, NUSA TENGGARA TIMUR",2,179,41,220
https://kawalpemilu.org#56264,"WATOWARA, TITEHENA, FLORES TIMUR, NUSA TENGGARA TIMUR",3,201,17,218
https://kawalpemilu.org#56264,"WATOWARA, TITEHENA, FLORES TIMUR, NUSA TENGGARA TIMUR",4,36,16,52
https://kawalpemilu.org#56265,"KONGA, TITEHENA, FLORES TIMUR, NUSA TENGGARA TIMUR",1,244,11,255
https://kawalpemilu.org#56265,"KONGA, TITEHENA, FLORES TIMUR, NUSA TENGGARA TIMUR",2,234,14,248
https://kawalpemilu.org#56266,"ILE GERONG, TITEHENA, FLORES TIMUR, NUSA TENGGARA TIMUR",1,138,5,143
https://kawalpemilu.org#56266,"ILE GERONG, TITEHENA, FLORES TIMUR, NUSA TENGGARA TIMUR",2,120,12,132
https://kawalpemilu.org#56267,"ADABANG, TITEHENA, FLORES TIMUR, NUSA TENGGARA TIMUR",1,212,3,215
https://kawalpemilu.org#56267,"ADABANG, TITEHENA, FLORES TIMUR, NUSA TENGGARA TIMUR",2,113,4,117
https://kawalpemilu.org#56267,"ADABANG, TITEHENA, FLORES TIMUR, NUSA TENGGARA TIMUR",3,67,8,75
https://kawalpemilu.org#56268,"DUN TANA LEWOINGU, TITEHENA, FLORES TIMUR, NUSA TENGGARA TIMUR",1,153,10,163
https://kawalpemilu.org#56268,"DUN TANA LEWOINGU, TITEHENA, FLORES TIMUR, NUSA TENGGARA TIMUR",2,88,1,89
https://kawalpemilu.org#85130,"DULI JAYA, TITEHENA, FLORES TIMUR, NUSA TENGGARA TIMUR",1,178,19,197
https://kawalpemilu.org#85131,"BOKANG WOLOMATANG, TITEHENA, FLORES TIMUR, NUSA TENGGARA TIMUR",1,201,14,215
https://kawalpemilu.org#56270,"WAIBALUN, LARANTUKA, FLORES TIMUR, NUSA TENGGARA TIMUR",1,264,8,272
https://kawalpemilu.org#56270,"WAIBALUN, LARANTUKA, FLORES TIMUR, NUSA TENGGARA TIMUR",2,234,20,254
https://kawalpemilu.org#56270,"WAIBALUN, LARANTUKA, FLORES TIMUR, NUSA TENGGARA TIMUR",3,257,8,265
https://kawalpemilu.org#56270,"WAIBALUN, LARANTUKA, FLORES TIMUR, NUSA TENGGARA TIMUR",4,249,9,258
https://kawalpemilu.org#56270,"WAIBALUN, LARANTUKA, FLORES TIMUR, NUSA TENGGARA TIMUR",5,243,10,253
https://kawalpemilu.org#56270,"WAIBALUN, LARANTUKA, FLORES TIMUR, NUSA TENGGARA TIMUR",6,242,17,259
https://kawalpemilu.org#56270,"WAIBALUN, LARANTUKA, FLORES TIMUR, NUSA TENGGARA TIMUR",7,232,12,244
https://kawalpemilu.org#56271,"LEWOLERE, LARANTUKA, FLORES TIMUR, NUSA TENGGARA TIMUR",1,227,10,237
https://kawalpemilu.org#56271,"LEWOLERE, LARANTUKA, FLORES TIMUR, NUSA TENGGARA TIMUR",2,227,8,235
https://kawalpemilu.org#56271,"LEWOLERE, LARANTUKA, FLORES TIMUR, NUSA TENGGARA TIMUR",3,264,5,269
https://kawalpemilu.org#56271,"LEWOLERE, LARANTUKA, FLORES TIMUR, NUSA TENGGARA TIMUR",4,264,15,279
https://kawalpemilu.org#56271,"LEWOLERE, LARANTUKA, FLORES TIMUR, NUSA TENGGARA TIMUR",5,208,1,209
https://kawalpemilu.org#56271,"LEWOLERE, LARANTUKA, FLORES TIMUR, NUSA TENGGARA TIMUR",6,215,4,219
https://kawalpemilu.org#56272,"PANTAI BESAR, LARANTUKA, FLORES TIMUR, NUSA TENGGARA TIMUR",1,223,9,232
https://kawalpemilu.org#56272,"PANTAI BESAR, LARANTUKA, FLORES TIMUR, NUSA TENGGARA TIMUR",2,167,13,180
https://kawalpemilu.org#56272,"PANTAI BESAR, LARANTUKA, FLORES TIMUR, NUSA TENGGARA TIMUR",3,165,21,186
https://kawalpemilu.org#56272,"PANTAI BESAR, LARANTUKA, FLORES TIMUR, NUSA TENGGARA TIMUR",4,170,24,194
https://kawalpemilu.org#56273,"LARANTUKA, LARANTUKA, FLORES TIMUR, NUSA TENGGARA TIMUR",1,205,14,219
https://kawalpemilu.org#56273,"LARANTUKA, LARANTUKA, FLORES TIMUR, NUSA TENGGARA TIMUR",2,238,12,250
https://kawalpemilu.org#56273,"LARANTUKA, LARANTUKA, FLORES TIMUR, NUSA TENGGARA TIMUR",3,230,12,242
https://kawalpemilu.org#56274,"BALELA, LARANTUKA, FLORES TIMUR, NUSA TENGGARA TIMUR",1,225,5,230
https://kawalpemilu.org#56274,"BALELA, LARANTUKA, FLORES TIMUR, NUSA TENGGARA TIMUR",2,198,9,207
https://kawalpemilu.org#56274,"BALELA, LARANTUKA, FLORES TIMUR, NUSA TENGGARA TIMUR",3,215,7,222
https://kawalpemilu.org#56275,"POHON SIRIH, LARANTUKA, FLORES TIMUR, NUSA TENGGARA TIMUR",1,185,11,196
https://kawalpemilu.org#56275,"POHON SIRIH, LARANTUKA, FLORES TIMUR, NUSA TENGGARA TIMUR",2,232,7,239
https://kawalpemilu.org#56276,"LOHAYONG, LARANTUKA, FLORES TIMUR, NUSA TENGGARA TIMUR",1,198,6,204
https://kawalpemilu.org#56276,"LOHAYONG, LARANTUKA, FLORES TIMUR, NUSA TENGGARA TIMUR",2,184,19,203
https://kawalpemilu.org#56277,"LOKEA, LARANTUKA, FLORES TIMUR, NUSA TENGGARA TIMUR",1,164,39,203
https://kawalpemilu.org#56277,"LOKEA, LARANTUKA, FLORES TIMUR, NUSA TENGGARA TIMUR",2,154,44,198
https://kawalpemilu.org#56277,"LOKEA, LARANTUKA, FLORES TIMUR, NUSA TENGGARA TIMUR",3,191,12,203
https://kawalpemilu.org#56277,"LOKEA, LARANTUKA, FLORES TIMUR, NUSA TENGGARA TIMUR",4,199,24,223
https://kawalpemilu.org#56278,"POSTOH, LARANTUKA, FLORES TIMUR, NUSA TENGGARA TIMUR",1,138,61,199
https://kawalpemilu.org#56278,"POSTOH, LARANTUKA, FLORES TIMUR, NUSA TENGGARA TIMUR",2,91,100,191
https://kawalpemilu.org#56278,"POSTOH, LARANTUKA, FLORES TIMUR, NUSA TENGGARA TIMUR",3,159,50,209
https://kawalpemilu.org#56278,"POSTOH, LARANTUKA, FLORES TIMUR, NUSA TENGGARA TIMUR",4,47,165,212
https://kawalpemilu.org#56278,"POSTOH, LARANTUKA, FLORES TIMUR, NUSA TENGGARA TIMUR",5,50,136,186
https://kawalpemilu.org#56279,"AMAGARAPATI, LARANTUKA, FLORES TIMUR, NUSA TENGGARA TIMUR",1,167,37,204
https://kawalpemilu.org#56279,"AMAGARAPATI, LARANTUKA, FLORES TIMUR, NUSA TENGGARA TIMUR",2,228,24,252
https://kawalpemilu.org#56279,"AMAGARAPATI, LARANTUKA, FLORES TIMUR, NUSA TENGGARA TIMUR",3,193,15,208
https://kawalpemilu.org#56279,"AMAGARAPATI, LARANTUKA, FLORES TIMUR, NUSA TENGGARA TIMUR",4,193,26,219
https://kawalpemilu.org#56279,"AMAGARAPATI, LARANTUKA, FLORES TIMUR, NUSA TENGGARA TIMUR",5,159,23,182
https://kawalpemilu.org#56279,"AMAGARAPATI, LARANTUKA, FLORES TIMUR, NUSA TENGGARA TIMUR",6,239,15,254
https://kawalpemilu.org#56280,"EKASAPTA, LARANTUKA, FLORES TIMUR, NUSA TENGGARA TIMUR",1,56,215,271
https://kawalpemilu.org#56280,"EKASAPTA, LARANTUKA, FLORES TIMUR, NUSA TENGGARA TIMUR",2,36,186,222
https://kawalpemilu.org#56280,"EKASAPTA, LARANTUKA, FLORES TIMUR, NUSA TENGGARA TIMUR",3,46,186,232
https://kawalpemilu.org#56280,"EKASAPTA, LARANTUKA, FLORES TIMUR, NUSA TENGGARA TIMUR",4,40,189,229
https://kawalpemilu.org#56280,"EKASAPTA, LARANTUKA, FLORES TIMUR, NUSA TENGGARA TIMUR",5,36,200,236
https://kawalpemilu.org#56280,"EKASAPTA, LARANTUKA, FLORES TIMUR, NUSA TENGGARA TIMUR",6,58,181,239
https://kawalpemilu.org#56280,"EKASAPTA, LARANTUKA, FLORES TIMUR, NUSA TENGGARA TIMUR",7,62,168,230
https://kawalpemilu.org#56281,"SAROTARI, LARANTUKA, FLORES TIMUR, NUSA TENGGARA TIMUR",1,238,32,270
https://kawalpemilu.org#56281,"SAROTARI, LARANTUKA, FLORES TIMUR, NUSA TENGGARA TIMUR",2,229,21,250
https://kawalpemilu.org#56281,"SAROTARI, LARANTUKA, FLORES TIMUR, NUSA TENGGARA TIMUR",3,227,13,240
https://kawalpemilu.org#56281,"SAROTARI, LARANTUKA, FLORES TIMUR, NUSA TENGGARA TIMUR",4,210,33,243
https://kawalpemilu.org#56281,"SAROTARI, LARANTUKA, FLORES TIMUR, NUSA TENGGARA TIMUR",5,219,19,238
https://kawalpemilu.org#56282,"WERI, LARANTUKA, FLORES TIMUR, NUSA TENGGARA TIMUR",1,182,55,237
https://kawalpemilu.org#56282,"WERI, LARANTUKA, FLORES TIMUR, NUSA TENGGARA TIMUR",2,185,43,228
https://kawalpemilu.org#56282,"WERI, LARANTUKA, FLORES TIMUR, NUSA TENGGARA TIMUR",3,195,20,215
https://kawalpemilu.org#56282,"WERI, LARANTUKA, FLORES TIMUR, NUSA TENGGARA TIMUR",4,225,26,251
https://kawalpemilu.org#56282,"WERI, LARANTUKA, FLORES TIMUR, NUSA TENGGARA TIMUR",5,157,52,209
https://kawalpemilu.org#56282,"WERI, LARANTUKA, FLORES TIMUR, NUSA TENGGARA TIMUR",6,181,22,203
https://kawalpemilu.org#56283,"PUKEN TOBI WANGI BAO, LARANTUKA, FLORES TIMUR, NUSA TENGGARA TIMUR",1,204,30,234
https://kawalpemilu.org#56283,"PUKEN TOBI WANGI BAO, LARANTUKA, FLORES TIMUR, NUSA TENGGARA TIMUR",3,237,6,243
https://kawalpemilu.org#56283,"PUKEN TOBI WANGI BAO, LARANTUKA, FLORES TIMUR, NUSA TENGGARA TIMUR",4,263,11,274
https://kawalpemilu.org#56283,"PUKEN TOBI WANGI BAO, LARANTUKA, FLORES TIMUR, NUSA TENGGARA TIMUR",5,258,3,261
https://kawalpemilu.org#56283,"PUKEN TOBI WANGI BAO, LARANTUKA, FLORES TIMUR, NUSA TENGGARA TIMUR",6,240,11,251
https://kawalpemilu.org#56283,"PUKEN TOBI WANGI BAO, LARANTUKA, FLORES TIMUR, NUSA TENGGARA TIMUR",7,238,21,259
https://kawalpemilu.org#56284,"MOKANTARAK, LARANTUKA, FLORES TIMUR, NUSA TENGGARA TIMUR",1,178,8,186
https://kawalpemilu.org#56284,"MOKANTARAK, LARANTUKA, FLORES TIMUR, NUSA TENGGARA TIMUR",2,129,4,133
https://kawalpemilu.org#56284,"MOKANTARAK, LARANTUKA, FLORES TIMUR, NUSA TENGGARA TIMUR",3,215,4,219
https://kawalpemilu.org#56284,"MOKANTARAK, LARANTUKA, FLORES TIMUR, NUSA TENGGARA TIMUR",4,228,8,236
https://kawalpemilu.org#56285,"LAMAWALANG, LARANTUKA, FLORES TIMUR, NUSA TENGGARA TIMUR",1,176,8,184
https://kawalpemilu.org#56285,"LAMAWALANG, LARANTUKA, FLORES TIMUR, NUSA TENGGARA TIMUR",2,132,1,133
https://kawalpemilu.org#56285,"LAMAWALANG, LARANTUKA, FLORES TIMUR, NUSA TENGGARA TIMUR",3,221,19,240
https://kawalpemilu.org#85132,"WAIHALI, LARANTUKA, FLORES TIMUR, NUSA TENGGARA TIMUR",1,203,19,222
https://kawalpemilu.org#85132,"WAIHALI, LARANTUKA, FLORES TIMUR, NUSA TENGGARA TIMUR",2,192,15,207
https://kawalpemilu.org#85132,"WAIHALI, LARANTUKA, FLORES TIMUR, NUSA TENGGARA TIMUR",3,206,20,226
https://kawalpemilu.org#85133,"POHON BAO, LARANTUKA, FLORES TIMUR, NUSA TENGGARA TIMUR",1,218,28,246
https://kawalpemilu.org#85133,"POHON BAO, LARANTUKA, FLORES TIMUR, NUSA TENGGARA TIMUR",2,222,20,242
https://kawalpemilu.org#85133,"POHON BAO, LARANTUKA, FLORES TIMUR, NUSA TENGGARA TIMUR",3,188,51,239
https://kawalpemilu.org#85133,"POHON BAO, LARANTUKA, FLORES TIMUR, NUSA TENGGARA TIMUR",4,182,58,240
https://kawalpemilu.org#85133,"POHON BAO, LARANTUKA, FLORES TIMUR, NUSA TENGGARA TIMUR",5,132,86,218
https://kawalpemilu.org#85133,"POHON BAO, LARANTUKA, FLORES TIMUR, NUSA TENGGARA TIMUR",6,112,98,210
https://kawalpemilu.org#85134,"SAROTARI TENGAH, LARANTUKA, FLORES TIMUR, NUSA TENGGARA TIMUR",1,280,16,296
https://kawalpemilu.org#85134,"SAROTARI TENGAH, LARANTUKA, FLORES TIMUR, NUSA TENGGARA TIMUR",2,255,22,277
https://kawalpemilu.org#85134,"SAROTARI TENGAH, LARANTUKA, FLORES TIMUR, NUSA TENGGARA TIMUR",3,256,18,274
https://kawalpemilu.org#85134,"SAROTARI TENGAH, LARANTUKA, FLORES TIMUR, NUSA TENGGARA TIMUR",4,256,11,267
https://kawalpemilu.org#85134,"SAROTARI TENGAH, LARANTUKA, FLORES TIMUR, NUSA TENGGARA TIMUR",5,237,13,250
https://kawalpemilu.org#85135,"SAROTARI TIMUR, LARANTUKA, FLORES TIMUR, NUSA TENGGARA TIMUR",1,193,34,227
https://kawalpemilu.org#85135,"SAROTARI TIMUR, LARANTUKA, FLORES TIMUR, NUSA TENGGARA TIMUR",2,176,40,216
https://kawalpemilu.org#85135,"SAROTARI TIMUR, LARANTUKA, FLORES TIMUR, NUSA TENGGARA TIMUR",3,182,11,193
https://kawalpemilu.org#85135,"SAROTARI TIMUR, LARANTUKA, FLORES TIMUR, NUSA TENGGARA TIMUR",4,187,16,203
https://kawalpemilu.org#56287,"WAILOLONG, ILE MANDIRI, FLORES TIMUR, NUSA TENGGARA TIMUR",1,235,11,246
https://kawalpemilu.org#56287,"WAILOLONG, ILE MANDIRI, FLORES TIMUR, NUSA TENGGARA TIMUR",2,257,4,261
https://kawalpemilu.org#56287,"WAILOLONG, ILE MANDIRI, FLORES TIMUR, NUSA TENGGARA TIMUR",3,238,10,248
https://kawalpemilu.org#56287,"WAILOLONG, ILE MANDIRI, FLORES TIMUR, NUSA TENGGARA TIMUR",4,215,5,220
https://kawalpemilu.org#56288,"LEWOLOBA, ILE MANDIRI, FLORES TIMUR, NUSA TENGGARA TIMUR",1,221,3,224
https://kawalpemilu.org#56288,"LEWOLOBA, ILE MANDIRI, FLORES TIMUR, NUSA TENGGARA TIMUR",2,200,2,202
https://kawalpemilu.org#56288,"LEWOLOBA, ILE MANDIRI, FLORES TIMUR, NUSA TENGGARA TIMUR",3,220,2,222
https://kawalpemilu.org#56289,"TIWATOBI, ILE MANDIRI, FLORES TIMUR, NUSA TENGGARA TIMUR",1,221,10,231
https://kawalpemilu.org#56289,"TIWATOBI, ILE MANDIRI, FLORES TIMUR, NUSA TENGGARA TIMUR",2,185,7,192
https://kawalpemilu.org#56289,"TIWATOBI, ILE MANDIRI, FLORES TIMUR, NUSA TENGGARA TIMUR",3,229,35,264
https://kawalpemilu.org#56289,"TIWATOBI, ILE MANDIRI, FLORES TIMUR, NUSA TENGGARA TIMUR",4,130,101,231
https://kawalpemilu.org#56290,"WATOTUTU, ILE MANDIRI, FLORES TIMUR, NUSA TENGGARA TIMUR",1,227,3,230
https://kawalpemilu.org#56290,"WATOTUTU, ILE MANDIRI, FLORES TIMUR, NUSA TENGGARA TIMUR",2,230,5,235
https://kawalpemilu.org#56290,"WATOTUTU, ILE MANDIRI, FLORES TIMUR, NUSA TENGGARA TIMUR",3,255,3,258
https://kawalpemilu.org#56291,"RIANGKEMIE, ILE MANDIRI, FLORES TIMUR, NUSA TENGGARA TIMUR",1,207,6,213
https://kawalpemilu.org#56291,"RIANGKEMIE, ILE MANDIRI, FLORES TIMUR, NUSA TENGGARA TIMUR",2,202,6,208
https://kawalpemilu.org#56291,"RIANGKEMIE, ILE MANDIRI, FLORES TIMUR, NUSA TENGGARA TIMUR",3,198,4,202
https://kawalpemilu.org#56291,"RIANGKEMIE, ILE MANDIRI, FLORES TIMUR, NUSA TENGGARA TIMUR",4,190,9,199
https://kawalpemilu.org#56291,"RIANGKEMIE, ILE MANDIRI, FLORES TIMUR, NUSA TENGGARA TIMUR",5,175,17,192
https://kawalpemilu.org#56292,"LEWOHALA, ILE MANDIRI, FLORES TIMUR, NUSA TENGGARA TIMUR",1,265,7,272
https://kawalpemilu.org#56292,"LEWOHALA, ILE MANDIRI, FLORES TIMUR, NUSA TENGGARA TIMUR",2,242,8,250
https://kawalpemilu.org#56292,"LEWOHALA, ILE MANDIRI, FLORES TIMUR, NUSA TENGGARA TIMUR",3,253,10,263
https://kawalpemilu.org#56293,"HALAKODANUAN, ILE MANDIRI, FLORES TIMUR, NUSA TENGGARA TIMUR",1,232,10,242
https://kawalpemilu.org#56294,"MUDAKAPUTU, ILE MANDIRI, FLORES TIMUR, NUSA TENGGARA TIMUR",1,183,6,189
https://kawalpemilu.org#56294,"MUDAKAPUTU, ILE MANDIRI, FLORES TIMUR, NUSA TENGGARA TIMUR",2,166,2,168
https://kawalpemilu.org#56294,"MUDAKAPUTU, ILE MANDIRI, FLORES TIMUR, NUSA TENGGARA TIMUR",3,153,9,162
https://kawalpemilu.org#56296,"LEWOBUNGA, TANJUNG BUNGA, FLORES TIMUR, NUSA TENGGARA TIMUR",1,181,10,191
https://kawalpemilu.org#56297,"SINAMALAKA, TANJUNG BUNGA, FLORES TIMUR, NUSA TENGGARA TIMUR",1,132,0,132
https://kawalpemilu.org#56297,"SINAMALAKA, TANJUNG BUNGA, FLORES TIMUR, NUSA TENGGARA TIMUR",2,167,2,169
https://kawalpemilu.org#56297,"SINAMALAKA, TANJUNG BUNGA, FLORES TIMUR, NUSA TENGGARA TIMUR",3,153,3,156
https://kawalpemilu.org#56297,"SINAMALAKA, TANJUNG BUNGA, FLORES TIMUR, NUSA TENGGARA TIMUR",4,111,1,112
https://kawalpemilu.org#56298,"RATULODONG, TANJUNG BUNGA, FLORES TIMUR, NUSA TENGGARA TIMUR",1,206,24,230
https://kawalpemilu.org#56298,"RATULODONG, TANJUNG BUNGA, FLORES TIMUR, NUSA TENGGARA TIMUR",2,191,8,199
https://kawalpemilu.org#56298,"RATULODONG, TANJUNG BUNGA, FLORES TIMUR, NUSA TENGGARA TIMUR",3,163,10,173
https://kawalpemilu.org#56298,"RATULODONG, TANJUNG BUNGA, FLORES TIMUR, NUSA TENGGARA TIMUR",4,214,2,216
https://kawalpemilu.org#56298,"RATULODONG, TANJUNG BUNGA, FLORES TIMUR, NUSA TENGGARA TIMUR",5,207,12,219
https://kawalpemilu.org#56299,"SINAR HADIGALA, TANJUNG BUNGA, FLORES TIMUR, NUSA TENGGARA TIMUR",1,159,18,177
https://kawalpemilu.org#56299,"SINAR HADIGALA, TANJUNG BUNGA, FLORES TIMUR, NUSA TENGGARA TIMUR",2,151,16,167
https://kawalpemilu.org#56300,"BAHINGA, TANJUNG BUNGA, FLORES TIMUR, NUSA TENGGARA TIMUR",1,207,2,209
https://kawalpemilu.org#56300,"BAHINGA, TANJUNG BUNGA, FLORES TIMUR, NUSA TENGGARA TIMUR",2,153,6,159
https://kawalpemilu.org#56300,"BAHINGA, TANJUNG BUNGA, FLORES TIMUR, NUSA TENGGARA TIMUR",3,179,4,183
https://kawalpemilu.org#56301,"WAIBAO, TANJUNG BUNGA, FLORES TIMUR, NUSA TENGGARA TIMUR",1,174,22,196
https://kawalpemilu.org#56301,"WAIBAO, TANJUNG BUNGA, FLORES TIMUR, NUSA TENGGARA TIMUR",2,186,5,191
https://kawalpemilu.org#56301,"WAIBAO, TANJUNG BUNGA, FLORES TIMUR, NUSA TENGGARA TIMUR",3,184,5,189
https://kawalpemilu.org#56301,"WAIBAO, TANJUNG BUNGA, FLORES TIMUR, NUSA TENGGARA TIMUR",4,193,1,194
https://kawalpemilu.org#56302,"LAMATUTU, TANJUNG BUNGA, FLORES TIMUR, NUSA TENGGARA TIMUR",1,185,1,186
https://kawalpemilu.org#56302,"LAMATUTU, TANJUNG BUNGA, FLORES TIMUR, NUSA TENGGARA TIMUR",2,164,0,164
https://kawalpemilu.org#56302,"LAMATUTU, TANJUNG BUNGA, FLORES TIMUR, NUSA TENGGARA TIMUR",3,128,0,128
https://kawalpemilu.org#56303,"LATON LIWO, TANJUNG BUNGA, FLORES TIMUR, NUSA TENGGARA TIMUR",1,216,12,228
https://kawalpemilu.org#56304,"KOLAKA, TANJUNG BUNGA, FLORES TIMUR, NUSA TENGGARA TIMUR",1,157,5,162
https://kawalpemilu.org#56304,"KOLAKA, TANJUNG BUNGA, FLORES TIMUR, NUSA TENGGARA TIMUR",2,158,4,162
https://kawalpemilu.org#56304,"KOLAKA, TANJUNG BUNGA, FLORES TIMUR, NUSA TENGGARA TIMUR",3,128,7,135
https://kawalpemilu.org#56304,"KOLAKA, TANJUNG BUNGA, FLORES TIMUR, NUSA TENGGARA TIMUR",4,122,11,133
https://kawalpemilu.org#56305,"BANDONA, TANJUNG BUNGA, FLORES TIMUR, NUSA TENGGARA TIMUR",1,198,7,205
https://kawalpemilu.org#56305,"BANDONA, TANJUNG BUNGA, FLORES TIMUR, NUSA TENGGARA TIMUR",2,117,11,128
https://kawalpemilu.org#56306,"NUSANIPA, TANJUNG BUNGA, FLORES TIMUR, NUSA TENGGARA TIMUR",1,122,2,124
https://kawalpemilu.org#56306,"NUSANIPA, TANJUNG BUNGA, FLORES TIMUR, NUSA TENGGARA TIMUR",2,166,4,170
https://kawalpemilu.org#56307,"PATISIRAWALANG, TANJUNG BUNGA, FLORES TIMUR, NUSA TENGGARA TIMUR",1,201,4,205
https://kawalpemilu.org#56307,"PATISIRAWALANG, TANJUNG BUNGA, FLORES TIMUR, NUSA TENGGARA TIMUR",2,226,6,232
https://kawalpemilu.org#56307,"PATISIRAWALANG, TANJUNG BUNGA, FLORES TIMUR, NUSA TENGGARA TIMUR",3,232,3,235
https://kawalpemilu.org#56308,"GEKENGDERAN, TANJUNG BUNGA, FLORES TIMUR, NUSA TENGGARA TIMUR",1,199,1,200
https://kawalpemilu.org#56309,"ARANSINA, TANJUNG BUNGA, FLORES TIMUR, NUSA TENGGARA TIMUR",1,126,0,126
https://kawalpemilu.org#56309,"ARANSINA, TANJUNG BUNGA, FLORES TIMUR, NUSA TENGGARA TIMUR",2,166,7,173
https://kawalpemilu.org#85136,"LATONLIWO DUA, TANJUNG BUNGA, FLORES TIMUR, NUSA TENGGARA TIMUR",1,154,4,158
https://kawalpemilu.org#85137,"LAMANABI, TANJUNG BUNGA, FLORES TIMUR, NUSA TENGGARA TIMUR",1,163,5,168
https://kawalpemilu.org#56311,"RITAEBANG, SOLOR BARAT, FLORES TIMUR, NUSA TENGGARA TIMUR",1,162,3,165
https://kawalpemilu.org#56311,"RITAEBANG, SOLOR BARAT, FLORES TIMUR, NUSA TENGGARA TIMUR",2,156,1,157
https://kawalpemilu.org#56311,"RITAEBANG, SOLOR BARAT, FLORES TIMUR, NUSA TENGGARA TIMUR",3,203,4,207
https://kawalpemilu.org#56311,"RITAEBANG, SOLOR BARAT, FLORES TIMUR, NUSA TENGGARA TIMUR",4,189,13,202
https://kawalpemilu.org#56312,"TANAH LEIN, SOLOR BARAT, FLORES TIMUR, NUSA TENGGARA TIMUR",1,160,4,164
https://kawalpemilu.org#56312,"TANAH LEIN, SOLOR BARAT, FLORES TIMUR, NUSA TENGGARA TIMUR",2,168,5,173
https://kawalpemilu.org#56312,"TANAH LEIN, SOLOR BARAT, FLORES TIMUR, NUSA TENGGARA TIMUR",3,89,2,91
https://kawalpemilu.org#56313,"LAMAOLE, SOLOR BARAT, FLORES TIMUR, NUSA TENGGARA TIMUR",1,186,8,194
https://kawalpemilu.org#56314,"KALELU, SOLOR BARAT, FLORES TIMUR, NUSA TENGGARA TIMUR",1,96,51,147
https://kawalpemilu.org#56314,"KALELU, SOLOR BARAT, FLORES TIMUR, NUSA TENGGARA TIMUR",2,109,9,118
https://kawalpemilu.org#56315,"NUHALOLON, SOLOR BARAT, FLORES TIMUR, NUSA TENGGARA TIMUR",1,165,3,168
https://kawalpemilu.org#56315,"NUHALOLON, SOLOR BARAT, FLORES TIMUR, NUSA TENGGARA TIMUR",2,116,7,123
https://kawalpemilu.org#56317,"BALAWELING II, SOLOR BARAT, FLORES TIMUR, NUSA TENGGARA TIMUR",1,192,4,196
https://kawalpemilu.org#56317,"BALAWELING II, SOLOR BARAT, FLORES TIMUR, NUSA TENGGARA TIMUR",2,171,14,185
https://kawalpemilu.org#56318,"BALAWELING I, SOLOR BARAT, FLORES TIMUR, NUSA TENGGARA TIMUR",1,197,2,199
https://kawalpemilu.org#56318,"BALAWELING I, SOLOR BARAT, FLORES TIMUR, NUSA TENGGARA TIMUR",2,174,1,175
https://kawalpemilu.org#56319,"PAMAKAYO, SOLOR BARAT, FLORES TIMUR, NUSA TENGGARA TIMUR",1,172,7,179
https://kawalpemilu.org#56319,"PAMAKAYO, SOLOR BARAT, FLORES TIMUR, NUSA TENGGARA TIMUR",2,167,5,172
https://kawalpemilu.org#56322,"ONGALERENG, SOLOR BARAT, FLORES TIMUR, NUSA TENGGARA TIMUR",1,188,3,191
https://kawalpemilu.org#56322,"ONGALERENG, SOLOR BARAT, FLORES TIMUR, NUSA TENGGARA TIMUR",2,182,9,191
https://kawalpemilu.org#56322,"ONGALERENG, SOLOR BARAT, FLORES TIMUR, NUSA TENGGARA TIMUR",3,188,9,197
https://kawalpemilu.org#56323,"KARAWATUNG, SOLOR BARAT, FLORES TIMUR, NUSA TENGGARA TIMUR",1,145,6,151
https://kawalpemilu.org#56323,"KARAWATUNG, SOLOR BARAT, FLORES TIMUR, NUSA TENGGARA TIMUR",2,171,9,180
https://kawalpemilu.org#56324,"LAMAWOHONG, SOLOR BARAT, FLORES TIMUR, NUSA TENGGARA TIMUR",1,179,6,185
https://kawalpemilu.org#56325,"DANI WATO, SOLOR BARAT, FLORES TIMUR, NUSA TENGGARA TIMUR",1,138,5,143
https://kawalpemilu.org#56325,"DANI WATO, SOLOR BARAT, FLORES TIMUR, NUSA TENGGARA TIMUR",2,197,4,201
https://kawalpemilu.org#56327,"LEWOTANAH OLE, SOLOR BARAT, FLORES TIMUR, NUSA TENGGARA TIMUR",1,214,2,216
https://kawalpemilu.org#85138,"LEWONAMA, SOLOR BARAT, FLORES TIMUR, NUSA TENGGARA TIMUR",1,125,9,134
https://kawalpemilu.org#85138,"LEWONAMA, SOLOR BARAT, FLORES TIMUR, NUSA TENGGARA TIMUR",2,113,11,124
https://kawalpemilu.org#91282,"TITEHENA, SOLOR BARAT, FLORES TIMUR, NUSA TENGGARA TIMUR",1,229,13,242
https://kawalpemilu.org#56331,"WATANHURA, SOLOR TIMUR, FLORES TIMUR, NUSA TENGGARA TIMUR",1,148,30,178
https://kawalpemilu.org#56332,"LEBAO, SOLOR TIMUR, FLORES TIMUR, NUSA TENGGARA TIMUR",1,176,8,184
https://kawalpemilu.org#56332,"LEBAO, SOLOR TIMUR, FLORES TIMUR, NUSA TENGGARA TIMUR",2,155,3,158
https://kawalpemilu.org#56333,"WATOHARI, SOLOR TIMUR, FLORES TIMUR, NUSA TENGGARA TIMUR",1,83,78,161
https://kawalpemilu.org#56333,"WATOHARI, SOLOR TIMUR, FLORES TIMUR, NUSA TENGGARA TIMUR",2,70,68,138
https://kawalpemilu.org#56334,"MOTONWUTUN, SOLOR TIMUR, FLORES TIMUR, NUSA TENGGARA TIMUR",1,22,231,253
https://kawalpemilu.org#56334,"MOTONWUTUN, SOLOR TIMUR, FLORES TIMUR, NUSA TENGGARA TIMUR",2,48,183,231
https://kawalpemilu.org#56335,"WATOBUKU, SOLOR TIMUR, FLORES TIMUR, NUSA TENGGARA TIMUR",1,27,211,238
https://kawalpemilu.org#56335,"WATOBUKU, SOLOR TIMUR, FLORES TIMUR, NUSA TENGGARA TIMUR",2,11,239,250
https://kawalpemilu.org#56335,"WATOBUKU, SOLOR TIMUR, FLORES TIMUR, NUSA TENGGARA TIMUR",3,22,222,244
https://kawalpemilu.org#56336,"LABELEN, SOLOR TIMUR, FLORES TIMUR, NUSA TENGGARA TIMUR",1,35,146,181
https://kawalpemilu.org#56336,"LABELEN, SOLOR TIMUR, FLORES TIMUR, NUSA TENGGARA TIMUR",2,18,107,125
https://kawalpemilu.org#56337,"MENANGA, SOLOR TIMUR, FLORES TIMUR, NUSA TENGGARA TIMUR",1,54,176,230
https://kawalpemilu.org#56337,"MENANGA, SOLOR TIMUR, FLORES TIMUR, NUSA TENGGARA TIMUR",2,143,91,234
https://kawalpemilu.org#56337,"MENANGA, SOLOR TIMUR, FLORES TIMUR, NUSA TENGGARA TIMUR",3,220,17,237
https://kawalpemilu.org#56338,"LOHAYONG I, SOLOR TIMUR, FLORES TIMUR, NUSA TENGGARA TIMUR",1,29,151,180
https://kawalpemilu.org#56338,"LOHAYONG I, SOLOR TIMUR, FLORES TIMUR, NUSA TENGGARA TIMUR",2,18,161,179
https://kawalpemilu.org#56338,"LOHAYONG I, SOLOR TIMUR, FLORES TIMUR, NUSA TENGGARA TIMUR",3,32,128,160
https://kawalpemilu.org#56339,"WULUBLOLONG, SOLOR TIMUR, FLORES TIMUR, NUSA TENGGARA TIMUR",1,204,8,212
https://kawalpemilu.org#56339,"WULUBLOLONG, SOLOR TIMUR, FLORES TIMUR, NUSA TENGGARA TIMUR",2,127,5,132
https://kawalpemilu.org#56339,"WULUBLOLONG, SOLOR TIMUR, FLORES TIMUR, NUSA TENGGARA TIMUR",3,124,7,131
https://kawalpemilu.org#56340,"LIWO, SOLOR TIMUR, FLORES TIMUR, NUSA TENGGARA TIMUR",1,144,15,159
https://kawalpemilu.org#56340,"LIWO, SOLOR TIMUR, FLORES TIMUR, NUSA TENGGARA TIMUR",2,173,9,182
https://kawalpemilu.org#56341,"TANAH WERANG, SOLOR TIMUR, FLORES TIMUR, NUSA TENGGARA TIMUR",1,39,98,137
https://kawalpemilu.org#56341,"TANAH WERANG, SOLOR TIMUR, FLORES TIMUR, NUSA TENGGARA TIMUR",2,35,106,141
https://kawalpemilu.org#56342,"LEWOHEDO, SOLOR TIMUR, FLORES TIMUR, NUSA TENGGARA TIMUR",1,155,4,159
https://kawalpemilu.org#56342,"LEWOHEDO, SOLOR TIMUR, FLORES TIMUR, NUSA TENGGARA TIMUR",2,101,4,105
https://kawalpemilu.org#56343,"LOHAYONG II, SOLOR TIMUR, FLORES TIMUR, NUSA TENGGARA TIMUR",1,45,188,233
https://kawalpemilu.org#56343,"LOHAYONG II, SOLOR TIMUR, FLORES TIMUR, NUSA TENGGARA TIMUR",2,29,208,237
https://kawalpemilu.org#56343,"LOHAYONG II, SOLOR TIMUR, FLORES TIMUR, NUSA TENGGARA TIMUR",3,44,139,183
https://kawalpemilu.org#56343,"LOHAYONG II, SOLOR TIMUR, FLORES TIMUR, NUSA TENGGARA TIMUR",4,21,124,145
https://kawalpemilu.org#56345,"WATANHURA II, SOLOR TIMUR, FLORES TIMUR, NUSA TENGGARA TIMUR",1,102,70,172
https://kawalpemilu.org#56345,"WATANHURA II, SOLOR TIMUR, FLORES TIMUR, NUSA TENGGARA TIMUR",2,90,20,110
https://kawalpemilu.org#56346,"LEWOGEKA, SOLOR TIMUR, FLORES TIMUR, NUSA TENGGARA TIMUR",1,22,94,116
https://kawalpemilu.org#56346,"LEWOGEKA, SOLOR TIMUR, FLORES TIMUR, NUSA TENGGARA TIMUR",2,17,93,110
https://kawalpemilu.org#56347,"LAMAWAI, SOLOR TIMUR, FLORES TIMUR, NUSA TENGGARA TIMUR",1,50,143,193
https://kawalpemilu.org#56347,"LAMAWAI, SOLOR TIMUR, FLORES TIMUR, NUSA TENGGARA TIMUR",2,59,121,180
https://kawalpemilu.org#56348,"KAWUTA, SOLOR TIMUR, FLORES TIMUR, NUSA TENGGARA TIMUR",1,12,133,145
https://kawalpemilu.org#56348,"KAWUTA, SOLOR TIMUR, FLORES TIMUR, NUSA TENGGARA TIMUR",2,15,128,143
https://kawalpemilu.org#56350,"DUANUR, ADONARA BARAT, FLORES TIMUR, NUSA TENGGARA TIMUR",1,26,181,207
https://kawalpemilu.org#56350,"DUANUR, ADONARA BARAT, FLORES TIMUR, NUSA TENGGARA TIMUR",2,61,170,231
https://kawalpemilu.org#56350,"DUANUR, ADONARA BARAT, FLORES TIMUR, NUSA TENGGARA TIMUR",3,38,198,236
https://kawalpemilu.org#56351,"BUKIT SEBURI, ADONARA BARAT, FLORES TIMUR, NUSA TENGGARA TIMUR",1,161,6,167
https://kawalpemilu.org#56351,"BUKIT SEBURI, ADONARA BARAT, FLORES TIMUR, NUSA TENGGARA TIMUR",2,163,2,165
https://kawalpemilu.org#56352,"WAIWADAN, ADONARA BARAT, FLORES TIMUR, NUSA TENGGARA TIMUR",1,222,5,227
https://kawalpemilu.org#56352,"WAIWADAN, ADONARA BARAT, FLORES TIMUR, NUSA TENGGARA TIMUR",2,192,11,203
https://kawalpemilu.org#56352,"WAIWADAN, ADONARA BARAT, FLORES TIMUR, NUSA TENGGARA TIMUR",3,174,25,199
https://kawalpemilu.org#56352,"WAIWADAN, ADONARA BARAT, FLORES TIMUR, NUSA TENGGARA TIMUR",4,104,105,209
https://kawalpemilu.org#56353,"DANIBAO, ADONARA BARAT, FLORES TIMUR, NUSA TENGGARA TIMUR",1,237,8,245
https://kawalpemilu.org#56353,"DANIBAO, ADONARA BARAT, FLORES TIMUR, NUSA TENGGARA TIMUR",2,73,1,74
https://kawalpemilu.org#56353,"DANIBAO, ADONARA BARAT, FLORES TIMUR, NUSA TENGGARA TIMUR",3,93,8,101
https://kawalpemilu.org#56354,"PAJINIAN, ADONARA BARAT, FLORES TIMUR, NUSA TENGGARA TIMUR",1,181,7,188
https://kawalpemilu.org#56354,"PAJINIAN, ADONARA BARAT, FLORES TIMUR, NUSA TENGGARA TIMUR",2,197,15,212
https://kawalpemilu.org#56355,"ILE PATI, ADONARA BARAT, FLORES TIMUR, NUSA TENGGARA TIMUR",1,265,2,267
https://kawalpemilu.org#56355,"ILE PATI, ADONARA BARAT, FLORES TIMUR, NUSA TENGGARA TIMUR",2,118,6,124
https://kawalpemilu.org#56356,"WUREH, ADONARA BARAT, FLORES TIMUR, NUSA TENGGARA TIMUR",1,219,6,225
https://kawalpemilu.org#56356,"WUREH, ADONARA BARAT, FLORES TIMUR, NUSA TENGGARA TIMUR",2,186,6,192
https://kawalpemilu.org#56357,"TONUWOTAN, ADONARA BARAT, FLORES TIMUR, NUSA TENGGARA TIMUR",1,117,9,126
https://kawalpemilu.org#56357,"TONUWOTAN, ADONARA BARAT, FLORES TIMUR, NUSA TENGGARA TIMUR",2,138,9,147
https://kawalpemilu.org#56358,"HURUNG, ADONARA BARAT, FLORES TIMUR, NUSA TENGGARA TIMUR",1,134,7,141
https://kawalpemilu.org#56358,"HURUNG, ADONARA BARAT, FLORES TIMUR, NUSA TENGGARA TIMUR",2,146,9,155
https://kawalpemilu.org#56359,"BUGALIMA, ADONARA BARAT, FLORES TIMUR, NUSA TENGGARA TIMUR",1,158,7,165
https://kawalpemilu.org#56359,"BUGALIMA, ADONARA BARAT, FLORES TIMUR, NUSA TENGGARA TIMUR",2,141,13,154
https://kawalpemilu.org#56360,"HOMA, ADONARA BARAT, FLORES TIMUR, NUSA TENGGARA TIMUR",1,167,25,192
https://kawalpemilu.org#56360,"HOMA, ADONARA BARAT, FLORES TIMUR, NUSA TENGGARA TIMUR",2,91,3,94
https://kawalpemilu.org#56361,"BUKIT SEBURI II, ADONARA BARAT, FLORES TIMUR, NUSA TENGGARA TIMUR",1,207,9,216
https://kawalpemilu.org#56361,"BUKIT SEBURI II, ADONARA BARAT, FLORES TIMUR, NUSA TENGGARA TIMUR",2,142,42,184
https://kawalpemilu.org#56361,"BUKIT SEBURI II, ADONARA BARAT, FLORES TIMUR, NUSA TENGGARA TIMUR",3,91,11,102
https://kawalpemilu.org#56362,"KIMAKAMAK, ADONARA BARAT, FLORES TIMUR, NUSA TENGGARA TIMUR",1,190,2,192
https://kawalpemilu.org#56363,"WATO BAYA, ADONARA BARAT, FLORES TIMUR, NUSA TENGGARA TIMUR",1,125,22,147
https://kawalpemilu.org#56363,"WATO BAYA, ADONARA BARAT, FLORES TIMUR, NUSA TENGGARA TIMUR",2,186,19,205
https://kawalpemilu.org#56363,"WATO BAYA, ADONARA BARAT, FLORES TIMUR, NUSA TENGGARA TIMUR",3,153,8,161
https://kawalpemilu.org#56364,"NIMUN DANIBAO, ADONARA BARAT, FLORES TIMUR, NUSA TENGGARA TIMUR",1,113,7,120
https://kawalpemilu.org#56364,"NIMUN DANIBAO, ADONARA BARAT, FLORES TIMUR, NUSA TENGGARA TIMUR",2,175,1,176
https://kawalpemilu.org#56365,"WAITUKAN, ADONARA BARAT, FLORES TIMUR, NUSA TENGGARA TIMUR",1,183,31,214
https://kawalpemilu.org#56365,"WAITUKAN, ADONARA BARAT, FLORES TIMUR, NUSA TENGGARA TIMUR",2,128,8,136
https://kawalpemilu.org#85139,"WOLOKIBANG, ADONARA BARAT, FLORES TIMUR, NUSA TENGGARA TIMUR",1,95,6,101
https://kawalpemilu.org#85140,"RIANGPADU, ADONARA BARAT, FLORES TIMUR, NUSA TENGGARA TIMUR",1,159,9,168
https://kawalpemilu.org#56367,"WAILEBE, WOTAN ULUMANDO, FLORES TIMUR, NUSA TENGGARA TIMUR",1,201,4,205
https://kawalpemilu.org#56368,"WOTANULUMADO, WOTAN ULUMANDO, FLORES TIMUR, NUSA TENGGARA TIMUR",1,154,10,164
https://kawalpemilu.org#56368,"WOTANULUMADO, WOTAN ULUMANDO, FLORES TIMUR, NUSA TENGGARA TIMUR",2,121,7,128
https://kawalpemilu.org#56369,"NAYUBAYA, WOTAN ULUMANDO, FLORES TIMUR, NUSA TENGGARA TIMUR",1,130,19,149
https://kawalpemilu.org#56369,"NAYUBAYA, WOTAN ULUMANDO, FLORES TIMUR, NUSA TENGGARA TIMUR",2,142,11,153
https://kawalpemilu.org#56370,"OYANGBARANG, WOTAN ULUMANDO, FLORES TIMUR, NUSA TENGGARA TIMUR",1,219,16,235
https://kawalpemilu.org#56370,"OYANGBARANG, WOTAN ULUMANDO, FLORES TIMUR, NUSA TENGGARA TIMUR",2,223,17,240
https://kawalpemilu.org#56370,"OYANGBARANG, WOTAN ULUMANDO, FLORES TIMUR, NUSA TENGGARA TIMUR",3,68,1,69
https://kawalpemilu.org#56371,"KAWELA, WOTAN ULUMANDO, FLORES TIMUR, NUSA TENGGARA TIMUR",1,253,5,258
https://kawalpemilu.org#56371,"KAWELA, WOTAN ULUMANDO, FLORES TIMUR, NUSA TENGGARA TIMUR",2,154,82,236
https://kawalpemilu.org#56371,"KAWELA, WOTAN ULUMANDO, FLORES TIMUR, NUSA TENGGARA TIMUR",3,28,115,143
https://kawalpemilu.org#56371,"KAWELA, WOTAN ULUMANDO, FLORES TIMUR, NUSA TENGGARA TIMUR",4,94,18,112
https://kawalpemilu.org#56372,"KLUKENGNUKING, WOTAN ULUMANDO, FLORES TIMUR, NUSA TENGGARA TIMUR",1,164,13,177
https://kawalpemilu.org#56372,"KLUKENGNUKING, WOTAN ULUMANDO, FLORES TIMUR, NUSA TENGGARA TIMUR",2,163,7,170
https://kawalpemilu.org#56372,"KLUKENGNUKING, WOTAN ULUMANDO, FLORES TIMUR, NUSA TENGGARA TIMUR",3,156,6,162
https://kawalpemilu.org#56372,"KLUKENGNUKING, WOTAN ULUMANDO, FLORES TIMUR, NUSA TENGGARA TIMUR",4,165,8,173
https://kawalpemilu.org#56373,"PANDAI, WOTAN ULUMANDO, FLORES TIMUR, NUSA TENGGARA TIMUR",1,224,7,231
https://kawalpemilu.org#56373,"PANDAI, WOTAN ULUMANDO, FLORES TIMUR, NUSA TENGGARA TIMUR",2,203,16,219
https://kawalpemilu.org#56374,"BELIKO, WOTAN ULUMANDO, FLORES TIMUR, NUSA TENGGARA TIMUR",1,188,5,193
https://kawalpemilu.org#56375,"SAMASOGE, WOTAN ULUMANDO, FLORES TIMUR, NUSA TENGGARA TIMUR",1,100,106,206
https://kawalpemilu.org#56376,"TOBILOTA, WOTAN ULUMANDO, FLORES TIMUR, NUSA TENGGARA TIMUR",1,184,4,188
https://kawalpemilu.org#56376,"TOBILOTA, WOTAN ULUMANDO, FLORES TIMUR, NUSA TENGGARA TIMUR",2,169,2,171
https://kawalpemilu.org#56377,"TANA TUKAN, WOTAN ULUMANDO, FLORES TIMUR, NUSA TENGGARA TIMUR",1,221,20,241
https://kawalpemilu.org#92174,"DEMONDEI, WOTAN ULUMANDO, FLORES TIMUR, NUSA TENGGARA TIMUR",1,168,6,174
https://kawalpemilu.org#56380,"WAIWERANG KOTA, ADONARA TIMUR, FLORES TIMUR, NUSA TENGGARA TIMUR",1,197,61,258
https://kawalpemilu.org#56380,"WAIWERANG KOTA, ADONARA TIMUR, FLORES TIMUR, NUSA TENGGARA TIMUR",2,105,106,211
https://kawalpemilu.org#56380,"WAIWERANG KOTA, ADONARA TIMUR, FLORES TIMUR, NUSA TENGGARA TIMUR",3,82,170,252
https://kawalpemilu.org#56380,"WAIWERANG KOTA, ADONARA TIMUR, FLORES TIMUR, NUSA TENGGARA TIMUR",4,91,171,262
https://kawalpemilu.org#56380,"WAIWERANG KOTA, ADONARA TIMUR, FLORES TIMUR, NUSA TENGGARA TIMUR",5,157,106,263
https://kawalpemilu.org#56380,"WAIWERANG KOTA, ADONARA TIMUR, FLORES TIMUR, NUSA TENGGARA TIMUR",6,134,21,155
https://kawalpemilu.org#56380,"WAIWERANG KOTA, ADONARA TIMUR, FLORES TIMUR, NUSA TENGGARA TIMUR",7,129,9,138
https://kawalpemilu.org#56380,"WAIWERANG KOTA, ADONARA TIMUR, FLORES TIMUR, NUSA TENGGARA TIMUR",8,207,27,234
https://kawalpemilu.org#56381,"LAMATWELU, ADONARA TIMUR, FLORES TIMUR, NUSA TENGGARA TIMUR",1,173,10,183
https://kawalpemilu.org#56381,"LAMATWELU, ADONARA TIMUR, FLORES TIMUR, NUSA TENGGARA TIMUR",2,138,5,143
https://kawalpemilu.org#56381,"LAMATWELU, ADONARA TIMUR, FLORES TIMUR, NUSA TENGGARA TIMUR",3,185,6,191
https://kawalpemilu.org#56381,"LAMATWELU, ADONARA TIMUR, FLORES TIMUR, NUSA TENGGARA TIMUR",4,109,2,111
https://kawalpemilu.org#56381,"LAMATWELU, ADONARA TIMUR, FLORES TIMUR, NUSA TENGGARA TIMUR",5,119,1,120
https://kawalpemilu.org#56382,"DAWATAA, ADONARA TIMUR, FLORES TIMUR, NUSA TENGGARA TIMUR",1,178,29,207
https://kawalpemilu.org#56383,"TERONG, ADONARA TIMUR, FLORES TIMUR, NUSA TENGGARA TIMUR",1,85,114,199
https://kawalpemilu.org#56383,"TERONG, ADONARA TIMUR, FLORES TIMUR, NUSA TENGGARA TIMUR",2,98,102,200
https://kawalpemilu.org#56383,"TERONG, ADONARA TIMUR, FLORES TIMUR, NUSA TENGGARA TIMUR",3,36,147,183
https://kawalpemilu.org#56383,"TERONG, ADONARA TIMUR, FLORES TIMUR, NUSA TENGGARA TIMUR",4,31,149,180
https://kawalpemilu.org#56383,"TERONG, ADONARA TIMUR, FLORES TIMUR, NUSA TENGGARA TIMUR",5,57,121,178
https://kawalpemilu.org#56384,"BILAL, ADONARA TIMUR, FLORES TIMUR, NUSA TENGGARA TIMUR",1,52,193,245
https://kawalpemilu.org#56384,"BILAL, ADONARA TIMUR, FLORES TIMUR, NUSA TENGGARA TIMUR",2,28,38,66
https://kawalpemilu.org#56385,"LAMAHALA JAYA, ADONARA TIMUR, FLORES TIMUR, NUSA TENGGARA TIMUR",1,30,177,207
https://kawalpemilu.org#56385,"LAMAHALA JAYA, ADONARA TIMUR, FLORES TIMUR, NUSA TENGGARA TIMUR",2,27,155,182
https://kawalpemilu.org#56385,"LAMAHALA JAYA, ADONARA TIMUR, FLORES TIMUR, NUSA TENGGARA TIMUR",3,25,173,198
https://kawalpemilu.org#56385,"LAMAHALA JAYA, ADONARA TIMUR, FLORES TIMUR, NUSA TENGGARA TIMUR",4,14,187,201
https://kawalpemilu.org#56385,"LAMAHALA JAYA, ADONARA TIMUR, FLORES TIMUR, NUSA TENGGARA TIMUR",5,25,179,204
https://kawalpemilu.org#56385,"LAMAHALA JAYA, ADONARA TIMUR, FLORES TIMUR, NUSA TENGGARA TIMUR",6,10,171,181
https://kawalpemilu.org#56385,"LAMAHALA JAYA, ADONARA TIMUR, FLORES TIMUR, NUSA TENGGARA TIMUR",7,14,162,176
https://kawalpemilu.org#56385,"LAMAHALA JAYA, ADONARA TIMUR, FLORES TIMUR, NUSA TENGGARA TIMUR",8,10,198,208
https://kawalpemilu.org#56385,"LAMAHALA JAYA, ADONARA TIMUR, FLORES TIMUR, NUSA TENGGARA TIMUR",9,18,172,190
https://kawalpemilu.org#56385,"LAMAHALA JAYA, ADONARA TIMUR, FLORES TIMUR, NUSA TENGGARA TIMUR",10,10,207,217
https://kawalpemilu.org#56385,"LAMAHALA JAYA, ADONARA TIMUR, FLORES TIMUR, NUSA TENGGARA TIMUR",11,10,184,194
https://kawalpemilu.org#56385,"LAMAHALA JAYA, ADONARA TIMUR, FLORES TIMUR, NUSA TENGGARA TIMUR",12,20,170,190
https://kawalpemilu.org#56385,"LAMAHALA JAYA, ADONARA TIMUR, FLORES TIMUR, NUSA TENGGARA TIMUR",13,24,187,211
https://kawalpemilu.org#56385,"LAMAHALA JAYA, ADONARA TIMUR, FLORES TIMUR, NUSA TENGGARA TIMUR",14,29,180,209
https://kawalpemilu.org#56385,"LAMAHALA JAYA, ADONARA TIMUR, FLORES TIMUR, NUSA TENGGARA TIMUR",15,8,213,221
https://kawalpemilu.org#56386,"WAIBURAK, ADONARA TIMUR, FLORES TIMUR, NUSA TENGGARA TIMUR",1,108,91,199
https://kawalpemilu.org#56386,"WAIBURAK, ADONARA TIMUR, FLORES TIMUR, NUSA TENGGARA TIMUR",2,53,169,222
https://kawalpemilu.org#56386,"WAIBURAK, ADONARA TIMUR, FLORES TIMUR, NUSA TENGGARA TIMUR",3,58,191,249
https://kawalpemilu.org#56386,"WAIBURAK, ADONARA TIMUR, FLORES TIMUR, NUSA TENGGARA TIMUR",4,192,43,235
https://kawalpemilu.org#56386,"WAIBURAK, ADONARA TIMUR, FLORES TIMUR, NUSA TENGGARA TIMUR",5,146,73,219
https://kawalpemilu.org#56386,"WAIBURAK, ADONARA TIMUR, FLORES TIMUR, NUSA TENGGARA TIMUR",6,193,41,234
https://kawalpemilu.org#56387,"NARASAOSINA, ADONARA TIMUR, FLORES TIMUR, NUSA TENGGARA TIMUR",1,172,26,198
https://kawalpemilu.org#56387,"NARASAOSINA, ADONARA TIMUR, FLORES TIMUR, NUSA TENGGARA TIMUR",2,56,2,58
https://kawalpemilu.org#56387,"NARASAOSINA, ADONARA TIMUR, FLORES TIMUR, NUSA TENGGARA TIMUR",3,150,11,161
https://kawalpemilu.org#56388,"KARINGLAMALOUK, ADONARA TIMUR, FLORES TIMUR, NUSA TENGGARA TIMUR",1,259,12,271
https://kawalpemilu.org#56388,"KARINGLAMALOUK, ADONARA TIMUR, FLORES TIMUR, NUSA TENGGARA TIMUR",2,187,7,194
https://kawalpemilu.org#56389,"TUAWOLO, ADONARA TIMUR, FLORES TIMUR, NUSA TENGGARA TIMUR",1,150,4,154
https://kawalpemilu.org#56389,"TUAWOLO, ADONARA TIMUR, FLORES TIMUR, NUSA TENGGARA TIMUR",2,148,6,154
https://kawalpemilu.org#56390,"KIWANGONA, ADONARA TIMUR, FLORES TIMUR, NUSA TENGGARA TIMUR",1,177,11,188
https://kawalpemilu.org#56390,"KIWANGONA, ADONARA TIMUR, FLORES TIMUR, NUSA TENGGARA TIMUR",2,146,16,162
https://kawalpemilu.org#56390,"KIWANGONA, ADONARA TIMUR, FLORES TIMUR, NUSA TENGGARA TIMUR",3,117,14,131
https://kawalpemilu.org#56390,"KIWANGONA, ADONARA TIMUR, FLORES TIMUR, NUSA TENGGARA TIMUR",4,146,13,159
https://kawalpemilu.org#56391,"TAPOBALI, ADONARA TIMUR, FLORES TIMUR, NUSA TENGGARA TIMUR",1,115,34,149
https://kawalpemilu.org#56391,"TAPOBALI, ADONARA TIMUR, FLORES TIMUR, NUSA TENGGARA TIMUR",2,124,16,140
https://kawalpemilu.org#56392,"LEWOBUNGA, ADONARA TIMUR, FLORES TIMUR, NUSA TENGGARA TIMUR",1,131,10,141
https://kawalpemilu.org#56392,"LEWOBUNGA, ADONARA TIMUR, FLORES TIMUR, NUSA TENGGARA TIMUR",2,141,11,152
https://kawalpemilu.org#56392,"LEWOBUNGA, ADONARA TIMUR, FLORES TIMUR, NUSA TENGGARA TIMUR",3,164,21,185
https://kawalpemilu.org#56392,"LEWOBUNGA, ADONARA TIMUR, FLORES TIMUR, NUSA TENGGARA TIMUR",4,177,16,193
https://kawalpemilu.org#56393,"BELOTO, ADONARA TIMUR, FLORES TIMUR, NUSA TENGGARA TIMUR",1,136,4,140
https://kawalpemilu.org#56393,"BELOTO, ADONARA TIMUR, FLORES TIMUR, NUSA TENGGARA TIMUR",2,147,5,152
https://kawalpemilu.org#56393,"BELOTO, ADONARA TIMUR, FLORES TIMUR, NUSA TENGGARA TIMUR",3,99,36,135
https://kawalpemilu.org#56394,"IPI EBANG, ADONARA TIMUR, FLORES TIMUR, NUSA TENGGARA TIMUR",1,122,57,179
https://kawalpemilu.org#56394,"IPI EBANG, ADONARA TIMUR, FLORES TIMUR, NUSA TENGGARA TIMUR",2,69,81,150
https://kawalpemilu.org#56395,"LAMALOTA, ADONARA TIMUR, FLORES TIMUR, NUSA TENGGARA TIMUR",1,183,5,188
https://kawalpemilu.org#56395,"LAMALOTA, ADONARA TIMUR, FLORES TIMUR, NUSA TENGGARA TIMUR",2,138,12,150
https://kawalpemilu.org#56396,"PUHU, ADONARA TIMUR, FLORES TIMUR, NUSA TENGGARA TIMUR",1,119,48,167
https://kawalpemilu.org#56396,"PUHU, ADONARA TIMUR, FLORES TIMUR, NUSA TENGGARA TIMUR",2,170,36,206
https://kawalpemilu.org#56397,"KWAELAGA LAMAWATO, ADONARA TIMUR, FLORES TIMUR, NUSA TENGGARA TIMUR",1,202,22,224
https://kawalpemilu.org#56398,"GELONG, ADONARA TIMUR, FLORES TIMUR, NUSA TENGGARA TIMUR",1,193,27,220
https://kawalpemilu.org#85141,"LELEN BALA, ADONARA TIMUR, FLORES TIMUR, NUSA TENGGARA TIMUR",1,221,8,229
https://kawalpemilu.org#85142,"SAOSINA, ADONARA TIMUR, FLORES TIMUR, NUSA TENGGARA TIMUR",1,149,52,201
https://kawalpemilu.org#85142,"SAOSINA, ADONARA TIMUR, FLORES TIMUR, NUSA TENGGARA TIMUR",2,93,31,124
https://kawalpemilu.org#56400,"REDONTENA, KELUBAGOLIT, FLORES TIMUR, NUSA TENGGARA TIMUR",1,148,4,152
https://kawalpemilu.org#56400,"REDONTENA, KELUBAGOLIT, FLORES TIMUR, NUSA TENGGARA TIMUR",2,130,6,136
https://kawalpemilu.org#56400,"REDONTENA, KELUBAGOLIT, FLORES TIMUR, NUSA TENGGARA TIMUR",3,138,35,173
https://kawalpemilu.org#56400,"REDONTENA, KELUBAGOLIT, FLORES TIMUR, NUSA TENGGARA TIMUR",4,150,9,159
https://kawalpemilu.org#56401,"ADOBALA, KELUBAGOLIT, FLORES TIMUR, NUSA TENGGARA TIMUR",1,171,13,184
https://kawalpemilu.org#56401,"ADOBALA, KELUBAGOLIT, FLORES TIMUR, NUSA TENGGARA TIMUR",2,162,10,172
https://kawalpemilu.org#56402,"HINGA, KELUBAGOLIT, FLORES TIMUR, NUSA TENGGARA TIMUR",1,176,21,197
https://kawalpemilu.org#56402,"HINGA, KELUBAGOLIT, FLORES TIMUR, NUSA TENGGARA TIMUR",2,193,12,205
https://kawalpemilu.org#56402,"HINGA, KELUBAGOLIT, FLORES TIMUR, NUSA TENGGARA TIMUR",3,193,15,208
https://kawalpemilu.org#56403,"LAMAPAHA, KELUBAGOLIT, FLORES TIMUR, NUSA TENGGARA TIMUR",1,190,9,199
https://kawalpemilu.org#56403,"LAMAPAHA, KELUBAGOLIT, FLORES TIMUR, NUSA TENGGARA TIMUR",2,149,6,155
https://kawalpemilu.org#56404,"SUKUTOKAN, KELUBAGOLIT, FLORES TIMUR, NUSA TENGGARA TIMUR",1,141,9,150
https://kawalpemilu.org#56404,"SUKUTOKAN, KELUBAGOLIT, FLORES TIMUR, NUSA TENGGARA TIMUR",2,152,21,173
https://kawalpemilu.org#56404,"SUKUTOKAN, KELUBAGOLIT, FLORES TIMUR, NUSA TENGGARA TIMUR",3,151,20,171
https://kawalpemilu.org#56405,"NISAKARANG, KELUBAGOLIT, FLORES TIMUR, NUSA TENGGARA TIMUR",1,107,27,134
https://kawalpemilu.org#56405,"NISAKARANG, KELUBAGOLIT, FLORES TIMUR, NUSA TENGGARA TIMUR",2,107,40,147
https://kawalpemilu.org#56405,"NISAKARANG, KELUBAGOLIT, FLORES TIMUR, NUSA TENGGARA TIMUR",3,117,31,148
https://kawalpemilu.org#56406,"MUDA, KELUBAGOLIT, FLORES TIMUR, NUSA TENGGARA TIMUR",1,144,14,158
https://kawalpemilu.org#56406,"MUDA, KELUBAGOLIT, FLORES TIMUR, NUSA TENGGARA TIMUR",2,121,14,135
https://kawalpemilu.org#56407,"HORINARA, KELUBAGOLIT, FLORES TIMUR, NUSA TENGGARA TIMUR",1,143,49,192
https://kawalpemilu.org#56407,"HORINARA, KELUBAGOLIT, FLORES TIMUR, NUSA TENGGARA TIMUR",2,97,112,209
https://kawalpemilu.org#56407,"HORINARA, KELUBAGOLIT, FLORES TIMUR, NUSA TENGGARA TIMUR",3,131,56,187
https://kawalpemilu.org#56407,"HORINARA, KELUBAGOLIT, FLORES TIMUR, NUSA TENGGARA TIMUR",4,91,80,171
https://kawalpemilu.org#56408,"PEPAK KELU, KELUBAGOLIT, FLORES TIMUR, NUSA TENGGARA TIMUR",1,154,13,167
https://kawalpemilu.org#56408,"PEPAK KELU, KELUBAGOLIT, FLORES TIMUR, NUSA TENGGARA TIMUR",2,113,23,136
https://kawalpemilu.org#56408,"PEPAK KELU, KELUBAGOLIT, FLORES TIMUR, NUSA TENGGARA TIMUR",3,166,8,174
https://kawalpemilu.org#56408,"PEPAK KELU, KELUBAGOLIT, FLORES TIMUR, NUSA TENGGARA TIMUR",4,165,11,176
https://kawalpemilu.org#56409,"LAMBUNGA, KELUBAGOLIT, FLORES TIMUR, NUSA TENGGARA TIMUR",1,129,25,154
https://kawalpemilu.org#56409,"LAMBUNGA, KELUBAGOLIT, FLORES TIMUR, NUSA TENGGARA TIMUR",2,138,18,156
https://kawalpemilu.org#56409,"LAMBUNGA, KELUBAGOLIT, FLORES TIMUR, NUSA TENGGARA TIMUR",3,150,20,170
https://kawalpemilu.org#56409,"LAMBUNGA, KELUBAGOLIT, FLORES TIMUR, NUSA TENGGARA TIMUR",4,129,35,164
https://kawalpemilu.org#56409,"LAMBUNGA, KELUBAGOLIT, FLORES TIMUR, NUSA TENGGARA TIMUR",5,110,50,160
https://kawalpemilu.org#56409,"LAMBUNGA, KELUBAGOLIT, FLORES TIMUR, NUSA TENGGARA TIMUR",6,117,38,155
https://kawalpemilu.org#56410,"MANGAALENG, KELUBAGOLIT, FLORES TIMUR, NUSA TENGGARA TIMUR",1,163,8,171
https://kawalpemilu.org#56410,"MANGAALENG, KELUBAGOLIT, FLORES TIMUR, NUSA TENGGARA TIMUR",2,186,12,198
https://kawalpemilu.org#56410,"MANGAALENG, KELUBAGOLIT, FLORES TIMUR, NUSA TENGGARA TIMUR",3,155,10,165
https://kawalpemilu.org#56411,"KELUWAIN, KELUBAGOLIT, FLORES TIMUR, NUSA TENGGARA TIMUR",1,154,8,162
https://kawalpemilu.org#56411,"KELUWAIN, KELUBAGOLIT, FLORES TIMUR, NUSA TENGGARA TIMUR",2,157,8,165
https://kawalpemilu.org#56413,"WATOLOLONG, WITIHAMA, FLORES TIMUR, NUSA TENGGARA TIMUR",1,122,3,125
https://kawalpemilu.org#56413,"WATOLOLONG, WITIHAMA, FLORES TIMUR, NUSA TENGGARA TIMUR",2,133,1,134
https://kawalpemilu.org#56414,"TUWAGOETOBI, WITIHAMA, FLORES TIMUR, NUSA TENGGARA TIMUR",1,177,35,212
https://kawalpemilu.org#56414,"TUWAGOETOBI, WITIHAMA, FLORES TIMUR, NUSA TENGGARA TIMUR",2,189,24,213
https://kawalpemilu.org#56414,"TUWAGOETOBI, WITIHAMA, FLORES TIMUR, NUSA TENGGARA TIMUR",3,191,1,192
https://kawalpemilu.org#56414,"TUWAGOETOBI, WITIHAMA, FLORES TIMUR, NUSA TENGGARA TIMUR",4,176,8,184
https://kawalpemilu.org#56414,"TUWAGOETOBI, WITIHAMA, FLORES TIMUR, NUSA TENGGARA TIMUR",5,179,13,192
https://kawalpemilu.org#56415,"WERANGGERE, WITIHAMA, FLORES TIMUR, NUSA TENGGARA TIMUR",1,115,49,164
https://kawalpemilu.org#56415,"WERANGGERE, WITIHAMA, FLORES TIMUR, NUSA TENGGARA TIMUR",2,100,54,154
https://kawalpemilu.org#56416,"ORINGBELE, WITIHAMA, FLORES TIMUR, NUSA TENGGARA TIMUR",1,182,30,212
https://kawalpemilu.org#56416,"ORINGBELE, WITIHAMA, FLORES TIMUR, NUSA TENGGARA TIMUR",2,182,26,208
https://kawalpemilu.org#56416,"ORINGBELE, WITIHAMA, FLORES TIMUR, NUSA TENGGARA TIMUR",3,200,20,220
https://kawalpemilu.org#56416,"ORINGBELE, WITIHAMA, FLORES TIMUR, NUSA TENGGARA TIMUR",4,218,24,242
https://kawalpemilu.org#56417,"WATOONE, WITIHAMA, FLORES TIMUR, NUSA TENGGARA TIMUR",1,226,6,232
https://kawalpemilu.org#56417,"WATOONE, WITIHAMA, FLORES TIMUR, NUSA TENGGARA TIMUR",2,216,11,227
https://kawalpemilu.org#56417,"WATOONE, WITIHAMA, FLORES TIMUR, NUSA TENGGARA TIMUR",3,217,6,223
https://kawalpemilu.org#56417,"WATOONE, WITIHAMA, FLORES TIMUR, NUSA TENGGARA TIMUR",4,200,12,212
https://kawalpemilu.org#56418,"LAMABLAWA, WITIHAMA, FLORES TIMUR, NUSA TENGGARA TIMUR",1,154,27,181
https://kawalpemilu.org#56418,"LAMABLAWA, WITIHAMA, FLORES TIMUR, NUSA TENGGARA TIMUR",2,184,13,197
https://kawalpemilu.org#56418,"LAMABLAWA, WITIHAMA, FLORES TIMUR, NUSA TENGGARA TIMUR",3,153,27,180
https://kawalpemilu.org#56419,"PLEDO, WITIHAMA, FLORES TIMUR, NUSA TENGGARA TIMUR",1,197,12,209
https://kawalpemilu.org#56419,"PLEDO, WITIHAMA, FLORES TIMUR, NUSA TENGGARA TIMUR",2,196,18,214
https://kawalpemilu.org#56419,"PLEDO, WITIHAMA, FLORES TIMUR, NUSA TENGGARA TIMUR",3,187,22,209
https://kawalpemilu.org#56419,"PLEDO, WITIHAMA, FLORES TIMUR, NUSA TENGGARA TIMUR",4,180,23,203
https://kawalpemilu.org#56419,"PLEDO, WITIHAMA, FLORES TIMUR, NUSA TENGGARA TIMUR",5,109,14,123
https://kawalpemilu.org#56420,"LEWOPULO, WITIHAMA, FLORES TIMUR, NUSA TENGGARA TIMUR",1,178,35,213
https://kawalpemilu.org#56420,"LEWOPULO, WITIHAMA, FLORES TIMUR, NUSA TENGGARA TIMUR",2,202,12,214
https://kawalpemilu.org#56421,"SANDOSI, WITIHAMA, FLORES TIMUR, NUSA TENGGARA TIMUR",1,186,11,197
https://kawalpemilu.org#56421,"SANDOSI, WITIHAMA, FLORES TIMUR, NUSA TENGGARA TIMUR",2,193,3,196
https://kawalpemilu.org#56421,"SANDOSI, WITIHAMA, FLORES TIMUR, NUSA TENGGARA TIMUR",3,201,7,208
https://kawalpemilu.org#56421,"SANDOSI, WITIHAMA, FLORES TIMUR, NUSA TENGGARA TIMUR",4,167,10,177
https://kawalpemilu.org#56422,"BALAWELING, WITIHAMA, FLORES TIMUR, NUSA TENGGARA TIMUR",1,181,6,187
https://kawalpemilu.org#56422,"BALAWELING, WITIHAMA, FLORES TIMUR, NUSA TENGGARA TIMUR",2,205,5,210
https://kawalpemilu.org#56423,"TOBITIKA, WITIHAMA, FLORES TIMUR, NUSA TENGGARA TIMUR",1,144,9,153
https://kawalpemilu.org#56423,"TOBITIKA, WITIHAMA, FLORES TIMUR, NUSA TENGGARA TIMUR",2,153,2,155
https://kawalpemilu.org#56424,"RIANGDULI, WITIHAMA, FLORES TIMUR, NUSA TENGGARA TIMUR",1,138,34,172
https://kawalpemilu.org#56424,"RIANGDULI, WITIHAMA, FLORES TIMUR, NUSA TENGGARA TIMUR",2,120,22,142
https://kawalpemilu.org#56425,"WAIWURING, WITIHAMA, FLORES TIMUR, NUSA TENGGARA TIMUR",1,216,21,237
https://kawalpemilu.org#85143,"BAOBAGE, WITIHAMA, FLORES TIMUR, NUSA TENGGARA TIMUR",1,264,4,268
https://kawalpemilu.org#85144,"LAMALEKA, WITIHAMA, FLORES TIMUR, NUSA TENGGARA TIMUR",1,170,7,177
https://kawalpemilu.org#85145,"BALAWELING NOTEN, WITIHAMA, FLORES TIMUR, NUSA TENGGARA TIMUR",1,154,0,154
https://kawalpemilu.org#85145,"BALAWELING NOTEN, WITIHAMA, FLORES TIMUR, NUSA TENGGARA TIMUR",2,142,5,147
https://kawalpemilu.org#56427,"BEDALEWUN, ILE BOLENG, FLORES TIMUR, NUSA TENGGARA TIMUR",1,164,1,165
https://kawalpemilu.org#56427,"BEDALEWUN, ILE BOLENG, FLORES TIMUR, NUSA TENGGARA TIMUR",2,129,3,132
https://kawalpemilu.org#56428,"NIHAONE, ILE BOLENG, FLORES TIMUR, NUSA TENGGARA TIMUR",1,164,13,177
https://kawalpemilu.org#56428,"NIHAONE, ILE BOLENG, FLORES TIMUR, NUSA TENGGARA TIMUR",2,197,3,200
https://kawalpemilu.org#56429,"LEWOBELOLONG, ILE BOLENG, FLORES TIMUR, NUSA TENGGARA TIMUR",1,169,7,176
https://kawalpemilu.org#56430,"BUNGALAWAN, ILE BOLENG, FLORES TIMUR, NUSA TENGGARA TIMUR",1,171,6,177
https://kawalpemilu.org#56430,"BUNGALAWAN, ILE BOLENG, FLORES TIMUR, NUSA TENGGARA TIMUR",2,166,10,176
https://kawalpemilu.org#56431,"LAMAWOLO, ILE BOLENG, FLORES TIMUR, NUSA TENGGARA TIMUR",1,142,4,146
https://kawalpemilu.org#56431,"LAMAWOLO, ILE BOLENG, FLORES TIMUR, NUSA TENGGARA TIMUR",2,190,8,198
https://kawalpemilu.org#56431,"LAMAWOLO, ILE BOLENG, FLORES TIMUR, NUSA TENGGARA TIMUR",3,143,3,146
https://kawalpemilu.org#56431,"LAMAWOLO, ILE BOLENG, FLORES TIMUR, NUSA TENGGARA TIMUR",4,154,4,158
https://kawalpemilu.org#56432,"HELANIANGOWUYO, ILE BOLENG, FLORES TIMUR, NUSA TENGGARA TIMUR",1,231,7,238
https://kawalpemilu.org#56432,"HELANIANGOWUYO, ILE BOLENG, FLORES TIMUR, NUSA TENGGARA TIMUR",2,158,1,159
https://kawalpemilu.org#56432,"HELANIANGOWUYO, ILE BOLENG, FLORES TIMUR, NUSA TENGGARA TIMUR",3,194,14,208
https://kawalpemilu.org#56432,"HELANIANGOWUYO, ILE BOLENG, FLORES TIMUR, NUSA TENGGARA TIMUR",4,174,8,182
https://kawalpemilu.org#56432,"HELANIANGOWUYO, ILE BOLENG, FLORES TIMUR, NUSA TENGGARA TIMUR",5,173,12,185
https://kawalpemilu.org#56432,"HELANIANGOWUYO, ILE BOLENG, FLORES TIMUR, NUSA TENGGARA TIMUR",6,199,14,213
https://kawalpemilu.org#56433,"LEWOPAO, ILE BOLENG, FLORES TIMUR, NUSA TENGGARA TIMUR",1,133,15,148
https://kawalpemilu.org#56433,"LEWOPAO, ILE BOLENG, FLORES TIMUR, NUSA TENGGARA TIMUR",2,131,10,141
https://kawalpemilu.org#56433,"LEWOPAO, ILE BOLENG, FLORES TIMUR, NUSA TENGGARA TIMUR",3,212,30,242
https://kawalpemilu.org#56433,"LEWOPAO, ILE BOLENG, FLORES TIMUR, NUSA TENGGARA TIMUR",4,161,8,169
https://kawalpemilu.org#56434,"GAYAK, ILE BOLENG, FLORES TIMUR, NUSA TENGGARA TIMUR",1,138,6,144
https://kawalpemilu.org#56435,"BOLENG, ILE BOLENG, FLORES TIMUR, NUSA TENGGARA TIMUR",1,30,184,214
https://kawalpemilu.org#56435,"BOLENG, ILE BOLENG, FLORES TIMUR, NUSA TENGGARA TIMUR",2,45,130,175
https://kawalpemilu.org#56435,"BOLENG, ILE BOLENG, FLORES TIMUR, NUSA TENGGARA TIMUR",3,30,129,159
https://kawalpemilu.org#56436,"NELEBLOLONG, ILE BOLENG, FLORES TIMUR, NUSA TENGGARA TIMUR",1,209,6,215
https://kawalpemilu.org#56437,"DUABLOLONG, ILE BOLENG, FLORES TIMUR, NUSA TENGGARA TIMUR",1,218,21,239
https://kawalpemilu.org#56437,"DUABLOLONG, ILE BOLENG, FLORES TIMUR, NUSA TENGGARA TIMUR",2,138,12,150
https://kawalpemilu.org#56438,"LEWO KELENG, ILE BOLENG, FLORES TIMUR, NUSA TENGGARA TIMUR",1,128,2,130
https://kawalpemilu.org#56438,"LEWO KELENG, ILE BOLENG, FLORES TIMUR, NUSA TENGGARA TIMUR",2,124,7,131
https://kawalpemilu.org#56438,"LEWO KELENG, ILE BOLENG, FLORES TIMUR, NUSA TENGGARA TIMUR",3,38,5,43
https://kawalpemilu.org#56439,"NELE LAMAWANGI, ILE BOLENG, FLORES TIMUR, NUSA TENGGARA TIMUR",1,197,11,208
https://kawalpemilu.org#56440,"HARUBALA, ILE BOLENG, FLORES TIMUR, NUSA TENGGARA TIMUR",1,89,5,94
https://kawalpemilu.org#56440,"HARUBALA, ILE BOLENG, FLORES TIMUR, NUSA TENGGARA TIMUR",2,199,7,206
https://kawalpemilu.org#56441,"NELELAMADIKE, ILE BOLENG, FLORES TIMUR, NUSA TENGGARA TIMUR",1,184,41,225
https://kawalpemilu.org#56441,"NELELAMADIKE, ILE BOLENG, FLORES TIMUR, NUSA TENGGARA TIMUR",2,208,22,230
https://kawalpemilu.org#56442,"LAMABAYUNG, ILE BOLENG, FLORES TIMUR, NUSA TENGGARA TIMUR",1,218,10,228
https://kawalpemilu.org#56442,"LAMABAYUNG, ILE BOLENG, FLORES TIMUR, NUSA TENGGARA TIMUR",2,195,7,202
https://kawalpemilu.org#56443,"LEWAT, ILE BOLENG, FLORES TIMUR, NUSA TENGGARA TIMUR",1,226,4,230
https://kawalpemilu.org#56444,"DOKENG, ILE BOLENG, FLORES TIMUR, NUSA TENGGARA TIMUR",1,141,6,147
https://kawalpemilu.org#56445,"BAYUNTAA, ILE BOLENG, FLORES TIMUR, NUSA TENGGARA TIMUR",1,177,4,181
https://kawalpemilu.org#56446,"NOBO, ILE BOLENG, FLORES TIMUR, NUSA TENGGARA TIMUR",1,151,19,170
https://kawalpemilu.org#56446,"NOBO, ILE BOLENG, FLORES TIMUR, NUSA TENGGARA TIMUR",2,87,14,101
https://kawalpemilu.org#85146,"NELELAMAWANGI DUA, ILE BOLENG, FLORES TIMUR, NUSA TENGGARA TIMUR",1,200,5,205
https://kawalpemilu.org#56448,"LAMIKA, DEMON PAGONG, FLORES TIMUR, NUSA TENGGARA TIMUR",1,123,2,125
https://kawalpemilu.org#56448,"LAMIKA, DEMON PAGONG, FLORES TIMUR, NUSA TENGGARA TIMUR",2,136,3,139
https://kawalpemilu.org#56448,"LAMIKA, DEMON PAGONG, FLORES TIMUR, NUSA TENGGARA TIMUR",3,167,3,170
https://kawalpemilu.org#56449,"WATOTIKA ILE, DEMON PAGONG, FLORES TIMUR, NUSA TENGGARA TIMUR",1,170,3,173
https://kawalpemilu.org#56449,"WATOTIKA ILE, DEMON PAGONG, FLORES TIMUR, NUSA TENGGARA TIMUR",2,176,1,177
https://kawalpemilu.org#56450,"LEWOKLUOK, DEMON PAGONG, FLORES TIMUR, NUSA TENGGARA TIMUR",1,234,6,240
https://kawalpemilu.org#56450,"LEWOKLUOK, DEMON PAGONG, FLORES TIMUR, NUSA TENGGARA TIMUR",2,225,10,235
https://kawalpemilu.org#56450,"LEWOKLUOK, DEMON PAGONG, FLORES TIMUR, NUSA TENGGARA TIMUR",3,158,6,164
https://kawalpemilu.org#56450,"LEWOKLUOK, DEMON PAGONG, FLORES TIMUR, NUSA TENGGARA TIMUR",4,100,2,102
https://kawalpemilu.org#56451,"BLEPANAWA, DEMON PAGONG, FLORES TIMUR, NUSA TENGGARA TIMUR",1,157,4,161
https://kawalpemilu.org#56451,"BLEPANAWA, DEMON PAGONG, FLORES TIMUR, NUSA TENGGARA TIMUR",2,130,4,134
https://kawalpemilu.org#56452,"KAWALELO, DEMON PAGONG, FLORES TIMUR, NUSA TENGGARA TIMUR",1,204,5,209
https://kawalpemilu.org#56452,"KAWALELO, DEMON PAGONG, FLORES TIMUR, NUSA TENGGARA TIMUR",2,151,3,154
https://kawalpemilu.org#56453,"BAMA, DEMON PAGONG, FLORES TIMUR, NUSA TENGGARA TIMUR",1,202,18,220
https://kawalpemilu.org#56453,"BAMA, DEMON PAGONG, FLORES TIMUR, NUSA TENGGARA TIMUR",2,204,13,217
https://kawalpemilu.org#85147,"LEWOMUDA, DEMON PAGONG, FLORES TIMUR, NUSA TENGGARA TIMUR",1,185,4,189
https://kawalpemilu.org#56455,"ILE PADUNG, LEWOLEMA, FLORES TIMUR, NUSA TENGGARA TIMUR",1,235,10,245
https://kawalpemilu.org#56455,"ILE PADUNG, LEWOLEMA, FLORES TIMUR, NUSA TENGGARA TIMUR",2,229,6,235
https://kawalpemilu.org#56455,"ILE PADUNG, LEWOLEMA, FLORES TIMUR, NUSA TENGGARA TIMUR",3,216,16,232
https://kawalpemilu.org#56456,"BANTALA, LEWOLEMA, FLORES TIMUR, NUSA TENGGARA TIMUR",2,184,10,194
https://kawalpemilu.org#56456,"BANTALA, LEWOLEMA, FLORES TIMUR, NUSA TENGGARA TIMUR",3,189,8,197
https://kawalpemilu.org#56456,"BANTALA, LEWOLEMA, FLORES TIMUR, NUSA TENGGARA TIMUR",4,153,6,159
https://kawalpemilu.org#56456,"BANTALA, LEWOLEMA, FLORES TIMUR, NUSA TENGGARA TIMUR",5,163,7,170
https://kawalpemilu.org#56457,"SINAR HADING, LEWOLEMA, FLORES TIMUR, NUSA TENGGARA TIMUR",1,220,12,232
https://kawalpemilu.org#56457,"SINAR HADING, LEWOLEMA, FLORES TIMUR, NUSA TENGGARA TIMUR",2,239,12,251
https://kawalpemilu.org#56457,"SINAR HADING, LEWOLEMA, FLORES TIMUR, NUSA TENGGARA TIMUR",3,202,12,214
https://kawalpemilu.org#56458,"PAINAPANG, LEWOLEMA, FLORES TIMUR, NUSA TENGGARA TIMUR",1,170,3,173
https://kawalpemilu.org#56458,"PAINAPANG, LEWOLEMA, FLORES TIMUR, NUSA TENGGARA TIMUR",2,161,2,163
https://kawalpemilu.org#56458,"PAINAPANG, LEWOLEMA, FLORES TIMUR, NUSA TENGGARA TIMUR",3,165,10,175
https://kawalpemilu.org#56458,"PAINAPANG, LEWOLEMA, FLORES TIMUR, NUSA TENGGARA TIMUR",4,179,3,182
https://kawalpemilu.org#56459,"BALUKHERING, LEWOLEMA, FLORES TIMUR, NUSA TENGGARA TIMUR",1,245,6,251
https://kawalpemilu.org#56459,"BALUKHERING, LEWOLEMA, FLORES TIMUR, NUSA TENGGARA TIMUR",2,228,31,259
https://kawalpemilu.org#56459,"BALUKHERING, LEWOLEMA, FLORES TIMUR, NUSA TENGGARA TIMUR",3,184,60,244
https://kawalpemilu.org#56459,"BALUKHERING, LEWOLEMA, FLORES TIMUR, NUSA TENGGARA TIMUR",4,216,21,237
https://kawalpemilu.org#56460,"RIANGKOTEK, LEWOLEMA, FLORES TIMUR, NUSA TENGGARA TIMUR",1,182,2,184
https://kawalpemilu.org#56460,"RIANGKOTEK, LEWOLEMA, FLORES TIMUR, NUSA TENGGARA TIMUR",2,179,1,180
https://kawalpemilu.org#56460,"RIANGKOTEK, LEWOLEMA, FLORES TIMUR, NUSA TENGGARA TIMUR",3,182,5,187
https://kawalpemilu.org#56461,"LEWOBELEN, LEWOLEMA, FLORES TIMUR, NUSA TENGGARA TIMUR",1,219,3,222
https://kawalpemilu.org#56463,"RIANGBARING, ILE BURA, FLORES TIMUR, NUSA TENGGARA TIMUR",1,184,5,189
https://kawalpemilu.org#56463,"RIANGBARING, ILE BURA, FLORES TIMUR, NUSA TENGGARA TIMUR",2,176,3,179
https://kawalpemilu.org#56464,"LEWOTOBI, ILE BURA, FLORES TIMUR, NUSA TENGGARA TIMUR",1,195,2,197
https://kawalpemilu.org#56464,"LEWOTOBI, ILE BURA, FLORES TIMUR, NUSA TENGGARA TIMUR",2,212,2,214
https://kawalpemilu.org#56464,"LEWOTOBI, ILE BURA, FLORES TIMUR, NUSA TENGGARA TIMUR",3,145,0,145
https://kawalpemilu.org#56464,"LEWOTOBI, ILE BURA, FLORES TIMUR, NUSA TENGGARA TIMUR",4,142,5,147
https://kawalpemilu.org#56465,"NURABELEN, ILE BURA, FLORES TIMUR, NUSA TENGGARA TIMUR",1,215,0,215
https://kawalpemilu.org#56465,"NURABELEN, ILE BURA, FLORES TIMUR, NUSA TENGGARA TIMUR",2,192,5,197
https://kawalpemilu.org#56466,"NOBO, ILE BURA, FLORES TIMUR, NUSA TENGGARA TIMUR",1,241,5,246
https://kawalpemilu.org#56466,"NOBO, ILE BURA, FLORES TIMUR, NUSA TENGGARA TIMUR",2,233,3,236
https://kawalpemilu.org#56466,"NOBO, ILE BURA, FLORES TIMUR, NUSA TENGGARA TIMUR",3,223,5,228
https://kawalpemilu.org#56467,"LEWOAWAN, ILE BURA, FLORES TIMUR, NUSA TENGGARA TIMUR",1,191,20,211
https://kawalpemilu.org#56467,"LEWOAWAN, ILE BURA, FLORES TIMUR, NUSA TENGGARA TIMUR",2,174,7,181
https://kawalpemilu.org#56467,"LEWOAWAN, ILE BURA, FLORES TIMUR, NUSA TENGGARA TIMUR",3,190,11,201
https://kawalpemilu.org#85148,"DULIPALI, ILE BURA, FLORES TIMUR, NUSA TENGGARA TIMUR",1,177,15,192
https://kawalpemilu.org#85148,"DULIPALI, ILE BURA, FLORES TIMUR, NUSA TENGGARA TIMUR",2,193,3,196
https://kawalpemilu.org#85149,"RIANG RITA, ILE BURA, FLORES TIMUR, NUSA TENGGARA TIMUR",1,147,3,150
https://kawalpemilu.org#85149,"RIANG RITA, ILE BURA, FLORES TIMUR, NUSA TENGGARA TIMUR",2,138,5,143
https://kawalpemilu.org#56469,"SAGU, ADONARA, FLORES TIMUR, NUSA TENGGARA TIMUR",1,44,124,168
https://kawalpemilu.org#56469,"SAGU, ADONARA, FLORES TIMUR, NUSA TENGGARA TIMUR",2,132,53,185
https://kawalpemilu.org#56469,"SAGU, ADONARA, FLORES TIMUR, NUSA TENGGARA TIMUR",3,132,113,245
https://kawalpemilu.org#56469,"SAGU, ADONARA, FLORES TIMUR, NUSA TENGGARA TIMUR",4,65,114,179
https://kawalpemilu.org#56469,"SAGU, ADONARA, FLORES TIMUR, NUSA TENGGARA TIMUR",5,124,100,224
https://kawalpemilu.org#56469,"SAGU, ADONARA, FLORES TIMUR, NUSA TENGGARA TIMUR",6,38,193,231
https://kawalpemilu.org#56469,"SAGU, ADONARA, FLORES TIMUR, NUSA TENGGARA TIMUR",7,95,31,126
https://kawalpemilu.org#56470,"KOLIMASANG, ADONARA, FLORES TIMUR, NUSA TENGGARA TIMUR",1,168,17,185
https://kawalpemilu.org#56470,"KOLIMASANG, ADONARA, FLORES TIMUR, NUSA TENGGARA TIMUR",2,197,18,215
https://kawalpemilu.org#56470,"KOLIMASANG, ADONARA, FLORES TIMUR, NUSA TENGGARA TIMUR",3,176,32,208
https://kawalpemilu.org#56470,"KOLIMASANG, ADONARA, FLORES TIMUR, NUSA TENGGARA TIMUR",4,165,15,180
https://kawalpemilu.org#56470,"KOLIMASANG, ADONARA, FLORES TIMUR, NUSA TENGGARA TIMUR",5,185,20,205
https://kawalpemilu.org#56471,"KOLILANANG, ADONARA, FLORES TIMUR, NUSA TENGGARA TIMUR",1,243,4,247
https://kawalpemilu.org#56471,"KOLILANANG, ADONARA, FLORES TIMUR, NUSA TENGGARA TIMUR",2,242,6,248
https://kawalpemilu.org#56471,"KOLILANANG, ADONARA, FLORES TIMUR, NUSA TENGGARA TIMUR",3,219,23,242
https://kawalpemilu.org#56472,"TIKATUKANG, ADONARA, FLORES TIMUR, NUSA TENGGARA TIMUR",1,159,28,187
https://kawalpemilu.org#56472,"TIKATUKANG, ADONARA, FLORES TIMUR, NUSA TENGGARA TIMUR",2,132,34,166
https://kawalpemilu.org#56472,"TIKATUKANG, ADONARA, FLORES TIMUR, NUSA TENGGARA TIMUR",3,124,12,136
https://kawalpemilu.org#56473,"NISA NULAN, ADONARA, FLORES TIMUR, NUSA TENGGARA TIMUR",1,128,7,135
https://kawalpemilu.org#56473,"NISA NULAN, ADONARA, FLORES TIMUR, NUSA TENGGARA TIMUR",2,141,4,145
https://kawalpemilu.org#56474,"LAMAHODA, ADONARA, FLORES TIMUR, NUSA TENGGARA TIMUR",1,101,80,181
https://kawalpemilu.org#56474,"LAMAHODA, ADONARA, FLORES TIMUR, NUSA TENGGARA TIMUR",2,104,52,156
https://kawalpemilu.org#56474,"LAMAHODA, ADONARA, FLORES TIMUR, NUSA TENGGARA TIMUR",3,117,44,161
https://kawalpemilu.org#56475,"ADONARA, ADONARA, FLORES TIMUR, NUSA TENGGARA TIMUR",1,73,121,194
https://kawalpemilu.org#56475,"ADONARA, ADONARA, FLORES TIMUR, NUSA TENGGARA TIMUR",2,71,115,186
https://kawalpemilu.org#56475,"ADONARA, ADONARA, FLORES TIMUR, NUSA TENGGARA TIMUR",3,62,112,174
https://kawalpemilu.org#85150,"KOLIPETUNG, ADONARA, FLORES TIMUR, NUSA TENGGARA TIMUR",1,31,103,134
https://kawalpemilu.org#85150,"KOLIPETUNG, ADONARA, FLORES TIMUR, NUSA TENGGARA TIMUR",2,44,88,132
https://kawalpemilu.org#56477,"HOROWURA, ADONARA TENGAH, FLORES TIMUR, NUSA TENGGARA TIMUR",1,190,5,195
https://kawalpemilu.org#56477,"HOROWURA, ADONARA TENGAH, FLORES TIMUR, NUSA TENGGARA TIMUR",2,137,12,149
https://kawalpemilu.org#56477,"HOROWURA, ADONARA TENGAH, FLORES TIMUR, NUSA TENGGARA TIMUR",3,171,10,181
https://kawalpemilu.org#56478,"KOKOTOBO, ADONARA TENGAH, FLORES TIMUR, NUSA TENGGARA TIMUR",1,170,25,195
https://kawalpemilu.org#56478,"KOKOTOBO, ADONARA TENGAH, FLORES TIMUR, NUSA TENGGARA TIMUR",2,210,16,226
https://kawalpemilu.org#56478,"KOKOTOBO, ADONARA TENGAH, FLORES TIMUR, NUSA TENGGARA TIMUR",3,87,5,92
https://kawalpemilu.org#56479,"LITE, ADONARA TENGAH, FLORES TIMUR, NUSA TENGGARA TIMUR",1,210,12,222
https://kawalpemilu.org#56479,"LITE, ADONARA TENGAH, FLORES TIMUR, NUSA TENGGARA TIMUR",2,187,10,197
https://kawalpemilu.org#56479,"LITE, ADONARA TENGAH, FLORES TIMUR, NUSA TENGGARA TIMUR",3,132,5,137
https://kawalpemilu.org#56480,"KENOTAN, ADONARA TENGAH, FLORES TIMUR, NUSA TENGGARA TIMUR",1,211,4,215
https://kawalpemilu.org#56480,"KENOTAN, ADONARA TENGAH, FLORES TIMUR, NUSA TENGGARA TIMUR",2,232,13,245
https://kawalpemilu.org#56480,"KENOTAN, ADONARA TENGAH, FLORES TIMUR, NUSA TENGGARA TIMUR",3,195,2,197
https://kawalpemilu.org#56480,"KENOTAN, ADONARA TENGAH, FLORES TIMUR, NUSA TENGGARA TIMUR",4,192,8,200
https://kawalpemilu.org#56481,"NUBALEMA, ADONARA TENGAH, FLORES TIMUR, NUSA TENGGARA TIMUR",1,94,57,151
https://kawalpemilu.org#56481,"NUBALEMA, ADONARA TENGAH, FLORES TIMUR, NUSA TENGGARA TIMUR",2,128,29,157
https://kawalpemilu.org#56482,"WEWIT, ADONARA TENGAH, FLORES TIMUR, NUSA TENGGARA TIMUR",1,29,173,202
https://kawalpemilu.org#56482,"WEWIT, ADONARA TENGAH, FLORES TIMUR, NUSA TENGGARA TIMUR",2,17,164,181
https://kawalpemilu.org#56482,"WEWIT, ADONARA TENGAH, FLORES TIMUR, NUSA TENGGARA TIMUR",3,94,47,141
https://kawalpemilu.org#56483,"LEWOBELE, ADONARA TENGAH, FLORES TIMUR, NUSA TENGGARA TIMUR",1,189,16,205
https://kawalpemilu.org#56483,"LEWOBELE, ADONARA TENGAH, FLORES TIMUR, NUSA TENGGARA TIMUR",2,174,25,199
https://kawalpemilu.org#56484,"BAYA, ADONARA TENGAH, FLORES TIMUR, NUSA TENGGARA TIMUR",1,202,16,218
https://kawalpemilu.org#56484,"BAYA, ADONARA TENGAH, FLORES TIMUR, NUSA TENGGARA TIMUR",2,201,19,220
https://kawalpemilu.org#56485,"BIDARA, ADONARA TENGAH, FLORES TIMUR, NUSA TENGGARA TIMUR",1,140,29,169
https://kawalpemilu.org#56485,"BIDARA, ADONARA TENGAH, FLORES TIMUR, NUSA TENGGARA TIMUR",2,32,122,154
https://kawalpemilu.org#56486,"OESAYANG, ADONARA TENGAH, FLORES TIMUR, NUSA TENGGARA TIMUR",1,189,11,200
https://kawalpemilu.org#56486,"OESAYANG, ADONARA TENGAH, FLORES TIMUR, NUSA TENGGARA TIMUR",2,201,10,211
https://kawalpemilu.org#56487,"HOKO HOROWURA, ADONARA TENGAH, FLORES TIMUR, NUSA TENGGARA TIMUR",1,178,6,184
https://kawalpemilu.org#56487,"HOKO HOROWURA, ADONARA TENGAH, FLORES TIMUR, NUSA TENGGARA TIMUR",2,155,2,157
https://kawalpemilu.org#56488,"LEWOPAO, ADONARA TENGAH, FLORES TIMUR, NUSA TENGGARA TIMUR",1,109,6,115
https://kawalpemilu.org#56488,"LEWOPAO, ADONARA TENGAH, FLORES TIMUR, NUSA TENGGARA TIMUR",2,95,25,120
https://kawalpemilu.org#85151,"NUBALEMA DUA, ADONARA TENGAH, FLORES TIMUR, NUSA TENGGARA TIMUR",1,154,27,181
https://kawalpemilu.org#85151,"NUBALEMA DUA, ADONARA TENGAH, FLORES TIMUR, NUSA TENGGARA TIMUR",2,180,30,210
https://kawalpemilu.org#56316,"SULENGWASENG, SOLOR SELATAN, FLORES TIMUR, NUSA TENGGARA TIMUR",1,215,11,226
https://kawalpemilu.org#56316,"SULENGWASENG, SOLOR SELATAN, FLORES TIMUR, NUSA TENGGARA TIMUR",2,157,10,167
https://kawalpemilu.org#56320,"LEMANU, SOLOR SELATAN, FLORES TIMUR, NUSA TENGGARA TIMUR",1,181,6,187
https://kawalpemilu.org#56320,"LEMANU, SOLOR SELATAN, FLORES TIMUR, NUSA TENGGARA TIMUR",2,174,10,184
https://kawalpemilu.org#56320,"LEMANU, SOLOR SELATAN, FLORES TIMUR, NUSA TENGGARA TIMUR",3,174,9,183
https://kawalpemilu.org#56326,"KENERE, SOLOR SELATAN, FLORES TIMUR, NUSA TENGGARA TIMUR",1,109,9,118
https://kawalpemilu.org#56326,"KENERE, SOLOR SELATAN, FLORES TIMUR, NUSA TENGGARA TIMUR",2,125,3,128
https://kawalpemilu.org#56330,"LEWOGRARAN, SOLOR SELATAN, FLORES TIMUR, NUSA TENGGARA TIMUR",1,183,12,195
https://kawalpemilu.org#56330,"LEWOGRARAN, SOLOR SELATAN, FLORES TIMUR, NUSA TENGGARA TIMUR",2,140,9,149
https://kawalpemilu.org#85152,"KELIKE, SOLOR SELATAN, FLORES TIMUR, NUSA TENGGARA TIMUR",1,224,2,226
https://kawalpemilu.org#85152,"KELIKE, SOLOR SELATAN, FLORES TIMUR, NUSA TENGGARA TIMUR",2,245,3,248
https://kawalpemilu.org#85153,"KELIKE AIMATAN, SOLOR SELATAN, FLORES TIMUR, NUSA TENGGARA TIMUR",1,141,8,149
https://kawalpemilu.org#85153,"KELIKE AIMATAN, SOLOR SELATAN, FLORES TIMUR, NUSA TENGGARA TIMUR",2,149,6,155
https://kawalpemilu.org#85153,"KELIKE AIMATAN, SOLOR SELATAN, FLORES TIMUR, NUSA TENGGARA TIMUR",3,153,16,169
https://kawalpemilu.org#85154,"BUBUATAGAMU, SOLOR SELATAN, FLORES TIMUR, NUSA TENGGARA TIMUR",1,204,7,211
https://kawalpemilu.org#85154,"BUBUATAGAMU, SOLOR SELATAN, FLORES TIMUR, NUSA TENGGARA TIMUR",2,179,7,186
https://kawalpemilu.org#56491,"MASABEWA, PAGA, SIKKA, NUSA TENGGARA TIMUR",1,162,6,168
https://kawalpemilu.org#56491,"MASABEWA, PAGA, SIKKA, NUSA TENGGARA TIMUR",2,114,23,137
https://kawalpemilu.org#56491,"MASABEWA, PAGA, SIKKA, NUSA TENGGARA TIMUR",3,90,7,97
https://kawalpemilu.org#56491,"MASABEWA, PAGA, SIKKA, NUSA TENGGARA TIMUR",4,171,12,183
https://kawalpemilu.org#56491,"MASABEWA, PAGA, SIKKA, NUSA TENGGARA TIMUR",5,111,6,117
https://kawalpemilu.org#56491,"MASABEWA, PAGA, SIKKA, NUSA TENGGARA TIMUR",6,159,26,185
https://kawalpemilu.org#56491,"MASABEWA, PAGA, SIKKA, NUSA TENGGARA TIMUR",7,152,4,156
https://kawalpemilu.org#56491,"MASABEWA, PAGA, SIKKA, NUSA TENGGARA TIMUR",8,120,5,125
https://kawalpemilu.org#56492,"WOLOWIRO, PAGA, SIKKA, NUSA TENGGARA TIMUR",1,218,6,224
https://kawalpemilu.org#56492,"WOLOWIRO, PAGA, SIKKA, NUSA TENGGARA TIMUR",2,226,9,235
https://kawalpemilu.org#56492,"WOLOWIRO, PAGA, SIKKA, NUSA TENGGARA TIMUR",3,241,10,251
https://kawalpemilu.org#56492,"WOLOWIRO, PAGA, SIKKA, NUSA TENGGARA TIMUR",4,219,24,243
https://kawalpemilu.org#56492,"WOLOWIRO, PAGA, SIKKA, NUSA TENGGARA TIMUR",5,207,18,225
https://kawalpemilu.org#56493,"MBENGU, PAGA, SIKKA, NUSA TENGGARA TIMUR",1,236,6,242
https://kawalpemilu.org#56493,"MBENGU, PAGA, SIKKA, NUSA TENGGARA TIMUR",2,219,15,234
https://kawalpemilu.org#56493,"MBENGU, PAGA, SIKKA, NUSA TENGGARA TIMUR",3,200,18,218
https://kawalpemilu.org#56493,"MBENGU, PAGA, SIKKA, NUSA TENGGARA TIMUR",4,207,14,221
https://kawalpemilu.org#56493,"MBENGU, PAGA, SIKKA, NUSA TENGGARA TIMUR",5,152,74,226
https://kawalpemilu.org#56493,"MBENGU, PAGA, SIKKA, NUSA TENGGARA TIMUR",6,131,6,137
https://kawalpemilu.org#56493,"MBENGU, PAGA, SIKKA, NUSA TENGGARA TIMUR",7,129,14,143
https://kawalpemilu.org#56494,"PAGA, PAGA, SIKKA, NUSA TENGGARA TIMUR",1,171,30,201
https://kawalpemilu.org#56494,"PAGA, PAGA, SIKKA, NUSA TENGGARA TIMUR",2,149,19,168
https://kawalpemilu.org#56494,"PAGA, PAGA, SIKKA, NUSA TENGGARA TIMUR",3,233,10,243
https://kawalpemilu.org#56494,"PAGA, PAGA, SIKKA, NUSA TENGGARA TIMUR",4,149,17,166
https://kawalpemilu.org#56494,"PAGA, PAGA, SIKKA, NUSA TENGGARA TIMUR",5,148,47,195
https://kawalpemilu.org#56494,"PAGA, PAGA, SIKKA, NUSA TENGGARA TIMUR",6,84,7,91
https://kawalpemilu.org#56494,"PAGA, PAGA, SIKKA, NUSA TENGGARA TIMUR",7,74,1,75
https://kawalpemilu.org#56494,"PAGA, PAGA, SIKKA, NUSA TENGGARA TIMUR",8,153,15,168
https://kawalpemilu.org#56494,"PAGA, PAGA, SIKKA, NUSA TENGGARA TIMUR",9,129,23,152
https://kawalpemilu.org#56494,"PAGA, PAGA, SIKKA, NUSA TENGGARA TIMUR",10,192,3,195
https://kawalpemilu.org#56494,"PAGA, PAGA, SIKKA, NUSA TENGGARA TIMUR",11,150,8,158
https://kawalpemilu.org#56494,"PAGA, PAGA, SIKKA, NUSA TENGGARA TIMUR",12,120,38,158
https://kawalpemilu.org#56494,"PAGA, PAGA, SIKKA, NUSA TENGGARA TIMUR",13,158,35,193
https://kawalpemilu.org#56495,"LENANDARETA, PAGA, SIKKA, NUSA TENGGARA TIMUR",1,104,0,104
https://kawalpemilu.org#56495,"LENANDARETA, PAGA, SIKKA, NUSA TENGGARA TIMUR",2,216,19,235
https://kawalpemilu.org#56495,"LENANDARETA, PAGA, SIKKA, NUSA TENGGARA TIMUR",3,172,7,179
https://kawalpemilu.org#56495,"LENANDARETA, PAGA, SIKKA, NUSA TENGGARA TIMUR",4,198,3,201
https://kawalpemilu.org#56496,"MAULOO, PAGA, SIKKA, NUSA TENGGARA TIMUR",1,111,8,119
https://kawalpemilu.org#56496,"MAULOO, PAGA, SIKKA, NUSA TENGGARA TIMUR",2,127,5,132
https://kawalpemilu.org#56496,"MAULOO, PAGA, SIKKA, NUSA TENGGARA TIMUR",3,159,4,163
https://kawalpemilu.org#56497,"WOLOREGA, PAGA, SIKKA, NUSA TENGGARA TIMUR",1,251,5,256
https://kawalpemilu.org#56497,"WOLOREGA, PAGA, SIKKA, NUSA TENGGARA TIMUR",2,146,7,153
https://kawalpemilu.org#56497,"WOLOREGA, PAGA, SIKKA, NUSA TENGGARA TIMUR",3,115,20,135
https://kawalpemilu.org#56497,"WOLOREGA, PAGA, SIKKA, NUSA TENGGARA TIMUR",4,86,0,86
https://kawalpemilu.org#56497,"WOLOREGA, PAGA, SIKKA, NUSA TENGGARA TIMUR",5,102,3,105
https://kawalpemilu.org#56497,"WOLOREGA, PAGA, SIKKA, NUSA TENGGARA TIMUR",6,95,1,96
https://kawalpemilu.org#56498,"WOLOWONA, PAGA, SIKKA, NUSA TENGGARA TIMUR",1,166,8,174
https://kawalpemilu.org#56498,"WOLOWONA, PAGA, SIKKA, NUSA TENGGARA TIMUR",2,127,8,135
https://kawalpemilu.org#56498,"WOLOWONA, PAGA, SIKKA, NUSA TENGGARA TIMUR",3,97,3,100
https://kawalpemilu.org#56500,"BHERA, MEGO, SIKKA, NUSA TENGGARA TIMUR",1,174,9,183
https://kawalpemilu.org#56500,"BHERA, MEGO, SIKKA, NUSA TENGGARA TIMUR",2,189,12,201
https://kawalpemilu.org#56500,"BHERA, MEGO, SIKKA, NUSA TENGGARA TIMUR",3,175,1,176
https://kawalpemilu.org#56500,"BHERA, MEGO, SIKKA, NUSA TENGGARA TIMUR",4,212,12,224
https://kawalpemilu.org#56500,"BHERA, MEGO, SIKKA, NUSA TENGGARA TIMUR",5,131,4,135
https://kawalpemilu.org#56500,"BHERA, MEGO, SIKKA, NUSA TENGGARA TIMUR",6,113,11,124
https://kawalpemilu.org#56500,"BHERA, MEGO, SIKKA, NUSA TENGGARA TIMUR",7,161,9,170
https://kawalpemilu.org#56501,"DOBO, MEGO, SIKKA, NUSA TENGGARA TIMUR",1,164,8,172
https://kawalpemilu.org#56501,"DOBO, MEGO, SIKKA, NUSA TENGGARA TIMUR",2,179,15,194
https://kawalpemilu.org#56501,"DOBO, MEGO, SIKKA, NUSA TENGGARA TIMUR",3,120,1,121
https://kawalpemilu.org#56501,"DOBO, MEGO, SIKKA, NUSA TENGGARA TIMUR",4,159,1,160
https://kawalpemilu.org#56501,"DOBO, MEGO, SIKKA, NUSA TENGGARA TIMUR",5,139,8,147
https://kawalpemilu.org#56501,"DOBO, MEGO, SIKKA, NUSA TENGGARA TIMUR",6,105,6,111
https://kawalpemilu.org#56502,"GERA, MEGO, SIKKA, NUSA TENGGARA TIMUR",1,130,3,133
https://kawalpemilu.org#56502,"GERA, MEGO, SIKKA, NUSA TENGGARA TIMUR",2,170,0,170
https://kawalpemilu.org#56502,"GERA, MEGO, SIKKA, NUSA TENGGARA TIMUR",3,173,4,177
https://kawalpemilu.org#56502,"GERA, MEGO, SIKKA, NUSA TENGGARA TIMUR",4,126,6,132
https://kawalpemilu.org#56502,"GERA, MEGO, SIKKA, NUSA TENGGARA TIMUR",5,133,1,134
https://kawalpemilu.org#56502,"GERA, MEGO, SIKKA, NUSA TENGGARA TIMUR",6,139,4,143
https://kawalpemilu.org#56502,"GERA, MEGO, SIKKA, NUSA TENGGARA TIMUR",7,122,2,124
https://kawalpemilu.org#56503,"LIAKUTU, MEGO, SIKKA, NUSA TENGGARA TIMUR",1,146,4,150
https://kawalpemilu.org#56503,"LIAKUTU, MEGO, SIKKA, NUSA TENGGARA TIMUR",2,217,1,218
https://kawalpemilu.org#56503,"LIAKUTU, MEGO, SIKKA, NUSA TENGGARA TIMUR",3,115,6,121
https://kawalpemilu.org#56504,"PARABUBU, MEGO, SIKKA, NUSA TENGGARA TIMUR",1,146,5,151
https://kawalpemilu.org#56504,"PARABUBU, MEGO, SIKKA, NUSA TENGGARA TIMUR",2,116,11,127
https://kawalpemilu.org#56504,"PARABUBU, MEGO, SIKKA, NUSA TENGGARA TIMUR",3,105,6,111
https://kawalpemilu.org#56505,"WOLODHESA, MEGO, SIKKA, NUSA TENGGARA TIMUR",1,168,6,174
https://kawalpemilu.org#56505,"WOLODHESA, MEGO, SIKKA, NUSA TENGGARA TIMUR",2,227,14,241
https://kawalpemilu.org#56505,"WOLODHESA, MEGO, SIKKA, NUSA TENGGARA TIMUR",3,159,10,165
https://kawalpemilu.org#56506,"KOROBHERA, MEGO, SIKKA, NUSA TENGGARA TIMUR",1,222,14,236
https://kawalpemilu.org#56506,"KOROBHERA, MEGO, SIKKA, NUSA TENGGARA TIMUR",2,163,8,171
https://kawalpemilu.org#56506,"KOROBHERA, MEGO, SIKKA, NUSA TENGGARA TIMUR",3,162,75,237
https://kawalpemilu.org#56507,"NAPUGERA, MEGO, SIKKA, NUSA TENGGARA TIMUR",1,116,3,119
https://kawalpemilu.org#56507,"NAPUGERA, MEGO, SIKKA, NUSA TENGGARA TIMUR",2,125,3,128
https://kawalpemilu.org#56507,"NAPUGERA, MEGO, SIKKA, NUSA TENGGARA TIMUR",3,127,5,132
https://kawalpemilu.org#56508,"KOWI, MEGO, SIKKA, NUSA TENGGARA TIMUR",1,181,4,185
https://kawalpemilu.org#56508,"KOWI, MEGO, SIKKA, NUSA TENGGARA TIMUR",2,107,0,107
https://kawalpemilu.org#56508,"KOWI, MEGO, SIKKA, NUSA TENGGARA TIMUR",3,65,1,66
https://kawalpemilu.org#56509,"DOBO NUAPUU, MEGO, SIKKA, NUSA TENGGARA TIMUR",1,195,6,201
https://kawalpemilu.org#56509,"DOBO NUAPUU, MEGO, SIKKA, NUSA TENGGARA TIMUR",2,141,9,150
https://kawalpemilu.org#56509,"DOBO NUAPUU, MEGO, SIKKA, NUSA TENGGARA TIMUR",3,191,4,195
https://kawalpemilu.org#56511,"LELA, LELA, SIKKA, NUSA TENGGARA TIMUR",1,217,8,225
https://kawalpemilu.org#56511,"LELA, LELA, SIKKA, NUSA TENGGARA TIMUR",2,186,8,194
https://kawalpemilu.org#56511,"LELA, LELA, SIKKA, NUSA TENGGARA TIMUR",3,195,2,197
https://kawalpemilu.org#56511,"LELA, LELA, SIKKA, NUSA TENGGARA TIMUR",4,167,3,170
https://kawalpemilu.org#56511,"LELA, LELA, SIKKA, NUSA TENGGARA TIMUR",5,219,18,237
https://kawalpemilu.org#56511,"LELA, LELA, SIKKA, NUSA TENGGARA TIMUR",6,183,2,185
https://kawalpemilu.org#56511,"LELA, LELA, SIKKA, NUSA TENGGARA TIMUR",7,120,3,123
https://kawalpemilu.org#56512,"WATUTEDANG, LELA, SIKKA, NUSA TENGGARA TIMUR",1,149,2,151
https://kawalpemilu.org#56512,"WATUTEDANG, LELA, SIKKA, NUSA TENGGARA TIMUR",2,180,3,183
https://kawalpemilu.org#56512,"WATUTEDANG, LELA, SIKKA, NUSA TENGGARA TIMUR",3,166,10,176
https://kawalpemilu.org#56513,"KOROWUWU, LELA, SIKKA, NUSA TENGGARA TIMUR",1,196,2,198
https://kawalpemilu.org#56513,"KOROWUWU, LELA, SIKKA, NUSA TENGGARA TIMUR",2,126,4,130
https://kawalpemilu.org#56513,"KOROWUWU, LELA, SIKKA, NUSA TENGGARA TIMUR",3,143,8,151
https://kawalpemilu.org#56513,"KOROWUWU, LELA, SIKKA, NUSA TENGGARA TIMUR",4,110,11,121
https://kawalpemilu.org#56513,"KOROWUWU, LELA, SIKKA, NUSA TENGGARA TIMUR",5,80,2,82
https://kawalpemilu.org#56514,"KOLIDETUNG, LELA, SIKKA, NUSA TENGGARA TIMUR",1,219,20,239
https://kawalpemilu.org#56514,"KOLIDETUNG, LELA, SIKKA, NUSA TENGGARA TIMUR",2,165,9,174
https://kawalpemilu.org#56514,"KOLIDETUNG, LELA, SIKKA, NUSA TENGGARA TIMUR",3,133,13,146
https://kawalpemilu.org#56514,"KOLIDETUNG, LELA, SIKKA, NUSA TENGGARA TIMUR",4,142,8,150
https://kawalpemilu.org#56514,"KOLIDETUNG, LELA, SIKKA, NUSA TENGGARA TIMUR",5,103,0,103
https://kawalpemilu.org#56515,"SIKKA, LELA, SIKKA, NUSA TENGGARA TIMUR",1,168,1,169
https://kawalpemilu.org#56515,"SIKKA, LELA, SIKKA, NUSA TENGGARA TIMUR",2,151,3,154
https://kawalpemilu.org#56515,"SIKKA, LELA, SIKKA, NUSA TENGGARA TIMUR",3,85,2,87
https://kawalpemilu.org#56515,"SIKKA, LELA, SIKKA, NUSA TENGGARA TIMUR",4,157,2,159
https://kawalpemilu.org#56515,"SIKKA, LELA, SIKKA, NUSA TENGGARA TIMUR",5,171,3,174
https://kawalpemilu.org#56516,"ILIGAI, LELA, SIKKA, NUSA TENGGARA TIMUR",1,134,6,140
https://kawalpemilu.org#56516,"ILIGAI, LELA, SIKKA, NUSA TENGGARA TIMUR",2,123,0,123
https://kawalpemilu.org#56516,"ILIGAI, LELA, SIKKA, NUSA TENGGARA TIMUR",3,182,1,183
https://kawalpemilu.org#56516,"ILIGAI, LELA, SIKKA, NUSA TENGGARA TIMUR",4,204,1,205
https://kawalpemilu.org#56516,"ILIGAI, LELA, SIKKA, NUSA TENGGARA TIMUR",5,167,9,176
https://kawalpemilu.org#56517,"HEPANG, LELA, SIKKA, NUSA TENGGARA TIMUR",1,189,7,196
https://kawalpemilu.org#56517,"HEPANG, LELA, SIKKA, NUSA TENGGARA TIMUR",2,171,7,178
https://kawalpemilu.org#56517,"HEPANG, LELA, SIKKA, NUSA TENGGARA TIMUR",3,153,4,157
https://kawalpemilu.org#56517,"HEPANG, LELA, SIKKA, NUSA TENGGARA TIMUR",4,118,8,126
https://kawalpemilu.org#56517,"HEPANG, LELA, SIKKA, NUSA TENGGARA TIMUR",5,156,6,162
https://kawalpemilu.org#56517,"HEPANG, LELA, SIKKA, NUSA TENGGARA TIMUR",6,190,3,193
https://kawalpemilu.org#56518,"BAOPAAT, LELA, SIKKA, NUSA TENGGARA TIMUR",1,221,3,224
https://kawalpemilu.org#56518,"BAOPAAT, LELA, SIKKA, NUSA TENGGARA TIMUR",2,200,1,201
https://kawalpemilu.org#56519,"DU, LELA, SIKKA, NUSA TENGGARA TIMUR",1,223,5,228
https://kawalpemilu.org#56519,"DU, LELA, SIKKA, NUSA TENGGARA TIMUR",2,125,7,132
https://kawalpemilu.org#56521,"NITA, NITA, SIKKA, NUSA TENGGARA TIMUR",1,237,0,237
https://kawalpemilu.org#56521,"NITA, NITA, SIKKA, NUSA TENGGARA TIMUR",2,174,2,176
https://kawalpemilu.org#56521,"NITA, NITA, SIKKA, NUSA TENGGARA TIMUR",3,229,10,239
https://kawalpemilu.org#56521,"NITA, NITA, SIKKA, NUSA TENGGARA TIMUR",4,231,7,238
https://kawalpemilu.org#56521,"NITA, NITA, SIKKA, NUSA TENGGARA TIMUR",5,233,7,240
https://kawalpemilu.org#56521,"NITA, NITA, SIKKA, NUSA TENGGARA TIMUR",6,238,4,242
https://kawalpemilu.org#56521,"NITA, NITA, SIKKA, NUSA TENGGARA TIMUR",7,238,9,247
https://kawalpemilu.org#56521,"NITA, NITA, SIKKA, NUSA TENGGARA TIMUR",8,276,4,280
https://kawalpemilu.org#56522,"TAKAPLAGER, NITA, SIKKA, NUSA TENGGARA TIMUR",1,200,4,204
https://kawalpemilu.org#56522,"TAKAPLAGER, NITA, SIKKA, NUSA TENGGARA TIMUR",2,197,9,206
https://kawalpemilu.org#56522,"TAKAPLAGER, NITA, SIKKA, NUSA TENGGARA TIMUR",3,222,3,225
https://kawalpemilu.org#56522,"TAKAPLAGER, NITA, SIKKA, NUSA TENGGARA TIMUR",4,203,4,207
https://kawalpemilu.org#56523,"TEBUK, NITA, SIKKA, NUSA TENGGARA TIMUR",1,221,3,224
https://kawalpemilu.org#56523,"TEBUK, NITA, SIKKA, NUSA TENGGARA TIMUR",2,170,23,193
https://kawalpemilu.org#56523,"TEBUK, NITA, SIKKA, NUSA TENGGARA TIMUR",3,174,5,179
https://kawalpemilu.org#56523,"TEBUK, NITA, SIKKA, NUSA TENGGARA TIMUR",4,201,12,213
https://kawalpemilu.org#56523,"TEBUK, NITA, SIKKA, NUSA TENGGARA TIMUR",5,139,11,150
https://kawalpemilu.org#56523,"TEBUK, NITA, SIKKA, NUSA TENGGARA TIMUR",6,161,12,173
https://kawalpemilu.org#56524,"LADOGAHAR, NITA, SIKKA, NUSA TENGGARA TIMUR",1,177,18,195
https://kawalpemilu.org#56524,"LADOGAHAR, NITA, SIKKA, NUSA TENGGARA TIMUR",2,159,28,187
https://kawalpemilu.org#56524,"LADOGAHAR, NITA, SIKKA, NUSA TENGGARA TIMUR",3,201,4,205
https://kawalpemilu.org#56524,"LADOGAHAR, NITA, SIKKA, NUSA TENGGARA TIMUR",4,84,1,85
https://kawalpemilu.org#56525,"NITAKLOANG, NITA, SIKKA, NUSA TENGGARA TIMUR",1,261,9,270
https://kawalpemilu.org#56525,"NITAKLOANG, NITA, SIKKA, NUSA TENGGARA TIMUR",2,244,12,256
https://kawalpemilu.org#56525,"NITAKLOANG, NITA, SIKKA, NUSA TENGGARA TIMUR",3,241,13,254
https://kawalpemilu.org#56525,"NITAKLOANG, NITA, SIKKA, NUSA TENGGARA TIMUR",4,238,21,259
https://kawalpemilu.org#56525,"NITAKLOANG, NITA, SIKKA, NUSA TENGGARA TIMUR",5,267,7,274
https://kawalpemilu.org#56526,"WULIWUTIK, NITA, SIKKA, NUSA TENGGARA TIMUR",1,186,2,188
https://kawalpemilu.org#56526,"WULIWUTIK, NITA, SIKKA, NUSA TENGGARA TIMUR",2,177,0,177
https://kawalpemilu.org#56526,"WULIWUTIK, NITA, SIKKA, NUSA TENGGARA TIMUR",3,182,1,183
https://kawalpemilu.org#56526,"WULIWUTIK, NITA, SIKKA, NUSA TENGGARA TIMUR",4,137,3,140
https://kawalpemilu.org#56526,"WULIWUTIK, NITA, SIKKA, NUSA TENGGARA TIMUR",5,167,3,170
https://kawalpemilu.org#56527,"LUSITADA, NITA, SIKKA, NUSA TENGGARA TIMUR",1,198,8,206
https://kawalpemilu.org#56527,"LUSITADA, NITA, SIKKA, NUSA TENGGARA TIMUR",2,175,5,180
https://kawalpemilu.org#56527,"LUSITADA, NITA, SIKKA, NUSA TENGGARA TIMUR",3,191,6,197
https://kawalpemilu.org#56527,"LUSITADA, NITA, SIKKA, NUSA TENGGARA TIMUR",4,155,8,163
https://kawalpemilu.org#56527,"LUSITADA, NITA, SIKKA, NUSA TENGGARA TIMUR",5,176,3,179
https://kawalpemilu.org#56528,"BLORO, NITA, SIKKA, NUSA TENGGARA TIMUR",1,248,10,258
https://kawalpemilu.org#56528,"BLORO, NITA, SIKKA, NUSA TENGGARA TIMUR",2,170,10,180
https://kawalpemilu.org#56528,"BLORO, NITA, SIKKA, NUSA TENGGARA TIMUR",3,177,6,183
https://kawalpemilu.org#56528,"BLORO, NITA, SIKKA, NUSA TENGGARA TIMUR",4,135,9,144
https://kawalpemilu.org#56528,"BLORO, NITA, SIKKA, NUSA TENGGARA TIMUR",5,141,11,152
https://kawalpemilu.org#56529,"RIIT, NITA, SIKKA, NUSA TENGGARA TIMUR",1,197,1,198
https://kawalpemilu.org#56529,"RIIT, NITA, SIKKA, NUSA TENGGARA TIMUR",2,179,0,179
https://kawalpemilu.org#56529,"RIIT, NITA, SIKKA, NUSA TENGGARA TIMUR",3,226,5,231
https://kawalpemilu.org#56529,"RIIT, NITA, SIKKA, NUSA TENGGARA TIMUR",4,131,2,133
https://kawalpemilu.org#56530,"TILANG, NITA, SIKKA, NUSA TENGGARA TIMUR",1,252,12,264
https://kawalpemilu.org#56530,"TILANG, NITA, SIKKA, NUSA TENGGARA TIMUR",2,245,4,249
https://kawalpemilu.org#56530,"TILANG, NITA, SIKKA, NUSA TENGGARA TIMUR",3,246,4,250
https://kawalpemilu.org#56530,"TILANG, NITA, SIKKA, NUSA TENGGARA TIMUR",4,246,4,250
https://kawalpemilu.org#56530,"TILANG, NITA, SIKKA, NUSA TENGGARA TIMUR",5,225,7,232
https://kawalpemilu.org#56530,"TILANG, NITA, SIKKA, NUSA TENGGARA TIMUR",6,170,11,181
https://kawalpemilu.org#56531,"NIRANGKLIUNG, NITA, SIKKA, NUSA TENGGARA TIMUR",1,118,0,118
https://kawalpemilu.org#56531,"NIRANGKLIUNG, NITA, SIKKA, NUSA TENGGARA TIMUR",2,120,5,125
https://kawalpemilu.org#56531,"NIRANGKLIUNG, NITA, SIKKA, NUSA TENGGARA TIMUR",3,229,1,230
https://kawalpemilu.org#56531,"NIRANGKLIUNG, NITA, SIKKA, NUSA TENGGARA TIMUR",4,148,3,151
https://kawalpemilu.org#56531,"NIRANGKLIUNG, NITA, SIKKA, NUSA TENGGARA TIMUR",5,226,5,231
https://kawalpemilu.org#56531,"NIRANGKLIUNG, NITA, SIKKA, NUSA TENGGARA TIMUR",6,142,6,148
https://kawalpemilu.org#56531,"NIRANGKLIUNG, NITA, SIKKA, NUSA TENGGARA TIMUR",7,230,7,237
https://kawalpemilu.org#56531,"NIRANGKLIUNG, NITA, SIKKA, NUSA TENGGARA TIMUR",8,229,7,236
https://kawalpemilu.org#56532,"MAHEBORA, NITA, SIKKA, NUSA TENGGARA TIMUR",1,143,2,145
https://kawalpemilu.org#56532,"MAHEBORA, NITA, SIKKA, NUSA TENGGARA TIMUR",2,135,1,136
https://kawalpemilu.org#56532,"MAHEBORA, NITA, SIKKA, NUSA TENGGARA TIMUR",3,116,1,117
https://kawalpemilu.org#56534,"MADAWAT, ALOK, SIKKA, NUSA TENGGARA TIMUR",1,179,82,261
https://kawalpemilu.org#56534,"MADAWAT, ALOK, SIKKA, NUSA TENGGARA TIMUR",2,188,41,229
https://kawalpemilu.org#56534,"MADAWAT, ALOK, SIKKA, NUSA TENGGARA TIMUR",3,213,7,220
https://kawalpemilu.org#56534,"MADAWAT, ALOK, SIKKA, NUSA TENGGARA TIMUR",4,203,7,210
https://kawalpemilu.org#56534,"MADAWAT, ALOK, SIKKA, NUSA TENGGARA TIMUR",5,199,11,210
https://kawalpemilu.org#56534,"MADAWAT, ALOK, SIKKA, NUSA TENGGARA TIMUR",6,246,8,254
https://kawalpemilu.org#56534,"MADAWAT, ALOK, SIKKA, NUSA TENGGARA TIMUR",7,234,19,253
https://kawalpemilu.org#56534,"MADAWAT, ALOK, SIKKA, NUSA TENGGARA TIMUR",8,173,10,183
https://kawalpemilu.org#56534,"MADAWAT, ALOK, SIKKA, NUSA TENGGARA TIMUR",9,199,13,212
https://kawalpemilu.org#56534,"MADAWAT, ALOK, SIKKA, NUSA TENGGARA TIMUR",10,170,14,184
https://kawalpemilu.org#56534,"MADAWAT, ALOK, SIKKA, NUSA TENGGARA TIMUR",11,172,62,234
https://kawalpemilu.org#56534,"MADAWAT, ALOK, SIKKA, NUSA TENGGARA TIMUR",12,189,41,230
https://kawalpemilu.org#56534,"MADAWAT, ALOK, SIKKA, NUSA TENGGARA TIMUR",13,207,11,218
https://kawalpemilu.org#56534,"MADAWAT, ALOK, SIKKA, NUSA TENGGARA TIMUR",14,190,13,203
https://kawalpemilu.org#56534,"MADAWAT, ALOK, SIKKA, NUSA TENGGARA TIMUR",15,227,11,238
https://kawalpemilu.org#56534,"MADAWAT, ALOK, SIKKA, NUSA TENGGARA TIMUR",16,203,3,206
https://kawalpemilu.org#56534,"MADAWAT, ALOK, SIKKA, NUSA TENGGARA TIMUR",17,214,27,241
https://kawalpemilu.org#56534,"MADAWAT, ALOK, SIKKA, NUSA TENGGARA TIMUR",18,196,16,212
https://kawalpemilu.org#56534,"MADAWAT, ALOK, SIKKA, NUSA TENGGARA TIMUR",19,202,17,219
https://kawalpemilu.org#56534,"MADAWAT, ALOK, SIKKA, NUSA TENGGARA TIMUR",20,232,9,241
https://kawalpemilu.org#56534,"MADAWAT, ALOK, SIKKA, NUSA TENGGARA TIMUR",21,157,12,169
https://kawalpemilu.org#56535,"NANGALIMANG, ALOK, SIKKA, NUSA TENGGARA TIMUR",1,208,19,227
https://kawalpemilu.org#56535,"NANGALIMANG, ALOK, SIKKA, NUSA TENGGARA TIMUR",2,200,13,213
https://kawalpemilu.org#56535,"NANGALIMANG, ALOK, SIKKA, NUSA TENGGARA TIMUR",3,204,9,213
https://kawalpemilu.org#56535,"NANGALIMANG, ALOK, SIKKA, NUSA TENGGARA TIMUR",4,191,21,212
https://kawalpemilu.org#56535,"NANGALIMANG, ALOK, SIKKA, NUSA TENGGARA TIMUR",5,200,26,226
https://kawalpemilu.org#56535,"NANGALIMANG, ALOK, SIKKA, NUSA TENGGARA TIMUR",6,226,13,239
https://kawalpemilu.org#56535,"NANGALIMANG, ALOK, SIKKA, NUSA TENGGARA TIMUR",7,212,6,218
https://kawalpemilu.org#56535,"NANGALIMANG, ALOK, SIKKA, NUSA TENGGARA TIMUR",8,242,19,261
https://kawalpemilu.org#56536,"KABOR, ALOK, SIKKA, NUSA TENGGARA TIMUR",1,194,15,209
https://kawalpemilu.org#56536,"KABOR, ALOK, SIKKA, NUSA TENGGARA TIMUR",2,218,19,237
https://kawalpemilu.org#56536,"KABOR, ALOK, SIKKA, NUSA TENGGARA TIMUR",3,208,21,229
https://kawalpemilu.org#56536,"KABOR, ALOK, SIKKA, NUSA TENGGARA TIMUR",4,250,14,264
https://kawalpemilu.org#56536,"KABOR, ALOK, SIKKA, NUSA TENGGARA TIMUR",5,249,6,255
https://kawalpemilu.org#56536,"KABOR, ALOK, SIKKA, NUSA TENGGARA TIMUR",6,219,10,229
https://kawalpemilu.org#56536,"KABOR, ALOK, SIKKA, NUSA TENGGARA TIMUR",7,220,15,235
https://kawalpemilu.org#56536,"KABOR, ALOK, SIKKA, NUSA TENGGARA TIMUR",8,231,3,234
https://kawalpemilu.org#56537,"KOTA UNENG, ALOK, SIKKA, NUSA TENGGARA TIMUR",1,219,19,238
https://kawalpemilu.org#56537,"KOTA UNENG, ALOK, SIKKA, NUSA TENGGARA TIMUR",2,182,40,222
https://kawalpemilu.org#56537,"KOTA UNENG, ALOK, SIKKA, NUSA TENGGARA TIMUR",3,169,61,230
https://kawalpemilu.org#56537,"KOTA UNENG, ALOK, SIKKA, NUSA TENGGARA TIMUR",4,144,74,218
https://kawalpemilu.org#56537,"KOTA UNENG, ALOK, SIKKA, NUSA TENGGARA TIMUR",5,171,26,197
https://kawalpemilu.org#56537,"KOTA UNENG, ALOK, SIKKA, NUSA TENGGARA TIMUR",6,201,10,211
https://kawalpemilu.org#56537,"KOTA UNENG, ALOK, SIKKA, NUSA TENGGARA TIMUR",7,195,4,199
https://kawalpemilu.org#56537,"KOTA UNENG, ALOK, SIKKA, NUSA TENGGARA TIMUR",8,205,9,214
https://kawalpemilu.org#56537,"KOTA UNENG, ALOK, SIKKA, NUSA TENGGARA TIMUR",9,184,44,228
https://kawalpemilu.org#56537,"KOTA UNENG, ALOK, SIKKA, NUSA TENGGARA TIMUR",10,180,48,228
https://kawalpemilu.org#56537,"KOTA UNENG, ALOK, SIKKA, NUSA TENGGARA TIMUR",11,115,88,203
https://kawalpemilu.org#56537,"KOTA UNENG, ALOK, SIKKA, NUSA TENGGARA TIMUR",12,141,15,156
https://kawalpemilu.org#56537,"KOTA UNENG, ALOK, SIKKA, NUSA TENGGARA TIMUR",13,163,21,184
https://kawalpemilu.org#56537,"KOTA UNENG, ALOK, SIKKA, NUSA TENGGARA TIMUR",14,214,13,227
https://kawalpemilu.org#56537,"KOTA UNENG, ALOK, SIKKA, NUSA TENGGARA TIMUR",15,229,10,239
https://kawalpemilu.org#56537,"KOTA UNENG, ALOK, SIKKA, NUSA TENGGARA TIMUR",16,178,43,221
https://kawalpemilu.org#56537,"KOTA UNENG, ALOK, SIKKA, NUSA TENGGARA TIMUR",17,189,26,215
https://kawalpemilu.org#56537,"KOTA UNENG, ALOK, SIKKA, NUSA TENGGARA TIMUR",18,201,23,224
https://kawalpemilu.org#56537,"KOTA UNENG, ALOK, SIKKA, NUSA TENGGARA TIMUR",19,187,10,197
https://kawalpemilu.org#56537,"KOTA UNENG, ALOK, SIKKA, NUSA TENGGARA TIMUR",20,214,6,220
https://kawalpemilu.org#56537,"KOTA UNENG, ALOK, SIKKA, NUSA TENGGARA TIMUR",21,194,31,225
https://kawalpemilu.org#56537,"KOTA UNENG, ALOK, SIKKA, NUSA TENGGARA TIMUR",22,164,42,206
https://kawalpemilu.org#56537,"KOTA UNENG, ALOK, SIKKA, NUSA TENGGARA TIMUR",23,116,95,211
https://kawalpemilu.org#56537,"KOTA UNENG, ALOK, SIKKA, NUSA TENGGARA TIMUR",24,171,35,206
https://kawalpemilu.org#56538,"PEMANA, ALOK, SIKKA, NUSA TENGGARA TIMUR",1,73,119,192
https://kawalpemilu.org#56538,"PEMANA, ALOK, SIKKA, NUSA TENGGARA TIMUR",2,73,96,169
https://kawalpemilu.org#56538,"PEMANA, ALOK, SIKKA, NUSA TENGGARA TIMUR",3,88,113,201
https://kawalpemilu.org#56538,"PEMANA, ALOK, SIKKA, NUSA TENGGARA TIMUR",4,90,113,203
https://kawalpemilu.org#56538,"PEMANA, ALOK, SIKKA, NUSA TENGGARA TIMUR",5,86,123,209
https://kawalpemilu.org#56538,"PEMANA, ALOK, SIKKA, NUSA TENGGARA TIMUR",6,89,116,205
https://kawalpemilu.org#56538,"PEMANA, ALOK, SIKKA, NUSA TENGGARA TIMUR",7,94,97,191
https://kawalpemilu.org#56538,"PEMANA, ALOK, SIKKA, NUSA TENGGARA TIMUR",8,133,66,199
https://kawalpemilu.org#56538,"PEMANA, ALOK, SIKKA, NUSA TENGGARA TIMUR",9,129,72,201
https://kawalpemilu.org#56539,"SAMPARONG, ALOK, SIKKA, NUSA TENGGARA TIMUR",1,19,156,175
https://kawalpemilu.org#56539,"SAMPARONG, ALOK, SIKKA, NUSA TENGGARA TIMUR",2,75,122,197
https://kawalpemilu.org#56539,"SAMPARONG, ALOK, SIKKA, NUSA TENGGARA TIMUR",3,44,137,181
https://kawalpemilu.org#56540,"GUNUNG SARI, ALOK, SIKKA, NUSA TENGGARA TIMUR",1,112,64,176
https://kawalpemilu.org#56540,"GUNUNG SARI, ALOK, SIKKA, NUSA TENGGARA TIMUR",2,183,100,283
https://kawalpemilu.org#56540,"GUNUNG SARI, ALOK, SIKKA, NUSA TENGGARA TIMUR",3,141,103,244
https://kawalpemilu.org#56540,"GUNUNG SARI, ALOK, SIKKA, NUSA TENGGARA TIMUR",4,79,76,155
https://kawalpemilu.org#56542,"MALURIWU, PALUE, SIKKA, NUSA TENGGARA TIMUR",1,169,3,172
https://kawalpemilu.org#56542,"MALURIWU, PALUE, SIKKA, NUSA TENGGARA TIMUR",2,188,2,190
https://kawalpemilu.org#56542,"MALURIWU, PALUE, SIKKA, NUSA TENGGARA TIMUR",3,166,1,167
https://kawalpemilu.org#56542,"MALURIWU, PALUE, SIKKA, NUSA TENGGARA TIMUR",4,116,0,116
https://kawalpemilu.org#56543,"RERUWAIRERE, PALUE, SIKKA, NUSA TENGGARA TIMUR",1,145,0,145
https://kawalpemilu.org#56543,"RERUWAIRERE, PALUE, SIKKA, NUSA TENGGARA TIMUR",2,137,0,137
https://kawalpemilu.org#56543,"RERUWAIRERE, PALUE, SIKKA, NUSA TENGGARA TIMUR",3,224,4,228
https://kawalpemilu.org#56543,"RERUWAIRERE, PALUE, SIKKA, NUSA TENGGARA TIMUR",4,182,0,182
https://kawalpemilu.org#56544,"TUANGGEO, PALUE, SIKKA, NUSA TENGGARA TIMUR",1,112,7,119
https://kawalpemilu.org#56544,"TUANGGEO, PALUE, SIKKA, NUSA TENGGARA TIMUR",2,179,16,195
https://kawalpemilu.org#56544,"TUANGGEO, PALUE, SIKKA, NUSA TENGGARA TIMUR",3,149,14,163
https://kawalpemilu.org#56544,"TUANGGEO, PALUE, SIKKA, NUSA TENGGARA TIMUR",4,140,1,141
https://kawalpemilu.org#56545,"LADOLAKA, PALUE, SIKKA, NUSA TENGGARA TIMUR",1,142,2,144
https://kawalpemilu.org#56545,"LADOLAKA, PALUE, SIKKA, NUSA TENGGARA TIMUR",2,221,2,223
https://kawalpemilu.org#56545,"LADOLAKA, PALUE, SIKKA, NUSA TENGGARA TIMUR",3,225,20,245
https://kawalpemilu.org#56545,"LADOLAKA, PALUE, SIKKA, NUSA TENGGARA TIMUR",4,132,0,132
https://kawalpemilu.org#56546,"NITUNGLEA, PALUE, SIKKA, NUSA TENGGARA TIMUR",1,212,2,214
https://kawalpemilu.org#56546,"NITUNGLEA, PALUE, SIKKA, NUSA TENGGARA TIMUR",2,178,2,180
https://kawalpemilu.org#56546,"NITUNGLEA, PALUE, SIKKA, NUSA TENGGARA TIMUR",3,117,0,117
https://kawalpemilu.org#56546,"NITUNGLEA, PALUE, SIKKA, NUSA TENGGARA TIMUR",4,147,5,152
https://kawalpemilu.org#56547,"ROKIROLE, PALUE, SIKKA, NUSA TENGGARA TIMUR",1,131,0,131
https://kawalpemilu.org#56547,"ROKIROLE, PALUE, SIKKA, NUSA TENGGARA TIMUR",2,217,0,217
https://kawalpemilu.org#56547,"ROKIROLE, PALUE, SIKKA, NUSA TENGGARA TIMUR",3,183,3,186
https://kawalpemilu.org#56547,"ROKIROLE, PALUE, SIKKA, NUSA TENGGARA TIMUR",4,134,0,134
https://kawalpemilu.org#56548,"KESOKOJA, PALUE, SIKKA, NUSA TENGGARA TIMUR",1,246,0,246
https://kawalpemilu.org#56548,"KESOKOJA, PALUE, SIKKA, NUSA TENGGARA TIMUR",2,177,0,177
https://kawalpemilu.org#56548,"KESOKOJA, PALUE, SIKKA, NUSA TENGGARA TIMUR",3,167,1,168
https://kawalpemilu.org#56548,"KESOKOJA, PALUE, SIKKA, NUSA TENGGARA TIMUR",4,214,0,214
https://kawalpemilu.org#56549,"LIDI, PALUE, SIKKA, NUSA TENGGARA TIMUR",1,164,0,164
https://kawalpemilu.org#56549,"LIDI, PALUE, SIKKA, NUSA TENGGARA TIMUR",2,187,2,189
https://kawalpemilu.org#56549,"LIDI, PALUE, SIKKA, NUSA TENGGARA TIMUR",3,189,1,190
https://kawalpemilu.org#56549,"LIDI, PALUE, SIKKA, NUSA TENGGARA TIMUR",4,114,0,114
https://kawalpemilu.org#56551,"NELLE URUNG, NELLE, SIKKA, NUSA TENGGARA TIMUR",1,200,13,213
https://kawalpemilu.org#56551,"NELLE URUNG, NELLE, SIKKA, NUSA TENGGARA TIMUR",2,192,19,211
https://kawalpemilu.org#56551,"NELLE URUNG, NELLE, SIKKA, NUSA TENGGARA TIMUR",3,200,11,211
https://kawalpemilu.org#56551,"NELLE URUNG, NELLE, SIKKA, NUSA TENGGARA TIMUR",4,221,5,226
https://kawalpemilu.org#56552,"NELLE WUTUNG, NELLE, SIKKA, NUSA TENGGARA TIMUR",1,215,1,216
https://kawalpemilu.org#56552,"NELLE WUTUNG, NELLE, SIKKA, NUSA TENGGARA TIMUR",2,228,4,232
https://kawalpemilu.org#56552,"NELLE WUTUNG, NELLE, SIKKA, NUSA TENGGARA TIMUR",3,247,8,255
https://kawalpemilu.org#56552,"NELLE WUTUNG, NELLE, SIKKA, NUSA TENGGARA TIMUR",4,239,2,241
https://kawalpemilu.org#56553,"NELLE BARAT, NELLE, SIKKA, NUSA TENGGARA TIMUR",1,208,10,218
https://kawalpemilu.org#56553,"NELLE BARAT, NELLE, SIKKA, NUSA TENGGARA TIMUR",2,216,3,219
https://kawalpemilu.org#56554,"NELLA LORANG, NELLE, SIKKA, NUSA TENGGARA TIMUR",1,218,8,226
https://kawalpemilu.org#56554,"NELLA LORANG, NELLE, SIKKA, NUSA TENGGARA TIMUR",3,188,6,194
https://kawalpemilu.org#56554,"NELLA LORANG, NELLE, SIKKA, NUSA TENGGARA TIMUR",4,209,9,218
https://kawalpemilu.org#56555,"MANUBURA, NELLE, SIKKA, NUSA TENGGARA TIMUR",1,222,11,233
https://kawalpemilu.org#56555,"MANUBURA, NELLE, SIKKA, NUSA TENGGARA TIMUR",2,208,9,217
https://kawalpemilu.org#56555,"MANUBURA, NELLE, SIKKA, NUSA TENGGARA TIMUR",3,228,2,230
https://kawalpemilu.org#56557,"DARAT GUNUNG, TALIBURA, SIKKA, NUSA TENGGARA TIMUR",1,197,4,201
https://kawalpemilu.org#56557,"DARAT GUNUNG, TALIBURA, SIKKA, NUSA TENGGARA TIMUR",2,209,3,212
https://kawalpemilu.org#56557,"DARAT GUNUNG, TALIBURA, SIKKA, NUSA TENGGARA TIMUR",3,162,2,164
https://kawalpemilu.org#56557,"DARAT GUNUNG, TALIBURA, SIKKA, NUSA TENGGARA TIMUR",4,164,2,166
https://kawalpemilu.org#56557,"DARAT GUNUNG, TALIBURA, SIKKA, NUSA TENGGARA TIMUR",5,190,3,193
https://kawalpemilu.org#56558,"OJANG, TALIBURA, SIKKA, NUSA TENGGARA TIMUR",1,231,12,243
https://kawalpemilu.org#56558,"OJANG, TALIBURA, SIKKA, NUSA TENGGARA TIMUR",2,140,3,143
https://kawalpemilu.org#56558,"OJANG, TALIBURA, SIKKA, NUSA TENGGARA TIMUR",3,152,13,165
https://kawalpemilu.org#56559,"HIKONG, TALIBURA, SIKKA, NUSA TENGGARA TIMUR",1,184,3,187
https://kawalpemilu.org#56559,"HIKONG, TALIBURA, SIKKA, NUSA TENGGARA TIMUR",2,169,6,175
https://kawalpemilu.org#56559,"HIKONG, TALIBURA, SIKKA, NUSA TENGGARA TIMUR",3,149,2,151
https://kawalpemilu.org#56559,"HIKONG, TALIBURA, SIKKA, NUSA TENGGARA TIMUR",4,130,0,130
https://kawalpemilu.org#56559,"HIKONG, TALIBURA, SIKKA, NUSA TENGGARA TIMUR",5,194,0,194
https://kawalpemilu.org#56559,"HIKONG, TALIBURA, SIKKA, NUSA TENGGARA TIMUR",6,185,0,185
https://kawalpemilu.org#56560,"NEBE, TALIBURA, SIKKA, NUSA TENGGARA TIMUR",1,177,6,183
https://kawalpemilu.org#56560,"NEBE, TALIBURA, SIKKA, NUSA TENGGARA TIMUR",2,193,14,207
https://kawalpemilu.org#56560,"NEBE, TALIBURA, SIKKA, NUSA TENGGARA TIMUR",3,149,10,159
https://kawalpemilu.org#56560,"NEBE, TALIBURA, SIKKA, NUSA TENGGARA TIMUR",4,201,3,204
https://kawalpemilu.org#56560,"NEBE, TALIBURA, SIKKA, NUSA TENGGARA TIMUR",5,172,2,174
https://kawalpemilu.org#56561,"WAILAMUNG, TALIBURA, SIKKA, NUSA TENGGARA TIMUR",1,157,11,168
https://kawalpemilu.org#56561,"WAILAMUNG, TALIBURA, SIKKA, NUSA TENGGARA TIMUR",2,213,5,218
https://kawalpemilu.org#56561,"WAILAMUNG, TALIBURA, SIKKA, NUSA TENGGARA TIMUR",3,221,19,240
https://kawalpemilu.org#56561,"WAILAMUNG, TALIBURA, SIKKA, NUSA TENGGARA TIMUR",4,193,3,196
https://kawalpemilu.org#56562,"LEWOMADA, TALIBURA, SIKKA, NUSA TENGGARA TIMUR",1,170,2,172
https://kawalpemilu.org#56562,"LEWOMADA, TALIBURA, SIKKA, NUSA TENGGARA TIMUR",2,185,4,189
https://kawalpemilu.org#56562,"LEWOMADA, TALIBURA, SIKKA, NUSA TENGGARA TIMUR",3,112,11,123
https://kawalpemilu.org#56562,"LEWOMADA, TALIBURA, SIKKA, NUSA TENGGARA TIMUR",4,115,21,136
https://kawalpemilu.org#56562,"LEWOMADA, TALIBURA, SIKKA, NUSA TENGGARA TIMUR",5,124,6,130
https://kawalpemilu.org#56562,"LEWOMADA, TALIBURA, SIKKA, NUSA TENGGARA TIMUR",6,113,9,122
https://kawalpemilu.org#56563,"NANGAHALE, TALIBURA, SIKKA, NUSA TENGGARA TIMUR",1,74,114,188
https://kawalpemilu.org#56563,"NANGAHALE, TALIBURA, SIKKA, NUSA TENGGARA TIMUR",2,70,124,194
https://kawalpemilu.org#56563,"NANGAHALE, TALIBURA, SIKKA, NUSA TENGGARA TIMUR",3,86,108,194
https://kawalpemilu.org#56563,"NANGAHALE, TALIBURA, SIKKA, NUSA TENGGARA TIMUR",4,35,202,237
https://kawalpemilu.org#56563,"NANGAHALE, TALIBURA, SIKKA, NUSA TENGGARA TIMUR",5,66,167,233
https://kawalpemilu.org#56563,"NANGAHALE, TALIBURA, SIKKA, NUSA TENGGARA TIMUR",6,181,4,185
https://kawalpemilu.org#56563,"NANGAHALE, TALIBURA, SIKKA, NUSA TENGGARA TIMUR",7,165,24,189
https://kawalpemilu.org#56563,"NANGAHALE, TALIBURA, SIKKA, NUSA TENGGARA TIMUR",8,175,33,208
https://kawalpemilu.org#56563,"NANGAHALE, TALIBURA, SIKKA, NUSA TENGGARA TIMUR",9,196,24,220
https://kawalpemilu.org#56563,"NANGAHALE, TALIBURA, SIKKA, NUSA TENGGARA TIMUR",10,57,126,183
https://kawalpemilu.org#56563,"NANGAHALE, TALIBURA, SIKKA, NUSA TENGGARA TIMUR",11,65,151,216
https://kawalpemilu.org#56564,"DARAT PANTAI, TALIBURA, SIKKA, NUSA TENGGARA TIMUR",1,144,55,199
https://kawalpemilu.org#56564,"DARAT PANTAI, TALIBURA, SIKKA, NUSA TENGGARA TIMUR",2,166,56,222
https://kawalpemilu.org#56564,"DARAT PANTAI, TALIBURA, SIKKA, NUSA TENGGARA TIMUR",3,89,29,118
https://kawalpemilu.org#56564,"DARAT PANTAI, TALIBURA, SIKKA, NUSA TENGGARA TIMUR",4,226,22,248
https://kawalpemilu.org#56565,"TALIBURA, TALIBURA, SIKKA, NUSA TENGGARA TIMUR",1,192,11,203
https://kawalpemilu.org#56565,"TALIBURA, TALIBURA, SIKKA, NUSA TENGGARA TIMUR",2,208,20,228
https://kawalpemilu.org#56565,"TALIBURA, TALIBURA, SIKKA, NUSA TENGGARA TIMUR",3,208,23,231
https://kawalpemilu.org#56565,"TALIBURA, TALIBURA, SIKKA, NUSA TENGGARA TIMUR",4,182,14,196
https://kawalpemilu.org#56565,"TALIBURA, TALIBURA, SIKKA, NUSA TENGGARA TIMUR",5,179,12,191
https://kawalpemilu.org#56565,"TALIBURA, TALIBURA, SIKKA, NUSA TENGGARA TIMUR",6,158,6,164
https://kawalpemilu.org#56566,"KRINGA, TALIBURA, SIKKA, NUSA TENGGARA TIMUR",1,165,2,167
https://kawalpemilu.org#56566,"KRINGA, TALIBURA, SIKKA, NUSA TENGGARA TIMUR",2,165,13,178
https://kawalpemilu.org#56566,"KRINGA, TALIBURA, SIKKA, NUSA TENGGARA TIMUR",3,190,12,202
https://kawalpemilu.org#56566,"KRINGA, TALIBURA, SIKKA, NUSA TENGGARA TIMUR",4,150,6,156
https://kawalpemilu.org#56567,"BANGKOOR, TALIBURA, SIKKA, NUSA TENGGARA TIMUR",1,196,7,203
https://kawalpemilu.org#56567,"BANGKOOR, TALIBURA, SIKKA, NUSA TENGGARA TIMUR",2,212,2,214
https://kawalpemilu.org#56567,"BANGKOOR, TALIBURA, SIKKA, NUSA TENGGARA TIMUR",3,205,6,211
https://kawalpemilu.org#56567,"BANGKOOR, TALIBURA, SIKKA, NUSA TENGGARA TIMUR",4,169,9,178
https://kawalpemilu.org#56567,"BANGKOOR, TALIBURA, SIKKA, NUSA TENGGARA TIMUR",5,174,16,190
https://kawalpemilu.org#56567,"BANGKOOR, TALIBURA, SIKKA, NUSA TENGGARA TIMUR",6,121,15,136
https://kawalpemilu.org#56568,"TIMUTAWA, TALIBURA, SIKKA, NUSA TENGGARA TIMUR",1,164,3,167
https://kawalpemilu.org#56568,"TIMUTAWA, TALIBURA, SIKKA, NUSA TENGGARA TIMUR",2,151,14,165
https://kawalpemilu.org#56568,"TIMUTAWA, TALIBURA, SIKKA, NUSA TENGGARA TIMUR",3,97,3,100
https://kawalpemilu.org#56570,"RUNUT, WAIGETE, SIKKA, NUSA TENGGARA TIMUR",1,212,7,219
https://kawalpemilu.org#56570,"RUNUT, WAIGETE, SIKKA, NUSA TENGGARA TIMUR",2,199,4,203
https://kawalpemilu.org#56570,"RUNUT, WAIGETE, SIKKA, NUSA TENGGARA TIMUR",3,199,10,209
https://kawalpemilu.org#56570,"RUNUT, WAIGETE, SIKKA, NUSA TENGGARA TIMUR",4,184,9,193
https://kawalpemilu.org#56570,"RUNUT, WAIGETE, SIKKA, NUSA TENGGARA TIMUR",5,172,19,191
https://kawalpemilu.org#56570,"RUNUT, WAIGETE, SIKKA, NUSA TENGGARA TIMUR",6,172,12,184
https://kawalpemilu.org#56570,"RUNUT, WAIGETE, SIKKA, NUSA TENGGARA TIMUR",7,129,3,132
https://kawalpemilu.org#56571,"EGON, WAIGETE, SIKKA, NUSA TENGGARA TIMUR",1,222,10,232
https://kawalpemilu.org#56571,"EGON, WAIGETE, SIKKA, NUSA TENGGARA TIMUR",3,211,13,224
https://kawalpemilu.org#56571,"EGON, WAIGETE, SIKKA, NUSA TENGGARA TIMUR",4,241,8,249
https://kawalpemilu.org#56571,"EGON, WAIGETE, SIKKA, NUSA TENGGARA TIMUR",5,251,16,267
https://kawalpemilu.org#56571,"EGON, WAIGETE, SIKKA, NUSA TENGGARA TIMUR",6,233,12,245
https://kawalpemilu.org#56571,"EGON, WAIGETE, SIKKA, NUSA TENGGARA TIMUR",7,291,6,297
https://kawalpemilu.org#56571,"EGON, WAIGETE, SIKKA, NUSA TENGGARA TIMUR",8,263,10,273
https://kawalpemilu.org#56572,"POGON, WAIGETE, SIKKA, NUSA TENGGARA TIMUR",1,244,16,260
https://kawalpemilu.org#56572,"POGON, WAIGETE, SIKKA, NUSA TENGGARA TIMUR",2,156,8,164
https://kawalpemilu.org#56572,"POGON, WAIGETE, SIKKA, NUSA TENGGARA TIMUR",3,157,8,165
https://kawalpemilu.org#56572,"POGON, WAIGETE, SIKKA, NUSA TENGGARA TIMUR",4,180,8,188
https://kawalpemilu.org#56572,"POGON, WAIGETE, SIKKA, NUSA TENGGARA TIMUR",5,185,8,193
https://kawalpemilu.org#56572,"POGON, WAIGETE, SIKKA, NUSA TENGGARA TIMUR",6,154,26,180
https://kawalpemilu.org#56572,"POGON, WAIGETE, SIKKA, NUSA TENGGARA TIMUR",7,163,8,171
https://kawalpemilu.org#56573,"AIBURA, WAIGETE, SIKKA, NUSA TENGGARA TIMUR",1,140,7,147
https://kawalpemilu.org#56573,"AIBURA, WAIGETE, SIKKA, NUSA TENGGARA TIMUR",2,190,4,194
https://kawalpemilu.org#56573,"AIBURA, WAIGETE, SIKKA, NUSA TENGGARA TIMUR",3,155,8,163
https://kawalpemilu.org#56573,"AIBURA, WAIGETE, SIKKA, NUSA TENGGARA TIMUR",4,130,13,143
https://kawalpemilu.org#56573,"AIBURA, WAIGETE, SIKKA, NUSA TENGGARA TIMUR",5,214,7,221
https://kawalpemilu.org#56573,"AIBURA, WAIGETE, SIKKA, NUSA TENGGARA TIMUR",6,158,9,167
https://kawalpemilu.org#56574,"WAIRBLELER, WAIGETE, SIKKA, NUSA TENGGARA TIMUR",1,194,12,206
https://kawalpemilu.org#56574,"WAIRBLELER, WAIGETE, SIKKA, NUSA TENGGARA TIMUR",2,171,10,181
https://kawalpemilu.org#56574,"WAIRBLELER, WAIGETE, SIKKA, NUSA TENGGARA TIMUR",3,125,81,206
https://kawalpemilu.org#56574,"WAIRBLELER, WAIGETE, SIKKA, NUSA TENGGARA TIMUR",4,205,18,223
https://kawalpemilu.org#56574,"WAIRBLELER, WAIGETE, SIKKA, NUSA TENGGARA TIMUR",5,161,2,163
https://kawalpemilu.org#56574,"WAIRBLELER, WAIGETE, SIKKA, NUSA TENGGARA TIMUR",6,175,6,181
https://kawalpemilu.org#56574,"WAIRBLELER, WAIGETE, SIKKA, NUSA TENGGARA TIMUR",7,198,5,203
https://kawalpemilu.org#56574,"WAIRBLELER, WAIGETE, SIKKA, NUSA TENGGARA TIMUR",8,193,6,199
https://kawalpemilu.org#56575,"HODER, WAIGETE, SIKKA, NUSA TENGGARA TIMUR",1,245,0,245
https://kawalpemilu.org#56575,"HODER, WAIGETE, SIKKA, NUSA TENGGARA TIMUR",2,232,17,249
https://kawalpemilu.org#56575,"HODER, WAIGETE, SIKKA, NUSA TENGGARA TIMUR",3,219,10,229
https://kawalpemilu.org#56575,"HODER, WAIGETE, SIKKA, NUSA TENGGARA TIMUR",4,201,13,214
https://kawalpemilu.org#56575,"HODER, WAIGETE, SIKKA, NUSA TENGGARA TIMUR",5,136,10,146
https://kawalpemilu.org#56575,"HODER, WAIGETE, SIKKA, NUSA TENGGARA TIMUR",6,196,6,202
https://kawalpemilu.org#56575,"HODER, WAIGETE, SIKKA, NUSA TENGGARA TIMUR",7,162,12,174
https://kawalpemilu.org#56576,"WAIRTERANG, WAIGETE, SIKKA, NUSA TENGGARA TIMUR",1,225,17,242
https://kawalpemilu.org#56576,"WAIRTERANG, WAIGETE, SIKKA, NUSA TENGGARA TIMUR",2,193,14,207
https://kawalpemilu.org#56576,"WAIRTERANG, WAIGETE, SIKKA, NUSA TENGGARA TIMUR",3,235,15,250
https://kawalpemilu.org#56576,"WAIRTERANG, WAIGETE, SIKKA, NUSA TENGGARA TIMUR",4,205,15,220
https://kawalpemilu.org#56576,"WAIRTERANG, WAIGETE, SIKKA, NUSA TENGGARA TIMUR",5,197,12,209
https://kawalpemilu.org#56577,"NANGATOBONG, WAIGETE, SIKKA, NUSA TENGGARA TIMUR",1,218,21,239
https://kawalpemilu.org#56577,"NANGATOBONG, WAIGETE, SIKKA, NUSA TENGGARA TIMUR",2,228,6,234
https://kawalpemilu.org#56577,"NANGATOBONG, WAIGETE, SIKKA, NUSA TENGGARA TIMUR",3,182,5,187
https://kawalpemilu.org#56577,"NANGATOBONG, WAIGETE, SIKKA, NUSA TENGGARA TIMUR",4,190,13,203
https://kawalpemilu.org#56577,"NANGATOBONG, WAIGETE, SIKKA, NUSA TENGGARA TIMUR",5,227,3,230
https://kawalpemilu.org#56577,"NANGATOBONG, WAIGETE, SIKKA, NUSA TENGGARA TIMUR",6,108,3,111
https://kawalpemilu.org#56577,"NANGATOBONG, WAIGETE, SIKKA, NUSA TENGGARA TIMUR",7,141,4,145
https://kawalpemilu.org#56578,"WATUDIRAN, WAIGETE, SIKKA, NUSA TENGGARA TIMUR",1,152,10,162
https://kawalpemilu.org#56578,"WATUDIRAN, WAIGETE, SIKKA, NUSA TENGGARA TIMUR",2,175,18,193
https://kawalpemilu.org#56578,"WATUDIRAN, WAIGETE, SIKKA, NUSA TENGGARA TIMUR",3,131,6,137
https://kawalpemilu.org#56578,"WATUDIRAN, WAIGETE, SIKKA, NUSA TENGGARA TIMUR",4,233,12,245
https://kawalpemilu.org#56578,"WATUDIRAN, WAIGETE, SIKKA, NUSA TENGGARA TIMUR",5,227,9,236
https://kawalpemilu.org#56580,"SEUSINA, KEWAPANTE, SIKKA, NUSA TENGGARA TIMUR",1,172,14,186
https://kawalpemilu.org#56580,"SEUSINA, KEWAPANTE, SIKKA, NUSA TENGGARA TIMUR",2,176,5,181
https://kawalpemilu.org#56580,"SEUSINA, KEWAPANTE, SIKKA, NUSA TENGGARA TIMUR",3,201,6,207
https://kawalpemilu.org#56581,"KOPONG, KEWAPANTE, SIKKA, NUSA TENGGARA TIMUR",1,154,7,161
https://kawalpemilu.org#56581,"KOPONG, KEWAPANTE, SIKKA, NUSA TENGGARA TIMUR",2,128,5,133
https://kawalpemilu.org#56581,"KOPONG, KEWAPANTE, SIKKA, NUSA TENGGARA TIMUR",3,167,3,170
https://kawalpemilu.org#56581,"KOPONG, KEWAPANTE, SIKKA, NUSA TENGGARA TIMUR",4,109,4,113
https://kawalpemilu.org#56581,"KOPONG, KEWAPANTE, SIKKA, NUSA TENGGARA TIMUR",5,175,2,177
https://kawalpemilu.org#56582,"NAMANGKEWA, KEWAPANTE, SIKKA, NUSA TENGGARA TIMUR",1,163,37,200
https://kawalpemilu.org#56582,"NAMANGKEWA, KEWAPANTE, SIKKA, NUSA TENGGARA TIMUR",2,213,3,216
https://kawalpemilu.org#56582,"NAMANGKEWA, KEWAPANTE, SIKKA, NUSA TENGGARA TIMUR",3,200,8,208
https://kawalpemilu.org#56582,"NAMANGKEWA, KEWAPANTE, SIKKA, NUSA TENGGARA TIMUR",4,182,8,190
https://kawalpemilu.org#56582,"NAMANGKEWA, KEWAPANTE, SIKKA, NUSA TENGGARA TIMUR",5,209,7,216
https://kawalpemilu.org#56582,"NAMANGKEWA, KEWAPANTE, SIKKA, NUSA TENGGARA TIMUR",6,180,9,189
https://kawalpemilu.org#56583,"IANTENA, KEWAPANTE, SIKKA, NUSA TENGGARA TIMUR",1,154,5,159
https://kawalpemilu.org#56583,"IANTENA, KEWAPANTE, SIKKA, NUSA TENGGARA TIMUR",2,183,1,184
https://kawalpemilu.org#56583,"IANTENA, KEWAPANTE, SIKKA, NUSA TENGGARA TIMUR",3,212,13,225
https://kawalpemilu.org#56583,"IANTENA, KEWAPANTE, SIKKA, NUSA TENGGARA TIMUR",4,184,1,185
https://kawalpemilu.org#56583,"IANTENA, KEWAPANTE, SIKKA, NUSA TENGGARA TIMUR",5,204,12,216
https://kawalpemilu.org#56583,"IANTENA, KEWAPANTE, SIKKA, NUSA TENGGARA TIMUR",6,177,4,181
https://kawalpemilu.org#56584,"UMAGERA, KEWAPANTE, SIKKA, NUSA TENGGARA TIMUR",1,149,7,156
https://kawalpemilu.org#56584,"UMAGERA, KEWAPANTE, SIKKA, NUSA TENGGARA TIMUR",2,204,9,213
https://kawalpemilu.org#56585,"GELITING, KEWAPANTE, SIKKA, NUSA TENGGARA TIMUR",1,182,5,187
https://kawalpemilu.org#56585,"GELITING, KEWAPANTE, SIKKA, NUSA TENGGARA TIMUR",2,174,15,189
https://kawalpemilu.org#56585,"GELITING, KEWAPANTE, SIKKA, NUSA TENGGARA TIMUR",3,189,11,200
https://kawalpemilu.org#56585,"GELITING, KEWAPANTE, SIKKA, NUSA TENGGARA TIMUR",4,146,65,211
https://kawalpemilu.org#56585,"GELITING, KEWAPANTE, SIKKA, NUSA TENGGARA TIMUR",5,146,62,208
https://kawalpemilu.org#56585,"GELITING, KEWAPANTE, SIKKA, NUSA TENGGARA TIMUR",6,58,160,218
https://kawalpemilu.org#56586,"WAIARA, KEWAPANTE, SIKKA, NUSA TENGGARA TIMUR",1,186,6,192
https://kawalpemilu.org#56586,"WAIARA, KEWAPANTE, SIKKA, NUSA TENGGARA TIMUR",2,114,3,117
https://kawalpemilu.org#56586,"WAIARA, KEWAPANTE, SIKKA, NUSA TENGGARA TIMUR",3,182,3,185
https://kawalpemilu.org#56586,"WAIARA, KEWAPANTE, SIKKA, NUSA TENGGARA TIMUR",4,222,4,226
https://kawalpemilu.org#56586,"WAIARA, KEWAPANTE, SIKKA, NUSA TENGGARA TIMUR",5,216,15,231
https://kawalpemilu.org#56586,"WAIARA, KEWAPANTE, SIKKA, NUSA TENGGARA TIMUR",6,172,76,248
https://kawalpemilu.org#56587,"WAIRKOJA, KEWAPANTE, SIKKA, NUSA TENGGARA TIMUR",1,214,14,228
https://kawalpemilu.org#56587,"WAIRKOJA, KEWAPANTE, SIKKA, NUSA TENGGARA TIMUR",2,165,13,178
https://kawalpemilu.org#56587,"WAIRKOJA, KEWAPANTE, SIKKA, NUSA TENGGARA TIMUR",3,196,12,208
https://kawalpemilu.org#56587,"WAIRKOJA, KEWAPANTE, SIKKA, NUSA TENGGARA TIMUR",4,180,5,185
https://kawalpemilu.org#56587,"WAIRKOJA, KEWAPANTE, SIKKA, NUSA TENGGARA TIMUR",5,215,32,247
https://kawalpemilu.org#56589,"HOKOR, BOLA, SIKKA, NUSA TENGGARA TIMUR",1,84,2,86
https://kawalpemilu.org#56589,"HOKOR, BOLA, SIKKA, NUSA TENGGARA TIMUR",2,180,9,189
https://kawalpemilu.org#56589,"HOKOR, BOLA, SIKKA, NUSA TENGGARA TIMUR",3,238,12,250
https://kawalpemilu.org#56589,"HOKOR, BOLA, SIKKA, NUSA TENGGARA TIMUR",4,162,3,165
https://kawalpemilu.org#56590,"WOLONWALU, BOLA, SIKKA, NUSA TENGGARA TIMUR",1,188,2,190
https://kawalpemilu.org#56590,"WOLONWALU, BOLA, SIKKA, NUSA TENGGARA TIMUR",2,149,1,150
https://kawalpemilu.org#56590,"WOLONWALU, BOLA, SIKKA, NUSA TENGGARA TIMUR",3,173,5,178
https://kawalpemilu.org#56590,"WOLONWALU, BOLA, SIKKA, NUSA TENGGARA TIMUR",4,206,1,207
https://kawalpemilu.org#56590,"WOLONWALU, BOLA, SIKKA, NUSA TENGGARA TIMUR",5,200,11,211
https://kawalpemilu.org#56590,"WOLONWALU, BOLA, SIKKA, NUSA TENGGARA TIMUR",6,231,6,237
https://kawalpemilu.org#56591,"WOLOKOLI, BOLA, SIKKA, NUSA TENGGARA TIMUR",1,199,10,209
https://kawalpemilu.org#56591,"WOLOKOLI, BOLA, SIKKA, NUSA TENGGARA TIMUR",2,188,5,193
https://kawalpemilu.org#56591,"WOLOKOLI, BOLA, SIKKA, NUSA TENGGARA TIMUR",3,194,10,204
https://kawalpemilu.org#56591,"WOLOKOLI, BOLA, SIKKA, NUSA TENGGARA TIMUR",4,173,10,183
https://kawalpemilu.org#56591,"WOLOKOLI, BOLA, SIKKA, NUSA TENGGARA TIMUR",5,163,15,178
https://kawalpemilu.org#56592,"BOLA, BOLA, SIKKA, NUSA TENGGARA TIMUR",1,171,12,183
https://kawalpemilu.org#56592,"BOLA, BOLA, SIKKA, NUSA TENGGARA TIMUR",2,176,10,186
https://kawalpemilu.org#56592,"BOLA, BOLA, SIKKA, NUSA TENGGARA TIMUR",3,168,33,201
https://kawalpemilu.org#56592,"BOLA, BOLA, SIKKA, NUSA TENGGARA TIMUR",4,139,7,146
https://kawalpemilu.org#56592,"BOLA, BOLA, SIKKA, NUSA TENGGARA TIMUR",5,152,7,159
https://kawalpemilu.org#56593,"UMAUTA, BOLA, SIKKA, NUSA TENGGARA TIMUR",1,128,38,166
https://kawalpemilu.org#56593,"UMAUTA, BOLA, SIKKA, NUSA TENGGARA TIMUR",2,128,16,144
https://kawalpemilu.org#56593,"UMAUTA, BOLA, SIKKA, NUSA TENGGARA TIMUR",3,129,19,148
https://kawalpemilu.org#56593,"UMAUTA, BOLA, SIKKA, NUSA TENGGARA TIMUR",4,245,14,259
https://kawalpemilu.org#56593,"UMAUTA, BOLA, SIKKA, NUSA TENGGARA TIMUR",5,150,9,159
https://kawalpemilu.org#56593,"UMAUTA, BOLA, SIKKA, NUSA TENGGARA TIMUR",6,214,7,221
https://kawalpemilu.org#56594,"IPIR, BOLA, SIKKA, NUSA TENGGARA TIMUR",1,209,48,257
https://kawalpemilu.org#56594,"IPIR, BOLA, SIKKA, NUSA TENGGARA TIMUR",2,172,26,198
https://kawalpemilu.org#56594,"IPIR, BOLA, SIKKA, NUSA TENGGARA TIMUR",3,139,21,160
https://kawalpemilu.org#56594,"IPIR, BOLA, SIKKA, NUSA TENGGARA TIMUR",4,106,49,155
https://kawalpemilu.org#56594,"IPIR, BOLA, SIKKA, NUSA TENGGARA TIMUR",5,144,10,154
https://kawalpemilu.org#56594,"IPIR, BOLA, SIKKA, NUSA TENGGARA TIMUR",6,117,16,133
https://kawalpemilu.org#56594,"IPIR, BOLA, SIKKA, NUSA TENGGARA TIMUR",7,208,31,239
https://kawalpemilu.org#56596,"MAGEPANDA, MAGEPANDA, SIKKA, NUSA TENGGARA TIMUR",1,105,148,253
https://kawalpemilu.org#56596,"MAGEPANDA, MAGEPANDA, SIKKA, NUSA TENGGARA TIMUR",2,227,4,231
https://kawalpemilu.org#56596,"MAGEPANDA, MAGEPANDA, SIKKA, NUSA TENGGARA TIMUR",3,241,4,245
https://kawalpemilu.org#56596,"MAGEPANDA, MAGEPANDA, SIKKA, NUSA TENGGARA TIMUR",4,251,4,255
https://kawalpemilu.org#56596,"MAGEPANDA, MAGEPANDA, SIKKA, NUSA TENGGARA TIMUR",5,221,9,230
https://kawalpemilu.org#56596,"MAGEPANDA, MAGEPANDA, SIKKA, NUSA TENGGARA TIMUR",6,193,7,200
https://kawalpemilu.org#56596,"MAGEPANDA, MAGEPANDA, SIKKA, NUSA TENGGARA TIMUR",7,210,8,218
https://kawalpemilu.org#56596,"MAGEPANDA, MAGEPANDA, SIKKA, NUSA TENGGARA TIMUR",8,138,6,144
https://kawalpemilu.org#56597,"REROROJA, MAGEPANDA, SIKKA, NUSA TENGGARA TIMUR",1,176,26,202
https://kawalpemilu.org#56597,"REROROJA, MAGEPANDA, SIKKA, NUSA TENGGARA TIMUR",2,96,90,186
https://kawalpemilu.org#56597,"REROROJA, MAGEPANDA, SIKKA, NUSA TENGGARA TIMUR",3,202,5,207
https://kawalpemilu.org#56597,"REROROJA, MAGEPANDA, SIKKA, NUSA TENGGARA TIMUR",4,218,12,230
https://kawalpemilu.org#56597,"REROROJA, MAGEPANDA, SIKKA, NUSA TENGGARA TIMUR",5,216,6,222
https://kawalpemilu.org#56597,"REROROJA, MAGEPANDA, SIKKA, NUSA TENGGARA TIMUR",6,244,6,250
https://kawalpemilu.org#56597,"REROROJA, MAGEPANDA, SIKKA, NUSA TENGGARA TIMUR",7,213,2,215
https://kawalpemilu.org#56597,"REROROJA, MAGEPANDA, SIKKA, NUSA TENGGARA TIMUR",8,236,6,242
https://kawalpemilu.org#56598,"DONE, MAGEPANDA, SIKKA, NUSA TENGGARA TIMUR",1,138,2,140
https://kawalpemilu.org#56598,"DONE, MAGEPANDA, SIKKA, NUSA TENGGARA TIMUR",2,142,3,145
https://kawalpemilu.org#56598,"DONE, MAGEPANDA, SIKKA, NUSA TENGGARA TIMUR",3,177,1,178
https://kawalpemilu.org#56598,"DONE, MAGEPANDA, SIKKA, NUSA TENGGARA TIMUR",4,170,21,191
https://kawalpemilu.org#56598,"DONE, MAGEPANDA, SIKKA, NUSA TENGGARA TIMUR",5,139,11,150
https://kawalpemilu.org#56599,"KOLISIA, MAGEPANDA, SIKKA, NUSA TENGGARA TIMUR",1,230,2,232
https://kawalpemilu.org#56599,"KOLISIA, MAGEPANDA, SIKKA, NUSA TENGGARA TIMUR",2,107,90,197
https://kawalpemilu.org#56599,"KOLISIA, MAGEPANDA, SIKKA, NUSA TENGGARA TIMUR",3,169,46,215
https://kawalpemilu.org#56599,"KOLISIA, MAGEPANDA, SIKKA, NUSA TENGGARA TIMUR",4,168,3,171
https://kawalpemilu.org#56599,"KOLISIA, MAGEPANDA, SIKKA, NUSA TENGGARA TIMUR",5,203,3,206
https://kawalpemilu.org#56599,"KOLISIA, MAGEPANDA, SIKKA, NUSA TENGGARA TIMUR",6,201,9,210
https://kawalpemilu.org#56599,"KOLISIA, MAGEPANDA, SIKKA, NUSA TENGGARA TIMUR",7,157,2,159
https://kawalpemilu.org#56599,"KOLISIA, MAGEPANDA, SIKKA, NUSA TENGGARA TIMUR",8,108,2,110
https://kawalpemilu.org#56600,"KOLISIA B, MAGEPANDA, SIKKA, NUSA TENGGARA TIMUR",1,217,4,221
https://kawalpemilu.org#56600,"KOLISIA B, MAGEPANDA, SIKKA, NUSA TENGGARA TIMUR",2,179,8,187
https://kawalpemilu.org#56600,"KOLISIA B, MAGEPANDA, SIKKA, NUSA TENGGARA TIMUR",3,210,13,223
https://kawalpemilu.org#56600,"KOLISIA B, MAGEPANDA, SIKKA, NUSA TENGGARA TIMUR",4,147,2,149
https://kawalpemilu.org#56602,"NATARMAGE, WAIBLAMA, SIKKA, NUSA TENGGARA TIMUR",1,182,11,193
https://kawalpemilu.org#56602,"NATARMAGE, WAIBLAMA, SIKKA, NUSA TENGGARA TIMUR",2,173,5,178
https://kawalpemilu.org#56602,"NATARMAGE, WAIBLAMA, SIKKA, NUSA TENGGARA TIMUR",3,216,11,227
https://kawalpemilu.org#56603,"TANARAWA, WAIBLAMA, SIKKA, NUSA TENGGARA TIMUR",1,231,13,244
https://kawalpemilu.org#56603,"TANARAWA, WAIBLAMA, SIKKA, NUSA TENGGARA TIMUR",2,159,6,165
https://kawalpemilu.org#56603,"TANARAWA, WAIBLAMA, SIKKA, NUSA TENGGARA TIMUR",3,124,8,132
https://kawalpemilu.org#56603,"TANARAWA, WAIBLAMA, SIKKA, NUSA TENGGARA TIMUR",4,194,17,211
https://kawalpemilu.org#56604,"PRUDA, WAIBLAMA, SIKKA, NUSA TENGGARA TIMUR",1,208,13,221
https://kawalpemilu.org#56604,"PRUDA, WAIBLAMA, SIKKA, NUSA TENGGARA TIMUR",2,191,24,215
https://kawalpemilu.org#56604,"PRUDA, WAIBLAMA, SIKKA, NUSA TENGGARA TIMUR",3,166,15,181
https://kawalpemilu.org#56604,"PRUDA, WAIBLAMA, SIKKA, NUSA TENGGARA TIMUR",4,144,14,158
https://kawalpemilu.org#56604,"PRUDA, WAIBLAMA, SIKKA, NUSA TENGGARA TIMUR",5,115,3,118
https://kawalpemilu.org#56604,"PRUDA, WAIBLAMA, SIKKA, NUSA TENGGARA TIMUR",6,196,8,204
https://kawalpemilu.org#56604,"PRUDA, WAIBLAMA, SIKKA, NUSA TENGGARA TIMUR",7,107,4,111
https://kawalpemilu.org#56605,"WERANG, WAIBLAMA, SIKKA, NUSA TENGGARA TIMUR",1,145,17,162
https://kawalpemilu.org#56605,"WERANG, WAIBLAMA, SIKKA, NUSA TENGGARA TIMUR",2,115,2,117
https://kawalpemilu.org#56605,"WERANG, WAIBLAMA, SIKKA, NUSA TENGGARA TIMUR",3,169,9,178
https://kawalpemilu.org#56605,"WERANG, WAIBLAMA, SIKKA, NUSA TENGGARA TIMUR",4,179,6,185
https://kawalpemilu.org#56605,"WERANG, WAIBLAMA, SIKKA, NUSA TENGGARA TIMUR",5,158,0,158
https://kawalpemilu.org#56606,"TUA BAO, WAIBLAMA, SIKKA, NUSA TENGGARA TIMUR",1,196,4,200
https://kawalpemilu.org#56606,"TUA BAO, WAIBLAMA, SIKKA, NUSA TENGGARA TIMUR",2,93,6,99
https://kawalpemilu.org#56606,"TUA BAO, WAIBLAMA, SIKKA, NUSA TENGGARA TIMUR",3,126,5,131
https://kawalpemilu.org#56607,"ILINMEDO, WAIBLAMA, SIKKA, NUSA TENGGARA TIMUR",1,185,14,199
https://kawalpemilu.org#56607,"ILINMEDO, WAIBLAMA, SIKKA, NUSA TENGGARA TIMUR",2,184,10,194
https://kawalpemilu.org#56607,"ILINMEDO, WAIBLAMA, SIKKA, NUSA TENGGARA TIMUR",3,133,6,139
https://kawalpemilu.org#56609,"HEWULI, ALOK BARAT, SIKKA, NUSA TENGGARA TIMUR",1,232,4,236
https://kawalpemilu.org#56609,"HEWULI, ALOK BARAT, SIKKA, NUSA TENGGARA TIMUR",2,252,5,257
https://kawalpemilu.org#56609,"HEWULI, ALOK BARAT, SIKKA, NUSA TENGGARA TIMUR",3,227,3,230
https://kawalpemilu.org#56609,"HEWULI, ALOK BARAT, SIKKA, NUSA TENGGARA TIMUR",4,272,10,282
https://kawalpemilu.org#56609,"HEWULI, ALOK BARAT, SIKKA, NUSA TENGGARA TIMUR",5,254,6,260
https://kawalpemilu.org#56610,"WAILITI, ALOK BARAT, SIKKA, NUSA TENGGARA TIMUR",1,233,5,238
https://kawalpemilu.org#56610,"WAILITI, ALOK BARAT, SIKKA, NUSA TENGGARA TIMUR",2,247,6,253
https://kawalpemilu.org#56610,"WAILITI, ALOK BARAT, SIKKA, NUSA TENGGARA TIMUR",3,226,23,249
https://kawalpemilu.org#56610,"WAILITI, ALOK BARAT, SIKKA, NUSA TENGGARA TIMUR",4,238,17,255
https://kawalpemilu.org#56610,"WAILITI, ALOK BARAT, SIKKA, NUSA TENGGARA TIMUR",5,225,13,238
https://kawalpemilu.org#56610,"WAILITI, ALOK BARAT, SIKKA, NUSA TENGGARA TIMUR",6,237,9,246
https://kawalpemilu.org#56610,"WAILITI, ALOK BARAT, SIKKA, NUSA TENGGARA TIMUR",7,153,1,154
https://kawalpemilu.org#56610,"WAILITI, ALOK BARAT, SIKKA, NUSA TENGGARA TIMUR",8,82,3,85
https://kawalpemilu.org#56611,"WOLOMARANG, ALOK BARAT, SIKKA, NUSA TENGGARA TIMUR",1,218,20,238
https://kawalpemilu.org#56611,"WOLOMARANG, ALOK BARAT, SIKKA, NUSA TENGGARA TIMUR",2,225,15,240
https://kawalpemilu.org#56611,"WOLOMARANG, ALOK BARAT, SIKKA, NUSA TENGGARA TIMUR",3,120,110,230
https://kawalpemilu.org#56611,"WOLOMARANG, ALOK BARAT, SIKKA, NUSA TENGGARA TIMUR",4,86,142,228
https://kawalpemilu.org#56611,"WOLOMARANG, ALOK BARAT, SIKKA, NUSA TENGGARA TIMUR",5,55,163,218
https://kawalpemilu.org#56611,"WOLOMARANG, ALOK BARAT, SIKKA, NUSA TENGGARA TIMUR",6,50,170,220
https://kawalpemilu.org#56611,"WOLOMARANG, ALOK BARAT, SIKKA, NUSA TENGGARA TIMUR",7,55,194,249
https://kawalpemilu.org#56611,"WOLOMARANG, ALOK BARAT, SIKKA, NUSA TENGGARA TIMUR",8,41,169,210
https://kawalpemilu.org#56611,"WOLOMARANG, ALOK BARAT, SIKKA, NUSA TENGGARA TIMUR",9,45,215,260
https://kawalpemilu.org#56611,"WOLOMARANG, ALOK BARAT, SIKKA, NUSA TENGGARA TIMUR",10,50,188,238
https://kawalpemilu.org#56611,"WOLOMARANG, ALOK BARAT, SIKKA, NUSA TENGGARA TIMUR",11,209,24,233
https://kawalpemilu.org#56611,"WOLOMARANG, ALOK BARAT, SIKKA, NUSA TENGGARA TIMUR",12,231,18,249
https://kawalpemilu.org#56611,"WOLOMARANG, ALOK BARAT, SIKKA, NUSA TENGGARA TIMUR",13,174,36,210
https://kawalpemilu.org#56611,"WOLOMARANG, ALOK BARAT, SIKKA, NUSA TENGGARA TIMUR",14,198,13,211
https://kawalpemilu.org#56611,"WOLOMARANG, ALOK BARAT, SIKKA, NUSA TENGGARA TIMUR",15,218,14,232
https://kawalpemilu.org#56611,"WOLOMARANG, ALOK BARAT, SIKKA, NUSA TENGGARA TIMUR",16,184,26,210
https://kawalpemilu.org#56611,"WOLOMARANG, ALOK BARAT, SIKKA, NUSA TENGGARA TIMUR",17,217,8,225
https://kawalpemilu.org#56611,"WOLOMARANG, ALOK BARAT, SIKKA, NUSA TENGGARA TIMUR",18,201,14,215
https://kawalpemilu.org#56611,"WOLOMARANG, ALOK BARAT, SIKKA, NUSA TENGGARA TIMUR",19,92,129,221
https://kawalpemilu.org#56611,"WOLOMARANG, ALOK BARAT, SIKKA, NUSA TENGGARA TIMUR",20,183,8,191
https://kawalpemilu.org#56612,"WURING, ALOK BARAT, SIKKA, NUSA TENGGARA TIMUR",1,57,164,222
https://kawalpemilu.org#56612,"WURING, ALOK BARAT, SIKKA, NUSA TENGGARA TIMUR",2,49,150,199
https://kawalpemilu.org#56612,"WURING, ALOK BARAT, SIKKA, NUSA TENGGARA TIMUR",3,69,151,220
https://kawalpemilu.org#56612,"WURING, ALOK BARAT, SIKKA, NUSA TENGGARA TIMUR",4,84,115,199
https://kawalpemilu.org#56612,"WURING, ALOK BARAT, SIKKA, NUSA TENGGARA TIMUR",5,153,54,207
https://kawalpemilu.org#56612,"WURING, ALOK BARAT, SIKKA, NUSA TENGGARA TIMUR",6,181,33,214
https://kawalpemilu.org#56612,"WURING, ALOK BARAT, SIKKA, NUSA TENGGARA TIMUR",7,207,7,214
https://kawalpemilu.org#56612,"WURING, ALOK BARAT, SIKKA, NUSA TENGGARA TIMUR",8,227,16,243
https://kawalpemilu.org#56612,"WURING, ALOK BARAT, SIKKA, NUSA TENGGARA TIMUR",9,189,39,228
https://kawalpemilu.org#56612,"WURING, ALOK BARAT, SIKKA, NUSA TENGGARA TIMUR",10,242,9,251
https://kawalpemilu.org#56612,"WURING, ALOK BARAT, SIKKA, NUSA TENGGARA TIMUR",11,238,19,257
https://kawalpemilu.org#56612,"WURING, ALOK BARAT, SIKKA, NUSA TENGGARA TIMUR",12,70,96,166
https://kawalpemilu.org#56614,"BERU, ALOK TIMUR, SIKKA, NUSA TENGGARA TIMUR",1,114,142,256
https://kawalpemilu.org#56614,"BERU, ALOK TIMUR, SIKKA, NUSA TENGGARA TIMUR",2,148,66,214
https://kawalpemilu.org#56614,"BERU, ALOK TIMUR, SIKKA, NUSA TENGGARA TIMUR",3,155,7,162
https://kawalpemilu.org#56614,"BERU, ALOK TIMUR, SIKKA, NUSA TENGGARA TIMUR",4,183,6,189
https://kawalpemilu.org#56614,"BERU, ALOK TIMUR, SIKKA, NUSA TENGGARA TIMUR",5,222,17,239
https://kawalpemilu.org#56614,"BERU, ALOK TIMUR, SIKKA, NUSA TENGGARA TIMUR",6,158,27,185
https://kawalpemilu.org#56614,"BERU, ALOK TIMUR, SIKKA, NUSA TENGGARA TIMUR",7,180,23,203
https://kawalpemilu.org#56614,"BERU, ALOK TIMUR, SIKKA, NUSA TENGGARA TIMUR",8,173,10,183
https://kawalpemilu.org#56614,"BERU, ALOK TIMUR, SIKKA, NUSA TENGGARA TIMUR",9,210,13,223
https://kawalpemilu.org#56614,"BERU, ALOK TIMUR, SIKKA, NUSA TENGGARA TIMUR",10,113,6,119
https://kawalpemilu.org#56615,"KOTA BARU, ALOK TIMUR, SIKKA, NUSA TENGGARA TIMUR",1,198,21,219
https://kawalpemilu.org#56615,"KOTA BARU, ALOK TIMUR, SIKKA, NUSA TENGGARA TIMUR",2,179,14,193
https://kawalpemilu.org#56615,"KOTA BARU, ALOK TIMUR, SIKKA, NUSA TENGGARA TIMUR",3,192,25,217
https://kawalpemilu.org#56615,"KOTA BARU, ALOK TIMUR, SIKKA, NUSA TENGGARA TIMUR",4,173,23,196
https://kawalpemilu.org#56615,"KOTA BARU, ALOK TIMUR, SIKKA, NUSA TENGGARA TIMUR",5,167,15,182
https://kawalpemilu.org#56615,"KOTA BARU, ALOK TIMUR, SIKKA, NUSA TENGGARA TIMUR",6,226,25,251
https://kawalpemilu.org#56615,"KOTA BARU, ALOK TIMUR, SIKKA, NUSA TENGGARA TIMUR",7,184,14,198
https://kawalpemilu.org#56615,"KOTA BARU, ALOK TIMUR, SIKKA, NUSA TENGGARA TIMUR",8,171,16,187
https://kawalpemilu.org#56615,"KOTA BARU, ALOK TIMUR, SIKKA, NUSA TENGGARA TIMUR",9,181,13,194
https://kawalpemilu.org#56615,"KOTA BARU, ALOK TIMUR, SIKKA, NUSA TENGGARA TIMUR",10,114,36,150
https://kawalpemilu.org#56615,"KOTA BARU, ALOK TIMUR, SIKKA, NUSA TENGGARA TIMUR",11,203,29,232
https://kawalpemilu.org#56615,"KOTA BARU, ALOK TIMUR, SIKKA, NUSA TENGGARA TIMUR",12,233,15,248
https://kawalpemilu.org#56615,"KOTA BARU, ALOK TIMUR, SIKKA, NUSA TENGGARA TIMUR",13,224,24,248
https://kawalpemilu.org#56615,"KOTA BARU, ALOK TIMUR, SIKKA, NUSA TENGGARA TIMUR",14,159,24,183
https://kawalpemilu.org#56616,"NANGAMETING, ALOK TIMUR, SIKKA, NUSA TENGGARA TIMUR",1,133,17,150
https://kawalpemilu.org#56616,"NANGAMETING, ALOK TIMUR, SIKKA, NUSA TENGGARA TIMUR",2,205,13,218
https://kawalpemilu.org#56616,"NANGAMETING, ALOK TIMUR, SIKKA, NUSA TENGGARA TIMUR",3,209,32,241
https://kawalpemilu.org#56616,"NANGAMETING, ALOK TIMUR, SIKKA, NUSA TENGGARA TIMUR",4,215,20,235
https://kawalpemilu.org#56616,"NANGAMETING, ALOK TIMUR, SIKKA, NUSA TENGGARA TIMUR",5,199,14,213
https://kawalpemilu.org#56616,"NANGAMETING, ALOK TIMUR, SIKKA, NUSA TENGGARA TIMUR",6,158,6,164
https://kawalpemilu.org#56616,"NANGAMETING, ALOK TIMUR, SIKKA, NUSA TENGGARA TIMUR",7,176,23,199
https://kawalpemilu.org#56616,"NANGAMETING, ALOK TIMUR, SIKKA, NUSA TENGGARA TIMUR",8,211,12,223
https://kawalpemilu.org#56616,"NANGAMETING, ALOK TIMUR, SIKKA, NUSA TENGGARA TIMUR",9,192,18,210
https://kawalpemilu.org#56616,"NANGAMETING, ALOK TIMUR, SIKKA, NUSA TENGGARA TIMUR",10,177,10,187
https://kawalpemilu.org#56616,"NANGAMETING, ALOK TIMUR, SIKKA, NUSA TENGGARA TIMUR",11,168,7,175
https://kawalpemilu.org#56617,"WAIOTI, ALOK TIMUR, SIKKA, NUSA TENGGARA TIMUR",1,194,44,238
https://kawalpemilu.org#56617,"WAIOTI, ALOK TIMUR, SIKKA, NUSA TENGGARA TIMUR",2,159,65,224
https://kawalpemilu.org#56617,"WAIOTI, ALOK TIMUR, SIKKA, NUSA TENGGARA TIMUR",3,245,21,266
https://kawalpemilu.org#56617,"WAIOTI, ALOK TIMUR, SIKKA, NUSA TENGGARA TIMUR",4,188,49,237
https://kawalpemilu.org#56617,"WAIOTI, ALOK TIMUR, SIKKA, NUSA TENGGARA TIMUR",5,210,27,237
https://kawalpemilu.org#56617,"WAIOTI, ALOK TIMUR, SIKKA, NUSA TENGGARA TIMUR",6,195,19,214
https://kawalpemilu.org#56617,"WAIOTI, ALOK TIMUR, SIKKA, NUSA TENGGARA TIMUR",7,204,26,230
https://kawalpemilu.org#56617,"WAIOTI, ALOK TIMUR, SIKKA, NUSA TENGGARA TIMUR",8,219,20,239
https://kawalpemilu.org#56617,"WAIOTI, ALOK TIMUR, SIKKA, NUSA TENGGARA TIMUR",9,194,21,215
https://kawalpemilu.org#56617,"WAIOTI, ALOK TIMUR, SIKKA, NUSA TENGGARA TIMUR",10,203,13,216
https://kawalpemilu.org#56617,"WAIOTI, ALOK TIMUR, SIKKA, NUSA TENGGARA TIMUR",11,156,22,178
https://kawalpemilu.org#56617,"WAIOTI, ALOK TIMUR, SIKKA, NUSA TENGGARA TIMUR",12,176,35,211
https://kawalpemilu.org#56617,"WAIOTI, ALOK TIMUR, SIKKA, NUSA TENGGARA TIMUR",13,209,14,223
https://kawalpemilu.org#56617,"WAIOTI, ALOK TIMUR, SIKKA, NUSA TENGGARA TIMUR",14,148,46,194
https://kawalpemilu.org#56617,"WAIOTI, ALOK TIMUR, SIKKA, NUSA TENGGARA TIMUR",15,227,12,239
https://kawalpemilu.org#56618,"WAIROTANG, ALOK TIMUR, SIKKA, NUSA TENGGARA TIMUR",1,184,16,200
https://kawalpemilu.org#56618,"WAIROTANG, ALOK TIMUR, SIKKA, NUSA TENGGARA TIMUR",2,217,12,229
https://kawalpemilu.org#56618,"WAIROTANG, ALOK TIMUR, SIKKA, NUSA TENGGARA TIMUR",3,216,6,222
https://kawalpemilu.org#56618,"WAIROTANG, ALOK TIMUR, SIKKA, NUSA TENGGARA TIMUR",4,229,22,251
https://kawalpemilu.org#56618,"WAIROTANG, ALOK TIMUR, SIKKA, NUSA TENGGARA TIMUR",5,232,16,248
https://kawalpemilu.org#56618,"WAIROTANG, ALOK TIMUR, SIKKA, NUSA TENGGARA TIMUR",6,207,15,222
https://kawalpemilu.org#56619,"KOJA DOI, ALOK TIMUR, SIKKA, NUSA TENGGARA TIMUR",1,54,175,229
https://kawalpemilu.org#56619,"KOJA DOI, ALOK TIMUR, SIKKA, NUSA TENGGARA TIMUR",2,42,167,209
https://kawalpemilu.org#56619,"KOJA DOI, ALOK TIMUR, SIKKA, NUSA TENGGARA TIMUR",3,34,145,179
https://kawalpemilu.org#56619,"KOJA DOI, ALOK TIMUR, SIKKA, NUSA TENGGARA TIMUR",4,50,78,128
https://kawalpemilu.org#56619,"KOJA DOI, ALOK TIMUR, SIKKA, NUSA TENGGARA TIMUR",5,84,59,143
https://kawalpemilu.org#56620,"KOJAGETE, ALOK TIMUR, SIKKA, NUSA TENGGARA TIMUR",1,131,2,133
https://kawalpemilu.org#56620,"KOJAGETE, ALOK TIMUR, SIKKA, NUSA TENGGARA TIMUR",2,29,170,199
https://kawalpemilu.org#56620,"KOJAGETE, ALOK TIMUR, SIKKA, NUSA TENGGARA TIMUR",3,12,213,225
https://kawalpemilu.org#56620,"KOJAGETE, ALOK TIMUR, SIKKA, NUSA TENGGARA TIMUR",4,49,86,135
https://kawalpemilu.org#56620,"KOJAGETE, ALOK TIMUR, SIKKA, NUSA TENGGARA TIMUR",5,98,21,119
https://kawalpemilu.org#56621,"LEPOLIMA, ALOK TIMUR, SIKKA, NUSA TENGGARA TIMUR",1,146,11,157
https://kawalpemilu.org#56621,"LEPOLIMA, ALOK TIMUR, SIKKA, NUSA TENGGARA TIMUR",2,172,2,174
https://kawalpemilu.org#56621,"LEPOLIMA, ALOK TIMUR, SIKKA, NUSA TENGGARA TIMUR",3,213,13,226
https://kawalpemilu.org#56621,"LEPOLIMA, ALOK TIMUR, SIKKA, NUSA TENGGARA TIMUR",4,219,11,230
https://kawalpemilu.org#56621,"LEPOLIMA, ALOK TIMUR, SIKKA, NUSA TENGGARA TIMUR",5,160,7,167
https://kawalpemilu.org#56622,"PARUMAAN, ALOK TIMUR, SIKKA, NUSA TENGGARA TIMUR",1,19,222,241
https://kawalpemilu.org#56622,"PARUMAAN, ALOK TIMUR, SIKKA, NUSA TENGGARA TIMUR",2,12,225,237
https://kawalpemilu.org#56622,"PARUMAAN, ALOK TIMUR, SIKKA, NUSA TENGGARA TIMUR",3,22,173,195
https://kawalpemilu.org#56622,"PARUMAAN, ALOK TIMUR, SIKKA, NUSA TENGGARA TIMUR",4,17,153,170
https://kawalpemilu.org#56622,"PARUMAAN, ALOK TIMUR, SIKKA, NUSA TENGGARA TIMUR",5,11,137,148
https://kawalpemilu.org#56622,"PARUMAAN, ALOK TIMUR, SIKKA, NUSA TENGGARA TIMUR",6,2,102,104
https://kawalpemilu.org#56623,"WATUGONG, ALOK TIMUR, SIKKA, NUSA TENGGARA TIMUR",1,218,10,228
https://kawalpemilu.org#56623,"WATUGONG, ALOK TIMUR, SIKKA, NUSA TENGGARA TIMUR",2,176,13,189
https://kawalpemilu.org#56623,"WATUGONG, ALOK TIMUR, SIKKA, NUSA TENGGARA TIMUR",3,214,6,220
https://kawalpemilu.org#56623,"WATUGONG, ALOK TIMUR, SIKKA, NUSA TENGGARA TIMUR",4,229,18,247
https://kawalpemilu.org#56623,"WATUGONG, ALOK TIMUR, SIKKA, NUSA TENGGARA TIMUR",5,216,15,231
https://kawalpemilu.org#56623,"WATUGONG, ALOK TIMUR, SIKKA, NUSA TENGGARA TIMUR",6,179,51,230
https://kawalpemilu.org#56623,"WATUGONG, ALOK TIMUR, SIKKA, NUSA TENGGARA TIMUR",7,161,2,163
https://kawalpemilu.org#56625,"KOTING A, KOTING, SIKKA, NUSA TENGGARA TIMUR",1,227,6,233
https://kawalpemilu.org#56625,"KOTING A, KOTING, SIKKA, NUSA TENGGARA TIMUR",2,241,5,246
https://kawalpemilu.org#56625,"KOTING A, KOTING, SIKKA, NUSA TENGGARA TIMUR",3,175,5,180
https://kawalpemilu.org#56625,"KOTING A, KOTING, SIKKA, NUSA TENGGARA TIMUR",4,205,10,215
https://kawalpemilu.org#56626,"KOTING B, KOTING, SIKKA, NUSA TENGGARA TIMUR",1,185,6,191
https://kawalpemilu.org#56626,"KOTING B, KOTING, SIKKA, NUSA TENGGARA TIMUR",2,237,4,241
https://kawalpemilu.org#56626,"KOTING B, KOTING, SIKKA, NUSA TENGGARA TIMUR",3,207,6,213
https://kawalpemilu.org#56627,"KOTING C, KOTING, SIKKA, NUSA TENGGARA TIMUR",1,196,3,199
https://kawalpemilu.org#56627,"KOTING C, KOTING, SIKKA, NUSA TENGGARA TIMUR",2,207,6,213
https://kawalpemilu.org#56627,"KOTING C, KOTING, SIKKA, NUSA TENGGARA TIMUR",3,197,8,205
https://kawalpemilu.org#56628,"KOTING D, KOTING, SIKKA, NUSA TENGGARA TIMUR",1,209,15,224
https://kawalpemilu.org#56628,"KOTING D, KOTING, SIKKA, NUSA TENGGARA TIMUR",2,218,4,222
https://kawalpemilu.org#56628,"KOTING D, KOTING, SIKKA, NUSA TENGGARA TIMUR",3,215,17,232
https://kawalpemilu.org#56628,"KOTING D, KOTING, SIKKA, NUSA TENGGARA TIMUR",4,227,13,240
https://kawalpemilu.org#56629,"PAUBEKOR, KOTING, SIKKA, NUSA TENGGARA TIMUR",1,202,3,205
https://kawalpemilu.org#56629,"PAUBEKOR, KOTING, SIKKA, NUSA TENGGARA TIMUR",2,213,7,220
https://kawalpemilu.org#56630,"RIBANG, KOTING, SIKKA, NUSA TENGGARA TIMUR",1,172,10,182
https://kawalpemilu.org#56630,"RIBANG, KOTING, SIKKA, NUSA TENGGARA TIMUR",2,188,11,199
https://kawalpemilu.org#56630,"RIBANG, KOTING, SIKKA, NUSA TENGGARA TIMUR",3,122,11,133
https://kawalpemilu.org#56632,"BU SELATAN, TANA WAWO, SIKKA, NUSA TENGGARA TIMUR",1,120,9,129
https://kawalpemilu.org#56632,"BU SELATAN, TANA WAWO, SIKKA, NUSA TENGGARA TIMUR",2,111,14,125
https://kawalpemilu.org#56632,"BU SELATAN, TANA WAWO, SIKKA, NUSA TENGGARA TIMUR",3,91,7,98
https://kawalpemilu.org#56632,"BU SELATAN, TANA WAWO, SIKKA, NUSA TENGGARA TIMUR",4,89,3,92
https://kawalpemilu.org#56632,"BU SELATAN, TANA WAWO, SIKKA, NUSA TENGGARA TIMUR",5,88,4,92
https://kawalpemilu.org#56632,"BU SELATAN, TANA WAWO, SIKKA, NUSA TENGGARA TIMUR",6,108,10,118
https://kawalpemilu.org#56633,"BU UTARA, TANA WAWO, SIKKA, NUSA TENGGARA TIMUR",1,190,9,199
https://kawalpemilu.org#56633,"BU UTARA, TANA WAWO, SIKKA, NUSA TENGGARA TIMUR",2,216,1,217
https://kawalpemilu.org#56633,"BU UTARA, TANA WAWO, SIKKA, NUSA TENGGARA TIMUR",3,157,1,158
https://kawalpemilu.org#56634,"BU WATUWETI, TANA WAWO, SIKKA, NUSA TENGGARA TIMUR",1,168,1,169
https://kawalpemilu.org#56634,"BU WATUWETI, TANA WAWO, SIKKA, NUSA TENGGARA TIMUR",2,99,0,99
https://kawalpemilu.org#56634,"BU WATUWETI, TANA WAWO, SIKKA, NUSA TENGGARA TIMUR",3,163,8,171
https://kawalpemilu.org#56635,"LOKE, TANA WAWO, SIKKA, NUSA TENGGARA TIMUR",1,221,5,226
https://kawalpemilu.org#56635,"LOKE, TANA WAWO, SIKKA, NUSA TENGGARA TIMUR",2,132,5,137
https://kawalpemilu.org#56635,"LOKE, TANA WAWO, SIKKA, NUSA TENGGARA TIMUR",3,123,1,124
https://kawalpemilu.org#56636,"RENGGARASI, TANA WAWO, SIKKA, NUSA TENGGARA TIMUR",1,138,2,140
https://kawalpemilu.org#56636,"RENGGARASI, TANA WAWO, SIKKA, NUSA TENGGARA TIMUR",2,175,1,176
https://kawalpemilu.org#56636,"RENGGARASI, TANA WAWO, SIKKA, NUSA TENGGARA TIMUR",3,212,4,216
https://kawalpemilu.org#56636,"RENGGARASI, TANA WAWO, SIKKA, NUSA TENGGARA TIMUR",4,182,4,186
https://kawalpemilu.org#56636,"RENGGARASI, TANA WAWO, SIKKA, NUSA TENGGARA TIMUR",5,84,1,85
https://kawalpemilu.org#56637,"DETUBINGA, TANA WAWO, SIKKA, NUSA TENGGARA TIMUR",1,204,8,212
https://kawalpemilu.org#56637,"DETUBINGA, TANA WAWO, SIKKA, NUSA TENGGARA TIMUR",2,116,12,128
https://kawalpemilu.org#56637,"DETUBINGA, TANA WAWO, SIKKA, NUSA TENGGARA TIMUR",3,134,6,140
https://kawalpemilu.org#56638,"TUWA, TANA WAWO, SIKKA, NUSA TENGGARA TIMUR",1,114,12,126
https://kawalpemilu.org#56638,"TUWA, TANA WAWO, SIKKA, NUSA TENGGARA TIMUR",2,179,1,180
https://kawalpemilu.org#56638,"TUWA, TANA WAWO, SIKKA, NUSA TENGGARA TIMUR",3,118,1,119
https://kawalpemilu.org#56638,"TUWA, TANA WAWO, SIKKA, NUSA TENGGARA TIMUR",4,99,1,100
https://kawalpemilu.org#56639,"POMA, TANA WAWO, SIKKA, NUSA TENGGARA TIMUR",1,85,1,86
https://kawalpemilu.org#56639,"POMA, TANA WAWO, SIKKA, NUSA TENGGARA TIMUR",2,64,0,64
https://kawalpemilu.org#56639,"POMA, TANA WAWO, SIKKA, NUSA TENGGARA TIMUR",3,196,2,198
https://kawalpemilu.org#56639,"POMA, TANA WAWO, SIKKA, NUSA TENGGARA TIMUR",4,224,5,229
https://kawalpemilu.org#56639,"POMA, TANA WAWO, SIKKA, NUSA TENGGARA TIMUR",5,89,4,93
https://kawalpemilu.org#56641,"RUBIT, HEWOKLOANG, SIKKA, NUSA TENGGARA TIMUR",1,115,5,120
https://kawalpemilu.org#56641,"RUBIT, HEWOKLOANG, SIKKA, NUSA TENGGARA TIMUR",2,132,5,137
https://kawalpemilu.org#56641,"RUBIT, HEWOKLOANG, SIKKA, NUSA TENGGARA TIMUR",3,129,3,132
https://kawalpemilu.org#56641,"RUBIT, HEWOKLOANG, SIKKA, NUSA TENGGARA TIMUR",4,123,5,128
https://kawalpemilu.org#56641,"RUBIT, HEWOKLOANG, SIKKA, NUSA TENGGARA TIMUR",5,159,14,173
https://kawalpemilu.org#56641,"RUBIT, HEWOKLOANG, SIKKA, NUSA TENGGARA TIMUR",6,151,15,166
https://kawalpemilu.org#56641,"RUBIT, HEWOKLOANG, SIKKA, NUSA TENGGARA TIMUR",7,122,6,128
https://kawalpemilu.org#56642,"WOLOMAPA, HEWOKLOANG, SIKKA, NUSA TENGGARA TIMUR",1,215,18,233
https://kawalpemilu.org#56642,"WOLOMAPA, HEWOKLOANG, SIKKA, NUSA TENGGARA TIMUR",2,159,2,161
https://kawalpemilu.org#56642,"WOLOMAPA, HEWOKLOANG, SIKKA, NUSA TENGGARA TIMUR",3,172,4,176
https://kawalpemilu.org#56643,"BAOMEKOT, HEWOKLOANG, SIKKA, NUSA TENGGARA TIMUR",1,213,23,236
https://kawalpemilu.org#56643,"BAOMEKOT, HEWOKLOANG, SIKKA, NUSA TENGGARA TIMUR",2,137,11,148
https://kawalpemilu.org#56643,"BAOMEKOT, HEWOKLOANG, SIKKA, NUSA TENGGARA TIMUR",3,185,12,197
https://kawalpemilu.org#56643,"BAOMEKOT, HEWOKLOANG, SIKKA, NUSA TENGGARA TIMUR",4,115,5,120
https://kawalpemilu.org#56644,"KAJOWAIR, HEWOKLOANG, SIKKA, NUSA TENGGARA TIMUR",1,159,13,172
https://kawalpemilu.org#56644,"KAJOWAIR, HEWOKLOANG, SIKKA, NUSA TENGGARA TIMUR",2,200,16,216
https://kawalpemilu.org#56644,"KAJOWAIR, HEWOKLOANG, SIKKA, NUSA TENGGARA TIMUR",3,116,11,127
https://kawalpemilu.org#56644,"KAJOWAIR, HEWOKLOANG, SIKKA, NUSA TENGGARA TIMUR",4,137,8,145
https://kawalpemilu.org#56644,"KAJOWAIR, HEWOKLOANG, SIKKA, NUSA TENGGARA TIMUR",5,188,13,201
https://kawalpemilu.org#56644,"KAJOWAIR, HEWOKLOANG, SIKKA, NUSA TENGGARA TIMUR",6,127,3,130
https://kawalpemilu.org#56645,"HEWOKLOANG, HEWOKLOANG, SIKKA, NUSA TENGGARA TIMUR",1,146,3,149
https://kawalpemilu.org#56645,"HEWOKLOANG, HEWOKLOANG, SIKKA, NUSA TENGGARA TIMUR",2,130,14,144
https://kawalpemilu.org#56645,"HEWOKLOANG, HEWOKLOANG, SIKKA, NUSA TENGGARA TIMUR",3,139,6,145
https://kawalpemilu.org#56645,"HEWOKLOANG, HEWOKLOANG, SIKKA, NUSA TENGGARA TIMUR",4,131,6,137
https://kawalpemilu.org#56646,"HEOPUAT, HEWOKLOANG, SIKKA, NUSA TENGGARA TIMUR",1,114,7,121
https://kawalpemilu.org#56646,"HEOPUAT, HEWOKLOANG, SIKKA, NUSA TENGGARA TIMUR",2,123,3,126
https://kawalpemilu.org#56646,"HEOPUAT, HEWOKLOANG, SIKKA, NUSA TENGGARA TIMUR",3,131,3,134
https://kawalpemilu.org#56646,"HEOPUAT, HEWOKLOANG, SIKKA, NUSA TENGGARA TIMUR",4,138,1,139
https://kawalpemilu.org#56647,"MUNERANA, HEWOKLOANG, SIKKA, NUSA TENGGARA TIMUR",1,180,4,184
https://kawalpemilu.org#56647,"MUNERANA, HEWOKLOANG, SIKKA, NUSA TENGGARA TIMUR",2,167,1,168
https://kawalpemilu.org#56647,"MUNERANA, HEWOKLOANG, SIKKA, NUSA TENGGARA TIMUR",3,135,6,141
https://kawalpemilu.org#56647,"MUNERANA, HEWOKLOANG, SIKKA, NUSA TENGGARA TIMUR",4,165,3,168
https://kawalpemilu.org#56649,"TEKA IKU, KANGAE, SIKKA, NUSA TENGGARA TIMUR",1,230,6,236
https://kawalpemilu.org#56649,"TEKA IKU, KANGAE, SIKKA, NUSA TENGGARA TIMUR",2,248,2,250
https://kawalpemilu.org#56649,"TEKA IKU, KANGAE, SIKKA, NUSA TENGGARA TIMUR",3,140,7,147
https://kawalpemilu.org#56649,"TEKA IKU, KANGAE, SIKKA, NUSA TENGGARA TIMUR",4,128,3,131
https://kawalpemilu.org#56650,"MEKENDETUNG, KANGAE, SIKKA, NUSA TENGGARA TIMUR",1,100,23,123
https://kawalpemilu.org#56650,"MEKENDETUNG, KANGAE, SIKKA, NUSA TENGGARA TIMUR",2,202,21,223
https://kawalpemilu.org#56650,"MEKENDETUNG, KANGAE, SIKKA, NUSA TENGGARA TIMUR",3,156,7,163
https://kawalpemilu.org#56650,"MEKENDETUNG, KANGAE, SIKKA, NUSA TENGGARA TIMUR",4,160,2,162
https://kawalpemilu.org#56650,"MEKENDETUNG, KANGAE, SIKKA, NUSA TENGGARA TIMUR",5,194,3,197
https://kawalpemilu.org#56650,"MEKENDETUNG, KANGAE, SIKKA, NUSA TENGGARA TIMUR",6,102,27,129
https://kawalpemilu.org#56651,"KOKOWAHOR, KANGAE, SIKKA, NUSA TENGGARA TIMUR",1,213,6,219
https://kawalpemilu.org#56651,"KOKOWAHOR, KANGAE, SIKKA, NUSA TENGGARA TIMUR",2,204,10,214
https://kawalpemilu.org#56651,"KOKOWAHOR, KANGAE, SIKKA, NUSA TENGGARA TIMUR",3,206,4,210
https://kawalpemilu.org#56651,"KOKOWAHOR, KANGAE, SIKKA, NUSA TENGGARA TIMUR",4,202,8,210
https://kawalpemilu.org#56652,"BLATATATIN, KANGAE, SIKKA, NUSA TENGGARA TIMUR",1,212,13,225
https://kawalpemilu.org#56652,"BLATATATIN, KANGAE, SIKKA, NUSA TENGGARA TIMUR",2,246,9,255
https://kawalpemilu.org#56652,"BLATATATIN, KANGAE, SIKKA, NUSA TENGGARA TIMUR",3,217,10,227
https://kawalpemilu.org#56652,"BLATATATIN, KANGAE, SIKKA, NUSA TENGGARA TIMUR",4,230,6,236
https://kawalpemilu.org#56653,"WATULIWUNG, KANGAE, SIKKA, NUSA TENGGARA TIMUR",1,220,3,223
https://kawalpemilu.org#56653,"WATULIWUNG, KANGAE, SIKKA, NUSA TENGGARA TIMUR",2,224,3,227
https://kawalpemilu.org#56653,"WATULIWUNG, KANGAE, SIKKA, NUSA TENGGARA TIMUR",3,190,14,204
https://kawalpemilu.org#56653,"WATULIWUNG, KANGAE, SIKKA, NUSA TENGGARA TIMUR",4,187,8,195
https://kawalpemilu.org#56653,"WATULIWUNG, KANGAE, SIKKA, NUSA TENGGARA TIMUR",5,191,19,210
https://kawalpemilu.org#56653,"WATULIWUNG, KANGAE, SIKKA, NUSA TENGGARA TIMUR",6,197,21,218
https://kawalpemilu.org#56654,"TANA DUEN, KANGAE, SIKKA, NUSA TENGGARA TIMUR",1,238,13,251
https://kawalpemilu.org#56654,"TANA DUEN, KANGAE, SIKKA, NUSA TENGGARA TIMUR",2,185,4,189
https://kawalpemilu.org#56654,"TANA DUEN, KANGAE, SIKKA, NUSA TENGGARA TIMUR",3,187,13,200
https://kawalpemilu.org#56654,"TANA DUEN, KANGAE, SIKKA, NUSA TENGGARA TIMUR",4,203,6,209
https://kawalpemilu.org#56654,"TANA DUEN, KANGAE, SIKKA, NUSA TENGGARA TIMUR",5,213,12,225
https://kawalpemilu.org#56654,"TANA DUEN, KANGAE, SIKKA, NUSA TENGGARA TIMUR",6,202,12,214
https://kawalpemilu.org#56655,"WATUMILOK, KANGAE, SIKKA, NUSA TENGGARA TIMUR",1,217,8,225
https://kawalpemilu.org#56655,"WATUMILOK, KANGAE, SIKKA, NUSA TENGGARA TIMUR",2,213,4,217
https://kawalpemilu.org#56655,"WATUMILOK, KANGAE, SIKKA, NUSA TENGGARA TIMUR",3,183,27,210
https://kawalpemilu.org#56655,"WATUMILOK, KANGAE, SIKKA, NUSA TENGGARA TIMUR",4,147,40,187
https://kawalpemilu.org#56655,"WATUMILOK, KANGAE, SIKKA, NUSA TENGGARA TIMUR",5,87,110,197
https://kawalpemilu.org#56655,"WATUMILOK, KANGAE, SIKKA, NUSA TENGGARA TIMUR",6,100,112,212
https://kawalpemilu.org#56655,"WATUMILOK, KANGAE, SIKKA, NUSA TENGGARA TIMUR",7,150,53,203
https://kawalpemilu.org#56656,"HABI, KANGAE, SIKKA, NUSA TENGGARA TIMUR",1,195,1,196
https://kawalpemilu.org#56656,"HABI, KANGAE, SIKKA, NUSA TENGGARA TIMUR",2,233,1,234
https://kawalpemilu.org#56656,"HABI, KANGAE, SIKKA, NUSA TENGGARA TIMUR",3,248,12,260
https://kawalpemilu.org#56656,"HABI, KANGAE, SIKKA, NUSA TENGGARA TIMUR",4,197,9,206
https://kawalpemilu.org#56656,"HABI, KANGAE, SIKKA, NUSA TENGGARA TIMUR",5,177,6,183
https://kawalpemilu.org#56656,"HABI, KANGAE, SIKKA, NUSA TENGGARA TIMUR",6,160,6,166
https://kawalpemilu.org#56657,"LANGIR, KANGAE, SIKKA, NUSA TENGGARA TIMUR",1,226,11,237
https://kawalpemilu.org#56657,"LANGIR, KANGAE, SIKKA, NUSA TENGGARA TIMUR",2,240,4,244
https://kawalpemilu.org#56657,"LANGIR, KANGAE, SIKKA, NUSA TENGGARA TIMUR",3,205,7,212
https://kawalpemilu.org#56657,"LANGIR, KANGAE, SIKKA, NUSA TENGGARA TIMUR",4,221,9,230
https://kawalpemilu.org#56657,"LANGIR, KANGAE, SIKKA, NUSA TENGGARA TIMUR",5,200,7,207
https://kawalpemilu.org#56657,"LANGIR, KANGAE, SIKKA, NUSA TENGGARA TIMUR",6,160,6,166
https://kawalpemilu.org#56659,"WAIHAWA, DORENG, SIKKA, NUSA TENGGARA TIMUR",1,141,4,145
https://kawalpemilu.org#56659,"WAIHAWA, DORENG, SIKKA, NUSA TENGGARA TIMUR",2,0,0,0
https://kawalpemilu.org#56659,"WAIHAWA, DORENG, SIKKA, NUSA TENGGARA TIMUR",3,103,10,113
https://kawalpemilu.org#56659,"WAIHAWA, DORENG, SIKKA, NUSA TENGGARA TIMUR",4,70,10,80
https://kawalpemilu.org#56660,"NENBURA, DORENG, SIKKA, NUSA TENGGARA TIMUR",1,228,12,240
https://kawalpemilu.org#56660,"NENBURA, DORENG, SIKKA, NUSA TENGGARA TIMUR",2,236,6,242
https://kawalpemilu.org#56660,"NENBURA, DORENG, SIKKA, NUSA TENGGARA TIMUR",3,213,9,222
https://kawalpemilu.org#56660,"NENBURA, DORENG, SIKKA, NUSA TENGGARA TIMUR",5,177,8,185
https://kawalpemilu.org#56660,"NENBURA, DORENG, SIKKA, NUSA TENGGARA TIMUR",6,129,1,130
https://kawalpemilu.org#56661,"WOGALIRIT, DORENG, SIKKA, NUSA TENGGARA TIMUR",1,229,6,235
https://kawalpemilu.org#56661,"WOGALIRIT, DORENG, SIKKA, NUSA TENGGARA TIMUR",2,112,1,113
https://kawalpemilu.org#56661,"WOGALIRIT, DORENG, SIKKA, NUSA TENGGARA TIMUR",3,159,2,161
https://kawalpemilu.org#56661,"WOGALIRIT, DORENG, SIKKA, NUSA TENGGARA TIMUR",4,147,8,155
https://kawalpemilu.org#56662,"WATUMERAK, DORENG, SIKKA, NUSA TENGGARA TIMUR",1,151,6,157
https://kawalpemilu.org#56662,"WATUMERAK, DORENG, SIKKA, NUSA TENGGARA TIMUR",2,213,5,218
https://kawalpemilu.org#56662,"WATUMERAK, DORENG, SIKKA, NUSA TENGGARA TIMUR",3,157,7,164
https://kawalpemilu.org#56663,"WOLONTERANG, DORENG, SIKKA, NUSA TENGGARA TIMUR",1,130,17,147
https://kawalpemilu.org#56663,"WOLONTERANG, DORENG, SIKKA, NUSA TENGGARA TIMUR",2,140,13,153
https://kawalpemilu.org#56663,"WOLONTERANG, DORENG, SIKKA, NUSA TENGGARA TIMUR",3,116,2,118
https://kawalpemilu.org#56663,"WOLONTERANG, DORENG, SIKKA, NUSA TENGGARA TIMUR",4,141,1,142
https://kawalpemilu.org#56664,"KLOANGPOPOT, DORENG, SIKKA, NUSA TENGGARA TIMUR",1,119,12,131
https://kawalpemilu.org#56664,"KLOANGPOPOT, DORENG, SIKKA, NUSA TENGGARA TIMUR",2,203,8,211
https://kawalpemilu.org#56664,"KLOANGPOPOT, DORENG, SIKKA, NUSA TENGGARA TIMUR",3,131,7,138
https://kawalpemilu.org#56664,"KLOANGPOPOT, DORENG, SIKKA, NUSA TENGGARA TIMUR",4,154,8,162
https://kawalpemilu.org#56664,"KLOANGPOPOT, DORENG, SIKKA, NUSA TENGGARA TIMUR",5,190,6,196
https://kawalpemilu.org#56664,"KLOANGPOPOT, DORENG, SIKKA, NUSA TENGGARA TIMUR",6,153,7,160
https://kawalpemilu.org#56664,"KLOANGPOPOT, DORENG, SIKKA, NUSA TENGGARA TIMUR",7,145,3,148
https://kawalpemilu.org#56664,"KLOANGPOPOT, DORENG, SIKKA, NUSA TENGGARA TIMUR",8,66,2,68
https://kawalpemilu.org#56664,"KLOANGPOPOT, DORENG, SIKKA, NUSA TENGGARA TIMUR",9,119,15,134
https://kawalpemilu.org#56665,"WOLOMOTONG, DORENG, SIKKA, NUSA TENGGARA TIMUR",1,236,3,239
https://kawalpemilu.org#56665,"WOLOMOTONG, DORENG, SIKKA, NUSA TENGGARA TIMUR",2,147,7,154
https://kawalpemilu.org#56665,"WOLOMOTONG, DORENG, SIKKA, NUSA TENGGARA TIMUR",3,219,17,236
https://kawalpemilu.org#56665,"WOLOMOTONG, DORENG, SIKKA, NUSA TENGGARA TIMUR",4,147,7,154
https://kawalpemilu.org#56665,"WOLOMOTONG, DORENG, SIKKA, NUSA TENGGARA TIMUR",5,136,3,139
https://kawalpemilu.org#56665,"WOLOMOTONG, DORENG, SIKKA, NUSA TENGGARA TIMUR",6,144,1,145
https://kawalpemilu.org#56665,"WOLOMOTONG, DORENG, SIKKA, NUSA TENGGARA TIMUR",7,128,7,135
https://kawalpemilu.org#56665,"WOLOMOTONG, DORENG, SIKKA, NUSA TENGGARA TIMUR",8,162,7,169
https://kawalpemilu.org#56667,"HALE, MAPITARA, SIKKA, NUSA TENGGARA TIMUR",1,184,13,197
https://kawalpemilu.org#56667,"HALE, MAPITARA, SIKKA, NUSA TENGGARA TIMUR",2,179,16,195
https://kawalpemilu.org#56667,"HALE, MAPITARA, SIKKA, NUSA TENGGARA TIMUR",3,207,25,232
https://kawalpemilu.org#56667,"HALE, MAPITARA, SIKKA, NUSA TENGGARA TIMUR",4,193,12,205
https://kawalpemilu.org#56667,"HALE, MAPITARA, SIKKA, NUSA TENGGARA TIMUR",5,170,10,180
https://kawalpemilu.org#56667,"HALE, MAPITARA, SIKKA, NUSA TENGGARA TIMUR",6,142,2,144
https://kawalpemilu.org#56667,"HALE, MAPITARA, SIKKA, NUSA TENGGARA TIMUR",7,115,2,117
https://kawalpemilu.org#56668,"HEBING, MAPITARA, SIKKA, NUSA TENGGARA TIMUR",1,190,11,201
https://kawalpemilu.org#56668,"HEBING, MAPITARA, SIKKA, NUSA TENGGARA TIMUR",2,135,12,147
https://kawalpemilu.org#56668,"HEBING, MAPITARA, SIKKA, NUSA TENGGARA TIMUR",3,113,18,131
https://kawalpemilu.org#56668,"HEBING, MAPITARA, SIKKA, NUSA TENGGARA TIMUR",4,160,9,169
https://kawalpemilu.org#56668,"HEBING, MAPITARA, SIKKA, NUSA TENGGARA TIMUR",5,127,11,138
https://kawalpemilu.org#56668,"HEBING, MAPITARA, SIKKA, NUSA TENGGARA TIMUR",6,128,14,142
https://kawalpemilu.org#56669,"NATAKOLI, MAPITARA, SIKKA, NUSA TENGGARA TIMUR",1,150,2,152
https://kawalpemilu.org#56669,"NATAKOLI, MAPITARA, SIKKA, NUSA TENGGARA TIMUR",2,108,1,109
https://kawalpemilu.org#56669,"NATAKOLI, MAPITARA, SIKKA, NUSA TENGGARA TIMUR",3,222,5,227
https://kawalpemilu.org#56669,"NATAKOLI, MAPITARA, SIKKA, NUSA TENGGARA TIMUR",4,222,8,230
https://kawalpemilu.org#56670,"EGON GAHAR, MAPITARA, SIKKA, NUSA TENGGARA TIMUR",1,209,7,216
https://kawalpemilu.org#56670,"EGON GAHAR, MAPITARA, SIKKA, NUSA TENGGARA TIMUR",2,211,11,222
https://kawalpemilu.org#56670,"EGON GAHAR, MAPITARA, SIKKA, NUSA TENGGARA TIMUR",3,161,4,165
https://kawalpemilu.org#56670,"EGON GAHAR, MAPITARA, SIKKA, NUSA TENGGARA TIMUR",4,195,7,202
https://kawalpemilu.org#56673,"NDORUREA, NANGAPANDA, ENDE, NUSA TENGGARA TIMUR",1,40,89,129
https://kawalpemilu.org#56673,"NDORUREA, NANGAPANDA, ENDE, NUSA TENGGARA TIMUR",2,41,111,152
https://kawalpemilu.org#56673,"NDORUREA, NANGAPANDA, ENDE, NUSA TENGGARA TIMUR",3,83,81,164
https://kawalpemilu.org#56673,"NDORUREA, NANGAPANDA, ENDE, NUSA TENGGARA TIMUR",4,38,88,126
https://kawalpemilu.org#56673,"NDORUREA, NANGAPANDA, ENDE, NUSA TENGGARA TIMUR",5,30,93,123
https://kawalpemilu.org#56673,"NDORUREA, NANGAPANDA, ENDE, NUSA TENGGARA TIMUR",6,89,72,161
https://kawalpemilu.org#56673,"NDORUREA, NANGAPANDA, ENDE, NUSA TENGGARA TIMUR",7,35,73,108
https://kawalpemilu.org#56674,"ONDOREA, NANGAPANDA, ENDE, NUSA TENGGARA TIMUR",1,141,43,184
https://kawalpemilu.org#56674,"ONDOREA, NANGAPANDA, ENDE, NUSA TENGGARA TIMUR",2,66,102,168
https://kawalpemilu.org#56674,"ONDOREA, NANGAPANDA, ENDE, NUSA TENGGARA TIMUR",3,82,40,122
https://kawalpemilu.org#56675,"WATUMITE, NANGAPANDA, ENDE, NUSA TENGGARA TIMUR",1,203,0,203
https://kawalpemilu.org#56675,"WATUMITE, NANGAPANDA, ENDE, NUSA TENGGARA TIMUR",2,150,2,152
https://kawalpemilu.org#56675,"WATUMITE, NANGAPANDA, ENDE, NUSA TENGGARA TIMUR",3,102,3,105
https://kawalpemilu.org#56676,"TENDAREA, NANGAPANDA, ENDE, NUSA TENGGARA TIMUR",2,180,5,185
https://kawalpemilu.org#56676,"TENDAREA, NANGAPANDA, ENDE, NUSA TENGGARA TIMUR",3,183,1,184
https://kawalpemilu.org#56677,"KERIREA, NANGAPANDA, ENDE, NUSA TENGGARA TIMUR",1,96,0,96
https://kawalpemilu.org#56677,"KERIREA, NANGAPANDA, ENDE, NUSA TENGGARA TIMUR",2,144,1,145
https://kawalpemilu.org#56677,"KERIREA, NANGAPANDA, ENDE, NUSA TENGGARA TIMUR",3,145,1,146
https://kawalpemilu.org#56677,"KERIREA, NANGAPANDA, ENDE, NUSA TENGGARA TIMUR",4,132,1,133
https://kawalpemilu.org#56678,"TENDAMBEPA, NANGAPANDA, ENDE, NUSA TENGGARA TIMUR",1,147,1,148
https://kawalpemilu.org#56678,"TENDAMBEPA, NANGAPANDA, ENDE, NUSA TENGGARA TIMUR",2,170,2,172
https://kawalpemilu.org#56678,"TENDAMBEPA, NANGAPANDA, ENDE, NUSA TENGGARA TIMUR",3,114,0,114
https://kawalpemilu.org#56679,"ZOZOZEA, NANGAPANDA, ENDE, NUSA TENGGARA TIMUR",1,138,0,138
https://kawalpemilu.org#56679,"ZOZOZEA, NANGAPANDA, ENDE, NUSA TENGGARA TIMUR",2,147,12,159
https://kawalpemilu.org#56680,"RAPOWAWO, NANGAPANDA, ENDE, NUSA TENGGARA TIMUR",1,126,2,128
https://kawalpemilu.org#56680,"RAPOWAWO, NANGAPANDA, ENDE, NUSA TENGGARA TIMUR",2,157,0,157
https://kawalpemilu.org#56680,"RAPOWAWO, NANGAPANDA, ENDE, NUSA TENGGARA TIMUR",3,174,3,177
https://kawalpemilu.org#56680,"RAPOWAWO, NANGAPANDA, ENDE, NUSA TENGGARA TIMUR",4,128,8,136
https://kawalpemilu.org#56681,"NGGOREA, NANGAPANDA, ENDE, NUSA TENGGARA TIMUR",1,32,192,224
https://kawalpemilu.org#56681,"NGGOREA, NANGAPANDA, ENDE, NUSA TENGGARA TIMUR",2,38,90,128
https://kawalpemilu.org#56681,"NGGOREA, NANGAPANDA, ENDE, NUSA TENGGARA TIMUR",3,67,136,203
https://kawalpemilu.org#56682,"RAPORENDU, NANGAPANDA, ENDE, NUSA TENGGARA TIMUR",1,32,189,221
https://kawalpemilu.org#56682,"RAPORENDU, NANGAPANDA, ENDE, NUSA TENGGARA TIMUR",2,17,128,145
https://kawalpemilu.org#56682,"RAPORENDU, NANGAPANDA, ENDE, NUSA TENGGARA TIMUR",3,11,155,166
https://kawalpemilu.org#56682,"RAPORENDU, NANGAPANDA, ENDE, NUSA TENGGARA TIMUR",4,81,175,256
https://kawalpemilu.org#56682,"RAPORENDU, NANGAPANDA, ENDE, NUSA TENGGARA TIMUR",5,11,112,123
https://kawalpemilu.org#56682,"RAPORENDU, NANGAPANDA, ENDE, NUSA TENGGARA TIMUR",6,84,76,160
https://kawalpemilu.org#56683,"BHERAMARI, NANGAPANDA, ENDE, NUSA TENGGARA TIMUR",1,136,25,161
https://kawalpemilu.org#56683,"BHERAMARI, NANGAPANDA, ENDE, NUSA TENGGARA TIMUR",2,179,6,185
https://kawalpemilu.org#56683,"BHERAMARI, NANGAPANDA, ENDE, NUSA TENGGARA TIMUR",3,120,58,178
https://kawalpemilu.org#56684,"TIWERHEA, NANGAPANDA, ENDE, NUSA TENGGARA TIMUR",2,174,8,182
https://kawalpemilu.org#56685,"SANGGARHORHO, NANGAPANDA, ENDE, NUSA TENGGARA TIMUR",1,195,5,200
https://kawalpemilu.org#56685,"SANGGARHORHO, NANGAPANDA, ENDE, NUSA TENGGARA TIMUR",2,144,2,146
https://kawalpemilu.org#56685,"SANGGARHORHO, NANGAPANDA, ENDE, NUSA TENGGARA TIMUR",3,137,3,140
https://kawalpemilu.org#56686,"NDETUZEA, NANGAPANDA, ENDE, NUSA TENGGARA TIMUR",1,81,153,234
https://kawalpemilu.org#56686,"NDETUZEA, NANGAPANDA, ENDE, NUSA TENGGARA TIMUR",2,64,181,245
https://kawalpemilu.org#56687,"NDORUREA I, NANGAPANDA, ENDE, NUSA TENGGARA TIMUR",1,147,25,172
https://kawalpemilu.org#56687,"NDORUREA I, NANGAPANDA, ENDE, NUSA TENGGARA TIMUR",2,70,71,141
https://kawalpemilu.org#56687,"NDORUREA I, NANGAPANDA, ENDE, NUSA TENGGARA TIMUR",3,173,8,181
https://kawalpemilu.org#56687,"NDORUREA I, NANGAPANDA, ENDE, NUSA TENGGARA TIMUR",4,132,13,145
https://kawalpemilu.org#56688,"PENGGAJAWA, NANGAPANDA, ENDE, NUSA TENGGARA TIMUR",1,68,144,212
https://kawalpemilu.org#56688,"PENGGAJAWA, NANGAPANDA, ENDE, NUSA TENGGARA TIMUR",2,20,121,141
https://kawalpemilu.org#56689,"JEGHARANGGA, NANGAPANDA, ENDE, NUSA TENGGARA TIMUR",1,150,2,152
https://kawalpemilu.org#56689,"JEGHARANGGA, NANGAPANDA, ENDE, NUSA TENGGARA TIMUR",2,81,8,89
https://kawalpemilu.org#56689,"JEGHARANGGA, NANGAPANDA, ENDE, NUSA TENGGARA TIMUR",3,124,1,125
https://kawalpemilu.org#56689,"JEGHARANGGA, NANGAPANDA, ENDE, NUSA TENGGARA TIMUR",4,163,4,167
https://kawalpemilu.org#56690,"ONDOREA BARAT, NANGAPANDA, ENDE, NUSA TENGGARA TIMUR",1,149,9,158
https://kawalpemilu.org#56690,"ONDOREA BARAT, NANGAPANDA, ENDE, NUSA TENGGARA TIMUR",2,200,6,206
https://kawalpemilu.org#56690,"ONDOREA BARAT, NANGAPANDA, ENDE, NUSA TENGGARA TIMUR",3,102,45,147
https://kawalpemilu.org#91267,"ROMAREA, NANGAPANDA, ENDE, NUSA TENGGARA TIMUR",1,97,6,103
https://kawalpemilu.org#91267,"ROMAREA, NANGAPANDA, ENDE, NUSA TENGGARA TIMUR",2,104,3,107
https://kawalpemilu.org#91268,"TIMBARIA, NANGAPANDA, ENDE, NUSA TENGGARA TIMUR",1,211,2,213
https://kawalpemilu.org#91268,"TIMBARIA, NANGAPANDA, ENDE, NUSA TENGGARA TIMUR",2,113,1,114
https://kawalpemilu.org#91269,"MBOBHENGA, NANGAPANDA, ENDE, NUSA TENGGARA TIMUR",1,208,5,213
https://kawalpemilu.org#91270,"MALAWARU, NANGAPANDA, ENDE, NUSA TENGGARA TIMUR",1,178,1,179
https://kawalpemilu.org#91271,"ANARAJA, NANGAPANDA, ENDE, NUSA TENGGARA TIMUR",1,16,234,250
https://kawalpemilu.org#91272,"KEKANDERE, NANGAPANDA, ENDE, NUSA TENGGARA TIMUR",1,144,1,145
https://kawalpemilu.org#91272,"KEKANDERE, NANGAPANDA, ENDE, NUSA TENGGARA TIMUR",2,134,2,136
https://kawalpemilu.org#91273,"TANAZOZO, NANGAPANDA, ENDE, NUSA TENGGARA TIMUR",1,216,46,262
https://kawalpemilu.org#91274,"TENDA ONDO, NANGAPANDA, ENDE, NUSA TENGGARA TIMUR",1,160,18,178
https://kawalpemilu.org#91275,"JEMBUREA, NANGAPANDA, ENDE, NUSA TENGGARA TIMUR",1,87,4,91
https://kawalpemilu.org#91276,"EMBUZOZO, NANGAPANDA, ENDE, NUSA TENGGARA TIMUR",1,148,29,177
https://kawalpemilu.org#91276,"EMBUZOZO, NANGAPANDA, ENDE, NUSA TENGGARA TIMUR",2,125,0,125
https://kawalpemilu.org#91277,"UZUZOZO, NANGAPANDA, ENDE, NUSA TENGGARA TIMUR",1,118,0,118
https://kawalpemilu.org#91277,"UZUZOZO, NANGAPANDA, ENDE, NUSA TENGGARA TIMUR",2,148,0,148
https://kawalpemilu.org#56692,"AEJETI, PULAU ENDE, ENDE, NUSA TENGGARA TIMUR",1,19,158,177
https://kawalpemilu.org#56692,"AEJETI, PULAU ENDE, ENDE, NUSA TENGGARA TIMUR",2,17,131,148
https://kawalpemilu.org#56692,"AEJETI, PULAU ENDE, ENDE, NUSA TENGGARA TIMUR",3,46,116,162
https://kawalpemilu.org#56693,"PUUTARA, PULAU ENDE, ENDE, NUSA TENGGARA TIMUR",1,7,108,115
https://kawalpemilu.org#56693,"PUUTARA, PULAU ENDE, ENDE, NUSA TENGGARA TIMUR",2,37,87,124
https://kawalpemilu.org#56693,"PUUTARA, PULAU ENDE, ENDE, NUSA TENGGARA TIMUR",3,8,109,117
https://kawalpemilu.org#56693,"PUUTARA, PULAU ENDE, ENDE, NUSA TENGGARA TIMUR",4,44,78,122
https://kawalpemilu.org#56694,"PADERAPE, PULAU ENDE, ENDE, NUSA TENGGARA TIMUR",1,30,124,154
https://kawalpemilu.org#56694,"PADERAPE, PULAU ENDE, ENDE, NUSA TENGGARA TIMUR",2,20,132,152
https://kawalpemilu.org#56694,"PADERAPE, PULAU ENDE, ENDE, NUSA TENGGARA TIMUR",3,27,118,145
https://kawalpemilu.org#56694,"PADERAPE, PULAU ENDE, ENDE, NUSA TENGGARA TIMUR",4,18,114,132
https://kawalpemilu.org#56695,"NDORIWOI, PULAU ENDE, ENDE, NUSA TENGGARA TIMUR",1,92,80,172
https://kawalpemilu.org#56695,"NDORIWOI, PULAU ENDE, ENDE, NUSA TENGGARA TIMUR",2,44,108,152
https://kawalpemilu.org#56695,"NDORIWOI, PULAU ENDE, ENDE, NUSA TENGGARA TIMUR",3,62,102,164
https://kawalpemilu.org#56695,"NDORIWOI, PULAU ENDE, ENDE, NUSA TENGGARA TIMUR",4,48,88,136
https://kawalpemilu.org#56696,"RORURANGGA, PULAU ENDE, ENDE, NUSA TENGGARA TIMUR",1,34,123,157
https://kawalpemilu.org#56696,"RORURANGGA, PULAU ENDE, ENDE, NUSA TENGGARA TIMUR",2,34,93,127
https://kawalpemilu.org#56696,"RORURANGGA, PULAU ENDE, ENDE, NUSA TENGGARA TIMUR",3,61,103,164
https://kawalpemilu.org#56696,"RORURANGGA, PULAU ENDE, ENDE, NUSA TENGGARA TIMUR",4,33,80,113
https://kawalpemilu.org#56697,"RENDORATERUA, PULAU ENDE, ENDE, NUSA TENGGARA TIMUR",1,14,135,149
https://kawalpemilu.org#56697,"RENDORATERUA, PULAU ENDE, ENDE, NUSA TENGGARA TIMUR",2,23,111,134
https://kawalpemilu.org#56697,"RENDORATERUA, PULAU ENDE, ENDE, NUSA TENGGARA TIMUR",3,20,122,142
https://kawalpemilu.org#56697,"RENDORATERUA, PULAU ENDE, ENDE, NUSA TENGGARA TIMUR",4,15,118,133
https://kawalpemilu.org#56698,"REDORORY, PULAU ENDE, ENDE, NUSA TENGGARA TIMUR",1,54,70,124
https://kawalpemilu.org#56698,"REDORORY, PULAU ENDE, ENDE, NUSA TENGGARA TIMUR",3,74,39,113
https://kawalpemilu.org#56698,"REDORORY, PULAU ENDE, ENDE, NUSA TENGGARA TIMUR",4,107,62,169
https://kawalpemilu.org#91265,"KAZO KAPO, PULAU ENDE, ENDE, NUSA TENGGARA TIMUR",1,39,57,96
https://kawalpemilu.org#91265,"KAZO KAPO, PULAU ENDE, ENDE, NUSA TENGGARA TIMUR",2,38,84,122
https://kawalpemilu.org#91265,"KAZO KAPO, PULAU ENDE, ENDE, NUSA TENGGARA TIMUR",3,32,81,113
https://kawalpemilu.org#91266,"RENGA MENGE, PULAU ENDE, ENDE, NUSA TENGGARA TIMUR",1,98,146,244
https://kawalpemilu.org#91266,"RENGA MENGE, PULAU ENDE, ENDE, NUSA TENGGARA TIMUR",2,81,105,186
https://kawalpemilu.org#56700,"RABURIA, ENDE, ENDE, NUSA TENGGARA TIMUR",1,147,3,150
https://kawalpemilu.org#56700,"RABURIA, ENDE, ENDE, NUSA TENGGARA TIMUR",2,95,0,95
https://kawalpemilu.org#56700,"RABURIA, ENDE, ENDE, NUSA TENGGARA TIMUR",3,90,6,96
https://kawalpemilu.org#56701,"RIARAJA, ENDE, ENDE, NUSA TENGGARA TIMUR",2,160,4,164
https://kawalpemilu.org#56701,"RIARAJA, ENDE, ENDE, NUSA TENGGARA TIMUR",3,75,32,107
https://kawalpemilu.org#56702,"MBOTUTENDA, ENDE, ENDE, NUSA TENGGARA TIMUR",1,149,1,150
https://kawalpemilu.org#56702,"MBOTUTENDA, ENDE, ENDE, NUSA TENGGARA TIMUR",2,184,1,185
https://kawalpemilu.org#56703,"WOLOGAI, ENDE, ENDE, NUSA TENGGARA TIMUR",1,161,1,162
https://kawalpemilu.org#56703,"WOLOGAI, ENDE, ENDE, NUSA TENGGARA TIMUR",2,180,4,184
https://kawalpemilu.org#56704,"NDETUNDORA I, ENDE, ENDE, NUSA TENGGARA TIMUR",1,132,0,132
https://kawalpemilu.org#56704,"NDETUNDORA I, ENDE, ENDE, NUSA TENGGARA TIMUR",2,104,1,105
https://kawalpemilu.org#56704,"NDETUNDORA I, ENDE, ENDE, NUSA TENGGARA TIMUR",3,144,3,147
https://kawalpemilu.org#56705,"NDETUNDORA II, ENDE, ENDE, NUSA TENGGARA TIMUR",1,219,1,220
https://kawalpemilu.org#56705,"NDETUNDORA II, ENDE, ENDE, NUSA TENGGARA TIMUR",2,175,0,175
https://kawalpemilu.org#56705,"NDETUNDORA II, ENDE, ENDE, NUSA TENGGARA TIMUR",3,90,0,90
https://kawalpemilu.org#56705,"NDETUNDORA II, ENDE, ENDE, NUSA TENGGARA TIMUR",4,100,3,103
https://kawalpemilu.org#56706,"TOMBERABU I, ENDE, ENDE, NUSA TENGGARA TIMUR",1,172,3,175
https://kawalpemilu.org#56706,"TOMBERABU I, ENDE, ENDE, NUSA TENGGARA TIMUR",2,152,4,156
https://kawalpemilu.org#56706,"TOMBERABU I, ENDE, ENDE, NUSA TENGGARA TIMUR",3,169,2,171
https://kawalpemilu.org#56707,"TOMBERABU II, ENDE, ENDE, NUSA TENGGARA TIMUR",1,75,1,76
https://kawalpemilu.org#56707,"TOMBERABU II, ENDE, ENDE, NUSA TENGGARA TIMUR",2,134,0,134
https://kawalpemilu.org#56707,"TOMBERABU II, ENDE, ENDE, NUSA TENGGARA TIMUR",3,137,2,139
https://kawalpemilu.org#56708,"NAKURAMBA, ENDE, ENDE, NUSA TENGGARA TIMUR",1,218,1,219
https://kawalpemilu.org#56709,"WOLOKARO, ENDE, ENDE, NUSA TENGGARA TIMUR",1,232,2,234
https://kawalpemilu.org#56710,"JA MOKE ASA, ENDE, ENDE, NUSA TENGGARA TIMUR",1,122,3,125
https://kawalpemilu.org#56711,"EMBURIA, ENDE, ENDE, NUSA TENGGARA TIMUR",1,89,3,92
https://kawalpemilu.org#56711,"EMBURIA, ENDE, ENDE, NUSA TENGGARA TIMUR",2,171,1,172
https://kawalpemilu.org#56712,"RANDOTONDA, ENDE, ENDE, NUSA TENGGARA TIMUR",1,163,2,165
https://kawalpemilu.org#56712,"RANDOTONDA, ENDE, ENDE, NUSA TENGGARA TIMUR",2,200,0,200
https://kawalpemilu.org#56713,"RUKURAMBA, ENDE, ENDE, NUSA TENGGARA TIMUR",1,221,33,254
https://kawalpemilu.org#56713,"RUKURAMBA, ENDE, ENDE, NUSA TENGGARA TIMUR",2,81,51,132
https://kawalpemilu.org#56713,"RUKURAMBA, ENDE, ENDE, NUSA TENGGARA TIMUR",3,81,0,81
https://kawalpemilu.org#56714,"TINABANI, ENDE, ENDE, NUSA TENGGARA TIMUR",2,134,2,136
https://kawalpemilu.org#56715,"NDETUNDORA III, ENDE, ENDE, NUSA TENGGARA TIMUR",1,191,4,195
https://kawalpemilu.org#56715,"NDETUNDORA III, ENDE, ENDE, NUSA TENGGARA TIMUR",2,179,8,187
https://kawalpemilu.org#56715,"NDETUNDORA III, ENDE, ENDE, NUSA TENGGARA TIMUR",3,159,6,165
https://kawalpemilu.org#56716,"UZURAMBA, ENDE, ENDE, NUSA TENGGARA TIMUR",1,220,2,222
https://kawalpemilu.org#56717,"TONGGOPAPA, ENDE, ENDE, NUSA TENGGARA TIMUR",1,210,10,220
https://kawalpemilu.org#56717,"TONGGOPAPA, ENDE, ENDE, NUSA TENGGARA TIMUR",2,108,1,109
https://kawalpemilu.org#91251,"WOLOGAI DUA, ENDE, ENDE, NUSA TENGGARA TIMUR",1,185,0,185
https://kawalpemilu.org#91251,"WOLOGAI DUA, ENDE, ENDE, NUSA TENGGARA TIMUR",2,104,1,105
https://kawalpemilu.org#91252,"WORHOPAPA, ENDE, ENDE, NUSA TENGGARA TIMUR",1,133,3,136
https://kawalpemilu.org#91252,"WORHOPAPA, ENDE, ENDE, NUSA TENGGARA TIMUR",2,151,1,152
https://kawalpemilu.org#91253,"WAWONATO, ENDE, ENDE, NUSA TENGGARA TIMUR",1,162,7,169
https://kawalpemilu.org#91254,"JEJARAJA, ENDE, ENDE, NUSA TENGGARA TIMUR",1,136,9,145
https://kawalpemilu.org#91255,"TENDAMBONGGI, ENDE, ENDE, NUSA TENGGARA TIMUR",1,191,1,192
https://kawalpemilu.org#91256,"RANDORAMA, ENDE, ENDE, NUSA TENGGARA TIMUR",1,279,11,290
https://kawalpemilu.org#91256,"RANDORAMA, ENDE, ENDE, NUSA TENGGARA TIMUR",2,107,5,112
https://kawalpemilu.org#91257,"RANORAMBA, ENDE, ENDE, NUSA TENGGARA TIMUR",1,182,2,184
https://kawalpemilu.org#91258,"PEOZAKARAMBA, ENDE, ENDE, NUSA TENGGARA TIMUR",1,264,6,270
https://kawalpemilu.org#91260,"NUAJA, ENDE, ENDE, NUSA TENGGARA TIMUR",1,111,1,112
https://kawalpemilu.org#91260,"NUAJA, ENDE, ENDE, NUSA TENGGARA TIMUR",2,181,5,186
https://kawalpemilu.org#91261,"WAJAKEA JAYA, ENDE, ENDE, NUSA TENGGARA TIMUR",1,145,61,206
https://kawalpemilu.org#91262,"NEMBORAMBA, ENDE, ENDE, NUSA TENGGARA TIMUR",1,113,0,113
https://kawalpemilu.org#91263,"EMBU NGENA, ENDE, ENDE, NUSA TENGGARA TIMUR",1,196,5,201
https://kawalpemilu.org#91264,"UZURAMBA BARAT, ENDE, ENDE, NUSA TENGGARA TIMUR",1,219,4,223
https://kawalpemilu.org#56719,"MBONGAWANI, ENDE SELATAN, ENDE, NUSA TENGGARA TIMUR",1,22,123,145
https://kawalpemilu.org#56719,"MBONGAWANI, ENDE SELATAN, ENDE, NUSA TENGGARA TIMUR",2,37,126,163
https://kawalpemilu.org#56719,"MBONGAWANI, ENDE SELATAN, ENDE, NUSA TENGGARA TIMUR",3,12,136,148
https://kawalpemilu.org#56719,"MBONGAWANI, ENDE SELATAN, ENDE, NUSA TENGGARA TIMUR",4,132,94,226
https://kawalpemilu.org#56719,"MBONGAWANI, ENDE SELATAN, ENDE, NUSA TENGGARA TIMUR",5,109,87,196
https://kawalpemilu.org#56719,"MBONGAWANI, ENDE SELATAN, ENDE, NUSA TENGGARA TIMUR",6,46,191,237
https://kawalpemilu.org#56719,"MBONGAWANI, ENDE SELATAN, ENDE, NUSA TENGGARA TIMUR",7,34,137,171
https://kawalpemilu.org#56719,"MBONGAWANI, ENDE SELATAN, ENDE, NUSA TENGGARA TIMUR",8,41,105,146
https://kawalpemilu.org#56719,"MBONGAWANI, ENDE SELATAN, ENDE, NUSA TENGGARA TIMUR",9,25,135,160
https://kawalpemilu.org#56719,"MBONGAWANI, ENDE SELATAN, ENDE, NUSA TENGGARA TIMUR",10,115,55,170
https://kawalpemilu.org#56720,"RUKUN LIMA, ENDE SELATAN, ENDE, NUSA TENGGARA TIMUR",1,29,144,173
https://kawalpemilu.org#56720,"RUKUN LIMA, ENDE SELATAN, ENDE, NUSA TENGGARA TIMUR",2,25,111,136
https://kawalpemilu.org#56720,"RUKUN LIMA, ENDE SELATAN, ENDE, NUSA TENGGARA TIMUR",3,39,173,212
https://kawalpemilu.org#56720,"RUKUN LIMA, ENDE SELATAN, ENDE, NUSA TENGGARA TIMUR",4,30,172,202
https://kawalpemilu.org#56720,"RUKUN LIMA, ENDE SELATAN, ENDE, NUSA TENGGARA TIMUR",5,18,136,154
https://kawalpemilu.org#56720,"RUKUN LIMA, ENDE SELATAN, ENDE, NUSA TENGGARA TIMUR",6,20,235,255
https://kawalpemilu.org#56720,"RUKUN LIMA, ENDE SELATAN, ENDE, NUSA TENGGARA TIMUR",7,7,132,139
https://kawalpemilu.org#56720,"RUKUN LIMA, ENDE SELATAN, ENDE, NUSA TENGGARA TIMUR",8,17,137,154
https://kawalpemilu.org#56720,"RUKUN LIMA, ENDE SELATAN, ENDE, NUSA TENGGARA TIMUR",10,24,156,180
https://kawalpemilu.org#56720,"RUKUN LIMA, ENDE SELATAN, ENDE, NUSA TENGGARA TIMUR",11,54,126,180
https://kawalpemilu.org#56720,"RUKUN LIMA, ENDE SELATAN, ENDE, NUSA TENGGARA TIMUR",12,73,175,248
https://kawalpemilu.org#56720,"RUKUN LIMA, ENDE SELATAN, ENDE, NUSA TENGGARA TIMUR",13,130,52,182
https://kawalpemilu.org#56720,"RUKUN LIMA, ENDE SELATAN, ENDE, NUSA TENGGARA TIMUR",14,173,33,206
https://kawalpemilu.org#56720,"RUKUN LIMA, ENDE SELATAN, ENDE, NUSA TENGGARA TIMUR",15,215,21,236
https://kawalpemilu.org#56720,"RUKUN LIMA, ENDE SELATAN, ENDE, NUSA TENGGARA TIMUR",16,30,131,161
https://kawalpemilu.org#56720,"RUKUN LIMA, ENDE SELATAN, ENDE, NUSA TENGGARA TIMUR",17,26,134,160
https://kawalpemilu.org#56720,"RUKUN LIMA, ENDE SELATAN, ENDE, NUSA TENGGARA TIMUR",18,14,118,132
https://kawalpemilu.org#56720,"RUKUN LIMA, ENDE SELATAN, ENDE, NUSA TENGGARA TIMUR",19,15,134,149
https://kawalpemilu.org#56720,"RUKUN LIMA, ENDE SELATAN, ENDE, NUSA TENGGARA TIMUR",20,154,45,199
https://kawalpemilu.org#56720,"RUKUN LIMA, ENDE SELATAN, ENDE, NUSA TENGGARA TIMUR",21,36,131,167
https://kawalpemilu.org#56720,"RUKUN LIMA, ENDE SELATAN, ENDE, NUSA TENGGARA TIMUR",22,50,108,158
https://kawalpemilu.org#56721,"PAUPANDA, ENDE SELATAN, ENDE, NUSA TENGGARA TIMUR",1,16,146,162
https://kawalpemilu.org#56721,"PAUPANDA, ENDE SELATAN, ENDE, NUSA TENGGARA TIMUR",2,12,120,132
https://kawalpemilu.org#56721,"PAUPANDA, ENDE SELATAN, ENDE, NUSA TENGGARA TIMUR",3,18,117,135
https://kawalpemilu.org#56721,"PAUPANDA, ENDE SELATAN, ENDE, NUSA TENGGARA TIMUR",4,19,164,183
https://kawalpemilu.org#56721,"PAUPANDA, ENDE SELATAN, ENDE, NUSA TENGGARA TIMUR",5,36,137,173
https://kawalpemilu.org#56721,"PAUPANDA, ENDE SELATAN, ENDE, NUSA TENGGARA TIMUR",6,8,126,134
https://kawalpemilu.org#56721,"PAUPANDA, ENDE SELATAN, ENDE, NUSA TENGGARA TIMUR",7,10,150,160
https://kawalpemilu.org#56721,"PAUPANDA, ENDE SELATAN, ENDE, NUSA TENGGARA TIMUR",8,31,98,129
https://kawalpemilu.org#56721,"PAUPANDA, ENDE SELATAN, ENDE, NUSA TENGGARA TIMUR",9,12,102,114
https://kawalpemilu.org#56721,"PAUPANDA, ENDE SELATAN, ENDE, NUSA TENGGARA TIMUR",10,25,163,188
https://kawalpemilu.org#56721,"PAUPANDA, ENDE SELATAN, ENDE, NUSA TENGGARA TIMUR",11,47,137,184
https://kawalpemilu.org#56721,"PAUPANDA, ENDE SELATAN, ENDE, NUSA TENGGARA TIMUR",12,21,104,125
https://kawalpemilu.org#56722,"TETANDARA, ENDE SELATAN, ENDE, NUSA TENGGARA TIMUR",1,90,117,207
https://kawalpemilu.org#56722,"TETANDARA, ENDE SELATAN, ENDE, NUSA TENGGARA TIMUR",3,37,106,143
https://kawalpemilu.org#56722,"TETANDARA, ENDE SELATAN, ENDE, NUSA TENGGARA TIMUR",4,73,105,178
https://kawalpemilu.org#56722,"TETANDARA, ENDE SELATAN, ENDE, NUSA TENGGARA TIMUR",5,84,52,136
https://kawalpemilu.org#56722,"TETANDARA, ENDE SELATAN, ENDE, NUSA TENGGARA TIMUR",6,89,99,188
https://kawalpemilu.org#56722,"TETANDARA, ENDE SELATAN, ENDE, NUSA TENGGARA TIMUR",7,84,134,218
https://kawalpemilu.org#56722,"TETANDARA, ENDE SELATAN, ENDE, NUSA TENGGARA TIMUR",8,118,100,218
https://kawalpemilu.org#56722,"TETANDARA, ENDE SELATAN, ENDE, NUSA TENGGARA TIMUR",9,149,29,178
https://kawalpemilu.org#56722,"TETANDARA, ENDE SELATAN, ENDE, NUSA TENGGARA TIMUR",10,174,48,222
https://kawalpemilu.org#56722,"TETANDARA, ENDE SELATAN, ENDE, NUSA TENGGARA TIMUR",11,0,0,0
https://kawalpemilu.org#56722,"TETANDARA, ENDE SELATAN, ENDE, NUSA TENGGARA TIMUR",12,130,4,134
https://kawalpemilu.org#56722,"TETANDARA, ENDE SELATAN, ENDE, NUSA TENGGARA TIMUR",13,158,1,159
https://kawalpemilu.org#56722,"TETANDARA, ENDE SELATAN, ENDE, NUSA TENGGARA TIMUR",14,209,27,236
https://kawalpemilu.org#56722,"TETANDARA, ENDE SELATAN, ENDE, NUSA TENGGARA TIMUR",17,101,70,171
https://kawalpemilu.org#56722,"TETANDARA, ENDE SELATAN, ENDE, NUSA TENGGARA TIMUR",19,54,67,121
https://kawalpemilu.org#56722,"TETANDARA, ENDE SELATAN, ENDE, NUSA TENGGARA TIMUR",20,28,92,120
https://kawalpemilu.org#56722,"TETANDARA, ENDE SELATAN, ENDE, NUSA TENGGARA TIMUR",21,75,106,181
https://kawalpemilu.org#56722,"TETANDARA, ENDE SELATAN, ENDE, NUSA TENGGARA TIMUR",22,96,41,137
https://kawalpemilu.org#56722,"TETANDARA, ENDE SELATAN, ENDE, NUSA TENGGARA TIMUR",23,165,10,175
https://kawalpemilu.org#56722,"TETANDARA, ENDE SELATAN, ENDE, NUSA TENGGARA TIMUR",24,114,2,116
https://kawalpemilu.org#56722,"TETANDARA, ENDE SELATAN, ENDE, NUSA TENGGARA TIMUR",25,159,3,162
https://kawalpemilu.org#56723,"TANJUNG, ENDE SELATAN, ENDE, NUSA TENGGARA TIMUR",1,22,84,106
https://kawalpemilu.org#56723,"TANJUNG, ENDE SELATAN, ENDE, NUSA TENGGARA TIMUR",2,17,136,153
https://kawalpemilu.org#56723,"TANJUNG, ENDE SELATAN, ENDE, NUSA TENGGARA TIMUR",3,29,197,226
https://kawalpemilu.org#56723,"TANJUNG, ENDE SELATAN, ENDE, NUSA TENGGARA TIMUR",4,23,109,132
https://kawalpemilu.org#56723,"TANJUNG, ENDE SELATAN, ENDE, NUSA TENGGARA TIMUR",5,12,171,183
https://kawalpemilu.org#56723,"TANJUNG, ENDE SELATAN, ENDE, NUSA TENGGARA TIMUR",6,9,157,166
https://kawalpemilu.org#56723,"TANJUNG, ENDE SELATAN, ENDE, NUSA TENGGARA TIMUR",7,28,136,164
https://kawalpemilu.org#56723,"TANJUNG, ENDE SELATAN, ENDE, NUSA TENGGARA TIMUR",8,39,169,208
https://kawalpemilu.org#56723,"TANJUNG, ENDE SELATAN, ENDE, NUSA TENGGARA TIMUR",9,31,134,165
https://kawalpemilu.org#56723,"TANJUNG, ENDE SELATAN, ENDE, NUSA TENGGARA TIMUR",10,10,165,175
https://kawalpemilu.org#56723,"TANJUNG, ENDE SELATAN, ENDE, NUSA TENGGARA TIMUR",11,10,130,140
https://kawalpemilu.org#56725,"ONELAKO, NDONA, ENDE, NUSA TENGGARA TIMUR",1,99,22,121
https://kawalpemilu.org#56725,"ONELAKO, NDONA, ENDE, NUSA TENGGARA TIMUR",2,41,113,154
https://kawalpemilu.org#56725,"ONELAKO, NDONA, ENDE, NUSA TENGGARA TIMUR",3,150,43,193
https://kawalpemilu.org#56725,"ONELAKO, NDONA, ENDE, NUSA TENGGARA TIMUR",4,117,6,123
https://kawalpemilu.org#56725,"ONELAKO, NDONA, ENDE, NUSA TENGGARA TIMUR",5,142,21,163
https://kawalpemilu.org#56725,"ONELAKO, NDONA, ENDE, NUSA TENGGARA TIMUR",6,163,0,163
https://kawalpemilu.org#56726,"LOKOBOKO, NDONA, ENDE, NUSA TENGGARA TIMUR",1,105,23,128
https://kawalpemilu.org#56726,"LOKOBOKO, NDONA, ENDE, NUSA TENGGARA TIMUR",3,133,56,189
https://kawalpemilu.org#56726,"LOKOBOKO, NDONA, ENDE, NUSA TENGGARA TIMUR",4,150,42,192
https://kawalpemilu.org#56726,"LOKOBOKO, NDONA, ENDE, NUSA TENGGARA TIMUR",5,59,4,63
https://kawalpemilu.org#56726,"LOKOBOKO, NDONA, ENDE, NUSA TENGGARA TIMUR",7,90,7,97
https://kawalpemilu.org#56727,"WOLOTOPO, NDONA, ENDE, NUSA TENGGARA TIMUR",1,232,26,258
https://kawalpemilu.org#56727,"WOLOTOPO, NDONA, ENDE, NUSA TENGGARA TIMUR",2,144,15,159
https://kawalpemilu.org#56727,"WOLOTOPO, NDONA, ENDE, NUSA TENGGARA TIMUR",3,135,14,149
https://kawalpemilu.org#56728,"WOLOTOPO TIMUR, NDONA, ENDE, NUSA TENGGARA TIMUR",1,228,11,239
https://kawalpemilu.org#56728,"WOLOTOPO TIMUR, NDONA, ENDE, NUSA TENGGARA TIMUR",2,146,7,153
https://kawalpemilu.org#56728,"WOLOTOPO TIMUR, NDONA, ENDE, NUSA TENGGARA TIMUR",3,162,5,167
https://kawalpemilu.org#56729,"PUUTUGA, NDONA, ENDE, NUSA TENGGARA TIMUR",1,211,1,212
https://kawalpemilu.org#56729,"PUUTUGA, NDONA, ENDE, NUSA TENGGARA TIMUR",2,172,4,176
https://kawalpemilu.org#56729,"PUUTUGA, NDONA, ENDE, NUSA TENGGARA TIMUR",3,78,1,79
https://kawalpemilu.org#56730,"NGALUPOLO, NDONA, ENDE, NUSA TENGGARA TIMUR",1,35,20,55
https://kawalpemilu.org#56730,"NGALUPOLO, NDONA, ENDE, NUSA TENGGARA TIMUR",2,136,103,239
https://kawalpemilu.org#56730,"NGALUPOLO, NDONA, ENDE, NUSA TENGGARA TIMUR",3,264,8,272
https://kawalpemilu.org#56731,"NGALUROGA, NDONA, ENDE, NUSA TENGGARA TIMUR",1,97,42,139
https://kawalpemilu.org#56731,"NGALUROGA, NDONA, ENDE, NUSA TENGGARA TIMUR",2,71,0,71
https://kawalpemilu.org#56731,"NGALUROGA, NDONA, ENDE, NUSA TENGGARA TIMUR",3,32,1,33
https://kawalpemilu.org#56732,"NILA, NDONA, ENDE, NUSA TENGGARA TIMUR",1,55,18,73
https://kawalpemilu.org#56732,"NILA, NDONA, ENDE, NUSA TENGGARA TIMUR",2,63,1,64
https://kawalpemilu.org#56732,"NILA, NDONA, ENDE, NUSA TENGGARA TIMUR",3,129,38,167
https://kawalpemilu.org#56732,"NILA, NDONA, ENDE, NUSA TENGGARA TIMUR",4,109,3,112
https://kawalpemilu.org#56733,"KEKASEWA, NDONA, ENDE, NUSA TENGGARA TIMUR",1,199,9,208
https://kawalpemilu.org#56733,"KEKASEWA, NDONA, ENDE, NUSA TENGGARA TIMUR",2,66,23,89
https://kawalpemilu.org#56734,"MANULANDO, NDONA, ENDE, NUSA TENGGARA TIMUR",1,238,18,256
https://kawalpemilu.org#56734,"MANULANDO, NDONA, ENDE, NUSA TENGGARA TIMUR",2,187,9,196
https://kawalpemilu.org#56734,"MANULANDO, NDONA, ENDE, NUSA TENGGARA TIMUR",3,237,6,243
https://kawalpemilu.org#56735,"NANGANESA, NDONA, ENDE, NUSA TENGGARA TIMUR",1,160,26,186
https://kawalpemilu.org#56735,"NANGANESA, NDONA, ENDE, NUSA TENGGARA TIMUR",2,85,78,163
https://kawalpemilu.org#56735,"NANGANESA, NDONA, ENDE, NUSA TENGGARA TIMUR",3,136,17,153
https://kawalpemilu.org#56735,"NANGANESA, NDONA, ENDE, NUSA TENGGARA TIMUR",4,118,23,141
https://kawalpemilu.org#56735,"NANGANESA, NDONA, ENDE, NUSA TENGGARA TIMUR",5,99,46,145
https://kawalpemilu.org#56735,"NANGANESA, NDONA, ENDE, NUSA TENGGARA TIMUR",6,134,14,148
https://kawalpemilu.org#56736,"WOLOKOTA, NDONA, ENDE, NUSA TENGGARA TIMUR",1,177,2,179
https://kawalpemilu.org#56737,"KELIKIKU, NDONA, ENDE, NUSA TENGGARA TIMUR",1,239,2,241
https://kawalpemilu.org#56737,"KELIKIKU, NDONA, ENDE, NUSA TENGGARA TIMUR",2,108,0,108
https://kawalpemilu.org#56738,"REKA, NDONA, ENDE, NUSA TENGGARA TIMUR",1,195,5,200
https://kawalpemilu.org#56738,"REKA, NDONA, ENDE, NUSA TENGGARA TIMUR",2,173,1,174
https://kawalpemilu.org#56740,"DETUSOKO, DETUSOKO, ENDE, NUSA TENGGARA TIMUR",1,161,2,163
https://kawalpemilu.org#56740,"DETUSOKO, DETUSOKO, ENDE, NUSA TENGGARA TIMUR",2,156,6,162
https://kawalpemilu.org#56740,"DETUSOKO, DETUSOKO, ENDE, NUSA TENGGARA TIMUR",3,117,9,126
https://kawalpemilu.org#56740,"DETUSOKO, DETUSOKO, ENDE, NUSA TENGGARA TIMUR",4,118,7,125
https://kawalpemilu.org#56741,"DETUSOKO BARAT, DETUSOKO, ENDE, NUSA TENGGARA TIMUR",1,250,5,255
https://kawalpemilu.org#56741,"DETUSOKO BARAT, DETUSOKO, ENDE, NUSA TENGGARA TIMUR",2,228,7,235
https://kawalpemilu.org#56742,"WOLOTOLO, DETUSOKO, ENDE, NUSA TENGGARA TIMUR",1,228,4,232
https://kawalpemilu.org#56742,"WOLOTOLO, DETUSOKO, ENDE, NUSA TENGGARA TIMUR",2,160,3,163
https://kawalpemilu.org#56742,"WOLOTOLO, DETUSOKO, ENDE, NUSA TENGGARA TIMUR",3,134,2,136
https://kawalpemilu.org#56743,"WOLOTOLO TENGAH, DETUSOKO, ENDE, NUSA TENGGARA TIMUR",1,193,2,195
https://kawalpemilu.org#56743,"WOLOTOLO TENGAH, DETUSOKO, ENDE, NUSA TENGGARA TIMUR",2,162,2,164
https://kawalpemilu.org#56744,"ROA, DETUSOKO, ENDE, NUSA TENGGARA TIMUR",1,132,2,134
https://kawalpemilu.org#56744,"ROA, DETUSOKO, ENDE, NUSA TENGGARA TIMUR",2,151,3,154
https://kawalpemilu.org#56745,"SAGA, DETUSOKO, ENDE, NUSA TENGGARA TIMUR",1,161,2,163
https://kawalpemilu.org#56745,"SAGA, DETUSOKO, ENDE, NUSA TENGGARA TIMUR",2,159,1,160
https://kawalpemilu.org#56745,"SAGA, DETUSOKO, ENDE, NUSA TENGGARA TIMUR",3,125,1,126
https://kawalpemilu.org#56746,"NIOWULA, DETUSOKO, ENDE, NUSA TENGGARA TIMUR",1,249,12,261
https://kawalpemilu.org#56747,"WOLOFEO, DETUSOKO, ENDE, NUSA TENGGARA TIMUR",1,184,10,194
https://kawalpemilu.org#56747,"WOLOFEO, DETUSOKO, ENDE, NUSA TENGGARA TIMUR",2,127,2,129
https://kawalpemilu.org#56748,"NUAONE, DETUSOKO, ENDE, NUSA TENGGARA TIMUR",1,235,2,237
https://kawalpemilu.org#56749,"WOLOGAI, DETUSOKO, ENDE, NUSA TENGGARA TIMUR",1,143,2,145
https://kawalpemilu.org#56749,"WOLOGAI, DETUSOKO, ENDE, NUSA TENGGARA TIMUR",2,177,3,180
https://kawalpemilu.org#56749,"WOLOGAI, DETUSOKO, ENDE, NUSA TENGGARA TIMUR",3,137,8,145
https://kawalpemilu.org#56750,"WOLOGAI TENGAH, DETUSOKO, ENDE, NUSA TENGGARA TIMUR",1,188,5,193
https://kawalpemilu.org#56750,"WOLOGAI TENGAH, DETUSOKO, ENDE, NUSA TENGGARA TIMUR",2,201,1,202
https://kawalpemilu.org#56750,"WOLOGAI TENGAH, DETUSOKO, ENDE, NUSA TENGGARA TIMUR",3,82,3,85
https://kawalpemilu.org#56752,"WOLOMAGE, DETUSOKO, ENDE, NUSA TENGGARA TIMUR",1,173,3,176
https://kawalpemilu.org#56752,"WOLOMAGE, DETUSOKO, ENDE, NUSA TENGGARA TIMUR",2,155,5,160
https://kawalpemilu.org#56754,"RANDORIA, DETUSOKO, ENDE, NUSA TENGGARA TIMUR",1,146,7,153
https://kawalpemilu.org#56754,"RANDORIA, DETUSOKO, ENDE, NUSA TENGGARA TIMUR",2,121,1,122
https://kawalpemilu.org#56755,"WOLOMASI, DETUSOKO, ENDE, NUSA TENGGARA TIMUR",1,197,8,205
https://kawalpemilu.org#56755,"WOLOMASI, DETUSOKO, ENDE, NUSA TENGGARA TIMUR",2,141,1,142
https://kawalpemilu.org#56756,"RATERORU, DETUSOKO, ENDE, NUSA TENGGARA TIMUR",1,158,1,159
https://kawalpemilu.org#56756,"RATERORU, DETUSOKO, ENDE, NUSA TENGGARA TIMUR",2,130,1,131
https://kawalpemilu.org#56757,"DILE, DETUSOKO, ENDE, NUSA TENGGARA TIMUR",1,172,4,176
https://kawalpemilu.org#56757,"DILE, DETUSOKO, ENDE, NUSA TENGGARA TIMUR",2,139,2,141
https://kawalpemilu.org#56758,"NDITO, DETUSOKO, ENDE, NUSA TENGGARA TIMUR",1,195,4,199
https://kawalpemilu.org#56758,"NDITO, DETUSOKO, ENDE, NUSA TENGGARA TIMUR",2,218,4,222
https://kawalpemilu.org#56759,"SIPIJENA, DETUSOKO, ENDE, NUSA TENGGARA TIMUR",1,133,2,135
https://kawalpemilu.org#56759,"SIPIJENA, DETUSOKO, ENDE, NUSA TENGGARA TIMUR",2,168,2,170
https://kawalpemilu.org#56760,"GOLULADA, DETUSOKO, ENDE, NUSA TENGGARA TIMUR",1,225,13,238
https://kawalpemilu.org#56760,"GOLULADA, DETUSOKO, ENDE, NUSA TENGGARA TIMUR",2,122,4,126
https://kawalpemilu.org#56761,"RANGA, DETUSOKO, ENDE, NUSA TENGGARA TIMUR",2,118,6,124
https://kawalpemilu.org#56761,"RANGA, DETUSOKO, ENDE, NUSA TENGGARA TIMUR",3,188,4,192
https://kawalpemilu.org#56763,"TURUNALU, DETUSOKO, ENDE, NUSA TENGGARA TIMUR",1,253,8,261
https://kawalpemilu.org#56765,"WELAMOSA, WEWARIA, ENDE, NUSA TENGGARA TIMUR",1,145,14,159
https://kawalpemilu.org#56765,"WELAMOSA, WEWARIA, ENDE, NUSA TENGGARA TIMUR",2,163,4,167
https://kawalpemilu.org#56765,"WELAMOSA, WEWARIA, ENDE, NUSA TENGGARA TIMUR",3,182,7,189
https://kawalpemilu.org#56765,"WELAMOSA, WEWARIA, ENDE, NUSA TENGGARA TIMUR",4,93,9,102
https://kawalpemilu.org#56766,"NUANGENDA, WEWARIA, ENDE, NUSA TENGGARA TIMUR",1,88,0,88
https://kawalpemilu.org#56766,"NUANGENDA, WEWARIA, ENDE, NUSA TENGGARA TIMUR",2,208,6,214
https://kawalpemilu.org#56767,"MAUTENDA, WEWARIA, ENDE, NUSA TENGGARA TIMUR",1,171,4,175
https://kawalpemilu.org#56767,"MAUTENDA, WEWARIA, ENDE, NUSA TENGGARA TIMUR",2,143,4,147
https://kawalpemilu.org#56767,"MAUTENDA, WEWARIA, ENDE, NUSA TENGGARA TIMUR",3,233,1,234
https://kawalpemilu.org#56767,"MAUTENDA, WEWARIA, ENDE, NUSA TENGGARA TIMUR",4,156,4,160
https://kawalpemilu.org#56767,"MAUTENDA, WEWARIA, ENDE, NUSA TENGGARA TIMUR",5,156,5,161
https://kawalpemilu.org#56767,"MAUTENDA, WEWARIA, ENDE, NUSA TENGGARA TIMUR",6,187,10,197
https://kawalpemilu.org#56767,"MAUTENDA, WEWARIA, ENDE, NUSA TENGGARA TIMUR",7,138,7,145
https://kawalpemilu.org#56767,"MAUTENDA, WEWARIA, ENDE, NUSA TENGGARA TIMUR",8,185,0,185
https://kawalpemilu.org#56767,"MAUTENDA, WEWARIA, ENDE, NUSA TENGGARA TIMUR",9,111,0,111
https://kawalpemilu.org#56767,"MAUTENDA, WEWARIA, ENDE, NUSA TENGGARA TIMUR",10,52,0,52
https://kawalpemilu.org#56767,"MAUTENDA, WEWARIA, ENDE, NUSA TENGGARA TIMUR",11,148,2,150
https://kawalpemilu.org#56768,"MAUTENDA BARAT, WEWARIA, ENDE, NUSA TENGGARA TIMUR",1,192,14,206
https://kawalpemilu.org#56768,"MAUTENDA BARAT, WEWARIA, ENDE, NUSA TENGGARA TIMUR",2,155,4,159
https://kawalpemilu.org#56769,"WEWARIA, WEWARIA, ENDE, NUSA TENGGARA TIMUR",2,193,2,195
https://kawalpemilu.org#56769,"WEWARIA, WEWARIA, ENDE, NUSA TENGGARA TIMUR",3,200,13,213
https://kawalpemilu.org#56769,"WEWARIA, WEWARIA, ENDE, NUSA TENGGARA TIMUR",4,159,3,162
https://kawalpemilu.org#56770,"TANALI, WEWARIA, ENDE, NUSA TENGGARA TIMUR",1,165,7,172
https://kawalpemilu.org#56770,"TANALI, WEWARIA, ENDE, NUSA TENGGARA TIMUR",2,193,2,195
https://kawalpemilu.org#56771,"DETUBELA, WEWARIA, ENDE, NUSA TENGGARA TIMUR",1,128,1,129
https://kawalpemilu.org#56771,"DETUBELA, WEWARIA, ENDE, NUSA TENGGARA TIMUR",2,163,1,164
https://kawalpemilu.org#56772,"FATAATU, WEWARIA, ENDE, NUSA TENGGARA TIMUR",1,107,10,117
https://kawalpemilu.org#56772,"FATAATU, WEWARIA, ENDE, NUSA TENGGARA TIMUR",2,174,10,184
https://kawalpemilu.org#56772,"FATAATU, WEWARIA, ENDE, NUSA TENGGARA TIMUR",4,120,8,128
https://kawalpemilu.org#56772,"FATAATU, WEWARIA, ENDE, NUSA TENGGARA TIMUR",5,116,13,129
https://kawalpemilu.org#56773,"FATAATU TIMUR, WEWARIA, ENDE, NUSA TENGGARA TIMUR",1,139,90,229
https://kawalpemilu.org#56773,"FATAATU TIMUR, WEWARIA, ENDE, NUSA TENGGARA TIMUR",2,197,18,215
https://kawalpemilu.org#56773,"FATAATU TIMUR, WEWARIA, ENDE, NUSA TENGGARA TIMUR",3,77,1,78
https://kawalpemilu.org#56773,"FATAATU TIMUR, WEWARIA, ENDE, NUSA TENGGARA TIMUR",4,129,8,137
https://kawalpemilu.org#56774,"MUKUSAKI, WEWARIA, ENDE, NUSA TENGGARA TIMUR",1,155,6,161
https://kawalpemilu.org#56774,"MUKUSAKI, WEWARIA, ENDE, NUSA TENGGARA TIMUR",2,89,145,234
https://kawalpemilu.org#56774,"MUKUSAKI, WEWARIA, ENDE, NUSA TENGGARA TIMUR",4,124,5,129
https://kawalpemilu.org#56775,"EKOAE, WEWARIA, ENDE, NUSA TENGGARA TIMUR",1,169,16,185
https://kawalpemilu.org#56775,"EKOAE, WEWARIA, ENDE, NUSA TENGGARA TIMUR",2,124,6,130
https://kawalpemilu.org#56775,"EKOAE, WEWARIA, ENDE, NUSA TENGGARA TIMUR",3,195,3,198
https://kawalpemilu.org#56775,"EKOAE, WEWARIA, ENDE, NUSA TENGGARA TIMUR",4,142,4,146
https://kawalpemilu.org#56776,"AEMURI, WEWARIA, ENDE, NUSA TENGGARA TIMUR",1,166,7,173
https://kawalpemilu.org#56777,"RATEWATI, WEWARIA, ENDE, NUSA TENGGARA TIMUR",1,201,8,209
https://kawalpemilu.org#56778,"MBOTULAKA, WEWARIA, ENDE, NUSA TENGGARA TIMUR",1,170,8,178
https://kawalpemilu.org#56779,"NUMBA, WEWARIA, ENDE, NUSA TENGGARA TIMUR",1,221,3,224
https://kawalpemilu.org#56780,"KALITEMBU, WEWARIA, ENDE, NUSA TENGGARA TIMUR",1,187,4,191
https://kawalpemilu.org#56780,"KALITEMBU, WEWARIA, ENDE, NUSA TENGGARA TIMUR",2,177,10,187
https://kawalpemilu.org#56781,"AELIPO, WEWARIA, ENDE, NUSA TENGGARA TIMUR",1,112,1,113
https://kawalpemilu.org#91247,"WAKA, WEWARIA, ENDE, NUSA TENGGARA TIMUR",1,194,7,201
https://kawalpemilu.org#91248,"WOLOOJA, WEWARIA, ENDE, NUSA TENGGARA TIMUR",1,176,7,183
https://kawalpemilu.org#91249,"EKOLEA, WEWARIA, ENDE, NUSA TENGGARA TIMUR",1,108,9,117
https://kawalpemilu.org#91249,"EKOLEA, WEWARIA, ENDE, NUSA TENGGARA TIMUR",2,122,9,131
https://kawalpemilu.org#91250,"AE NDOKO, WEWARIA, ENDE, NUSA TENGGARA TIMUR",1,193,12,205
https://kawalpemilu.org#92189,"RATEWATI SELATAN, WEWARIA, ENDE, NUSA TENGGARA TIMUR",1,188,0,188
https://kawalpemilu.org#56783,"BOKASAPE, WOLOWARU, ENDE, NUSA TENGGARA TIMUR",1,99,31,130
https://kawalpemilu.org#56783,"BOKASAPE, WOLOWARU, ENDE, NUSA TENGGARA TIMUR",2,70,64,134
https://kawalpemilu.org#56783,"BOKASAPE, WOLOWARU, ENDE, NUSA TENGGARA TIMUR",3,57,203,260
https://kawalpemilu.org#56783,"BOKASAPE, WOLOWARU, ENDE, NUSA TENGGARA TIMUR",4,16,138,154
https://kawalpemilu.org#56783,"BOKASAPE, WOLOWARU, ENDE, NUSA TENGGARA TIMUR",5,119,51,170
https://kawalpemilu.org#56783,"BOKASAPE, WOLOWARU, ENDE, NUSA TENGGARA TIMUR",6,60,72,132
https://kawalpemilu.org#56783,"BOKASAPE, WOLOWARU, ENDE, NUSA TENGGARA TIMUR",7,27,91,118
https://kawalpemilu.org#56784,"BOKASAPE TIMUR, WOLOWARU, ENDE, NUSA TENGGARA TIMUR",1,95,57,152
https://kawalpemilu.org#56784,"BOKASAPE TIMUR, WOLOWARU, ENDE, NUSA TENGGARA TIMUR",2,117,15,132
https://kawalpemilu.org#56785,"MBULILOO, WOLOWARU, ENDE, NUSA TENGGARA TIMUR",1,54,82,136
https://kawalpemilu.org#56785,"MBULILOO, WOLOWARU, ENDE, NUSA TENGGARA TIMUR",2,80,54,134
https://kawalpemilu.org#56785,"MBULILOO, WOLOWARU, ENDE, NUSA TENGGARA TIMUR",3,47,108,155
https://kawalpemilu.org#56785,"MBULILOO, WOLOWARU, ENDE, NUSA TENGGARA TIMUR",4,163,8,171
https://kawalpemilu.org#56786,"RINDIWAWO, WOLOWARU, ENDE, NUSA TENGGARA TIMUR",1,80,73,153
https://kawalpemilu.org#56786,"RINDIWAWO, WOLOWARU, ENDE, NUSA TENGGARA TIMUR",2,72,95,167
https://kawalpemilu.org#56786,"RINDIWAWO, WOLOWARU, ENDE, NUSA TENGGARA TIMUR",3,76,96,172
https://kawalpemilu.org#56787,"JOPU, WOLOWARU, ENDE, NUSA TENGGARA TIMUR",1,175,10,185
https://kawalpemilu.org#56787,"JOPU, WOLOWARU, ENDE, NUSA TENGGARA TIMUR",2,198,8,206
https://kawalpemilu.org#56787,"JOPU, WOLOWARU, ENDE, NUSA TENGGARA TIMUR",3,166,7,173
https://kawalpemilu.org#56787,"JOPU, WOLOWARU, ENDE, NUSA TENGGARA TIMUR",4,157,5,162
https://kawalpemilu.org#56787,"JOPU, WOLOWARU, ENDE, NUSA TENGGARA TIMUR",5,163,11,174
https://kawalpemilu.org#56788,"WOLOKOLI, WOLOWARU, ENDE, NUSA TENGGARA TIMUR",1,209,10,219
https://kawalpemilu.org#56788,"WOLOKOLI, WOLOWARU, ENDE, NUSA TENGGARA TIMUR",2,257,9,266
https://kawalpemilu.org#56788,"WOLOKOLI, WOLOWARU, ENDE, NUSA TENGGARA TIMUR",3,130,1,131
https://kawalpemilu.org#56788,"WOLOKOLI, WOLOWARU, ENDE, NUSA TENGGARA TIMUR",4,214,29,243
https://kawalpemilu.org#56789,"MBULIWARALAU, WOLOWARU, ENDE, NUSA TENGGARA TIMUR",1,29,157,186
https://kawalpemilu.org#56789,"MBULIWARALAU, WOLOWARU, ENDE, NUSA TENGGARA TIMUR",2,94,80,174
https://kawalpemilu.org#56789,"MBULIWARALAU, WOLOWARU, ENDE, NUSA TENGGARA TIMUR",3,19,103,122
https://kawalpemilu.org#56789,"MBULIWARALAU, WOLOWARU, ENDE, NUSA TENGGARA TIMUR",4,14,100,114
https://kawalpemilu.org#56789,"MBULIWARALAU, WOLOWARU, ENDE, NUSA TENGGARA TIMUR",5,43,143,186
https://kawalpemilu.org#56790,"MBULIWARALAU UTARA, WOLOWARU, ENDE, NUSA TENGGARA TIMUR",1,104,108,212
https://kawalpemilu.org#56790,"MBULIWARALAU UTARA, WOLOWARU, ENDE, NUSA TENGGARA TIMUR",2,190,80,270
https://kawalpemilu.org#56790,"MBULIWARALAU UTARA, WOLOWARU, ENDE, NUSA TENGGARA TIMUR",3,40,59,99
https://kawalpemilu.org#56790,"MBULIWARALAU UTARA, WOLOWARU, ENDE, NUSA TENGGARA TIMUR",4,111,4,115
https://kawalpemilu.org#56791,"LISEDETU, WOLOWARU, ENDE, NUSA TENGGARA TIMUR",1,191,5,196
https://kawalpemilu.org#56791,"LISEDETU, WOLOWARU, ENDE, NUSA TENGGARA TIMUR",2,233,8,241
https://kawalpemilu.org#56791,"LISEDETU, WOLOWARU, ENDE, NUSA TENGGARA TIMUR",3,162,4,166
https://kawalpemilu.org#56792,"NUALISE, WOLOWARU, ENDE, NUSA TENGGARA TIMUR",1,213,4,217
https://kawalpemilu.org#56792,"NUALISE, WOLOWARU, ENDE, NUSA TENGGARA TIMUR",2,84,4,88
https://kawalpemilu.org#56793,"WOLOSOKO, WOLOWARU, ENDE, NUSA TENGGARA TIMUR",1,126,4,130
https://kawalpemilu.org#56793,"WOLOSOKO, WOLOWARU, ENDE, NUSA TENGGARA TIMUR",2,134,4,138
https://kawalpemilu.org#56794,"LISELOWOBORA, WOLOWARU, ENDE, NUSA TENGGARA TIMUR",1,225,9,234
https://kawalpemilu.org#56794,"LISELOWOBORA, WOLOWARU, ENDE, NUSA TENGGARA TIMUR",2,93,2,95
https://kawalpemilu.org#56795,"LIKANAKA, WOLOWARU, ENDE, NUSA TENGGARA TIMUR",1,89,0,89
https://kawalpemilu.org#56795,"LIKANAKA, WOLOWARU, ENDE, NUSA TENGGARA TIMUR",2,96,0,96
https://kawalpemilu.org#56795,"LIKANAKA, WOLOWARU, ENDE, NUSA TENGGARA TIMUR",3,150,9,159
https://kawalpemilu.org#56796,"NAKAMBARA, WOLOWARU, ENDE, NUSA TENGGARA TIMUR",1,53,95,148
https://kawalpemilu.org#56796,"NAKAMBARA, WOLOWARU, ENDE, NUSA TENGGARA TIMUR",2,26,213,239
https://kawalpemilu.org#56796,"NAKAMBARA, WOLOWARU, ENDE, NUSA TENGGARA TIMUR",3,39,114,153
https://kawalpemilu.org#56796,"NAKAMBARA, WOLOWARU, ENDE, NUSA TENGGARA TIMUR",4,52,104,156
https://kawalpemilu.org#56797,"NIRAMESI, WOLOWARU, ENDE, NUSA TENGGARA TIMUR",1,145,10,155
https://kawalpemilu.org#56797,"NIRAMESI, WOLOWARU, ENDE, NUSA TENGGARA TIMUR",2,156,3,159
https://kawalpemilu.org#56797,"NIRAMESI, WOLOWARU, ENDE, NUSA TENGGARA TIMUR",3,81,12,93
https://kawalpemilu.org#927491,"LISE PU'U, WOLOWARU, ENDE, NUSA TENGGARA TIMUR",1,103,6,109
https://kawalpemilu.org#927491,"LISE PU'U, WOLOWARU, ENDE, NUSA TENGGARA TIMUR",2,101,4,105
https://kawalpemilu.org#927492,"TANA LO'O, WOLOWARU, ENDE, NUSA TENGGARA TIMUR",1,131,14,145
https://kawalpemilu.org#927492,"TANA LO'O, WOLOWARU, ENDE, NUSA TENGGARA TIMUR",2,49,67,116
https://kawalpemilu.org#56799,"WOLOJITA, WOLOJITA, ENDE, NUSA TENGGARA TIMUR",1,194,6,200
https://kawalpemilu.org#56799,"WOLOJITA, WOLOJITA, ENDE, NUSA TENGGARA TIMUR",2,246,4,250
https://kawalpemilu.org#56799,"WOLOJITA, WOLOJITA, ENDE, NUSA TENGGARA TIMUR",3,121,0,121
https://kawalpemilu.org#56799,"WOLOJITA, WOLOJITA, ENDE, NUSA TENGGARA TIMUR",4,106,51,157
https://kawalpemilu.org#56799,"WOLOJITA, WOLOJITA, ENDE, NUSA TENGGARA TIMUR",5,140,1,141
https://kawalpemilu.org#56800,"TENDA, WOLOJITA, ENDE, NUSA TENGGARA TIMUR",1,237,8,245
https://kawalpemilu.org#56800,"TENDA, WOLOJITA, ENDE, NUSA TENGGARA TIMUR",2,125,5,130
https://kawalpemilu.org#56800,"TENDA, WOLOJITA, ENDE, NUSA TENGGARA TIMUR",3,152,1,153
https://kawalpemilu.org#56801,"WIWIPEMO, WOLOJITA, ENDE, NUSA TENGGARA TIMUR",1,215,9,224
https://kawalpemilu.org#56801,"WIWIPEMO, WOLOJITA, ENDE, NUSA TENGGARA TIMUR",2,139,1,140
https://kawalpemilu.org#56801,"WIWIPEMO, WOLOJITA, ENDE, NUSA TENGGARA TIMUR",3,147,4,151
https://kawalpemilu.org#56802,"PORA, WOLOJITA, ENDE, NUSA TENGGARA TIMUR",1,143,8,151
https://kawalpemilu.org#56802,"PORA, WOLOJITA, ENDE, NUSA TENGGARA TIMUR",2,187,15,202
https://kawalpemilu.org#56802,"PORA, WOLOJITA, ENDE, NUSA TENGGARA TIMUR",3,194,22,216
https://kawalpemilu.org#56803,"NUAMULU, WOLOJITA, ENDE, NUSA TENGGARA TIMUR",1,162,5,167
https://kawalpemilu.org#56803,"NUAMULU, WOLOJITA, ENDE, NUSA TENGGARA TIMUR",2,185,57,242
https://kawalpemilu.org#56803,"NUAMULU, WOLOJITA, ENDE, NUSA TENGGARA TIMUR",3,47,53,100
https://kawalpemilu.org#56804,"NGGELA, WOLOJITA, ENDE, NUSA TENGGARA TIMUR",1,107,21,128
https://kawalpemilu.org#56804,"NGGELA, WOLOJITA, ENDE, NUSA TENGGARA TIMUR",2,143,4,147
https://kawalpemilu.org#56804,"NGGELA, WOLOJITA, ENDE, NUSA TENGGARA TIMUR",3,155,2,157
https://kawalpemilu.org#56804,"NGGELA, WOLOJITA, ENDE, NUSA TENGGARA TIMUR",4,161,3,164
https://kawalpemilu.org#56806,"MAUROLE, MAUROLE, ENDE, NUSA TENGGARA TIMUR",1,82,137,219
https://kawalpemilu.org#56806,"MAUROLE, MAUROLE, ENDE, NUSA TENGGARA TIMUR",2,147,18,165
https://kawalpemilu.org#56806,"MAUROLE, MAUROLE, ENDE, NUSA TENGGARA TIMUR",3,144,41,185
https://kawalpemilu.org#56806,"MAUROLE, MAUROLE, ENDE, NUSA TENGGARA TIMUR",4,223,16,239
https://kawalpemilu.org#56806,"MAUROLE, MAUROLE, ENDE, NUSA TENGGARA TIMUR",5,238,14,252
https://kawalpemilu.org#56806,"MAUROLE, MAUROLE, ENDE, NUSA TENGGARA TIMUR",6,37,51,88
https://kawalpemilu.org#56807,"AEWORA, MAUROLE, ENDE, NUSA TENGGARA TIMUR",1,230,12,242
https://kawalpemilu.org#56807,"AEWORA, MAUROLE, ENDE, NUSA TENGGARA TIMUR",2,99,11,110
https://kawalpemilu.org#56807,"AEWORA, MAUROLE, ENDE, NUSA TENGGARA TIMUR",3,77,3,80
https://kawalpemilu.org#56807,"AEWORA, MAUROLE, ENDE, NUSA TENGGARA TIMUR",4,193,25,218
https://kawalpemilu.org#56807,"AEWORA, MAUROLE, ENDE, NUSA TENGGARA TIMUR",5,142,43,185
https://kawalpemilu.org#56808,"MAUSAMBI, MAUROLE, ENDE, NUSA TENGGARA TIMUR",1,173,8,181
https://kawalpemilu.org#56808,"MAUSAMBI, MAUROLE, ENDE, NUSA TENGGARA TIMUR",2,118,68,186
https://kawalpemilu.org#56808,"MAUSAMBI, MAUROLE, ENDE, NUSA TENGGARA TIMUR",3,149,11,160
https://kawalpemilu.org#56808,"MAUSAMBI, MAUROLE, ENDE, NUSA TENGGARA TIMUR",4,159,13,172
https://kawalpemilu.org#56809,"RANAKOLO, MAUROLE, ENDE, NUSA TENGGARA TIMUR",1,272,10,282
https://kawalpemilu.org#56810,"WATUKAMBA, MAUROLE, ENDE, NUSA TENGGARA TIMUR",1,202,25,227
https://kawalpemilu.org#56810,"WATUKAMBA, MAUROLE, ENDE, NUSA TENGGARA TIMUR",2,162,5,167
https://kawalpemilu.org#56810,"WATUKAMBA, MAUROLE, ENDE, NUSA TENGGARA TIMUR",3,121,51,172
https://kawalpemilu.org#56811,"RANAKOLO SELATAN, MAUROLE, ENDE, NUSA TENGGARA TIMUR",1,158,2,160
https://kawalpemilu.org#56811,"RANAKOLO SELATAN, MAUROLE, ENDE, NUSA TENGGARA TIMUR",2,112,3,115
https://kawalpemilu.org#56812,"KELIWUMBU, MAUROLE, ENDE, NUSA TENGGARA TIMUR",1,176,9,185
https://kawalpemilu.org#56812,"KELIWUMBU, MAUROLE, ENDE, NUSA TENGGARA TIMUR",2,242,13,255
https://kawalpemilu.org#56813,"DETUWULU, MAUROLE, ENDE, NUSA TENGGARA TIMUR",1,227,2,229
https://kawalpemilu.org#56813,"DETUWULU, MAUROLE, ENDE, NUSA TENGGARA TIMUR",2,105,2,107
https://kawalpemilu.org#56814,"OTOGEDU, MAUROLE, ENDE, NUSA TENGGARA TIMUR",1,182,11,193
https://kawalpemilu.org#91242,"WOLOAU, MAUROLE, ENDE, NUSA TENGGARA TIMUR",1,165,8,173
https://kawalpemilu.org#91242,"WOLOAU, MAUROLE, ENDE, NUSA TENGGARA TIMUR",2,110,5,115
https://kawalpemilu.org#91242,"WOLOAU, MAUROLE, ENDE, NUSA TENGGARA TIMUR",3,127,7,134
https://kawalpemilu.org#91243,"NGALUKOJA, MAUROLE, ENDE, NUSA TENGGARA TIMUR",1,203,38,241
https://kawalpemilu.org#91244,"NIRANUSA, MAUROLE, ENDE, NUSA TENGGARA TIMUR",1,243,5,248
https://kawalpemilu.org#91245,"ULUDALA, MAUROLE, ENDE, NUSA TENGGARA TIMUR",1,226,10,236
https://kawalpemilu.org#56816,"KEBIRANGGA, MAUKARO, ENDE, NUSA TENGGARA TIMUR",1,214,2,216
https://kawalpemilu.org#56816,"KEBIRANGGA, MAUKARO, ENDE, NUSA TENGGARA TIMUR",2,67,163,230
https://kawalpemilu.org#56816,"KEBIRANGGA, MAUKARO, ENDE, NUSA TENGGARA TIMUR",3,117,10,127
https://kawalpemilu.org#56816,"KEBIRANGGA, MAUKARO, ENDE, NUSA TENGGARA TIMUR",4,121,10,131
https://kawalpemilu.org#56816,"KEBIRANGGA, MAUKARO, ENDE, NUSA TENGGARA TIMUR",5,166,3,169
https://kawalpemilu.org#56818,"KAMUBHEKA, MAUKARO, ENDE, NUSA TENGGARA TIMUR",1,222,13,235
https://kawalpemilu.org#56818,"KAMUBHEKA, MAUKARO, ENDE, NUSA TENGGARA TIMUR",2,208,32,240
https://kawalpemilu.org#56819,"MAGEKAPA, MAUKARO, ENDE, NUSA TENGGARA TIMUR",1,238,2,240
https://kawalpemilu.org#56819,"MAGEKAPA, MAUKARO, ENDE, NUSA TENGGARA TIMUR",2,75,1,76
https://kawalpemilu.org#56820,"BOAFEO, MAUKARO, ENDE, NUSA TENGGARA TIMUR",1,229,18,247
https://kawalpemilu.org#56820,"BOAFEO, MAUKARO, ENDE, NUSA TENGGARA TIMUR",2,81,3,84
https://kawalpemilu.org#56821,"NABE, MAUKARO, ENDE, NUSA TENGGARA TIMUR",1,195,9,204
https://kawalpemilu.org#56821,"NABE, MAUKARO, ENDE, NUSA TENGGARA TIMUR",2,150,7,157
https://kawalpemilu.org#56822,"KOBALEBA, MAUKARO, ENDE, NUSA TENGGARA TIMUR",1,94,5,99
https://kawalpemilu.org#56822,"KOBALEBA, MAUKARO, ENDE, NUSA TENGGARA TIMUR",2,193,4,197
https://kawalpemilu.org#56823,"MUNDINGGASA, MAUKARO, ENDE, NUSA TENGGARA TIMUR",1,131,3,134
https://kawalpemilu.org#56823,"MUNDINGGASA, MAUKARO, ENDE, NUSA TENGGARA TIMUR",2,150,5,155
https://kawalpemilu.org#56824,"KOLIKAPA, MAUKARO, ENDE, NUSA TENGGARA TIMUR",1,248,11,259
https://kawalpemilu.org#56825,"KEBIRANGGA TENGAH, MAUKARO, ENDE, NUSA TENGGARA TIMUR",1,146,12,158
https://kawalpemilu.org#56825,"KEBIRANGGA TENGAH, MAUKARO, ENDE, NUSA TENGGARA TIMUR",2,110,12,122
https://kawalpemilu.org#56825,"KEBIRANGGA TENGAH, MAUKARO, ENDE, NUSA TENGGARA TIMUR",3,189,6,195
https://kawalpemilu.org#56827,"WATUNESO, LIO TIMUR, ENDE, NUSA TENGGARA TIMUR",1,155,8,163
https://kawalpemilu.org#56827,"WATUNESO, LIO TIMUR, ENDE, NUSA TENGGARA TIMUR",2,195,5,200
https://kawalpemilu.org#56827,"WATUNESO, LIO TIMUR, ENDE, NUSA TENGGARA TIMUR",3,183,5,188
https://kawalpemilu.org#56827,"WATUNESO, LIO TIMUR, ENDE, NUSA TENGGARA TIMUR",4,142,10,152
https://kawalpemilu.org#56827,"WATUNESO, LIO TIMUR, ENDE, NUSA TENGGARA TIMUR",6,82,3,85
https://kawalpemilu.org#56828,"HOBATUA, LIO TIMUR, ENDE, NUSA TENGGARA TIMUR",1,90,125,215
https://kawalpemilu.org#56828,"HOBATUA, LIO TIMUR, ENDE, NUSA TENGGARA TIMUR",2,100,95,195
https://kawalpemilu.org#56829,"WOLOSAMBI, LIO TIMUR, ENDE, NUSA TENGGARA TIMUR",1,95,4,99
https://kawalpemilu.org#56829,"WOLOSAMBI, LIO TIMUR, ENDE, NUSA TENGGARA TIMUR",2,145,0,145
https://kawalpemilu.org#56830,"WOLOARA, LIO TIMUR, ENDE, NUSA TENGGARA TIMUR",1,181,3,184
https://kawalpemilu.org#56830,"WOLOARA, LIO TIMUR, ENDE, NUSA TENGGARA TIMUR",2,183,7,190
https://kawalpemilu.org#56831,"DETUPERA, LIO TIMUR, ENDE, NUSA TENGGARA TIMUR",1,171,7,178
https://kawalpemilu.org#56832,"WOLOLELA A, LIO TIMUR, ENDE, NUSA TENGGARA TIMUR",1,253,5,258
https://kawalpemilu.org#56833,"LIABEKE, LIO TIMUR, ENDE, NUSA TENGGARA TIMUR",1,162,4,166
https://kawalpemilu.org#56833,"LIABEKE, LIO TIMUR, ENDE, NUSA TENGGARA TIMUR",2,116,6,122
https://kawalpemilu.org#56833,"LIABEKE, LIO TIMUR, ENDE, NUSA TENGGARA TIMUR",3,104,1,105
https://kawalpemilu.org#56834,"FATAMARI, LIO TIMUR, ENDE, NUSA TENGGARA TIMUR",1,196,16,212
https://kawalpemilu.org#56834,"FATAMARI, LIO TIMUR, ENDE, NUSA TENGGARA TIMUR",2,120,1,121
https://kawalpemilu.org#91236,"RANGGATALO, LIO TIMUR, ENDE, NUSA TENGGARA TIMUR",1,145,3,148
https://kawalpemilu.org#91237,"NUA LIMA, LIO TIMUR, ENDE, NUSA TENGGARA TIMUR",1,114,3,117
https://kawalpemilu.org#91238,"TANAROGA, LIO TIMUR, ENDE, NUSA TENGGARA TIMUR",1,161,6,167
https://kawalpemilu.org#91239,"BU TANALAGU, LIO TIMUR, ENDE, NUSA TENGGARA TIMUR",1,171,2,173
https://kawalpemilu.org#91240,"MBEWAWORA, LIO TIMUR, ENDE, NUSA TENGGARA TIMUR",1,120,2,122
https://kawalpemilu.org#56836,"KOTABARU, KOTA BARU, ENDE, NUSA TENGGARA TIMUR",1,182,29,211
https://kawalpemilu.org#56836,"KOTABARU, KOTA BARU, ENDE, NUSA TENGGARA TIMUR",2,137,34,171
https://kawalpemilu.org#56836,"KOTABARU, KOTA BARU, ENDE, NUSA TENGGARA TIMUR",3,117,2,119
https://kawalpemilu.org#56836,"KOTABARU, KOTA BARU, ENDE, NUSA TENGGARA TIMUR",4,59,5,64
https://kawalpemilu.org#56836,"KOTABARU, KOTA BARU, ENDE, NUSA TENGGARA TIMUR",5,111,24,135
https://kawalpemilu.org#56837,"TOU, KOTA BARU, ENDE, NUSA TENGGARA TIMUR",1,201,3,204
https://kawalpemilu.org#56837,"TOU, KOTA BARU, ENDE, NUSA TENGGARA TIMUR",2,168,3,171
https://kawalpemilu.org#56837,"TOU, KOTA BARU, ENDE, NUSA TENGGARA TIMUR",3,202,10,212
https://kawalpemilu.org#56838,"TOU TIMUR, KOTA BARU, ENDE, NUSA TENGGARA TIMUR",1,266,13,279
https://kawalpemilu.org#56838,"TOU TIMUR, KOTA BARU, ENDE, NUSA TENGGARA TIMUR",2,245,1,246
https://kawalpemilu.org#56838,"TOU TIMUR, KOTA BARU, ENDE, NUSA TENGGARA TIMUR",3,98,1,99
https://kawalpemilu.org#56839,"LOBONIKI, KOTA BARU, ENDE, NUSA TENGGARA TIMUR",1,230,11,241
https://kawalpemilu.org#56839,"LOBONIKI, KOTA BARU, ENDE, NUSA TENGGARA TIMUR",2,213,10,223
https://kawalpemilu.org#56839,"LOBONIKI, KOTA BARU, ENDE, NUSA TENGGARA TIMUR",3,187,16,203
https://kawalpemilu.org#56840,"NDONDO, KOTA BARU, ENDE, NUSA TENGGARA TIMUR",1,192,6,198
https://kawalpemilu.org#56840,"NDONDO, KOTA BARU, ENDE, NUSA TENGGARA TIMUR",2,207,14,221
https://kawalpemilu.org#56841,"NIOPANDA, KOTA BARU, ENDE, NUSA TENGGARA TIMUR",2,102,4,106
https://kawalpemilu.org#56841,"NIOPANDA, KOTA BARU, ENDE, NUSA TENGGARA TIMUR",3,112,12,124
https://kawalpemilu.org#56842,"HANGALANDE, KOTA BARU, ENDE, NUSA TENGGARA TIMUR",1,218,3,221
https://kawalpemilu.org#56842,"HANGALANDE, KOTA BARU, ENDE, NUSA TENGGARA TIMUR",2,95,1,96
https://kawalpemilu.org#56842,"HANGALANDE, KOTA BARU, ENDE, NUSA TENGGARA TIMUR",3,117,1,118
https://kawalpemilu.org#56843,"PISE, KOTA BARU, ENDE, NUSA TENGGARA TIMUR",1,239,5,244
https://kawalpemilu.org#56845,"NEOTONDA, KOTA BARU, ENDE, NUSA TENGGARA TIMUR",1,95,1,96
https://kawalpemilu.org#56845,"NEOTONDA, KOTA BARU, ENDE, NUSA TENGGARA TIMUR",2,155,4,159
https://kawalpemilu.org#56847,"TOU BARAT, KOTA BARU, ENDE, NUSA TENGGARA TIMUR",1,194,5,199
https://kawalpemilu.org#56847,"TOU BARAT, KOTA BARU, ENDE, NUSA TENGGARA TIMUR",2,85,0,85
https://kawalpemilu.org#56847,"TOU BARAT, KOTA BARU, ENDE, NUSA TENGGARA TIMUR",3,72,1,73
https://kawalpemilu.org#85156,"LISELANDE, KOTA BARU, ENDE, NUSA TENGGARA TIMUR",1,154,3,157
https://kawalpemilu.org#85156,"LISELANDE, KOTA BARU, ENDE, NUSA TENGGARA TIMUR",2,122,1,123
https://kawalpemilu.org#85157,"RANGALAKA, KOTA BARU, ENDE, NUSA TENGGARA TIMUR",1,201,7,208
https://kawalpemilu.org#85157,"RANGALAKA, KOTA BARU, ENDE, NUSA TENGGARA TIMUR",2,155,27,182
https://kawalpemilu.org#92204,"NUANAGA, KOTA BARU, ENDE, NUSA TENGGARA TIMUR",1,141,7,148
https://kawalpemilu.org#56850,"NDUARIA, KELIMUTU, ENDE, NUSA TENGGARA TIMUR",1,190,1,191
https://kawalpemilu.org#56850,"NDUARIA, KELIMUTU, ENDE, NUSA TENGGARA TIMUR",2,138,1,139
https://kawalpemilu.org#56850,"NDUARIA, KELIMUTU, ENDE, NUSA TENGGARA TIMUR",3,225,6,231
https://kawalpemilu.org#56850,"NDUARIA, KELIMUTU, ENDE, NUSA TENGGARA TIMUR",4,146,9,155
https://kawalpemilu.org#56850,"NDUARIA, KELIMUTU, ENDE, NUSA TENGGARA TIMUR",5,125,2,127
https://kawalpemilu.org#56851,"NUAMURI, KELIMUTU, ENDE, NUSA TENGGARA TIMUR",1,204,9,213
https://kawalpemilu.org#56851,"NUAMURI, KELIMUTU, ENDE, NUSA TENGGARA TIMUR",2,201,6,207
https://kawalpemilu.org#56851,"NUAMURI, KELIMUTU, ENDE, NUSA TENGGARA TIMUR",3,105,1,106
https://kawalpemilu.org#56852,"NUAMURI BARAT, KELIMUTU, ENDE, NUSA TENGGARA TIMUR",1,276,8,284
https://kawalpemilu.org#56853,"KOANARA, KELIMUTU, ENDE, NUSA TENGGARA TIMUR",1,246,6,252
https://kawalpemilu.org#56853,"KOANARA, KELIMUTU, ENDE, NUSA TENGGARA TIMUR",2,220,15,235
https://kawalpemilu.org#56854,"WOLOARA, KELIMUTU, ENDE, NUSA TENGGARA TIMUR",1,132,4,136
https://kawalpemilu.org#56854,"WOLOARA, KELIMUTU, ENDE, NUSA TENGGARA TIMUR",2,159,3,162
https://kawalpemilu.org#56854,"WOLOARA, KELIMUTU, ENDE, NUSA TENGGARA TIMUR",3,138,4,142
https://kawalpemilu.org#56854,"WOLOARA, KELIMUTU, ENDE, NUSA TENGGARA TIMUR",4,153,9,162
https://kawalpemilu.org#56855,"PEMO, KELIMUTU, ENDE, NUSA TENGGARA TIMUR",1,132,20,152
https://kawalpemilu.org#56855,"PEMO, KELIMUTU, ENDE, NUSA TENGGARA TIMUR",2,110,21,131
https://kawalpemilu.org#91232,"DETUENA, KELIMUTU, ENDE, NUSA TENGGARA TIMUR",1,157,9,166
https://kawalpemilu.org#91232,"DETUENA, KELIMUTU, ENDE, NUSA TENGGARA TIMUR",2,100,2,102
https://kawalpemilu.org#91234,"WATURAKA, KELIMUTU, ENDE, NUSA TENGGARA TIMUR",1,130,4,134
https://kawalpemilu.org#91234,"WATURAKA, KELIMUTU, ENDE, NUSA TENGGARA TIMUR",2,170,8,178
https://kawalpemilu.org#92205,"WOLOKELO, KELIMUTU, ENDE, NUSA TENGGARA TIMUR",1,192,4,196
https://kawalpemilu.org#56858,"NGGESA, DETUKELI, ENDE, NUSA TENGGARA TIMUR",1,213,17,230
https://kawalpemilu.org#56858,"NGGESA, DETUKELI, ENDE, NUSA TENGGARA TIMUR",2,88,1,89
https://kawalpemilu.org#56859,"DETUKELI, DETUKELI, ENDE, NUSA TENGGARA TIMUR",1,80,1,81
https://kawalpemilu.org#56860,"KEBESANI, DETUKELI, ENDE, NUSA TENGGARA TIMUR",1,138,3,141
https://kawalpemilu.org#56860,"KEBESANI, DETUKELI, ENDE, NUSA TENGGARA TIMUR",2,99,5,104
https://kawalpemilu.org#56861,"WOLOMUKU, DETUKELI, ENDE, NUSA TENGGARA TIMUR",1,226,19,245
https://kawalpemilu.org#56861,"WOLOMUKU, DETUKELI, ENDE, NUSA TENGGARA TIMUR",2,213,2,215
https://kawalpemilu.org#56862,"WATUNGGERE, DETUKELI, ENDE, NUSA TENGGARA TIMUR",1,139,8,147
https://kawalpemilu.org#56862,"WATUNGGERE, DETUKELI, ENDE, NUSA TENGGARA TIMUR",2,179,10,189
https://kawalpemilu.org#56863,"NIDA, DETUKELI, ENDE, NUSA TENGGARA TIMUR",1,230,6,236
https://kawalpemilu.org#56864,"MAUROLE SELATAN, DETUKELI, ENDE, NUSA TENGGARA TIMUR",1,167,6,173
https://kawalpemilu.org#56864,"MAUROLE SELATAN, DETUKELI, ENDE, NUSA TENGGARA TIMUR",2,107,4,111
https://kawalpemilu.org#56865,"DETUMBEWA, DETUKELI, ENDE, NUSA TENGGARA TIMUR",1,208,10,218
https://kawalpemilu.org#56866,"KANGANARA, DETUKELI, ENDE, NUSA TENGGARA TIMUR",2,104,1,105
https://kawalpemilu.org#56868,"UNGGU, DETUKELI, ENDE, NUSA TENGGARA TIMUR",1,107,1,108
https://kawalpemilu.org#56868,"UNGGU, DETUKELI, ENDE, NUSA TENGGARA TIMUR",2,162,4,166
https://kawalpemilu.org#56869,"NGGESABIRI, DETUKELI, ENDE, NUSA TENGGARA TIMUR",1,201,13,214
https://kawalpemilu.org#56870,"WATUNGGERE MARILONGA, DETUKELI, ENDE, NUSA TENGGARA TIMUR",1,178,8,186
https://kawalpemilu.org#91231,"JEO DU'A, DETUKELI, ENDE, NUSA TENGGARA TIMUR",1,225,4,229
https://kawalpemilu.org#56872,"KURULIMBU, NDONA TIMUR, ENDE, NUSA TENGGARA TIMUR",1,228,5,233
https://kawalpemilu.org#56872,"KURULIMBU, NDONA TIMUR, ENDE, NUSA TENGGARA TIMUR",2,157,2,159
https://kawalpemilu.org#56872,"KURULIMBU, NDONA TIMUR, ENDE, NUSA TENGGARA TIMUR",3,114,0,114
https://kawalpemilu.org#56873,"SOKORIA, NDONA TIMUR, ENDE, NUSA TENGGARA TIMUR",1,226,5,231
https://kawalpemilu.org#56873,"SOKORIA, NDONA TIMUR, ENDE, NUSA TENGGARA TIMUR",2,189,3,192
https://kawalpemilu.org#56873,"SOKORIA, NDONA TIMUR, ENDE, NUSA TENGGARA TIMUR",3,128,5,133
https://kawalpemilu.org#56874,"DEMULAKA, NDONA TIMUR, ENDE, NUSA TENGGARA TIMUR",1,168,2,170
https://kawalpemilu.org#56874,"DEMULAKA, NDONA TIMUR, ENDE, NUSA TENGGARA TIMUR",2,135,3,138
https://kawalpemilu.org#56875,"ROGA, NDONA TIMUR, ENDE, NUSA TENGGARA TIMUR",1,225,6,231
https://kawalpemilu.org#56875,"ROGA, NDONA TIMUR, ENDE, NUSA TENGGARA TIMUR",2,281,2,283
https://kawalpemilu.org#56875,"ROGA, NDONA TIMUR, ENDE, NUSA TENGGARA TIMUR",3,198,4,202
https://kawalpemilu.org#56875,"ROGA, NDONA TIMUR, ENDE, NUSA TENGGARA TIMUR",4,36,2,38
https://kawalpemilu.org#56876,"KURULIMBU SELATAN, NDONA TIMUR, ENDE, NUSA TENGGARA TIMUR",1,98,22,120
https://kawalpemilu.org#56876,"KURULIMBU SELATAN, NDONA TIMUR, ENDE, NUSA TENGGARA TIMUR",2,75,38,113
https://kawalpemilu.org#56877,"NGGUWA, NDONA TIMUR, ENDE, NUSA TENGGARA TIMUR",1,85,6,91
https://kawalpemilu.org#56877,"NGGUWA, NDONA TIMUR, ENDE, NUSA TENGGARA TIMUR",2,193,17,210
https://kawalpemilu.org#91230,"SOKORIA SELATAN, NDONA TIMUR, ENDE, NUSA TENGGARA TIMUR",1,174,2,176
https://kawalpemilu.org#56879,"MAUBASA, NDORI, ENDE, NUSA TENGGARA TIMUR",1,92,109,201
https://kawalpemilu.org#56879,"MAUBASA, NDORI, ENDE, NUSA TENGGARA TIMUR",2,73,129,202
https://kawalpemilu.org#56880,"MAUBASA TIMUR, NDORI, ENDE, NUSA TENGGARA TIMUR",1,54,132,186
https://kawalpemilu.org#56880,"MAUBASA TIMUR, NDORI, ENDE, NUSA TENGGARA TIMUR",2,16,158,174
https://kawalpemilu.org#56881,"WONDA, NDORI, ENDE, NUSA TENGGARA TIMUR",1,115,8,123
https://kawalpemilu.org#56881,"WONDA, NDORI, ENDE, NUSA TENGGARA TIMUR",2,67,6,73
https://kawalpemilu.org#56881,"WONDA, NDORI, ENDE, NUSA TENGGARA TIMUR",3,57,0,57
https://kawalpemilu.org#56882,"SERANDORI, NDORI, ENDE, NUSA TENGGARA TIMUR",1,144,30,174
https://kawalpemilu.org#56882,"SERANDORI, NDORI, ENDE, NUSA TENGGARA TIMUR",2,65,97,162
https://kawalpemilu.org#56882,"SERANDORI, NDORI, ENDE, NUSA TENGGARA TIMUR",3,77,28,105
https://kawalpemilu.org#56883,"KELISAMBA, NDORI, ENDE, NUSA TENGGARA TIMUR",1,130,12,142
https://kawalpemilu.org#56883,"KELISAMBA, NDORI, ENDE, NUSA TENGGARA TIMUR",2,116,12,128
https://kawalpemilu.org#91225,"MOLE, NDORI, ENDE, NUSA TENGGARA TIMUR",1,67,127,194
https://kawalpemilu.org#91226,"LUNGGARIA, NDORI, ENDE, NUSA TENGGARA TIMUR",1,46,128,174
https://kawalpemilu.org#91227,"AEBARA, NDORI, ENDE, NUSA TENGGARA TIMUR",1,107,6,113
https://kawalpemilu.org#91227,"AEBARA, NDORI, ENDE, NUSA TENGGARA TIMUR",2,146,5,151
https://kawalpemilu.org#91228,"RATEMANGGA, NDORI, ENDE, NUSA TENGGARA TIMUR",1,149,38,187
https://kawalpemilu.org#91229,"MAUBASA BARAT, NDORI, ENDE, NUSA TENGGARA TIMUR",1,35,128,163
https://kawalpemilu.org#91229,"MAUBASA BARAT, NDORI, ENDE, NUSA TENGGARA TIMUR",2,66,136,202
https://kawalpemilu.org#56885,"KOTA RAJA, ENDE UTARA, ENDE, NUSA TENGGARA TIMUR",1,29,211,240
https://kawalpemilu.org#56885,"KOTA RAJA, ENDE UTARA, ENDE, NUSA TENGGARA TIMUR",2,25,58,83
https://kawalpemilu.org#56885,"KOTA RAJA, ENDE UTARA, ENDE, NUSA TENGGARA TIMUR",3,69,193,262
https://kawalpemilu.org#56885,"KOTA RAJA, ENDE UTARA, ENDE, NUSA TENGGARA TIMUR",4,45,115,160
https://kawalpemilu.org#56885,"KOTA RAJA, ENDE UTARA, ENDE, NUSA TENGGARA TIMUR",5,38,190,228
https://kawalpemilu.org#56885,"KOTA RAJA, ENDE UTARA, ENDE, NUSA TENGGARA TIMUR",6,222,28,250
https://kawalpemilu.org#56885,"KOTA RAJA, ENDE UTARA, ENDE, NUSA TENGGARA TIMUR",7,222,33,255
https://kawalpemilu.org#56885,"KOTA RAJA, ENDE UTARA, ENDE, NUSA TENGGARA TIMUR",8,79,45,124
https://kawalpemilu.org#56885,"KOTA RAJA, ENDE UTARA, ENDE, NUSA TENGGARA TIMUR",9,37,122,159
https://kawalpemilu.org#56886,"KOTA RATU, ENDE UTARA, ENDE, NUSA TENGGARA TIMUR",1,149,36,185
https://kawalpemilu.org#56886,"KOTA RATU, ENDE UTARA, ENDE, NUSA TENGGARA TIMUR",2,101,130,231
https://kawalpemilu.org#56886,"KOTA RATU, ENDE UTARA, ENDE, NUSA TENGGARA TIMUR",4,93,127,220
https://kawalpemilu.org#56886,"KOTA RATU, ENDE UTARA, ENDE, NUSA TENGGARA TIMUR",5,32,149,181
https://kawalpemilu.org#56886,"KOTA RATU, ENDE UTARA, ENDE, NUSA TENGGARA TIMUR",6,21,161,182
https://kawalpemilu.org#56886,"KOTA RATU, ENDE UTARA, ENDE, NUSA TENGGARA TIMUR",7,27,147,174
https://kawalpemilu.org#56886,"KOTA RATU, ENDE UTARA, ENDE, NUSA TENGGARA TIMUR",8,47,215,262
https://kawalpemilu.org#56886,"KOTA RATU, ENDE UTARA, ENDE, NUSA TENGGARA TIMUR",9,32,186,218
https://kawalpemilu.org#56886,"KOTA RATU, ENDE UTARA, ENDE, NUSA TENGGARA TIMUR",10,40,104,144
https://kawalpemilu.org#56886,"KOTA RATU, ENDE UTARA, ENDE, NUSA TENGGARA TIMUR",12,89,4,93
https://kawalpemilu.org#56886,"KOTA RATU, ENDE UTARA, ENDE, NUSA TENGGARA TIMUR",13,54,171,225
https://kawalpemilu.org#56886,"KOTA RATU, ENDE UTARA, ENDE, NUSA TENGGARA TIMUR",14,44,169,213
https://kawalpemilu.org#56886,"KOTA RATU, ENDE UTARA, ENDE, NUSA TENGGARA TIMUR",15,55,78,133
https://kawalpemilu.org#56886,"KOTA RATU, ENDE UTARA, ENDE, NUSA TENGGARA TIMUR",16,56,101,157
https://kawalpemilu.org#56887,"ROWORENA, ENDE UTARA, ENDE, NUSA TENGGARA TIMUR",1,150,15,165
https://kawalpemilu.org#56887,"ROWORENA, ENDE UTARA, ENDE, NUSA TENGGARA TIMUR",2,256,3,259
https://kawalpemilu.org#56887,"ROWORENA, ENDE UTARA, ENDE, NUSA TENGGARA TIMUR",3,122,1,123
https://kawalpemilu.org#56887,"ROWORENA, ENDE UTARA, ENDE, NUSA TENGGARA TIMUR",4,195,12,207
https://kawalpemilu.org#56887,"ROWORENA, ENDE UTARA, ENDE, NUSA TENGGARA TIMUR",5,200,5,205
https://kawalpemilu.org#56887,"ROWORENA, ENDE UTARA, ENDE, NUSA TENGGARA TIMUR",6,49,0,49
https://kawalpemilu.org#56887,"ROWORENA, ENDE UTARA, ENDE, NUSA TENGGARA TIMUR",7,92,64,156
https://kawalpemilu.org#56887,"ROWORENA, ENDE UTARA, ENDE, NUSA TENGGARA TIMUR",8,158,11,169
https://kawalpemilu.org#56887,"ROWORENA, ENDE UTARA, ENDE, NUSA TENGGARA TIMUR",9,80,3,83
https://kawalpemilu.org#56887,"ROWORENA, ENDE UTARA, ENDE, NUSA TENGGARA TIMUR",10,164,6,170
https://kawalpemilu.org#56888,"ROWORENA BARAT, ENDE UTARA, ENDE, NUSA TENGGARA TIMUR",1,68,79,147
https://kawalpemilu.org#56888,"ROWORENA BARAT, ENDE UTARA, ENDE, NUSA TENGGARA TIMUR",2,209,37,246
https://kawalpemilu.org#56888,"ROWORENA BARAT, ENDE UTARA, ENDE, NUSA TENGGARA TIMUR",3,116,33,149
https://kawalpemilu.org#56888,"ROWORENA BARAT, ENDE UTARA, ENDE, NUSA TENGGARA TIMUR",4,139,5,144
https://kawalpemilu.org#56888,"ROWORENA BARAT, ENDE UTARA, ENDE, NUSA TENGGARA TIMUR",5,82,78,160
https://kawalpemilu.org#56889,"GHEOGHOMA, ENDE UTARA, ENDE, NUSA TENGGARA TIMUR",1,175,16,191
https://kawalpemilu.org#56889,"GHEOGHOMA, ENDE UTARA, ENDE, NUSA TENGGARA TIMUR",2,176,17,193
https://kawalpemilu.org#56889,"GHEOGHOMA, ENDE UTARA, ENDE, NUSA TENGGARA TIMUR",3,154,17,171
https://kawalpemilu.org#56890,"BOROKANDA, ENDE UTARA, ENDE, NUSA TENGGARA TIMUR",1,30,182,212
https://kawalpemilu.org#56890,"BOROKANDA, ENDE UTARA, ENDE, NUSA TENGGARA TIMUR",2,42,183,225
https://kawalpemilu.org#56890,"BOROKANDA, ENDE UTARA, ENDE, NUSA TENGGARA TIMUR",3,27,136,163
https://kawalpemilu.org#56890,"BOROKANDA, ENDE UTARA, ENDE, NUSA TENGGARA TIMUR",4,137,50,187
https://kawalpemilu.org#56891,"WATUSIPI, ENDE UTARA, ENDE, NUSA TENGGARA TIMUR",1,165,4,169
https://kawalpemilu.org#56891,"WATUSIPI, ENDE UTARA, ENDE, NUSA TENGGARA TIMUR",2,162,1,163
https://kawalpemilu.org#91222,"MBOMBA, ENDE UTARA, ENDE, NUSA TENGGARA TIMUR",1,160,9,169
https://kawalpemilu.org#91222,"MBOMBA, ENDE UTARA, ENDE, NUSA TENGGARA TIMUR",2,140,0,140
https://kawalpemilu.org#91223,"EMBUNDOA, ENDE UTARA, ENDE, NUSA TENGGARA TIMUR",1,228,49,277
https://kawalpemilu.org#91224,"RATERUA, ENDE UTARA, ENDE, NUSA TENGGARA TIMUR",1,30,128,158
https://kawalpemilu.org#91224,"RATERUA, ENDE UTARA, ENDE, NUSA TENGGARA TIMUR",2,98,54,152
https://kawalpemilu.org#56893,"POTULANDO, ENDE TENGAH, ENDE, NUSA TENGGARA TIMUR",2,127,9,136
https://kawalpemilu.org#56893,"POTULANDO, ENDE TENGAH, ENDE, NUSA TENGGARA TIMUR",3,234,22,256
https://kawalpemilu.org#56893,"POTULANDO, ENDE TENGAH, ENDE, NUSA TENGGARA TIMUR",4,185,57,242
https://kawalpemilu.org#56893,"POTULANDO, ENDE TENGAH, ENDE, NUSA TENGGARA TIMUR",5,110,13,123
https://kawalpemilu.org#56893,"POTULANDO, ENDE TENGAH, ENDE, NUSA TENGGARA TIMUR",6,222,10,232
https://kawalpemilu.org#56893,"POTULANDO, ENDE TENGAH, ENDE, NUSA TENGGARA TIMUR",7,136,7,143
https://kawalpemilu.org#56893,"POTULANDO, ENDE TENGAH, ENDE, NUSA TENGGARA TIMUR",8,43,59,102
https://kawalpemilu.org#56893,"POTULANDO, ENDE TENGAH, ENDE, NUSA TENGGARA TIMUR",9,64,121,185
https://kawalpemilu.org#56893,"POTULANDO, ENDE TENGAH, ENDE, NUSA TENGGARA TIMUR",10,106,27,133
https://kawalpemilu.org#56894,"ONEKORE, ENDE TENGAH, ENDE, NUSA TENGGARA TIMUR",1,115,36,151
https://kawalpemilu.org#56894,"ONEKORE, ENDE TENGAH, ENDE, NUSA TENGGARA TIMUR",2,203,6,209
https://kawalpemilu.org#56894,"ONEKORE, ENDE TENGAH, ENDE, NUSA TENGGARA TIMUR",3,219,30,249
https://kawalpemilu.org#56894,"ONEKORE, ENDE TENGAH, ENDE, NUSA TENGGARA TIMUR",4,147,50,197
https://kawalpemilu.org#56894,"ONEKORE, ENDE TENGAH, ENDE, NUSA TENGGARA TIMUR",5,190,14,204
https://kawalpemilu.org#56894,"ONEKORE, ENDE TENGAH, ENDE, NUSA TENGGARA TIMUR",6,178,68,246
https://kawalpemilu.org#56894,"ONEKORE, ENDE TENGAH, ENDE, NUSA TENGGARA TIMUR",8,192,45,237
https://kawalpemilu.org#56894,"ONEKORE, ENDE TENGAH, ENDE, NUSA TENGGARA TIMUR",9,173,7,180
https://kawalpemilu.org#56894,"ONEKORE, ENDE TENGAH, ENDE, NUSA TENGGARA TIMUR",10,138,16,154
https://kawalpemilu.org#56894,"ONEKORE, ENDE TENGAH, ENDE, NUSA TENGGARA TIMUR",12,108,136,244
https://kawalpemilu.org#56894,"ONEKORE, ENDE TENGAH, ENDE, NUSA TENGGARA TIMUR",13,143,18,161
https://kawalpemilu.org#56894,"ONEKORE, ENDE TENGAH, ENDE, NUSA TENGGARA TIMUR",14,187,32,219
https://kawalpemilu.org#56894,"ONEKORE, ENDE TENGAH, ENDE, NUSA TENGGARA TIMUR",15,94,51,145
https://kawalpemilu.org#56894,"ONEKORE, ENDE TENGAH, ENDE, NUSA TENGGARA TIMUR",16,135,9,144
https://kawalpemilu.org#56894,"ONEKORE, ENDE TENGAH, ENDE, NUSA TENGGARA TIMUR",17,147,10,157
https://kawalpemilu.org#56894,"ONEKORE, ENDE TENGAH, ENDE, NUSA TENGGARA TIMUR",20,158,11,169
https://kawalpemilu.org#56895,"KELIMUTU, ENDE TENGAH, ENDE, NUSA TENGGARA TIMUR",1,162,36,198
https://kawalpemilu.org#56895,"KELIMUTU, ENDE TENGAH, ENDE, NUSA TENGGARA TIMUR",2,78,54,132
https://kawalpemilu.org#56895,"KELIMUTU, ENDE TENGAH, ENDE, NUSA TENGGARA TIMUR",3,168,63,231
https://kawalpemilu.org#56895,"KELIMUTU, ENDE TENGAH, ENDE, NUSA TENGGARA TIMUR",4,0,0,0
https://kawalpemilu.org#56895,"KELIMUTU, ENDE TENGAH, ENDE, NUSA TENGGARA TIMUR",5,206,19,225
https://kawalpemilu.org#56895,"KELIMUTU, ENDE TENGAH, ENDE, NUSA TENGGARA TIMUR",6,90,13,103
https://kawalpemilu.org#56895,"KELIMUTU, ENDE TENGAH, ENDE, NUSA TENGGARA TIMUR",7,206,5,211
https://kawalpemilu.org#56895,"KELIMUTU, ENDE TENGAH, ENDE, NUSA TENGGARA TIMUR",8,120,10,130
https://kawalpemilu.org#56895,"KELIMUTU, ENDE TENGAH, ENDE, NUSA TENGGARA TIMUR",9,67,85,152
https://kawalpemilu.org#56895,"KELIMUTU, ENDE TENGAH, ENDE, NUSA TENGGARA TIMUR",10,125,50,175
https://kawalpemilu.org#56895,"KELIMUTU, ENDE TENGAH, ENDE, NUSA TENGGARA TIMUR",11,113,129,242
https://kawalpemilu.org#56895,"KELIMUTU, ENDE TENGAH, ENDE, NUSA TENGGARA TIMUR",12,229,12,241
https://kawalpemilu.org#56895,"KELIMUTU, ENDE TENGAH, ENDE, NUSA TENGGARA TIMUR",13,155,15,170
https://kawalpemilu.org#56895,"KELIMUTU, ENDE TENGAH, ENDE, NUSA TENGGARA TIMUR",14,176,28,201
https://kawalpemilu.org#56895,"KELIMUTU, ENDE TENGAH, ENDE, NUSA TENGGARA TIMUR",16,136,10,146
https://kawalpemilu.org#56895,"KELIMUTU, ENDE TENGAH, ENDE, NUSA TENGGARA TIMUR",17,36,118,154
https://kawalpemilu.org#56895,"KELIMUTU, ENDE TENGAH, ENDE, NUSA TENGGARA TIMUR",18,125,6,131
https://kawalpemilu.org#56896,"PAUPIRE, ENDE TENGAH, ENDE, NUSA TENGGARA TIMUR",3,197,26,223
https://kawalpemilu.org#56896,"PAUPIRE, ENDE TENGAH, ENDE, NUSA TENGGARA TIMUR",4,110,38,148
https://kawalpemilu.org#56896,"PAUPIRE, ENDE TENGAH, ENDE, NUSA TENGGARA TIMUR",5,149,7,156
https://kawalpemilu.org#56896,"PAUPIRE, ENDE TENGAH, ENDE, NUSA TENGGARA TIMUR",7,177,9,186
https://kawalpemilu.org#56896,"PAUPIRE, ENDE TENGAH, ENDE, NUSA TENGGARA TIMUR",8,241,27,268
https://kawalpemilu.org#56896,"PAUPIRE, ENDE TENGAH, ENDE, NUSA TENGGARA TIMUR",9,164,15,179
https://kawalpemilu.org#56896,"PAUPIRE, ENDE TENGAH, ENDE, NUSA TENGGARA TIMUR",11,159,29,188
https://kawalpemilu.org#56896,"PAUPIRE, ENDE TENGAH, ENDE, NUSA TENGGARA TIMUR",12,161,39,200
https://kawalpemilu.org#56896,"PAUPIRE, ENDE TENGAH, ENDE, NUSA TENGGARA TIMUR",13,135,8,143
https://kawalpemilu.org#56896,"PAUPIRE, ENDE TENGAH, ENDE, NUSA TENGGARA TIMUR",15,236,8,244
https://kawalpemilu.org#56896,"PAUPIRE, ENDE TENGAH, ENDE, NUSA TENGGARA TIMUR",16,123,17,140
https://kawalpemilu.org#56896,"PAUPIRE, ENDE TENGAH, ENDE, NUSA TENGGARA TIMUR",18,113,30,143
https://kawalpemilu.org#56896,"PAUPIRE, ENDE TENGAH, ENDE, NUSA TENGGARA TIMUR",20,147,37,184
https://kawalpemilu.org#56896,"PAUPIRE, ENDE TENGAH, ENDE, NUSA TENGGARA TIMUR",21,123,14,137
https://kawalpemilu.org#56896,"PAUPIRE, ENDE TENGAH, ENDE, NUSA TENGGARA TIMUR",22,90,44,134
https://kawalpemilu.org#56896,"PAUPIRE, ENDE TENGAH, ENDE, NUSA TENGGARA TIMUR",23,170,58,228
https://kawalpemilu.org#56898,"MAUTAPAGA, ENDE TIMUR, ENDE, NUSA TENGGARA TIMUR",1,99,80,179
https://kawalpemilu.org#56898,"MAUTAPAGA, ENDE TIMUR, ENDE, NUSA TENGGARA TIMUR",3,87,12,99
https://kawalpemilu.org#56898,"MAUTAPAGA, ENDE TIMUR, ENDE, NUSA TENGGARA TIMUR",4,77,24,101
https://kawalpemilu.org#56898,"MAUTAPAGA, ENDE TIMUR, ENDE, NUSA TENGGARA TIMUR",5,107,77,184
https://kawalpemilu.org#56898,"MAUTAPAGA, ENDE TIMUR, ENDE, NUSA TENGGARA TIMUR",6,174,29,203
https://kawalpemilu.org#56898,"MAUTAPAGA, ENDE TIMUR, ENDE, NUSA TENGGARA TIMUR",7,144,17,161
https://kawalpemilu.org#56898,"MAUTAPAGA, ENDE TIMUR, ENDE, NUSA TENGGARA TIMUR",8,104,13,117
https://kawalpemilu.org#56898,"MAUTAPAGA, ENDE TIMUR, ENDE, NUSA TENGGARA TIMUR",9,122,37,159
https://kawalpemilu.org#56898,"MAUTAPAGA, ENDE TIMUR, ENDE, NUSA TENGGARA TIMUR",10,122,48,170
https://kawalpemilu.org#56898,"MAUTAPAGA, ENDE TIMUR, ENDE, NUSA TENGGARA TIMUR",11,104,89,193
https://kawalpemilu.org#56898,"MAUTAPAGA, ENDE TIMUR, ENDE, NUSA TENGGARA TIMUR",12,68,96,164
https://kawalpemilu.org#56898,"MAUTAPAGA, ENDE TIMUR, ENDE, NUSA TENGGARA TIMUR",13,127,50,177
https://kawalpemilu.org#56898,"MAUTAPAGA, ENDE TIMUR, ENDE, NUSA TENGGARA TIMUR",14,93,117,210
https://kawalpemilu.org#56898,"MAUTAPAGA, ENDE TIMUR, ENDE, NUSA TENGGARA TIMUR",15,140,56,196
https://kawalpemilu.org#56898,"MAUTAPAGA, ENDE TIMUR, ENDE, NUSA TENGGARA TIMUR",16,138,29,167
https://kawalpemilu.org#56898,"MAUTAPAGA, ENDE TIMUR, ENDE, NUSA TENGGARA TIMUR",17,98,89,187
https://kawalpemilu.org#56898,"MAUTAPAGA, ENDE TIMUR, ENDE, NUSA TENGGARA TIMUR",18,97,86,183
https://kawalpemilu.org#56898,"MAUTAPAGA, ENDE TIMUR, ENDE, NUSA TENGGARA TIMUR",19,171,73,244
https://kawalpemilu.org#56898,"MAUTAPAGA, ENDE TIMUR, ENDE, NUSA TENGGARA TIMUR",20,161,98,259
https://kawalpemilu.org#56898,"MAUTAPAGA, ENDE TIMUR, ENDE, NUSA TENGGARA TIMUR",21,149,41,190
https://kawalpemilu.org#56898,"MAUTAPAGA, ENDE TIMUR, ENDE, NUSA TENGGARA TIMUR",22,207,32,239
https://kawalpemilu.org#56898,"MAUTAPAGA, ENDE TIMUR, ENDE, NUSA TENGGARA TIMUR",23,87,66,153
https://kawalpemilu.org#56898,"MAUTAPAGA, ENDE TIMUR, ENDE, NUSA TENGGARA TIMUR",24,152,41,193
https://kawalpemilu.org#56898,"MAUTAPAGA, ENDE TIMUR, ENDE, NUSA TENGGARA TIMUR",26,98,11,109
https://kawalpemilu.org#56898,"MAUTAPAGA, ENDE TIMUR, ENDE, NUSA TENGGARA TIMUR",27,60,52,112
https://kawalpemilu.org#56898,"MAUTAPAGA, ENDE TIMUR, ENDE, NUSA TENGGARA TIMUR",28,156,8,164
https://kawalpemilu.org#56898,"MAUTAPAGA, ENDE TIMUR, ENDE, NUSA TENGGARA TIMUR",29,110,28,138
https://kawalpemilu.org#56898,"MAUTAPAGA, ENDE TIMUR, ENDE, NUSA TENGGARA TIMUR",30,121,55,176
https://kawalpemilu.org#56898,"MAUTAPAGA, ENDE TIMUR, ENDE, NUSA TENGGARA TIMUR",31,127,51,178
https://kawalpemilu.org#56898,"MAUTAPAGA, ENDE TIMUR, ENDE, NUSA TENGGARA TIMUR",32,106,9,115
https://kawalpemilu.org#56898,"MAUTAPAGA, ENDE TIMUR, ENDE, NUSA TENGGARA TIMUR",33,106,25,131
https://kawalpemilu.org#56899,"REWARANGGA, ENDE TIMUR, ENDE, NUSA TENGGARA TIMUR",1,210,5,215
https://kawalpemilu.org#56899,"REWARANGGA, ENDE TIMUR, ENDE, NUSA TENGGARA TIMUR",2,230,3,233
https://kawalpemilu.org#56899,"REWARANGGA, ENDE TIMUR, ENDE, NUSA TENGGARA TIMUR",3,210,24,234
https://kawalpemilu.org#56899,"REWARANGGA, ENDE TIMUR, ENDE, NUSA TENGGARA TIMUR",4,242,12,254
https://kawalpemilu.org#56899,"REWARANGGA, ENDE TIMUR, ENDE, NUSA TENGGARA TIMUR",5,152,11,163
https://kawalpemilu.org#56899,"REWARANGGA, ENDE TIMUR, ENDE, NUSA TENGGARA TIMUR",6,192,5,197
https://kawalpemilu.org#56900,"REWARANGGA SELATAN, ENDE TIMUR, ENDE, NUSA TENGGARA TIMUR",1,161,8,169
https://kawalpemilu.org#56900,"REWARANGGA SELATAN, ENDE TIMUR, ENDE, NUSA TENGGARA TIMUR",2,175,3,178
https://kawalpemilu.org#56900,"REWARANGGA SELATAN, ENDE TIMUR, ENDE, NUSA TENGGARA TIMUR",3,144,20,164
https://kawalpemilu.org#56900,"REWARANGGA SELATAN, ENDE TIMUR, ENDE, NUSA TENGGARA TIMUR",4,60,48,108
https://kawalpemilu.org#56900,"REWARANGGA SELATAN, ENDE TIMUR, ENDE, NUSA TENGGARA TIMUR",5,93,47,140
https://kawalpemilu.org#56900,"REWARANGGA SELATAN, ENDE TIMUR, ENDE, NUSA TENGGARA TIMUR",6,129,65,194
https://kawalpemilu.org#56900,"REWARANGGA SELATAN, ENDE TIMUR, ENDE, NUSA TENGGARA TIMUR",7,167,60,227
https://kawalpemilu.org#56900,"REWARANGGA SELATAN, ENDE TIMUR, ENDE, NUSA TENGGARA TIMUR",8,157,20,177
https://kawalpemilu.org#56900,"REWARANGGA SELATAN, ENDE TIMUR, ENDE, NUSA TENGGARA TIMUR",9,111,19,130
https://kawalpemilu.org#56900,"REWARANGGA SELATAN, ENDE TIMUR, ENDE, NUSA TENGGARA TIMUR",10,206,16,222
https://kawalpemilu.org#56900,"REWARANGGA SELATAN, ENDE TIMUR, ENDE, NUSA TENGGARA TIMUR",11,134,4,138
https://kawalpemilu.org#56900,"REWARANGGA SELATAN, ENDE TIMUR, ENDE, NUSA TENGGARA TIMUR",12,68,55,123
https://kawalpemilu.org#56900,"REWARANGGA SELATAN, ENDE TIMUR, ENDE, NUSA TENGGARA TIMUR",13,111,32,143
https://kawalpemilu.org#56901,"KEDEBODU, ENDE TIMUR, ENDE, NUSA TENGGARA TIMUR",1,195,5,200
https://kawalpemilu.org#56901,"KEDEBODU, ENDE TIMUR, ENDE, NUSA TENGGARA TIMUR",2,158,1,159
https://kawalpemilu.org#56902,"NDUNGGA, ENDE TIMUR, ENDE, NUSA TENGGARA TIMUR",1,133,9,142
https://kawalpemilu.org#56902,"NDUNGGA, ENDE TIMUR, ENDE, NUSA TENGGARA TIMUR",2,173,5,178
https://kawalpemilu.org#56903,"TIWUTEWA, ENDE TIMUR, ENDE, NUSA TENGGARA TIMUR",1,156,1,157
https://kawalpemilu.org#56903,"TIWUTEWA, ENDE TIMUR, ENDE, NUSA TENGGARA TIMUR",2,143,2,145
https://kawalpemilu.org#56751,"WOLOGAI TIMUR, LEPEMBUSU KELISOKE, ENDE, NUSA TENGGARA TIMUR",1,220,7,227
https://kawalpemilu.org#56753,"NGGUMBELAKA, LEPEMBUSU KELISOKE, ENDE, NUSA TENGGARA TIMUR",1,141,4,145
https://kawalpemilu.org#56753,"NGGUMBELAKA, LEPEMBUSU KELISOKE, ENDE, NUSA TENGGARA TIMUR",2,138,3,141
https://kawalpemilu.org#56762,"MUKUREKU, LEPEMBUSU KELISOKE, ENDE, NUSA TENGGARA TIMUR",1,157,6,163
https://kawalpemilu.org#56844,"TANIWODA, LEPEMBUSU KELISOKE, ENDE, NUSA TENGGARA TIMUR",1,126,2,128
https://kawalpemilu.org#56844,"TANIWODA, LEPEMBUSU KELISOKE, ENDE, NUSA TENGGARA TIMUR",2,108,0,108
https://kawalpemilu.org#56844,"TANIWODA, LEPEMBUSU KELISOKE, ENDE, NUSA TENGGARA TIMUR",3,101,0,101
https://kawalpemilu.org#56849,"KURU, LEPEMBUSU KELISOKE, ENDE, NUSA TENGGARA TIMUR",1,109,0,109
https://kawalpemilu.org#56849,"KURU, LEPEMBUSU KELISOKE, ENDE, NUSA TENGGARA TIMUR",2,94,7,101
https://kawalpemilu.org#56856,"NDENGGARONGGE, LEPEMBUSU KELISOKE, ENDE, NUSA TENGGARA TIMUR",1,151,19,170
https://kawalpemilu.org#56867,"NDIKOSAPU, LEPEMBUSU KELISOKE, ENDE, NUSA TENGGARA TIMUR",1,107,3,110
https://kawalpemilu.org#56867,"NDIKOSAPU, LEPEMBUSU KELISOKE, ENDE, NUSA TENGGARA TIMUR",2,121,1,122
https://kawalpemilu.org#85158,"DETUARA, LEPEMBUSU KELISOKE, ENDE, NUSA TENGGARA TIMUR",1,173,2,175
https://kawalpemilu.org#85159,"TIWUSORA, LEPEMBUSU KELISOKE, ENDE, NUSA TENGGARA TIMUR",1,195,6,201
https://kawalpemilu.org#91278,"LISEKURU, LEPEMBUSU KELISOKE, ENDE, NUSA TENGGARA TIMUR",1,178,2,180
https://kawalpemilu.org#91279,"RUTUJEJA, LEPEMBUSU KELISOKE, ENDE, NUSA TENGGARA TIMUR",1,155,1,156
https://kawalpemilu.org#91280,"KURUSARE, LEPEMBUSU KELISOKE, ENDE, NUSA TENGGARA TIMUR",1,71,4,75
https://kawalpemilu.org#91280,"KURUSARE, LEPEMBUSU KELISOKE, ENDE, NUSA TENGGARA TIMUR",2,51,2,53
https://kawalpemilu.org#91280,"KURUSARE, LEPEMBUSU KELISOKE, ENDE, NUSA TENGGARA TIMUR",3,72,0,72
https://kawalpemilu.org#91281,"MUKUREKU SA'ATE, LEPEMBUSU KELISOKE, ENDE, NUSA TENGGARA TIMUR",1,84,3,87
https://kawalpemilu.org#91281,"MUKUREKU SA'ATE, LEPEMBUSU KELISOKE, ENDE, NUSA TENGGARA TIMUR",2,70,1,71
https://kawalpemilu.org#56906,"AIMERE, AIMERE, NGADA, NUSA TENGGARA TIMUR",1,134,20,154
https://kawalpemilu.org#56906,"AIMERE, AIMERE, NGADA, NUSA TENGGARA TIMUR",2,142,8,150
https://kawalpemilu.org#56906,"AIMERE, AIMERE, NGADA, NUSA TENGGARA TIMUR",3,116,4,120
https://kawalpemilu.org#56907,"FOA, AIMERE, NGADA, NUSA TENGGARA TIMUR",1,140,12,152
https://kawalpemilu.org#56907,"FOA, AIMERE, NGADA, NUSA TENGGARA TIMUR",2,157,5,162
https://kawalpemilu.org#56907,"FOA, AIMERE, NGADA, NUSA TENGGARA TIMUR",3,156,6,162
https://kawalpemilu.org#56908,"KELIGEJO, AIMERE, NGADA, NUSA TENGGARA TIMUR",1,173,10,183
https://kawalpemilu.org#56908,"KELIGEJO, AIMERE, NGADA, NUSA TENGGARA TIMUR",2,205,10,215
https://kawalpemilu.org#56908,"KELIGEJO, AIMERE, NGADA, NUSA TENGGARA TIMUR",3,114,4,118
https://kawalpemilu.org#56908,"KELIGEJO, AIMERE, NGADA, NUSA TENGGARA TIMUR",4,148,7,155
https://kawalpemilu.org#56914,"AIMERE TIMUR, AIMERE, NGADA, NUSA TENGGARA TIMUR",1,131,69,200
https://kawalpemilu.org#56914,"AIMERE TIMUR, AIMERE, NGADA, NUSA TENGGARA TIMUR",2,166,17,183
https://kawalpemilu.org#56914,"AIMERE TIMUR, AIMERE, NGADA, NUSA TENGGARA TIMUR",3,122,16,138
https://kawalpemilu.org#56914,"AIMERE TIMUR, AIMERE, NGADA, NUSA TENGGARA TIMUR",4,236,3,239
https://kawalpemilu.org#56914,"AIMERE TIMUR, AIMERE, NGADA, NUSA TENGGARA TIMUR",5,194,16,210
https://kawalpemilu.org#56917,"HEAWEA, AIMERE, NGADA, NUSA TENGGARA TIMUR",1,139,2,141
https://kawalpemilu.org#56917,"HEAWEA, AIMERE, NGADA, NUSA TENGGARA TIMUR",2,157,3,160
https://kawalpemilu.org#85160,"LEGELAPU, AIMERE, NGADA, NUSA TENGGARA TIMUR",1,167,1,168
https://kawalpemilu.org#85160,"LEGELAPU, AIMERE, NGADA, NUSA TENGGARA TIMUR",2,215,6,221
https://kawalpemilu.org#85160,"LEGELAPU, AIMERE, NGADA, NUSA TENGGARA TIMUR",3,216,18,234
https://kawalpemilu.org#85161,"LEKOGOKO, AIMERE, NGADA, NUSA TENGGARA TIMUR",1,187,19,206
https://kawalpemilu.org#85161,"LEKOGOKO, AIMERE, NGADA, NUSA TENGGARA TIMUR",2,153,12,165
https://kawalpemilu.org#85161,"LEKOGOKO, AIMERE, NGADA, NUSA TENGGARA TIMUR",3,139,0,139
https://kawalpemilu.org#85162,"BINAWALI, AIMERE, NGADA, NUSA TENGGARA TIMUR",1,169,12,181
https://kawalpemilu.org#85162,"BINAWALI, AIMERE, NGADA, NUSA TENGGARA TIMUR",2,163,6,169
https://kawalpemilu.org#85163,"WAESAE, AIMERE, NGADA, NUSA TENGGARA TIMUR",1,156,18,174
https://kawalpemilu.org#85163,"WAESAE, AIMERE, NGADA, NUSA TENGGARA TIMUR",2,175,7,182
https://kawalpemilu.org#85163,"WAESAE, AIMERE, NGADA, NUSA TENGGARA TIMUR",3,128,7,135
https://kawalpemilu.org#93373,"KILA, AIMERE, NGADA, NUSA TENGGARA TIMUR",1,176,3,179
https://kawalpemilu.org#93373,"KILA, AIMERE, NGADA, NUSA TENGGARA TIMUR",2,135,1,136
https://kawalpemilu.org#56920,"TODABELU, GOLEWA, NGADA, NUSA TENGGARA TIMUR",1,159,18,177
https://kawalpemilu.org#56920,"TODABELU, GOLEWA, NGADA, NUSA TENGGARA TIMUR",2,198,9,207
https://kawalpemilu.org#56921,"MATALOKO, GOLEWA, NGADA, NUSA TENGGARA TIMUR",1,238,1,239
https://kawalpemilu.org#56921,"MATALOKO, GOLEWA, NGADA, NUSA TENGGARA TIMUR",4,178,12,190
https://kawalpemilu.org#56923,"WERE I, GOLEWA, NGADA, NUSA TENGGARA TIMUR",1,211,5,216
https://kawalpemilu.org#56923,"WERE I, GOLEWA, NGADA, NUSA TENGGARA TIMUR",2,206,3,209
https://kawalpemilu.org#56923,"WERE I, GOLEWA, NGADA, NUSA TENGGARA TIMUR",3,159,4,163
https://kawalpemilu.org#56923,"WERE I, GOLEWA, NGADA, NUSA TENGGARA TIMUR",4,222,4,226
https://kawalpemilu.org#56925,"WERE, GOLEWA, NGADA, NUSA TENGGARA TIMUR",1,213,7,220
https://kawalpemilu.org#56925,"WERE, GOLEWA, NGADA, NUSA TENGGARA TIMUR",2,210,10,220
https://kawalpemilu.org#56925,"WERE, GOLEWA, NGADA, NUSA TENGGARA TIMUR",3,212,5,217
https://kawalpemilu.org#56928,"SANGADETO, GOLEWA, NGADA, NUSA TENGGARA TIMUR",1,234,1,235
https://kawalpemilu.org#56928,"SANGADETO, GOLEWA, NGADA, NUSA TENGGARA TIMUR",2,120,0,120
https://kawalpemilu.org#56928,"SANGADETO, GOLEWA, NGADA, NUSA TENGGARA TIMUR",3,177,2,179
https://kawalpemilu.org#56929,"RATOGESA, GOLEWA, NGADA, NUSA TENGGARA TIMUR",1,149,3,152
https://kawalpemilu.org#56929,"RATOGESA, GOLEWA, NGADA, NUSA TENGGARA TIMUR",3,171,9,180
https://kawalpemilu.org#56929,"RATOGESA, GOLEWA, NGADA, NUSA TENGGARA TIMUR",4,206,0,206
https://kawalpemilu.org#56929,"RATOGESA, GOLEWA, NGADA, NUSA TENGGARA TIMUR",5,122,0,122
https://kawalpemilu.org#56930,"RADABATA, GOLEWA, NGADA, NUSA TENGGARA TIMUR",1,216,17,233
https://kawalpemilu.org#56930,"RADABATA, GOLEWA, NGADA, NUSA TENGGARA TIMUR",2,179,3,182
https://kawalpemilu.org#56930,"RADABATA, GOLEWA, NGADA, NUSA TENGGARA TIMUR",3,226,4,230
https://kawalpemilu.org#56930,"RADABATA, GOLEWA, NGADA, NUSA TENGGARA TIMUR",4,208,18,226
https://kawalpemilu.org#56931,"ULU BELU, GOLEWA, NGADA, NUSA TENGGARA TIMUR",1,174,9,183
https://kawalpemilu.org#56931,"ULU BELU, GOLEWA, NGADA, NUSA TENGGARA TIMUR",2,144,3,147
https://kawalpemilu.org#56936,"DADAWEA, GOLEWA, NGADA, NUSA TENGGARA TIMUR",1,198,3,201
https://kawalpemilu.org#56936,"DADAWEA, GOLEWA, NGADA, NUSA TENGGARA TIMUR",2,113,2,115
https://kawalpemilu.org#56936,"DADAWEA, GOLEWA, NGADA, NUSA TENGGARA TIMUR",3,158,2,160
https://kawalpemilu.org#56937,"SARASEDU, GOLEWA, NGADA, NUSA TENGGARA TIMUR",1,193,9,202
https://kawalpemilu.org#56937,"SARASEDU, GOLEWA, NGADA, NUSA TENGGARA TIMUR",2,126,9,135
https://kawalpemilu.org#56937,"SARASEDU, GOLEWA, NGADA, NUSA TENGGARA TIMUR",3,108,15,123
https://kawalpemilu.org#56938,"MALANUZA, GOLEWA, NGADA, NUSA TENGGARA TIMUR",1,214,7,221
https://kawalpemilu.org#56938,"MALANUZA, GOLEWA, NGADA, NUSA TENGGARA TIMUR",2,215,5,220
https://kawalpemilu.org#56938,"MALANUZA, GOLEWA, NGADA, NUSA TENGGARA TIMUR",4,222,12,234
https://kawalpemilu.org#85164,"WERE IV, GOLEWA, NGADA, NUSA TENGGARA TIMUR",1,160,2,162
https://kawalpemilu.org#85164,"WERE IV, GOLEWA, NGADA, NUSA TENGGARA TIMUR",2,168,9,177
https://kawalpemilu.org#85165,"MALANUZA SATU, GOLEWA, NGADA, NUSA TENGGARA TIMUR",1,189,1,190
https://kawalpemilu.org#85165,"MALANUZA SATU, GOLEWA, NGADA, NUSA TENGGARA TIMUR",2,141,2,143
https://kawalpemilu.org#85166,"SARASEDU SATU, GOLEWA, NGADA, NUSA TENGGARA TIMUR",1,192,9,201
https://kawalpemilu.org#85166,"SARASEDU SATU, GOLEWA, NGADA, NUSA TENGGARA TIMUR",2,193,10,203
https://kawalpemilu.org#85167,"EKOROKA, GOLEWA, NGADA, NUSA TENGGARA TIMUR",1,184,5,189
https://kawalpemilu.org#85167,"EKOROKA, GOLEWA, NGADA, NUSA TENGGARA TIMUR",2,218,4,222
https://kawalpemilu.org#85168,"WAE IA, GOLEWA, NGADA, NUSA TENGGARA TIMUR",1,149,27,176
https://kawalpemilu.org#85168,"WAE IA, GOLEWA, NGADA, NUSA TENGGARA TIMUR",2,199,5,204
https://kawalpemilu.org#85168,"WAE IA, GOLEWA, NGADA, NUSA TENGGARA TIMUR",3,175,8,183
https://kawalpemilu.org#56941,"BAJAWA, BAJAWA, NGADA, NUSA TENGGARA TIMUR",1,168,9,177
https://kawalpemilu.org#56941,"BAJAWA, BAJAWA, NGADA, NUSA TENGGARA TIMUR",2,164,4,168
https://kawalpemilu.org#56941,"BAJAWA, BAJAWA, NGADA, NUSA TENGGARA TIMUR",3,138,25,163
https://kawalpemilu.org#56941,"BAJAWA, BAJAWA, NGADA, NUSA TENGGARA TIMUR",4,236,12,248
https://kawalpemilu.org#56941,"BAJAWA, BAJAWA, NGADA, NUSA TENGGARA TIMUR",5,217,14,231
https://kawalpemilu.org#56941,"BAJAWA, BAJAWA, NGADA, NUSA TENGGARA TIMUR",6,242,14,256
https://kawalpemilu.org#56941,"BAJAWA, BAJAWA, NGADA, NUSA TENGGARA TIMUR",7,207,10,217
https://kawalpemilu.org#56941,"BAJAWA, BAJAWA, NGADA, NUSA TENGGARA TIMUR",8,160,12,172
https://kawalpemilu.org#56942,"TANALODU, BAJAWA, NGADA, NUSA TENGGARA TIMUR",1,214,17,231
https://kawalpemilu.org#56942,"TANALODU, BAJAWA, NGADA, NUSA TENGGARA TIMUR",2,182,36,218
https://kawalpemilu.org#56942,"TANALODU, BAJAWA, NGADA, NUSA TENGGARA TIMUR",3,216,13,229
https://kawalpemilu.org#56942,"TANALODU, BAJAWA, NGADA, NUSA TENGGARA TIMUR",4,179,17,196
https://kawalpemilu.org#56942,"TANALODU, BAJAWA, NGADA, NUSA TENGGARA TIMUR",5,188,42,230
https://kawalpemilu.org#56942,"TANALODU, BAJAWA, NGADA, NUSA TENGGARA TIMUR",6,167,59,226
https://kawalpemilu.org#56943,"KISANATA, BAJAWA, NGADA, NUSA TENGGARA TIMUR",1,206,26,232
https://kawalpemilu.org#56943,"KISANATA, BAJAWA, NGADA, NUSA TENGGARA TIMUR",2,163,56,219
https://kawalpemilu.org#56943,"KISANATA, BAJAWA, NGADA, NUSA TENGGARA TIMUR",3,78,20,98
https://kawalpemilu.org#56944,"JAWAMEZE, BAJAWA, NGADA, NUSA TENGGARA TIMUR",1,254,23,277
https://kawalpemilu.org#56944,"JAWAMEZE, BAJAWA, NGADA, NUSA TENGGARA TIMUR",2,232,5,237
https://kawalpemilu.org#56944,"JAWAMEZE, BAJAWA, NGADA, NUSA TENGGARA TIMUR",3,187,17,204
https://kawalpemilu.org#56945,"TRIKORA, BAJAWA, NGADA, NUSA TENGGARA TIMUR",1,141,58,199
https://kawalpemilu.org#56945,"TRIKORA, BAJAWA, NGADA, NUSA TENGGARA TIMUR",2,144,28,172
https://kawalpemilu.org#56945,"TRIKORA, BAJAWA, NGADA, NUSA TENGGARA TIMUR",3,201,20,221
https://kawalpemilu.org#56945,"TRIKORA, BAJAWA, NGADA, NUSA TENGGARA TIMUR",4,218,5,223
https://kawalpemilu.org#56945,"TRIKORA, BAJAWA, NGADA, NUSA TENGGARA TIMUR",5,207,13,220
https://kawalpemilu.org#56945,"TRIKORA, BAJAWA, NGADA, NUSA TENGGARA TIMUR",6,216,15,231
https://kawalpemilu.org#56946,"NGEDUKELU, BAJAWA, NGADA, NUSA TENGGARA TIMUR",1,208,35,243
https://kawalpemilu.org#56946,"NGEDUKELU, BAJAWA, NGADA, NUSA TENGGARA TIMUR",2,178,63,241
https://kawalpemilu.org#56946,"NGEDUKELU, BAJAWA, NGADA, NUSA TENGGARA TIMUR",3,208,36,244
https://kawalpemilu.org#56946,"NGEDUKELU, BAJAWA, NGADA, NUSA TENGGARA TIMUR",4,202,25,227
https://kawalpemilu.org#56946,"NGEDUKELU, BAJAWA, NGADA, NUSA TENGGARA TIMUR",5,193,38,231
https://kawalpemilu.org#56946,"NGEDUKELU, BAJAWA, NGADA, NUSA TENGGARA TIMUR",6,134,20,154
https://kawalpemilu.org#56947,"LEBIJAGA, BAJAWA, NGADA, NUSA TENGGARA TIMUR",1,245,12,257
https://kawalpemilu.org#56947,"LEBIJAGA, BAJAWA, NGADA, NUSA TENGGARA TIMUR",2,241,16,257
https://kawalpemilu.org#56947,"LEBIJAGA, BAJAWA, NGADA, NUSA TENGGARA TIMUR",3,199,9,208
https://kawalpemilu.org#56947,"LEBIJAGA, BAJAWA, NGADA, NUSA TENGGARA TIMUR",4,149,34,183
https://kawalpemilu.org#56947,"LEBIJAGA, BAJAWA, NGADA, NUSA TENGGARA TIMUR",5,160,28,188
https://kawalpemilu.org#56947,"LEBIJAGA, BAJAWA, NGADA, NUSA TENGGARA TIMUR",6,194,22,216
https://kawalpemilu.org#56947,"LEBIJAGA, BAJAWA, NGADA, NUSA TENGGARA TIMUR",7,228,37,265
https://kawalpemilu.org#56948,"FAOBATA, BAJAWA, NGADA, NUSA TENGGARA TIMUR",1,208,36,244
https://kawalpemilu.org#56948,"FAOBATA, BAJAWA, NGADA, NUSA TENGGARA TIMUR",2,222,13,235
https://kawalpemilu.org#56948,"FAOBATA, BAJAWA, NGADA, NUSA TENGGARA TIMUR",3,200,11,211
https://kawalpemilu.org#56948,"FAOBATA, BAJAWA, NGADA, NUSA TENGGARA TIMUR",4,219,14,233
https://kawalpemilu.org#56948,"FAOBATA, BAJAWA, NGADA, NUSA TENGGARA TIMUR",5,262,5,267
https://kawalpemilu.org#56948,"FAOBATA, BAJAWA, NGADA, NUSA TENGGARA TIMUR",6,82,2,84
https://kawalpemilu.org#56949,"SUSU, BAJAWA, NGADA, NUSA TENGGARA TIMUR",1,221,18,239
https://kawalpemilu.org#56949,"SUSU, BAJAWA, NGADA, NUSA TENGGARA TIMUR",2,232,18,250
https://kawalpemilu.org#56949,"SUSU, BAJAWA, NGADA, NUSA TENGGARA TIMUR",3,216,14,230
https://kawalpemilu.org#56949,"SUSU, BAJAWA, NGADA, NUSA TENGGARA TIMUR",4,181,8,189
https://kawalpemilu.org#56949,"SUSU, BAJAWA, NGADA, NUSA TENGGARA TIMUR",5,168,17,185
https://kawalpemilu.org#56949,"SUSU, BAJAWA, NGADA, NUSA TENGGARA TIMUR",6,195,6,201
https://kawalpemilu.org#56950,"BEJA, BAJAWA, NGADA, NUSA TENGGARA TIMUR",1,224,9,233
https://kawalpemilu.org#56950,"BEJA, BAJAWA, NGADA, NUSA TENGGARA TIMUR",2,210,4,214
https://kawalpemilu.org#56951,"BOMARI, BAJAWA, NGADA, NUSA TENGGARA TIMUR",1,228,11,239
https://kawalpemilu.org#56951,"BOMARI, BAJAWA, NGADA, NUSA TENGGARA TIMUR",2,243,6,249
https://kawalpemilu.org#56951,"BOMARI, BAJAWA, NGADA, NUSA TENGGARA TIMUR",3,194,13,207
https://kawalpemilu.org#56951,"BOMARI, BAJAWA, NGADA, NUSA TENGGARA TIMUR",4,104,8,112
https://kawalpemilu.org#56952,"WAWOWAE, BAJAWA, NGADA, NUSA TENGGARA TIMUR",1,155,4,159
https://kawalpemilu.org#56952,"WAWOWAE, BAJAWA, NGADA, NUSA TENGGARA TIMUR",4,239,10,249
https://kawalpemilu.org#56952,"WAWOWAE, BAJAWA, NGADA, NUSA TENGGARA TIMUR",6,181,3,184
https://kawalpemilu.org#56953,"UBEDOLUMOLO, BAJAWA, NGADA, NUSA TENGGARA TIMUR",2,210,16,226
https://kawalpemilu.org#56954,"NARU, BAJAWA, NGADA, NUSA TENGGARA TIMUR",1,182,10,192
https://kawalpemilu.org#56954,"NARU, BAJAWA, NGADA, NUSA TENGGARA TIMUR",2,176,5,181
https://kawalpemilu.org#56954,"NARU, BAJAWA, NGADA, NUSA TENGGARA TIMUR",3,165,11,176
https://kawalpemilu.org#56954,"NARU, BAJAWA, NGADA, NUSA TENGGARA TIMUR",4,200,17,217
https://kawalpemilu.org#56954,"NARU, BAJAWA, NGADA, NUSA TENGGARA TIMUR",5,212,13,225
https://kawalpemilu.org#56954,"NARU, BAJAWA, NGADA, NUSA TENGGARA TIMUR",6,224,12,236
https://kawalpemilu.org#56955,"BEIWALI, BAJAWA, NGADA, NUSA TENGGARA TIMUR",1,237,7,244
https://kawalpemilu.org#56955,"BEIWALI, BAJAWA, NGADA, NUSA TENGGARA TIMUR",2,227,0,227
https://kawalpemilu.org#56955,"BEIWALI, BAJAWA, NGADA, NUSA TENGGARA TIMUR",3,229,6,235
https://kawalpemilu.org#56957,"BORANI, BAJAWA, NGADA, NUSA TENGGARA TIMUR",1,172,11,183
https://kawalpemilu.org#56957,"BORANI, BAJAWA, NGADA, NUSA TENGGARA TIMUR",2,201,204,205
https://kawalpemilu.org#56957,"BORANI, BAJAWA, NGADA, NUSA TENGGARA TIMUR",3,191,7,198
https://kawalpemilu.org#85169,"LANGAGEDHA, BAJAWA, NGADA, NUSA TENGGARA TIMUR",1,200,15,215
https://kawalpemilu.org#85169,"LANGAGEDHA, BAJAWA, NGADA, NUSA TENGGARA TIMUR",2,101,18,119
https://kawalpemilu.org#85169,"LANGAGEDHA, BAJAWA, NGADA, NUSA TENGGARA TIMUR",3,128,2,130
https://kawalpemilu.org#85170,"BOWALI, BAJAWA, NGADA, NUSA TENGGARA TIMUR",1,236,10,246
https://kawalpemilu.org#85170,"BOWALI, BAJAWA, NGADA, NUSA TENGGARA TIMUR",2,207,4,211
https://kawalpemilu.org#85171,"UBEDOLUMOLO SATU, BAJAWA, NGADA, NUSA TENGGARA TIMUR",1,188,9,197
https://kawalpemilu.org#85171,"UBEDOLUMOLO SATU, BAJAWA, NGADA, NUSA TENGGARA TIMUR",2,261,4,265
https://kawalpemilu.org#91179,"BELA, BAJAWA, NGADA, NUSA TENGGARA TIMUR",1,176,5,181
https://kawalpemilu.org#91179,"BELA, BAJAWA, NGADA, NUSA TENGGARA TIMUR",2,116,5,121
https://kawalpemilu.org#91179,"BELA, BAJAWA, NGADA, NUSA TENGGARA TIMUR",3,148,5,153
https://kawalpemilu.org#92231,"PAPE, BAJAWA, NGADA, NUSA TENGGARA TIMUR",1,142,1,143
https://kawalpemilu.org#92231,"PAPE, BAJAWA, NGADA, NUSA TENGGARA TIMUR",2,184,1,185
https://kawalpemilu.org#92232,"NGORANALE, BAJAWA, NGADA, NUSA TENGGARA TIMUR",1,235,17,252
https://kawalpemilu.org#92232,"NGORANALE, BAJAWA, NGADA, NUSA TENGGARA TIMUR",2,231,8,239
https://kawalpemilu.org#92232,"NGORANALE, BAJAWA, NGADA, NUSA TENGGARA TIMUR",3,228,20,248
https://kawalpemilu.org#56959,"WAEPANA, SOA, NGADA, NUSA TENGGARA TIMUR",1,200,13,213
https://kawalpemilu.org#56959,"WAEPANA, SOA, NGADA, NUSA TENGGARA TIMUR",4,207,15,222
https://kawalpemilu.org#56960,"MASUMELI, SOA, NGADA, NUSA TENGGARA TIMUR",1,229,13,242
https://kawalpemilu.org#56960,"MASUMELI, SOA, NGADA, NUSA TENGGARA TIMUR",2,146,3,149
https://kawalpemilu.org#56960,"MASUMELI, SOA, NGADA, NUSA TENGGARA TIMUR",3,157,6,163
https://kawalpemilu.org#56961,"PIGA, SOA, NGADA, NUSA TENGGARA TIMUR",2,168,18,186
https://kawalpemilu.org#56961,"PIGA, SOA, NGADA, NUSA TENGGARA TIMUR",3,151,11,162
https://kawalpemilu.org#56962,"LOA, SOA, NGADA, NUSA TENGGARA TIMUR",1,247,15,262
https://kawalpemilu.org#56962,"LOA, SOA, NGADA, NUSA TENGGARA TIMUR",2,178,5,183
https://kawalpemilu.org#56963,"TARAWAJA, SOA, NGADA, NUSA TENGGARA TIMUR",2,229,2,231
https://kawalpemilu.org#56963,"TARAWAJA, SOA, NGADA, NUSA TENGGARA TIMUR",3,156,8,164
https://kawalpemilu.org#56964,"SESO, SOA, NGADA, NUSA TENGGARA TIMUR",1,234,17,251
https://kawalpemilu.org#56964,"SESO, SOA, NGADA, NUSA TENGGARA TIMUR",2,229,20,249
https://kawalpemilu.org#56964,"SESO, SOA, NGADA, NUSA TENGGARA TIMUR",3,219,15,234
https://kawalpemilu.org#56965,"MANGERUDA, SOA, NGADA, NUSA TENGGARA TIMUR",1,166,16,182
https://kawalpemilu.org#56965,"MANGERUDA, SOA, NGADA, NUSA TENGGARA TIMUR",2,156,11,167
https://kawalpemilu.org#56965,"MANGERUDA, SOA, NGADA, NUSA TENGGARA TIMUR",3,176,14,190
https://kawalpemilu.org#56965,"MANGERUDA, SOA, NGADA, NUSA TENGGARA TIMUR",4,185,11,196
https://kawalpemilu.org#85172,"MASU KEDHI, SOA, NGADA, NUSA TENGGARA TIMUR",1,166,10,176
https://kawalpemilu.org#85172,"MASU KEDHI, SOA, NGADA, NUSA TENGGARA TIMUR",2,143,9,152
https://kawalpemilu.org#85172,"MASU KEDHI, SOA, NGADA, NUSA TENGGARA TIMUR",3,215,12,227
https://kawalpemilu.org#85173,"LIBUNIO, SOA, NGADA, NUSA TENGGARA TIMUR",1,174,13,187
https://kawalpemilu.org#85173,"LIBUNIO, SOA, NGADA, NUSA TENGGARA TIMUR",2,145,10,155
https://kawalpemilu.org#85174,"MELI WARU, SOA, NGADA, NUSA TENGGARA TIMUR",1,184,7,191
https://kawalpemilu.org#85174,"MELI WARU, SOA, NGADA, NUSA TENGGARA TIMUR",2,97,2,99
https://kawalpemilu.org#85175,"NGABHEO, SOA, NGADA, NUSA TENGGARA TIMUR",1,221,10,231
https://kawalpemilu.org#85175,"NGABHEO, SOA, NGADA, NUSA TENGGARA TIMUR",2,177,8,185
https://kawalpemilu.org#85176,"BOGOBOA, SOA, NGADA, NUSA TENGGARA TIMUR",1,150,7,157
https://kawalpemilu.org#85176,"BOGOBOA, SOA, NGADA, NUSA TENGGARA TIMUR",3,175,2,177
https://kawalpemilu.org#85177,"PIGA SATU, SOA, NGADA, NUSA TENGGARA TIMUR",1,196,18,214
https://kawalpemilu.org#85177,"PIGA SATU, SOA, NGADA, NUSA TENGGARA TIMUR",2,171,11,182
https://kawalpemilu.org#85178,"TARAWALI, SOA, NGADA, NUSA TENGGARA TIMUR",1,181,1,182
https://kawalpemilu.org#85178,"TARAWALI, SOA, NGADA, NUSA TENGGARA TIMUR",2,234,7,241
https://kawalpemilu.org#85178,"TARAWALI, SOA, NGADA, NUSA TENGGARA TIMUR",3,201,4,205
https://kawalpemilu.org#56967,"BENTENG TENGAH, RIUNG, NGADA, NUSA TENGGARA TIMUR",1,68,117,185
https://kawalpemilu.org#56967,"BENTENG TENGAH, RIUNG, NGADA, NUSA TENGGARA TIMUR",2,88,105,193
https://kawalpemilu.org#56967,"BENTENG TENGAH, RIUNG, NGADA, NUSA TENGGARA TIMUR",3,67,76,143
https://kawalpemilu.org#56967,"BENTENG TENGAH, RIUNG, NGADA, NUSA TENGGARA TIMUR",4,79,147,226
https://kawalpemilu.org#56967,"BENTENG TENGAH, RIUNG, NGADA, NUSA TENGGARA TIMUR",5,67,177,244
https://kawalpemilu.org#56968,"NANGAMESE, RIUNG, NGADA, NUSA TENGGARA TIMUR",1,113,93,206
https://kawalpemilu.org#56968,"NANGAMESE, RIUNG, NGADA, NUSA TENGGARA TIMUR",2,67,143,210
https://kawalpemilu.org#56968,"NANGAMESE, RIUNG, NGADA, NUSA TENGGARA TIMUR",3,32,183,215
https://kawalpemilu.org#56968,"NANGAMESE, RIUNG, NGADA, NUSA TENGGARA TIMUR",4,60,164,224
https://kawalpemilu.org#56969,"TAENTERONG, RIUNG, NGADA, NUSA TENGGARA TIMUR",1,146,6,152
https://kawalpemilu.org#56969,"TAENTERONG, RIUNG, NGADA, NUSA TENGGARA TIMUR",2,96,9,105
https://kawalpemilu.org#56970,"WANGKA, RIUNG, NGADA, NUSA TENGGARA TIMUR",1,213,7,220
https://kawalpemilu.org#56970,"WANGKA, RIUNG, NGADA, NUSA TENGGARA TIMUR",2,206,9,215
https://kawalpemilu.org#56970,"WANGKA, RIUNG, NGADA, NUSA TENGGARA TIMUR",3,215,4,219
https://kawalpemilu.org#56971,"LENGKOSAMBI, RIUNG, NGADA, NUSA TENGGARA TIMUR",1,192,29,221
https://kawalpemilu.org#56971,"LENGKOSAMBI, RIUNG, NGADA, NUSA TENGGARA TIMUR",2,201,21,222
https://kawalpemilu.org#56972,"TADHO, RIUNG, NGADA, NUSA TENGGARA TIMUR",1,29,142,171
https://kawalpemilu.org#56972,"TADHO, RIUNG, NGADA, NUSA TENGGARA TIMUR",2,143,71,214
https://kawalpemilu.org#56972,"TADHO, RIUNG, NGADA, NUSA TENGGARA TIMUR",3,101,74,175
https://kawalpemilu.org#56972,"TADHO, RIUNG, NGADA, NUSA TENGGARA TIMUR",4,152,33,185
https://kawalpemilu.org#56972,"TADHO, RIUNG, NGADA, NUSA TENGGARA TIMUR",5,204,21,225
https://kawalpemilu.org#56973,"SAMBINASI, RIUNG, NGADA, NUSA TENGGARA TIMUR",1,46,150,196
https://kawalpemilu.org#56973,"SAMBINASI, RIUNG, NGADA, NUSA TENGGARA TIMUR",2,11,59,70
https://kawalpemilu.org#56974,"LATUNG, RIUNG, NGADA, NUSA TENGGARA TIMUR",1,216,19,235
https://kawalpemilu.org#56974,"LATUNG, RIUNG, NGADA, NUSA TENGGARA TIMUR",2,198,18,216
https://kawalpemilu.org#56975,"RAWANGKALO, RIUNG, NGADA, NUSA TENGGARA TIMUR",1,228,8,236
https://kawalpemilu.org#56975,"RAWANGKALO, RIUNG, NGADA, NUSA TENGGARA TIMUR",2,219,7,226
https://kawalpemilu.org#56975,"RAWANGKALO, RIUNG, NGADA, NUSA TENGGARA TIMUR",3,211,0,211
https://kawalpemilu.org#56976,"WANGKA SELATAN, RIUNG, NGADA, NUSA TENGGARA TIMUR",1,178,22,200
https://kawalpemilu.org#56976,"WANGKA SELATAN, RIUNG, NGADA, NUSA TENGGARA TIMUR",2,186,20,206
https://kawalpemilu.org#56976,"WANGKA SELATAN, RIUNG, NGADA, NUSA TENGGARA TIMUR",3,190,14,204
https://kawalpemilu.org#56976,"WANGKA SELATAN, RIUNG, NGADA, NUSA TENGGARA TIMUR",4,72,1,73
https://kawalpemilu.org#56977,"LENGKOSAMBI TIMUR, RIUNG, NGADA, NUSA TENGGARA TIMUR",1,162,2,164
https://kawalpemilu.org#56977,"LENGKOSAMBI TIMUR, RIUNG, NGADA, NUSA TENGGARA TIMUR",2,146,21,167
https://kawalpemilu.org#56978,"LENGKOSAMBI BARAT, RIUNG, NGADA, NUSA TENGGARA TIMUR",1,179,5,184
https://kawalpemilu.org#56978,"LENGKOSAMBI BARAT, RIUNG, NGADA, NUSA TENGGARA TIMUR",2,169,10,179
https://kawalpemilu.org#56978,"LENGKOSAMBI BARAT, RIUNG, NGADA, NUSA TENGGARA TIMUR",3,170,13,183
https://kawalpemilu.org#85179,"SAMBINASI BARAT, RIUNG, NGADA, NUSA TENGGARA TIMUR",1,48,99,147
https://kawalpemilu.org#85179,"SAMBINASI BARAT, RIUNG, NGADA, NUSA TENGGARA TIMUR",2,45,89,134
https://kawalpemilu.org#85180,"LENGKOSAMBI UTARA, RIUNG, NGADA, NUSA TENGGARA TIMUR",1,127,9,136
https://kawalpemilu.org#85180,"LENGKOSAMBI UTARA, RIUNG, NGADA, NUSA TENGGARA TIMUR",2,117,18,135
https://kawalpemilu.org#91153,"TAEN TERONG SATU, RIUNG, NGADA, NUSA TENGGARA TIMUR",1,24,98,122
https://kawalpemilu.org#91153,"TAEN TERONG SATU, RIUNG, NGADA, NUSA TENGGARA TIMUR",2,37,88,125
https://kawalpemilu.org#91156,"TAEN TERONG DUA, RIUNG, NGADA, NUSA TENGGARA TIMUR",1,168,7,175
https://kawalpemilu.org#56980,"WATUMANU, JEREBUU, NGADA, NUSA TENGGARA TIMUR",1,163,6,169
https://kawalpemilu.org#56980,"WATUMANU, JEREBUU, NGADA, NUSA TENGGARA TIMUR",2,157,8,165
https://kawalpemilu.org#56980,"WATUMANU, JEREBUU, NGADA, NUSA TENGGARA TIMUR",3,146,6,152
https://kawalpemilu.org#56981,"TIWORIWU, JEREBUU, NGADA, NUSA TENGGARA TIMUR",1,231,5,236
https://kawalpemilu.org#56981,"TIWORIWU, JEREBUU, NGADA, NUSA TENGGARA TIMUR",2,183,1,184
https://kawalpemilu.org#56982,"DARIWALI, JEREBUU, NGADA, NUSA TENGGARA TIMUR",1,168,5,173
https://kawalpemilu.org#56982,"DARIWALI, JEREBUU, NGADA, NUSA TENGGARA TIMUR",2,147,3,150
https://kawalpemilu.org#56983,"NARUWOLO, JEREBUU, NGADA, NUSA TENGGARA TIMUR",1,190,0,190
https://kawalpemilu.org#56983,"NARUWOLO, JEREBUU, NGADA, NUSA TENGGARA TIMUR",2,203,4,207
https://kawalpemilu.org#56984,"NENOWEA, JEREBUU, NGADA, NUSA TENGGARA TIMUR",1,146,1,147
https://kawalpemilu.org#56984,"NENOWEA, JEREBUU, NGADA, NUSA TENGGARA TIMUR",2,138,0,138
https://kawalpemilu.org#56986,"NARUWOLO I, JEREBUU, NGADA, NUSA TENGGARA TIMUR",1,172,5,177
https://kawalpemilu.org#56986,"NARUWOLO I, JEREBUU, NGADA, NUSA TENGGARA TIMUR",2,179,4,183
https://kawalpemilu.org#56987,"NARUWOLO II, JEREBUU, NGADA, NUSA TENGGARA TIMUR",1,193,4,197
https://kawalpemilu.org#85181,"BATAJAWA, JEREBUU, NGADA, NUSA TENGGARA TIMUR",1,168,5,173
https://kawalpemilu.org#85181,"BATAJAWA, JEREBUU, NGADA, NUSA TENGGARA TIMUR",2,101,0,101
https://kawalpemilu.org#91140,"DARIWALI I, JEREBUU, NGADA, NUSA TENGGARA TIMUR",1,124,3,127
https://kawalpemilu.org#91140,"DARIWALI I, JEREBUU, NGADA, NUSA TENGGARA TIMUR",2,127,1,128
https://kawalpemilu.org#91140,"DARIWALI I, JEREBUU, NGADA, NUSA TENGGARA TIMUR",3,205,1,206
https://kawalpemilu.org#91141,"NIO LEWA, JEREBUU, NGADA, NUSA TENGGARA TIMUR",1,156,2,158
https://kawalpemilu.org#91143,"TIWORIWU I, JEREBUU, NGADA, NUSA TENGGARA TIMUR",1,147,1,148
https://kawalpemilu.org#91143,"TIWORIWU I, JEREBUU, NGADA, NUSA TENGGARA TIMUR",2,114,7,121
https://kawalpemilu.org#92235,"TIWORIWU II, JEREBUU, NGADA, NUSA TENGGARA TIMUR",1,166,4,170
https://kawalpemilu.org#56989,"BENTENG TAWA, RIUNG BARAT, NGADA, NUSA TENGGARA TIMUR",1,86,15,101
https://kawalpemilu.org#56989,"BENTENG TAWA, RIUNG BARAT, NGADA, NUSA TENGGARA TIMUR",2,164,19,183
https://kawalpemilu.org#56989,"BENTENG TAWA, RIUNG BARAT, NGADA, NUSA TENGGARA TIMUR",3,202,12,214
https://kawalpemilu.org#56989,"BENTENG TAWA, RIUNG BARAT, NGADA, NUSA TENGGARA TIMUR",4,195,29,224
https://kawalpemilu.org#56990,"LANAMAI, RIUNG BARAT, NGADA, NUSA TENGGARA TIMUR",1,130,10,140
https://kawalpemilu.org#56990,"LANAMAI, RIUNG BARAT, NGADA, NUSA TENGGARA TIMUR",2,114,7,121
https://kawalpemilu.org#56990,"LANAMAI, RIUNG BARAT, NGADA, NUSA TENGGARA TIMUR",3,170,3,173
https://kawalpemilu.org#56991,"WOLOMEZE, RIUNG BARAT, NGADA, NUSA TENGGARA TIMUR",1,199,16,215
https://kawalpemilu.org#56991,"WOLOMEZE, RIUNG BARAT, NGADA, NUSA TENGGARA TIMUR",2,108,22,130
https://kawalpemilu.org#56991,"WOLOMEZE, RIUNG BARAT, NGADA, NUSA TENGGARA TIMUR",3,115,5,120
https://kawalpemilu.org#56992,"RIA, RIUNG BARAT, NGADA, NUSA TENGGARA TIMUR",1,188,14,202
https://kawalpemilu.org#56992,"RIA, RIUNG BARAT, NGADA, NUSA TENGGARA TIMUR",2,179,23,202
https://kawalpemilu.org#56992,"RIA, RIUNG BARAT, NGADA, NUSA TENGGARA TIMUR",3,181,58,239
https://kawalpemilu.org#56993,"NGARA, RIUNG BARAT, NGADA, NUSA TENGGARA TIMUR",1,206,26,232
https://kawalpemilu.org#56993,"NGARA, RIUNG BARAT, NGADA, NUSA TENGGARA TIMUR",2,112,6,118
https://kawalpemilu.org#56993,"NGARA, RIUNG BARAT, NGADA, NUSA TENGGARA TIMUR",3,189,10,199
https://kawalpemilu.org#56994,"RIA I, RIUNG BARAT, NGADA, NUSA TENGGARA TIMUR",1,249,7,256
https://kawalpemilu.org#56994,"RIA I, RIUNG BARAT, NGADA, NUSA TENGGARA TIMUR",2,136,12,148
https://kawalpemilu.org#85182,"WOLOMEZE I, RIUNG BARAT, NGADA, NUSA TENGGARA TIMUR",1,178,15,193
https://kawalpemilu.org#85182,"WOLOMEZE I, RIUNG BARAT, NGADA, NUSA TENGGARA TIMUR",2,131,14,145
https://kawalpemilu.org#85183,"BENTENG TAWA I, RIUNG BARAT, NGADA, NUSA TENGGARA TIMUR",1,166,29,195
https://kawalpemilu.org#85183,"BENTENG TAWA I, RIUNG BARAT, NGADA, NUSA TENGGARA TIMUR",2,108,9,117
https://kawalpemilu.org#85183,"BENTENG TAWA I, RIUNG BARAT, NGADA, NUSA TENGGARA TIMUR",3,99,17,116
https://kawalpemilu.org#85183,"BENTENG TAWA I, RIUNG BARAT, NGADA, NUSA TENGGARA TIMUR",4,128,4,132
https://kawalpemilu.org#85183,"BENTENG TAWA I, RIUNG BARAT, NGADA, NUSA TENGGARA TIMUR",5,80,9,89
https://kawalpemilu.org#85184,"LANAMAI I, RIUNG BARAT, NGADA, NUSA TENGGARA TIMUR",1,174,9,183
https://kawalpemilu.org#85184,"LANAMAI I, RIUNG BARAT, NGADA, NUSA TENGGARA TIMUR",2,192,5,197
https://kawalpemilu.org#85184,"LANAMAI I, RIUNG BARAT, NGADA, NUSA TENGGARA TIMUR",3,102,2,104
https://kawalpemilu.org#85185,"WOLOMEZE II, RIUNG BARAT, NGADA, NUSA TENGGARA TIMUR",1,113,7,120
https://kawalpemilu.org#85185,"WOLOMEZE II, RIUNG BARAT, NGADA, NUSA TENGGARA TIMUR",2,160,4,164
https://kawalpemilu.org#56996,"ULUWAE, BAJAWA UTARA, NGADA, NUSA TENGGARA TIMUR",1,137,25,162
https://kawalpemilu.org#56996,"ULUWAE, BAJAWA UTARA, NGADA, NUSA TENGGARA TIMUR",2,137,36,173
https://kawalpemilu.org#56996,"ULUWAE, BAJAWA UTARA, NGADA, NUSA TENGGARA TIMUR",3,226,42,268
https://kawalpemilu.org#56997,"INELIKA, BAJAWA UTARA, NGADA, NUSA TENGGARA TIMUR",1,187,14,201
https://kawalpemilu.org#56997,"INELIKA, BAJAWA UTARA, NGADA, NUSA TENGGARA TIMUR",2,216,10,226
https://kawalpemilu.org#56998,"INEGENA, BAJAWA UTARA, NGADA, NUSA TENGGARA TIMUR",1,227,17,244
https://kawalpemilu.org#56999,"WOLOLIKA, BAJAWA UTARA, NGADA, NUSA TENGGARA TIMUR",1,250,23,273
https://kawalpemilu.org#56999,"WOLOLIKA, BAJAWA UTARA, NGADA, NUSA TENGGARA TIMUR",2,87,9,96
https://kawalpemilu.org#56999,"WOLOLIKA, BAJAWA UTARA, NGADA, NUSA TENGGARA TIMUR",3,157,3,160
https://kawalpemilu.org#57000,"WATUKAPU, BAJAWA UTARA, NGADA, NUSA TENGGARA TIMUR",1,204,9,213
https://kawalpemilu.org#57000,"WATUKAPU, BAJAWA UTARA, NGADA, NUSA TENGGARA TIMUR",2,167,18,185
https://kawalpemilu.org#57002,"NABELENA, BAJAWA UTARA, NGADA, NUSA TENGGARA TIMUR",1,227,14,241
https://kawalpemilu.org#57002,"NABELENA, BAJAWA UTARA, NGADA, NUSA TENGGARA TIMUR",2,155,19,174
https://kawalpemilu.org#57002,"NABELENA, BAJAWA UTARA, NGADA, NUSA TENGGARA TIMUR",3,186,8,194
https://kawalpemilu.org#57002,"NABELENA, BAJAWA UTARA, NGADA, NUSA TENGGARA TIMUR",4,132,16,148
https://kawalpemilu.org#85186,"GENAMERE, BAJAWA UTARA, NGADA, NUSA TENGGARA TIMUR",1,201,8,209
https://kawalpemilu.org#85186,"GENAMERE, BAJAWA UTARA, NGADA, NUSA TENGGARA TIMUR",2,194,6,200
https://kawalpemilu.org#85188,"ULUWAE II, BAJAWA UTARA, NGADA, NUSA TENGGARA TIMUR",1,188,15,203
https://kawalpemilu.org#85188,"ULUWAE II, BAJAWA UTARA, NGADA, NUSA TENGGARA TIMUR",2,87,15,102
https://kawalpemilu.org#85189,"TURA MURI, BAJAWA UTARA, NGADA, NUSA TENGGARA TIMUR",1,210,22,232
https://kawalpemilu.org#85189,"TURA MURI, BAJAWA UTARA, NGADA, NUSA TENGGARA TIMUR",2,109,16,125
https://kawalpemilu.org#85189,"TURA MURI, BAJAWA UTARA, NGADA, NUSA TENGGARA TIMUR",3,134,16,150
https://kawalpemilu.org#57004,"NGINAMANU, WOLOMEZE, NGADA, NUSA TENGGARA TIMUR",1,222,17,239
https://kawalpemilu.org#57004,"NGINAMANU, WOLOMEZE, NGADA, NUSA TENGGARA TIMUR",2,148,12,160
https://kawalpemilu.org#57004,"NGINAMANU, WOLOMEZE, NGADA, NUSA TENGGARA TIMUR",3,202,11,213
https://kawalpemilu.org#57004,"NGINAMANU, WOLOMEZE, NGADA, NUSA TENGGARA TIMUR",4,200,44,244
https://kawalpemilu.org#57005,"DENATANA, WOLOMEZE, NGADA, NUSA TENGGARA TIMUR",1,193,24,217
https://kawalpemilu.org#57006,"MAINAI, WOLOMEZE, NGADA, NUSA TENGGARA TIMUR",1,131,23,154
https://kawalpemilu.org#57006,"MAINAI, WOLOMEZE, NGADA, NUSA TENGGARA TIMUR",2,97,28,125
https://kawalpemilu.org#57006,"MAINAI, WOLOMEZE, NGADA, NUSA TENGGARA TIMUR",3,211,7,218
https://kawalpemilu.org#57006,"MAINAI, WOLOMEZE, NGADA, NUSA TENGGARA TIMUR",4,81,23,104
https://kawalpemilu.org#57007,"TURALOA, WOLOMEZE, NGADA, NUSA TENGGARA TIMUR",1,197,19,216
https://kawalpemilu.org#57007,"TURALOA, WOLOMEZE, NGADA, NUSA TENGGARA TIMUR",2,159,12,171
https://kawalpemilu.org#57007,"TURALOA, WOLOMEZE, NGADA, NUSA TENGGARA TIMUR",3,75,9,84
https://kawalpemilu.org#85190,"NGINAMANU SELATAN, WOLOMEZE, NGADA, NUSA TENGGARA TIMUR",1,137,14,151
https://kawalpemilu.org#85190,"NGINAMANU SELATAN, WOLOMEZE, NGADA, NUSA TENGGARA TIMUR",2,144,3,147
https://kawalpemilu.org#85191,"NGINAMANU BARAT, WOLOMEZE, NGADA, NUSA TENGGARA TIMUR",1,206,8,214
https://kawalpemilu.org#85192,"WUE, WOLOMEZE, NGADA, NUSA TENGGARA TIMUR",1,150,12,162
https://kawalpemilu.org#85192,"WUE, WOLOMEZE, NGADA, NUSA TENGGARA TIMUR",2,112,6,118
https://kawalpemilu.org#85192,"WUE, WOLOMEZE, NGADA, NUSA TENGGARA TIMUR",3,112,8,120
https://kawalpemilu.org#85193,"DENATANA TIMUR, WOLOMEZE, NGADA, NUSA TENGGARA TIMUR",1,190,3,193
https://kawalpemilu.org#85193,"DENATANA TIMUR, WOLOMEZE, NGADA, NUSA TENGGARA TIMUR",2,158,5,163
https://kawalpemilu.org#56922,"WOGOWELA, GOLEWA SELATAN, NGADA, NUSA TENGGARA TIMUR",1,163,8,171
https://kawalpemilu.org#56924,"BOBA, GOLEWA SELATAN, NGADA, NUSA TENGGARA TIMUR",1,197,6,203
https://kawalpemilu.org#56924,"BOBA, GOLEWA SELATAN, NGADA, NUSA TENGGARA TIMUR",2,154,3,157
https://kawalpemilu.org#56924,"BOBA, GOLEWA SELATAN, NGADA, NUSA TENGGARA TIMUR",3,98,1,99
https://kawalpemilu.org#56926,"TAKATUNGA, GOLEWA SELATAN, NGADA, NUSA TENGGARA TIMUR",1,225,4,229
https://kawalpemilu.org#56926,"TAKATUNGA, GOLEWA SELATAN, NGADA, NUSA TENGGARA TIMUR",2,222,13,235
https://kawalpemilu.org#56926,"TAKATUNGA, GOLEWA SELATAN, NGADA, NUSA TENGGARA TIMUR",3,145,19,164
https://kawalpemilu.org#56926,"TAKATUNGA, GOLEWA SELATAN, NGADA, NUSA TENGGARA TIMUR",4,146,7,153
https://kawalpemilu.org#56927,"SADHA, GOLEWA SELATAN, NGADA, NUSA TENGGARA TIMUR",1,191,4,195
https://kawalpemilu.org#56927,"SADHA, GOLEWA SELATAN, NGADA, NUSA TENGGARA TIMUR",2,168,4,172
https://kawalpemilu.org#56927,"SADHA, GOLEWA SELATAN, NGADA, NUSA TENGGARA TIMUR",3,189,6,195
https://kawalpemilu.org#56934,"KEZEWEA, GOLEWA SELATAN, NGADA, NUSA TENGGARA TIMUR",1,39,182,221
https://kawalpemilu.org#56934,"KEZEWEA, GOLEWA SELATAN, NGADA, NUSA TENGGARA TIMUR",2,55,155,210
https://kawalpemilu.org#56934,"KEZEWEA, GOLEWA SELATAN, NGADA, NUSA TENGGARA TIMUR",3,138,4,142
https://kawalpemilu.org#56934,"KEZEWEA, GOLEWA SELATAN, NGADA, NUSA TENGGARA TIMUR",4,177,5,182
https://kawalpemilu.org#85194,"WERE TIGA, GOLEWA SELATAN, NGADA, NUSA TENGGARA TIMUR",1,152,3,155
https://kawalpemilu.org#85194,"WERE TIGA, GOLEWA SELATAN, NGADA, NUSA TENGGARA TIMUR",2,194,3,197
https://kawalpemilu.org#85194,"WERE TIGA, GOLEWA SELATAN, NGADA, NUSA TENGGARA TIMUR",3,123,6,129
https://kawalpemilu.org#85194,"WERE TIGA, GOLEWA SELATAN, NGADA, NUSA TENGGARA TIMUR",4,165,8,173
https://kawalpemilu.org#85194,"WERE TIGA, GOLEWA SELATAN, NGADA, NUSA TENGGARA TIMUR",5,166,4,170
https://kawalpemilu.org#85194,"WERE TIGA, GOLEWA SELATAN, NGADA, NUSA TENGGARA TIMUR",6,99,7,106
https://kawalpemilu.org#85194,"WERE TIGA, GOLEWA SELATAN, NGADA, NUSA TENGGARA TIMUR",7,190,3,193
https://kawalpemilu.org#91128,"BAWARANI, GOLEWA SELATAN, NGADA, NUSA TENGGARA TIMUR",1,141,1,142
https://kawalpemilu.org#91128,"BAWARANI, GOLEWA SELATAN, NGADA, NUSA TENGGARA TIMUR",2,122,3,125
https://kawalpemilu.org#91129,"WATU SIPI, GOLEWA SELATAN, NGADA, NUSA TENGGARA TIMUR",1,169,0,169
https://kawalpemilu.org#91130,"NIRMALA, GOLEWA SELATAN, NGADA, NUSA TENGGARA TIMUR",1,142,4,146
https://kawalpemilu.org#91130,"NIRMALA, GOLEWA SELATAN, NGADA, NUSA TENGGARA TIMUR",2,186,5,191
https://kawalpemilu.org#91130,"NIRMALA, GOLEWA SELATAN, NGADA, NUSA TENGGARA TIMUR",3,182,6,188
https://kawalpemilu.org#91131,"RADAMASA, GOLEWA SELATAN, NGADA, NUSA TENGGARA TIMUR",1,205,2,207
https://kawalpemilu.org#91131,"RADAMASA, GOLEWA SELATAN, NGADA, NUSA TENGGARA TIMUR",2,162,5,167
https://kawalpemilu.org#91133,"BOBA SATU, GOLEWA SELATAN, NGADA, NUSA TENGGARA TIMUR",1,115,1,116
https://kawalpemilu.org#91133,"BOBA SATU, GOLEWA SELATAN, NGADA, NUSA TENGGARA TIMUR",2,210,3,213
https://kawalpemilu.org#92242,"WERE DUA, GOLEWA SELATAN, NGADA, NUSA TENGGARA TIMUR",1,206,16,222
https://kawalpemilu.org#92242,"WERE DUA, GOLEWA SELATAN, NGADA, NUSA TENGGARA TIMUR",2,118,6,124
https://kawalpemilu.org#92242,"WERE DUA, GOLEWA SELATAN, NGADA, NUSA TENGGARA TIMUR",3,206,16,222
https://kawalpemilu.org#56919,"MANGULEWA, GOLEWA BARAT, NGADA, NUSA TENGGARA TIMUR",1,187,3,190
https://kawalpemilu.org#56919,"MANGULEWA, GOLEWA BARAT, NGADA, NUSA TENGGARA TIMUR",2,143,1,144
https://kawalpemilu.org#56919,"MANGULEWA, GOLEWA BARAT, NGADA, NUSA TENGGARA TIMUR",3,142,7,149
https://kawalpemilu.org#56919,"MANGULEWA, GOLEWA BARAT, NGADA, NUSA TENGGARA TIMUR",4,183,9,192
https://kawalpemilu.org#56919,"MANGULEWA, GOLEWA BARAT, NGADA, NUSA TENGGARA TIMUR",5,171,16,187
https://kawalpemilu.org#56933,"RAKALABA, GOLEWA BARAT, NGADA, NUSA TENGGARA TIMUR",1,198,11,209
https://kawalpemilu.org#56933,"RAKALABA, GOLEWA BARAT, NGADA, NUSA TENGGARA TIMUR",2,211,3,214
https://kawalpemilu.org#56933,"RAKALABA, GOLEWA BARAT, NGADA, NUSA TENGGARA TIMUR",3,173,15,188
https://kawalpemilu.org#56933,"RAKALABA, GOLEWA BARAT, NGADA, NUSA TENGGARA TIMUR",4,163,8,171
https://kawalpemilu.org#56933,"RAKALABA, GOLEWA BARAT, NGADA, NUSA TENGGARA TIMUR",5,120,6,126
https://kawalpemilu.org#91206,"TUREKISA, GOLEWA BARAT, NGADA, NUSA TENGGARA TIMUR",1,192,5,197
https://kawalpemilu.org#91206,"TUREKISA, GOLEWA BARAT, NGADA, NUSA TENGGARA TIMUR",2,122,5,127
https://kawalpemilu.org#91206,"TUREKISA, GOLEWA BARAT, NGADA, NUSA TENGGARA TIMUR",3,202,5,207
https://kawalpemilu.org#91206,"TUREKISA, GOLEWA BARAT, NGADA, NUSA TENGGARA TIMUR",4,175,1,176
https://kawalpemilu.org#91206,"TUREKISA, GOLEWA BARAT, NGADA, NUSA TENGGARA TIMUR",5,107,3,110
https://kawalpemilu.org#91207,"SOBO, GOLEWA BARAT, NGADA, NUSA TENGGARA TIMUR",1,195,16,211
https://kawalpemilu.org#91207,"SOBO, GOLEWA BARAT, NGADA, NUSA TENGGARA TIMUR",2,122,16,138
https://kawalpemilu.org#91207,"SOBO, GOLEWA BARAT, NGADA, NUSA TENGGARA TIMUR",3,160,11,171
https://kawalpemilu.org#91207,"SOBO, GOLEWA BARAT, NGADA, NUSA TENGGARA TIMUR",4,192,5,197
https://kawalpemilu.org#91212,"WATUNAY, GOLEWA BARAT, NGADA, NUSA TENGGARA TIMUR",1,184,0,184
https://kawalpemilu.org#91212,"WATUNAY, GOLEWA BARAT, NGADA, NUSA TENGGARA TIMUR",2,178,2,180
https://kawalpemilu.org#91213,"DIZI GEDHA, GOLEWA BARAT, NGADA, NUSA TENGGARA TIMUR",1,156,11,167
https://kawalpemilu.org#91213,"DIZI GEDHA, GOLEWA BARAT, NGADA, NUSA TENGGARA TIMUR",2,170,6,176
https://kawalpemilu.org#92246,"RAKATEDA DUA, GOLEWA BARAT, NGADA, NUSA TENGGARA TIMUR",1,153,5,158
https://kawalpemilu.org#92246,"RAKATEDA DUA, GOLEWA BARAT, NGADA, NUSA TENGGARA TIMUR",2,151,5,156
https://kawalpemilu.org#92246,"RAKATEDA DUA, GOLEWA BARAT, NGADA, NUSA TENGGARA TIMUR",3,141,0,141
https://kawalpemilu.org#92247,"RAKATEDA SATU, GOLEWA BARAT, NGADA, NUSA TENGGARA TIMUR",1,196,9,205
https://kawalpemilu.org#92247,"RAKATEDA SATU, GOLEWA BARAT, NGADA, NUSA TENGGARA TIMUR",2,217,4,221
https://kawalpemilu.org#92252,"SOBO SATU, GOLEWA BARAT, NGADA, NUSA TENGGARA TIMUR",1,140,3,143
https://kawalpemilu.org#92252,"SOBO SATU, GOLEWA BARAT, NGADA, NUSA TENGGARA TIMUR",2,141,3,144
https://kawalpemilu.org#92254,"BEA PAWE, GOLEWA BARAT, NGADA, NUSA TENGGARA TIMUR",1,167,0,167
https://kawalpemilu.org#92254,"BEA PAWE, GOLEWA BARAT, NGADA, NUSA TENGGARA TIMUR",2,141,6,147
https://kawalpemilu.org#92254,"BEA PAWE, GOLEWA BARAT, NGADA, NUSA TENGGARA TIMUR",3,81,2,83
https://kawalpemilu.org#56909,"SEBOWULI, INERIE, NGADA, NUSA TENGGARA TIMUR",1,154,13,167
https://kawalpemilu.org#56909,"SEBOWULI, INERIE, NGADA, NUSA TENGGARA TIMUR",2,161,9,170
https://kawalpemilu.org#56909,"SEBOWULI, INERIE, NGADA, NUSA TENGGARA TIMUR",3,144,6,150
https://kawalpemilu.org#56910,"INERIE, INERIE, NGADA, NUSA TENGGARA TIMUR",1,132,11,143
https://kawalpemilu.org#56910,"INERIE, INERIE, NGADA, NUSA TENGGARA TIMUR",2,159,5,164
https://kawalpemilu.org#56910,"INERIE, INERIE, NGADA, NUSA TENGGARA TIMUR",3,133,4,137
https://kawalpemilu.org#56913,"KELITEI, INERIE, NGADA, NUSA TENGGARA TIMUR",1,140,10,150
https://kawalpemilu.org#56913,"KELITEI, INERIE, NGADA, NUSA TENGGARA TIMUR",2,122,20,142
https://kawalpemilu.org#56915,"PAUPAGA, INERIE, NGADA, NUSA TENGGARA TIMUR",1,204,4,208
https://kawalpemilu.org#56915,"PAUPAGA, INERIE, NGADA, NUSA TENGGARA TIMUR",2,180,2,182
https://kawalpemilu.org#56916,"WAEBELA, INERIE, NGADA, NUSA TENGGARA TIMUR",1,187,15,202
https://kawalpemilu.org#56916,"WAEBELA, INERIE, NGADA, NUSA TENGGARA TIMUR",3,181,8,189
https://kawalpemilu.org#56985,"MANUBHARA, INERIE, NGADA, NUSA TENGGARA TIMUR",1,219,8,227
https://kawalpemilu.org#56985,"MANUBHARA, INERIE, NGADA, NUSA TENGGARA TIMUR",2,130,7,137
https://kawalpemilu.org#85195,"WARUPELE II, INERIE, NGADA, NUSA TENGGARA TIMUR",1,198,8,206
https://kawalpemilu.org#85195,"WARUPELE II, INERIE, NGADA, NUSA TENGGARA TIMUR",2,194,7,201
https://kawalpemilu.org#85196,"TIWURANA, INERIE, NGADA, NUSA TENGGARA TIMUR",1,134,3,137
https://kawalpemilu.org#91123,"WARUPELE I, INERIE, NGADA, NUSA TENGGARA TIMUR",1,210,6,216
https://kawalpemilu.org#91123,"WARUPELE I, INERIE, NGADA, NUSA TENGGARA TIMUR",2,184,2,186
https://kawalpemilu.org#91123,"WARUPELE I, INERIE, NGADA, NUSA TENGGARA TIMUR",3,187,5,192
https://kawalpemilu.org#91123,"WARUPELE I, INERIE, NGADA, NUSA TENGGARA TIMUR",4,157,4,161
https://kawalpemilu.org#92256,"LEGERIWU, INERIE, NGADA, NUSA TENGGARA TIMUR",1,116,1,117
https://kawalpemilu.org#57010,"SATAR NGKELING, WAE RII, MANGGARAI, NUSA TENGGARA TIMUR",1,184,6,190
https://kawalpemilu.org#57010,"SATAR NGKELING, WAE RII, MANGGARAI, NUSA TENGGARA TIMUR",2,156,5,161
https://kawalpemilu.org#57010,"SATAR NGKELING, WAE RII, MANGGARAI, NUSA TENGGARA TIMUR",3,216,2,218
https://kawalpemilu.org#57010,"SATAR NGKELING, WAE RII, MANGGARAI, NUSA TENGGARA TIMUR",4,162,10,172
https://kawalpemilu.org#57010,"SATAR NGKELING, WAE RII, MANGGARAI, NUSA TENGGARA TIMUR",5,148,5,153
https://kawalpemilu.org#57010,"SATAR NGKELING, WAE RII, MANGGARAI, NUSA TENGGARA TIMUR",6,144,11,155
https://kawalpemilu.org#57011,"LALONG, WAE RII, MANGGARAI, NUSA TENGGARA TIMUR",1,225,10,235
https://kawalpemilu.org#57011,"LALONG, WAE RII, MANGGARAI, NUSA TENGGARA TIMUR",2,111,4,115
https://kawalpemilu.org#57011,"LALONG, WAE RII, MANGGARAI, NUSA TENGGARA TIMUR",3,180,8,188
https://kawalpemilu.org#57011,"LALONG, WAE RII, MANGGARAI, NUSA TENGGARA TIMUR",4,190,8,198
https://kawalpemilu.org#57011,"LALONG, WAE RII, MANGGARAI, NUSA TENGGARA TIMUR",5,147,6,153
https://kawalpemilu.org#57012,"POCO, WAE RII, MANGGARAI, NUSA TENGGARA TIMUR",1,151,16,167
https://kawalpemilu.org#57012,"POCO, WAE RII, MANGGARAI, NUSA TENGGARA TIMUR",2,165,6,171
https://kawalpemilu.org#57012,"POCO, WAE RII, MANGGARAI, NUSA TENGGARA TIMUR",3,199,5,204
https://kawalpemilu.org#57013,"WAE MULU, WAE RII, MANGGARAI, NUSA TENGGARA TIMUR",1,205,12,217
https://kawalpemilu.org#57013,"WAE MULU, WAE RII, MANGGARAI, NUSA TENGGARA TIMUR",2,207,5,212
https://kawalpemilu.org#57013,"WAE MULU, WAE RII, MANGGARAI, NUSA TENGGARA TIMUR",3,169,11,180
https://kawalpemilu.org#57013,"WAE MULU, WAE RII, MANGGARAI, NUSA TENGGARA TIMUR",4,171,2,173
https://kawalpemilu.org#57013,"WAE MULU, WAE RII, MANGGARAI, NUSA TENGGARA TIMUR",5,156,5,161
https://kawalpemilu.org#57013,"WAE MULU, WAE RII, MANGGARAI, NUSA TENGGARA TIMUR",6,188,19,207
https://kawalpemilu.org#57014,"NDEHES, WAE RII, MANGGARAI, NUSA TENGGARA TIMUR",1,143,5,148
https://kawalpemilu.org#57014,"NDEHES, WAE RII, MANGGARAI, NUSA TENGGARA TIMUR",2,149,6,155
https://kawalpemilu.org#57014,"NDEHES, WAE RII, MANGGARAI, NUSA TENGGARA TIMUR",3,213,12,225
https://kawalpemilu.org#57014,"NDEHES, WAE RII, MANGGARAI, NUSA TENGGARA TIMUR",4,136,11,147
https://kawalpemilu.org#57014,"NDEHES, WAE RII, MANGGARAI, NUSA TENGGARA TIMUR",5,161,11,172
https://kawalpemilu.org#57014,"NDEHES, WAE RII, MANGGARAI, NUSA TENGGARA TIMUR",6,107,11,118
https://kawalpemilu.org#57014,"NDEHES, WAE RII, MANGGARAI, NUSA TENGGARA TIMUR",7,121,9,130
https://kawalpemilu.org#57015,"GOLO CADOR, WAE RII, MANGGARAI, NUSA TENGGARA TIMUR",1,201,9,210
https://kawalpemilu.org#57015,"GOLO CADOR, WAE RII, MANGGARAI, NUSA TENGGARA TIMUR",2,222,20,242
https://kawalpemilu.org#57015,"GOLO CADOR, WAE RII, MANGGARAI, NUSA TENGGARA TIMUR",3,205,13,218
https://kawalpemilu.org#57015,"GOLO CADOR, WAE RII, MANGGARAI, NUSA TENGGARA TIMUR",4,209,13,222
https://kawalpemilu.org#57015,"GOLO CADOR, WAE RII, MANGGARAI, NUSA TENGGARA TIMUR",5,205,19,224
https://kawalpemilu.org#57015,"GOLO CADOR, WAE RII, MANGGARAI, NUSA TENGGARA TIMUR",6,188,14,202
https://kawalpemilu.org#57016,"LONGKO, WAE RII, MANGGARAI, NUSA TENGGARA TIMUR",1,224,8,232
https://kawalpemilu.org#57016,"LONGKO, WAE RII, MANGGARAI, NUSA TENGGARA TIMUR",2,249,8,257
https://kawalpemilu.org#57016,"LONGKO, WAE RII, MANGGARAI, NUSA TENGGARA TIMUR",3,216,13,229
https://kawalpemilu.org#57017,"RANGGI, WAE RII, MANGGARAI, NUSA TENGGARA TIMUR",1,126,13,139
https://kawalpemilu.org#57017,"RANGGI, WAE RII, MANGGARAI, NUSA TENGGARA TIMUR",2,225,22,247
https://kawalpemilu.org#57017,"RANGGI, WAE RII, MANGGARAI, NUSA TENGGARA TIMUR",3,225,22,247
https://kawalpemilu.org#57017,"RANGGI, WAE RII, MANGGARAI, NUSA TENGGARA TIMUR",4,147,3,150
https://kawalpemilu.org#57018,"COMPANG NDEHES, WAE RII, MANGGARAI, NUSA TENGGARA TIMUR",1,204,4,208
https://kawalpemilu.org#57018,"COMPANG NDEHES, WAE RII, MANGGARAI, NUSA TENGGARA TIMUR",2,212,11,223
https://kawalpemilu.org#57018,"COMPANG NDEHES, WAE RII, MANGGARAI, NUSA TENGGARA TIMUR",3,60,5,65
https://kawalpemilu.org#57018,"COMPANG NDEHES, WAE RII, MANGGARAI, NUSA TENGGARA TIMUR",4,158,5,163
https://kawalpemilu.org#57018,"COMPANG NDEHES, WAE RII, MANGGARAI, NUSA TENGGARA TIMUR",5,154,11,165
https://kawalpemilu.org#57019,"BANGKA JONG, WAE RII, MANGGARAI, NUSA TENGGARA TIMUR",1,226,13,239
https://kawalpemilu.org#57019,"BANGKA JONG, WAE RII, MANGGARAI, NUSA TENGGARA TIMUR",2,233,16,249
https://kawalpemilu.org#57019,"BANGKA JONG, WAE RII, MANGGARAI, NUSA TENGGARA TIMUR",3,184,10,194
https://kawalpemilu.org#57020,"BANGKA KENDA, WAE RII, MANGGARAI, NUSA TENGGARA TIMUR",1,205,17,222
https://kawalpemilu.org#57020,"BANGKA KENDA, WAE RII, MANGGARAI, NUSA TENGGARA TIMUR",2,146,9,155
https://kawalpemilu.org#57020,"BANGKA KENDA, WAE RII, MANGGARAI, NUSA TENGGARA TIMUR",3,133,8,141
https://kawalpemilu.org#57020,"BANGKA KENDA, WAE RII, MANGGARAI, NUSA TENGGARA TIMUR",4,184,10,194
https://kawalpemilu.org#57020,"BANGKA KENDA, WAE RII, MANGGARAI, NUSA TENGGARA TIMUR",5,149,5,154
https://kawalpemilu.org#57020,"BANGKA KENDA, WAE RII, MANGGARAI, NUSA TENGGARA TIMUR",6,221,10,231
https://kawalpemilu.org#57020,"BANGKA KENDA, WAE RII, MANGGARAI, NUSA TENGGARA TIMUR",7,117,14,131
https://kawalpemilu.org#57020,"BANGKA KENDA, WAE RII, MANGGARAI, NUSA TENGGARA TIMUR",8,112,8,120
https://kawalpemilu.org#57021,"GOLO MENDO, WAE RII, MANGGARAI, NUSA TENGGARA TIMUR",1,225,6,231
https://kawalpemilu.org#57021,"GOLO MENDO, WAE RII, MANGGARAI, NUSA TENGGARA TIMUR",2,192,6,198
https://kawalpemilu.org#57021,"GOLO MENDO, WAE RII, MANGGARAI, NUSA TENGGARA TIMUR",3,142,11,153
https://kawalpemilu.org#57022,"GOLO WUA, WAE RII, MANGGARAI, NUSA TENGGARA TIMUR",1,187,6,193
https://kawalpemilu.org#57022,"GOLO WUA, WAE RII, MANGGARAI, NUSA TENGGARA TIMUR",2,140,9,149
https://kawalpemilu.org#57022,"GOLO WUA, WAE RII, MANGGARAI, NUSA TENGGARA TIMUR",3,149,2,151
https://kawalpemilu.org#57023,"WAE RII, WAE RII, MANGGARAI, NUSA TENGGARA TIMUR",1,240,9,249
https://kawalpemilu.org#57023,"WAE RII, WAE RII, MANGGARAI, NUSA TENGGARA TIMUR",2,243,13,256
https://kawalpemilu.org#57023,"WAE RII, WAE RII, MANGGARAI, NUSA TENGGARA TIMUR",3,247,11,258
https://kawalpemilu.org#57023,"WAE RII, WAE RII, MANGGARAI, NUSA TENGGARA TIMUR",4,237,12,249
https://kawalpemilu.org#57023,"WAE RII, WAE RII, MANGGARAI, NUSA TENGGARA TIMUR",5,221,8,229
https://kawalpemilu.org#57024,"RANAKA, WAE RII, MANGGARAI, NUSA TENGGARA TIMUR",1,231,4,235
https://kawalpemilu.org#57024,"RANAKA, WAE RII, MANGGARAI, NUSA TENGGARA TIMUR",2,240,7,248
https://kawalpemilu.org#57024,"RANAKA, WAE RII, MANGGARAI, NUSA TENGGARA TIMUR",3,200,9,209
https://kawalpemilu.org#57024,"RANAKA, WAE RII, MANGGARAI, NUSA TENGGARA TIMUR",4,212,11,223
https://kawalpemilu.org#57025,"GOLO WATU, WAE RII, MANGGARAI, NUSA TENGGARA TIMUR",1,224,20,244
https://kawalpemilu.org#57025,"GOLO WATU, WAE RII, MANGGARAI, NUSA TENGGARA TIMUR",2,228,18,246
https://kawalpemilu.org#57025,"GOLO WATU, WAE RII, MANGGARAI, NUSA TENGGARA TIMUR",3,174,8,182
https://kawalpemilu.org#57025,"GOLO WATU, WAE RII, MANGGARAI, NUSA TENGGARA TIMUR",4,186,17,203
https://kawalpemilu.org#57025,"GOLO WATU, WAE RII, MANGGARAI, NUSA TENGGARA TIMUR",5,189,16,205
https://kawalpemilu.org#87842,"BENTENG POCO, WAE RII, MANGGARAI, NUSA TENGGARA TIMUR",1,201,3,204
https://kawalpemilu.org#87842,"BENTENG POCO, WAE RII, MANGGARAI, NUSA TENGGARA TIMUR",2,127,9,136
https://kawalpemilu.org#87842,"BENTENG POCO, WAE RII, MANGGARAI, NUSA TENGGARA TIMUR",3,126,2,128
https://kawalpemilu.org#57027,"WAE BELANG, RUTENG, MANGGARAI, NUSA TENGGARA TIMUR",1,183,22,205
https://kawalpemilu.org#57027,"WAE BELANG, RUTENG, MANGGARAI, NUSA TENGGARA TIMUR",3,177,16,193
https://kawalpemilu.org#57027,"WAE BELANG, RUTENG, MANGGARAI, NUSA TENGGARA TIMUR",4,76,3,79
https://kawalpemilu.org#57027,"WAE BELANG, RUTENG, MANGGARAI, NUSA TENGGARA TIMUR",5,163,9,172
https://kawalpemilu.org#57027,"WAE BELANG, RUTENG, MANGGARAI, NUSA TENGGARA TIMUR",6,158,9,167
https://kawalpemilu.org#57027,"WAE BELANG, RUTENG, MANGGARAI, NUSA TENGGARA TIMUR",7,193,18,211
https://kawalpemilu.org#57027,"WAE BELANG, RUTENG, MANGGARAI, NUSA TENGGARA TIMUR",8,200,12,212
https://kawalpemilu.org#57027,"WAE BELANG, RUTENG, MANGGARAI, NUSA TENGGARA TIMUR",9,211,13,224
https://kawalpemilu.org#57027,"WAE BELANG, RUTENG, MANGGARAI, NUSA TENGGARA TIMUR",10,178,13,191
https://kawalpemilu.org#57027,"WAE BELANG, RUTENG, MANGGARAI, NUSA TENGGARA TIMUR",11,139,11,150
https://kawalpemilu.org#57028,"CUMBI, RUTENG, MANGGARAI, NUSA TENGGARA TIMUR",1,151,9,160
https://kawalpemilu.org#57028,"CUMBI, RUTENG, MANGGARAI, NUSA TENGGARA TIMUR",2,198,8,206
https://kawalpemilu.org#57028,"CUMBI, RUTENG, MANGGARAI, NUSA TENGGARA TIMUR",3,194,9,203
https://kawalpemilu.org#57028,"CUMBI, RUTENG, MANGGARAI, NUSA TENGGARA TIMUR",4,132,20,152
https://kawalpemilu.org#57028,"CUMBI, RUTENG, MANGGARAI, NUSA TENGGARA TIMUR",5,123,6,129
https://kawalpemilu.org#57028,"CUMBI, RUTENG, MANGGARAI, NUSA TENGGARA TIMUR",6,119,13,132
https://kawalpemilu.org#57028,"CUMBI, RUTENG, MANGGARAI, NUSA TENGGARA TIMUR",7,110,14,124
https://kawalpemilu.org#57029,"KAKOR, RUTENG, MANGGARAI, NUSA TENGGARA TIMUR",1,165,16,181
https://kawalpemilu.org#57029,"KAKOR, RUTENG, MANGGARAI, NUSA TENGGARA TIMUR",2,177,8,185
https://kawalpemilu.org#57029,"KAKOR, RUTENG, MANGGARAI, NUSA TENGGARA TIMUR",3,191,8,199
https://kawalpemilu.org#57029,"KAKOR, RUTENG, MANGGARAI, NUSA TENGGARA TIMUR",4,168,5,173
https://kawalpemilu.org#57029,"KAKOR, RUTENG, MANGGARAI, NUSA TENGGARA TIMUR",5,162,17,179
https://kawalpemilu.org#57030,"PONG MURUNG, RUTENG, MANGGARAI, NUSA TENGGARA TIMUR",1,128,3,131
https://kawalpemilu.org#57030,"PONG MURUNG, RUTENG, MANGGARAI, NUSA TENGGARA TIMUR",2,117,4,121
https://kawalpemilu.org#57030,"PONG MURUNG, RUTENG, MANGGARAI, NUSA TENGGARA TIMUR",3,120,4,124
https://kawalpemilu.org#57030,"PONG MURUNG, RUTENG, MANGGARAI, NUSA TENGGARA TIMUR",4,120,1,121
https://kawalpemilu.org#57030,"PONG MURUNG, RUTENG, MANGGARAI, NUSA TENGGARA TIMUR",5,105,2,107
https://kawalpemilu.org#57030,"PONG MURUNG, RUTENG, MANGGARAI, NUSA TENGGARA TIMUR",6,149,6,155
https://kawalpemilu.org#57030,"PONG MURUNG, RUTENG, MANGGARAI, NUSA TENGGARA TIMUR",7,134,12,146
https://kawalpemilu.org#57030,"PONG MURUNG, RUTENG, MANGGARAI, NUSA TENGGARA TIMUR",8,160,10,170
https://kawalpemilu.org#57030,"PONG MURUNG, RUTENG, MANGGARAI, NUSA TENGGARA TIMUR",9,158,9,167
https://kawalpemilu.org#57030,"PONG MURUNG, RUTENG, MANGGARAI, NUSA TENGGARA TIMUR",10,184,9,193
https://kawalpemilu.org#57030,"PONG MURUNG, RUTENG, MANGGARAI, NUSA TENGGARA TIMUR",11,184,6,190
https://kawalpemilu.org#57031,"BULAN, RUTENG, MANGGARAI, NUSA TENGGARA TIMUR",1,119,2,121
https://kawalpemilu.org#57031,"BULAN, RUTENG, MANGGARAI, NUSA TENGGARA TIMUR",2,157,10,167
https://kawalpemilu.org#57031,"BULAN, RUTENG, MANGGARAI, NUSA TENGGARA TIMUR",3,144,9,153
https://kawalpemilu.org#57031,"BULAN, RUTENG, MANGGARAI, NUSA TENGGARA TIMUR",4,133,11,144
https://kawalpemilu.org#57031,"BULAN, RUTENG, MANGGARAI, NUSA TENGGARA TIMUR",5,162,4,166
https://kawalpemilu.org#57031,"BULAN, RUTENG, MANGGARAI, NUSA TENGGARA TIMUR",6,159,3,162
https://kawalpemilu.org#57031,"BULAN, RUTENG, MANGGARAI, NUSA TENGGARA TIMUR",7,96,13,109
https://kawalpemilu.org#57031,"BULAN, RUTENG, MANGGARAI, NUSA TENGGARA TIMUR",8,117,11,128
https://kawalpemilu.org#57031,"BULAN, RUTENG, MANGGARAI, NUSA TENGGARA TIMUR",9,132,17,149
https://kawalpemilu.org#57031,"BULAN, RUTENG, MANGGARAI, NUSA TENGGARA TIMUR",10,149,17,166
https://kawalpemilu.org#57031,"BULAN, RUTENG, MANGGARAI, NUSA TENGGARA TIMUR",11,167,19,186
https://kawalpemilu.org#57031,"BULAN, RUTENG, MANGGARAI, NUSA TENGGARA TIMUR",12,112,12,124
https://kawalpemilu.org#57032,"PONG LAO, RUTENG, MANGGARAI, NUSA TENGGARA TIMUR",1,237,2,239
https://kawalpemilu.org#57032,"PONG LAO, RUTENG, MANGGARAI, NUSA TENGGARA TIMUR",2,196,5,201
https://kawalpemilu.org#57032,"PONG LAO, RUTENG, MANGGARAI, NUSA TENGGARA TIMUR",4,125,5,130
https://kawalpemilu.org#57032,"PONG LAO, RUTENG, MANGGARAI, NUSA TENGGARA TIMUR",5,156,9,165
https://kawalpemilu.org#57033,"BEO RAHONG, RUTENG, MANGGARAI, NUSA TENGGARA TIMUR",1,200,6,206
https://kawalpemilu.org#57033,"BEO RAHONG, RUTENG, MANGGARAI, NUSA TENGGARA TIMUR",2,119,1,120
https://kawalpemilu.org#57033,"BEO RAHONG, RUTENG, MANGGARAI, NUSA TENGGARA TIMUR",3,182,8,190
https://kawalpemilu.org#57033,"BEO RAHONG, RUTENG, MANGGARAI, NUSA TENGGARA TIMUR",4,181,15,196
https://kawalpemilu.org#57033,"BEO RAHONG, RUTENG, MANGGARAI, NUSA TENGGARA TIMUR",5,167,6,173
https://kawalpemilu.org#57033,"BEO RAHONG, RUTENG, MANGGARAI, NUSA TENGGARA TIMUR",6,66,9,75
https://kawalpemilu.org#57033,"BEO RAHONG, RUTENG, MANGGARAI, NUSA TENGGARA TIMUR",7,177,6,183
https://kawalpemilu.org#57033,"BEO RAHONG, RUTENG, MANGGARAI, NUSA TENGGARA TIMUR",8,172,2,174
https://kawalpemilu.org#57034,"GOLO WOROK, RUTENG, MANGGARAI, NUSA TENGGARA TIMUR",1,134,10,144
https://kawalpemilu.org#57034,"GOLO WOROK, RUTENG, MANGGARAI, NUSA TENGGARA TIMUR",2,163,8,171
https://kawalpemilu.org#57034,"GOLO WOROK, RUTENG, MANGGARAI, NUSA TENGGARA TIMUR",3,179,1,180
https://kawalpemilu.org#57034,"GOLO WOROK, RUTENG, MANGGARAI, NUSA TENGGARA TIMUR",4,122,1,123
https://kawalpemilu.org#57034,"GOLO WOROK, RUTENG, MANGGARAI, NUSA TENGGARA TIMUR",5,222,6,228
https://kawalpemilu.org#57034,"GOLO WOROK, RUTENG, MANGGARAI, NUSA TENGGARA TIMUR",6,90,10,100
https://kawalpemilu.org#57035,"MELER, RUTENG, MANGGARAI, NUSA TENGGARA TIMUR",1,172,9,181
https://kawalpemilu.org#57035,"MELER, RUTENG, MANGGARAI, NUSA TENGGARA TIMUR",2,198,3,201
https://kawalpemilu.org#57035,"MELER, RUTENG, MANGGARAI, NUSA TENGGARA TIMUR",3,154,7,161
https://kawalpemilu.org#57035,"MELER, RUTENG, MANGGARAI, NUSA TENGGARA TIMUR",4,149,7,156
https://kawalpemilu.org#57035,"MELER, RUTENG, MANGGARAI, NUSA TENGGARA TIMUR",5,181,10,191
https://kawalpemilu.org#57035,"MELER, RUTENG, MANGGARAI, NUSA TENGGARA TIMUR",6,127,8,135
https://kawalpemilu.org#57035,"MELER, RUTENG, MANGGARAI, NUSA TENGGARA TIMUR",7,130,6,136
https://kawalpemilu.org#57035,"MELER, RUTENG, MANGGARAI, NUSA TENGGARA TIMUR",8,237,22,259
https://kawalpemilu.org#57036,"BENTENG KUWU, RUTENG, MANGGARAI, NUSA TENGGARA TIMUR",1,230,10,240
https://kawalpemilu.org#57036,"BENTENG KUWU, RUTENG, MANGGARAI, NUSA TENGGARA TIMUR",2,146,10,156
https://kawalpemilu.org#57036,"BENTENG KUWU, RUTENG, MANGGARAI, NUSA TENGGARA TIMUR",3,218,17,235
https://kawalpemilu.org#57036,"BENTENG KUWU, RUTENG, MANGGARAI, NUSA TENGGARA TIMUR",4,271,8,279
https://kawalpemilu.org#57036,"BENTENG KUWU, RUTENG, MANGGARAI, NUSA TENGGARA TIMUR",5,158,4,162
https://kawalpemilu.org#57036,"BENTENG KUWU, RUTENG, MANGGARAI, NUSA TENGGARA TIMUR",6,159,6,165
https://kawalpemilu.org#57036,"BENTENG KUWU, RUTENG, MANGGARAI, NUSA TENGGARA TIMUR",7,153,9,162
https://kawalpemilu.org#57037,"BELANG TURI, RUTENG, MANGGARAI, NUSA TENGGARA TIMUR",1,115,9,124
https://kawalpemilu.org#57037,"BELANG TURI, RUTENG, MANGGARAI, NUSA TENGGARA TIMUR",2,213,9,222
https://kawalpemilu.org#57037,"BELANG TURI, RUTENG, MANGGARAI, NUSA TENGGARA TIMUR",3,159,10,169
https://kawalpemilu.org#57037,"BELANG TURI, RUTENG, MANGGARAI, NUSA TENGGARA TIMUR",4,137,10,147
https://kawalpemilu.org#57037,"BELANG TURI, RUTENG, MANGGARAI, NUSA TENGGARA TIMUR",5,198,18,216
https://kawalpemilu.org#57037,"BELANG TURI, RUTENG, MANGGARAI, NUSA TENGGARA TIMUR",6,227,9,236
https://kawalpemilu.org#57038,"PONG LEKO, RUTENG, MANGGARAI, NUSA TENGGARA TIMUR",2,159,6,165
https://kawalpemilu.org#57038,"PONG LEKO, RUTENG, MANGGARAI, NUSA TENGGARA TIMUR",3,152,2,154
https://kawalpemilu.org#57038,"PONG LEKO, RUTENG, MANGGARAI, NUSA TENGGARA TIMUR",4,165,13,178
https://kawalpemilu.org#57038,"PONG LEKO, RUTENG, MANGGARAI, NUSA TENGGARA TIMUR",5,145,11,156
https://kawalpemilu.org#57038,"PONG LEKO, RUTENG, MANGGARAI, NUSA TENGGARA TIMUR",6,84,9,93
https://kawalpemilu.org#57039,"RAI, RUTENG, MANGGARAI, NUSA TENGGARA TIMUR",1,220,2,222
https://kawalpemilu.org#57039,"RAI, RUTENG, MANGGARAI, NUSA TENGGARA TIMUR",2,157,8,165
https://kawalpemilu.org#57039,"RAI, RUTENG, MANGGARAI, NUSA TENGGARA TIMUR",3,104,13,117
https://kawalpemilu.org#57039,"RAI, RUTENG, MANGGARAI, NUSA TENGGARA TIMUR",4,141,19,160
https://kawalpemilu.org#57039,"RAI, RUTENG, MANGGARAI, NUSA TENGGARA TIMUR",5,153,18,171
https://kawalpemilu.org#57039,"RAI, RUTENG, MANGGARAI, NUSA TENGGARA TIMUR",6,148,11,159
https://kawalpemilu.org#57039,"RAI, RUTENG, MANGGARAI, NUSA TENGGARA TIMUR",7,109,6,115
https://kawalpemilu.org#57040,"POCO LIKANG, RUTENG, MANGGARAI, NUSA TENGGARA TIMUR",1,203,7,210
https://kawalpemilu.org#57040,"POCO LIKANG, RUTENG, MANGGARAI, NUSA TENGGARA TIMUR",2,163,15,178
https://kawalpemilu.org#57040,"POCO LIKANG, RUTENG, MANGGARAI, NUSA TENGGARA TIMUR",3,159,9,168
https://kawalpemilu.org#57040,"POCO LIKANG, RUTENG, MANGGARAI, NUSA TENGGARA TIMUR",4,137,6,143
https://kawalpemilu.org#57040,"POCO LIKANG, RUTENG, MANGGARAI, NUSA TENGGARA TIMUR",5,150,9,159
https://kawalpemilu.org#57040,"POCO LIKANG, RUTENG, MANGGARAI, NUSA TENGGARA TIMUR",6,131,5,136
https://kawalpemilu.org#57040,"POCO LIKANG, RUTENG, MANGGARAI, NUSA TENGGARA TIMUR",7,208,6,214
https://kawalpemilu.org#57041,"BANGKA LAO, RUTENG, MANGGARAI, NUSA TENGGARA TIMUR",1,206,15,221
https://kawalpemilu.org#57041,"BANGKA LAO, RUTENG, MANGGARAI, NUSA TENGGARA TIMUR",2,202,26,228
https://kawalpemilu.org#57041,"BANGKA LAO, RUTENG, MANGGARAI, NUSA TENGGARA TIMUR",3,174,25,199
https://kawalpemilu.org#57041,"BANGKA LAO, RUTENG, MANGGARAI, NUSA TENGGARA TIMUR",4,169,7,176
https://kawalpemilu.org#57041,"BANGKA LAO, RUTENG, MANGGARAI, NUSA TENGGARA TIMUR",5,153,13,166
https://kawalpemilu.org#57041,"BANGKA LAO, RUTENG, MANGGARAI, NUSA TENGGARA TIMUR",6,200,22,222
https://kawalpemilu.org#57042,"COMPANG DALO, RUTENG, MANGGARAI, NUSA TENGGARA TIMUR",1,146,13,159
https://kawalpemilu.org#57042,"COMPANG DALO, RUTENG, MANGGARAI, NUSA TENGGARA TIMUR",2,145,4,149
https://kawalpemilu.org#57042,"COMPANG DALO, RUTENG, MANGGARAI, NUSA TENGGARA TIMUR",3,152,12,164
https://kawalpemilu.org#57042,"COMPANG DALO, RUTENG, MANGGARAI, NUSA TENGGARA TIMUR",4,161,18,179
https://kawalpemilu.org#57042,"COMPANG DALO, RUTENG, MANGGARAI, NUSA TENGGARA TIMUR",5,174,10,184
https://kawalpemilu.org#57042,"COMPANG DALO, RUTENG, MANGGARAI, NUSA TENGGARA TIMUR",6,194,12,206
https://kawalpemilu.org#87841,"PONG LALE, RUTENG, MANGGARAI, NUSA TENGGARA TIMUR",1,146,2,148
https://kawalpemilu.org#87841,"PONG LALE, RUTENG, MANGGARAI, NUSA TENGGARA TIMUR",2,145,2,147
https://kawalpemilu.org#87841,"PONG LALE, RUTENG, MANGGARAI, NUSA TENGGARA TIMUR",3,148,4,152
https://kawalpemilu.org#88091,"BEA KAKOR, RUTENG, MANGGARAI, NUSA TENGGARA TIMUR",1,175,11,186
https://kawalpemilu.org#88091,"BEA KAKOR, RUTENG, MANGGARAI, NUSA TENGGARA TIMUR",2,186,21,207
https://kawalpemilu.org#88091,"BEA KAKOR, RUTENG, MANGGARAI, NUSA TENGGARA TIMUR",3,196,15,211
https://kawalpemilu.org#88091,"BEA KAKOR, RUTENG, MANGGARAI, NUSA TENGGARA TIMUR",4,133,5,138
https://kawalpemilu.org#88092,"COMPANG NAMUT, RUTENG, MANGGARAI, NUSA TENGGARA TIMUR",1,202,11,213
https://kawalpemilu.org#88092,"COMPANG NAMUT, RUTENG, MANGGARAI, NUSA TENGGARA TIMUR",2,179,9,188
https://kawalpemilu.org#88092,"COMPANG NAMUT, RUTENG, MANGGARAI, NUSA TENGGARA TIMUR",3,175,2,177
https://kawalpemilu.org#88092,"COMPANG NAMUT, RUTENG, MANGGARAI, NUSA TENGGARA TIMUR",4,175,6,181
https://kawalpemilu.org#88092,"COMPANG NAMUT, RUTENG, MANGGARAI, NUSA TENGGARA TIMUR",5,59,2,61
https://kawalpemilu.org#57044,"JAONG, SATAR MESE, MANGGARAI, NUSA TENGGARA TIMUR",1,222,4,226
https://kawalpemilu.org#57044,"JAONG, SATAR MESE, MANGGARAI, NUSA TENGGARA TIMUR",2,231,9,240
https://kawalpemilu.org#57045,"PONGKOR, SATAR MESE, MANGGARAI, NUSA TENGGARA TIMUR",1,142,15,157
https://kawalpemilu.org#57045,"PONGKOR, SATAR MESE, MANGGARAI, NUSA TENGGARA TIMUR",2,240,12,252
https://kawalpemilu.org#57045,"PONGKOR, SATAR MESE, MANGGARAI, NUSA TENGGARA TIMUR",3,236,10,246
https://kawalpemilu.org#57045,"PONGKOR, SATAR MESE, MANGGARAI, NUSA TENGGARA TIMUR",4,154,8,162
https://kawalpemilu.org#57045,"PONGKOR, SATAR MESE, MANGGARAI, NUSA TENGGARA TIMUR",5,119,10,129
https://kawalpemilu.org#57046,"WAE AJANG, SATAR MESE, MANGGARAI, NUSA TENGGARA TIMUR",1,75,6,81
https://kawalpemilu.org#57046,"WAE AJANG, SATAR MESE, MANGGARAI, NUSA TENGGARA TIMUR",2,109,55,164
https://kawalpemilu.org#57046,"WAE AJANG, SATAR MESE, MANGGARAI, NUSA TENGGARA TIMUR",3,141,20,161
https://kawalpemilu.org#57046,"WAE AJANG, SATAR MESE, MANGGARAI, NUSA TENGGARA TIMUR",4,113,5,118
https://kawalpemilu.org#57046,"WAE AJANG, SATAR MESE, MANGGARAI, NUSA TENGGARA TIMUR",5,191,10,201
https://kawalpemilu.org#57046,"WAE AJANG, SATAR MESE, MANGGARAI, NUSA TENGGARA TIMUR",6,226,6,232
https://kawalpemilu.org#57047,"PAPANG, SATAR MESE, MANGGARAI, NUSA TENGGARA TIMUR",1,189,5,194
https://kawalpemilu.org#57047,"PAPANG, SATAR MESE, MANGGARAI, NUSA TENGGARA TIMUR",2,120,3,123
https://kawalpemilu.org#57047,"PAPANG, SATAR MESE, MANGGARAI, NUSA TENGGARA TIMUR",3,194,13,207
https://kawalpemilu.org#57047,"PAPANG, SATAR MESE, MANGGARAI, NUSA TENGGARA TIMUR",4,197,18,215
https://kawalpemilu.org#57047,"PAPANG, SATAR MESE, MANGGARAI, NUSA TENGGARA TIMUR",5,209,20,229
https://kawalpemilu.org#57047,"PAPANG, SATAR MESE, MANGGARAI, NUSA TENGGARA TIMUR",6,212,17,229
https://kawalpemilu.org#57048,"WEWO, SATAR MESE, MANGGARAI, NUSA TENGGARA TIMUR",1,240,17,257
https://kawalpemilu.org#57048,"WEWO, SATAR MESE, MANGGARAI, NUSA TENGGARA TIMUR",2,152,12,164
https://kawalpemilu.org#57048,"WEWO, SATAR MESE, MANGGARAI, NUSA TENGGARA TIMUR",3,118,3,121
https://kawalpemilu.org#57048,"WEWO, SATAR MESE, MANGGARAI, NUSA TENGGARA TIMUR",4,112,1,113
https://kawalpemilu.org#57048,"WEWO, SATAR MESE, MANGGARAI, NUSA TENGGARA TIMUR",5,151,6,157
https://kawalpemilu.org#57048,"WEWO, SATAR MESE, MANGGARAI, NUSA TENGGARA TIMUR",6,165,5,170
https://kawalpemilu.org#57048,"WEWO, SATAR MESE, MANGGARAI, NUSA TENGGARA TIMUR",7,218,4,222
https://kawalpemilu.org#57049,"LUNGAR, SATAR MESE, MANGGARAI, NUSA TENGGARA TIMUR",1,165,5,170
https://kawalpemilu.org#57049,"LUNGAR, SATAR MESE, MANGGARAI, NUSA TENGGARA TIMUR",2,198,7,205
https://kawalpemilu.org#57049,"LUNGAR, SATAR MESE, MANGGARAI, NUSA TENGGARA TIMUR",3,117,8,125
https://kawalpemilu.org#57049,"LUNGAR, SATAR MESE, MANGGARAI, NUSA TENGGARA TIMUR",4,75,3,78
https://kawalpemilu.org#57049,"LUNGAR, SATAR MESE, MANGGARAI, NUSA TENGGARA TIMUR",5,107,6,113
https://kawalpemilu.org#57050,"MOCOK, SATAR MESE, MANGGARAI, NUSA TENGGARA TIMUR",1,131,9,140
https://kawalpemilu.org#57050,"MOCOK, SATAR MESE, MANGGARAI, NUSA TENGGARA TIMUR",2,211,5,216
https://kawalpemilu.org#57050,"MOCOK, SATAR MESE, MANGGARAI, NUSA TENGGARA TIMUR",3,179,16,195
https://kawalpemilu.org#57050,"MOCOK, SATAR MESE, MANGGARAI, NUSA TENGGARA TIMUR",4,183,10,193
https://kawalpemilu.org#57051,"KOAK, SATAR MESE, MANGGARAI, NUSA TENGGARA TIMUR",1,202,19,221
https://kawalpemilu.org#57051,"KOAK, SATAR MESE, MANGGARAI, NUSA TENGGARA TIMUR",2,200,21,221
https://kawalpemilu.org#57051,"KOAK, SATAR MESE, MANGGARAI, NUSA TENGGARA TIMUR",3,195,15,210
https://kawalpemilu.org#57051,"KOAK, SATAR MESE, MANGGARAI, NUSA TENGGARA TIMUR",4,160,11,171
https://kawalpemilu.org#57052,"LANGGO, SATAR MESE, MANGGARAI, NUSA TENGGARA TIMUR",1,191,12,203
https://kawalpemilu.org#57052,"LANGGO, SATAR MESE, MANGGARAI, NUSA TENGGARA TIMUR",2,136,14,150
https://kawalpemilu.org#57052,"LANGGO, SATAR MESE, MANGGARAI, NUSA TENGGARA TIMUR",3,121,7,128
https://kawalpemilu.org#57052,"LANGGO, SATAR MESE, MANGGARAI, NUSA TENGGARA TIMUR",4,123,5,128
https://kawalpemilu.org#57052,"LANGGO, SATAR MESE, MANGGARAI, NUSA TENGGARA TIMUR",5,105,4,109
https://kawalpemilu.org#57053,"LEGU, SATAR MESE, MANGGARAI, NUSA TENGGARA TIMUR",1,36,105,141
https://kawalpemilu.org#57053,"LEGU, SATAR MESE, MANGGARAI, NUSA TENGGARA TIMUR",2,52,109,161
https://kawalpemilu.org#57053,"LEGU, SATAR MESE, MANGGARAI, NUSA TENGGARA TIMUR",3,223,11,234
https://kawalpemilu.org#57053,"LEGU, SATAR MESE, MANGGARAI, NUSA TENGGARA TIMUR",4,182,9,191
https://kawalpemilu.org#57053,"LEGU, SATAR MESE, MANGGARAI, NUSA TENGGARA TIMUR",5,176,8,184
https://kawalpemilu.org#57053,"LEGU, SATAR MESE, MANGGARAI, NUSA TENGGARA TIMUR",6,149,4,153
https://kawalpemilu.org#57054,"PAKA, SATAR MESE, MANGGARAI, NUSA TENGGARA TIMUR",1,160,24,184
https://kawalpemilu.org#57054,"PAKA, SATAR MESE, MANGGARAI, NUSA TENGGARA TIMUR",2,179,11,190
https://kawalpemilu.org#57054,"PAKA, SATAR MESE, MANGGARAI, NUSA TENGGARA TIMUR",3,145,15,160
https://kawalpemilu.org#57054,"PAKA, SATAR MESE, MANGGARAI, NUSA TENGGARA TIMUR",4,180,15,195
https://kawalpemilu.org#57054,"PAKA, SATAR MESE, MANGGARAI, NUSA TENGGARA TIMUR",5,202,3,205
https://kawalpemilu.org#57055,"TAL, SATAR MESE, MANGGARAI, NUSA TENGGARA TIMUR",1,152,36,188
https://kawalpemilu.org#57055,"TAL, SATAR MESE, MANGGARAI, NUSA TENGGARA TIMUR",2,116,14,130
https://kawalpemilu.org#57055,"TAL, SATAR MESE, MANGGARAI, NUSA TENGGARA TIMUR",3,157,6,163
https://kawalpemilu.org#57055,"TAL, SATAR MESE, MANGGARAI, NUSA TENGGARA TIMUR",4,105,6,111
https://kawalpemilu.org#57055,"TAL, SATAR MESE, MANGGARAI, NUSA TENGGARA TIMUR",5,120,11,129
https://kawalpemilu.org#57055,"TAL, SATAR MESE, MANGGARAI, NUSA TENGGARA TIMUR",6,111,53,164
https://kawalpemilu.org#57056,"GOLO LAMBO, SATAR MESE, MANGGARAI, NUSA TENGGARA TIMUR",1,232,11,243
https://kawalpemilu.org#57056,"GOLO LAMBO, SATAR MESE, MANGGARAI, NUSA TENGGARA TIMUR",2,155,7,162
https://kawalpemilu.org#57057,"NGKAER, SATAR MESE, MANGGARAI, NUSA TENGGARA TIMUR",1,148,11,159
https://kawalpemilu.org#57057,"NGKAER, SATAR MESE, MANGGARAI, NUSA TENGGARA TIMUR",2,121,11,132
https://kawalpemilu.org#57057,"NGKAER, SATAR MESE, MANGGARAI, NUSA TENGGARA TIMUR",3,150,19,169
https://kawalpemilu.org#57058,"UMUNG, SATAR MESE, MANGGARAI, NUSA TENGGARA TIMUR",1,218,12,230
https://kawalpemilu.org#57058,"UMUNG, SATAR MESE, MANGGARAI, NUSA TENGGARA TIMUR",2,217,14,231
https://kawalpemilu.org#57058,"UMUNG, SATAR MESE, MANGGARAI, NUSA TENGGARA TIMUR",3,176,8,184
https://kawalpemilu.org#57058,"UMUNG, SATAR MESE, MANGGARAI, NUSA TENGGARA TIMUR",4,215,7,222
https://kawalpemilu.org#57059,"TADO, SATAR MESE, MANGGARAI, NUSA TENGGARA TIMUR",1,161,12,173
https://kawalpemilu.org#57059,"TADO, SATAR MESE, MANGGARAI, NUSA TENGGARA TIMUR",2,106,21,127
https://kawalpemilu.org#57059,"TADO, SATAR MESE, MANGGARAI, NUSA TENGGARA TIMUR",3,165,15,180
https://kawalpemilu.org#57060,"GARA, SATAR MESE, MANGGARAI, NUSA TENGGARA TIMUR",1,183,10,193
https://kawalpemilu.org#57060,"GARA, SATAR MESE, MANGGARAI, NUSA TENGGARA TIMUR",2,189,10,199
https://kawalpemilu.org#57060,"GARA, SATAR MESE, MANGGARAI, NUSA TENGGARA TIMUR",3,121,2,123
https://kawalpemilu.org#57061,"GOLO MUNTAS, SATAR MESE, MANGGARAI, NUSA TENGGARA TIMUR",1,150,14,164
https://kawalpemilu.org#57061,"GOLO MUNTAS, SATAR MESE, MANGGARAI, NUSA TENGGARA TIMUR",2,106,8,114
https://kawalpemilu.org#57061,"GOLO MUNTAS, SATAR MESE, MANGGARAI, NUSA TENGGARA TIMUR",3,190,17,207
https://kawalpemilu.org#57061,"GOLO MUNTAS, SATAR MESE, MANGGARAI, NUSA TENGGARA TIMUR",4,145,6,151
https://kawalpemilu.org#57062,"PONGGEOK, SATAR MESE, MANGGARAI, NUSA TENGGARA TIMUR",1,196,16,212
https://kawalpemilu.org#57062,"PONGGEOK, SATAR MESE, MANGGARAI, NUSA TENGGARA TIMUR",2,200,13,213
https://kawalpemilu.org#57062,"PONGGEOK, SATAR MESE, MANGGARAI, NUSA TENGGARA TIMUR",3,158,13,171
https://kawalpemilu.org#57062,"PONGGEOK, SATAR MESE, MANGGARAI, NUSA TENGGARA TIMUR",4,137,6,143
https://kawalpemilu.org#87834,"ITENG, SATAR MESE, MANGGARAI, NUSA TENGGARA TIMUR",1,187,29,216
https://kawalpemilu.org#87834,"ITENG, SATAR MESE, MANGGARAI, NUSA TENGGARA TIMUR",2,180,8,188
https://kawalpemilu.org#87834,"ITENG, SATAR MESE, MANGGARAI, NUSA TENGGARA TIMUR",3,206,20,226
https://kawalpemilu.org#87835,"SATAR LOUNG, SATAR MESE, MANGGARAI, NUSA TENGGARA TIMUR",1,184,22,206
https://kawalpemilu.org#87835,"SATAR LOUNG, SATAR MESE, MANGGARAI, NUSA TENGGARA TIMUR",2,211,3,214
https://kawalpemilu.org#87835,"SATAR LOUNG, SATAR MESE, MANGGARAI, NUSA TENGGARA TIMUR",3,71,1,72
https://kawalpemilu.org#87836,"LOLANG, SATAR MESE, MANGGARAI, NUSA TENGGARA TIMUR",1,193,10,203
https://kawalpemilu.org#87836,"LOLANG, SATAR MESE, MANGGARAI, NUSA TENGGARA TIMUR",2,159,7,166
https://kawalpemilu.org#87836,"LOLANG, SATAR MESE, MANGGARAI, NUSA TENGGARA TIMUR",3,164,1,165
https://kawalpemilu.org#87836,"LOLANG, SATAR MESE, MANGGARAI, NUSA TENGGARA TIMUR",4,144,8,152
https://kawalpemilu.org#87836,"LOLANG, SATAR MESE, MANGGARAI, NUSA TENGGARA TIMUR",5,153,15,168
https://kawalpemilu.org#87836,"LOLANG, SATAR MESE, MANGGARAI, NUSA TENGGARA TIMUR",6,126,9,135
https://kawalpemilu.org#87837,"ULU BELANG, SATAR MESE, MANGGARAI, NUSA TENGGARA TIMUR",1,175,9,184
https://kawalpemilu.org#87837,"ULU BELANG, SATAR MESE, MANGGARAI, NUSA TENGGARA TIMUR",2,151,9,160
https://kawalpemilu.org#87837,"ULU BELANG, SATAR MESE, MANGGARAI, NUSA TENGGARA TIMUR",3,116,3,119
https://kawalpemilu.org#87837,"ULU BELANG, SATAR MESE, MANGGARAI, NUSA TENGGARA TIMUR",4,105,6,111
https://kawalpemilu.org#57064,"PAGAL, CIBAL, MANGGARAI, NUSA TENGGARA TIMUR",1,169,9,178
https://kawalpemilu.org#57064,"PAGAL, CIBAL, MANGGARAI, NUSA TENGGARA TIMUR",2,161,10,171
https://kawalpemilu.org#57064,"PAGAL, CIBAL, MANGGARAI, NUSA TENGGARA TIMUR",3,197,15,212
https://kawalpemilu.org#57064,"PAGAL, CIBAL, MANGGARAI, NUSA TENGGARA TIMUR",4,194,17,211
https://kawalpemilu.org#57064,"PAGAL, CIBAL, MANGGARAI, NUSA TENGGARA TIMUR",5,189,10,199
https://kawalpemilu.org#57064,"PAGAL, CIBAL, MANGGARAI, NUSA TENGGARA TIMUR",6,228,15,243
https://kawalpemilu.org#57065,"NENU, CIBAL, MANGGARAI, NUSA TENGGARA TIMUR",1,249,9,258
https://kawalpemilu.org#57065,"NENU, CIBAL, MANGGARAI, NUSA TENGGARA TIMUR",2,166,8,174
https://kawalpemilu.org#57065,"NENU, CIBAL, MANGGARAI, NUSA TENGGARA TIMUR",3,203,6,209
https://kawalpemilu.org#57065,"NENU, CIBAL, MANGGARAI, NUSA TENGGARA TIMUR",4,121,2,123
https://kawalpemilu.org#57065,"NENU, CIBAL, MANGGARAI, NUSA TENGGARA TIMUR",5,164,6,170
https://kawalpemilu.org#57065,"NENU, CIBAL, MANGGARAI, NUSA TENGGARA TIMUR",6,116,5,121
https://kawalpemilu.org#57065,"NENU, CIBAL, MANGGARAI, NUSA TENGGARA TIMUR",7,182,5,187
https://kawalpemilu.org#57066,"RADO, CIBAL, MANGGARAI, NUSA TENGGARA TIMUR",1,207,6,213
https://kawalpemilu.org#57066,"RADO, CIBAL, MANGGARAI, NUSA TENGGARA TIMUR",2,222,7,229
https://kawalpemilu.org#57066,"RADO, CIBAL, MANGGARAI, NUSA TENGGARA TIMUR",3,181,13,194
https://kawalpemilu.org#57066,"RADO, CIBAL, MANGGARAI, NUSA TENGGARA TIMUR",4,151,8,159
https://kawalpemilu.org#57070,"WUDI, CIBAL, MANGGARAI, NUSA TENGGARA TIMUR",1,211,33,244
https://kawalpemilu.org#57070,"WUDI, CIBAL, MANGGARAI, NUSA TENGGARA TIMUR",2,130,10,140
https://kawalpemilu.org#57070,"WUDI, CIBAL, MANGGARAI, NUSA TENGGARA TIMUR",3,185,18,203
https://kawalpemilu.org#57070,"WUDI, CIBAL, MANGGARAI, NUSA TENGGARA TIMUR",4,168,11,179
https://kawalpemilu.org#57070,"WUDI, CIBAL, MANGGARAI, NUSA TENGGARA TIMUR",5,86,5,91
https://kawalpemilu.org#57071,"WELU, CIBAL, MANGGARAI, NUSA TENGGARA TIMUR",1,231,10,241
https://kawalpemilu.org#57071,"WELU, CIBAL, MANGGARAI, NUSA TENGGARA TIMUR",2,142,13,155
https://kawalpemilu.org#57071,"WELU, CIBAL, MANGGARAI, NUSA TENGGARA TIMUR",3,140,9,149
https://kawalpemilu.org#57071,"WELU, CIBAL, MANGGARAI, NUSA TENGGARA TIMUR",4,242,20,262
https://kawalpemilu.org#57071,"WELU, CIBAL, MANGGARAI, NUSA TENGGARA TIMUR",5,104,13,117
https://kawalpemilu.org#57071,"WELU, CIBAL, MANGGARAI, NUSA TENGGARA TIMUR",6,120,7,127
https://kawalpemilu.org#57072,"GOLO, CIBAL, MANGGARAI, NUSA TENGGARA TIMUR",1,182,10,192
https://kawalpemilu.org#57072,"GOLO, CIBAL, MANGGARAI, NUSA TENGGARA TIMUR",2,149,13,162
https://kawalpemilu.org#57072,"GOLO, CIBAL, MANGGARAI, NUSA TENGGARA TIMUR",3,158,5,163
https://kawalpemilu.org#57072,"GOLO, CIBAL, MANGGARAI, NUSA TENGGARA TIMUR",4,206,6,212
https://kawalpemilu.org#57073,"BARANG, CIBAL, MANGGARAI, NUSA TENGGARA TIMUR",1,218,23,241
https://kawalpemilu.org#57073,"BARANG, CIBAL, MANGGARAI, NUSA TENGGARA TIMUR",2,177,22,199
https://kawalpemilu.org#57073,"BARANG, CIBAL, MANGGARAI, NUSA TENGGARA TIMUR",3,225,15,240
https://kawalpemilu.org#57074,"PERAK, CIBAL, MANGGARAI, NUSA TENGGARA TIMUR",1,130,14,144
https://kawalpemilu.org#57074,"PERAK, CIBAL, MANGGARAI, NUSA TENGGARA TIMUR",2,137,5,142
https://kawalpemilu.org#57074,"PERAK, CIBAL, MANGGARAI, NUSA TENGGARA TIMUR",3,143,16,159
https://kawalpemilu.org#57074,"PERAK, CIBAL, MANGGARAI, NUSA TENGGARA TIMUR",4,85,17,102
https://kawalpemilu.org#57074,"PERAK, CIBAL, MANGGARAI, NUSA TENGGARA TIMUR",5,133,9,142
https://kawalpemilu.org#57075,"BEA MESE, CIBAL, MANGGARAI, NUSA TENGGARA TIMUR",1,160,21,181
https://kawalpemilu.org#57075,"BEA MESE, CIBAL, MANGGARAI, NUSA TENGGARA TIMUR",2,219,7,226
https://kawalpemilu.org#57075,"BEA MESE, CIBAL, MANGGARAI, NUSA TENGGARA TIMUR",3,135,4,139
https://kawalpemilu.org#57075,"BEA MESE, CIBAL, MANGGARAI, NUSA TENGGARA TIMUR",4,103,6,109
https://kawalpemilu.org#57076,"LANGKAS, CIBAL, MANGGARAI, NUSA TENGGARA TIMUR",1,180,12,192
https://kawalpemilu.org#57076,"LANGKAS, CIBAL, MANGGARAI, NUSA TENGGARA TIMUR",2,164,18,182
https://kawalpemilu.org#57076,"LANGKAS, CIBAL, MANGGARAI, NUSA TENGGARA TIMUR",3,160,8,168
https://kawalpemilu.org#57076,"LANGKAS, CIBAL, MANGGARAI, NUSA TENGGARA TIMUR",4,168,6,174
https://kawalpemilu.org#57077,"LADUR, CIBAL, MANGGARAI, NUSA TENGGARA TIMUR",1,138,3,141
https://kawalpemilu.org#57077,"LADUR, CIBAL, MANGGARAI, NUSA TENGGARA TIMUR",2,174,5,179
https://kawalpemilu.org#57077,"LADUR, CIBAL, MANGGARAI, NUSA TENGGARA TIMUR",3,180,29,209
https://kawalpemilu.org#57077,"LADUR, CIBAL, MANGGARAI, NUSA TENGGARA TIMUR",4,170,9,179
https://kawalpemilu.org#57077,"LADUR, CIBAL, MANGGARAI, NUSA TENGGARA TIMUR",5,134,2,136
https://kawalpemilu.org#57077,"LADUR, CIBAL, MANGGARAI, NUSA TENGGARA TIMUR",6,159,2,161
https://kawalpemilu.org#57078,"KENTOL, CIBAL, MANGGARAI, NUSA TENGGARA TIMUR",1,78,11,89
https://kawalpemilu.org#57078,"KENTOL, CIBAL, MANGGARAI, NUSA TENGGARA TIMUR",2,151,5,156
https://kawalpemilu.org#57078,"KENTOL, CIBAL, MANGGARAI, NUSA TENGGARA TIMUR",3,121,8,129
https://kawalpemilu.org#57078,"KENTOL, CIBAL, MANGGARAI, NUSA TENGGARA TIMUR",4,137,4,141
https://kawalpemilu.org#57079,"RIUNG, CIBAL, MANGGARAI, NUSA TENGGARA TIMUR",1,185,33,218
https://kawalpemilu.org#57079,"RIUNG, CIBAL, MANGGARAI, NUSA TENGGARA TIMUR",2,148,14,162
https://kawalpemilu.org#57079,"RIUNG, CIBAL, MANGGARAI, NUSA TENGGARA TIMUR",3,137,22,159
https://kawalpemilu.org#57079,"RIUNG, CIBAL, MANGGARAI, NUSA TENGGARA TIMUR",4,146,13,159
https://kawalpemilu.org#57079,"RIUNG, CIBAL, MANGGARAI, NUSA TENGGARA TIMUR",5,189,5,194
https://kawalpemilu.org#57079,"RIUNG, CIBAL, MANGGARAI, NUSA TENGGARA TIMUR",6,189,4,193
https://kawalpemilu.org#57086,"PINGGANG, CIBAL, MANGGARAI, NUSA TENGGARA TIMUR",1,216,9,225
https://kawalpemilu.org#57086,"PINGGANG, CIBAL, MANGGARAI, NUSA TENGGARA TIMUR",2,203,19,222
https://kawalpemilu.org#57086,"PINGGANG, CIBAL, MANGGARAI, NUSA TENGGARA TIMUR",3,175,14,189
https://kawalpemilu.org#57086,"PINGGANG, CIBAL, MANGGARAI, NUSA TENGGARA TIMUR",4,164,15,179
https://kawalpemilu.org#57088,"LANDO, CIBAL, MANGGARAI, NUSA TENGGARA TIMUR",1,136,10,146
https://kawalpemilu.org#57088,"LANDO, CIBAL, MANGGARAI, NUSA TENGGARA TIMUR",2,102,8,110
https://kawalpemilu.org#57088,"LANDO, CIBAL, MANGGARAI, NUSA TENGGARA TIMUR",3,185,8,193
https://kawalpemilu.org#57089,"GAPONG, CIBAL, MANGGARAI, NUSA TENGGARA TIMUR",1,185,15,200
https://kawalpemilu.org#57089,"GAPONG, CIBAL, MANGGARAI, NUSA TENGGARA TIMUR",2,175,13,188
https://kawalpemilu.org#57089,"GAPONG, CIBAL, MANGGARAI, NUSA TENGGARA TIMUR",3,196,35,231
https://kawalpemilu.org#57090,"GOLO NCUANG, CIBAL, MANGGARAI, NUSA TENGGARA TIMUR",1,160,3,163
https://kawalpemilu.org#57090,"GOLO NCUANG, CIBAL, MANGGARAI, NUSA TENGGARA TIMUR",2,188,2,190
https://kawalpemilu.org#57090,"GOLO NCUANG, CIBAL, MANGGARAI, NUSA TENGGARA TIMUR",3,155,8,163
https://kawalpemilu.org#57090,"GOLO NCUANG, CIBAL, MANGGARAI, NUSA TENGGARA TIMUR",4,210,5,215
https://kawalpemilu.org#57092,"REO, REOK, MANGGARAI, NUSA TENGGARA TIMUR",1,69,80,149
https://kawalpemilu.org#57092,"REO, REOK, MANGGARAI, NUSA TENGGARA TIMUR",2,57,76,133
https://kawalpemilu.org#57092,"REO, REOK, MANGGARAI, NUSA TENGGARA TIMUR",3,112,104,216
https://kawalpemilu.org#57092,"REO, REOK, MANGGARAI, NUSA TENGGARA TIMUR",4,22,143,165
https://kawalpemilu.org#57092,"REO, REOK, MANGGARAI, NUSA TENGGARA TIMUR",5,45,104,149
https://kawalpemilu.org#57092,"REO, REOK, MANGGARAI, NUSA TENGGARA TIMUR",6,11,77,88
https://kawalpemilu.org#57092,"REO, REOK, MANGGARAI, NUSA TENGGARA TIMUR",7,31,149,180
https://kawalpemilu.org#57092,"REO, REOK, MANGGARAI, NUSA TENGGARA TIMUR",8,45,77,122
https://kawalpemilu.org#57092,"REO, REOK, MANGGARAI, NUSA TENGGARA TIMUR",9,45,44,89
https://kawalpemilu.org#57093,"MATA AIR, REOK, MANGGARAI, NUSA TENGGARA TIMUR",1,179,57,236
https://kawalpemilu.org#57093,"MATA AIR, REOK, MANGGARAI, NUSA TENGGARA TIMUR",2,115,50,165
https://kawalpemilu.org#57093,"MATA AIR, REOK, MANGGARAI, NUSA TENGGARA TIMUR",3,34,139,173
https://kawalpemilu.org#57093,"MATA AIR, REOK, MANGGARAI, NUSA TENGGARA TIMUR",4,24,136,160
https://kawalpemilu.org#57093,"MATA AIR, REOK, MANGGARAI, NUSA TENGGARA TIMUR",5,74,171,245
https://kawalpemilu.org#57093,"MATA AIR, REOK, MANGGARAI, NUSA TENGGARA TIMUR",6,91,54,145
https://kawalpemilu.org#57093,"MATA AIR, REOK, MANGGARAI, NUSA TENGGARA TIMUR",7,26,142,168
https://kawalpemilu.org#57093,"MATA AIR, REOK, MANGGARAI, NUSA TENGGARA TIMUR",8,25,78,103
https://kawalpemilu.org#57094,"BARU, REOK, MANGGARAI, NUSA TENGGARA TIMUR",1,75,85,160
https://kawalpemilu.org#57094,"BARU, REOK, MANGGARAI, NUSA TENGGARA TIMUR",2,214,13,227
https://kawalpemilu.org#57094,"BARU, REOK, MANGGARAI, NUSA TENGGARA TIMUR",3,149,12,161
https://kawalpemilu.org#57094,"BARU, REOK, MANGGARAI, NUSA TENGGARA TIMUR",4,84,71,155
https://kawalpemilu.org#57094,"BARU, REOK, MANGGARAI, NUSA TENGGARA TIMUR",5,99,39,138
https://kawalpemilu.org#57094,"BARU, REOK, MANGGARAI, NUSA TENGGARA TIMUR",6,70,5,75
https://kawalpemilu.org#57095,"WANGKUNG, REOK, MANGGARAI, NUSA TENGGARA TIMUR",1,156,17,173
https://kawalpemilu.org#57095,"WANGKUNG, REOK, MANGGARAI, NUSA TENGGARA TIMUR",2,216,6,222
https://kawalpemilu.org#57095,"WANGKUNG, REOK, MANGGARAI, NUSA TENGGARA TIMUR",3,169,5,174
https://kawalpemilu.org#57095,"WANGKUNG, REOK, MANGGARAI, NUSA TENGGARA TIMUR",4,202,2,204
https://kawalpemilu.org#57095,"WANGKUNG, REOK, MANGGARAI, NUSA TENGGARA TIMUR",5,168,8,176
https://kawalpemilu.org#57095,"WANGKUNG, REOK, MANGGARAI, NUSA TENGGARA TIMUR",6,245,12,257
https://kawalpemilu.org#57095,"WANGKUNG, REOK, MANGGARAI, NUSA TENGGARA TIMUR",7,186,13,199
https://kawalpemilu.org#57095,"WANGKUNG, REOK, MANGGARAI, NUSA TENGGARA TIMUR",8,80,25,105
https://kawalpemilu.org#57095,"WANGKUNG, REOK, MANGGARAI, NUSA TENGGARA TIMUR",9,117,26,143
https://kawalpemilu.org#57095,"WANGKUNG, REOK, MANGGARAI, NUSA TENGGARA TIMUR",10,123,4,127
https://kawalpemilu.org#57096,"ROBEK, REOK, MANGGARAI, NUSA TENGGARA TIMUR",1,115,9,124
https://kawalpemilu.org#57096,"ROBEK, REOK, MANGGARAI, NUSA TENGGARA TIMUR",2,93,6,99
https://kawalpemilu.org#57096,"ROBEK, REOK, MANGGARAI, NUSA TENGGARA TIMUR",3,205,7,212
https://kawalpemilu.org#57096,"ROBEK, REOK, MANGGARAI, NUSA TENGGARA TIMUR",4,174,4,178
https://kawalpemilu.org#57096,"ROBEK, REOK, MANGGARAI, NUSA TENGGARA TIMUR",5,172,7,179
https://kawalpemilu.org#57096,"ROBEK, REOK, MANGGARAI, NUSA TENGGARA TIMUR",6,135,14,149
https://kawalpemilu.org#57096,"ROBEK, REOK, MANGGARAI, NUSA TENGGARA TIMUR",7,107,40,147
https://kawalpemilu.org#57104,"RUIS, REOK, MANGGARAI, NUSA TENGGARA TIMUR",1,168,6,174
https://kawalpemilu.org#57104,"RUIS, REOK, MANGGARAI, NUSA TENGGARA TIMUR",2,60,7,67
https://kawalpemilu.org#57104,"RUIS, REOK, MANGGARAI, NUSA TENGGARA TIMUR",3,226,3,229
https://kawalpemilu.org#57104,"RUIS, REOK, MANGGARAI, NUSA TENGGARA TIMUR",4,222,4,226
https://kawalpemilu.org#57104,"RUIS, REOK, MANGGARAI, NUSA TENGGARA TIMUR",5,217,23,240
https://kawalpemilu.org#57104,"RUIS, REOK, MANGGARAI, NUSA TENGGARA TIMUR",6,107,4,111
https://kawalpemilu.org#57105,"BAJAK, REOK, MANGGARAI, NUSA TENGGARA TIMUR",1,202,10,212
https://kawalpemilu.org#57105,"BAJAK, REOK, MANGGARAI, NUSA TENGGARA TIMUR",2,156,13,169
https://kawalpemilu.org#57105,"BAJAK, REOK, MANGGARAI, NUSA TENGGARA TIMUR",3,229,27,256
https://kawalpemilu.org#57105,"BAJAK, REOK, MANGGARAI, NUSA TENGGARA TIMUR",4,187,9,196
https://kawalpemilu.org#57106,"WATU BAUR, REOK, MANGGARAI, NUSA TENGGARA TIMUR",1,184,6,190
https://kawalpemilu.org#57106,"WATU BAUR, REOK, MANGGARAI, NUSA TENGGARA TIMUR",2,184,19,203
https://kawalpemilu.org#57107,"SALAMA, REOK, MANGGARAI, NUSA TENGGARA TIMUR",1,95,101,196
https://kawalpemilu.org#57107,"SALAMA, REOK, MANGGARAI, NUSA TENGGARA TIMUR",2,43,137,180
https://kawalpemilu.org#57107,"SALAMA, REOK, MANGGARAI, NUSA TENGGARA TIMUR",3,181,17,198
https://kawalpemilu.org#57107,"SALAMA, REOK, MANGGARAI, NUSA TENGGARA TIMUR",4,125,72,197
https://kawalpemilu.org#57107,"SALAMA, REOK, MANGGARAI, NUSA TENGGARA TIMUR",5,63,110,173
https://kawalpemilu.org#57111,"WATU TANGO, REOK, MANGGARAI, NUSA TENGGARA TIMUR",1,194,5,199
https://kawalpemilu.org#57111,"WATU TANGO, REOK, MANGGARAI, NUSA TENGGARA TIMUR",2,222,3,225
https://kawalpemilu.org#57111,"WATU TANGO, REOK, MANGGARAI, NUSA TENGGARA TIMUR",3,177,1,178
https://kawalpemilu.org#57113,"GOLO DUKAL, LANGKE REMBONG, MANGGARAI, NUSA TENGGARA TIMUR",1,211,22,233
https://kawalpemilu.org#57113,"GOLO DUKAL, LANGKE REMBONG, MANGGARAI, NUSA TENGGARA TIMUR",2,252,15,267
https://kawalpemilu.org#57113,"GOLO DUKAL, LANGKE REMBONG, MANGGARAI, NUSA TENGGARA TIMUR",3,180,15,195
https://kawalpemilu.org#57113,"GOLO DUKAL, LANGKE REMBONG, MANGGARAI, NUSA TENGGARA TIMUR",4,179,11,190
https://kawalpemilu.org#57113,"GOLO DUKAL, LANGKE REMBONG, MANGGARAI, NUSA TENGGARA TIMUR",5,184,32,216
https://kawalpemilu.org#57113,"GOLO DUKAL, LANGKE REMBONG, MANGGARAI, NUSA TENGGARA TIMUR",6,211,21,232
https://kawalpemilu.org#57113,"GOLO DUKAL, LANGKE REMBONG, MANGGARAI, NUSA TENGGARA TIMUR",7,183,13,196
https://kawalpemilu.org#57113,"GOLO DUKAL, LANGKE REMBONG, MANGGARAI, NUSA TENGGARA TIMUR",8,191,6,197
https://kawalpemilu.org#57113,"GOLO DUKAL, LANGKE REMBONG, MANGGARAI, NUSA TENGGARA TIMUR",9,47,9,56
https://kawalpemilu.org#57114,"WALI, LANGKE REMBONG, MANGGARAI, NUSA TENGGARA TIMUR",1,200,17,217
https://kawalpemilu.org#57114,"WALI, LANGKE REMBONG, MANGGARAI, NUSA TENGGARA TIMUR",2,157,18,175
https://kawalpemilu.org#57114,"WALI, LANGKE REMBONG, MANGGARAI, NUSA TENGGARA TIMUR",3,202,21,223
https://kawalpemilu.org#57114,"WALI, LANGKE REMBONG, MANGGARAI, NUSA TENGGARA TIMUR",4,162,25,187
https://kawalpemilu.org#57114,"WALI, LANGKE REMBONG, MANGGARAI, NUSA TENGGARA TIMUR",5,226,15,241
https://kawalpemilu.org#57114,"WALI, LANGKE REMBONG, MANGGARAI, NUSA TENGGARA TIMUR",6,263,16,279
https://kawalpemilu.org#57114,"WALI, LANGKE REMBONG, MANGGARAI, NUSA TENGGARA TIMUR",7,234,23,257
https://kawalpemilu.org#57114,"WALI, LANGKE REMBONG, MANGGARAI, NUSA TENGGARA TIMUR",8,203,40,243
https://kawalpemilu.org#57114,"WALI, LANGKE REMBONG, MANGGARAI, NUSA TENGGARA TIMUR",9,189,24,213
https://kawalpemilu.org#57114,"WALI, LANGKE REMBONG, MANGGARAI, NUSA TENGGARA TIMUR",10,189,19,208
https://kawalpemilu.org#57114,"WALI, LANGKE REMBONG, MANGGARAI, NUSA TENGGARA TIMUR",11,176,20,196
https://kawalpemilu.org#57115,"KAROT, LANGKE REMBONG, MANGGARAI, NUSA TENGGARA TIMUR",1,179,14,193
https://kawalpemilu.org#57115,"KAROT, LANGKE REMBONG, MANGGARAI, NUSA TENGGARA TIMUR",2,206,9,215
https://kawalpemilu.org#57115,"KAROT, LANGKE REMBONG, MANGGARAI, NUSA TENGGARA TIMUR",3,207,8,215
https://kawalpemilu.org#57115,"KAROT, LANGKE REMBONG, MANGGARAI, NUSA TENGGARA TIMUR",4,172,9,181
https://kawalpemilu.org#57115,"KAROT, LANGKE REMBONG, MANGGARAI, NUSA TENGGARA TIMUR",5,195,17,212
https://kawalpemilu.org#57115,"KAROT, LANGKE REMBONG, MANGGARAI, NUSA TENGGARA TIMUR",6,188,16,204
https://kawalpemilu.org#57115,"KAROT, LANGKE REMBONG, MANGGARAI, NUSA TENGGARA TIMUR",7,200,13,213
https://kawalpemilu.org#57115,"KAROT, LANGKE REMBONG, MANGGARAI, NUSA TENGGARA TIMUR",8,149,12,161
https://kawalpemilu.org#57115,"KAROT, LANGKE REMBONG, MANGGARAI, NUSA TENGGARA TIMUR",9,148,3,151
https://kawalpemilu.org#57116,"PITAK, LANGKE REMBONG, MANGGARAI, NUSA TENGGARA TIMUR",1,175,46,221
https://kawalpemilu.org#57116,"PITAK, LANGKE REMBONG, MANGGARAI, NUSA TENGGARA TIMUR",2,202,38,240
https://kawalpemilu.org#57116,"PITAK, LANGKE REMBONG, MANGGARAI, NUSA TENGGARA TIMUR",3,164,33,197
https://kawalpemilu.org#57116,"PITAK, LANGKE REMBONG, MANGGARAI, NUSA TENGGARA TIMUR",4,166,29,195
https://kawalpemilu.org#57116,"PITAK, LANGKE REMBONG, MANGGARAI, NUSA TENGGARA TIMUR",5,211,11,222
https://kawalpemilu.org#57116,"PITAK, LANGKE REMBONG, MANGGARAI, NUSA TENGGARA TIMUR",6,116,43,159
https://kawalpemilu.org#57116,"PITAK, LANGKE REMBONG, MANGGARAI, NUSA TENGGARA TIMUR",7,118,6,124
https://kawalpemilu.org#57116,"PITAK, LANGKE REMBONG, MANGGARAI, NUSA TENGGARA TIMUR",8,188,20,208
https://kawalpemilu.org#57116,"PITAK, LANGKE REMBONG, MANGGARAI, NUSA TENGGARA TIMUR",9,150,12,162
https://kawalpemilu.org#57116,"PITAK, LANGKE REMBONG, MANGGARAI, NUSA TENGGARA TIMUR",10,150,10,160
https://kawalpemilu.org#57116,"PITAK, LANGKE REMBONG, MANGGARAI, NUSA TENGGARA TIMUR",11,183,21,204
https://kawalpemilu.org#57116,"PITAK, LANGKE REMBONG, MANGGARAI, NUSA TENGGARA TIMUR",12,172,14,186
https://kawalpemilu.org#57117,"LAWIR, LANGKE REMBONG, MANGGARAI, NUSA TENGGARA TIMUR",1,213,12,225
https://kawalpemilu.org#57117,"LAWIR, LANGKE REMBONG, MANGGARAI, NUSA TENGGARA TIMUR",2,224,27,251
https://kawalpemilu.org#57117,"LAWIR, LANGKE REMBONG, MANGGARAI, NUSA TENGGARA TIMUR",3,183,61,244
https://kawalpemilu.org#57117,"LAWIR, LANGKE REMBONG, MANGGARAI, NUSA TENGGARA TIMUR",4,156,8,164
https://kawalpemilu.org#57118,"PAU, LANGKE REMBONG, MANGGARAI, NUSA TENGGARA TIMUR",1,219,25,244
https://kawalpemilu.org#57118,"PAU, LANGKE REMBONG, MANGGARAI, NUSA TENGGARA TIMUR",2,195,28,223
https://kawalpemilu.org#57118,"PAU, LANGKE REMBONG, MANGGARAI, NUSA TENGGARA TIMUR",3,172,3,175
https://kawalpemilu.org#57118,"PAU, LANGKE REMBONG, MANGGARAI, NUSA TENGGARA TIMUR",4,189,22,211
https://kawalpemilu.org#57118,"PAU, LANGKE REMBONG, MANGGARAI, NUSA TENGGARA TIMUR",5,178,9,187
https://kawalpemilu.org#57118,"PAU, LANGKE REMBONG, MANGGARAI, NUSA TENGGARA TIMUR",6,168,11,179
https://kawalpemilu.org#57118,"PAU, LANGKE REMBONG, MANGGARAI, NUSA TENGGARA TIMUR",7,128,4,132
https://kawalpemilu.org#57118,"PAU, LANGKE REMBONG, MANGGARAI, NUSA TENGGARA TIMUR",8,183,8,191
https://kawalpemilu.org#57118,"PAU, LANGKE REMBONG, MANGGARAI, NUSA TENGGARA TIMUR",9,264,3,267
https://kawalpemilu.org#57118,"PAU, LANGKE REMBONG, MANGGARAI, NUSA TENGGARA TIMUR",10,116,9,125
https://kawalpemilu.org#57118,"PAU, LANGKE REMBONG, MANGGARAI, NUSA TENGGARA TIMUR",11,209,16,225
https://kawalpemilu.org#57118,"PAU, LANGKE REMBONG, MANGGARAI, NUSA TENGGARA TIMUR",12,157,51,208
https://kawalpemilu.org#57118,"PAU, LANGKE REMBONG, MANGGARAI, NUSA TENGGARA TIMUR",13,212,15,227
https://kawalpemilu.org#57118,"PAU, LANGKE REMBONG, MANGGARAI, NUSA TENGGARA TIMUR",14,217,23,240
https://kawalpemilu.org#57118,"PAU, LANGKE REMBONG, MANGGARAI, NUSA TENGGARA TIMUR",15,247,22,269
https://kawalpemilu.org#57118,"PAU, LANGKE REMBONG, MANGGARAI, NUSA TENGGARA TIMUR",16,187,9,196
https://kawalpemilu.org#57118,"PAU, LANGKE REMBONG, MANGGARAI, NUSA TENGGARA TIMUR",17,248,16,264
https://kawalpemilu.org#57118,"PAU, LANGKE REMBONG, MANGGARAI, NUSA TENGGARA TIMUR",18,196,9,205
https://kawalpemilu.org#57118,"PAU, LANGKE REMBONG, MANGGARAI, NUSA TENGGARA TIMUR",19,208,30,238
https://kawalpemilu.org#57118,"PAU, LANGKE REMBONG, MANGGARAI, NUSA TENGGARA TIMUR",20,83,3,86
https://kawalpemilu.org#57118,"PAU, LANGKE REMBONG, MANGGARAI, NUSA TENGGARA TIMUR",21,118,11,129
https://kawalpemilu.org#57119,"WASO, LANGKE REMBONG, MANGGARAI, NUSA TENGGARA TIMUR",1,238,15,253
https://kawalpemilu.org#57119,"WASO, LANGKE REMBONG, MANGGARAI, NUSA TENGGARA TIMUR",2,189,15,204
https://kawalpemilu.org#57119,"WASO, LANGKE REMBONG, MANGGARAI, NUSA TENGGARA TIMUR",3,187,13,200
https://kawalpemilu.org#57119,"WASO, LANGKE REMBONG, MANGGARAI, NUSA TENGGARA TIMUR",4,177,18,195
https://kawalpemilu.org#57119,"WASO, LANGKE REMBONG, MANGGARAI, NUSA TENGGARA TIMUR",5,163,24,187
https://kawalpemilu.org#57119,"WASO, LANGKE REMBONG, MANGGARAI, NUSA TENGGARA TIMUR",6,183,15,198
https://kawalpemilu.org#57119,"WASO, LANGKE REMBONG, MANGGARAI, NUSA TENGGARA TIMUR",7,184,14,198
https://kawalpemilu.org#57119,"WASO, LANGKE REMBONG, MANGGARAI, NUSA TENGGARA TIMUR",8,156,29,185
https://kawalpemilu.org#57120,"WATU, LANGKE REMBONG, MANGGARAI, NUSA TENGGARA TIMUR",1,214,9,223
https://kawalpemilu.org#57120,"WATU, LANGKE REMBONG, MANGGARAI, NUSA TENGGARA TIMUR",2,164,6,170
https://kawalpemilu.org#57120,"WATU, LANGKE REMBONG, MANGGARAI, NUSA TENGGARA TIMUR",3,262,13,275
https://kawalpemilu.org#57120,"WATU, LANGKE REMBONG, MANGGARAI, NUSA TENGGARA TIMUR",4,138,16,154
https://kawalpemilu.org#57120,"WATU, LANGKE REMBONG, MANGGARAI, NUSA TENGGARA TIMUR",5,150,14,164
https://kawalpemilu.org#57120,"WATU, LANGKE REMBONG, MANGGARAI, NUSA TENGGARA TIMUR",6,158,12,170
https://kawalpemilu.org#57120,"WATU, LANGKE REMBONG, MANGGARAI, NUSA TENGGARA TIMUR",7,186,1,187
https://kawalpemilu.org#57120,"WATU, LANGKE REMBONG, MANGGARAI, NUSA TENGGARA TIMUR",8,213,28,241
https://kawalpemilu.org#57120,"WATU, LANGKE REMBONG, MANGGARAI, NUSA TENGGARA TIMUR",9,123,6,129
https://kawalpemilu.org#57120,"WATU, LANGKE REMBONG, MANGGARAI, NUSA TENGGARA TIMUR",10,195,15,210
https://kawalpemilu.org#57120,"WATU, LANGKE REMBONG, MANGGARAI, NUSA TENGGARA TIMUR",11,185,10,195
https://kawalpemilu.org#57120,"WATU, LANGKE REMBONG, MANGGARAI, NUSA TENGGARA TIMUR",12,243,7,250
https://kawalpemilu.org#57121,"MBAUMUKU, LANGKE REMBONG, MANGGARAI, NUSA TENGGARA TIMUR",1,241,45,286
https://kawalpemilu.org#57121,"MBAUMUKU, LANGKE REMBONG, MANGGARAI, NUSA TENGGARA TIMUR",2,149,24,173
https://kawalpemilu.org#57121,"MBAUMUKU, LANGKE REMBONG, MANGGARAI, NUSA TENGGARA TIMUR",3,203,21,224
https://kawalpemilu.org#57121,"MBAUMUKU, LANGKE REMBONG, MANGGARAI, NUSA TENGGARA TIMUR",4,244,15,259
https://kawalpemilu.org#57121,"MBAUMUKU, LANGKE REMBONG, MANGGARAI, NUSA TENGGARA TIMUR",5,264,14,278
https://kawalpemilu.org#57121,"MBAUMUKU, LANGKE REMBONG, MANGGARAI, NUSA TENGGARA TIMUR",6,239,24,263
https://kawalpemilu.org#57122,"TENDA, LANGKE REMBONG, MANGGARAI, NUSA TENGGARA TIMUR",1,233,21,254
https://kawalpemilu.org#57122,"TENDA, LANGKE REMBONG, MANGGARAI, NUSA TENGGARA TIMUR",2,224,6,230
https://kawalpemilu.org#57122,"TENDA, LANGKE REMBONG, MANGGARAI, NUSA TENGGARA TIMUR",3,178,12,190
https://kawalpemilu.org#57122,"TENDA, LANGKE REMBONG, MANGGARAI, NUSA TENGGARA TIMUR",4,117,3,120
https://kawalpemilu.org#57122,"TENDA, LANGKE REMBONG, MANGGARAI, NUSA TENGGARA TIMUR",5,209,14,223
https://kawalpemilu.org#57122,"TENDA, LANGKE REMBONG, MANGGARAI, NUSA TENGGARA TIMUR",6,145,28,173
https://kawalpemilu.org#57122,"TENDA, LANGKE REMBONG, MANGGARAI, NUSA TENGGARA TIMUR",7,126,6,132
https://kawalpemilu.org#57122,"TENDA, LANGKE REMBONG, MANGGARAI, NUSA TENGGARA TIMUR",8,204,15,219
https://kawalpemilu.org#57123,"CAREP, LANGKE REMBONG, MANGGARAI, NUSA TENGGARA TIMUR",1,186,15,201
https://kawalpemilu.org#57123,"CAREP, LANGKE REMBONG, MANGGARAI, NUSA TENGGARA TIMUR",2,246,12,258
https://kawalpemilu.org#57123,"CAREP, LANGKE REMBONG, MANGGARAI, NUSA TENGGARA TIMUR",3,97,29,126
https://kawalpemilu.org#57123,"CAREP, LANGKE REMBONG, MANGGARAI, NUSA TENGGARA TIMUR",4,245,15,260
https://kawalpemilu.org#57123,"CAREP, LANGKE REMBONG, MANGGARAI, NUSA TENGGARA TIMUR",5,162,13,175
https://kawalpemilu.org#57123,"CAREP, LANGKE REMBONG, MANGGARAI, NUSA TENGGARA TIMUR",6,264,6,270
https://kawalpemilu.org#930813,"BANGKA NEKANG, LANGKE REMBONG, MANGGARAI, NUSA TENGGARA TIMUR",1,96,20,116
https://kawalpemilu.org#930813,"BANGKA NEKANG, LANGKE REMBONG, MANGGARAI, NUSA TENGGARA TIMUR",2,258,13,271
https://kawalpemilu.org#930813,"BANGKA NEKANG, LANGKE REMBONG, MANGGARAI, NUSA TENGGARA TIMUR",3,265,11,276
https://kawalpemilu.org#930813,"BANGKA NEKANG, LANGKE REMBONG, MANGGARAI, NUSA TENGGARA TIMUR",4,275,5,280
https://kawalpemilu.org#930813,"BANGKA NEKANG, LANGKE REMBONG, MANGGARAI, NUSA TENGGARA TIMUR",5,164,9,173
https://kawalpemilu.org#930813,"BANGKA NEKANG, LANGKE REMBONG, MANGGARAI, NUSA TENGGARA TIMUR",6,192,9,201
https://kawalpemilu.org#930813,"BANGKA NEKANG, LANGKE REMBONG, MANGGARAI, NUSA TENGGARA TIMUR",7,233,22,255
https://kawalpemilu.org#930814,"SATAR TACIK, LANGKE REMBONG, MANGGARAI, NUSA TENGGARA TIMUR",1,209,24,233
https://kawalpemilu.org#930814,"SATAR TACIK, LANGKE REMBONG, MANGGARAI, NUSA TENGGARA TIMUR",2,250,48,298
https://kawalpemilu.org#930814,"SATAR TACIK, LANGKE REMBONG, MANGGARAI, NUSA TENGGARA TIMUR",3,246,56,302
https://kawalpemilu.org#930814,"SATAR TACIK, LANGKE REMBONG, MANGGARAI, NUSA TENGGARA TIMUR",4,209,55,264
https://kawalpemilu.org#930814,"SATAR TACIK, LANGKE REMBONG, MANGGARAI, NUSA TENGGARA TIMUR",5,202,26,228
https://kawalpemilu.org#930814,"SATAR TACIK, LANGKE REMBONG, MANGGARAI, NUSA TENGGARA TIMUR",6,289,14,303
https://kawalpemilu.org#930814,"SATAR TACIK, LANGKE REMBONG, MANGGARAI, NUSA TENGGARA TIMUR",7,185,21,206
https://kawalpemilu.org#930814,"SATAR TACIK, LANGKE REMBONG, MANGGARAI, NUSA TENGGARA TIMUR",8,215,33,248
https://kawalpemilu.org#930814,"SATAR TACIK, LANGKE REMBONG, MANGGARAI, NUSA TENGGARA TIMUR",9,205,45,250
https://kawalpemilu.org#930814,"SATAR TACIK, LANGKE REMBONG, MANGGARAI, NUSA TENGGARA TIMUR",10,228,50,278
https://kawalpemilu.org#930815,"POCO MAL, LANGKE REMBONG, MANGGARAI, NUSA TENGGARA TIMUR",1,165,25,190
https://kawalpemilu.org#930815,"POCO MAL, LANGKE REMBONG, MANGGARAI, NUSA TENGGARA TIMUR",2,227,20,247
https://kawalpemilu.org#930815,"POCO MAL, LANGKE REMBONG, MANGGARAI, NUSA TENGGARA TIMUR",3,201,23,224
https://kawalpemilu.org#930815,"POCO MAL, LANGKE REMBONG, MANGGARAI, NUSA TENGGARA TIMUR",4,204,6,210
https://kawalpemilu.org#930816,"COMPANG CAREP, LANGKE REMBONG, MANGGARAI, NUSA TENGGARA TIMUR",1,184,15,199
https://kawalpemilu.org#930816,"COMPANG CAREP, LANGKE REMBONG, MANGGARAI, NUSA TENGGARA TIMUR",2,179,1,180
https://kawalpemilu.org#930816,"COMPANG CAREP, LANGKE REMBONG, MANGGARAI, NUSA TENGGARA TIMUR",3,174,3,177
https://kawalpemilu.org#930817,"LACI CAREP, LANGKE REMBONG, MANGGARAI, NUSA TENGGARA TIMUR",1,213,18,231
https://kawalpemilu.org#930817,"LACI CAREP, LANGKE REMBONG, MANGGARAI, NUSA TENGGARA TIMUR",2,230,20,250
https://kawalpemilu.org#930817,"LACI CAREP, LANGKE REMBONG, MANGGARAI, NUSA TENGGARA TIMUR",3,145,17,162
https://kawalpemilu.org#930818,"TADONG, LANGKE REMBONG, MANGGARAI, NUSA TENGGARA TIMUR",1,238,19,257
https://kawalpemilu.org#930818,"TADONG, LANGKE REMBONG, MANGGARAI, NUSA TENGGARA TIMUR",2,167,15,182
https://kawalpemilu.org#930818,"TADONG, LANGKE REMBONG, MANGGARAI, NUSA TENGGARA TIMUR",3,210,23,233
https://kawalpemilu.org#930818,"TADONG, LANGKE REMBONG, MANGGARAI, NUSA TENGGARA TIMUR",4,241,22,263
https://kawalpemilu.org#930818,"TADONG, LANGKE REMBONG, MANGGARAI, NUSA TENGGARA TIMUR",5,252,6,258
https://kawalpemilu.org#930818,"TADONG, LANGKE REMBONG, MANGGARAI, NUSA TENGGARA TIMUR",6,159,0,159
https://kawalpemilu.org#930818,"TADONG, LANGKE REMBONG, MANGGARAI, NUSA TENGGARA TIMUR",7,107,2,109
https://kawalpemilu.org#930819,"ROWANG, LANGKE REMBONG, MANGGARAI, NUSA TENGGARA TIMUR",1,172,6,178
https://kawalpemilu.org#930819,"ROWANG, LANGKE REMBONG, MANGGARAI, NUSA TENGGARA TIMUR",2,185,10,195
https://kawalpemilu.org#930819,"ROWANG, LANGKE REMBONG, MANGGARAI, NUSA TENGGARA TIMUR",3,238,12,250
https://kawalpemilu.org#930820,"BANGKA LEDA, LANGKE REMBONG, MANGGARAI, NUSA TENGGARA TIMUR",1,220,16,236
https://kawalpemilu.org#930820,"BANGKA LEDA, LANGKE REMBONG, MANGGARAI, NUSA TENGGARA TIMUR",2,201,19,220
https://kawalpemilu.org#930820,"BANGKA LEDA, LANGKE REMBONG, MANGGARAI, NUSA TENGGARA TIMUR",3,218,18,236
https://kawalpemilu.org#930820,"BANGKA LEDA, LANGKE REMBONG, MANGGARAI, NUSA TENGGARA TIMUR",4,235,17,252
https://kawalpemilu.org#930820,"BANGKA LEDA, LANGKE REMBONG, MANGGARAI, NUSA TENGGARA TIMUR",5,234,17,251
https://kawalpemilu.org#930820,"BANGKA LEDA, LANGKE REMBONG, MANGGARAI, NUSA TENGGARA TIMUR",6,209,15,224
https://kawalpemilu.org#930821,"COMPANG TUKE, LANGKE REMBONG, MANGGARAI, NUSA TENGGARA TIMUR",1,243,21,264
https://kawalpemilu.org#930821,"COMPANG TUKE, LANGKE REMBONG, MANGGARAI, NUSA TENGGARA TIMUR",2,214,15,229
https://kawalpemilu.org#930821,"COMPANG TUKE, LANGKE REMBONG, MANGGARAI, NUSA TENGGARA TIMUR",3,188,7,195
https://kawalpemilu.org#930821,"COMPANG TUKE, LANGKE REMBONG, MANGGARAI, NUSA TENGGARA TIMUR",4,259,11,270
https://kawalpemilu.org#930821,"COMPANG TUKE, LANGKE REMBONG, MANGGARAI, NUSA TENGGARA TIMUR",5,154,24,178
https://kawalpemilu.org#930821,"COMPANG TUKE, LANGKE REMBONG, MANGGARAI, NUSA TENGGARA TIMUR",6,126,30,156
https://kawalpemilu.org#57126,"HILIHINTIR, SATAR MESE BARAT, MANGGARAI, NUSA TENGGARA TIMUR",1,153,16,169
https://kawalpemilu.org#57126,"HILIHINTIR, SATAR MESE BARAT, MANGGARAI, NUSA TENGGARA TIMUR",2,102,18,120
https://kawalpemilu.org#57126,"HILIHINTIR, SATAR MESE BARAT, MANGGARAI, NUSA TENGGARA TIMUR",3,133,29,162
https://kawalpemilu.org#57126,"HILIHINTIR, SATAR MESE BARAT, MANGGARAI, NUSA TENGGARA TIMUR",4,181,24,205
https://kawalpemilu.org#57126,"HILIHINTIR, SATAR MESE BARAT, MANGGARAI, NUSA TENGGARA TIMUR",5,132,9,141
https://kawalpemilu.org#57126,"HILIHINTIR, SATAR MESE BARAT, MANGGARAI, NUSA TENGGARA TIMUR",6,168,18,186
https://kawalpemilu.org#57126,"HILIHINTIR, SATAR MESE BARAT, MANGGARAI, NUSA TENGGARA TIMUR",7,192,15,207
https://kawalpemilu.org#57126,"HILIHINTIR, SATAR MESE BARAT, MANGGARAI, NUSA TENGGARA TIMUR",8,121,24,145
https://kawalpemilu.org#57126,"HILIHINTIR, SATAR MESE BARAT, MANGGARAI, NUSA TENGGARA TIMUR",9,121,19,140
https://kawalpemilu.org#57129,"BEA KONDO, SATAR MESE BARAT, MANGGARAI, NUSA TENGGARA TIMUR",1,221,9,230
https://kawalpemilu.org#57129,"BEA KONDO, SATAR MESE BARAT, MANGGARAI, NUSA TENGGARA TIMUR",2,152,9,161
https://kawalpemilu.org#57129,"BEA KONDO, SATAR MESE BARAT, MANGGARAI, NUSA TENGGARA TIMUR",3,209,12,221
https://kawalpemilu.org#57129,"BEA KONDO, SATAR MESE BARAT, MANGGARAI, NUSA TENGGARA TIMUR",4,156,17,173
https://kawalpemilu.org#57136,"GOLO ROPONG, SATAR MESE BARAT, MANGGARAI, NUSA TENGGARA TIMUR",1,193,17,210
https://kawalpemilu.org#57136,"GOLO ROPONG, SATAR MESE BARAT, MANGGARAI, NUSA TENGGARA TIMUR",2,88,5,93
https://kawalpemilu.org#57136,"GOLO ROPONG, SATAR MESE BARAT, MANGGARAI, NUSA TENGGARA TIMUR",3,107,11,118
https://kawalpemilu.org#57136,"GOLO ROPONG, SATAR MESE BARAT, MANGGARAI, NUSA TENGGARA TIMUR",4,154,20,174
https://kawalpemilu.org#57137,"TERONG, SATAR MESE BARAT, MANGGARAI, NUSA TENGGARA TIMUR",1,90,22,112
https://kawalpemilu.org#57137,"TERONG, SATAR MESE BARAT, MANGGARAI, NUSA TENGGARA TIMUR",2,100,34,134
https://kawalpemilu.org#57137,"TERONG, SATAR MESE BARAT, MANGGARAI, NUSA TENGGARA TIMUR",3,118,102,220
https://kawalpemilu.org#57137,"TERONG, SATAR MESE BARAT, MANGGARAI, NUSA TENGGARA TIMUR",4,144,18,162
https://kawalpemilu.org#57137,"TERONG, SATAR MESE BARAT, MANGGARAI, NUSA TENGGARA TIMUR",5,72,25,97
https://kawalpemilu.org#57137,"TERONG, SATAR MESE BARAT, MANGGARAI, NUSA TENGGARA TIMUR",6,116,13,129
https://kawalpemilu.org#57137,"TERONG, SATAR MESE BARAT, MANGGARAI, NUSA TENGGARA TIMUR",7,72,7,79
https://kawalpemilu.org#57138,"CEKA LUJU, SATAR MESE BARAT, MANGGARAI, NUSA TENGGARA TIMUR",1,150,13,163
https://kawalpemilu.org#57138,"CEKA LUJU, SATAR MESE BARAT, MANGGARAI, NUSA TENGGARA TIMUR",2,118,26,144
https://kawalpemilu.org#57138,"CEKA LUJU, SATAR MESE BARAT, MANGGARAI, NUSA TENGGARA TIMUR",3,174,17,191
https://kawalpemilu.org#57139,"SATAR LUJU, SATAR MESE BARAT, MANGGARAI, NUSA TENGGARA TIMUR",1,149,10,159
https://kawalpemilu.org#57139,"SATAR LUJU, SATAR MESE BARAT, MANGGARAI, NUSA TENGGARA TIMUR",2,149,5,154
https://kawalpemilu.org#57139,"SATAR LUJU, SATAR MESE BARAT, MANGGARAI, NUSA TENGGARA TIMUR",3,196,9,205
https://kawalpemilu.org#57139,"SATAR LUJU, SATAR MESE BARAT, MANGGARAI, NUSA TENGGARA TIMUR",4,216,17,233
https://kawalpemilu.org#57139,"SATAR LUJU, SATAR MESE BARAT, MANGGARAI, NUSA TENGGARA TIMUR",5,81,14,95
https://kawalpemilu.org#57140,"SATAR LENDA, SATAR MESE BARAT, MANGGARAI, NUSA TENGGARA TIMUR",1,196,10,206
https://kawalpemilu.org#57140,"SATAR LENDA, SATAR MESE BARAT, MANGGARAI, NUSA TENGGARA TIMUR",2,114,15,129
https://kawalpemilu.org#57140,"SATAR LENDA, SATAR MESE BARAT, MANGGARAI, NUSA TENGGARA TIMUR",3,111,8,119
https://kawalpemilu.org#57140,"SATAR LENDA, SATAR MESE BARAT, MANGGARAI, NUSA TENGGARA TIMUR",4,207,13,220
https://kawalpemilu.org#57140,"SATAR LENDA, SATAR MESE BARAT, MANGGARAI, NUSA TENGGARA TIMUR",5,118,4,122
https://kawalpemilu.org#57140,"SATAR LENDA, SATAR MESE BARAT, MANGGARAI, NUSA TENGGARA TIMUR",6,172,14,186
https://kawalpemilu.org#57140,"SATAR LENDA, SATAR MESE BARAT, MANGGARAI, NUSA TENGGARA TIMUR",7,111,76,187
https://kawalpemilu.org#57141,"SATAR RUWUK, SATAR MESE BARAT, MANGGARAI, NUSA TENGGARA TIMUR",1,167,16,183
https://kawalpemilu.org#57141,"SATAR RUWUK, SATAR MESE BARAT, MANGGARAI, NUSA TENGGARA TIMUR",2,174,40,214
https://kawalpemilu.org#57141,"SATAR RUWUK, SATAR MESE BARAT, MANGGARAI, NUSA TENGGARA TIMUR",3,242,32,274
https://kawalpemilu.org#57141,"SATAR RUWUK, SATAR MESE BARAT, MANGGARAI, NUSA TENGGARA TIMUR",4,102,27,129
https://kawalpemilu.org#57142,"NUCA MOLAS, SATAR MESE BARAT, MANGGARAI, NUSA TENGGARA TIMUR",1,12,196,208
https://kawalpemilu.org#57142,"NUCA MOLAS, SATAR MESE BARAT, MANGGARAI, NUSA TENGGARA TIMUR",2,23,170,193
https://kawalpemilu.org#57142,"NUCA MOLAS, SATAR MESE BARAT, MANGGARAI, NUSA TENGGARA TIMUR",3,51,246,297
https://kawalpemilu.org#57143,"BORIK, SATAR MESE BARAT, MANGGARAI, NUSA TENGGARA TIMUR",1,187,16,203
https://kawalpemilu.org#57143,"BORIK, SATAR MESE BARAT, MANGGARAI, NUSA TENGGARA TIMUR",2,220,13,233
https://kawalpemilu.org#57143,"BORIK, SATAR MESE BARAT, MANGGARAI, NUSA TENGGARA TIMUR",3,143,11,154
https://kawalpemilu.org#87838,"CAMBIR LECA, SATAR MESE BARAT, MANGGARAI, NUSA TENGGARA TIMUR",1,188,17,205
https://kawalpemilu.org#87838,"CAMBIR LECA, SATAR MESE BARAT, MANGGARAI, NUSA TENGGARA TIMUR",2,196,29,225
https://kawalpemilu.org#87838,"CAMBIR LECA, SATAR MESE BARAT, MANGGARAI, NUSA TENGGARA TIMUR",3,170,26,196
https://kawalpemilu.org#87838,"CAMBIR LECA, SATAR MESE BARAT, MANGGARAI, NUSA TENGGARA TIMUR",4,97,16,113
https://kawalpemilu.org#87838,"CAMBIR LECA, SATAR MESE BARAT, MANGGARAI, NUSA TENGGARA TIMUR",5,117,7,124
https://kawalpemilu.org#87838,"CAMBIR LECA, SATAR MESE BARAT, MANGGARAI, NUSA TENGGARA TIMUR",6,184,39,223
https://kawalpemilu.org#87838,"CAMBIR LECA, SATAR MESE BARAT, MANGGARAI, NUSA TENGGARA TIMUR",7,88,11,99
https://kawalpemilu.org#87839,"WONGKA, SATAR MESE BARAT, MANGGARAI, NUSA TENGGARA TIMUR",1,165,22,187
https://kawalpemilu.org#87839,"WONGKA, SATAR MESE BARAT, MANGGARAI, NUSA TENGGARA TIMUR",2,148,13,161
https://kawalpemilu.org#87839,"WONGKA, SATAR MESE BARAT, MANGGARAI, NUSA TENGGARA TIMUR",3,173,22,195
https://kawalpemilu.org#57146,"BUAR, RAHONG UTARA, MANGGARAI, NUSA TENGGARA TIMUR",1,157,12,169
https://kawalpemilu.org#57146,"BUAR, RAHONG UTARA, MANGGARAI, NUSA TENGGARA TIMUR",2,197,15,212
https://kawalpemilu.org#57146,"BUAR, RAHONG UTARA, MANGGARAI, NUSA TENGGARA TIMUR",3,124,11,135
https://kawalpemilu.org#57146,"BUAR, RAHONG UTARA, MANGGARAI, NUSA TENGGARA TIMUR",4,186,6,192
https://kawalpemilu.org#57146,"BUAR, RAHONG UTARA, MANGGARAI, NUSA TENGGARA TIMUR",5,110,8,118
https://kawalpemilu.org#57146,"BUAR, RAHONG UTARA, MANGGARAI, NUSA TENGGARA TIMUR",6,124,4,128
https://kawalpemilu.org#57146,"BUAR, RAHONG UTARA, MANGGARAI, NUSA TENGGARA TIMUR",7,104,1,105
https://kawalpemilu.org#57146,"BUAR, RAHONG UTARA, MANGGARAI, NUSA TENGGARA TIMUR",8,129,3,132
https://kawalpemilu.org#57147,"BENTENG TUBI, RAHONG UTARA, MANGGARAI, NUSA TENGGARA TIMUR",1,207,6,213
https://kawalpemilu.org#57147,"BENTENG TUBI, RAHONG UTARA, MANGGARAI, NUSA TENGGARA TIMUR",2,194,15,209
https://kawalpemilu.org#57147,"BENTENG TUBI, RAHONG UTARA, MANGGARAI, NUSA TENGGARA TIMUR",3,185,12,197
https://kawalpemilu.org#57147,"BENTENG TUBI, RAHONG UTARA, MANGGARAI, NUSA TENGGARA TIMUR",4,117,7,124
https://kawalpemilu.org#57148,"COMPANG DARI, RAHONG UTARA, MANGGARAI, NUSA TENGGARA TIMUR",1,115,7,122
https://kawalpemilu.org#57148,"COMPANG DARI, RAHONG UTARA, MANGGARAI, NUSA TENGGARA TIMUR",2,105,4,109
https://kawalpemilu.org#57148,"COMPANG DARI, RAHONG UTARA, MANGGARAI, NUSA TENGGARA TIMUR",3,193,15,208
https://kawalpemilu.org#57149,"DIMPONG, RAHONG UTARA, MANGGARAI, NUSA TENGGARA TIMUR",1,237,13,250
https://kawalpemilu.org#57149,"DIMPONG, RAHONG UTARA, MANGGARAI, NUSA TENGGARA TIMUR",2,231,18,249
https://kawalpemilu.org#57149,"DIMPONG, RAHONG UTARA, MANGGARAI, NUSA TENGGARA TIMUR",3,149,8,157
https://kawalpemilu.org#57149,"DIMPONG, RAHONG UTARA, MANGGARAI, NUSA TENGGARA TIMUR",4,129,8,137
https://kawalpemilu.org#57150,"BANGKA AJANG, RAHONG UTARA, MANGGARAI, NUSA TENGGARA TIMUR",1,100,4,104
https://kawalpemilu.org#57150,"BANGKA AJANG, RAHONG UTARA, MANGGARAI, NUSA TENGGARA TIMUR",2,158,2,160
https://kawalpemilu.org#57150,"BANGKA AJANG, RAHONG UTARA, MANGGARAI, NUSA TENGGARA TIMUR",3,151,13,164
https://kawalpemilu.org#57150,"BANGKA AJANG, RAHONG UTARA, MANGGARAI, NUSA TENGGARA TIMUR",4,187,7,194
https://kawalpemilu.org#57150,"BANGKA AJANG, RAHONG UTARA, MANGGARAI, NUSA TENGGARA TIMUR",5,171,7,178
https://kawalpemilu.org#57150,"BANGKA AJANG, RAHONG UTARA, MANGGARAI, NUSA TENGGARA TIMUR",6,113,8,121
https://kawalpemilu.org#57151,"LIANG BUA, RAHONG UTARA, MANGGARAI, NUSA TENGGARA TIMUR",1,83,3,86
https://kawalpemilu.org#57151,"LIANG BUA, RAHONG UTARA, MANGGARAI, NUSA TENGGARA TIMUR",2,168,5,173
https://kawalpemilu.org#57151,"LIANG BUA, RAHONG UTARA, MANGGARAI, NUSA TENGGARA TIMUR",3,85,5,90
https://kawalpemilu.org#57151,"LIANG BUA, RAHONG UTARA, MANGGARAI, NUSA TENGGARA TIMUR",5,91,4,95
https://kawalpemilu.org#57151,"LIANG BUA, RAHONG UTARA, MANGGARAI, NUSA TENGGARA TIMUR",6,104,1,105
https://kawalpemilu.org#57151,"LIANG BUA, RAHONG UTARA, MANGGARAI, NUSA TENGGARA TIMUR",7,106,4,110
https://kawalpemilu.org#57151,"LIANG BUA, RAHONG UTARA, MANGGARAI, NUSA TENGGARA TIMUR",8,141,8,149
https://kawalpemilu.org#57151,"LIANG BUA, RAHONG UTARA, MANGGARAI, NUSA TENGGARA TIMUR",9,104,7,111
https://kawalpemilu.org#57152,"TENGKU LESE, RAHONG UTARA, MANGGARAI, NUSA TENGGARA TIMUR",1,95,12,107
https://kawalpemilu.org#57152,"TENGKU LESE, RAHONG UTARA, MANGGARAI, NUSA TENGGARA TIMUR",2,156,4,160
https://kawalpemilu.org#57152,"TENGKU LESE, RAHONG UTARA, MANGGARAI, NUSA TENGGARA TIMUR",3,115,2,117
https://kawalpemilu.org#57152,"TENGKU LESE, RAHONG UTARA, MANGGARAI, NUSA TENGGARA TIMUR",4,159,7,166
https://kawalpemilu.org#57152,"TENGKU LESE, RAHONG UTARA, MANGGARAI, NUSA TENGGARA TIMUR",5,113,9,122
https://kawalpemilu.org#57152,"TENGKU LESE, RAHONG UTARA, MANGGARAI, NUSA TENGGARA TIMUR",6,119,5,124
https://kawalpemilu.org#57152,"TENGKU LESE, RAHONG UTARA, MANGGARAI, NUSA TENGGARA TIMUR",7,138,11,149
https://kawalpemilu.org#57152,"TENGKU LESE, RAHONG UTARA, MANGGARAI, NUSA TENGGARA TIMUR",8,111,5,116
https://kawalpemilu.org#57153,"GOLO LANGKOK, RAHONG UTARA, MANGGARAI, NUSA TENGGARA TIMUR",1,197,11,208
https://kawalpemilu.org#57153,"GOLO LANGKOK, RAHONG UTARA, MANGGARAI, NUSA TENGGARA TIMUR",2,195,21,216
https://kawalpemilu.org#57153,"GOLO LANGKOK, RAHONG UTARA, MANGGARAI, NUSA TENGGARA TIMUR",3,166,1,167
https://kawalpemilu.org#57153,"GOLO LANGKOK, RAHONG UTARA, MANGGARAI, NUSA TENGGARA TIMUR",4,215,4,219
https://kawalpemilu.org#57153,"GOLO LANGKOK, RAHONG UTARA, MANGGARAI, NUSA TENGGARA TIMUR",5,155,10,165
https://kawalpemilu.org#57153,"GOLO LANGKOK, RAHONG UTARA, MANGGARAI, NUSA TENGGARA TIMUR",6,187,7,194
https://kawalpemilu.org#57154,"PONG  LENGOR, RAHONG UTARA, MANGGARAI, NUSA TENGGARA TIMUR",1,190,7,197
https://kawalpemilu.org#57154,"PONG  LENGOR, RAHONG UTARA, MANGGARAI, NUSA TENGGARA TIMUR",2,146,1,147
https://kawalpemilu.org#57154,"PONG  LENGOR, RAHONG UTARA, MANGGARAI, NUSA TENGGARA TIMUR",3,124,1,125
https://kawalpemilu.org#57154,"PONG  LENGOR, RAHONG UTARA, MANGGARAI, NUSA TENGGARA TIMUR",4,180,10,190
https://kawalpemilu.org#57154,"PONG  LENGOR, RAHONG UTARA, MANGGARAI, NUSA TENGGARA TIMUR",5,213,12,225
https://kawalpemilu.org#57154,"PONG  LENGOR, RAHONG UTARA, MANGGARAI, NUSA TENGGARA TIMUR",6,141,3,144
https://kawalpemilu.org#57154,"PONG  LENGOR, RAHONG UTARA, MANGGARAI, NUSA TENGGARA TIMUR",7,163,8,171
https://kawalpemilu.org#57155,"MANONG, RAHONG UTARA, MANGGARAI, NUSA TENGGARA TIMUR",1,186,7,193
https://kawalpemilu.org#57155,"MANONG, RAHONG UTARA, MANGGARAI, NUSA TENGGARA TIMUR",2,163,13,176
https://kawalpemilu.org#57155,"MANONG, RAHONG UTARA, MANGGARAI, NUSA TENGGARA TIMUR",3,133,6,139
https://kawalpemilu.org#57155,"MANONG, RAHONG UTARA, MANGGARAI, NUSA TENGGARA TIMUR",4,89,3,92
https://kawalpemilu.org#57155,"MANONG, RAHONG UTARA, MANGGARAI, NUSA TENGGARA TIMUR",5,67,2,69
https://kawalpemilu.org#57156,"BANGKA RUANG, RAHONG UTARA, MANGGARAI, NUSA TENGGARA TIMUR",1,192,5,197
https://kawalpemilu.org#57156,"BANGKA RUANG, RAHONG UTARA, MANGGARAI, NUSA TENGGARA TIMUR",2,190,7,197
https://kawalpemilu.org#57156,"BANGKA RUANG, RAHONG UTARA, MANGGARAI, NUSA TENGGARA TIMUR",3,205,7,212
https://kawalpemilu.org#57156,"BANGKA RUANG, RAHONG UTARA, MANGGARAI, NUSA TENGGARA TIMUR",4,166,15,181
https://kawalpemilu.org#57157,"WAE MANTANG, RAHONG UTARA, MANGGARAI, NUSA TENGGARA TIMUR",1,130,7,137
https://kawalpemilu.org#57157,"WAE MANTANG, RAHONG UTARA, MANGGARAI, NUSA TENGGARA TIMUR",2,117,5,122
https://kawalpemilu.org#57157,"WAE MANTANG, RAHONG UTARA, MANGGARAI, NUSA TENGGARA TIMUR",3,131,2,133
https://kawalpemilu.org#57157,"WAE MANTANG, RAHONG UTARA, MANGGARAI, NUSA TENGGARA TIMUR",4,199,17,216
https://kawalpemilu.org#57157,"WAE MANTANG, RAHONG UTARA, MANGGARAI, NUSA TENGGARA TIMUR",5,183,6,189
https://kawalpemilu.org#57159,"BANGKA LELAK, LELAK, MANGGARAI, NUSA TENGGARA TIMUR",1,206,8,214
https://kawalpemilu.org#57159,"BANGKA LELAK, LELAK, MANGGARAI, NUSA TENGGARA TIMUR",2,192,15,207
https://kawalpemilu.org#57159,"BANGKA LELAK, LELAK, MANGGARAI, NUSA TENGGARA TIMUR",3,93,5,98
https://kawalpemilu.org#57159,"BANGKA LELAK, LELAK, MANGGARAI, NUSA TENGGARA TIMUR",4,189,12,201
https://kawalpemilu.org#57159,"BANGKA LELAK, LELAK, MANGGARAI, NUSA TENGGARA TIMUR",5,181,6,187
https://kawalpemilu.org#57159,"BANGKA LELAK, LELAK, MANGGARAI, NUSA TENGGARA TIMUR",6,233,8,241
https://kawalpemilu.org#57160,"GELONG, LELAK, MANGGARAI, NUSA TENGGARA TIMUR",1,141,24,165
https://kawalpemilu.org#57160,"GELONG, LELAK, MANGGARAI, NUSA TENGGARA TIMUR",2,139,16,155
https://kawalpemilu.org#57160,"GELONG, LELAK, MANGGARAI, NUSA TENGGARA TIMUR",3,123,11,134
https://kawalpemilu.org#57160,"GELONG, LELAK, MANGGARAI, NUSA TENGGARA TIMUR",4,130,4,134
https://kawalpemilu.org#57160,"GELONG, LELAK, MANGGARAI, NUSA TENGGARA TIMUR",5,82,2,84
https://kawalpemilu.org#57161,"URANG, LELAK, MANGGARAI, NUSA TENGGARA TIMUR",1,90,3,93
https://kawalpemilu.org#57161,"URANG, LELAK, MANGGARAI, NUSA TENGGARA TIMUR",2,85,1,86
https://kawalpemilu.org#57161,"URANG, LELAK, MANGGARAI, NUSA TENGGARA TIMUR",3,117,27,144
https://kawalpemilu.org#57161,"URANG, LELAK, MANGGARAI, NUSA TENGGARA TIMUR",4,90,11,101
https://kawalpemilu.org#57161,"URANG, LELAK, MANGGARAI, NUSA TENGGARA TIMUR",5,116,12,128
https://kawalpemilu.org#57161,"URANG, LELAK, MANGGARAI, NUSA TENGGARA TIMUR",6,142,19,161
https://kawalpemilu.org#57162,"KETANG, LELAK, MANGGARAI, NUSA TENGGARA TIMUR",1,184,17,201
https://kawalpemilu.org#57162,"KETANG, LELAK, MANGGARAI, NUSA TENGGARA TIMUR",2,98,17,115
https://kawalpemilu.org#57162,"KETANG, LELAK, MANGGARAI, NUSA TENGGARA TIMUR",3,156,5,161
https://kawalpemilu.org#57162,"KETANG, LELAK, MANGGARAI, NUSA TENGGARA TIMUR",4,71,3,74
https://kawalpemilu.org#57162,"KETANG, LELAK, MANGGARAI, NUSA TENGGARA TIMUR",5,120,11,131
https://kawalpemilu.org#57162,"KETANG, LELAK, MANGGARAI, NUSA TENGGARA TIMUR",6,60,3,63
https://kawalpemilu.org#57163,"PONG UMPU, LELAK, MANGGARAI, NUSA TENGGARA TIMUR",1,176,11,187
https://kawalpemilu.org#57163,"PONG UMPU, LELAK, MANGGARAI, NUSA TENGGARA TIMUR",2,202,20,222
https://kawalpemilu.org#57163,"PONG UMPU, LELAK, MANGGARAI, NUSA TENGGARA TIMUR",3,98,3,101
https://kawalpemilu.org#57164,"BANGKA DESE, LELAK, MANGGARAI, NUSA TENGGARA TIMUR",1,141,11,152
https://kawalpemilu.org#57164,"BANGKA DESE, LELAK, MANGGARAI, NUSA TENGGARA TIMUR",3,93,9,102
https://kawalpemilu.org#57165,"NATI, LELAK, MANGGARAI, NUSA TENGGARA TIMUR",1,160,21,181
https://kawalpemilu.org#57165,"NATI, LELAK, MANGGARAI, NUSA TENGGARA TIMUR",2,135,11,146
https://kawalpemilu.org#57165,"NATI, LELAK, MANGGARAI, NUSA TENGGARA TIMUR",3,87,6,93
https://kawalpemilu.org#57166,"NDIWAR, LELAK, MANGGARAI, NUSA TENGGARA TIMUR",1,133,25,158
https://kawalpemilu.org#57166,"NDIWAR, LELAK, MANGGARAI, NUSA TENGGARA TIMUR",2,159,27,186
https://kawalpemilu.org#57166,"NDIWAR, LELAK, MANGGARAI, NUSA TENGGARA TIMUR",3,133,5,138
https://kawalpemilu.org#57166,"NDIWAR, LELAK, MANGGARAI, NUSA TENGGARA TIMUR",4,79,2,81
https://kawalpemilu.org#87832,"BANGKA TONGGUR, LELAK, MANGGARAI, NUSA TENGGARA TIMUR",1,177,5,182
https://kawalpemilu.org#87832,"BANGKA TONGGUR, LELAK, MANGGARAI, NUSA TENGGARA TIMUR",2,157,15,172
https://kawalpemilu.org#87832,"BANGKA TONGGUR, LELAK, MANGGARAI, NUSA TENGGARA TIMUR",3,100,0,100
https://kawalpemilu.org#87833,"LENTANG, LELAK, MANGGARAI, NUSA TENGGARA TIMUR",1,137,5,142
https://kawalpemilu.org#87833,"LENTANG, LELAK, MANGGARAI, NUSA TENGGARA TIMUR",2,110,13,123
https://kawalpemilu.org#87833,"LENTANG, LELAK, MANGGARAI, NUSA TENGGARA TIMUR",3,145,8,153
https://kawalpemilu.org#87833,"LENTANG, LELAK, MANGGARAI, NUSA TENGGARA TIMUR",4,94,2,96
https://kawalpemilu.org#87833,"LENTANG, LELAK, MANGGARAI, NUSA TENGGARA TIMUR",5,113,2,115
https://kawalpemilu.org#87833,"LENTANG, LELAK, MANGGARAI, NUSA TENGGARA TIMUR",6,109,11,120
https://kawalpemilu.org#87833,"LENTANG, LELAK, MANGGARAI, NUSA TENGGARA TIMUR",7,175,8,183
https://kawalpemilu.org#57097,"RURA, REOK BARAT, MANGGARAI, NUSA TENGGARA TIMUR",1,195,22,217
https://kawalpemilu.org#57097,"RURA, REOK BARAT, MANGGARAI, NUSA TENGGARA TIMUR",2,256,2,258
https://kawalpemilu.org#57097,"RURA, REOK BARAT, MANGGARAI, NUSA TENGGARA TIMUR",3,201,0,201
https://kawalpemilu.org#57097,"RURA, REOK BARAT, MANGGARAI, NUSA TENGGARA TIMUR",4,150,9,159
https://kawalpemilu.org#57097,"RURA, REOK BARAT, MANGGARAI, NUSA TENGGARA TIMUR",5,172,7,179
https://kawalpemilu.org#57098,"KAJONG, REOK BARAT, MANGGARAI, NUSA TENGGARA TIMUR",1,218,5,223
https://kawalpemilu.org#57098,"KAJONG, REOK BARAT, MANGGARAI, NUSA TENGGARA TIMUR",2,158,1,159
https://kawalpemilu.org#57098,"KAJONG, REOK BARAT, MANGGARAI, NUSA TENGGARA TIMUR",3,189,9,198
https://kawalpemilu.org#57098,"KAJONG, REOK BARAT, MANGGARAI, NUSA TENGGARA TIMUR",4,166,13,179
https://kawalpemilu.org#57098,"KAJONG, REOK BARAT, MANGGARAI, NUSA TENGGARA TIMUR",5,145,6,151
https://kawalpemilu.org#57098,"KAJONG, REOK BARAT, MANGGARAI, NUSA TENGGARA TIMUR",6,254,15,269
https://kawalpemilu.org#57098,"KAJONG, REOK BARAT, MANGGARAI, NUSA TENGGARA TIMUR",7,165,10,175
https://kawalpemilu.org#57099,"TOE, REOK BARAT, MANGGARAI, NUSA TENGGARA TIMUR",1,158,9,167
https://kawalpemilu.org#57099,"TOE, REOK BARAT, MANGGARAI, NUSA TENGGARA TIMUR",2,221,13,234
https://kawalpemilu.org#57099,"TOE, REOK BARAT, MANGGARAI, NUSA TENGGARA TIMUR",3,162,3,165
https://kawalpemilu.org#57100,"LOCE, REOK BARAT, MANGGARAI, NUSA TENGGARA TIMUR",1,146,1,147
https://kawalpemilu.org#57100,"LOCE, REOK BARAT, MANGGARAI, NUSA TENGGARA TIMUR",2,294,6,300
https://kawalpemilu.org#57100,"LOCE, REOK BARAT, MANGGARAI, NUSA TENGGARA TIMUR",3,271,1,272
https://kawalpemilu.org#57100,"LOCE, REOK BARAT, MANGGARAI, NUSA TENGGARA TIMUR",4,148,6,154
https://kawalpemilu.org#57100,"LOCE, REOK BARAT, MANGGARAI, NUSA TENGGARA TIMUR",5,188,6,194
https://kawalpemilu.org#57100,"LOCE, REOK BARAT, MANGGARAI, NUSA TENGGARA TIMUR",6,145,1,146
https://kawalpemilu.org#57100,"LOCE, REOK BARAT, MANGGARAI, NUSA TENGGARA TIMUR",7,204,4,208
https://kawalpemilu.org#57101,"SAMBI, REOK BARAT, MANGGARAI, NUSA TENGGARA TIMUR",1,133,8,141
https://kawalpemilu.org#57101,"SAMBI, REOK BARAT, MANGGARAI, NUSA TENGGARA TIMUR",2,206,7,213
https://kawalpemilu.org#57101,"SAMBI, REOK BARAT, MANGGARAI, NUSA TENGGARA TIMUR",3,195,17,212
https://kawalpemilu.org#57101,"SAMBI, REOK BARAT, MANGGARAI, NUSA TENGGARA TIMUR",4,185,14,199
https://kawalpemilu.org#57101,"SAMBI, REOK BARAT, MANGGARAI, NUSA TENGGARA TIMUR",5,194,6,200
https://kawalpemilu.org#57101,"SAMBI, REOK BARAT, MANGGARAI, NUSA TENGGARA TIMUR",6,118,3,121
https://kawalpemilu.org#57102,"LANTE, REOK BARAT, MANGGARAI, NUSA TENGGARA TIMUR",1,142,27,169
https://kawalpemilu.org#57102,"LANTE, REOK BARAT, MANGGARAI, NUSA TENGGARA TIMUR",2,159,9,168
https://kawalpemilu.org#57102,"LANTE, REOK BARAT, MANGGARAI, NUSA TENGGARA TIMUR",3,139,6,145
https://kawalpemilu.org#57102,"LANTE, REOK BARAT, MANGGARAI, NUSA TENGGARA TIMUR",4,179,20,199
https://kawalpemilu.org#57103,"NGGALAK, REOK BARAT, MANGGARAI, NUSA TENGGARA TIMUR",1,194,8,202
https://kawalpemilu.org#57103,"NGGALAK, REOK BARAT, MANGGARAI, NUSA TENGGARA TIMUR",2,137,4,141
https://kawalpemilu.org#57103,"NGGALAK, REOK BARAT, MANGGARAI, NUSA TENGGARA TIMUR",3,221,3,224
https://kawalpemilu.org#57103,"NGGALAK, REOK BARAT, MANGGARAI, NUSA TENGGARA TIMUR",4,162,4,166
https://kawalpemilu.org#57103,"NGGALAK, REOK BARAT, MANGGARAI, NUSA TENGGARA TIMUR",5,119,7,126
https://kawalpemilu.org#57108,"PARA LANDO, REOK BARAT, MANGGARAI, NUSA TENGGARA TIMUR",1,188,5,193
https://kawalpemilu.org#57108,"PARA LANDO, REOK BARAT, MANGGARAI, NUSA TENGGARA TIMUR",2,68,70,138
https://kawalpemilu.org#57108,"PARA LANDO, REOK BARAT, MANGGARAI, NUSA TENGGARA TIMUR",3,180,16,196
https://kawalpemilu.org#57109,"LEMARANG, REOK BARAT, MANGGARAI, NUSA TENGGARA TIMUR",1,204,10,214
https://kawalpemilu.org#57109,"LEMARANG, REOK BARAT, MANGGARAI, NUSA TENGGARA TIMUR",2,141,7,148
https://kawalpemilu.org#57109,"LEMARANG, REOK BARAT, MANGGARAI, NUSA TENGGARA TIMUR",3,97,3,100
https://kawalpemilu.org#88090,"TORONGKOE, REOK BARAT, MANGGARAI, NUSA TENGGARA TIMUR",1,218,21,239
https://kawalpemilu.org#88090,"TORONGKOE, REOK BARAT, MANGGARAI, NUSA TENGGARA TIMUR",2,198,9,207
https://kawalpemilu.org#88090,"TORONGKOE, REOK BARAT, MANGGARAI, NUSA TENGGARA TIMUR",3,220,13,233
https://kawalpemilu.org#57067,"TIMBU, CIBAL BARAT, MANGGARAI, NUSA TENGGARA TIMUR",1,108,15,123
https://kawalpemilu.org#57067,"TIMBU, CIBAL BARAT, MANGGARAI, NUSA TENGGARA TIMUR",2,112,7,119
https://kawalpemilu.org#57067,"TIMBU, CIBAL BARAT, MANGGARAI, NUSA TENGGARA TIMUR",3,112,9,121
https://kawalpemilu.org#57067,"TIMBU, CIBAL BARAT, MANGGARAI, NUSA TENGGARA TIMUR",4,96,18,114
https://kawalpemilu.org#57067,"TIMBU, CIBAL BARAT, MANGGARAI, NUSA TENGGARA TIMUR",5,195,15,210
https://kawalpemilu.org#57067,"TIMBU, CIBAL BARAT, MANGGARAI, NUSA TENGGARA TIMUR",6,196,13,209
https://kawalpemilu.org#57068,"GOLO WOI, CIBAL BARAT, MANGGARAI, NUSA TENGGARA TIMUR",1,160,16,176
https://kawalpemilu.org#57068,"GOLO WOI, CIBAL BARAT, MANGGARAI, NUSA TENGGARA TIMUR",2,122,11,133
https://kawalpemilu.org#57068,"GOLO WOI, CIBAL BARAT, MANGGARAI, NUSA TENGGARA TIMUR",3,170,6,176
https://kawalpemilu.org#57068,"GOLO WOI, CIBAL BARAT, MANGGARAI, NUSA TENGGARA TIMUR",4,153,7,160
https://kawalpemilu.org#57069,"BANGKA ARA, CIBAL BARAT, MANGGARAI, NUSA TENGGARA TIMUR",1,177,11,188
https://kawalpemilu.org#57069,"BANGKA ARA, CIBAL BARAT, MANGGARAI, NUSA TENGGARA TIMUR",2,131,5,136
https://kawalpemilu.org#57080,"WAE RENCA, CIBAL BARAT, MANGGARAI, NUSA TENGGARA TIMUR",1,102,11,113
https://kawalpemilu.org#57080,"WAE RENCA, CIBAL BARAT, MANGGARAI, NUSA TENGGARA TIMUR",2,155,3,158
https://kawalpemilu.org#57080,"WAE RENCA, CIBAL BARAT, MANGGARAI, NUSA TENGGARA TIMUR",3,182,8,190
https://kawalpemilu.org#57080,"WAE RENCA, CIBAL BARAT, MANGGARAI, NUSA TENGGARA TIMUR",4,153,7,160
https://kawalpemilu.org#57080,"WAE RENCA, CIBAL BARAT, MANGGARAI, NUSA TENGGARA TIMUR",5,169,5,174
https://kawalpemilu.org#57080,"WAE RENCA, CIBAL BARAT, MANGGARAI, NUSA TENGGARA TIMUR",6,82,5,87
https://kawalpemilu.org#57080,"WAE RENCA, CIBAL BARAT, MANGGARAI, NUSA TENGGARA TIMUR",7,105,3,108
https://kawalpemilu.org#57081,"WAE CODI, CIBAL BARAT, MANGGARAI, NUSA TENGGARA TIMUR",1,166,8,174
https://kawalpemilu.org#57081,"WAE CODI, CIBAL BARAT, MANGGARAI, NUSA TENGGARA TIMUR",2,209,9,218
https://kawalpemilu.org#57081,"WAE CODI, CIBAL BARAT, MANGGARAI, NUSA TENGGARA TIMUR",3,112,16,128
https://kawalpemilu.org#57081,"WAE CODI, CIBAL BARAT, MANGGARAI, NUSA TENGGARA TIMUR",4,172,12,184
https://kawalpemilu.org#57081,"WAE CODI, CIBAL BARAT, MANGGARAI, NUSA TENGGARA TIMUR",5,141,3,144
https://kawalpemilu.org#57081,"WAE CODI, CIBAL BARAT, MANGGARAI, NUSA TENGGARA TIMUR",6,74,5,79
https://kawalpemilu.org#57082,"LATUNG, CIBAL BARAT, MANGGARAI, NUSA TENGGARA TIMUR",1,173,11,184
https://kawalpemilu.org#57082,"LATUNG, CIBAL BARAT, MANGGARAI, NUSA TENGGARA TIMUR",2,99,6,105
https://kawalpemilu.org#57082,"LATUNG, CIBAL BARAT, MANGGARAI, NUSA TENGGARA TIMUR",3,130,8,138
https://kawalpemilu.org#57082,"LATUNG, CIBAL BARAT, MANGGARAI, NUSA TENGGARA TIMUR",4,188,15,203
https://kawalpemilu.org#57083,"COMPANG CIBAL, CIBAL BARAT, MANGGARAI, NUSA TENGGARA TIMUR",1,205,9,214
https://kawalpemilu.org#57083,"COMPANG CIBAL, CIBAL BARAT, MANGGARAI, NUSA TENGGARA TIMUR",2,245,9,254
https://kawalpemilu.org#57083,"COMPANG CIBAL, CIBAL BARAT, MANGGARAI, NUSA TENGGARA TIMUR",3,207,14,221
https://kawalpemilu.org#57084,"LENDA, CIBAL BARAT, MANGGARAI, NUSA TENGGARA TIMUR",1,129,6,135
https://kawalpemilu.org#57084,"LENDA, CIBAL BARAT, MANGGARAI, NUSA TENGGARA TIMUR",2,61,28,89
https://kawalpemilu.org#57084,"LENDA, CIBAL BARAT, MANGGARAI, NUSA TENGGARA TIMUR",3,142,10,152
https://kawalpemilu.org#57084,"LENDA, CIBAL BARAT, MANGGARAI, NUSA TENGGARA TIMUR",4,76,6,82
https://kawalpemilu.org#57084,"LENDA, CIBAL BARAT, MANGGARAI, NUSA TENGGARA TIMUR",5,143,6,149
https://kawalpemilu.org#57084,"LENDA, CIBAL BARAT, MANGGARAI, NUSA TENGGARA TIMUR",6,144,16,160
https://kawalpemilu.org#57084,"LENDA, CIBAL BARAT, MANGGARAI, NUSA TENGGARA TIMUR",7,39,0,39
https://kawalpemilu.org#57085,"BERE, CIBAL BARAT, MANGGARAI, NUSA TENGGARA TIMUR",1,154,18,172
https://kawalpemilu.org#57085,"BERE, CIBAL BARAT, MANGGARAI, NUSA TENGGARA TIMUR",2,163,10,173
https://kawalpemilu.org#57085,"BERE, CIBAL BARAT, MANGGARAI, NUSA TENGGARA TIMUR",3,110,3,113
https://kawalpemilu.org#57085,"BERE, CIBAL BARAT, MANGGARAI, NUSA TENGGARA TIMUR",4,85,2,87
https://kawalpemilu.org#57085,"BERE, CIBAL BARAT, MANGGARAI, NUSA TENGGARA TIMUR",5,80,12,92
https://kawalpemilu.org#57085,"BERE, CIBAL BARAT, MANGGARAI, NUSA TENGGARA TIMUR",6,133,4,137
https://kawalpemilu.org#57085,"BERE, CIBAL BARAT, MANGGARAI, NUSA TENGGARA TIMUR",7,121,8,129
https://kawalpemilu.org#57087,"GOLO LANAK, CIBAL BARAT, MANGGARAI, NUSA TENGGARA TIMUR",1,143,10,153
https://kawalpemilu.org#57087,"GOLO LANAK, CIBAL BARAT, MANGGARAI, NUSA TENGGARA TIMUR",2,176,12,188
https://kawalpemilu.org#57087,"GOLO LANAK, CIBAL BARAT, MANGGARAI, NUSA TENGGARA TIMUR",3,181,12,193
https://kawalpemilu.org#57087,"GOLO LANAK, CIBAL BARAT, MANGGARAI, NUSA TENGGARA TIMUR",4,121,9,130
https://kawalpemilu.org#57125,"TODO, SATAR MESE UTARA, MANGGARAI, NUSA TENGGARA TIMUR",1,162,5,167
https://kawalpemilu.org#57125,"TODO, SATAR MESE UTARA, MANGGARAI, NUSA TENGGARA TIMUR",2,214,24,238
https://kawalpemilu.org#57125,"TODO, SATAR MESE UTARA, MANGGARAI, NUSA TENGGARA TIMUR",3,181,16,197
https://kawalpemilu.org#57125,"TODO, SATAR MESE UTARA, MANGGARAI, NUSA TENGGARA TIMUR",4,59,7,66
https://kawalpemilu.org#57127,"GULUNG, SATAR MESE UTARA, MANGGARAI, NUSA TENGGARA TIMUR",1,151,17,168
https://kawalpemilu.org#57127,"GULUNG, SATAR MESE UTARA, MANGGARAI, NUSA TENGGARA TIMUR",2,188,26,214
https://kawalpemilu.org#57127,"GULUNG, SATAR MESE UTARA, MANGGARAI, NUSA TENGGARA TIMUR",3,103,17,120
https://kawalpemilu.org#57127,"GULUNG, SATAR MESE UTARA, MANGGARAI, NUSA TENGGARA TIMUR",4,93,10,103
https://kawalpemilu.org#57127,"GULUNG, SATAR MESE UTARA, MANGGARAI, NUSA TENGGARA TIMUR",5,154,10,164
https://kawalpemilu.org#57128,"RENDA, SATAR MESE UTARA, MANGGARAI, NUSA TENGGARA TIMUR",1,128,24,152
https://kawalpemilu.org#57128,"RENDA, SATAR MESE UTARA, MANGGARAI, NUSA TENGGARA TIMUR",2,144,28,172
https://kawalpemilu.org#57128,"RENDA, SATAR MESE UTARA, MANGGARAI, NUSA TENGGARA TIMUR",3,238,55,293
https://kawalpemilu.org#57128,"RENDA, SATAR MESE UTARA, MANGGARAI, NUSA TENGGARA TIMUR",4,215,15,230
https://kawalpemilu.org#57130,"POPO, SATAR MESE UTARA, MANGGARAI, NUSA TENGGARA TIMUR",1,170,9,179
https://kawalpemilu.org#57130,"POPO, SATAR MESE UTARA, MANGGARAI, NUSA TENGGARA TIMUR",2,130,5,135
https://kawalpemilu.org#57130,"POPO, SATAR MESE UTARA, MANGGARAI, NUSA TENGGARA TIMUR",3,180,57,237
https://kawalpemilu.org#57130,"POPO, SATAR MESE UTARA, MANGGARAI, NUSA TENGGARA TIMUR",4,156,31,187
https://kawalpemilu.org#57131,"LIA, SATAR MESE UTARA, MANGGARAI, NUSA TENGGARA TIMUR",1,170,28,198
https://kawalpemilu.org#57131,"LIA, SATAR MESE UTARA, MANGGARAI, NUSA TENGGARA TIMUR",2,105,25,130
https://kawalpemilu.org#57131,"LIA, SATAR MESE UTARA, MANGGARAI, NUSA TENGGARA TIMUR",3,143,15,158
https://kawalpemilu.org#57131,"LIA, SATAR MESE UTARA, MANGGARAI, NUSA TENGGARA TIMUR",4,154,23,177
https://kawalpemilu.org#57132,"LING, SATAR MESE UTARA, MANGGARAI, NUSA TENGGARA TIMUR",1,227,30,257
https://kawalpemilu.org#57132,"LING, SATAR MESE UTARA, MANGGARAI, NUSA TENGGARA TIMUR",2,78,8,86
https://kawalpemilu.org#57132,"LING, SATAR MESE UTARA, MANGGARAI, NUSA TENGGARA TIMUR",3,181,18,199
https://kawalpemilu.org#57133,"KOLE, SATAR MESE UTARA, MANGGARAI, NUSA TENGGARA TIMUR",1,198,32,230
https://kawalpemilu.org#57133,"KOLE, SATAR MESE UTARA, MANGGARAI, NUSA TENGGARA TIMUR",2,202,25,227
https://kawalpemilu.org#57133,"KOLE, SATAR MESE UTARA, MANGGARAI, NUSA TENGGARA TIMUR",3,200,30,230
https://kawalpemilu.org#57134,"NAO, SATAR MESE UTARA, MANGGARAI, NUSA TENGGARA TIMUR",1,207,16,223
https://kawalpemilu.org#57134,"NAO, SATAR MESE UTARA, MANGGARAI, NUSA TENGGARA TIMUR",2,158,8,166
https://kawalpemilu.org#57134,"NAO, SATAR MESE UTARA, MANGGARAI, NUSA TENGGARA TIMUR",3,112,28,140
https://kawalpemilu.org#57134,"NAO, SATAR MESE UTARA, MANGGARAI, NUSA TENGGARA TIMUR",4,185,12,197
https://kawalpemilu.org#57134,"NAO, SATAR MESE UTARA, MANGGARAI, NUSA TENGGARA TIMUR",5,109,11,120
https://kawalpemilu.org#57135,"CIRENG, SATAR MESE UTARA, MANGGARAI, NUSA TENGGARA TIMUR",1,161,10,171
https://kawalpemilu.org#57135,"CIRENG, SATAR MESE UTARA, MANGGARAI, NUSA TENGGARA TIMUR",2,104,4,108
https://kawalpemilu.org#57135,"CIRENG, SATAR MESE UTARA, MANGGARAI, NUSA TENGGARA TIMUR",3,140,14,154
https://kawalpemilu.org#57135,"CIRENG, SATAR MESE UTARA, MANGGARAI, NUSA TENGGARA TIMUR",4,153,18,171
https://kawalpemilu.org#57144,"RUANG, SATAR MESE UTARA, MANGGARAI, NUSA TENGGARA TIMUR",1,186,6,192
https://kawalpemilu.org#57144,"RUANG, SATAR MESE UTARA, MANGGARAI, NUSA TENGGARA TIMUR",2,135,6,141
https://kawalpemilu.org#57144,"RUANG, SATAR MESE UTARA, MANGGARAI, NUSA TENGGARA TIMUR",3,155,5,160
https://kawalpemilu.org#57144,"RUANG, SATAR MESE UTARA, MANGGARAI, NUSA TENGGARA TIMUR",4,95,6,101
https://kawalpemilu.org#87840,"MATA WAE, SATAR MESE UTARA, MANGGARAI, NUSA TENGGARA TIMUR",1,130,25,155
https://kawalpemilu.org#87840,"MATA WAE, SATAR MESE UTARA, MANGGARAI, NUSA TENGGARA TIMUR",2,199,16,215
https://kawalpemilu.org#87840,"MATA WAE, SATAR MESE UTARA, MANGGARAI, NUSA TENGGARA TIMUR",3,95,13,108
https://kawalpemilu.org#87840,"MATA WAE, SATAR MESE UTARA, MANGGARAI, NUSA TENGGARA TIMUR",4,153,15,168
https://kawalpemilu.org#57169,"KAMBAJAWA, KOTA WAINGAPU, SUMBA TIMUR, NUSA TENGGARA TIMUR",1,161,10,171
https://kawalpemilu.org#57169,"KAMBAJAWA, KOTA WAINGAPU, SUMBA TIMUR, NUSA TENGGARA TIMUR",2,170,33,203
https://kawalpemilu.org#57169,"KAMBAJAWA, KOTA WAINGAPU, SUMBA TIMUR, NUSA TENGGARA TIMUR",3,113,95,208
https://kawalpemilu.org#57169,"KAMBAJAWA, KOTA WAINGAPU, SUMBA TIMUR, NUSA TENGGARA TIMUR",4,101,57,158
https://kawalpemilu.org#57169,"KAMBAJAWA, KOTA WAINGAPU, SUMBA TIMUR, NUSA TENGGARA TIMUR",5,95,4,99
https://kawalpemilu.org#57169,"KAMBAJAWA, KOTA WAINGAPU, SUMBA TIMUR, NUSA TENGGARA TIMUR",6,189,16,205
https://kawalpemilu.org#57169,"KAMBAJAWA, KOTA WAINGAPU, SUMBA TIMUR, NUSA TENGGARA TIMUR",7,192,26,218
https://kawalpemilu.org#57169,"KAMBAJAWA, KOTA WAINGAPU, SUMBA TIMUR, NUSA TENGGARA TIMUR",8,173,13,186
https://kawalpemilu.org#57169,"KAMBAJAWA, KOTA WAINGAPU, SUMBA TIMUR, NUSA TENGGARA TIMUR",9,156,60,216
https://kawalpemilu.org#57169,"KAMBAJAWA, KOTA WAINGAPU, SUMBA TIMUR, NUSA TENGGARA TIMUR",10,135,13,148
https://kawalpemilu.org#57169,"KAMBAJAWA, KOTA WAINGAPU, SUMBA TIMUR, NUSA TENGGARA TIMUR",11,185,14,199
https://kawalpemilu.org#57169,"KAMBAJAWA, KOTA WAINGAPU, SUMBA TIMUR, NUSA TENGGARA TIMUR",12,182,10,192
https://kawalpemilu.org#57169,"KAMBAJAWA, KOTA WAINGAPU, SUMBA TIMUR, NUSA TENGGARA TIMUR",13,192,14,206
https://kawalpemilu.org#57169,"KAMBAJAWA, KOTA WAINGAPU, SUMBA TIMUR, NUSA TENGGARA TIMUR",14,188,15,203
https://kawalpemilu.org#57169,"KAMBAJAWA, KOTA WAINGAPU, SUMBA TIMUR, NUSA TENGGARA TIMUR",15,124,6,130
https://kawalpemilu.org#57169,"KAMBAJAWA, KOTA WAINGAPU, SUMBA TIMUR, NUSA TENGGARA TIMUR",16,171,3,174
https://kawalpemilu.org#57169,"KAMBAJAWA, KOTA WAINGAPU, SUMBA TIMUR, NUSA TENGGARA TIMUR",17,118,19,137
https://kawalpemilu.org#57169,"KAMBAJAWA, KOTA WAINGAPU, SUMBA TIMUR, NUSA TENGGARA TIMUR",18,129,12,141
https://kawalpemilu.org#57169,"KAMBAJAWA, KOTA WAINGAPU, SUMBA TIMUR, NUSA TENGGARA TIMUR",19,159,13,172
https://kawalpemilu.org#57169,"KAMBAJAWA, KOTA WAINGAPU, SUMBA TIMUR, NUSA TENGGARA TIMUR",20,198,31,229
https://kawalpemilu.org#57169,"KAMBAJAWA, KOTA WAINGAPU, SUMBA TIMUR, NUSA TENGGARA TIMUR",21,132,54,186
https://kawalpemilu.org#57169,"KAMBAJAWA, KOTA WAINGAPU, SUMBA TIMUR, NUSA TENGGARA TIMUR",22,118,18,136
https://kawalpemilu.org#57169,"KAMBAJAWA, KOTA WAINGAPU, SUMBA TIMUR, NUSA TENGGARA TIMUR",23,107,9,116
https://kawalpemilu.org#57169,"KAMBAJAWA, KOTA WAINGAPU, SUMBA TIMUR, NUSA TENGGARA TIMUR",24,153,47,200
https://kawalpemilu.org#57169,"KAMBAJAWA, KOTA WAINGAPU, SUMBA TIMUR, NUSA TENGGARA TIMUR",25,153,12,165
https://kawalpemilu.org#57169,"KAMBAJAWA, KOTA WAINGAPU, SUMBA TIMUR, NUSA TENGGARA TIMUR",26,153,17,170
https://kawalpemilu.org#57169,"KAMBAJAWA, KOTA WAINGAPU, SUMBA TIMUR, NUSA TENGGARA TIMUR",27,111,2,113
https://kawalpemilu.org#57169,"KAMBAJAWA, KOTA WAINGAPU, SUMBA TIMUR, NUSA TENGGARA TIMUR",28,160,7,167
https://kawalpemilu.org#57169,"KAMBAJAWA, KOTA WAINGAPU, SUMBA TIMUR, NUSA TENGGARA TIMUR",29,110,3,113
https://kawalpemilu.org#57169,"KAMBAJAWA, KOTA WAINGAPU, SUMBA TIMUR, NUSA TENGGARA TIMUR",30,116,11,127
https://kawalpemilu.org#57170,"HAMBALA, KOTA WAINGAPU, SUMBA TIMUR, NUSA TENGGARA TIMUR",1,85,154,239
https://kawalpemilu.org#57170,"HAMBALA, KOTA WAINGAPU, SUMBA TIMUR, NUSA TENGGARA TIMUR",2,107,121,228
https://kawalpemilu.org#57170,"HAMBALA, KOTA WAINGAPU, SUMBA TIMUR, NUSA TENGGARA TIMUR",3,61,137,198
https://kawalpemilu.org#57170,"HAMBALA, KOTA WAINGAPU, SUMBA TIMUR, NUSA TENGGARA TIMUR",4,46,147,193
https://kawalpemilu.org#57170,"HAMBALA, KOTA WAINGAPU, SUMBA TIMUR, NUSA TENGGARA TIMUR",5,212,25,237
https://kawalpemilu.org#57170,"HAMBALA, KOTA WAINGAPU, SUMBA TIMUR, NUSA TENGGARA TIMUR",6,219,32,251
https://kawalpemilu.org#57170,"HAMBALA, KOTA WAINGAPU, SUMBA TIMUR, NUSA TENGGARA TIMUR",7,217,15,232
https://kawalpemilu.org#57170,"HAMBALA, KOTA WAINGAPU, SUMBA TIMUR, NUSA TENGGARA TIMUR",8,177,18,195
https://kawalpemilu.org#57170,"HAMBALA, KOTA WAINGAPU, SUMBA TIMUR, NUSA TENGGARA TIMUR",9,153,63,216
https://kawalpemilu.org#57170,"HAMBALA, KOTA WAINGAPU, SUMBA TIMUR, NUSA TENGGARA TIMUR",10,233,12,245
https://kawalpemilu.org#57170,"HAMBALA, KOTA WAINGAPU, SUMBA TIMUR, NUSA TENGGARA TIMUR",11,212,12,224
https://kawalpemilu.org#57170,"HAMBALA, KOTA WAINGAPU, SUMBA TIMUR, NUSA TENGGARA TIMUR",12,86,147,233
https://kawalpemilu.org#57170,"HAMBALA, KOTA WAINGAPU, SUMBA TIMUR, NUSA TENGGARA TIMUR",13,62,92,154
https://kawalpemilu.org#57170,"HAMBALA, KOTA WAINGAPU, SUMBA TIMUR, NUSA TENGGARA TIMUR",14,82,123,205
https://kawalpemilu.org#57170,"HAMBALA, KOTA WAINGAPU, SUMBA TIMUR, NUSA TENGGARA TIMUR",15,163,40,203
https://kawalpemilu.org#57170,"HAMBALA, KOTA WAINGAPU, SUMBA TIMUR, NUSA TENGGARA TIMUR",16,156,12,168
https://kawalpemilu.org#57170,"HAMBALA, KOTA WAINGAPU, SUMBA TIMUR, NUSA TENGGARA TIMUR",17,224,2,226
https://kawalpemilu.org#57170,"HAMBALA, KOTA WAINGAPU, SUMBA TIMUR, NUSA TENGGARA TIMUR",18,69,101,170
https://kawalpemilu.org#57170,"HAMBALA, KOTA WAINGAPU, SUMBA TIMUR, NUSA TENGGARA TIMUR",19,51,100,151
https://kawalpemilu.org#57171,"MATAWAI, KOTA WAINGAPU, SUMBA TIMUR, NUSA TENGGARA TIMUR",1,156,36,192
https://kawalpemilu.org#57171,"MATAWAI, KOTA WAINGAPU, SUMBA TIMUR, NUSA TENGGARA TIMUR",2,181,32,213
https://kawalpemilu.org#57171,"MATAWAI, KOTA WAINGAPU, SUMBA TIMUR, NUSA TENGGARA TIMUR",3,232,25,257
https://kawalpemilu.org#57171,"MATAWAI, KOTA WAINGAPU, SUMBA TIMUR, NUSA TENGGARA TIMUR",4,230,22,252
https://kawalpemilu.org#57171,"MATAWAI, KOTA WAINGAPU, SUMBA TIMUR, NUSA TENGGARA TIMUR",5,165,44,209
https://kawalpemilu.org#57171,"MATAWAI, KOTA WAINGAPU, SUMBA TIMUR, NUSA TENGGARA TIMUR",6,180,16,196
https://kawalpemilu.org#57171,"MATAWAI, KOTA WAINGAPU, SUMBA TIMUR, NUSA TENGGARA TIMUR",7,145,13,158
https://kawalpemilu.org#57171,"MATAWAI, KOTA WAINGAPU, SUMBA TIMUR, NUSA TENGGARA TIMUR",8,132,22,154
https://kawalpemilu.org#57171,"MATAWAI, KOTA WAINGAPU, SUMBA TIMUR, NUSA TENGGARA TIMUR",9,136,73,209
https://kawalpemilu.org#57171,"MATAWAI, KOTA WAINGAPU, SUMBA TIMUR, NUSA TENGGARA TIMUR",10,155,9,164
https://kawalpemilu.org#57172,"KAMALAPUTI, KOTA WAINGAPU, SUMBA TIMUR, NUSA TENGGARA TIMUR",1,89,127,216
https://kawalpemilu.org#57172,"KAMALAPUTI, KOTA WAINGAPU, SUMBA TIMUR, NUSA TENGGARA TIMUR",2,52,168,220
https://kawalpemilu.org#57172,"KAMALAPUTI, KOTA WAINGAPU, SUMBA TIMUR, NUSA TENGGARA TIMUR",3,215,6,221
https://kawalpemilu.org#57172,"KAMALAPUTI, KOTA WAINGAPU, SUMBA TIMUR, NUSA TENGGARA TIMUR",4,115,98,213
https://kawalpemilu.org#57172,"KAMALAPUTI, KOTA WAINGAPU, SUMBA TIMUR, NUSA TENGGARA TIMUR",5,125,60,185
https://kawalpemilu.org#57172,"KAMALAPUTI, KOTA WAINGAPU, SUMBA TIMUR, NUSA TENGGARA TIMUR",6,190,47,237
https://kawalpemilu.org#57172,"KAMALAPUTI, KOTA WAINGAPU, SUMBA TIMUR, NUSA TENGGARA TIMUR",7,181,34,215
https://kawalpemilu.org#57172,"KAMALAPUTI, KOTA WAINGAPU, SUMBA TIMUR, NUSA TENGGARA TIMUR",8,188,51,239
https://kawalpemilu.org#57172,"KAMALAPUTI, KOTA WAINGAPU, SUMBA TIMUR, NUSA TENGGARA TIMUR",9,66,150,216
https://kawalpemilu.org#57172,"KAMALAPUTI, KOTA WAINGAPU, SUMBA TIMUR, NUSA TENGGARA TIMUR",10,72,179,251
https://kawalpemilu.org#57172,"KAMALAPUTI, KOTA WAINGAPU, SUMBA TIMUR, NUSA TENGGARA TIMUR",11,101,169,270
https://kawalpemilu.org#57172,"KAMALAPUTI, KOTA WAINGAPU, SUMBA TIMUR, NUSA TENGGARA TIMUR",12,169,43,212
https://kawalpemilu.org#57172,"KAMALAPUTI, KOTA WAINGAPU, SUMBA TIMUR, NUSA TENGGARA TIMUR",13,191,51,242
https://kawalpemilu.org#57172,"KAMALAPUTI, KOTA WAINGAPU, SUMBA TIMUR, NUSA TENGGARA TIMUR",14,43,218,261
https://kawalpemilu.org#57172,"KAMALAPUTI, KOTA WAINGAPU, SUMBA TIMUR, NUSA TENGGARA TIMUR",15,115,22,137
https://kawalpemilu.org#57172,"KAMALAPUTI, KOTA WAINGAPU, SUMBA TIMUR, NUSA TENGGARA TIMUR",16,173,49,222
https://kawalpemilu.org#57172,"KAMALAPUTI, KOTA WAINGAPU, SUMBA TIMUR, NUSA TENGGARA TIMUR",17,96,118,214
https://kawalpemilu.org#57172,"KAMALAPUTI, KOTA WAINGAPU, SUMBA TIMUR, NUSA TENGGARA TIMUR",18,57,142,199
https://kawalpemilu.org#57172,"KAMALAPUTI, KOTA WAINGAPU, SUMBA TIMUR, NUSA TENGGARA TIMUR",19,43,218,261
https://kawalpemilu.org#57172,"KAMALAPUTI, KOTA WAINGAPU, SUMBA TIMUR, NUSA TENGGARA TIMUR",20,57,107,164
https://kawalpemilu.org#57173,"LUKUKAMARU, KOTA WAINGAPU, SUMBA TIMUR, NUSA TENGGARA TIMUR",1,131,2,133
https://kawalpemilu.org#57173,"LUKUKAMARU, KOTA WAINGAPU, SUMBA TIMUR, NUSA TENGGARA TIMUR",2,129,1,130
https://kawalpemilu.org#57173,"LUKUKAMARU, KOTA WAINGAPU, SUMBA TIMUR, NUSA TENGGARA TIMUR",3,104,1,105
https://kawalpemilu.org#57174,"MBATAKAPIDU, KOTA WAINGAPU, SUMBA TIMUR, NUSA TENGGARA TIMUR",1,215,13,228
https://kawalpemilu.org#57174,"MBATAKAPIDU, KOTA WAINGAPU, SUMBA TIMUR, NUSA TENGGARA TIMUR",2,172,7,179
https://kawalpemilu.org#57174,"MBATAKAPIDU, KOTA WAINGAPU, SUMBA TIMUR, NUSA TENGGARA TIMUR",3,182,4,186
https://kawalpemilu.org#57174,"MBATAKAPIDU, KOTA WAINGAPU, SUMBA TIMUR, NUSA TENGGARA TIMUR",4,213,6,219
https://kawalpemilu.org#57174,"MBATAKAPIDU, KOTA WAINGAPU, SUMBA TIMUR, NUSA TENGGARA TIMUR",5,149,8,157
https://kawalpemilu.org#57175,"PAMBOTANDJARA, KOTA WAINGAPU, SUMBA TIMUR, NUSA TENGGARA TIMUR",1,210,6,216
https://kawalpemilu.org#57175,"PAMBOTANDJARA, KOTA WAINGAPU, SUMBA TIMUR, NUSA TENGGARA TIMUR",2,211,6,217
https://kawalpemilu.org#57175,"PAMBOTANDJARA, KOTA WAINGAPU, SUMBA TIMUR, NUSA TENGGARA TIMUR",3,230,2,232
https://kawalpemilu.org#57175,"PAMBOTANDJARA, KOTA WAINGAPU, SUMBA TIMUR, NUSA TENGGARA TIMUR",4,75,0,75
https://kawalpemilu.org#57175,"PAMBOTANDJARA, KOTA WAINGAPU, SUMBA TIMUR, NUSA TENGGARA TIMUR",5,148,0,153
https://kawalpemilu.org#57175,"PAMBOTANDJARA, KOTA WAINGAPU, SUMBA TIMUR, NUSA TENGGARA TIMUR",6,160,7,167
https://kawalpemilu.org#57177,"RAMBANGARU, HAHARU, SUMBA TIMUR, NUSA TENGGARA TIMUR",1,194,9,203
https://kawalpemilu.org#57177,"RAMBANGARU, HAHARU, SUMBA TIMUR, NUSA TENGGARA TIMUR",2,234,12,246
https://kawalpemilu.org#57177,"RAMBANGARU, HAHARU, SUMBA TIMUR, NUSA TENGGARA TIMUR",3,180,13,193
https://kawalpemilu.org#57178,"PRAIBAKUL, HAHARU, SUMBA TIMUR, NUSA TENGGARA TIMUR",1,87,4,91
https://kawalpemilu.org#57178,"PRAIBAKUL, HAHARU, SUMBA TIMUR, NUSA TENGGARA TIMUR",2,183,14,197
https://kawalpemilu.org#57178,"PRAIBAKUL, HAHARU, SUMBA TIMUR, NUSA TENGGARA TIMUR",3,156,8,164
https://kawalpemilu.org#57179,"WUNGA, HAHARU, SUMBA TIMUR, NUSA TENGGARA TIMUR",1,218,9,227
https://kawalpemilu.org#57179,"WUNGA, HAHARU, SUMBA TIMUR, NUSA TENGGARA TIMUR",2,203,3,206
https://kawalpemilu.org#57180,"KADAHANG, HAHARU, SUMBA TIMUR, NUSA TENGGARA TIMUR",1,179,6,185
https://kawalpemilu.org#57180,"KADAHANG, HAHARU, SUMBA TIMUR, NUSA TENGGARA TIMUR",2,190,16,206
https://kawalpemilu.org#57181,"NAPU, HAHARU, SUMBA TIMUR, NUSA TENGGARA TIMUR",1,164,9,173
https://kawalpemilu.org#57181,"NAPU, HAHARU, SUMBA TIMUR, NUSA TENGGARA TIMUR",2,192,1,193
https://kawalpemilu.org#57181,"NAPU, HAHARU, SUMBA TIMUR, NUSA TENGGARA TIMUR",3,97,2,99
https://kawalpemilu.org#57182,"MBATAPUHU, HAHARU, SUMBA TIMUR, NUSA TENGGARA TIMUR",1,139,7,146
https://kawalpemilu.org#57182,"MBATAPUHU, HAHARU, SUMBA TIMUR, NUSA TENGGARA TIMUR",2,153,32,185
https://kawalpemilu.org#57182,"MBATAPUHU, HAHARU, SUMBA TIMUR, NUSA TENGGARA TIMUR",3,101,3,104
https://kawalpemilu.org#57182,"MBATAPUHU, HAHARU, SUMBA TIMUR, NUSA TENGGARA TIMUR",4,131,8,139
https://kawalpemilu.org#57183,"KALAMBA, HAHARU, SUMBA TIMUR, NUSA TENGGARA TIMUR",1,162,3,165
https://kawalpemilu.org#57185,"LEWA PAKU, LEWA, SUMBA TIMUR, NUSA TENGGARA TIMUR",1,132,20,152
https://kawalpemilu.org#57185,"LEWA PAKU, LEWA, SUMBA TIMUR, NUSA TENGGARA TIMUR",2,198,10,208
https://kawalpemilu.org#57185,"LEWA PAKU, LEWA, SUMBA TIMUR, NUSA TENGGARA TIMUR",3,126,105,231
https://kawalpemilu.org#57185,"LEWA PAKU, LEWA, SUMBA TIMUR, NUSA TENGGARA TIMUR",4,146,71,217
https://kawalpemilu.org#57185,"LEWA PAKU, LEWA, SUMBA TIMUR, NUSA TENGGARA TIMUR",5,153,4,157
https://kawalpemilu.org#57185,"LEWA PAKU, LEWA, SUMBA TIMUR, NUSA TENGGARA TIMUR",6,157,15,172
https://kawalpemilu.org#57185,"LEWA PAKU, LEWA, SUMBA TIMUR, NUSA TENGGARA TIMUR",7,226,10,236
https://kawalpemilu.org#57185,"LEWA PAKU, LEWA, SUMBA TIMUR, NUSA TENGGARA TIMUR",8,182,8,190
https://kawalpemilu.org#57185,"LEWA PAKU, LEWA, SUMBA TIMUR, NUSA TENGGARA TIMUR",9,167,12,179
https://kawalpemilu.org#57185,"LEWA PAKU, LEWA, SUMBA TIMUR, NUSA TENGGARA TIMUR",10,180,6,186
https://kawalpemilu.org#57185,"LEWA PAKU, LEWA, SUMBA TIMUR, NUSA TENGGARA TIMUR",11,175,8,183
https://kawalpemilu.org#57186,"KAMBUHAPANG, LEWA, SUMBA TIMUR, NUSA TENGGARA TIMUR",1,206,23,229
https://kawalpemilu.org#57186,"KAMBUHAPANG, LEWA, SUMBA TIMUR, NUSA TENGGARA TIMUR",2,211,6,217
https://kawalpemilu.org#57186,"KAMBUHAPANG, LEWA, SUMBA TIMUR, NUSA TENGGARA TIMUR",3,204,1,205
https://kawalpemilu.org#57186,"KAMBUHAPANG, LEWA, SUMBA TIMUR, NUSA TENGGARA TIMUR",4,200,3,203
https://kawalpemilu.org#57187,"KAMBATA WUNDUT, LEWA, SUMBA TIMUR, NUSA TENGGARA TIMUR",1,262,4,266
https://kawalpemilu.org#57187,"KAMBATA WUNDUT, LEWA, SUMBA TIMUR, NUSA TENGGARA TIMUR",2,237,5,242
https://kawalpemilu.org#57187,"KAMBATA WUNDUT, LEWA, SUMBA TIMUR, NUSA TENGGARA TIMUR",3,186,11,197
https://kawalpemilu.org#57187,"KAMBATA WUNDUT, LEWA, SUMBA TIMUR, NUSA TENGGARA TIMUR",4,171,12,183
https://kawalpemilu.org#57187,"KAMBATA WUNDUT, LEWA, SUMBA TIMUR, NUSA TENGGARA TIMUR",5,161,9,170
https://kawalpemilu.org#57187,"KAMBATA WUNDUT, LEWA, SUMBA TIMUR, NUSA TENGGARA TIMUR",6,192,11,0
https://kawalpemilu.org#57187,"KAMBATA WUNDUT, LEWA, SUMBA TIMUR, NUSA TENGGARA TIMUR",7,123,4,127
https://kawalpemilu.org#57187,"KAMBATA WUNDUT, LEWA, SUMBA TIMUR, NUSA TENGGARA TIMUR",8,163,4,167
https://kawalpemilu.org#57188,"KONDAMARA, LEWA, SUMBA TIMUR, NUSA TENGGARA TIMUR",1,218,3,221
https://kawalpemilu.org#57188,"KONDAMARA, LEWA, SUMBA TIMUR, NUSA TENGGARA TIMUR",2,237,6,243
https://kawalpemilu.org#57188,"KONDAMARA, LEWA, SUMBA TIMUR, NUSA TENGGARA TIMUR",3,162,6,168
https://kawalpemilu.org#57188,"KONDAMARA, LEWA, SUMBA TIMUR, NUSA TENGGARA TIMUR",4,299,10,309
https://kawalpemilu.org#57188,"KONDAMARA, LEWA, SUMBA TIMUR, NUSA TENGGARA TIMUR",5,223,8,231
https://kawalpemilu.org#57188,"KONDAMARA, LEWA, SUMBA TIMUR, NUSA TENGGARA TIMUR",6,171,2,173
https://kawalpemilu.org#57189,"MATAWAI PAWALI, LEWA, SUMBA TIMUR, NUSA TENGGARA TIMUR",1,157,5,162
https://kawalpemilu.org#57189,"MATAWAI PAWALI, LEWA, SUMBA TIMUR, NUSA TENGGARA TIMUR",2,149,3,152
https://kawalpemilu.org#57189,"MATAWAI PAWALI, LEWA, SUMBA TIMUR, NUSA TENGGARA TIMUR",3,192,3,195
https://kawalpemilu.org#57190,"RAKAWATU, LEWA, SUMBA TIMUR, NUSA TENGGARA TIMUR",1,155,1,156
https://kawalpemilu.org#57190,"RAKAWATU, LEWA, SUMBA TIMUR, NUSA TENGGARA TIMUR",2,264,3,267
https://kawalpemilu.org#57190,"RAKAWATU, LEWA, SUMBA TIMUR, NUSA TENGGARA TIMUR",3,169,1,170
https://kawalpemilu.org#57190,"RAKAWATU, LEWA, SUMBA TIMUR, NUSA TENGGARA TIMUR",4,88,2,90
https://kawalpemilu.org#57190,"RAKAWATU, LEWA, SUMBA TIMUR, NUSA TENGGARA TIMUR",5,91,0,94
https://kawalpemilu.org#57191,"TANARARA, LEWA, SUMBA TIMUR, NUSA TENGGARA TIMUR",1,220,15,235
https://kawalpemilu.org#57191,"TANARARA, LEWA, SUMBA TIMUR, NUSA TENGGARA TIMUR",2,221,4,225
https://kawalpemilu.org#57191,"TANARARA, LEWA, SUMBA TIMUR, NUSA TENGGARA TIMUR",3,152,2,154
https://kawalpemilu.org#57191,"TANARARA, LEWA, SUMBA TIMUR, NUSA TENGGARA TIMUR",4,214,7,221
https://kawalpemilu.org#57191,"TANARARA, LEWA, SUMBA TIMUR, NUSA TENGGARA TIMUR",5,182,13,195
https://kawalpemilu.org#57191,"TANARARA, LEWA, SUMBA TIMUR, NUSA TENGGARA TIMUR",6,170,8,178
https://kawalpemilu.org#57192,"BIDI HUNGA, LEWA, SUMBA TIMUR, NUSA TENGGARA TIMUR",1,157,11,168
https://kawalpemilu.org#57192,"BIDI HUNGA, LEWA, SUMBA TIMUR, NUSA TENGGARA TIMUR",2,131,1,132
https://kawalpemilu.org#57194,"MAKAMENGGIT, NGGAHA ORI ANGU, SUMBA TIMUR, NUSA TENGGARA TIMUR",1,158,6,164
https://kawalpemilu.org#57194,"MAKAMENGGIT, NGGAHA ORI ANGU, SUMBA TIMUR, NUSA TENGGARA TIMUR",2,220,6,226
https://kawalpemilu.org#57194,"MAKAMENGGIT, NGGAHA ORI ANGU, SUMBA TIMUR, NUSA TENGGARA TIMUR",3,179,1,180
https://kawalpemilu.org#57194,"MAKAMENGGIT, NGGAHA ORI ANGU, SUMBA TIMUR, NUSA TENGGARA TIMUR",4,170,1,171
https://kawalpemilu.org#57194,"MAKAMENGGIT, NGGAHA ORI ANGU, SUMBA TIMUR, NUSA TENGGARA TIMUR",5,120,2,122
https://kawalpemilu.org#57195,"TANDULA JANGGA, NGGAHA ORI ANGU, SUMBA TIMUR, NUSA TENGGARA TIMUR",1,233,6,239
https://kawalpemilu.org#57195,"TANDULA JANGGA, NGGAHA ORI ANGU, SUMBA TIMUR, NUSA TENGGARA TIMUR",2,74,10,84
https://kawalpemilu.org#57196,"PRAI PAHA, NGGAHA ORI ANGU, SUMBA TIMUR, NUSA TENGGARA TIMUR",1,215,14,229
https://kawalpemilu.org#57196,"PRAI PAHA, NGGAHA ORI ANGU, SUMBA TIMUR, NUSA TENGGARA TIMUR",2,156,12,168
https://kawalpemilu.org#57196,"PRAI PAHA, NGGAHA ORI ANGU, SUMBA TIMUR, NUSA TENGGARA TIMUR",3,132,0,132
https://kawalpemilu.org#57196,"PRAI PAHA, NGGAHA ORI ANGU, SUMBA TIMUR, NUSA TENGGARA TIMUR",4,153,6,159
https://kawalpemilu.org#57196,"PRAI PAHA, NGGAHA ORI ANGU, SUMBA TIMUR, NUSA TENGGARA TIMUR",5,243,13,256
https://kawalpemilu.org#57197,"PRAIHAMBULI, NGGAHA ORI ANGU, SUMBA TIMUR, NUSA TENGGARA TIMUR",1,178,7,185
https://kawalpemilu.org#57197,"PRAIHAMBULI, NGGAHA ORI ANGU, SUMBA TIMUR, NUSA TENGGARA TIMUR",2,202,11,213
https://kawalpemilu.org#57197,"PRAIHAMBULI, NGGAHA ORI ANGU, SUMBA TIMUR, NUSA TENGGARA TIMUR",3,169,6,175
https://kawalpemilu.org#57197,"PRAIHAMBULI, NGGAHA ORI ANGU, SUMBA TIMUR, NUSA TENGGARA TIMUR",4,139,2,141
https://kawalpemilu.org#57197,"PRAIHAMBULI, NGGAHA ORI ANGU, SUMBA TIMUR, NUSA TENGGARA TIMUR",5,138,3,141
https://kawalpemilu.org#57197,"PRAIHAMBULI, NGGAHA ORI ANGU, SUMBA TIMUR, NUSA TENGGARA TIMUR",6,169,4,173
https://kawalpemilu.org#57198,"PULU PANJANG, NGGAHA ORI ANGU, SUMBA TIMUR, NUSA TENGGARA TIMUR",1,196,9,205
https://kawalpemilu.org#57198,"PULU PANJANG, NGGAHA ORI ANGU, SUMBA TIMUR, NUSA TENGGARA TIMUR",2,182,8,190
https://kawalpemilu.org#57198,"PULU PANJANG, NGGAHA ORI ANGU, SUMBA TIMUR, NUSA TENGGARA TIMUR",3,161,7,168
https://kawalpemilu.org#57198,"PULU PANJANG, NGGAHA ORI ANGU, SUMBA TIMUR, NUSA TENGGARA TIMUR",4,120,0,120
https://kawalpemilu.org#57199,"PRAIKARANG, NGGAHA ORI ANGU, SUMBA TIMUR, NUSA TENGGARA TIMUR",1,188,3,191
https://kawalpemilu.org#57199,"PRAIKARANG, NGGAHA ORI ANGU, SUMBA TIMUR, NUSA TENGGARA TIMUR",2,192,4,196
https://kawalpemilu.org#57199,"PRAIKARANG, NGGAHA ORI ANGU, SUMBA TIMUR, NUSA TENGGARA TIMUR",3,87,5,92
https://kawalpemilu.org#57199,"PRAIKARANG, NGGAHA ORI ANGU, SUMBA TIMUR, NUSA TENGGARA TIMUR",4,116,3,119
https://kawalpemilu.org#57200,"TANA TUKU, NGGAHA ORI ANGU, SUMBA TIMUR, NUSA TENGGARA TIMUR",1,147,4,151
https://kawalpemilu.org#57200,"TANA TUKU, NGGAHA ORI ANGU, SUMBA TIMUR, NUSA TENGGARA TIMUR",2,127,6,133
https://kawalpemilu.org#57200,"TANA TUKU, NGGAHA ORI ANGU, SUMBA TIMUR, NUSA TENGGARA TIMUR",3,175,3,178
https://kawalpemilu.org#57200,"TANA TUKU, NGGAHA ORI ANGU, SUMBA TIMUR, NUSA TENGGARA TIMUR",4,193,7,200
https://kawalpemilu.org#57201,"NGADU LANGGI, NGGAHA ORI ANGU, SUMBA TIMUR, NUSA TENGGARA TIMUR",1,252,1,253
https://kawalpemilu.org#57201,"NGADU LANGGI, NGGAHA ORI ANGU, SUMBA TIMUR, NUSA TENGGARA TIMUR",2,132,4,136
https://kawalpemilu.org#57203,"BILLA, TABUNDUNG, SUMBA TIMUR, NUSA TENGGARA TIMUR",1,185,12,197
https://kawalpemilu.org#57203,"BILLA, TABUNDUNG, SUMBA TIMUR, NUSA TENGGARA TIMUR",2,192,26,218
https://kawalpemilu.org#57203,"BILLA, TABUNDUNG, SUMBA TIMUR, NUSA TENGGARA TIMUR",3,183,12,195
https://kawalpemilu.org#57203,"BILLA, TABUNDUNG, SUMBA TIMUR, NUSA TENGGARA TIMUR",4,132,10,142
https://kawalpemilu.org#57204,"KARITA, TABUNDUNG, SUMBA TIMUR, NUSA TENGGARA TIMUR",1,151,5,156
https://kawalpemilu.org#57204,"KARITA, TABUNDUNG, SUMBA TIMUR, NUSA TENGGARA TIMUR",2,121,7,128
https://kawalpemilu.org#57204,"KARITA, TABUNDUNG, SUMBA TIMUR, NUSA TENGGARA TIMUR",3,119,2,121
https://kawalpemilu.org#57204,"KARITA, TABUNDUNG, SUMBA TIMUR, NUSA TENGGARA TIMUR",4,166,5,171
https://kawalpemilu.org#57204,"KARITA, TABUNDUNG, SUMBA TIMUR, NUSA TENGGARA TIMUR",5,128,2,130
https://kawalpemilu.org#57205,"KUKI TALU, TABUNDUNG, SUMBA TIMUR, NUSA TENGGARA TIMUR",1,187,2,189
https://kawalpemilu.org#57205,"KUKI TALU, TABUNDUNG, SUMBA TIMUR, NUSA TENGGARA TIMUR",2,167,8,175
https://kawalpemilu.org#57206,"TAPIL, TABUNDUNG, SUMBA TIMUR, NUSA TENGGARA TIMUR",1,106,2,108
https://kawalpemilu.org#57206,"TAPIL, TABUNDUNG, SUMBA TIMUR, NUSA TENGGARA TIMUR",2,70,2,72
https://kawalpemilu.org#57207,"TARIMBANG, TABUNDUNG, SUMBA TIMUR, NUSA TENGGARA TIMUR",1,136,0,136
https://kawalpemilu.org#57207,"TARIMBANG, TABUNDUNG, SUMBA TIMUR, NUSA TENGGARA TIMUR",2,217,8,225
https://kawalpemilu.org#57207,"TARIMBANG, TABUNDUNG, SUMBA TIMUR, NUSA TENGGARA TIMUR",3,141,3,144
https://kawalpemilu.org#57207,"TARIMBANG, TABUNDUNG, SUMBA TIMUR, NUSA TENGGARA TIMUR",4,133,11,144
https://kawalpemilu.org#57207,"TARIMBANG, TABUNDUNG, SUMBA TIMUR, NUSA TENGGARA TIMUR",5,138,4,142
https://kawalpemilu.org#57208,"WAIKANABU, TABUNDUNG, SUMBA TIMUR, NUSA TENGGARA TIMUR",1,157,3,160
https://kawalpemilu.org#57208,"WAIKANABU, TABUNDUNG, SUMBA TIMUR, NUSA TENGGARA TIMUR",2,146,0,146
https://kawalpemilu.org#57208,"WAIKANABU, TABUNDUNG, SUMBA TIMUR, NUSA TENGGARA TIMUR",3,126,5,131
https://kawalpemilu.org#57208,"WAIKANABU, TABUNDUNG, SUMBA TIMUR, NUSA TENGGARA TIMUR",4,178,0,178
https://kawalpemilu.org#57209,"PINDU HURANI, TABUNDUNG, SUMBA TIMUR, NUSA TENGGARA TIMUR",1,168,5,173
https://kawalpemilu.org#57209,"PINDU HURANI, TABUNDUNG, SUMBA TIMUR, NUSA TENGGARA TIMUR",2,135,17,152
https://kawalpemilu.org#57210,"PRAING KAREHA, TABUNDUNG, SUMBA TIMUR, NUSA TENGGARA TIMUR",1,161,33,194
https://kawalpemilu.org#57210,"PRAING KAREHA, TABUNDUNG, SUMBA TIMUR, NUSA TENGGARA TIMUR",2,191,14,205
https://kawalpemilu.org#57210,"PRAING KAREHA, TABUNDUNG, SUMBA TIMUR, NUSA TENGGARA TIMUR",3,166,14,180
https://kawalpemilu.org#57210,"PRAING KAREHA, TABUNDUNG, SUMBA TIMUR, NUSA TENGGARA TIMUR",4,133,6,139
https://kawalpemilu.org#57211,"WUDI PANDAK, TABUNDUNG, SUMBA TIMUR, NUSA TENGGARA TIMUR",1,154,16,170
https://kawalpemilu.org#57211,"WUDI PANDAK, TABUNDUNG, SUMBA TIMUR, NUSA TENGGARA TIMUR",2,187,8,195
https://kawalpemilu.org#57212,"BANGGA WATU, TABUNDUNG, SUMBA TIMUR, NUSA TENGGARA TIMUR",1,114,2,116
https://kawalpemilu.org#57212,"BANGGA WATU, TABUNDUNG, SUMBA TIMUR, NUSA TENGGARA TIMUR",2,137,1,138
https://kawalpemilu.org#57214,"RAMUK, PINU PAHAR, SUMBA TIMUR, NUSA TENGGARA TIMUR",1,218,13,231
https://kawalpemilu.org#57214,"RAMUK, PINU PAHAR, SUMBA TIMUR, NUSA TENGGARA TIMUR",2,126,2,128
https://kawalpemilu.org#57214,"RAMUK, PINU PAHAR, SUMBA TIMUR, NUSA TENGGARA TIMUR",3,111,6,117
https://kawalpemilu.org#57215,"WANGGA MBEWA, PINU PAHAR, SUMBA TIMUR, NUSA TENGGARA TIMUR",1,138,4,142
https://kawalpemilu.org#57215,"WANGGA MBEWA, PINU PAHAR, SUMBA TIMUR, NUSA TENGGARA TIMUR",2,137,1,138
https://kawalpemilu.org#57215,"WANGGA MBEWA, PINU PAHAR, SUMBA TIMUR, NUSA TENGGARA TIMUR",3,140,10,150
https://kawalpemilu.org#57215,"WANGGA MBEWA, PINU PAHAR, SUMBA TIMUR, NUSA TENGGARA TIMUR",4,100,3,103
https://kawalpemilu.org#57216,"LAILUNGGI, PINU PAHAR, SUMBA TIMUR, NUSA TENGGARA TIMUR",1,121,3,124
https://kawalpemilu.org#57216,"LAILUNGGI, PINU PAHAR, SUMBA TIMUR, NUSA TENGGARA TIMUR",2,126,8,134
https://kawalpemilu.org#57216,"LAILUNGGI, PINU PAHAR, SUMBA TIMUR, NUSA TENGGARA TIMUR",3,65,5,70
https://kawalpemilu.org#57216,"LAILUNGGI, PINU PAHAR, SUMBA TIMUR, NUSA TENGGARA TIMUR",4,140,1,141
https://kawalpemilu.org#57216,"LAILUNGGI, PINU PAHAR, SUMBA TIMUR, NUSA TENGGARA TIMUR",5,125,5,130
https://kawalpemilu.org#57216,"LAILUNGGI, PINU PAHAR, SUMBA TIMUR, NUSA TENGGARA TIMUR",6,148,8,156
https://kawalpemilu.org#57217,"TAWUI, PINU PAHAR, SUMBA TIMUR, NUSA TENGGARA TIMUR",1,169,4,173
https://kawalpemilu.org#57217,"TAWUI, PINU PAHAR, SUMBA TIMUR, NUSA TENGGARA TIMUR",2,175,6,181
https://kawalpemilu.org#57217,"TAWUI, PINU PAHAR, SUMBA TIMUR, NUSA TENGGARA TIMUR",3,155,3,158
https://kawalpemilu.org#57217,"TAWUI, PINU PAHAR, SUMBA TIMUR, NUSA TENGGARA TIMUR",4,133,12,145
https://kawalpemilu.org#57217,"TAWUI, PINU PAHAR, SUMBA TIMUR, NUSA TENGGARA TIMUR",5,131,7,138
https://kawalpemilu.org#57217,"TAWUI, PINU PAHAR, SUMBA TIMUR, NUSA TENGGARA TIMUR",6,134,7,141
https://kawalpemilu.org#57218,"WAHANG, PINU PAHAR, SUMBA TIMUR, NUSA TENGGARA TIMUR",1,194,27,221
https://kawalpemilu.org#57218,"WAHANG, PINU PAHAR, SUMBA TIMUR, NUSA TENGGARA TIMUR",2,123,10,133
https://kawalpemilu.org#57218,"WAHANG, PINU PAHAR, SUMBA TIMUR, NUSA TENGGARA TIMUR",3,141,7,148
https://kawalpemilu.org#57218,"WAHANG, PINU PAHAR, SUMBA TIMUR, NUSA TENGGARA TIMUR",4,207,8,215
https://kawalpemilu.org#57218,"WAHANG, PINU PAHAR, SUMBA TIMUR, NUSA TENGGARA TIMUR",5,205,17,222
https://kawalpemilu.org#57219,"MAHANIWA, PINU PAHAR, SUMBA TIMUR, NUSA TENGGARA TIMUR",1,203,4,207
https://kawalpemilu.org#57219,"MAHANIWA, PINU PAHAR, SUMBA TIMUR, NUSA TENGGARA TIMUR",2,117,2,119
https://kawalpemilu.org#57219,"MAHANIWA, PINU PAHAR, SUMBA TIMUR, NUSA TENGGARA TIMUR",3,113,1,114
https://kawalpemilu.org#57221,"KAWANGU, PANDAWAI, SUMBA TIMUR, NUSA TENGGARA TIMUR",1,214,8,222
https://kawalpemilu.org#57221,"KAWANGU, PANDAWAI, SUMBA TIMUR, NUSA TENGGARA TIMUR",2,205,13,218
https://kawalpemilu.org#57221,"KAWANGU, PANDAWAI, SUMBA TIMUR, NUSA TENGGARA TIMUR",3,193,6,199
https://kawalpemilu.org#57221,"KAWANGU, PANDAWAI, SUMBA TIMUR, NUSA TENGGARA TIMUR",4,176,1,177
https://kawalpemilu.org#57221,"KAWANGU, PANDAWAI, SUMBA TIMUR, NUSA TENGGARA TIMUR",5,163,3,166
https://kawalpemilu.org#57221,"KAWANGU, PANDAWAI, SUMBA TIMUR, NUSA TENGGARA TIMUR",6,223,8,231
https://kawalpemilu.org#57221,"KAWANGU, PANDAWAI, SUMBA TIMUR, NUSA TENGGARA TIMUR",7,192,9,201
https://kawalpemilu.org#57221,"KAWANGU, PANDAWAI, SUMBA TIMUR, NUSA TENGGARA TIMUR",8,186,3,189
https://kawalpemilu.org#57221,"KAWANGU, PANDAWAI, SUMBA TIMUR, NUSA TENGGARA TIMUR",9,137,6,143
https://kawalpemilu.org#57221,"KAWANGU, PANDAWAI, SUMBA TIMUR, NUSA TENGGARA TIMUR",10,213,8,221
https://kawalpemilu.org#57221,"KAWANGU, PANDAWAI, SUMBA TIMUR, NUSA TENGGARA TIMUR",11,189,5,194
https://kawalpemilu.org#57221,"KAWANGU, PANDAWAI, SUMBA TIMUR, NUSA TENGGARA TIMUR",12,125,3,128
https://kawalpemilu.org#57221,"KAWANGU, PANDAWAI, SUMBA TIMUR, NUSA TENGGARA TIMUR",13,127,4,131
https://kawalpemilu.org#57222,"WATUMBAKA, PANDAWAI, SUMBA TIMUR, NUSA TENGGARA TIMUR",1,181,4,185
https://kawalpemilu.org#57222,"WATUMBAKA, PANDAWAI, SUMBA TIMUR, NUSA TENGGARA TIMUR",2,144,1,145
https://kawalpemilu.org#57222,"WATUMBAKA, PANDAWAI, SUMBA TIMUR, NUSA TENGGARA TIMUR",3,185,8,193
https://kawalpemilu.org#57222,"WATUMBAKA, PANDAWAI, SUMBA TIMUR, NUSA TENGGARA TIMUR",4,157,5,162
https://kawalpemilu.org#57222,"WATUMBAKA, PANDAWAI, SUMBA TIMUR, NUSA TENGGARA TIMUR",5,116,1,117
https://kawalpemilu.org#57222,"WATUMBAKA, PANDAWAI, SUMBA TIMUR, NUSA TENGGARA TIMUR",6,165,11,176
https://kawalpemilu.org#57223,"KAMBATATANA, PANDAWAI, SUMBA TIMUR, NUSA TENGGARA TIMUR",1,206,11,217
https://kawalpemilu.org#57223,"KAMBATATANA, PANDAWAI, SUMBA TIMUR, NUSA TENGGARA TIMUR",2,204,12,216
https://kawalpemilu.org#57223,"KAMBATATANA, PANDAWAI, SUMBA TIMUR, NUSA TENGGARA TIMUR",3,153,6,159
https://kawalpemilu.org#57223,"KAMBATATANA, PANDAWAI, SUMBA TIMUR, NUSA TENGGARA TIMUR",4,196,11,207
https://kawalpemilu.org#57223,"KAMBATATANA, PANDAWAI, SUMBA TIMUR, NUSA TENGGARA TIMUR",5,186,8,194
https://kawalpemilu.org#57223,"KAMBATATANA, PANDAWAI, SUMBA TIMUR, NUSA TENGGARA TIMUR",6,145,5,150
https://kawalpemilu.org#57224,"PALAKAHEMBI, PANDAWAI, SUMBA TIMUR, NUSA TENGGARA TIMUR",1,156,7,163
https://kawalpemilu.org#57224,"PALAKAHEMBI, PANDAWAI, SUMBA TIMUR, NUSA TENGGARA TIMUR",2,207,5,212
https://kawalpemilu.org#57224,"PALAKAHEMBI, PANDAWAI, SUMBA TIMUR, NUSA TENGGARA TIMUR",3,187,17,204
https://kawalpemilu.org#57224,"PALAKAHEMBI, PANDAWAI, SUMBA TIMUR, NUSA TENGGARA TIMUR",4,176,3,179
https://kawalpemilu.org#57224,"PALAKAHEMBI, PANDAWAI, SUMBA TIMUR, NUSA TENGGARA TIMUR",5,231,10,241
https://kawalpemilu.org#57224,"PALAKAHEMBI, PANDAWAI, SUMBA TIMUR, NUSA TENGGARA TIMUR",6,240,3,243
https://kawalpemilu.org#57224,"PALAKAHEMBI, PANDAWAI, SUMBA TIMUR, NUSA TENGGARA TIMUR",7,160,8,168
https://kawalpemilu.org#57224,"PALAKAHEMBI, PANDAWAI, SUMBA TIMUR, NUSA TENGGARA TIMUR",8,161,15,176
https://kawalpemilu.org#57224,"PALAKAHEMBI, PANDAWAI, SUMBA TIMUR, NUSA TENGGARA TIMUR",9,152,5,157
https://kawalpemilu.org#57224,"PALAKAHEMBI, PANDAWAI, SUMBA TIMUR, NUSA TENGGARA TIMUR",10,181,4,185
https://kawalpemilu.org#57224,"PALAKAHEMBI, PANDAWAI, SUMBA TIMUR, NUSA TENGGARA TIMUR",11,167,21,188
https://kawalpemilu.org#57225,"KADUMBUL, PANDAWAI, SUMBA TIMUR, NUSA TENGGARA TIMUR",2,158,8,166
https://kawalpemilu.org#57225,"KADUMBUL, PANDAWAI, SUMBA TIMUR, NUSA TENGGARA TIMUR",3,182,19,201
https://kawalpemilu.org#57225,"KADUMBUL, PANDAWAI, SUMBA TIMUR, NUSA TENGGARA TIMUR",4,213,29,242
https://kawalpemilu.org#57225,"KADUMBUL, PANDAWAI, SUMBA TIMUR, NUSA TENGGARA TIMUR",5,120,3,123
https://kawalpemilu.org#57225,"KADUMBUL, PANDAWAI, SUMBA TIMUR, NUSA TENGGARA TIMUR",6,122,2,124
https://kawalpemilu.org#57226,"MAUBOKUL, PANDAWAI, SUMBA TIMUR, NUSA TENGGARA TIMUR",1,192,7,199
https://kawalpemilu.org#57226,"MAUBOKUL, PANDAWAI, SUMBA TIMUR, NUSA TENGGARA TIMUR",2,196,29,225
https://kawalpemilu.org#57226,"MAUBOKUL, PANDAWAI, SUMBA TIMUR, NUSA TENGGARA TIMUR",3,183,8,191
https://kawalpemilu.org#57226,"MAUBOKUL, PANDAWAI, SUMBA TIMUR, NUSA TENGGARA TIMUR",4,196,4,200
https://kawalpemilu.org#57226,"MAUBOKUL, PANDAWAI, SUMBA TIMUR, NUSA TENGGARA TIMUR",5,172,6,178
https://kawalpemilu.org#57227,"LAINDEHA, PANDAWAI, SUMBA TIMUR, NUSA TENGGARA TIMUR",1,168,3,171
https://kawalpemilu.org#57227,"LAINDEHA, PANDAWAI, SUMBA TIMUR, NUSA TENGGARA TIMUR",2,181,7,188
https://kawalpemilu.org#57229,"LUMBUKORE, UMALULU, SUMBA TIMUR, NUSA TENGGARA TIMUR",1,193,2,195
https://kawalpemilu.org#57229,"LUMBUKORE, UMALULU, SUMBA TIMUR, NUSA TENGGARA TIMUR",2,183,25,208
https://kawalpemilu.org#57229,"LUMBUKORE, UMALULU, SUMBA TIMUR, NUSA TENGGARA TIMUR",3,132,12,144
https://kawalpemilu.org#57229,"LUMBUKORE, UMALULU, SUMBA TIMUR, NUSA TENGGARA TIMUR",4,196,10,206
https://kawalpemilu.org#57229,"LUMBUKORE, UMALULU, SUMBA TIMUR, NUSA TENGGARA TIMUR",5,189,49,238
https://kawalpemilu.org#57229,"LUMBUKORE, UMALULU, SUMBA TIMUR, NUSA TENGGARA TIMUR",6,148,7,155
https://kawalpemilu.org#57229,"LUMBUKORE, UMALULU, SUMBA TIMUR, NUSA TENGGARA TIMUR",7,156,9,165
https://kawalpemilu.org#57229,"LUMBUKORE, UMALULU, SUMBA TIMUR, NUSA TENGGARA TIMUR",8,63,53,116
https://kawalpemilu.org#57229,"LUMBUKORE, UMALULU, SUMBA TIMUR, NUSA TENGGARA TIMUR",9,37,117,154
https://kawalpemilu.org#57229,"LUMBUKORE, UMALULU, SUMBA TIMUR, NUSA TENGGARA TIMUR",10,116,9,125
https://kawalpemilu.org#57230,"UMALULU, UMALULU, SUMBA TIMUR, NUSA TENGGARA TIMUR",1,164,23,187
https://kawalpemilu.org#57230,"UMALULU, UMALULU, SUMBA TIMUR, NUSA TENGGARA TIMUR",2,182,6,188
https://kawalpemilu.org#57230,"UMALULU, UMALULU, SUMBA TIMUR, NUSA TENGGARA TIMUR",3,142,6,148
https://kawalpemilu.org#57230,"UMALULU, UMALULU, SUMBA TIMUR, NUSA TENGGARA TIMUR",4,100,5,105
https://kawalpemilu.org#57231,"PATAWANG, UMALULU, SUMBA TIMUR, NUSA TENGGARA TIMUR",1,195,8,203
https://kawalpemilu.org#57231,"PATAWANG, UMALULU, SUMBA TIMUR, NUSA TENGGARA TIMUR",2,194,16,210
https://kawalpemilu.org#57231,"PATAWANG, UMALULU, SUMBA TIMUR, NUSA TENGGARA TIMUR",3,144,4,148
https://kawalpemilu.org#57231,"PATAWANG, UMALULU, SUMBA TIMUR, NUSA TENGGARA TIMUR",4,149,14,163
https://kawalpemilu.org#57231,"PATAWANG, UMALULU, SUMBA TIMUR, NUSA TENGGARA TIMUR",5,115,4,119
https://kawalpemilu.org#57231,"PATAWANG, UMALULU, SUMBA TIMUR, NUSA TENGGARA TIMUR",6,218,11,229
https://kawalpemilu.org#57232,"WANGA, UMALULU, SUMBA TIMUR, NUSA TENGGARA TIMUR",1,216,6,222
https://kawalpemilu.org#57232,"WANGA, UMALULU, SUMBA TIMUR, NUSA TENGGARA TIMUR",2,205,10,215
https://kawalpemilu.org#57232,"WANGA, UMALULU, SUMBA TIMUR, NUSA TENGGARA TIMUR",3,219,5,224
https://kawalpemilu.org#57232,"WANGA, UMALULU, SUMBA TIMUR, NUSA TENGGARA TIMUR",4,212,12,224
https://kawalpemilu.org#57233,"MATAWAI ATU, UMALULU, SUMBA TIMUR, NUSA TENGGARA TIMUR",1,224,11,235
https://kawalpemilu.org#57233,"MATAWAI ATU, UMALULU, SUMBA TIMUR, NUSA TENGGARA TIMUR",2,175,16,191
https://kawalpemilu.org#57233,"MATAWAI ATU, UMALULU, SUMBA TIMUR, NUSA TENGGARA TIMUR",3,158,6,164
https://kawalpemilu.org#57233,"MATAWAI ATU, UMALULU, SUMBA TIMUR, NUSA TENGGARA TIMUR",4,214,5,219
https://kawalpemilu.org#57233,"MATAWAI ATU, UMALULU, SUMBA TIMUR, NUSA TENGGARA TIMUR",5,203,9,212
https://kawalpemilu.org#57234,"MUTUNGGEDING, UMALULU, SUMBA TIMUR, NUSA TENGGARA TIMUR",1,195,29,224
https://kawalpemilu.org#57234,"MUTUNGGEDING, UMALULU, SUMBA TIMUR, NUSA TENGGARA TIMUR",2,233,11,244
https://kawalpemilu.org#57234,"MUTUNGGEDING, UMALULU, SUMBA TIMUR, NUSA TENGGARA TIMUR",3,162,14,176
https://kawalpemilu.org#57234,"MUTUNGGEDING, UMALULU, SUMBA TIMUR, NUSA TENGGARA TIMUR",4,199,11,210
https://kawalpemilu.org#57234,"MUTUNGGEDING, UMALULU, SUMBA TIMUR, NUSA TENGGARA TIMUR",5,190,6,196
https://kawalpemilu.org#57235,"LAIRURU, UMALULU, SUMBA TIMUR, NUSA TENGGARA TIMUR",1,131,12,143
https://kawalpemilu.org#57235,"LAIRURU, UMALULU, SUMBA TIMUR, NUSA TENGGARA TIMUR",2,131,8,139
https://kawalpemilu.org#57235,"LAIRURU, UMALULU, SUMBA TIMUR, NUSA TENGGARA TIMUR",3,214,11,225
https://kawalpemilu.org#57235,"LAIRURU, UMALULU, SUMBA TIMUR, NUSA TENGGARA TIMUR",4,108,6,114
https://kawalpemilu.org#57235,"LAIRURU, UMALULU, SUMBA TIMUR, NUSA TENGGARA TIMUR",5,87,6,93
https://kawalpemilu.org#57236,"WATU HADANG, UMALULU, SUMBA TIMUR, NUSA TENGGARA TIMUR",1,113,74,187
https://kawalpemilu.org#57236,"WATU HADANG, UMALULU, SUMBA TIMUR, NUSA TENGGARA TIMUR",2,144,21,165
https://kawalpemilu.org#57236,"WATU HADANG, UMALULU, SUMBA TIMUR, NUSA TENGGARA TIMUR",3,145,20,165
https://kawalpemilu.org#57236,"WATU HADANG, UMALULU, SUMBA TIMUR, NUSA TENGGARA TIMUR",4,157,9,166
https://kawalpemilu.org#57236,"WATU HADANG, UMALULU, SUMBA TIMUR, NUSA TENGGARA TIMUR",5,170,4,174
https://kawalpemilu.org#57236,"WATU HADANG, UMALULU, SUMBA TIMUR, NUSA TENGGARA TIMUR",6,108,38,146
https://kawalpemilu.org#57237,"WATU PUDA, UMALULU, SUMBA TIMUR, NUSA TENGGARA TIMUR",1,191,13,204
https://kawalpemilu.org#57237,"WATU PUDA, UMALULU, SUMBA TIMUR, NUSA TENGGARA TIMUR",2,143,9,152
https://kawalpemilu.org#57237,"WATU PUDA, UMALULU, SUMBA TIMUR, NUSA TENGGARA TIMUR",3,116,4,120
https://kawalpemilu.org#57237,"WATU PUDA, UMALULU, SUMBA TIMUR, NUSA TENGGARA TIMUR",4,70,1,71
https://kawalpemilu.org#57237,"WATU PUDA, UMALULU, SUMBA TIMUR, NUSA TENGGARA TIMUR",5,93,10,103
https://kawalpemilu.org#57237,"WATU PUDA, UMALULU, SUMBA TIMUR, NUSA TENGGARA TIMUR",6,91,4,95
https://kawalpemilu.org#57238,"NGARU KANORU, UMALULU, SUMBA TIMUR, NUSA TENGGARA TIMUR",1,183,25,208
https://kawalpemilu.org#57238,"NGARU KANORU, UMALULU, SUMBA TIMUR, NUSA TENGGARA TIMUR",2,109,4,113
https://kawalpemilu.org#57238,"NGARU KANORU, UMALULU, SUMBA TIMUR, NUSA TENGGARA TIMUR",3,66,1,67
https://kawalpemilu.org#57240,"RINDI, RINDI, SUMBA TIMUR, NUSA TENGGARA TIMUR",1,183,8,191
https://kawalpemilu.org#57240,"RINDI, RINDI, SUMBA TIMUR, NUSA TENGGARA TIMUR",2,126,31,157
https://kawalpemilu.org#57240,"RINDI, RINDI, SUMBA TIMUR, NUSA TENGGARA TIMUR",3,181,19,200
https://kawalpemilu.org#57240,"RINDI, RINDI, SUMBA TIMUR, NUSA TENGGARA TIMUR",4,134,21,155
https://kawalpemilu.org#57241,"TANARAING, RINDI, SUMBA TIMUR, NUSA TENGGARA TIMUR",1,152,29,180
https://kawalpemilu.org#57241,"TANARAING, RINDI, SUMBA TIMUR, NUSA TENGGARA TIMUR",2,33,86,119
https://kawalpemilu.org#57241,"TANARAING, RINDI, SUMBA TIMUR, NUSA TENGGARA TIMUR",3,107,25,132
https://kawalpemilu.org#57241,"TANARAING, RINDI, SUMBA TIMUR, NUSA TENGGARA TIMUR",4,91,50,141
https://kawalpemilu.org#57241,"TANARAING, RINDI, SUMBA TIMUR, NUSA TENGGARA TIMUR",5,95,31,126
https://kawalpemilu.org#57242,"HAIKATAPU, RINDI, SUMBA TIMUR, NUSA TENGGARA TIMUR",1,210,23,233
https://kawalpemilu.org#57242,"HAIKATAPU, RINDI, SUMBA TIMUR, NUSA TENGGARA TIMUR",2,141,82,223
https://kawalpemilu.org#57242,"HAIKATAPU, RINDI, SUMBA TIMUR, NUSA TENGGARA TIMUR",3,206,8,214
https://kawalpemilu.org#57242,"HAIKATAPU, RINDI, SUMBA TIMUR, NUSA TENGGARA TIMUR",4,166,6,172
https://kawalpemilu.org#57243,"KABARU, RINDI, SUMBA TIMUR, NUSA TENGGARA TIMUR",1,178,2,180
https://kawalpemilu.org#57243,"KABARU, RINDI, SUMBA TIMUR, NUSA TENGGARA TIMUR",2,139,2,141
https://kawalpemilu.org#57243,"KABARU, RINDI, SUMBA TIMUR, NUSA TENGGARA TIMUR",3,185,3,188
https://kawalpemilu.org#57244,"HANGGARORU, RINDI, SUMBA TIMUR, NUSA TENGGARA TIMUR",1,137,14,151
https://kawalpemilu.org#57244,"HANGGARORU, RINDI, SUMBA TIMUR, NUSA TENGGARA TIMUR",2,154,22,176
https://kawalpemilu.org#57244,"HANGGARORU, RINDI, SUMBA TIMUR, NUSA TENGGARA TIMUR",3,180,27,207
https://kawalpemilu.org#57244,"HANGGARORU, RINDI, SUMBA TIMUR, NUSA TENGGARA TIMUR",4,219,13,232
https://kawalpemilu.org#57245,"LAILANJANG, RINDI, SUMBA TIMUR, NUSA TENGGARA TIMUR",1,114,34,148
https://kawalpemilu.org#57245,"LAILANJANG, RINDI, SUMBA TIMUR, NUSA TENGGARA TIMUR",2,163,11,174
https://kawalpemilu.org#57245,"LAILANJANG, RINDI, SUMBA TIMUR, NUSA TENGGARA TIMUR",3,199,7,206
https://kawalpemilu.org#57246,"TAMBURI, RINDI, SUMBA TIMUR, NUSA TENGGARA TIMUR",1,117,18,135
https://kawalpemilu.org#57246,"TAMBURI, RINDI, SUMBA TIMUR, NUSA TENGGARA TIMUR",2,198,8,206
https://kawalpemilu.org#57246,"TAMBURI, RINDI, SUMBA TIMUR, NUSA TENGGARA TIMUR",3,126,23,149
https://kawalpemilu.org#57247,"KAYURI, RINDI, SUMBA TIMUR, NUSA TENGGARA TIMUR",1,154,29,183
https://kawalpemilu.org#57247,"KAYURI, RINDI, SUMBA TIMUR, NUSA TENGGARA TIMUR",2,204,1,205
https://kawalpemilu.org#57247,"KAYURI, RINDI, SUMBA TIMUR, NUSA TENGGARA TIMUR",3,141,35,176
https://kawalpemilu.org#57247,"KAYURI, RINDI, SUMBA TIMUR, NUSA TENGGARA TIMUR",4,134,34,168
https://kawalpemilu.org#57249,"KALIUDA, PAHUNGA LODU, SUMBA TIMUR, NUSA TENGGARA TIMUR",1,222,22,244
https://kawalpemilu.org#57249,"KALIUDA, PAHUNGA LODU, SUMBA TIMUR, NUSA TENGGARA TIMUR",2,200,11,211
https://kawalpemilu.org#57249,"KALIUDA, PAHUNGA LODU, SUMBA TIMUR, NUSA TENGGARA TIMUR",3,211,2,213
https://kawalpemilu.org#57249,"KALIUDA, PAHUNGA LODU, SUMBA TIMUR, NUSA TENGGARA TIMUR",4,203,4,207
https://kawalpemilu.org#57249,"KALIUDA, PAHUNGA LODU, SUMBA TIMUR, NUSA TENGGARA TIMUR",5,192,51,243
https://kawalpemilu.org#57249,"KALIUDA, PAHUNGA LODU, SUMBA TIMUR, NUSA TENGGARA TIMUR",6,122,13,135
https://kawalpemilu.org#57249,"KALIUDA, PAHUNGA LODU, SUMBA TIMUR, NUSA TENGGARA TIMUR",7,211,10,221
https://kawalpemilu.org#57249,"KALIUDA, PAHUNGA LODU, SUMBA TIMUR, NUSA TENGGARA TIMUR",8,196,5,201
https://kawalpemilu.org#57249,"KALIUDA, PAHUNGA LODU, SUMBA TIMUR, NUSA TENGGARA TIMUR",9,187,14,201
https://kawalpemilu.org#57249,"KALIUDA, PAHUNGA LODU, SUMBA TIMUR, NUSA TENGGARA TIMUR",10,228,18,246
https://kawalpemilu.org#57249,"KALIUDA, PAHUNGA LODU, SUMBA TIMUR, NUSA TENGGARA TIMUR",11,139,12,151
https://kawalpemilu.org#57250,"KURUWAKI, PAHUNGA LODU, SUMBA TIMUR, NUSA TENGGARA TIMUR",1,206,16,222
https://kawalpemilu.org#57250,"KURUWAKI, PAHUNGA LODU, SUMBA TIMUR, NUSA TENGGARA TIMUR",2,202,9,211
https://kawalpemilu.org#57251,"TANAMANANG, PAHUNGA LODU, SUMBA TIMUR, NUSA TENGGARA TIMUR",1,193,40,233
https://kawalpemilu.org#57251,"TANAMANANG, PAHUNGA LODU, SUMBA TIMUR, NUSA TENGGARA TIMUR",2,208,32,240
https://kawalpemilu.org#57251,"TANAMANANG, PAHUNGA LODU, SUMBA TIMUR, NUSA TENGGARA TIMUR",3,133,3,136
https://kawalpemilu.org#57251,"TANAMANANG, PAHUNGA LODU, SUMBA TIMUR, NUSA TENGGARA TIMUR",4,223,14,237
https://kawalpemilu.org#57251,"TANAMANANG, PAHUNGA LODU, SUMBA TIMUR, NUSA TENGGARA TIMUR",5,227,9,236
https://kawalpemilu.org#57252,"MBURUKULU, PAHUNGA LODU, SUMBA TIMUR, NUSA TENGGARA TIMUR",1,232,9,241
https://kawalpemilu.org#57252,"MBURUKULU, PAHUNGA LODU, SUMBA TIMUR, NUSA TENGGARA TIMUR",2,203,5,208
https://kawalpemilu.org#57252,"MBURUKULU, PAHUNGA LODU, SUMBA TIMUR, NUSA TENGGARA TIMUR",3,180,7,187
https://kawalpemilu.org#57252,"MBURUKULU, PAHUNGA LODU, SUMBA TIMUR, NUSA TENGGARA TIMUR",4,131,3,134
https://kawalpemilu.org#57252,"MBURUKULU, PAHUNGA LODU, SUMBA TIMUR, NUSA TENGGARA TIMUR",5,164,5,169
https://kawalpemilu.org#57253,"PAMBURU, PAHUNGA LODU, SUMBA TIMUR, NUSA TENGGARA TIMUR",1,229,9,238
https://kawalpemilu.org#57253,"PAMBURU, PAHUNGA LODU, SUMBA TIMUR, NUSA TENGGARA TIMUR",2,248,9,257
https://kawalpemilu.org#57254,"LAMBAKARA, PAHUNGA LODU, SUMBA TIMUR, NUSA TENGGARA TIMUR",1,185,29,214
https://kawalpemilu.org#57254,"LAMBAKARA, PAHUNGA LODU, SUMBA TIMUR, NUSA TENGGARA TIMUR",2,217,19,236
https://kawalpemilu.org#57254,"LAMBAKARA, PAHUNGA LODU, SUMBA TIMUR, NUSA TENGGARA TIMUR",3,217,18,235
https://kawalpemilu.org#57254,"LAMBAKARA, PAHUNGA LODU, SUMBA TIMUR, NUSA TENGGARA TIMUR",4,107,14,121
https://kawalpemilu.org#57255,"TAMMA, PAHUNGA LODU, SUMBA TIMUR, NUSA TENGGARA TIMUR",1,228,5,233
https://kawalpemilu.org#57255,"TAMMA, PAHUNGA LODU, SUMBA TIMUR, NUSA TENGGARA TIMUR",2,250,5,255
https://kawalpemilu.org#57255,"TAMMA, PAHUNGA LODU, SUMBA TIMUR, NUSA TENGGARA TIMUR",3,126,20,146
https://kawalpemilu.org#57255,"TAMMA, PAHUNGA LODU, SUMBA TIMUR, NUSA TENGGARA TIMUR",4,86,1,87
https://kawalpemilu.org#57255,"TAMMA, PAHUNGA LODU, SUMBA TIMUR, NUSA TENGGARA TIMUR",5,137,14,151
https://kawalpemilu.org#57256,"PALANGGAI, PAHUNGA LODU, SUMBA TIMUR, NUSA TENGGARA TIMUR",1,189,21,210
https://kawalpemilu.org#57256,"PALANGGAI, PAHUNGA LODU, SUMBA TIMUR, NUSA TENGGARA TIMUR",2,215,15,230
https://kawalpemilu.org#57258,"WULLA, WULLA WAIJELU, SUMBA TIMUR, NUSA TENGGARA TIMUR",1,143,9,152
https://kawalpemilu.org#57258,"WULLA, WULLA WAIJELU, SUMBA TIMUR, NUSA TENGGARA TIMUR",2,199,4,203
https://kawalpemilu.org#57258,"WULLA, WULLA WAIJELU, SUMBA TIMUR, NUSA TENGGARA TIMUR",3,160,7,167
https://kawalpemilu.org#57258,"WULLA, WULLA WAIJELU, SUMBA TIMUR, NUSA TENGGARA TIMUR",4,172,6,178
https://kawalpemilu.org#57259,"HADAKAMALI, WULLA WAIJELU, SUMBA TIMUR, NUSA TENGGARA TIMUR",1,186,26,212
https://kawalpemilu.org#57259,"HADAKAMALI, WULLA WAIJELU, SUMBA TIMUR, NUSA TENGGARA TIMUR",2,181,10,191
https://kawalpemilu.org#57259,"HADAKAMALI, WULLA WAIJELU, SUMBA TIMUR, NUSA TENGGARA TIMUR",3,153,27,180
https://kawalpemilu.org#57259,"HADAKAMALI, WULLA WAIJELU, SUMBA TIMUR, NUSA TENGGARA TIMUR",4,156,3,159
https://kawalpemilu.org#57260,"LUMBU MANGGIT, WULLA WAIJELU, SUMBA TIMUR, NUSA TENGGARA TIMUR",1,176,12,188
https://kawalpemilu.org#57260,"LUMBU MANGGIT, WULLA WAIJELU, SUMBA TIMUR, NUSA TENGGARA TIMUR",2,192,19,211
https://kawalpemilu.org#57260,"LUMBU MANGGIT, WULLA WAIJELU, SUMBA TIMUR, NUSA TENGGARA TIMUR",3,162,4,166
https://kawalpemilu.org#57261,"LATENA, WULLA WAIJELU, SUMBA TIMUR, NUSA TENGGARA TIMUR",1,151,10,161
https://kawalpemilu.org#57261,"LATENA, WULLA WAIJELU, SUMBA TIMUR, NUSA TENGGARA TIMUR",2,159,14,173
https://kawalpemilu.org#57261,"LATENA, WULLA WAIJELU, SUMBA TIMUR, NUSA TENGGARA TIMUR",3,137,13,150
https://kawalpemilu.org#57262,"LAINJANJI, WULLA WAIJELU, SUMBA TIMUR, NUSA TENGGARA TIMUR",1,135,26,161
https://kawalpemilu.org#57262,"LAINJANJI, WULLA WAIJELU, SUMBA TIMUR, NUSA TENGGARA TIMUR",2,135,31,166
https://kawalpemilu.org#57262,"LAINJANJI, WULLA WAIJELU, SUMBA TIMUR, NUSA TENGGARA TIMUR",3,126,10,136
https://kawalpemilu.org#57262,"LAINJANJI, WULLA WAIJELU, SUMBA TIMUR, NUSA TENGGARA TIMUR",4,103,1,104
https://kawalpemilu.org#57262,"LAINJANJI, WULLA WAIJELU, SUMBA TIMUR, NUSA TENGGARA TIMUR",5,132,11,143
https://kawalpemilu.org#57263,"LAIPANDAK, WULLA WAIJELU, SUMBA TIMUR, NUSA TENGGARA TIMUR",1,192,23,215
https://kawalpemilu.org#57263,"LAIPANDAK, WULLA WAIJELU, SUMBA TIMUR, NUSA TENGGARA TIMUR",2,196,28,224
https://kawalpemilu.org#57263,"LAIPANDAK, WULLA WAIJELU, SUMBA TIMUR, NUSA TENGGARA TIMUR",3,154,10,164
https://kawalpemilu.org#57264,"PARANDA, WULLA WAIJELU, SUMBA TIMUR, NUSA TENGGARA TIMUR",1,161,3,164
https://kawalpemilu.org#57264,"PARANDA, WULLA WAIJELU, SUMBA TIMUR, NUSA TENGGARA TIMUR",2,86,6,92
https://kawalpemilu.org#57264,"PARANDA, WULLA WAIJELU, SUMBA TIMUR, NUSA TENGGARA TIMUR",3,134,5,139
https://kawalpemilu.org#57266,"KANANGGAR, PABERIWAI, SUMBA TIMUR, NUSA TENGGARA TIMUR",1,216,16,232
https://kawalpemilu.org#57266,"KANANGGAR, PABERIWAI, SUMBA TIMUR, NUSA TENGGARA TIMUR",2,162,14,176
https://kawalpemilu.org#57266,"KANANGGAR, PABERIWAI, SUMBA TIMUR, NUSA TENGGARA TIMUR",3,193,7,200
https://kawalpemilu.org#57267,"MEHANG MATA, PABERIWAI, SUMBA TIMUR, NUSA TENGGARA TIMUR",1,164,3,167
https://kawalpemilu.org#57267,"MEHANG MATA, PABERIWAI, SUMBA TIMUR, NUSA TENGGARA TIMUR",2,196,9,205
https://kawalpemilu.org#57267,"MEHANG MATA, PABERIWAI, SUMBA TIMUR, NUSA TENGGARA TIMUR",3,102,2,104
https://kawalpemilu.org#57268,"KARERA JANGGA, PABERIWAI, SUMBA TIMUR, NUSA TENGGARA TIMUR",1,183,9,192
https://kawalpemilu.org#57268,"KARERA JANGGA, PABERIWAI, SUMBA TIMUR, NUSA TENGGARA TIMUR",2,120,6,126
https://kawalpemilu.org#57268,"KARERA JANGGA, PABERIWAI, SUMBA TIMUR, NUSA TENGGARA TIMUR",3,89,9,98
https://kawalpemilu.org#57268,"KARERA JANGGA, PABERIWAI, SUMBA TIMUR, NUSA TENGGARA TIMUR",4,106,16,122
https://kawalpemilu.org#57269,"PRAIMBANA, PABERIWAI, SUMBA TIMUR, NUSA TENGGARA TIMUR",1,161,12,173
https://kawalpemilu.org#57269,"PRAIMBANA, PABERIWAI, SUMBA TIMUR, NUSA TENGGARA TIMUR",2,184,10,194
https://kawalpemilu.org#57270,"PABERA MANERA, PABERIWAI, SUMBA TIMUR, NUSA TENGGARA TIMUR",1,143,10,153
https://kawalpemilu.org#57270,"PABERA MANERA, PABERIWAI, SUMBA TIMUR, NUSA TENGGARA TIMUR",2,181,2,183
https://kawalpemilu.org#57270,"PABERA MANERA, PABERIWAI, SUMBA TIMUR, NUSA TENGGARA TIMUR",3,97,8,105
https://kawalpemilu.org#57271,"WINU MURU, PABERIWAI, SUMBA TIMUR, NUSA TENGGARA TIMUR",1,234,8,242
https://kawalpemilu.org#57272,"LAITAKU, PABERIWAI, SUMBA TIMUR, NUSA TENGGARA TIMUR",1,209,5,214
https://kawalpemilu.org#57274,"NGGONGI, KARERA, SUMBA TIMUR, NUSA TENGGARA TIMUR",1,206,4,210
https://kawalpemilu.org#57274,"NGGONGI, KARERA, SUMBA TIMUR, NUSA TENGGARA TIMUR",2,167,7,174
https://kawalpemilu.org#57274,"NGGONGI, KARERA, SUMBA TIMUR, NUSA TENGGARA TIMUR",3,170,8,178
https://kawalpemilu.org#57274,"NGGONGI, KARERA, SUMBA TIMUR, NUSA TENGGARA TIMUR",4,112,4,116
https://kawalpemilu.org#57274,"NGGONGI, KARERA, SUMBA TIMUR, NUSA TENGGARA TIMUR",5,102,9,111
https://kawalpemilu.org#57274,"NGGONGI, KARERA, SUMBA TIMUR, NUSA TENGGARA TIMUR",6,202,4,206
https://kawalpemilu.org#57275,"PRAIMADITA, KARERA, SUMBA TIMUR, NUSA TENGGARA TIMUR",1,211,2,213
https://kawalpemilu.org#57275,"PRAIMADITA, KARERA, SUMBA TIMUR, NUSA TENGGARA TIMUR",2,178,2,180
https://kawalpemilu.org#57275,"PRAIMADITA, KARERA, SUMBA TIMUR, NUSA TENGGARA TIMUR",3,220,3,223
https://kawalpemilu.org#57275,"PRAIMADITA, KARERA, SUMBA TIMUR, NUSA TENGGARA TIMUR",4,108,0,108
https://kawalpemilu.org#57275,"PRAIMADITA, KARERA, SUMBA TIMUR, NUSA TENGGARA TIMUR",5,201,0,201
https://kawalpemilu.org#57275,"PRAIMADITA, KARERA, SUMBA TIMUR, NUSA TENGGARA TIMUR",6,168,10,178
https://kawalpemilu.org#57275,"PRAIMADITA, KARERA, SUMBA TIMUR, NUSA TENGGARA TIMUR",7,141,0,141
https://kawalpemilu.org#57276,"PRAISALURA, KARERA, SUMBA TIMUR, NUSA TENGGARA TIMUR",1,87,130,217
https://kawalpemilu.org#57276,"PRAISALURA, KARERA, SUMBA TIMUR, NUSA TENGGARA TIMUR",2,83,52,135
https://kawalpemilu.org#57277,"TANDULA JANGGA, KARERA, SUMBA TIMUR, NUSA TENGGARA TIMUR",1,195,6,201
https://kawalpemilu.org#57277,"TANDULA JANGGA, KARERA, SUMBA TIMUR, NUSA TENGGARA TIMUR",2,141,2,143
https://kawalpemilu.org#57278,"NANGGA, KARERA, SUMBA TIMUR, NUSA TENGGARA TIMUR",1,221,4,225
https://kawalpemilu.org#57278,"NANGGA, KARERA, SUMBA TIMUR, NUSA TENGGARA TIMUR",2,172,11,183
https://kawalpemilu.org#57279,"JANGGA MANGU, KARERA, SUMBA TIMUR, NUSA TENGGARA TIMUR",1,196,9,205
https://kawalpemilu.org#57279,"JANGGA MANGU, KARERA, SUMBA TIMUR, NUSA TENGGARA TIMUR",2,187,2,189
https://kawalpemilu.org#57280,"ANANJAKI, KARERA, SUMBA TIMUR, NUSA TENGGARA TIMUR",1,256,4,260
https://kawalpemilu.org#57280,"ANANJAKI, KARERA, SUMBA TIMUR, NUSA TENGGARA TIMUR",2,251,10,261
https://kawalpemilu.org#57282,"KAMANGGIH, KAHAUNGU ETI, SUMBA TIMUR, NUSA TENGGARA TIMUR",1,201,12,213
https://kawalpemilu.org#57282,"KAMANGGIH, KAHAUNGU ETI, SUMBA TIMUR, NUSA TENGGARA TIMUR",2,179,6,185
https://kawalpemilu.org#57282,"KAMANGGIH, KAHAUNGU ETI, SUMBA TIMUR, NUSA TENGGARA TIMUR",3,126,4,130
https://kawalpemilu.org#57282,"KAMANGGIH, KAHAUNGU ETI, SUMBA TIMUR, NUSA TENGGARA TIMUR",4,133,6,139
https://kawalpemilu.org#57282,"KAMANGGIH, KAHAUNGU ETI, SUMBA TIMUR, NUSA TENGGARA TIMUR",5,175,1,176
https://kawalpemilu.org#57283,"KAMBATA BUNDUNG, KAHAUNGU ETI, SUMBA TIMUR, NUSA TENGGARA TIMUR",1,146,4,150
https://kawalpemilu.org#57283,"KAMBATA BUNDUNG, KAHAUNGU ETI, SUMBA TIMUR, NUSA TENGGARA TIMUR",2,135,2,137
https://kawalpemilu.org#57283,"KAMBATA BUNDUNG, KAHAUNGU ETI, SUMBA TIMUR, NUSA TENGGARA TIMUR",3,148,4,152
https://kawalpemilu.org#57283,"KAMBATA BUNDUNG, KAHAUNGU ETI, SUMBA TIMUR, NUSA TENGGARA TIMUR",4,103,1,104
https://kawalpemilu.org#57283,"KAMBATA BUNDUNG, KAHAUNGU ETI, SUMBA TIMUR, NUSA TENGGARA TIMUR",5,117,12,129
https://kawalpemilu.org#57284,"MEURUMBA, KAHAUNGU ETI, SUMBA TIMUR, NUSA TENGGARA TIMUR",1,183,16,199
https://kawalpemilu.org#57284,"MEURUMBA, KAHAUNGU ETI, SUMBA TIMUR, NUSA TENGGARA TIMUR",2,225,11,236
https://kawalpemilu.org#57284,"MEURUMBA, KAHAUNGU ETI, SUMBA TIMUR, NUSA TENGGARA TIMUR",3,89,5,94
https://kawalpemilu.org#57284,"MEURUMBA, KAHAUNGU ETI, SUMBA TIMUR, NUSA TENGGARA TIMUR",4,114,6,120
https://kawalpemilu.org#57285,"LAIMBONGA, KAHAUNGU ETI, SUMBA TIMUR, NUSA TENGGARA TIMUR",1,144,30,174
https://kawalpemilu.org#57285,"LAIMBONGA, KAHAUNGU ETI, SUMBA TIMUR, NUSA TENGGARA TIMUR",2,158,7,165
https://kawalpemilu.org#57286,"KOTA KAWAU, KAHAUNGU ETI, SUMBA TIMUR, NUSA TENGGARA TIMUR",1,196,11,207
https://kawalpemilu.org#57286,"KOTA KAWAU, KAHAUNGU ETI, SUMBA TIMUR, NUSA TENGGARA TIMUR",2,146,6,152
https://kawalpemilu.org#57286,"KOTA KAWAU, KAHAUNGU ETI, SUMBA TIMUR, NUSA TENGGARA TIMUR",3,154,2,156
https://kawalpemilu.org#57286,"KOTA KAWAU, KAHAUNGU ETI, SUMBA TIMUR, NUSA TENGGARA TIMUR",4,155,7,162
https://kawalpemilu.org#57286,"KOTA KAWAU, KAHAUNGU ETI, SUMBA TIMUR, NUSA TENGGARA TIMUR",5,147,5,152
https://kawalpemilu.org#57287,"MATAWAI KATINGGA, KAHAUNGU ETI, SUMBA TIMUR, NUSA TENGGARA TIMUR",1,140,7,147
https://kawalpemilu.org#57287,"MATAWAI KATINGGA, KAHAUNGU ETI, SUMBA TIMUR, NUSA TENGGARA TIMUR",2,121,6,127
https://kawalpemilu.org#57288,"KATAKA, KAHAUNGU ETI, SUMBA TIMUR, NUSA TENGGARA TIMUR",1,154,0,154
https://kawalpemilu.org#57288,"KATAKA, KAHAUNGU ETI, SUMBA TIMUR, NUSA TENGGARA TIMUR",2,100,0,100
https://kawalpemilu.org#57288,"KATAKA, KAHAUNGU ETI, SUMBA TIMUR, NUSA TENGGARA TIMUR",3,155,5,160
https://kawalpemilu.org#57288,"KATAKA, KAHAUNGU ETI, SUMBA TIMUR, NUSA TENGGARA TIMUR",4,155,5,160
https://kawalpemilu.org#57289,"MATAWAI MARINGU, KAHAUNGU ETI, SUMBA TIMUR, NUSA TENGGARA TIMUR",1,115,7,122
https://kawalpemilu.org#57289,"MATAWAI MARINGU, KAHAUNGU ETI, SUMBA TIMUR, NUSA TENGGARA TIMUR",2,163,6,169
https://kawalpemilu.org#57290,"MAURAMBA, KAHAUNGU ETI, SUMBA TIMUR, NUSA TENGGARA TIMUR",1,152,5,157
https://kawalpemilu.org#57290,"MAURAMBA, KAHAUNGU ETI, SUMBA TIMUR, NUSA TENGGARA TIMUR",2,114,5,119
https://kawalpemilu.org#57292,"PRAIBOKUL, MATAWAI LA PAWU, SUMBA TIMUR, NUSA TENGGARA TIMUR",1,137,12,149
https://kawalpemilu.org#57292,"PRAIBOKUL, MATAWAI LA PAWU, SUMBA TIMUR, NUSA TENGGARA TIMUR",2,168,16,184
https://kawalpemilu.org#57292,"PRAIBOKUL, MATAWAI LA PAWU, SUMBA TIMUR, NUSA TENGGARA TIMUR",3,203,8,211
https://kawalpemilu.org#57292,"PRAIBOKUL, MATAWAI LA PAWU, SUMBA TIMUR, NUSA TENGGARA TIMUR",4,150,16,166
https://kawalpemilu.org#57293,"KATIKU TANA, MATAWAI LA PAWU, SUMBA TIMUR, NUSA TENGGARA TIMUR",1,166,2,168
https://kawalpemilu.org#57293,"KATIKU TANA, MATAWAI LA PAWU, SUMBA TIMUR, NUSA TENGGARA TIMUR",2,143,3,146
https://kawalpemilu.org#57293,"KATIKU TANA, MATAWAI LA PAWU, SUMBA TIMUR, NUSA TENGGARA TIMUR",3,118,4,122
https://kawalpemilu.org#57293,"KATIKU TANA, MATAWAI LA PAWU, SUMBA TIMUR, NUSA TENGGARA TIMUR",4,97,2,99
https://kawalpemilu.org#57293,"KATIKU TANA, MATAWAI LA PAWU, SUMBA TIMUR, NUSA TENGGARA TIMUR",5,139,10,149
https://kawalpemilu.org#57294,"KARIPI, MATAWAI LA PAWU, SUMBA TIMUR, NUSA TENGGARA TIMUR",1,123,3,126
https://kawalpemilu.org#57294,"KARIPI, MATAWAI LA PAWU, SUMBA TIMUR, NUSA TENGGARA TIMUR",2,140,3,143
https://kawalpemilu.org#57295,"WANGGA METI, MATAWAI LA PAWU, SUMBA TIMUR, NUSA TENGGARA TIMUR",1,133,8,141
https://kawalpemilu.org#57295,"WANGGA METI, MATAWAI LA PAWU, SUMBA TIMUR, NUSA TENGGARA TIMUR",2,110,11,121
https://kawalpemilu.org#57296,"KATIKU WAI, MATAWAI LA PAWU, SUMBA TIMUR, NUSA TENGGARA TIMUR",1,138,6,144
https://kawalpemilu.org#57296,"KATIKU WAI, MATAWAI LA PAWU, SUMBA TIMUR, NUSA TENGGARA TIMUR",2,212,2,214
https://kawalpemilu.org#57296,"KATIKU WAI, MATAWAI LA PAWU, SUMBA TIMUR, NUSA TENGGARA TIMUR",3,167,2,169
https://kawalpemilu.org#57296,"KATIKU WAI, MATAWAI LA PAWU, SUMBA TIMUR, NUSA TENGGARA TIMUR",4,114,0,114
https://kawalpemilu.org#57297,"KATIKU LUKU, MATAWAI LA PAWU, SUMBA TIMUR, NUSA TENGGARA TIMUR",1,231,7,238
https://kawalpemilu.org#57297,"KATIKU LUKU, MATAWAI LA PAWU, SUMBA TIMUR, NUSA TENGGARA TIMUR",2,128,12,140
https://kawalpemilu.org#57297,"KATIKU LUKU, MATAWAI LA PAWU, SUMBA TIMUR, NUSA TENGGARA TIMUR",3,211,11,222
https://kawalpemilu.org#57299,"WANGGA, KAMBERA, SUMBA TIMUR, NUSA TENGGARA TIMUR",1,199,11,210
https://kawalpemilu.org#57299,"WANGGA, KAMBERA, SUMBA TIMUR, NUSA TENGGARA TIMUR",2,137,3,140
https://kawalpemilu.org#57299,"WANGGA, KAMBERA, SUMBA TIMUR, NUSA TENGGARA TIMUR",3,210,5,215
https://kawalpemilu.org#57299,"WANGGA, KAMBERA, SUMBA TIMUR, NUSA TENGGARA TIMUR",4,175,5,180
https://kawalpemilu.org#57299,"WANGGA, KAMBERA, SUMBA TIMUR, NUSA TENGGARA TIMUR",5,214,4,218
https://kawalpemilu.org#57299,"WANGGA, KAMBERA, SUMBA TIMUR, NUSA TENGGARA TIMUR",6,193,11,204
https://kawalpemilu.org#57299,"WANGGA, KAMBERA, SUMBA TIMUR, NUSA TENGGARA TIMUR",7,218,7,225
https://kawalpemilu.org#57299,"WANGGA, KAMBERA, SUMBA TIMUR, NUSA TENGGARA TIMUR",8,199,5,204
https://kawalpemilu.org#57299,"WANGGA, KAMBERA, SUMBA TIMUR, NUSA TENGGARA TIMUR",9,163,7,170
https://kawalpemilu.org#57299,"WANGGA, KAMBERA, SUMBA TIMUR, NUSA TENGGARA TIMUR",10,168,2,170
https://kawalpemilu.org#57299,"WANGGA, KAMBERA, SUMBA TIMUR, NUSA TENGGARA TIMUR",11,221,8,229
https://kawalpemilu.org#57299,"WANGGA, KAMBERA, SUMBA TIMUR, NUSA TENGGARA TIMUR",12,155,5,160
https://kawalpemilu.org#57299,"WANGGA, KAMBERA, SUMBA TIMUR, NUSA TENGGARA TIMUR",13,168,17,185
https://kawalpemilu.org#57299,"WANGGA, KAMBERA, SUMBA TIMUR, NUSA TENGGARA TIMUR",14,172,21,193
https://kawalpemilu.org#57299,"WANGGA, KAMBERA, SUMBA TIMUR, NUSA TENGGARA TIMUR",15,230,8,238
https://kawalpemilu.org#57299,"WANGGA, KAMBERA, SUMBA TIMUR, NUSA TENGGARA TIMUR",16,221,4,225
https://kawalpemilu.org#57299,"WANGGA, KAMBERA, SUMBA TIMUR, NUSA TENGGARA TIMUR",17,128,8,136
https://kawalpemilu.org#57300,"PRAILIU, KAMBERA, SUMBA TIMUR, NUSA TENGGARA TIMUR",1,214,3,217
https://kawalpemilu.org#57300,"PRAILIU, KAMBERA, SUMBA TIMUR, NUSA TENGGARA TIMUR",2,229,10,239
https://kawalpemilu.org#57300,"PRAILIU, KAMBERA, SUMBA TIMUR, NUSA TENGGARA TIMUR",3,117,1,118
https://kawalpemilu.org#57300,"PRAILIU, KAMBERA, SUMBA TIMUR, NUSA TENGGARA TIMUR",4,163,8,171
https://kawalpemilu.org#57300,"PRAILIU, KAMBERA, SUMBA TIMUR, NUSA TENGGARA TIMUR",5,130,2,132
https://kawalpemilu.org#57300,"PRAILIU, KAMBERA, SUMBA TIMUR, NUSA TENGGARA TIMUR",6,190,10,200
https://kawalpemilu.org#57300,"PRAILIU, KAMBERA, SUMBA TIMUR, NUSA TENGGARA TIMUR",7,148,42,190
https://kawalpemilu.org#57300,"PRAILIU, KAMBERA, SUMBA TIMUR, NUSA TENGGARA TIMUR",8,123,1,124
https://kawalpemilu.org#57300,"PRAILIU, KAMBERA, SUMBA TIMUR, NUSA TENGGARA TIMUR",9,100,5,105
https://kawalpemilu.org#57300,"PRAILIU, KAMBERA, SUMBA TIMUR, NUSA TENGGARA TIMUR",10,144,3,147
https://kawalpemilu.org#57300,"PRAILIU, KAMBERA, SUMBA TIMUR, NUSA TENGGARA TIMUR",11,105,29,134
https://kawalpemilu.org#57300,"PRAILIU, KAMBERA, SUMBA TIMUR, NUSA TENGGARA TIMUR",12,143,1,144
https://kawalpemilu.org#57300,"PRAILIU, KAMBERA, SUMBA TIMUR, NUSA TENGGARA TIMUR",13,194,7,201
https://kawalpemilu.org#57300,"PRAILIU, KAMBERA, SUMBA TIMUR, NUSA TENGGARA TIMUR",14,83,34,117
https://kawalpemilu.org#57300,"PRAILIU, KAMBERA, SUMBA TIMUR, NUSA TENGGARA TIMUR",15,205,4,209
https://kawalpemilu.org#57300,"PRAILIU, KAMBERA, SUMBA TIMUR, NUSA TENGGARA TIMUR",16,178,8,186
https://kawalpemilu.org#57300,"PRAILIU, KAMBERA, SUMBA TIMUR, NUSA TENGGARA TIMUR",17,148,10,158
https://kawalpemilu.org#57300,"PRAILIU, KAMBERA, SUMBA TIMUR, NUSA TENGGARA TIMUR",18,167,3,170
https://kawalpemilu.org#57300,"PRAILIU, KAMBERA, SUMBA TIMUR, NUSA TENGGARA TIMUR",19,190,7,197
https://kawalpemilu.org#57300,"PRAILIU, KAMBERA, SUMBA TIMUR, NUSA TENGGARA TIMUR",20,115,5,120
https://kawalpemilu.org#57300,"PRAILIU, KAMBERA, SUMBA TIMUR, NUSA TENGGARA TIMUR",21,77,3,80
https://kawalpemilu.org#57300,"PRAILIU, KAMBERA, SUMBA TIMUR, NUSA TENGGARA TIMUR",22,177,4,181
https://kawalpemilu.org#57300,"PRAILIU, KAMBERA, SUMBA TIMUR, NUSA TENGGARA TIMUR",23,175,24,199
https://kawalpemilu.org#57300,"PRAILIU, KAMBERA, SUMBA TIMUR, NUSA TENGGARA TIMUR",24,122,12,134
https://kawalpemilu.org#57301,"KAMBANIRU, KAMBERA, SUMBA TIMUR, NUSA TENGGARA TIMUR",1,165,7,172
https://kawalpemilu.org#57301,"KAMBANIRU, KAMBERA, SUMBA TIMUR, NUSA TENGGARA TIMUR",2,176,5,181
https://kawalpemilu.org#57301,"KAMBANIRU, KAMBERA, SUMBA TIMUR, NUSA TENGGARA TIMUR",3,179,4,183
https://kawalpemilu.org#57301,"KAMBANIRU, KAMBERA, SUMBA TIMUR, NUSA TENGGARA TIMUR",4,133,6,139
https://kawalpemilu.org#57301,"KAMBANIRU, KAMBERA, SUMBA TIMUR, NUSA TENGGARA TIMUR",5,159,2,161
https://kawalpemilu.org#57301,"KAMBANIRU, KAMBERA, SUMBA TIMUR, NUSA TENGGARA TIMUR",6,242,5,247
https://kawalpemilu.org#57301,"KAMBANIRU, KAMBERA, SUMBA TIMUR, NUSA TENGGARA TIMUR",7,215,8,223
https://kawalpemilu.org#57301,"KAMBANIRU, KAMBERA, SUMBA TIMUR, NUSA TENGGARA TIMUR",8,203,7,210
https://kawalpemilu.org#57301,"KAMBANIRU, KAMBERA, SUMBA TIMUR, NUSA TENGGARA TIMUR",9,138,6,144
https://kawalpemilu.org#57301,"KAMBANIRU, KAMBERA, SUMBA TIMUR, NUSA TENGGARA TIMUR",10,170,6,176
https://kawalpemilu.org#57301,"KAMBANIRU, KAMBERA, SUMBA TIMUR, NUSA TENGGARA TIMUR",11,149,2,151
https://kawalpemilu.org#57301,"KAMBANIRU, KAMBERA, SUMBA TIMUR, NUSA TENGGARA TIMUR",12,194,0,194
https://kawalpemilu.org#57301,"KAMBANIRU, KAMBERA, SUMBA TIMUR, NUSA TENGGARA TIMUR",13,197,2,199
https://kawalpemilu.org#57301,"KAMBANIRU, KAMBERA, SUMBA TIMUR, NUSA TENGGARA TIMUR",14,177,4,181
https://kawalpemilu.org#57301,"KAMBANIRU, KAMBERA, SUMBA TIMUR, NUSA TENGGARA TIMUR",15,206,15,221
https://kawalpemilu.org#57301,"KAMBANIRU, KAMBERA, SUMBA TIMUR, NUSA TENGGARA TIMUR",16,171,20,191
https://kawalpemilu.org#57301,"KAMBANIRU, KAMBERA, SUMBA TIMUR, NUSA TENGGARA TIMUR",17,194,9,203
https://kawalpemilu.org#57301,"KAMBANIRU, KAMBERA, SUMBA TIMUR, NUSA TENGGARA TIMUR",19,190,14,204
https://kawalpemilu.org#57301,"KAMBANIRU, KAMBERA, SUMBA TIMUR, NUSA TENGGARA TIMUR",20,217,10,227
https://kawalpemilu.org#57302,"MAULIRU, KAMBERA, SUMBA TIMUR, NUSA TENGGARA TIMUR",1,131,3,134
https://kawalpemilu.org#57302,"MAULIRU, KAMBERA, SUMBA TIMUR, NUSA TENGGARA TIMUR",2,139,8,147
https://kawalpemilu.org#57302,"MAULIRU, KAMBERA, SUMBA TIMUR, NUSA TENGGARA TIMUR",3,215,3,218
https://kawalpemilu.org#57302,"MAULIRU, KAMBERA, SUMBA TIMUR, NUSA TENGGARA TIMUR",4,175,6,181
https://kawalpemilu.org#57302,"MAULIRU, KAMBERA, SUMBA TIMUR, NUSA TENGGARA TIMUR",5,161,2,163
https://kawalpemilu.org#57302,"MAULIRU, KAMBERA, SUMBA TIMUR, NUSA TENGGARA TIMUR",6,221,6,227
https://kawalpemilu.org#57302,"MAULIRU, KAMBERA, SUMBA TIMUR, NUSA TENGGARA TIMUR",7,188,5,193
https://kawalpemilu.org#57302,"MAULIRU, KAMBERA, SUMBA TIMUR, NUSA TENGGARA TIMUR",8,150,12,162
https://kawalpemilu.org#57302,"MAULIRU, KAMBERA, SUMBA TIMUR, NUSA TENGGARA TIMUR",9,217,22,239
https://kawalpemilu.org#57302,"MAULIRU, KAMBERA, SUMBA TIMUR, NUSA TENGGARA TIMUR",10,165,2,167
https://kawalpemilu.org#57302,"MAULIRU, KAMBERA, SUMBA TIMUR, NUSA TENGGARA TIMUR",11,137,5,142
https://kawalpemilu.org#57302,"MAULIRU, KAMBERA, SUMBA TIMUR, NUSA TENGGARA TIMUR",12,159,10,169
https://kawalpemilu.org#57302,"MAULIRU, KAMBERA, SUMBA TIMUR, NUSA TENGGARA TIMUR",13,181,13,194
https://kawalpemilu.org#57302,"MAULIRU, KAMBERA, SUMBA TIMUR, NUSA TENGGARA TIMUR",14,77,6,83
https://kawalpemilu.org#57303,"MAUHAU, KAMBERA, SUMBA TIMUR, NUSA TENGGARA TIMUR",2,139,4,143
https://kawalpemilu.org#57303,"MAUHAU, KAMBERA, SUMBA TIMUR, NUSA TENGGARA TIMUR",3,225,6,231
https://kawalpemilu.org#57303,"MAUHAU, KAMBERA, SUMBA TIMUR, NUSA TENGGARA TIMUR",4,176,8,184
https://kawalpemilu.org#57303,"MAUHAU, KAMBERA, SUMBA TIMUR, NUSA TENGGARA TIMUR",5,157,12,169
https://kawalpemilu.org#57303,"MAUHAU, KAMBERA, SUMBA TIMUR, NUSA TENGGARA TIMUR",6,188,6,194
https://kawalpemilu.org#57304,"MALUMBI, KAMBERA, SUMBA TIMUR, NUSA TENGGARA TIMUR",1,232,15,247
https://kawalpemilu.org#57304,"MALUMBI, KAMBERA, SUMBA TIMUR, NUSA TENGGARA TIMUR",2,167,1,168
https://kawalpemilu.org#57304,"MALUMBI, KAMBERA, SUMBA TIMUR, NUSA TENGGARA TIMUR",4,195,3,198
https://kawalpemilu.org#57304,"MALUMBI, KAMBERA, SUMBA TIMUR, NUSA TENGGARA TIMUR",5,197,3,200
https://kawalpemilu.org#57304,"MALUMBI, KAMBERA, SUMBA TIMUR, NUSA TENGGARA TIMUR",6,148,5,153
https://kawalpemilu.org#57305,"LAMBANAPU, KAMBERA, SUMBA TIMUR, NUSA TENGGARA TIMUR",1,194,18,212
https://kawalpemilu.org#57305,"LAMBANAPU, KAMBERA, SUMBA TIMUR, NUSA TENGGARA TIMUR",2,191,7,198
https://kawalpemilu.org#57305,"LAMBANAPU, KAMBERA, SUMBA TIMUR, NUSA TENGGARA TIMUR",3,206,7,213
https://kawalpemilu.org#57305,"LAMBANAPU, KAMBERA, SUMBA TIMUR, NUSA TENGGARA TIMUR",4,176,16,192
https://kawalpemilu.org#57305,"LAMBANAPU, KAMBERA, SUMBA TIMUR, NUSA TENGGARA TIMUR",5,238,8,246
https://kawalpemilu.org#57305,"LAMBANAPU, KAMBERA, SUMBA TIMUR, NUSA TENGGARA TIMUR",6,234,4,238
https://kawalpemilu.org#57305,"LAMBANAPU, KAMBERA, SUMBA TIMUR, NUSA TENGGARA TIMUR",7,206,10,216
https://kawalpemilu.org#57305,"LAMBANAPU, KAMBERA, SUMBA TIMUR, NUSA TENGGARA TIMUR",8,191,32,223
https://kawalpemilu.org#57306,"KIRITANA, KAMBERA, SUMBA TIMUR, NUSA TENGGARA TIMUR",1,179,6,185
https://kawalpemilu.org#57306,"KIRITANA, KAMBERA, SUMBA TIMUR, NUSA TENGGARA TIMUR",2,111,11,122
https://kawalpemilu.org#57306,"KIRITANA, KAMBERA, SUMBA TIMUR, NUSA TENGGARA TIMUR",3,123,6,129
https://kawalpemilu.org#57306,"KIRITANA, KAMBERA, SUMBA TIMUR, NUSA TENGGARA TIMUR",4,113,4,117
https://kawalpemilu.org#57308,"LUKU WINGIR, KAMBATA MAPAMBUHANG, SUMBA TIMUR, NUSA TENGGARA TIMUR",1,153,7,160
https://kawalpemilu.org#57308,"LUKU WINGIR, KAMBATA MAPAMBUHANG, SUMBA TIMUR, NUSA TENGGARA TIMUR",2,137,15,152
https://kawalpemilu.org#57309,"WAIMBIDI, KAMBATA MAPAMBUHANG, SUMBA TIMUR, NUSA TENGGARA TIMUR",1,121,2,123
https://kawalpemilu.org#57309,"WAIMBIDI, KAMBATA MAPAMBUHANG, SUMBA TIMUR, NUSA TENGGARA TIMUR",2,133,6,139
https://kawalpemilu.org#57310,"LAIMETA, KAMBATA MAPAMBUHANG, SUMBA TIMUR, NUSA TENGGARA TIMUR",1,172,5,177
https://kawalpemilu.org#57310,"LAIMETA, KAMBATA MAPAMBUHANG, SUMBA TIMUR, NUSA TENGGARA TIMUR",2,138,4,142
https://kawalpemilu.org#57311,"MAHU BOKUL, KAMBATA MAPAMBUHANG, SUMBA TIMUR, NUSA TENGGARA TIMUR",1,117,1,118
https://kawalpemilu.org#57311,"MAHU BOKUL, KAMBATA MAPAMBUHANG, SUMBA TIMUR, NUSA TENGGARA TIMUR",2,103,2,105
https://kawalpemilu.org#57312,"MARADAMUNDI, KAMBATA MAPAMBUHANG, SUMBA TIMUR, NUSA TENGGARA TIMUR",1,210,13,223
https://kawalpemilu.org#57312,"MARADAMUNDI, KAMBATA MAPAMBUHANG, SUMBA TIMUR, NUSA TENGGARA TIMUR",2,217,11,228
https://kawalpemilu.org#57313,"MAIDANG, KAMBATA MAPAMBUHANG, SUMBA TIMUR, NUSA TENGGARA TIMUR",1,131,4,135
https://kawalpemilu.org#57313,"MAIDANG, KAMBATA MAPAMBUHANG, SUMBA TIMUR, NUSA TENGGARA TIMUR",2,151,9,160
https://kawalpemilu.org#57313,"MAIDANG, KAMBATA MAPAMBUHANG, SUMBA TIMUR, NUSA TENGGARA TIMUR",3,112,0,112
https://kawalpemilu.org#57315,"WATUMBELAR, LEWA TIDAHU, SUMBA TIMUR, NUSA TENGGARA TIMUR",1,152,6,158
https://kawalpemilu.org#57315,"WATUMBELAR, LEWA TIDAHU, SUMBA TIMUR, NUSA TENGGARA TIMUR",2,126,2,128
https://kawalpemilu.org#57315,"WATUMBELAR, LEWA TIDAHU, SUMBA TIMUR, NUSA TENGGARA TIMUR",3,134,1,135
https://kawalpemilu.org#57316,"BIDIPRAING, LEWA TIDAHU, SUMBA TIMUR, NUSA TENGGARA TIMUR",1,168,9,177
https://kawalpemilu.org#57316,"BIDIPRAING, LEWA TIDAHU, SUMBA TIMUR, NUSA TENGGARA TIMUR",2,173,4,177
https://kawalpemilu.org#57317,"UMAMANU, LEWA TIDAHU, SUMBA TIMUR, NUSA TENGGARA TIMUR",1,182,10,192
https://kawalpemilu.org#57317,"UMAMANU, LEWA TIDAHU, SUMBA TIMUR, NUSA TENGGARA TIMUR",2,172,5,177
https://kawalpemilu.org#57317,"UMAMANU, LEWA TIDAHU, SUMBA TIMUR, NUSA TENGGARA TIMUR",3,114,1,115
https://kawalpemilu.org#57318,"MONDU LAMBI, LEWA TIDAHU, SUMBA TIMUR, NUSA TENGGARA TIMUR",1,211,9,220
https://kawalpemilu.org#57318,"MONDU LAMBI, LEWA TIDAHU, SUMBA TIMUR, NUSA TENGGARA TIMUR",2,178,3,181
https://kawalpemilu.org#57319,"KANGELI, LEWA TIDAHU, SUMBA TIMUR, NUSA TENGGARA TIMUR",1,190,8,198
https://kawalpemilu.org#57319,"KANGELI, LEWA TIDAHU, SUMBA TIMUR, NUSA TENGGARA TIMUR",2,154,4,158
https://kawalpemilu.org#57319,"KANGELI, LEWA TIDAHU, SUMBA TIMUR, NUSA TENGGARA TIMUR",3,213,5,218
https://kawalpemilu.org#57319,"KANGELI, LEWA TIDAHU, SUMBA TIMUR, NUSA TENGGARA TIMUR",4,139,0,139
https://kawalpemilu.org#57319,"KANGELI, LEWA TIDAHU, SUMBA TIMUR, NUSA TENGGARA TIMUR",5,149,3,152
https://kawalpemilu.org#57319,"KANGELI, LEWA TIDAHU, SUMBA TIMUR, NUSA TENGGARA TIMUR",6,163,2,165
https://kawalpemilu.org#57320,"LAIHAU, LEWA TIDAHU, SUMBA TIMUR, NUSA TENGGARA TIMUR",1,156,5,161
https://kawalpemilu.org#57320,"LAIHAU, LEWA TIDAHU, SUMBA TIMUR, NUSA TENGGARA TIMUR",2,132,5,137
https://kawalpemilu.org#57320,"LAIHAU, LEWA TIDAHU, SUMBA TIMUR, NUSA TENGGARA TIMUR",3,191,4,195
https://kawalpemilu.org#57320,"LAIHAU, LEWA TIDAHU, SUMBA TIMUR, NUSA TENGGARA TIMUR",4,175,2,177
https://kawalpemilu.org#57320,"LAIHAU, LEWA TIDAHU, SUMBA TIMUR, NUSA TENGGARA TIMUR",5,145,11,156
https://kawalpemilu.org#57322,"KOMBAPARI, KATALA HAMU LINGU, SUMBA TIMUR, NUSA TENGGARA TIMUR",1,214,3,217
https://kawalpemilu.org#57322,"KOMBAPARI, KATALA HAMU LINGU, SUMBA TIMUR, NUSA TENGGARA TIMUR",2,200,1,201
https://kawalpemilu.org#57323,"MATAWAI AMAHU, KATALA HAMU LINGU, SUMBA TIMUR, NUSA TENGGARA TIMUR",1,230,13,243
https://kawalpemilu.org#57324,"MANDAHU, KATALA HAMU LINGU, SUMBA TIMUR, NUSA TENGGARA TIMUR",1,211,17,228
https://kawalpemilu.org#57324,"MANDAHU, KATALA HAMU LINGU, SUMBA TIMUR, NUSA TENGGARA TIMUR",2,153,18,171
https://kawalpemilu.org#57325,"LAI LARA, KATALA HAMU LINGU, SUMBA TIMUR, NUSA TENGGARA TIMUR",1,190,6,196
https://kawalpemilu.org#57325,"LAI LARA, KATALA HAMU LINGU, SUMBA TIMUR, NUSA TENGGARA TIMUR",2,162,7,169
https://kawalpemilu.org#57325,"LAI LARA, KATALA HAMU LINGU, SUMBA TIMUR, NUSA TENGGARA TIMUR",3,229,12,241
https://kawalpemilu.org#57326,"PRAIBAKUL, KATALA HAMU LINGU, SUMBA TIMUR, NUSA TENGGARA TIMUR",1,169,13,182
https://kawalpemilu.org#57326,"PRAIBAKUL, KATALA HAMU LINGU, SUMBA TIMUR, NUSA TENGGARA TIMUR",2,207,2,209
https://kawalpemilu.org#57326,"PRAIBAKUL, KATALA HAMU LINGU, SUMBA TIMUR, NUSA TENGGARA TIMUR",3,167,3,170
https://kawalpemilu.org#57328,"TEMU, KANATANG, SUMBA TIMUR, NUSA TENGGARA TIMUR",1,177,11,188
https://kawalpemilu.org#57328,"TEMU, KANATANG, SUMBA TIMUR, NUSA TENGGARA TIMUR",2,207,4,211
https://kawalpemilu.org#57328,"TEMU, KANATANG, SUMBA TIMUR, NUSA TENGGARA TIMUR",3,193,11,204
https://kawalpemilu.org#57328,"TEMU, KANATANG, SUMBA TIMUR, NUSA TENGGARA TIMUR",4,209,18,227
https://kawalpemilu.org#57328,"TEMU, KANATANG, SUMBA TIMUR, NUSA TENGGARA TIMUR",5,167,13,180
https://kawalpemilu.org#57328,"TEMU, KANATANG, SUMBA TIMUR, NUSA TENGGARA TIMUR",6,201,15,216
https://kawalpemilu.org#57328,"TEMU, KANATANG, SUMBA TIMUR, NUSA TENGGARA TIMUR",7,218,12,230
https://kawalpemilu.org#57328,"TEMU, KANATANG, SUMBA TIMUR, NUSA TENGGARA TIMUR",8,181,9,190
https://kawalpemilu.org#57328,"TEMU, KANATANG, SUMBA TIMUR, NUSA TENGGARA TIMUR",9,131,5,136
https://kawalpemilu.org#57328,"TEMU, KANATANG, SUMBA TIMUR, NUSA TENGGARA TIMUR",10,195,2,197
https://kawalpemilu.org#57328,"TEMU, KANATANG, SUMBA TIMUR, NUSA TENGGARA TIMUR",11,152,1,153
https://kawalpemilu.org#57328,"TEMU, KANATANG, SUMBA TIMUR, NUSA TENGGARA TIMUR",12,131,6,137
https://kawalpemilu.org#57328,"TEMU, KANATANG, SUMBA TIMUR, NUSA TENGGARA TIMUR",13,154,8,162
https://kawalpemilu.org#57328,"TEMU, KANATANG, SUMBA TIMUR, NUSA TENGGARA TIMUR",14,186,10,196
https://kawalpemilu.org#57328,"TEMU, KANATANG, SUMBA TIMUR, NUSA TENGGARA TIMUR",15,103,2,105
https://kawalpemilu.org#57329,"KUTA, KANATANG, SUMBA TIMUR, NUSA TENGGARA TIMUR",1,221,19,240
https://kawalpemilu.org#57329,"KUTA, KANATANG, SUMBA TIMUR, NUSA TENGGARA TIMUR",2,98,8,106
https://kawalpemilu.org#57329,"KUTA, KANATANG, SUMBA TIMUR, NUSA TENGGARA TIMUR",3,208,5,213
https://kawalpemilu.org#57329,"KUTA, KANATANG, SUMBA TIMUR, NUSA TENGGARA TIMUR",4,125,4,129
https://kawalpemilu.org#57330,"HAMBAPRAING, KANATANG, SUMBA TIMUR, NUSA TENGGARA TIMUR",1,204,10,214
https://kawalpemilu.org#57330,"HAMBAPRAING, KANATANG, SUMBA TIMUR, NUSA TENGGARA TIMUR",2,226,13,239
https://kawalpemilu.org#57330,"HAMBAPRAING, KANATANG, SUMBA TIMUR, NUSA TENGGARA TIMUR",3,112,1,113
https://kawalpemilu.org#57331,"MONDU, KANATANG, SUMBA TIMUR, NUSA TENGGARA TIMUR",1,198,6,204
https://kawalpemilu.org#57331,"MONDU, KANATANG, SUMBA TIMUR, NUSA TENGGARA TIMUR",2,156,4,160
https://kawalpemilu.org#57331,"MONDU, KANATANG, SUMBA TIMUR, NUSA TENGGARA TIMUR",3,157,6,163
https://kawalpemilu.org#57331,"MONDU, KANATANG, SUMBA TIMUR, NUSA TENGGARA TIMUR",4,143,5,148
https://kawalpemilu.org#57331,"MONDU, KANATANG, SUMBA TIMUR, NUSA TENGGARA TIMUR",5,103,3,106
https://kawalpemilu.org#57332,"NDAPAYAMI, KANATANG, SUMBA TIMUR, NUSA TENGGARA TIMUR",1,177,5,182
https://kawalpemilu.org#57332,"NDAPAYAMI, KANATANG, SUMBA TIMUR, NUSA TENGGARA TIMUR",2,180,5,185
https://kawalpemilu.org#57334,"PRAIWITU, NGADU NGALA, SUMBA TIMUR, NUSA TENGGARA TIMUR",1,209,15,224
https://kawalpemilu.org#57334,"PRAIWITU, NGADU NGALA, SUMBA TIMUR, NUSA TENGGARA TIMUR",2,151,5,156
https://kawalpemilu.org#57335,"KAKAHA, NGADU NGALA, SUMBA TIMUR, NUSA TENGGARA TIMUR",1,155,2,157
https://kawalpemilu.org#57335,"KAKAHA, NGADU NGALA, SUMBA TIMUR, NUSA TENGGARA TIMUR",2,162,13,175
https://kawalpemilu.org#57335,"KAKAHA, NGADU NGALA, SUMBA TIMUR, NUSA TENGGARA TIMUR",3,185,5,190
https://kawalpemilu.org#57335,"KAKAHA, NGADU NGALA, SUMBA TIMUR, NUSA TENGGARA TIMUR",4,175,6,181
https://kawalpemilu.org#57335,"KAKAHA, NGADU NGALA, SUMBA TIMUR, NUSA TENGGARA TIMUR",5,155,16,171
https://kawalpemilu.org#57335,"KAKAHA, NGADU NGALA, SUMBA TIMUR, NUSA TENGGARA TIMUR",6,143,3,146
https://kawalpemilu.org#57336,"HAMBA WUTANG, NGADU NGALA, SUMBA TIMUR, NUSA TENGGARA TIMUR",1,188,8,196
https://kawalpemilu.org#57336,"HAMBA WUTANG, NGADU NGALA, SUMBA TIMUR, NUSA TENGGARA TIMUR",2,171,4,175
https://kawalpemilu.org#57336,"HAMBA WUTANG, NGADU NGALA, SUMBA TIMUR, NUSA TENGGARA TIMUR",3,142,6,148
https://kawalpemilu.org#57336,"HAMBA WUTANG, NGADU NGALA, SUMBA TIMUR, NUSA TENGGARA TIMUR",4,87,0,87
https://kawalpemilu.org#57337,"KABANDA, NGADU NGALA, SUMBA TIMUR, NUSA TENGGARA TIMUR",1,176,16,192
https://kawalpemilu.org#57337,"KABANDA, NGADU NGALA, SUMBA TIMUR, NUSA TENGGARA TIMUR",2,103,6,109
https://kawalpemilu.org#57337,"KABANDA, NGADU NGALA, SUMBA TIMUR, NUSA TENGGARA TIMUR",3,95,3,98
https://kawalpemilu.org#57338,"PRAURAMING, NGADU NGALA, SUMBA TIMUR, NUSA TENGGARA TIMUR",1,106,2,108
https://kawalpemilu.org#57338,"PRAURAMING, NGADU NGALA, SUMBA TIMUR, NUSA TENGGARA TIMUR",2,99,6,105
https://kawalpemilu.org#57340,"LAHIRU, MAHU, SUMBA TIMUR, NUSA TENGGARA TIMUR",1,161,3,164
https://kawalpemilu.org#57340,"LAHIRU, MAHU, SUMBA TIMUR, NUSA TENGGARA TIMUR",2,166,4,170
https://kawalpemilu.org#57340,"LAHIRU, MAHU, SUMBA TIMUR, NUSA TENGGARA TIMUR",3,93,0,93
https://kawalpemilu.org#57340,"LAHIRU, MAHU, SUMBA TIMUR, NUSA TENGGARA TIMUR",4,85,3,88
https://kawalpemilu.org#57341,"PATAMAWAI, MAHU, SUMBA TIMUR, NUSA TENGGARA TIMUR",1,123,25,148
https://kawalpemilu.org#57341,"PATAMAWAI, MAHU, SUMBA TIMUR, NUSA TENGGARA TIMUR",2,127,8,135
https://kawalpemilu.org#57341,"PATAMAWAI, MAHU, SUMBA TIMUR, NUSA TENGGARA TIMUR",3,124,4,128
https://kawalpemilu.org#57342,"WAIRARA, MAHU, SUMBA TIMUR, NUSA TENGGARA TIMUR",1,183,6,189
https://kawalpemilu.org#57343,"PRAIKALALA, MAHU, SUMBA TIMUR, NUSA TENGGARA TIMUR",1,132,3,135
https://kawalpemilu.org#57343,"PRAIKALALA, MAHU, SUMBA TIMUR, NUSA TENGGARA TIMUR",2,116,8,124
https://kawalpemilu.org#57344,"LULUNDILU, MAHU, SUMBA TIMUR, NUSA TENGGARA TIMUR",1,130,22,152
https://kawalpemilu.org#57344,"LULUNDILU, MAHU, SUMBA TIMUR, NUSA TENGGARA TIMUR",2,107,13,120
https://kawalpemilu.org#57344,"LULUNDILU, MAHU, SUMBA TIMUR, NUSA TENGGARA TIMUR",3,110,17,127
https://kawalpemilu.org#57344,"LULUNDILU, MAHU, SUMBA TIMUR, NUSA TENGGARA TIMUR",4,158,19,177
https://kawalpemilu.org#57345,"HARAI, MAHU, SUMBA TIMUR, NUSA TENGGARA TIMUR",1,193,11,204
https://kawalpemilu.org#57345,"HARAI, MAHU, SUMBA TIMUR, NUSA TENGGARA TIMUR",2,131,7,138
https://kawalpemilu.org#57348,"LOKORY, TANA RIGHU, SUMBA BARAT, NUSA TENGGARA TIMUR",1,175,6,181
https://kawalpemilu.org#57348,"LOKORY, TANA RIGHU, SUMBA BARAT, NUSA TENGGARA TIMUR",2,158,22,180
https://kawalpemilu.org#57348,"LOKORY, TANA RIGHU, SUMBA BARAT, NUSA TENGGARA TIMUR",3,185,7,192
https://kawalpemilu.org#57348,"LOKORY, TANA RIGHU, SUMBA BARAT, NUSA TENGGARA TIMUR",4,178,9,187
https://kawalpemilu.org#57348,"LOKORY, TANA RIGHU, SUMBA BARAT, NUSA TENGGARA TIMUR",5,140,5,145
https://kawalpemilu.org#57348,"LOKORY, TANA RIGHU, SUMBA BARAT, NUSA TENGGARA TIMUR",6,161,1,162
https://kawalpemilu.org#57348,"LOKORY, TANA RIGHU, SUMBA BARAT, NUSA TENGGARA TIMUR",7,191,10,201
https://kawalpemilu.org#57348,"LOKORY, TANA RIGHU, SUMBA BARAT, NUSA TENGGARA TIMUR",8,176,2,178
https://kawalpemilu.org#57349,"LOLO WANO, TANA RIGHU, SUMBA BARAT, NUSA TENGGARA TIMUR",1,187,8,195
https://kawalpemilu.org#57349,"LOLO WANO, TANA RIGHU, SUMBA BARAT, NUSA TENGGARA TIMUR",2,170,1,171
https://kawalpemilu.org#57349,"LOLO WANO, TANA RIGHU, SUMBA BARAT, NUSA TENGGARA TIMUR",3,158,10,168
https://kawalpemilu.org#57350,"MALATA, TANA RIGHU, SUMBA BARAT, NUSA TENGGARA TIMUR",1,163,20,183
https://kawalpemilu.org#57350,"MALATA, TANA RIGHU, SUMBA BARAT, NUSA TENGGARA TIMUR",2,129,12,141
https://kawalpemilu.org#57350,"MALATA, TANA RIGHU, SUMBA BARAT, NUSA TENGGARA TIMUR",3,158,9,167
https://kawalpemilu.org#57350,"MALATA, TANA RIGHU, SUMBA BARAT, NUSA TENGGARA TIMUR",4,160,2,162
https://kawalpemilu.org#57351,"NGADU PADA, TANA RIGHU, SUMBA BARAT, NUSA TENGGARA TIMUR",1,187,20,207
https://kawalpemilu.org#57351,"NGADU PADA, TANA RIGHU, SUMBA BARAT, NUSA TENGGARA TIMUR",2,207,5,212
https://kawalpemilu.org#57352,"LINGU LANGO, TANA RIGHU, SUMBA BARAT, NUSA TENGGARA TIMUR",1,157,7,164
https://kawalpemilu.org#57352,"LINGU LANGO, TANA RIGHU, SUMBA BARAT, NUSA TENGGARA TIMUR",2,128,9,137
https://kawalpemilu.org#57352,"LINGU LANGO, TANA RIGHU, SUMBA BARAT, NUSA TENGGARA TIMUR",3,123,13,136
https://kawalpemilu.org#57352,"LINGU LANGO, TANA RIGHU, SUMBA BARAT, NUSA TENGGARA TIMUR",4,119,6,125
https://kawalpemilu.org#57353,"KAREKA NDUKU, TANA RIGHU, SUMBA BARAT, NUSA TENGGARA TIMUR",1,145,10,155
https://kawalpemilu.org#57353,"KAREKA NDUKU, TANA RIGHU, SUMBA BARAT, NUSA TENGGARA TIMUR",2,140,6,146
https://kawalpemilu.org#57353,"KAREKA NDUKU, TANA RIGHU, SUMBA BARAT, NUSA TENGGARA TIMUR",3,170,8,178
https://kawalpemilu.org#57354,"WANO KAZA, TANA RIGHU, SUMBA BARAT, NUSA TENGGARA TIMUR",1,183,10,193
https://kawalpemilu.org#57354,"WANO KAZA, TANA RIGHU, SUMBA BARAT, NUSA TENGGARA TIMUR",2,172,5,177
https://kawalpemilu.org#57354,"WANO KAZA, TANA RIGHU, SUMBA BARAT, NUSA TENGGARA TIMUR",3,198,6,204
https://kawalpemilu.org#57355,"WEE PATOLA, TANA RIGHU, SUMBA BARAT, NUSA TENGGARA TIMUR",1,136,5,141
https://kawalpemilu.org#57355,"WEE PATOLA, TANA RIGHU, SUMBA BARAT, NUSA TENGGARA TIMUR",2,162,9,171
https://kawalpemilu.org#57355,"WEE PATOLA, TANA RIGHU, SUMBA BARAT, NUSA TENGGARA TIMUR",3,123,2,125
https://kawalpemilu.org#57356,"ZALAKADU, TANA RIGHU, SUMBA BARAT, NUSA TENGGARA TIMUR",1,148,16,164
https://kawalpemilu.org#57356,"ZALAKADU, TANA RIGHU, SUMBA BARAT, NUSA TENGGARA TIMUR",2,146,13,159
https://kawalpemilu.org#57356,"ZALAKADU, TANA RIGHU, SUMBA BARAT, NUSA TENGGARA TIMUR",3,140,6,146
https://kawalpemilu.org#57357,"BONDO TERA, TANA RIGHU, SUMBA BARAT, NUSA TENGGARA TIMUR",1,193,9,202
https://kawalpemilu.org#57357,"BONDO TERA, TANA RIGHU, SUMBA BARAT, NUSA TENGGARA TIMUR",2,164,5,169
https://kawalpemilu.org#57357,"BONDO TERA, TANA RIGHU, SUMBA BARAT, NUSA TENGGARA TIMUR",3,122,6,128
https://kawalpemilu.org#57358,"MANU KUKU, TANA RIGHU, SUMBA BARAT, NUSA TENGGARA TIMUR",1,131,6,137
https://kawalpemilu.org#57358,"MANU KUKU, TANA RIGHU, SUMBA BARAT, NUSA TENGGARA TIMUR",2,153,1,154
https://kawalpemilu.org#57358,"MANU KUKU, TANA RIGHU, SUMBA BARAT, NUSA TENGGARA TIMUR",3,105,2,107
https://kawalpemilu.org#57358,"MANU KUKU, TANA RIGHU, SUMBA BARAT, NUSA TENGGARA TIMUR",4,143,3,146
https://kawalpemilu.org#88665,"LOLO TANA, TANA RIGHU, SUMBA BARAT, NUSA TENGGARA TIMUR",1,211,2,213
https://kawalpemilu.org#88665,"LOLO TANA, TANA RIGHU, SUMBA BARAT, NUSA TENGGARA TIMUR",2,162,4,166
https://kawalpemilu.org#88666,"KAREKA NDUKU UTARA, TANA RIGHU, SUMBA BARAT, NUSA TENGGARA TIMUR",1,166,13,179
https://kawalpemilu.org#88666,"KAREKA NDUKU UTARA, TANA RIGHU, SUMBA BARAT, NUSA TENGGARA TIMUR",2,163,2,165
https://kawalpemilu.org#88669,"KAREKA NDUKU SELATAN, TANA RIGHU, SUMBA BARAT, NUSA TENGGARA TIMUR",1,161,3,164
https://kawalpemilu.org#88669,"KAREKA NDUKU SELATAN, TANA RIGHU, SUMBA BARAT, NUSA TENGGARA TIMUR",2,167,5,172
https://kawalpemilu.org#88672,"MANU MADA, TANA RIGHU, SUMBA BARAT, NUSA TENGGARA TIMUR",1,156,10,166
https://kawalpemilu.org#88672,"MANU MADA, TANA RIGHU, SUMBA BARAT, NUSA TENGGARA TIMUR",2,156,3,159
https://kawalpemilu.org#88672,"MANU MADA, TANA RIGHU, SUMBA BARAT, NUSA TENGGARA TIMUR",3,171,6,177
https://kawalpemilu.org#88673,"ELU LODA, TANA RIGHU, SUMBA BARAT, NUSA TENGGARA TIMUR",1,134,1,135
https://kawalpemilu.org#88673,"ELU LODA, TANA RIGHU, SUMBA BARAT, NUSA TENGGARA TIMUR",2,162,21,183
https://kawalpemilu.org#88674,"KALEMBU ANA KAKA, TANA RIGHU, SUMBA BARAT, NUSA TENGGARA TIMUR",1,116,11,127
https://kawalpemilu.org#88674,"KALEMBU ANA KAKA, TANA RIGHU, SUMBA BARAT, NUSA TENGGARA TIMUR",2,130,2,132
https://kawalpemilu.org#88674,"KALEMBU ANA KAKA, TANA RIGHU, SUMBA BARAT, NUSA TENGGARA TIMUR",3,142,9,151
https://kawalpemilu.org#88678,"TARONA, TANA RIGHU, SUMBA BARAT, NUSA TENGGARA TIMUR",1,185,10,195
https://kawalpemilu.org#88678,"TARONA, TANA RIGHU, SUMBA BARAT, NUSA TENGGARA TIMUR",2,181,10,191
https://kawalpemilu.org#57360,"WEE KAROU, LOLI, SUMBA BARAT, NUSA TENGGARA TIMUR",1,164,16,180
https://kawalpemilu.org#57360,"WEE KAROU, LOLI, SUMBA BARAT, NUSA TENGGARA TIMUR",2,190,24,214
https://kawalpemilu.org#57360,"WEE KAROU, LOLI, SUMBA BARAT, NUSA TENGGARA TIMUR",3,173,13,186
https://kawalpemilu.org#57360,"WEE KAROU, LOLI, SUMBA BARAT, NUSA TENGGARA TIMUR",4,198,40,238
https://kawalpemilu.org#57360,"WEE KAROU, LOLI, SUMBA BARAT, NUSA TENGGARA TIMUR",5,139,12,151
https://kawalpemilu.org#57360,"WEE KAROU, LOLI, SUMBA BARAT, NUSA TENGGARA TIMUR",6,193,18,211
https://kawalpemilu.org#57360,"WEE KAROU, LOLI, SUMBA BARAT, NUSA TENGGARA TIMUR",7,127,19,146
https://kawalpemilu.org#57360,"WEE KAROU, LOLI, SUMBA BARAT, NUSA TENGGARA TIMUR",8,139,6,145
https://kawalpemilu.org#57360,"WEE KAROU, LOLI, SUMBA BARAT, NUSA TENGGARA TIMUR",9,132,14,146
https://kawalpemilu.org#57361,"SOBA WAWI, LOLI, SUMBA BARAT, NUSA TENGGARA TIMUR",1,183,14,197
https://kawalpemilu.org#57361,"SOBA WAWI, LOLI, SUMBA BARAT, NUSA TENGGARA TIMUR",2,143,8,151
https://kawalpemilu.org#57361,"SOBA WAWI, LOLI, SUMBA BARAT, NUSA TENGGARA TIMUR",3,205,17,222
https://kawalpemilu.org#57361,"SOBA WAWI, LOLI, SUMBA BARAT, NUSA TENGGARA TIMUR",4,159,15,174
https://kawalpemilu.org#57361,"SOBA WAWI, LOLI, SUMBA BARAT, NUSA TENGGARA TIMUR",5,195,26,221
https://kawalpemilu.org#57361,"SOBA WAWI, LOLI, SUMBA BARAT, NUSA TENGGARA TIMUR",6,228,16,244
https://kawalpemilu.org#57361,"SOBA WAWI, LOLI, SUMBA BARAT, NUSA TENGGARA TIMUR",7,148,13,161
https://kawalpemilu.org#57361,"SOBA WAWI, LOLI, SUMBA BARAT, NUSA TENGGARA TIMUR",8,143,10,153
https://kawalpemilu.org#57361,"SOBA WAWI, LOLI, SUMBA BARAT, NUSA TENGGARA TIMUR",9,108,7,115
https://kawalpemilu.org#57361,"SOBA WAWI, LOLI, SUMBA BARAT, NUSA TENGGARA TIMUR",10,159,12,171
https://kawalpemilu.org#57361,"SOBA WAWI, LOLI, SUMBA BARAT, NUSA TENGGARA TIMUR",11,126,12,138
https://kawalpemilu.org#57362,"BERA DOLU, LOLI, SUMBA BARAT, NUSA TENGGARA TIMUR",1,219,13,232
https://kawalpemilu.org#57362,"BERA DOLU, LOLI, SUMBA BARAT, NUSA TENGGARA TIMUR",2,131,14,145
https://kawalpemilu.org#57362,"BERA DOLU, LOLI, SUMBA BARAT, NUSA TENGGARA TIMUR",3,153,10,163
https://kawalpemilu.org#57362,"BERA DOLU, LOLI, SUMBA BARAT, NUSA TENGGARA TIMUR",4,146,3,149
https://kawalpemilu.org#57362,"BERA DOLU, LOLI, SUMBA BARAT, NUSA TENGGARA TIMUR",5,115,12,127
https://kawalpemilu.org#57362,"BERA DOLU, LOLI, SUMBA BARAT, NUSA TENGGARA TIMUR",6,158,9,167
https://kawalpemilu.org#57362,"BERA DOLU, LOLI, SUMBA BARAT, NUSA TENGGARA TIMUR",7,176,10,186
https://kawalpemilu.org#57363,"DOKA KAKA, LOLI, SUMBA BARAT, NUSA TENGGARA TIMUR",1,202,6,208
https://kawalpemilu.org#57363,"DOKA KAKA, LOLI, SUMBA BARAT, NUSA TENGGARA TIMUR",2,201,7,208
https://kawalpemilu.org#57363,"DOKA KAKA, LOLI, SUMBA BARAT, NUSA TENGGARA TIMUR",3,208,11,219
https://kawalpemilu.org#57363,"DOKA KAKA, LOLI, SUMBA BARAT, NUSA TENGGARA TIMUR",4,130,2,132
https://kawalpemilu.org#57363,"DOKA KAKA, LOLI, SUMBA BARAT, NUSA TENGGARA TIMUR",5,127,7,134
https://kawalpemilu.org#57363,"DOKA KAKA, LOLI, SUMBA BARAT, NUSA TENGGARA TIMUR",6,109,9,118
https://kawalpemilu.org#57364,"TANA RARA, LOLI, SUMBA BARAT, NUSA TENGGARA TIMUR",1,178,7,185
https://kawalpemilu.org#57364,"TANA RARA, LOLI, SUMBA BARAT, NUSA TENGGARA TIMUR",2,202,4,206
https://kawalpemilu.org#57364,"TANA RARA, LOLI, SUMBA BARAT, NUSA TENGGARA TIMUR",3,171,14,185
https://kawalpemilu.org#57365,"BALI LEDO, LOLI, SUMBA BARAT, NUSA TENGGARA TIMUR",1,159,7,166
https://kawalpemilu.org#57365,"BALI LEDO, LOLI, SUMBA BARAT, NUSA TENGGARA TIMUR",2,161,7,168
https://kawalpemilu.org#57365,"BALI LEDO, LOLI, SUMBA BARAT, NUSA TENGGARA TIMUR",3,118,6,124
https://kawalpemilu.org#57366,"DEDE KADU, LOLI, SUMBA BARAT, NUSA TENGGARA TIMUR",1,149,11,160
https://kawalpemilu.org#57366,"DEDE KADU, LOLI, SUMBA BARAT, NUSA TENGGARA TIMUR",2,173,18,191
https://kawalpemilu.org#57366,"DEDE KADU, LOLI, SUMBA BARAT, NUSA TENGGARA TIMUR",3,211,11,222
https://kawalpemilu.org#57366,"DEDE KADU, LOLI, SUMBA BARAT, NUSA TENGGARA TIMUR",4,155,24,179
https://kawalpemilu.org#57366,"DEDE KADU, LOLI, SUMBA BARAT, NUSA TENGGARA TIMUR",5,185,14,199
https://kawalpemilu.org#57366,"DEDE KADU, LOLI, SUMBA BARAT, NUSA TENGGARA TIMUR",6,203,15,218
https://kawalpemilu.org#57366,"DEDE KADU, LOLI, SUMBA BARAT, NUSA TENGGARA TIMUR",7,184,7,191
https://kawalpemilu.org#57366,"DEDE KADU, LOLI, SUMBA BARAT, NUSA TENGGARA TIMUR",8,122,8,130
https://kawalpemilu.org#57366,"DEDE KADU, LOLI, SUMBA BARAT, NUSA TENGGARA TIMUR",9,172,10,182
https://kawalpemilu.org#57367,"UBU PEDE, LOLI, SUMBA BARAT, NUSA TENGGARA TIMUR",1,197,20,217
https://kawalpemilu.org#57367,"UBU PEDE, LOLI, SUMBA BARAT, NUSA TENGGARA TIMUR",2,188,12,200
https://kawalpemilu.org#57367,"UBU PEDE, LOLI, SUMBA BARAT, NUSA TENGGARA TIMUR",3,171,26,197
https://kawalpemilu.org#57367,"UBU PEDE, LOLI, SUMBA BARAT, NUSA TENGGARA TIMUR",4,148,14,162
https://kawalpemilu.org#57367,"UBU PEDE, LOLI, SUMBA BARAT, NUSA TENGGARA TIMUR",5,175,8,183
https://kawalpemilu.org#57367,"UBU PEDE, LOLI, SUMBA BARAT, NUSA TENGGARA TIMUR",6,110,7,117
https://kawalpemilu.org#88650,"LODA PARE, LOLI, SUMBA BARAT, NUSA TENGGARA TIMUR",1,196,13,209
https://kawalpemilu.org#88650,"LODA PARE, LOLI, SUMBA BARAT, NUSA TENGGARA TIMUR",2,170,10,180
https://kawalpemilu.org#88650,"LODA PARE, LOLI, SUMBA BARAT, NUSA TENGGARA TIMUR",3,209,11,220
https://kawalpemilu.org#88650,"LODA PARE, LOLI, SUMBA BARAT, NUSA TENGGARA TIMUR",4,173,18,191
https://kawalpemilu.org#88651,"WEE DABO, LOLI, SUMBA BARAT, NUSA TENGGARA TIMUR",1,174,15,189
https://kawalpemilu.org#88651,"WEE DABO, LOLI, SUMBA BARAT, NUSA TENGGARA TIMUR",2,207,3,210
https://kawalpemilu.org#88651,"WEE DABO, LOLI, SUMBA BARAT, NUSA TENGGARA TIMUR",3,191,9,200
https://kawalpemilu.org#88651,"WEE DABO, LOLI, SUMBA BARAT, NUSA TENGGARA TIMUR",4,190,13,203
https://kawalpemilu.org#88651,"WEE DABO, LOLI, SUMBA BARAT, NUSA TENGGARA TIMUR",5,159,7,166
https://kawalpemilu.org#88652,"DIRA TANA, LOLI, SUMBA BARAT, NUSA TENGGARA TIMUR",1,100,34,134
https://kawalpemilu.org#88652,"DIRA TANA, LOLI, SUMBA BARAT, NUSA TENGGARA TIMUR",2,214,13,227
https://kawalpemilu.org#88652,"DIRA TANA, LOLI, SUMBA BARAT, NUSA TENGGARA TIMUR",3,155,15,170
https://kawalpemilu.org#88652,"DIRA TANA, LOLI, SUMBA BARAT, NUSA TENGGARA TIMUR",4,210,20,230
https://kawalpemilu.org#88652,"DIRA TANA, LOLI, SUMBA BARAT, NUSA TENGGARA TIMUR",5,185,38,223
https://kawalpemilu.org#88652,"DIRA TANA, LOLI, SUMBA BARAT, NUSA TENGGARA TIMUR",6,221,22,243
https://kawalpemilu.org#88652,"DIRA TANA, LOLI, SUMBA BARAT, NUSA TENGGARA TIMUR",7,157,7,164
https://kawalpemilu.org#88652,"DIRA TANA, LOLI, SUMBA BARAT, NUSA TENGGARA TIMUR",8,101,3,104
https://kawalpemilu.org#88652,"DIRA TANA, LOLI, SUMBA BARAT, NUSA TENGGARA TIMUR",9,197,22,219
https://kawalpemilu.org#88653,"TEMA TANA, LOLI, SUMBA BARAT, NUSA TENGGARA TIMUR",1,201,3,204
https://kawalpemilu.org#88653,"TEMA TANA, LOLI, SUMBA BARAT, NUSA TENGGARA TIMUR",2,177,15,192
https://kawalpemilu.org#88654,"UBU RAYA, LOLI, SUMBA BARAT, NUSA TENGGARA TIMUR",1,199,15,214
https://kawalpemilu.org#88654,"UBU RAYA, LOLI, SUMBA BARAT, NUSA TENGGARA TIMUR",2,190,6,196
https://kawalpemilu.org#88654,"UBU RAYA, LOLI, SUMBA BARAT, NUSA TENGGARA TIMUR",3,172,7,179
https://kawalpemilu.org#88654,"UBU RAYA, LOLI, SUMBA BARAT, NUSA TENGGARA TIMUR",4,136,4,140
https://kawalpemilu.org#88655,"MANOLA, LOLI, SUMBA BARAT, NUSA TENGGARA TIMUR",1,187,5,192
https://kawalpemilu.org#88655,"MANOLA, LOLI, SUMBA BARAT, NUSA TENGGARA TIMUR",2,154,4,158
https://kawalpemilu.org#57369,"KATIKU LOKU, WANOKAKA, SUMBA BARAT, NUSA TENGGARA TIMUR",1,216,1,217
https://kawalpemilu.org#57369,"KATIKU LOKU, WANOKAKA, SUMBA BARAT, NUSA TENGGARA TIMUR",2,126,4,130
https://kawalpemilu.org#57370,"HUPU MADA, WANOKAKA, SUMBA BARAT, NUSA TENGGARA TIMUR",2,210,13,223
https://kawalpemilu.org#57370,"HUPU MADA, WANOKAKA, SUMBA BARAT, NUSA TENGGARA TIMUR",3,186,13,199
https://kawalpemilu.org#57370,"HUPU MADA, WANOKAKA, SUMBA BARAT, NUSA TENGGARA TIMUR",4,147,6,153
https://kawalpemilu.org#57370,"HUPU MADA, WANOKAKA, SUMBA BARAT, NUSA TENGGARA TIMUR",5,104,12,116
https://kawalpemilu.org#57371,"PRAIBAKUL, WANOKAKA, SUMBA BARAT, NUSA TENGGARA TIMUR",1,194,10,204
https://kawalpemilu.org#57371,"PRAIBAKUL, WANOKAKA, SUMBA BARAT, NUSA TENGGARA TIMUR",2,197,9,206
https://kawalpemilu.org#57371,"PRAIBAKUL, WANOKAKA, SUMBA BARAT, NUSA TENGGARA TIMUR",3,117,7,124
https://kawalpemilu.org#57371,"PRAIBAKUL, WANOKAKA, SUMBA BARAT, NUSA TENGGARA TIMUR",4,178,8,186
https://kawalpemilu.org#57372,"HOBA WAWI, WANOKAKA, SUMBA BARAT, NUSA TENGGARA TIMUR",1,213,12,225
https://kawalpemilu.org#57372,"HOBA WAWI, WANOKAKA, SUMBA BARAT, NUSA TENGGARA TIMUR",2,207,5,212
https://kawalpemilu.org#57372,"HOBA WAWI, WANOKAKA, SUMBA BARAT, NUSA TENGGARA TIMUR",3,169,10,179
https://kawalpemilu.org#57373,"WAIHURA, WANOKAKA, SUMBA BARAT, NUSA TENGGARA TIMUR",1,204,7,211
https://kawalpemilu.org#57373,"WAIHURA, WANOKAKA, SUMBA BARAT, NUSA TENGGARA TIMUR",2,132,26,158
https://kawalpemilu.org#57373,"WAIHURA, WANOKAKA, SUMBA BARAT, NUSA TENGGARA TIMUR",3,147,10,157
https://kawalpemilu.org#57373,"WAIHURA, WANOKAKA, SUMBA BARAT, NUSA TENGGARA TIMUR",4,158,5,163
https://kawalpemilu.org#57373,"WAIHURA, WANOKAKA, SUMBA BARAT, NUSA TENGGARA TIMUR",5,207,4,211
https://kawalpemilu.org#57374,"PAHOLA, WANOKAKA, SUMBA BARAT, NUSA TENGGARA TIMUR",1,170,7,177
https://kawalpemilu.org#57374,"PAHOLA, WANOKAKA, SUMBA BARAT, NUSA TENGGARA TIMUR",2,170,10,180
https://kawalpemilu.org#57374,"PAHOLA, WANOKAKA, SUMBA BARAT, NUSA TENGGARA TIMUR",3,166,8,174
https://kawalpemilu.org#57374,"PAHOLA, WANOKAKA, SUMBA BARAT, NUSA TENGGARA TIMUR",4,131,18,149
https://kawalpemilu.org#57375,"BALI LOKU, WANOKAKA, SUMBA BARAT, NUSA TENGGARA TIMUR",2,211,9,220
https://kawalpemilu.org#57375,"BALI LOKU, WANOKAKA, SUMBA BARAT, NUSA TENGGARA TIMUR",3,129,5,134
https://kawalpemilu.org#57375,"BALI LOKU, WANOKAKA, SUMBA BARAT, NUSA TENGGARA TIMUR",4,129,8,137
https://kawalpemilu.org#57375,"BALI LOKU, WANOKAKA, SUMBA BARAT, NUSA TENGGARA TIMUR",5,164,9,173
https://kawalpemilu.org#57376,"TARA MANU, WANOKAKA, SUMBA BARAT, NUSA TENGGARA TIMUR",1,220,8,228
https://kawalpemilu.org#57376,"TARA MANU, WANOKAKA, SUMBA BARAT, NUSA TENGGARA TIMUR",2,148,21,169
https://kawalpemilu.org#57376,"TARA MANU, WANOKAKA, SUMBA BARAT, NUSA TENGGARA TIMUR",3,215,16,231
https://kawalpemilu.org#57377,"MAMODU, WANOKAKA, SUMBA BARAT, NUSA TENGGARA TIMUR",1,141,12,153
https://kawalpemilu.org#57377,"MAMODU, WANOKAKA, SUMBA BARAT, NUSA TENGGARA TIMUR",2,187,4,191
https://kawalpemilu.org#57377,"MAMODU, WANOKAKA, SUMBA BARAT, NUSA TENGGARA TIMUR",3,127,9,136
https://kawalpemilu.org#57378,"RUA, WANOKAKA, SUMBA BARAT, NUSA TENGGARA TIMUR",1,212,13,225
https://kawalpemilu.org#57378,"RUA, WANOKAKA, SUMBA BARAT, NUSA TENGGARA TIMUR",2,210,12,222
https://kawalpemilu.org#57378,"RUA, WANOKAKA, SUMBA BARAT, NUSA TENGGARA TIMUR",3,208,10,218
https://kawalpemilu.org#88659,"REWA RARA, WANOKAKA, SUMBA BARAT, NUSA TENGGARA TIMUR",1,181,8,189
https://kawalpemilu.org#88659,"REWA RARA, WANOKAKA, SUMBA BARAT, NUSA TENGGARA TIMUR",2,213,13,226
https://kawalpemilu.org#88660,"WEI MANGOMA, WANOKAKA, SUMBA BARAT, NUSA TENGGARA TIMUR",1,198,16,214
https://kawalpemilu.org#88660,"WEI MANGOMA, WANOKAKA, SUMBA BARAT, NUSA TENGGARA TIMUR",2,186,7,193
https://kawalpemilu.org#88660,"WEI MANGOMA, WANOKAKA, SUMBA BARAT, NUSA TENGGARA TIMUR",3,176,10,186
https://kawalpemilu.org#88661,"ANA WOLU, WANOKAKA, SUMBA BARAT, NUSA TENGGARA TIMUR",1,131,1,132
https://kawalpemilu.org#88661,"ANA WOLU, WANOKAKA, SUMBA BARAT, NUSA TENGGARA TIMUR",2,149,2,151
https://kawalpemilu.org#88662,"PARI RARA, WANOKAKA, SUMBA BARAT, NUSA TENGGARA TIMUR",1,220,4,224
https://kawalpemilu.org#88662,"PARI RARA, WANOKAKA, SUMBA BARAT, NUSA TENGGARA TIMUR",2,167,7,174
https://kawalpemilu.org#57380,"PATIALA BAWA, LAMBOYA, SUMBA BARAT, NUSA TENGGARA TIMUR",1,199,12,211
https://kawalpemilu.org#57380,"PATIALA BAWA, LAMBOYA, SUMBA BARAT, NUSA TENGGARA TIMUR",2,161,12,173
https://kawalpemilu.org#57380,"PATIALA BAWA, LAMBOYA, SUMBA BARAT, NUSA TENGGARA TIMUR",3,143,11,154
https://kawalpemilu.org#57380,"PATIALA BAWA, LAMBOYA, SUMBA BARAT, NUSA TENGGARA TIMUR",4,167,25,192
https://kawalpemilu.org#57380,"PATIALA BAWA, LAMBOYA, SUMBA BARAT, NUSA TENGGARA TIMUR",5,129,6,135
https://kawalpemilu.org#57381,"WELIBO, LAMBOYA, SUMBA BARAT, NUSA TENGGARA TIMUR",1,180,19,199
https://kawalpemilu.org#57381,"WELIBO, LAMBOYA, SUMBA BARAT, NUSA TENGGARA TIMUR",2,164,10,174
https://kawalpemilu.org#57381,"WELIBO, LAMBOYA, SUMBA BARAT, NUSA TENGGARA TIMUR",3,194,5,199
https://kawalpemilu.org#57381,"WELIBO, LAMBOYA, SUMBA BARAT, NUSA TENGGARA TIMUR",4,170,7,177
https://kawalpemilu.org#57381,"WELIBO, LAMBOYA, SUMBA BARAT, NUSA TENGGARA TIMUR",5,147,14,161
https://kawalpemilu.org#57381,"WELIBO, LAMBOYA, SUMBA BARAT, NUSA TENGGARA TIMUR",6,127,8,135
https://kawalpemilu.org#57382,"LABOYA BAWA, LAMBOYA, SUMBA BARAT, NUSA TENGGARA TIMUR",1,192,24,216
https://kawalpemilu.org#57382,"LABOYA BAWA, LAMBOYA, SUMBA BARAT, NUSA TENGGARA TIMUR",2,128,11,139
https://kawalpemilu.org#57382,"LABOYA BAWA, LAMBOYA, SUMBA BARAT, NUSA TENGGARA TIMUR",3,181,11,192
https://kawalpemilu.org#57382,"LABOYA BAWA, LAMBOYA, SUMBA BARAT, NUSA TENGGARA TIMUR",4,202,9,211
https://kawalpemilu.org#57382,"LABOYA BAWA, LAMBOYA, SUMBA BARAT, NUSA TENGGARA TIMUR",5,193,12,205
https://kawalpemilu.org#57383,"WATU KARERE, LAMBOYA, SUMBA BARAT, NUSA TENGGARA TIMUR",1,163,24,187
https://kawalpemilu.org#57383,"WATU KARERE, LAMBOYA, SUMBA BARAT, NUSA TENGGARA TIMUR",2,187,24,211
https://kawalpemilu.org#57383,"WATU KARERE, LAMBOYA, SUMBA BARAT, NUSA TENGGARA TIMUR",3,175,23,198
https://kawalpemilu.org#57383,"WATU KARERE, LAMBOYA, SUMBA BARAT, NUSA TENGGARA TIMUR",4,187,21,208
https://kawalpemilu.org#57383,"WATU KARERE, LAMBOYA, SUMBA BARAT, NUSA TENGGARA TIMUR",5,186,11,197
https://kawalpemilu.org#57384,"KABU KARUDI, LAMBOYA, SUMBA BARAT, NUSA TENGGARA TIMUR",1,187,13,200
https://kawalpemilu.org#57384,"KABU KARUDI, LAMBOYA, SUMBA BARAT, NUSA TENGGARA TIMUR",2,181,14,195
https://kawalpemilu.org#57384,"KABU KARUDI, LAMBOYA, SUMBA BARAT, NUSA TENGGARA TIMUR",3,185,6,191
https://kawalpemilu.org#57384,"KABU KARUDI, LAMBOYA, SUMBA BARAT, NUSA TENGGARA TIMUR",4,180,7,187
https://kawalpemilu.org#57384,"KABU KARUDI, LAMBOYA, SUMBA BARAT, NUSA TENGGARA TIMUR",5,183,25,208
https://kawalpemilu.org#57385,"RAJAKA, LAMBOYA, SUMBA BARAT, NUSA TENGGARA TIMUR",1,173,11,184
https://kawalpemilu.org#57385,"RAJAKA, LAMBOYA, SUMBA BARAT, NUSA TENGGARA TIMUR",2,162,8,170
https://kawalpemilu.org#57385,"RAJAKA, LAMBOYA, SUMBA BARAT, NUSA TENGGARA TIMUR",3,166,15,181
https://kawalpemilu.org#57385,"RAJAKA, LAMBOYA, SUMBA BARAT, NUSA TENGGARA TIMUR",4,132,26,158
https://kawalpemilu.org#57385,"RAJAKA, LAMBOYA, SUMBA BARAT, NUSA TENGGARA TIMUR",5,166,21,187
https://kawalpemilu.org#57385,"RAJAKA, LAMBOYA, SUMBA BARAT, NUSA TENGGARA TIMUR",6,144,2,146
https://kawalpemilu.org#57386,"SODANA, LAMBOYA, SUMBA BARAT, NUSA TENGGARA TIMUR",1,127,7,134
https://kawalpemilu.org#57386,"SODANA, LAMBOYA, SUMBA BARAT, NUSA TENGGARA TIMUR",2,107,2,109
https://kawalpemilu.org#57386,"SODANA, LAMBOYA, SUMBA BARAT, NUSA TENGGARA TIMUR",3,117,4,121
https://kawalpemilu.org#57386,"SODANA, LAMBOYA, SUMBA BARAT, NUSA TENGGARA TIMUR",4,126,3,129
https://kawalpemilu.org#57387,"LABOYA DETE, LAMBOYA, SUMBA BARAT, NUSA TENGGARA TIMUR",1,163,25,188
https://kawalpemilu.org#57387,"LABOYA DETE, LAMBOYA, SUMBA BARAT, NUSA TENGGARA TIMUR",2,170,18,188
https://kawalpemilu.org#57387,"LABOYA DETE, LAMBOYA, SUMBA BARAT, NUSA TENGGARA TIMUR",3,182,12,194
https://kawalpemilu.org#57387,"LABOYA DETE, LAMBOYA, SUMBA BARAT, NUSA TENGGARA TIMUR",4,133,30,163
https://kawalpemilu.org#57387,"LABOYA DETE, LAMBOYA, SUMBA BARAT, NUSA TENGGARA TIMUR",5,164,14,178
https://kawalpemilu.org#57388,"RINGU RARA, LAMBOYA, SUMBA BARAT, NUSA TENGGARA TIMUR",1,197,8,205
https://kawalpemilu.org#57388,"RINGU RARA, LAMBOYA, SUMBA BARAT, NUSA TENGGARA TIMUR",2,166,20,186
https://kawalpemilu.org#57388,"RINGU RARA, LAMBOYA, SUMBA BARAT, NUSA TENGGARA TIMUR",3,195,16,211
https://kawalpemilu.org#57388,"RINGU RARA, LAMBOYA, SUMBA BARAT, NUSA TENGGARA TIMUR",4,184,25,209
https://kawalpemilu.org#57388,"RINGU RARA, LAMBOYA, SUMBA BARAT, NUSA TENGGARA TIMUR",5,97,6,103
https://kawalpemilu.org#88656,"BODO HULA, LAMBOYA, SUMBA BARAT, NUSA TENGGARA TIMUR",1,151,14,165
https://kawalpemilu.org#88656,"BODO HULA, LAMBOYA, SUMBA BARAT, NUSA TENGGARA TIMUR",2,148,8,156
https://kawalpemilu.org#88656,"BODO HULA, LAMBOYA, SUMBA BARAT, NUSA TENGGARA TIMUR",3,122,8,130
https://kawalpemilu.org#88657,"PALA MOKO, LAMBOYA, SUMBA BARAT, NUSA TENGGARA TIMUR",1,198,3,201
https://kawalpemilu.org#88657,"PALA MOKO, LAMBOYA, SUMBA BARAT, NUSA TENGGARA TIMUR",2,106,11,117
https://kawalpemilu.org#57390,"WAILIANG, KOTA WAIKABUBAK, SUMBA BARAT, NUSA TENGGARA TIMUR",1,72,161,233
https://kawalpemilu.org#57390,"WAILIANG, KOTA WAIKABUBAK, SUMBA BARAT, NUSA TENGGARA TIMUR",2,124,74,198
https://kawalpemilu.org#57390,"WAILIANG, KOTA WAIKABUBAK, SUMBA BARAT, NUSA TENGGARA TIMUR",3,96,106,202
https://kawalpemilu.org#57390,"WAILIANG, KOTA WAIKABUBAK, SUMBA BARAT, NUSA TENGGARA TIMUR",4,131,63,194
https://kawalpemilu.org#57390,"WAILIANG, KOTA WAIKABUBAK, SUMBA BARAT, NUSA TENGGARA TIMUR",5,137,115,252
https://kawalpemilu.org#57390,"WAILIANG, KOTA WAIKABUBAK, SUMBA BARAT, NUSA TENGGARA TIMUR",6,108,133,241
https://kawalpemilu.org#57390,"WAILIANG, KOTA WAIKABUBAK, SUMBA BARAT, NUSA TENGGARA TIMUR",7,196,11,207
https://kawalpemilu.org#57390,"WAILIANG, KOTA WAIKABUBAK, SUMBA BARAT, NUSA TENGGARA TIMUR",8,87,139,226
https://kawalpemilu.org#57390,"WAILIANG, KOTA WAIKABUBAK, SUMBA BARAT, NUSA TENGGARA TIMUR",9,50,121,171
https://kawalpemilu.org#57391,"KOMERDA, KOTA WAIKABUBAK, SUMBA BARAT, NUSA TENGGARA TIMUR",1,126,51,177
https://kawalpemilu.org#57391,"KOMERDA, KOTA WAIKABUBAK, SUMBA BARAT, NUSA TENGGARA TIMUR",2,112,95,207
https://kawalpemilu.org#57391,"KOMERDA, KOTA WAIKABUBAK, SUMBA BARAT, NUSA TENGGARA TIMUR",3,199,10,209
https://kawalpemilu.org#57391,"KOMERDA, KOTA WAIKABUBAK, SUMBA BARAT, NUSA TENGGARA TIMUR",4,172,32,204
https://kawalpemilu.org#57391,"KOMERDA, KOTA WAIKABUBAK, SUMBA BARAT, NUSA TENGGARA TIMUR",5,204,8,212
https://kawalpemilu.org#57392,"KAMPUNG BARU, KOTA WAIKABUBAK, SUMBA BARAT, NUSA TENGGARA TIMUR",1,171,14,185
https://kawalpemilu.org#57392,"KAMPUNG BARU, KOTA WAIKABUBAK, SUMBA BARAT, NUSA TENGGARA TIMUR",2,195,9,204
https://kawalpemilu.org#57392,"KAMPUNG BARU, KOTA WAIKABUBAK, SUMBA BARAT, NUSA TENGGARA TIMUR",3,222,21,243
https://kawalpemilu.org#57392,"KAMPUNG BARU, KOTA WAIKABUBAK, SUMBA BARAT, NUSA TENGGARA TIMUR",4,210,10,220
https://kawalpemilu.org#57392,"KAMPUNG BARU, KOTA WAIKABUBAK, SUMBA BARAT, NUSA TENGGARA TIMUR",5,199,8,207
https://kawalpemilu.org#57393,"KAMPUNG SAWAH, KOTA WAIKABUBAK, SUMBA BARAT, NUSA TENGGARA TIMUR",1,173,26,199
https://kawalpemilu.org#57393,"KAMPUNG SAWAH, KOTA WAIKABUBAK, SUMBA BARAT, NUSA TENGGARA TIMUR",2,196,8,204
https://kawalpemilu.org#57393,"KAMPUNG SAWAH, KOTA WAIKABUBAK, SUMBA BARAT, NUSA TENGGARA TIMUR",3,194,17,211
https://kawalpemilu.org#57393,"KAMPUNG SAWAH, KOTA WAIKABUBAK, SUMBA BARAT, NUSA TENGGARA TIMUR",4,105,12,117
https://kawalpemilu.org#57393,"KAMPUNG SAWAH, KOTA WAIKABUBAK, SUMBA BARAT, NUSA TENGGARA TIMUR",5,134,16,150
https://kawalpemilu.org#57393,"KAMPUNG SAWAH, KOTA WAIKABUBAK, SUMBA BARAT, NUSA TENGGARA TIMUR",6,133,8,141
https://kawalpemilu.org#57394,"PADA EWETA, KOTA WAIKABUBAK, SUMBA BARAT, NUSA TENGGARA TIMUR",1,189,11,200
https://kawalpemilu.org#57394,"PADA EWETA, KOTA WAIKABUBAK, SUMBA BARAT, NUSA TENGGARA TIMUR",2,168,19,187
https://kawalpemilu.org#57394,"PADA EWETA, KOTA WAIKABUBAK, SUMBA BARAT, NUSA TENGGARA TIMUR",3,130,39,169
https://kawalpemilu.org#57394,"PADA EWETA, KOTA WAIKABUBAK, SUMBA BARAT, NUSA TENGGARA TIMUR",4,152,25,177
https://kawalpemilu.org#57394,"PADA EWETA, KOTA WAIKABUBAK, SUMBA BARAT, NUSA TENGGARA TIMUR",5,150,12,162
https://kawalpemilu.org#57394,"PADA EWETA, KOTA WAIKABUBAK, SUMBA BARAT, NUSA TENGGARA TIMUR",6,159,15,174
https://kawalpemilu.org#57395,"MALITI, KOTA WAIKABUBAK, SUMBA BARAT, NUSA TENGGARA TIMUR",1,111,72,183
https://kawalpemilu.org#57395,"MALITI, KOTA WAIKABUBAK, SUMBA BARAT, NUSA TENGGARA TIMUR",2,95,108,203
https://kawalpemilu.org#57395,"MALITI, KOTA WAIKABUBAK, SUMBA BARAT, NUSA TENGGARA TIMUR",3,154,41,195
https://kawalpemilu.org#57395,"MALITI, KOTA WAIKABUBAK, SUMBA BARAT, NUSA TENGGARA TIMUR",4,134,80,214
https://kawalpemilu.org#57395,"MALITI, KOTA WAIKABUBAK, SUMBA BARAT, NUSA TENGGARA TIMUR",5,129,48,177
https://kawalpemilu.org#57395,"MALITI, KOTA WAIKABUBAK, SUMBA BARAT, NUSA TENGGARA TIMUR",6,126,13,139
https://kawalpemilu.org#57396,"KODAKA, KOTA WAIKABUBAK, SUMBA BARAT, NUSA TENGGARA TIMUR",1,177,8,185
https://kawalpemilu.org#57396,"KODAKA, KOTA WAIKABUBAK, SUMBA BARAT, NUSA TENGGARA TIMUR",2,170,14,184
https://kawalpemilu.org#57396,"KODAKA, KOTA WAIKABUBAK, SUMBA BARAT, NUSA TENGGARA TIMUR",3,136,18,154
https://kawalpemilu.org#57396,"KODAKA, KOTA WAIKABUBAK, SUMBA BARAT, NUSA TENGGARA TIMUR",4,152,23,175
https://kawalpemilu.org#57396,"KODAKA, KOTA WAIKABUBAK, SUMBA BARAT, NUSA TENGGARA TIMUR",5,180,12,192
https://kawalpemilu.org#57397,"TEBARA, KOTA WAIKABUBAK, SUMBA BARAT, NUSA TENGGARA TIMUR",1,164,9,173
https://kawalpemilu.org#57397,"TEBARA, KOTA WAIKABUBAK, SUMBA BARAT, NUSA TENGGARA TIMUR",2,183,9,192
https://kawalpemilu.org#57397,"TEBARA, KOTA WAIKABUBAK, SUMBA BARAT, NUSA TENGGARA TIMUR",3,149,16,165
https://kawalpemilu.org#57397,"TEBARA, KOTA WAIKABUBAK, SUMBA BARAT, NUSA TENGGARA TIMUR",4,99,7,106
https://kawalpemilu.org#57397,"TEBARA, KOTA WAIKABUBAK, SUMBA BARAT, NUSA TENGGARA TIMUR",5,151,7,158
https://kawalpemilu.org#57397,"TEBARA, KOTA WAIKABUBAK, SUMBA BARAT, NUSA TENGGARA TIMUR",6,138,4,142
https://kawalpemilu.org#57397,"TEBARA, KOTA WAIKABUBAK, SUMBA BARAT, NUSA TENGGARA TIMUR",7,190,11,201
https://kawalpemilu.org#57397,"TEBARA, KOTA WAIKABUBAK, SUMBA BARAT, NUSA TENGGARA TIMUR",8,153,5,158
https://kawalpemilu.org#57398,"KALIMBU KUNI, KOTA WAIKABUBAK, SUMBA BARAT, NUSA TENGGARA TIMUR",1,194,11,205
https://kawalpemilu.org#57398,"KALIMBU KUNI, KOTA WAIKABUBAK, SUMBA BARAT, NUSA TENGGARA TIMUR",2,164,10,174
https://kawalpemilu.org#57398,"KALIMBU KUNI, KOTA WAIKABUBAK, SUMBA BARAT, NUSA TENGGARA TIMUR",3,173,11,184
https://kawalpemilu.org#57398,"KALIMBU KUNI, KOTA WAIKABUBAK, SUMBA BARAT, NUSA TENGGARA TIMUR",4,148,6,154
https://kawalpemilu.org#57398,"KALIMBU KUNI, KOTA WAIKABUBAK, SUMBA BARAT, NUSA TENGGARA TIMUR",5,171,17,188
https://kawalpemilu.org#57398,"KALIMBU KUNI, KOTA WAIKABUBAK, SUMBA BARAT, NUSA TENGGARA TIMUR",6,135,9,144
https://kawalpemilu.org#57399,"SOBARADE, KOTA WAIKABUBAK, SUMBA BARAT, NUSA TENGGARA TIMUR",1,185,3,188
https://kawalpemilu.org#57399,"SOBARADE, KOTA WAIKABUBAK, SUMBA BARAT, NUSA TENGGARA TIMUR",2,159,4,163
https://kawalpemilu.org#57399,"SOBARADE, KOTA WAIKABUBAK, SUMBA BARAT, NUSA TENGGARA TIMUR",3,191,11,202
https://kawalpemilu.org#57399,"SOBARADE, KOTA WAIKABUBAK, SUMBA BARAT, NUSA TENGGARA TIMUR",4,187,16,203
https://kawalpemilu.org#57399,"SOBARADE, KOTA WAIKABUBAK, SUMBA BARAT, NUSA TENGGARA TIMUR",5,109,6,115
https://kawalpemilu.org#57399,"SOBARADE, KOTA WAIKABUBAK, SUMBA BARAT, NUSA TENGGARA TIMUR",6,165,18,183
https://kawalpemilu.org#57400,"LAPALE, KOTA WAIKABUBAK, SUMBA BARAT, NUSA TENGGARA TIMUR",1,206,7,213
https://kawalpemilu.org#57400,"LAPALE, KOTA WAIKABUBAK, SUMBA BARAT, NUSA TENGGARA TIMUR",2,173,11,184
https://kawalpemilu.org#88638,"MODU WAIMARINGU, KOTA WAIKABUBAK, SUMBA BARAT, NUSA TENGGARA TIMUR",1,204,17,221
https://kawalpemilu.org#88638,"MODU WAIMARINGU, KOTA WAIKABUBAK, SUMBA BARAT, NUSA TENGGARA TIMUR",2,194,13,207
https://kawalpemilu.org#88638,"MODU WAIMARINGU, KOTA WAIKABUBAK, SUMBA BARAT, NUSA TENGGARA TIMUR",3,207,15,222
https://kawalpemilu.org#88638,"MODU WAIMARINGU, KOTA WAIKABUBAK, SUMBA BARAT, NUSA TENGGARA TIMUR",4,184,16,200
https://kawalpemilu.org#88638,"MODU WAIMARINGU, KOTA WAIKABUBAK, SUMBA BARAT, NUSA TENGGARA TIMUR",5,174,16,190
https://kawalpemilu.org#88638,"MODU WAIMARINGU, KOTA WAIKABUBAK, SUMBA BARAT, NUSA TENGGARA TIMUR",6,165,12,177
https://kawalpemilu.org#88639,"PUU MAWO, KOTA WAIKABUBAK, SUMBA BARAT, NUSA TENGGARA TIMUR",1,206,18,224
https://kawalpemilu.org#88639,"PUU MAWO, KOTA WAIKABUBAK, SUMBA BARAT, NUSA TENGGARA TIMUR",2,164,3,167
https://kawalpemilu.org#88639,"PUU MAWO, KOTA WAIKABUBAK, SUMBA BARAT, NUSA TENGGARA TIMUR",3,187,7,194
https://kawalpemilu.org#88639,"PUU MAWO, KOTA WAIKABUBAK, SUMBA BARAT, NUSA TENGGARA TIMUR",4,169,7,176
https://kawalpemilu.org#88639,"PUU MAWO, KOTA WAIKABUBAK, SUMBA BARAT, NUSA TENGGARA TIMUR",5,180,6,186
https://kawalpemilu.org#57402,"WEE TANA, LABOYA BARAT, SUMBA BARAT, NUSA TENGGARA TIMUR",1,123,10,133
https://kawalpemilu.org#57402,"WEE TANA, LABOYA BARAT, SUMBA BARAT, NUSA TENGGARA TIMUR",2,192,33,225
https://kawalpemilu.org#57402,"WEE TANA, LABOYA BARAT, SUMBA BARAT, NUSA TENGGARA TIMUR",3,181,16,197
https://kawalpemilu.org#57402,"WEE TANA, LABOYA BARAT, SUMBA BARAT, NUSA TENGGARA TIMUR",4,184,7,191
https://kawalpemilu.org#57402,"WEE TANA, LABOYA BARAT, SUMBA BARAT, NUSA TENGGARA TIMUR",5,212,11,223
https://kawalpemilu.org#57403,"GAURA, LABOYA BARAT, SUMBA BARAT, NUSA TENGGARA TIMUR",1,195,31,226
https://kawalpemilu.org#57403,"GAURA, LABOYA BARAT, SUMBA BARAT, NUSA TENGGARA TIMUR",2,183,20,203
https://kawalpemilu.org#57403,"GAURA, LABOYA BARAT, SUMBA BARAT, NUSA TENGGARA TIMUR",3,120,13,133
https://kawalpemilu.org#57403,"GAURA, LABOYA BARAT, SUMBA BARAT, NUSA TENGGARA TIMUR",4,147,17,164
https://kawalpemilu.org#57403,"GAURA, LABOYA BARAT, SUMBA BARAT, NUSA TENGGARA TIMUR",5,129,13,142
https://kawalpemilu.org#57403,"GAURA, LABOYA BARAT, SUMBA BARAT, NUSA TENGGARA TIMUR",6,152,19,171
https://kawalpemilu.org#57403,"GAURA, LABOYA BARAT, SUMBA BARAT, NUSA TENGGARA TIMUR",7,177,22,199
https://kawalpemilu.org#57404,"PATIALA DETE, LABOYA BARAT, SUMBA BARAT, NUSA TENGGARA TIMUR",1,157,10,167
https://kawalpemilu.org#57404,"PATIALA DETE, LABOYA BARAT, SUMBA BARAT, NUSA TENGGARA TIMUR",2,170,26,196
https://kawalpemilu.org#57404,"PATIALA DETE, LABOYA BARAT, SUMBA BARAT, NUSA TENGGARA TIMUR",3,198,17,215
https://kawalpemilu.org#57404,"PATIALA DETE, LABOYA BARAT, SUMBA BARAT, NUSA TENGGARA TIMUR",4,95,3,98
https://kawalpemilu.org#57404,"PATIALA DETE, LABOYA BARAT, SUMBA BARAT, NUSA TENGGARA TIMUR",5,158,13,171
https://kawalpemilu.org#57405,"HARONA KALLA, LABOYA BARAT, SUMBA BARAT, NUSA TENGGARA TIMUR",1,200,17,217
https://kawalpemilu.org#57405,"HARONA KALLA, LABOYA BARAT, SUMBA BARAT, NUSA TENGGARA TIMUR",2,231,15,246
https://kawalpemilu.org#57405,"HARONA KALLA, LABOYA BARAT, SUMBA BARAT, NUSA TENGGARA TIMUR",3,184,18,202
https://kawalpemilu.org#57405,"HARONA KALLA, LABOYA BARAT, SUMBA BARAT, NUSA TENGGARA TIMUR",4,179,21,200
https://kawalpemilu.org#57408,"PASIR PUTIH, NAGA WUTUNG, LEMBATA, NUSA TENGGARA TIMUR",1,170,14,184
https://kawalpemilu.org#57408,"PASIR PUTIH, NAGA WUTUNG, LEMBATA, NUSA TENGGARA TIMUR",2,198,4,202
https://kawalpemilu.org#57408,"PASIR PUTIH, NAGA WUTUNG, LEMBATA, NUSA TENGGARA TIMUR",3,228,5,233
https://kawalpemilu.org#57409,"DUAWUTUN, NAGA WUTUNG, LEMBATA, NUSA TENGGARA TIMUR",1,203,15,218
https://kawalpemilu.org#57409,"DUAWUTUN, NAGA WUTUNG, LEMBATA, NUSA TENGGARA TIMUR",2,212,3,215
https://kawalpemilu.org#57410,"ATAWAI, NAGA WUTUNG, LEMBATA, NUSA TENGGARA TIMUR",1,191,20,211
https://kawalpemilu.org#57410,"ATAWAI, NAGA WUTUNG, LEMBATA, NUSA TENGGARA TIMUR",2,183,10,193
https://kawalpemilu.org#57411,"LUSIDUAWUTUN, NAGA WUTUNG, LEMBATA, NUSA TENGGARA TIMUR",1,131,3,134
https://kawalpemilu.org#57411,"LUSIDUAWUTUN, NAGA WUTUNG, LEMBATA, NUSA TENGGARA TIMUR",2,58,1,59
https://kawalpemilu.org#57412,"LABALIMUT, NAGA WUTUNG, LEMBATA, NUSA TENGGARA TIMUR",1,196,7,203
https://kawalpemilu.org#57412,"LABALIMUT, NAGA WUTUNG, LEMBATA, NUSA TENGGARA TIMUR",2,209,3,212
https://kawalpemilu.org#57413,"ILE BOLI, NAGA WUTUNG, LEMBATA, NUSA TENGGARA TIMUR",1,135,1,136
https://kawalpemilu.org#57414,"BABOKERONG, NAGA WUTUNG, LEMBATA, NUSA TENGGARA TIMUR",1,109,63,172
https://kawalpemilu.org#57414,"BABOKERONG, NAGA WUTUNG, LEMBATA, NUSA TENGGARA TIMUR",2,129,55,184
https://kawalpemilu.org#57414,"BABOKERONG, NAGA WUTUNG, LEMBATA, NUSA TENGGARA TIMUR",3,117,61,178
https://kawalpemilu.org#57415,"PENIKENEK, NAGA WUTUNG, LEMBATA, NUSA TENGGARA TIMUR",1,172,2,174
https://kawalpemilu.org#57416,"BELOBAJA, NAGA WUTUNG, LEMBATA, NUSA TENGGARA TIMUR",1,203,6,209
https://kawalpemilu.org#57416,"BELOBAJA, NAGA WUTUNG, LEMBATA, NUSA TENGGARA TIMUR",2,209,7,216
https://kawalpemilu.org#57417,"LOLONG, NAGA WUTUNG, LEMBATA, NUSA TENGGARA TIMUR",1,167,1,168
https://kawalpemilu.org#57418,"WUAKERONG, NAGA WUTUNG, LEMBATA, NUSA TENGGARA TIMUR",1,167,11,178
https://kawalpemilu.org#57419,"BAOBOLAK, NAGA WUTUNG, LEMBATA, NUSA TENGGARA TIMUR",1,170,1,171
https://kawalpemilu.org#57420,"TEWAOWUTUNG, NAGA WUTUNG, LEMBATA, NUSA TENGGARA TIMUR",1,156,7,163
https://kawalpemilu.org#57421,"BOLI BEAN, NAGA WUTUNG, LEMBATA, NUSA TENGGARA TIMUR",1,190,2,192
https://kawalpemilu.org#92287,"WARAWATUNG, NAGA WUTUNG, LEMBATA, NUSA TENGGARA TIMUR",1,193,7,200
https://kawalpemilu.org#92289,"IDALOLONG, NAGA WUTUNG, LEMBATA, NUSA TENGGARA TIMUR",1,223,2,225
https://kawalpemilu.org#92289,"IDALOLONG, NAGA WUTUNG, LEMBATA, NUSA TENGGARA TIMUR",2,75,0,75
https://kawalpemilu.org#92290,"RIABAO, NAGA WUTUNG, LEMBATA, NUSA TENGGARA TIMUR",1,208,10,218
https://kawalpemilu.org#92290,"RIABAO, NAGA WUTUNG, LEMBATA, NUSA TENGGARA TIMUR",2,180,0,180
https://kawalpemilu.org#93292,"LIWULAGANG, NAGA WUTUNG, LEMBATA, NUSA TENGGARA TIMUR",1,121,2,123
https://kawalpemilu.org#57423,"ATAKORE, ATADEI, LEMBATA, NUSA TENGGARA TIMUR",1,198,2,200
https://kawalpemilu.org#57423,"ATAKORE, ATADEI, LEMBATA, NUSA TENGGARA TIMUR",2,164,10,174
https://kawalpemilu.org#57424,"LUSILAME, ATADEI, LEMBATA, NUSA TENGGARA TIMUR",1,125,4,129
https://kawalpemilu.org#57424,"LUSILAME, ATADEI, LEMBATA, NUSA TENGGARA TIMUR",2,112,3,115
https://kawalpemilu.org#57425,"LEREK, ATADEI, LEMBATA, NUSA TENGGARA TIMUR",1,194,1,195
https://kawalpemilu.org#57425,"LEREK, ATADEI, LEMBATA, NUSA TENGGARA TIMUR",2,208,4,212
https://kawalpemilu.org#57426,"NUBAHAERAKA, ATADEI, LEMBATA, NUSA TENGGARA TIMUR",1,138,3,141
https://kawalpemilu.org#57426,"NUBAHAERAKA, ATADEI, LEMBATA, NUSA TENGGARA TIMUR",2,48,2,50
https://kawalpemilu.org#57427,"TUBUK RAJAN, ATADEI, LEMBATA, NUSA TENGGARA TIMUR",1,149,1,150
https://kawalpemilu.org#57427,"TUBUK RAJAN, ATADEI, LEMBATA, NUSA TENGGARA TIMUR",2,150,4,154
https://kawalpemilu.org#57428,"LEBAATA, ATADEI, LEMBATA, NUSA TENGGARA TIMUR",1,111,0,111
https://kawalpemilu.org#57429,"ILE KIMOK, ATADEI, LEMBATA, NUSA TENGGARA TIMUR",2,215,35,250
https://kawalpemilu.org#57429,"ILE KIMOK, ATADEI, LEMBATA, NUSA TENGGARA TIMUR",3,145,24,169
https://kawalpemilu.org#57429,"ILE KIMOK, ATADEI, LEMBATA, NUSA TENGGARA TIMUR",4,158,21,179
https://kawalpemilu.org#57429,"ILE KIMOK, ATADEI, LEMBATA, NUSA TENGGARA TIMUR",5,55,11,66
https://kawalpemilu.org#57430,"KATAKEJA, ATADEI, LEMBATA, NUSA TENGGARA TIMUR",1,230,4,234
https://kawalpemilu.org#57430,"KATAKEJA, ATADEI, LEMBATA, NUSA TENGGARA TIMUR",2,267,5,272
https://kawalpemilu.org#57430,"KATAKEJA, ATADEI, LEMBATA, NUSA TENGGARA TIMUR",3,241,6,247
https://kawalpemilu.org#57431,"ILE KERBAU, ATADEI, LEMBATA, NUSA TENGGARA TIMUR",1,178,2,180
https://kawalpemilu.org#57432,"DULIR, ATADEI, LEMBATA, NUSA TENGGARA TIMUR",1,76,2,78
https://kawalpemilu.org#57432,"DULIR, ATADEI, LEMBATA, NUSA TENGGARA TIMUR",2,119,5,124
https://kawalpemilu.org#57433,"DORI PEWUT, ATADEI, LEMBATA, NUSA TENGGARA TIMUR",1,126,2,128
https://kawalpemilu.org#57433,"DORI PEWUT, ATADEI, LEMBATA, NUSA TENGGARA TIMUR",2,128,5,133
https://kawalpemilu.org#57434,"NUBA ATALOJO, ATADEI, LEMBATA, NUSA TENGGARA TIMUR",1,135,4,139
https://kawalpemilu.org#57434,"NUBA ATALOJO, ATADEI, LEMBATA, NUSA TENGGARA TIMUR",2,64,3,67
https://kawalpemilu.org#57435,"NOGO DONI, ATADEI, LEMBATA, NUSA TENGGARA TIMUR",1,95,1,96
https://kawalpemilu.org#57436,"NUBABOLI, ATADEI, LEMBATA, NUSA TENGGARA TIMUR",1,102,2,104
https://kawalpemilu.org#57437,"LEWOGROMA, ATADEI, LEMBATA, NUSA TENGGARA TIMUR",1,100,2,102
https://kawalpemilu.org#57439,"KOLIPADAN, ILE APE, LEMBATA, NUSA TENGGARA TIMUR",1,138,109,247
https://kawalpemilu.org#57439,"KOLIPADAN, ILE APE, LEMBATA, NUSA TENGGARA TIMUR",2,159,87,246
https://kawalpemilu.org#57440,"DULITUKAN, ILE APE, LEMBATA, NUSA TENGGARA TIMUR",1,168,17,185
https://kawalpemilu.org#57440,"DULITUKAN, ILE APE, LEMBATA, NUSA TENGGARA TIMUR",2,156,20,176
https://kawalpemilu.org#57440,"DULITUKAN, ILE APE, LEMBATA, NUSA TENGGARA TIMUR",3,144,30,174
https://kawalpemilu.org#57441,"TAGAWITI, ILE APE, LEMBATA, NUSA TENGGARA TIMUR",1,139,53,192
https://kawalpemilu.org#57441,"TAGAWITI, ILE APE, LEMBATA, NUSA TENGGARA TIMUR",2,146,31,177
https://kawalpemilu.org#57443,"AMAKAKA, ILE APE, LEMBATA, NUSA TENGGARA TIMUR",1,190,24,214
https://kawalpemilu.org#57443,"AMAKAKA, ILE APE, LEMBATA, NUSA TENGGARA TIMUR",2,185,15,200
https://kawalpemilu.org#57443,"AMAKAKA, ILE APE, LEMBATA, NUSA TENGGARA TIMUR",3,205,20,225
https://kawalpemilu.org#57444,"BUNGAMUDA, ILE APE, LEMBATA, NUSA TENGGARA TIMUR",1,128,12,140
https://kawalpemilu.org#57444,"BUNGAMUDA, ILE APE, LEMBATA, NUSA TENGGARA TIMUR",2,129,8,137
https://kawalpemilu.org#57445,"NAPASABOK, ILE APE, LEMBATA, NUSA TENGGARA TIMUR",1,127,6,133
https://kawalpemilu.org#57445,"NAPASABOK, ILE APE, LEMBATA, NUSA TENGGARA TIMUR",2,119,2,121
https://kawalpemilu.org#57446,"PETUNTAWA, ILE APE, LEMBATA, NUSA TENGGARA TIMUR",1,114,4,118
https://kawalpemilu.org#57446,"PETUNTAWA, ILE APE, LEMBATA, NUSA TENGGARA TIMUR",2,129,15,144
https://kawalpemilu.org#57447,"KOLONTOBO, ILE APE, LEMBATA, NUSA TENGGARA TIMUR",1,171,5,176
https://kawalpemilu.org#57447,"KOLONTOBO, ILE APE, LEMBATA, NUSA TENGGARA TIMUR",2,177,8,185
https://kawalpemilu.org#57447,"KOLONTOBO, ILE APE, LEMBATA, NUSA TENGGARA TIMUR",3,148,24,172
https://kawalpemilu.org#57447,"KOLONTOBO, ILE APE, LEMBATA, NUSA TENGGARA TIMUR",4,105,51,156
https://kawalpemilu.org#57448,"LARANWUTUN, ILE APE, LEMBATA, NUSA TENGGARA TIMUR",1,213,15,228
https://kawalpemilu.org#57448,"LARANWUTUN, ILE APE, LEMBATA, NUSA TENGGARA TIMUR",2,241,6,247
https://kawalpemilu.org#57448,"LARANWUTUN, ILE APE, LEMBATA, NUSA TENGGARA TIMUR",3,215,18,233
https://kawalpemilu.org#57449,"WATODIRI, ILE APE, LEMBATA, NUSA TENGGARA TIMUR",1,171,17,188
https://kawalpemilu.org#57449,"WATODIRI, ILE APE, LEMBATA, NUSA TENGGARA TIMUR",2,180,13,193
https://kawalpemilu.org#57450,"TANJUNG BATU, ILE APE, LEMBATA, NUSA TENGGARA TIMUR",1,132,13,145
https://kawalpemilu.org#57450,"TANJUNG BATU, ILE APE, LEMBATA, NUSA TENGGARA TIMUR",2,97,11,108
https://kawalpemilu.org#57451,"MURUONA, ILE APE, LEMBATA, NUSA TENGGARA TIMUR",1,193,2,195
https://kawalpemilu.org#57451,"MURUONA, ILE APE, LEMBATA, NUSA TENGGARA TIMUR",2,172,8,180
https://kawalpemilu.org#57452,"PALILOLON, ILE APE, LEMBATA, NUSA TENGGARA TIMUR",1,100,26,126
https://kawalpemilu.org#57453,"LAMAWARA, ILE APE, LEMBATA, NUSA TENGGARA TIMUR",1,237,3,240
https://kawalpemilu.org#92292,"RIANGBAO, ILE APE, LEMBATA, NUSA TENGGARA TIMUR",1,207,40,247
https://kawalpemilu.org#57456,"HADAKEWA, LEBATUKAN, LEMBATA, NUSA TENGGARA TIMUR",1,197,8,205
https://kawalpemilu.org#57456,"HADAKEWA, LEBATUKAN, LEMBATA, NUSA TENGGARA TIMUR",2,134,54,188
https://kawalpemilu.org#57456,"HADAKEWA, LEBATUKAN, LEMBATA, NUSA TENGGARA TIMUR",3,156,4,160
https://kawalpemilu.org#57457,"LAMATUKA, LEBATUKAN, LEMBATA, NUSA TENGGARA TIMUR",1,154,3,157
https://kawalpemilu.org#57457,"LAMATUKA, LEBATUKAN, LEMBATA, NUSA TENGGARA TIMUR",2,146,4,150
https://kawalpemilu.org#57458,"SERANGGORANG, LEBATUKAN, LEMBATA, NUSA TENGGARA TIMUR",1,75,2,77
https://kawalpemilu.org#57458,"SERANGGORANG, LEBATUKAN, LEMBATA, NUSA TENGGARA TIMUR",2,132,2,134
https://kawalpemilu.org#57459,"LODOTODOKOWA, LEBATUKAN, LEMBATA, NUSA TENGGARA TIMUR",1,176,2,178
https://kawalpemilu.org#57459,"LODOTODOKOWA, LEBATUKAN, LEMBATA, NUSA TENGGARA TIMUR",2,166,3,169
https://kawalpemilu.org#57460,"BAOPANA, LEBATUKAN, LEMBATA, NUSA TENGGARA TIMUR",1,222,4,226
https://kawalpemilu.org#57460,"BAOPANA, LEBATUKAN, LEMBATA, NUSA TENGGARA TIMUR",2,213,4,217
https://kawalpemilu.org#57461,"WAIENGA, LEBATUKAN, LEMBATA, NUSA TENGGARA TIMUR",1,232,5,237
https://kawalpemilu.org#57461,"WAIENGA, LEBATUKAN, LEMBATA, NUSA TENGGARA TIMUR",2,233,6,239
https://kawalpemilu.org#57462,"LEWOELENG, LEBATUKAN, LEMBATA, NUSA TENGGARA TIMUR",1,206,5,211
https://kawalpemilu.org#57462,"LEWOELENG, LEBATUKAN, LEMBATA, NUSA TENGGARA TIMUR",2,151,6,157
https://kawalpemilu.org#57463,"DIKESARE, LEBATUKAN, LEMBATA, NUSA TENGGARA TIMUR",1,190,51,241
https://kawalpemilu.org#57464,"MERDEKA, LEBATUKAN, LEMBATA, NUSA TENGGARA TIMUR",1,223,8,231
https://kawalpemilu.org#57464,"MERDEKA, LEBATUKAN, LEMBATA, NUSA TENGGARA TIMUR",2,204,2,206
https://kawalpemilu.org#57465,"LERAHINGA, LEBATUKAN, LEMBATA, NUSA TENGGARA TIMUR",1,142,1,143
https://kawalpemilu.org#57465,"LERAHINGA, LEBATUKAN, LEMBATA, NUSA TENGGARA TIMUR",2,146,6,152
https://kawalpemilu.org#57466,"TAPOBARANG, LEBATUKAN, LEMBATA, NUSA TENGGARA TIMUR",1,247,6,253
https://kawalpemilu.org#57467,"BALUREBONG, LEBATUKAN, LEMBATA, NUSA TENGGARA TIMUR",1,150,2,152
https://kawalpemilu.org#57467,"BALUREBONG, LEBATUKAN, LEMBATA, NUSA TENGGARA TIMUR",2,67,0,67
https://kawalpemilu.org#57468,"LAMADALE, LEBATUKAN, LEMBATA, NUSA TENGGARA TIMUR",1,197,3,200
https://kawalpemilu.org#57469,"TAPOLANGU, LEBATUKAN, LEMBATA, NUSA TENGGARA TIMUR",1,140,31,171
https://kawalpemilu.org#57469,"TAPOLANGU, LEBATUKAN, LEMBATA, NUSA TENGGARA TIMUR",2,133,8,141
https://kawalpemilu.org#57470,"LAMALELA, LEBATUKAN, LEMBATA, NUSA TENGGARA TIMUR",1,147,5,152
https://kawalpemilu.org#57470,"LAMALELA, LEBATUKAN, LEMBATA, NUSA TENGGARA TIMUR",2,55,1,56
https://kawalpemilu.org#57471,"ATAKOWA, LEBATUKAN, LEMBATA, NUSA TENGGARA TIMUR",1,155,2,157
https://kawalpemilu.org#57472,"BANITOBO, LEBATUKAN, LEMBATA, NUSA TENGGARA TIMUR",1,108,0,108
https://kawalpemilu.org#57472,"BANITOBO, LEBATUKAN, LEMBATA, NUSA TENGGARA TIMUR",2,121,1,122
https://kawalpemilu.org#57474,"LEWOLEBA, NUBATUKAN, LEMBATA, NUSA TENGGARA TIMUR",1,178,22,200
https://kawalpemilu.org#57474,"LEWOLEBA, NUBATUKAN, LEMBATA, NUSA TENGGARA TIMUR",2,233,14,247
https://kawalpemilu.org#57474,"LEWOLEBA, NUBATUKAN, LEMBATA, NUSA TENGGARA TIMUR",3,143,3,146
https://kawalpemilu.org#57474,"LEWOLEBA, NUBATUKAN, LEMBATA, NUSA TENGGARA TIMUR",4,156,2,158
https://kawalpemilu.org#57474,"LEWOLEBA, NUBATUKAN, LEMBATA, NUSA TENGGARA TIMUR",5,226,12,238
https://kawalpemilu.org#57474,"LEWOLEBA, NUBATUKAN, LEMBATA, NUSA TENGGARA TIMUR",6,222,15,237
https://kawalpemilu.org#57474,"LEWOLEBA, NUBATUKAN, LEMBATA, NUSA TENGGARA TIMUR",7,196,3,199
https://kawalpemilu.org#57474,"LEWOLEBA, NUBATUKAN, LEMBATA, NUSA TENGGARA TIMUR",8,231,20,251
https://kawalpemilu.org#57474,"LEWOLEBA, NUBATUKAN, LEMBATA, NUSA TENGGARA TIMUR",9,189,16,205
https://kawalpemilu.org#57474,"LEWOLEBA, NUBATUKAN, LEMBATA, NUSA TENGGARA TIMUR",10,200,11,211
https://kawalpemilu.org#57474,"LEWOLEBA, NUBATUKAN, LEMBATA, NUSA TENGGARA TIMUR",11,177,2,179
https://kawalpemilu.org#57474,"LEWOLEBA, NUBATUKAN, LEMBATA, NUSA TENGGARA TIMUR",12,103,2,105
https://kawalpemilu.org#57475,"LEWOLEBA TIMUR, NUBATUKAN, LEMBATA, NUSA TENGGARA TIMUR",1,170,48,218
https://kawalpemilu.org#57475,"LEWOLEBA TIMUR, NUBATUKAN, LEMBATA, NUSA TENGGARA TIMUR",2,202,29,231
https://kawalpemilu.org#57475,"LEWOLEBA TIMUR, NUBATUKAN, LEMBATA, NUSA TENGGARA TIMUR",3,173,31,204
https://kawalpemilu.org#57475,"LEWOLEBA TIMUR, NUBATUKAN, LEMBATA, NUSA TENGGARA TIMUR",4,203,14,217
https://kawalpemilu.org#57475,"LEWOLEBA TIMUR, NUBATUKAN, LEMBATA, NUSA TENGGARA TIMUR",5,216,9,225
https://kawalpemilu.org#57475,"LEWOLEBA TIMUR, NUBATUKAN, LEMBATA, NUSA TENGGARA TIMUR",6,219,5,224
https://kawalpemilu.org#57475,"LEWOLEBA TIMUR, NUBATUKAN, LEMBATA, NUSA TENGGARA TIMUR",7,194,17,211
https://kawalpemilu.org#57475,"LEWOLEBA TIMUR, NUBATUKAN, LEMBATA, NUSA TENGGARA TIMUR",8,196,16,212
https://kawalpemilu.org#57475,"LEWOLEBA TIMUR, NUBATUKAN, LEMBATA, NUSA TENGGARA TIMUR",9,216,19,235
https://kawalpemilu.org#57475,"LEWOLEBA TIMUR, NUBATUKAN, LEMBATA, NUSA TENGGARA TIMUR",10,221,13,234
https://kawalpemilu.org#57476,"LEWOLEBA TENGAH, NUBATUKAN, LEMBATA, NUSA TENGGARA TIMUR",1,135,98,233
https://kawalpemilu.org#57476,"LEWOLEBA TENGAH, NUBATUKAN, LEMBATA, NUSA TENGGARA TIMUR",2,99,75,174
https://kawalpemilu.org#57476,"LEWOLEBA TENGAH, NUBATUKAN, LEMBATA, NUSA TENGGARA TIMUR",3,85,85,170
https://kawalpemilu.org#57476,"LEWOLEBA TENGAH, NUBATUKAN, LEMBATA, NUSA TENGGARA TIMUR",4,114,123,237
https://kawalpemilu.org#57476,"LEWOLEBA TENGAH, NUBATUKAN, LEMBATA, NUSA TENGGARA TIMUR",5,152,30,182
https://kawalpemilu.org#57476,"LEWOLEBA TENGAH, NUBATUKAN, LEMBATA, NUSA TENGGARA TIMUR",6,178,13,191
https://kawalpemilu.org#57476,"LEWOLEBA TENGAH, NUBATUKAN, LEMBATA, NUSA TENGGARA TIMUR",7,167,4,171
https://kawalpemilu.org#57476,"LEWOLEBA TENGAH, NUBATUKAN, LEMBATA, NUSA TENGGARA TIMUR",8,178,8,186
https://kawalpemilu.org#57476,"LEWOLEBA TENGAH, NUBATUKAN, LEMBATA, NUSA TENGGARA TIMUR",9,236,7,243
https://kawalpemilu.org#57476,"LEWOLEBA TENGAH, NUBATUKAN, LEMBATA, NUSA TENGGARA TIMUR",10,218,12,230
https://kawalpemilu.org#57477,"LEWOLEBA UTARA, NUBATUKAN, LEMBATA, NUSA TENGGARA TIMUR",1,62,144,206
https://kawalpemilu.org#57477,"LEWOLEBA UTARA, NUBATUKAN, LEMBATA, NUSA TENGGARA TIMUR",2,165,61,226
https://kawalpemilu.org#57477,"LEWOLEBA UTARA, NUBATUKAN, LEMBATA, NUSA TENGGARA TIMUR",3,107,120,227
https://kawalpemilu.org#57477,"LEWOLEBA UTARA, NUBATUKAN, LEMBATA, NUSA TENGGARA TIMUR",4,129,101,230
https://kawalpemilu.org#57477,"LEWOLEBA UTARA, NUBATUKAN, LEMBATA, NUSA TENGGARA TIMUR",5,189,22,211
https://kawalpemilu.org#57477,"LEWOLEBA UTARA, NUBATUKAN, LEMBATA, NUSA TENGGARA TIMUR",6,162,9,171
https://kawalpemilu.org#57477,"LEWOLEBA UTARA, NUBATUKAN, LEMBATA, NUSA TENGGARA TIMUR",7,142,10,152
https://kawalpemilu.org#57477,"LEWOLEBA UTARA, NUBATUKAN, LEMBATA, NUSA TENGGARA TIMUR",8,93,65,158
https://kawalpemilu.org#57477,"LEWOLEBA UTARA, NUBATUKAN, LEMBATA, NUSA TENGGARA TIMUR",9,103,63,166
https://kawalpemilu.org#57477,"LEWOLEBA UTARA, NUBATUKAN, LEMBATA, NUSA TENGGARA TIMUR",10,165,21,186
https://kawalpemilu.org#57477,"LEWOLEBA UTARA, NUBATUKAN, LEMBATA, NUSA TENGGARA TIMUR",11,58,65,123
https://kawalpemilu.org#57478,"LEWOLEBA BARAT, NUBATUKAN, LEMBATA, NUSA TENGGARA TIMUR",1,108,8,116
https://kawalpemilu.org#57478,"LEWOLEBA BARAT, NUBATUKAN, LEMBATA, NUSA TENGGARA TIMUR",2,159,14,173
https://kawalpemilu.org#57478,"LEWOLEBA BARAT, NUBATUKAN, LEMBATA, NUSA TENGGARA TIMUR",3,165,4,169
https://kawalpemilu.org#57478,"LEWOLEBA BARAT, NUBATUKAN, LEMBATA, NUSA TENGGARA TIMUR",4,162,9,171
https://kawalpemilu.org#57478,"LEWOLEBA BARAT, NUBATUKAN, LEMBATA, NUSA TENGGARA TIMUR",5,141,12,153
https://kawalpemilu.org#57478,"LEWOLEBA BARAT, NUBATUKAN, LEMBATA, NUSA TENGGARA TIMUR",6,185,18,203
https://kawalpemilu.org#57478,"LEWOLEBA BARAT, NUBATUKAN, LEMBATA, NUSA TENGGARA TIMUR",7,211,7,218
https://kawalpemilu.org#57478,"LEWOLEBA BARAT, NUBATUKAN, LEMBATA, NUSA TENGGARA TIMUR",8,191,5,196
https://kawalpemilu.org#57478,"LEWOLEBA BARAT, NUBATUKAN, LEMBATA, NUSA TENGGARA TIMUR",9,199,5,204
https://kawalpemilu.org#57478,"LEWOLEBA BARAT, NUBATUKAN, LEMBATA, NUSA TENGGARA TIMUR",10,202,6,208
https://kawalpemilu.org#57478,"LEWOLEBA BARAT, NUBATUKAN, LEMBATA, NUSA TENGGARA TIMUR",11,232,5,237
https://kawalpemilu.org#57479,"SELANDORO, NUBATUKAN, LEMBATA, NUSA TENGGARA TIMUR",1,148,46,194
https://kawalpemilu.org#57479,"SELANDORO, NUBATUKAN, LEMBATA, NUSA TENGGARA TIMUR",3,136,23,159
https://kawalpemilu.org#57479,"SELANDORO, NUBATUKAN, LEMBATA, NUSA TENGGARA TIMUR",4,218,9,227
https://kawalpemilu.org#57479,"SELANDORO, NUBATUKAN, LEMBATA, NUSA TENGGARA TIMUR",5,195,18,213
https://kawalpemilu.org#57479,"SELANDORO, NUBATUKAN, LEMBATA, NUSA TENGGARA TIMUR",6,210,17,227
https://kawalpemilu.org#57479,"SELANDORO, NUBATUKAN, LEMBATA, NUSA TENGGARA TIMUR",7,204,19,223
https://kawalpemilu.org#57479,"SELANDORO, NUBATUKAN, LEMBATA, NUSA TENGGARA TIMUR",8,232,18,250
https://kawalpemilu.org#57479,"SELANDORO, NUBATUKAN, LEMBATA, NUSA TENGGARA TIMUR",9,211,32,243
https://kawalpemilu.org#57479,"SELANDORO, NUBATUKAN, LEMBATA, NUSA TENGGARA TIMUR",10,86,99,185
https://kawalpemilu.org#57479,"SELANDORO, NUBATUKAN, LEMBATA, NUSA TENGGARA TIMUR",11,49,69,118
https://kawalpemilu.org#57479,"SELANDORO, NUBATUKAN, LEMBATA, NUSA TENGGARA TIMUR",12,62,90,152
https://kawalpemilu.org#57479,"SELANDORO, NUBATUKAN, LEMBATA, NUSA TENGGARA TIMUR",13,87,91,178
https://kawalpemilu.org#57479,"SELANDORO, NUBATUKAN, LEMBATA, NUSA TENGGARA TIMUR",14,144,56,200
https://kawalpemilu.org#57479,"SELANDORO, NUBATUKAN, LEMBATA, NUSA TENGGARA TIMUR",15,103,41,144
https://kawalpemilu.org#57479,"SELANDORO, NUBATUKAN, LEMBATA, NUSA TENGGARA TIMUR",16,117,120,237
https://kawalpemilu.org#57479,"SELANDORO, NUBATUKAN, LEMBATA, NUSA TENGGARA TIMUR",17,107,77,184
https://kawalpemilu.org#57480,"LEWOLEBA SELATAN, NUBATUKAN, LEMBATA, NUSA TENGGARA TIMUR",1,173,25,198
https://kawalpemilu.org#57480,"LEWOLEBA SELATAN, NUBATUKAN, LEMBATA, NUSA TENGGARA TIMUR",2,172,14,186
https://kawalpemilu.org#57480,"LEWOLEBA SELATAN, NUBATUKAN, LEMBATA, NUSA TENGGARA TIMUR",3,183,12,195
https://kawalpemilu.org#57480,"LEWOLEBA SELATAN, NUBATUKAN, LEMBATA, NUSA TENGGARA TIMUR",4,128,7,135
https://kawalpemilu.org#57480,"LEWOLEBA SELATAN, NUBATUKAN, LEMBATA, NUSA TENGGARA TIMUR",5,197,13,210
https://kawalpemilu.org#57480,"LEWOLEBA SELATAN, NUBATUKAN, LEMBATA, NUSA TENGGARA TIMUR",6,223,9,232
https://kawalpemilu.org#57480,"LEWOLEBA SELATAN, NUBATUKAN, LEMBATA, NUSA TENGGARA TIMUR",7,217,7,224
https://kawalpemilu.org#57480,"LEWOLEBA SELATAN, NUBATUKAN, LEMBATA, NUSA TENGGARA TIMUR",8,190,4,194
https://kawalpemilu.org#57481,"BAOLANGU, NUBATUKAN, LEMBATA, NUSA TENGGARA TIMUR",1,212,5,217
https://kawalpemilu.org#57481,"BAOLANGU, NUBATUKAN, LEMBATA, NUSA TENGGARA TIMUR",2,174,3,177
https://kawalpemilu.org#57482,"NUBA MADO, NUBATUKAN, LEMBATA, NUSA TENGGARA TIMUR",1,213,15,228
https://kawalpemilu.org#57483,"WATOKOBU, NUBATUKAN, LEMBATA, NUSA TENGGARA TIMUR",1,100,58,158
https://kawalpemilu.org#57483,"WATOKOBU, NUBATUKAN, LEMBATA, NUSA TENGGARA TIMUR",2,104,54,158
https://kawalpemilu.org#57483,"WATOKOBU, NUBATUKAN, LEMBATA, NUSA TENGGARA TIMUR",3,86,5,91
https://kawalpemilu.org#57483,"WATOKOBU, NUBATUKAN, LEMBATA, NUSA TENGGARA TIMUR",4,51,8,59
https://kawalpemilu.org#57484,"BELOBATANG, NUBATUKAN, LEMBATA, NUSA TENGGARA TIMUR",1,175,12,187
https://kawalpemilu.org#57485,"WAIJARANG, NUBATUKAN, LEMBATA, NUSA TENGGARA TIMUR",1,173,24,197
https://kawalpemilu.org#57485,"WAIJARANG, NUBATUKAN, LEMBATA, NUSA TENGGARA TIMUR",2,132,28,160
https://kawalpemilu.org#57486,"UDAK MELOMATA, NUBATUKAN, LEMBATA, NUSA TENGGARA TIMUR",1,149,1,150
https://kawalpemilu.org#57487,"PAUBOKOL, NUBATUKAN, LEMBATA, NUSA TENGGARA TIMUR",1,159,11,170
https://kawalpemilu.org#57488,"PADA, NUBATUKAN, LEMBATA, NUSA TENGGARA TIMUR",1,192,37,229
https://kawalpemilu.org#57488,"PADA, NUBATUKAN, LEMBATA, NUSA TENGGARA TIMUR",2,152,23,175
https://kawalpemilu.org#57488,"PADA, NUBATUKAN, LEMBATA, NUSA TENGGARA TIMUR",3,175,32,207
https://kawalpemilu.org#57489,"LITE ULUMADO, NUBATUKAN, LEMBATA, NUSA TENGGARA TIMUR",1,142,1,143
https://kawalpemilu.org#57490,"BAKALEREK, NUBATUKAN, LEMBATA, NUSA TENGGARA TIMUR",1,197,9,206
https://kawalpemilu.org#92293,"BOUR, NUBATUKAN, LEMBATA, NUSA TENGGARA TIMUR",1,183,13,196
https://kawalpemilu.org#57492,"BALAURING, OMESURI, LEMBATA, NUSA TENGGARA TIMUR",1,122,107,229
https://kawalpemilu.org#57492,"BALAURING, OMESURI, LEMBATA, NUSA TENGGARA TIMUR",2,120,132,252
https://kawalpemilu.org#57492,"BALAURING, OMESURI, LEMBATA, NUSA TENGGARA TIMUR",3,83,134,217
https://kawalpemilu.org#57492,"BALAURING, OMESURI, LEMBATA, NUSA TENGGARA TIMUR",4,102,29,131
https://kawalpemilu.org#57492,"BALAURING, OMESURI, LEMBATA, NUSA TENGGARA TIMUR",5,97,41,138
https://kawalpemilu.org#57493,"NILANAPO, OMESURI, LEMBATA, NUSA TENGGARA TIMUR",1,179,70,249
https://kawalpemilu.org#57493,"NILANAPO, OMESURI, LEMBATA, NUSA TENGGARA TIMUR",2,113,3,116
https://kawalpemilu.org#57494,"LEUBATANG, OMESURI, LEMBATA, NUSA TENGGARA TIMUR",1,40,120,160
https://kawalpemilu.org#57494,"LEUBATANG, OMESURI, LEMBATA, NUSA TENGGARA TIMUR",2,50,115,165
https://kawalpemilu.org#57494,"LEUBATANG, OMESURI, LEMBATA, NUSA TENGGARA TIMUR",3,60,104,164
https://kawalpemilu.org#57495,"WALANGSAWAH, OMESURI, LEMBATA, NUSA TENGGARA TIMUR",1,40,76,116
https://kawalpemilu.org#57495,"WALANGSAWAH, OMESURI, LEMBATA, NUSA TENGGARA TIMUR",2,139,52,191
https://kawalpemilu.org#57495,"WALANGSAWAH, OMESURI, LEMBATA, NUSA TENGGARA TIMUR",3,71,94,165
https://kawalpemilu.org#57496,"MAHAL, OMESURI, LEMBATA, NUSA TENGGARA TIMUR",1,107,61,168
https://kawalpemilu.org#57496,"MAHAL, OMESURI, LEMBATA, NUSA TENGGARA TIMUR",2,108,19,127
https://kawalpemilu.org#57496,"MAHAL, OMESURI, LEMBATA, NUSA TENGGARA TIMUR",3,125,11,136
https://kawalpemilu.org#57497,"ARAMENGI, OMESURI, LEMBATA, NUSA TENGGARA TIMUR",1,175,11,186
https://kawalpemilu.org#57497,"ARAMENGI, OMESURI, LEMBATA, NUSA TENGGARA TIMUR",2,141,31,172
https://kawalpemilu.org#57498,"MELUWITING, OMESURI, LEMBATA, NUSA TENGGARA TIMUR",2,175,39,214
https://kawalpemilu.org#57499,"HINGALAMAMENGI, OMESURI, LEMBATA, NUSA TENGGARA TIMUR",1,121,42,163
https://kawalpemilu.org#57499,"HINGALAMAMENGI, OMESURI, LEMBATA, NUSA TENGGARA TIMUR",2,45,109,154
https://kawalpemilu.org#57499,"HINGALAMAMENGI, OMESURI, LEMBATA, NUSA TENGGARA TIMUR",3,52,118,170
https://kawalpemilu.org#57499,"HINGALAMAMENGI, OMESURI, LEMBATA, NUSA TENGGARA TIMUR",4,28,186,214
https://kawalpemilu.org#57500,"DOLULOLONG, OMESURI, LEMBATA, NUSA TENGGARA TIMUR",1,64,163,227
https://kawalpemilu.org#57500,"DOLULOLONG, OMESURI, LEMBATA, NUSA TENGGARA TIMUR",2,39,98,137
https://kawalpemilu.org#57501,"HOELEA, OMESURI, LEMBATA, NUSA TENGGARA TIMUR",1,133,24,157
https://kawalpemilu.org#57501,"HOELEA, OMESURI, LEMBATA, NUSA TENGGARA TIMUR",2,92,89,181
https://kawalpemilu.org#57501,"HOELEA, OMESURI, LEMBATA, NUSA TENGGARA TIMUR",3,103,72,175
https://kawalpemilu.org#57502,"ROMA, OMESURI, LEMBATA, NUSA TENGGARA TIMUR",1,77,83,160
https://kawalpemilu.org#57502,"ROMA, OMESURI, LEMBATA, NUSA TENGGARA TIMUR",2,103,69,172
https://kawalpemilu.org#57503,"LEUWAYANG, OMESURI, LEMBATA, NUSA TENGGARA TIMUR",1,177,19,196
https://kawalpemilu.org#57503,"LEUWAYANG, OMESURI, LEMBATA, NUSA TENGGARA TIMUR",2,174,29,203
https://kawalpemilu.org#57503,"LEUWAYANG, OMESURI, LEMBATA, NUSA TENGGARA TIMUR",3,189,19,208
https://kawalpemilu.org#57504,"LEUDANUNG, OMESURI, LEMBATA, NUSA TENGGARA TIMUR",1,118,40,158
https://kawalpemilu.org#57504,"LEUDANUNG, OMESURI, LEMBATA, NUSA TENGGARA TIMUR",2,133,18,151
https://kawalpemilu.org#57505,"NORMAL, OMESURI, LEMBATA, NUSA TENGGARA TIMUR",1,45,75,120
https://kawalpemilu.org#57505,"NORMAL, OMESURI, LEMBATA, NUSA TENGGARA TIMUR",2,37,111,148
https://kawalpemilu.org#57506,"WAILOLONG, OMESURI, LEMBATA, NUSA TENGGARA TIMUR",1,130,109,239
https://kawalpemilu.org#57506,"WAILOLONG, OMESURI, LEMBATA, NUSA TENGGARA TIMUR",2,66,67,133
https://kawalpemilu.org#57507,"HOELEA II, OMESURI, LEMBATA, NUSA TENGGARA TIMUR",1,121,44,165
https://kawalpemilu.org#57507,"HOELEA II, OMESURI, LEMBATA, NUSA TENGGARA TIMUR",2,79,73,152
https://kawalpemilu.org#57508,"LEBEWALA, OMESURI, LEMBATA, NUSA TENGGARA TIMUR",1,138,43,181
https://kawalpemilu.org#57508,"LEBEWALA, OMESURI, LEMBATA, NUSA TENGGARA TIMUR",2,76,118,194
https://kawalpemilu.org#57509,"MAHAL II, OMESURI, LEMBATA, NUSA TENGGARA TIMUR",1,174,15,189
https://kawalpemilu.org#57509,"MAHAL II, OMESURI, LEMBATA, NUSA TENGGARA TIMUR",2,112,7,119
https://kawalpemilu.org#57510,"PEUSAWA, OMESURI, LEMBATA, NUSA TENGGARA TIMUR",1,159,17,176
https://kawalpemilu.org#57510,"PEUSAWA, OMESURI, LEMBATA, NUSA TENGGARA TIMUR",2,120,46,166
https://kawalpemilu.org#57511,"WOWONG, OMESURI, LEMBATA, NUSA TENGGARA TIMUR",1,91,89,180
https://kawalpemilu.org#57512,"NORMAL I, OMESURI, LEMBATA, NUSA TENGGARA TIMUR",1,103,74,177
https://kawalpemilu.org#92294,"MELUWITING I, OMESURI, LEMBATA, NUSA TENGGARA TIMUR",1,137,61,198
https://kawalpemilu.org#92294,"MELUWITING I, OMESURI, LEMBATA, NUSA TENGGARA TIMUR",2,116,48,164
https://kawalpemilu.org#57514,"PANAMA, BUYASURI, LEMBATA, NUSA TENGGARA TIMUR",1,192,40,232
https://kawalpemilu.org#57514,"PANAMA, BUYASURI, LEMBATA, NUSA TENGGARA TIMUR",2,205,16,221
https://kawalpemilu.org#57514,"PANAMA, BUYASURI, LEMBATA, NUSA TENGGARA TIMUR",3,174,8,182
https://kawalpemilu.org#57514,"PANAMA, BUYASURI, LEMBATA, NUSA TENGGARA TIMUR",4,170,10,180
https://kawalpemilu.org#57515,"BENIHADING, BUYASURI, LEMBATA, NUSA TENGGARA TIMUR",1,143,56,199
https://kawalpemilu.org#57515,"BENIHADING, BUYASURI, LEMBATA, NUSA TENGGARA TIMUR",2,148,16,164
https://kawalpemilu.org#57516,"ATULALENG, BUYASURI, LEMBATA, NUSA TENGGARA TIMUR",1,126,41,167
https://kawalpemilu.org#57516,"ATULALENG, BUYASURI, LEMBATA, NUSA TENGGARA TIMUR",2,69,95,164
https://kawalpemilu.org#57517,"ROHO, BUYASURI, LEMBATA, NUSA TENGGARA TIMUR",1,187,28,215
https://kawalpemilu.org#57517,"ROHO, BUYASURI, LEMBATA, NUSA TENGGARA TIMUR",2,98,86,184
https://kawalpemilu.org#57517,"ROHO, BUYASURI, LEMBATA, NUSA TENGGARA TIMUR",3,95,32,127
https://kawalpemilu.org#57518,"LOYOBOHOR, BUYASURI, LEMBATA, NUSA TENGGARA TIMUR",1,164,12,176
https://kawalpemilu.org#57518,"LOYOBOHOR, BUYASURI, LEMBATA, NUSA TENGGARA TIMUR",2,121,7,128
https://kawalpemilu.org#57518,"LOYOBOHOR, BUYASURI, LEMBATA, NUSA TENGGARA TIMUR",3,120,83,203
https://kawalpemilu.org#57519,"LEUBURI, BUYASURI, LEMBATA, NUSA TENGGARA TIMUR",1,169,24,193
https://kawalpemilu.org#57519,"LEUBURI, BUYASURI, LEMBATA, NUSA TENGGARA TIMUR",2,118,36,154
https://kawalpemilu.org#57519,"LEUBURI, BUYASURI, LEMBATA, NUSA TENGGARA TIMUR",3,138,64,202
https://kawalpemilu.org#57520,"KAOHUA, BUYASURI, LEMBATA, NUSA TENGGARA TIMUR",1,93,68,161
https://kawalpemilu.org#57520,"KAOHUA, BUYASURI, LEMBATA, NUSA TENGGARA TIMUR",2,47,114,161
https://kawalpemilu.org#57520,"KAOHUA, BUYASURI, LEMBATA, NUSA TENGGARA TIMUR",3,70,105,175
https://kawalpemilu.org#57521,"KALIKUR WL, BUYASURI, LEMBATA, NUSA TENGGARA TIMUR",1,86,90,176
https://kawalpemilu.org#57521,"KALIKUR WL, BUYASURI, LEMBATA, NUSA TENGGARA TIMUR",2,79,88,167
https://kawalpemilu.org#57521,"KALIKUR WL, BUYASURI, LEMBATA, NUSA TENGGARA TIMUR",3,64,93,157
https://kawalpemilu.org#57522,"UMALEU, BUYASURI, LEMBATA, NUSA TENGGARA TIMUR",1,141,24,165
https://kawalpemilu.org#57522,"UMALEU, BUYASURI, LEMBATA, NUSA TENGGARA TIMUR",2,109,45,154
https://kawalpemilu.org#57522,"UMALEU, BUYASURI, LEMBATA, NUSA TENGGARA TIMUR",3,108,86,194
https://kawalpemilu.org#57522,"UMALEU, BUYASURI, LEMBATA, NUSA TENGGARA TIMUR",4,158,36,194
https://kawalpemilu.org#57522,"UMALEU, BUYASURI, LEMBATA, NUSA TENGGARA TIMUR",5,67,126,193
https://kawalpemilu.org#57522,"UMALEU, BUYASURI, LEMBATA, NUSA TENGGARA TIMUR",6,27,61,88
https://kawalpemilu.org#57523,"BURIWUTUN, BUYASURI, LEMBATA, NUSA TENGGARA TIMUR",1,98,81,179
https://kawalpemilu.org#57523,"BURIWUTUN, BUYASURI, LEMBATA, NUSA TENGGARA TIMUR",2,172,14,186
https://kawalpemilu.org#57523,"BURIWUTUN, BUYASURI, LEMBATA, NUSA TENGGARA TIMUR",3,177,11,188
https://kawalpemilu.org#57523,"BURIWUTUN, BUYASURI, LEMBATA, NUSA TENGGARA TIMUR",4,160,5,165
https://kawalpemilu.org#57524,"MAMPIR, BUYASURI, LEMBATA, NUSA TENGGARA TIMUR",1,121,28,149
https://kawalpemilu.org#57524,"MAMPIR, BUYASURI, LEMBATA, NUSA TENGGARA TIMUR",2,184,15,199
https://kawalpemilu.org#57524,"MAMPIR, BUYASURI, LEMBATA, NUSA TENGGARA TIMUR",3,148,27,175
https://kawalpemilu.org#57524,"MAMPIR, BUYASURI, LEMBATA, NUSA TENGGARA TIMUR",4,122,43,165
https://kawalpemilu.org#57525,"LEUWOHUNG, BUYASURI, LEMBATA, NUSA TENGGARA TIMUR",1,40,98,138
https://kawalpemilu.org#57525,"LEUWOHUNG, BUYASURI, LEMBATA, NUSA TENGGARA TIMUR",2,36,171,207
https://kawalpemilu.org#57526,"BARENG, BUYASURI, LEMBATA, NUSA TENGGARA TIMUR",1,8,232,240
https://kawalpemilu.org#57526,"BARENG, BUYASURI, LEMBATA, NUSA TENGGARA TIMUR",2,9,179,188
https://kawalpemilu.org#57527,"KALIKUR, BUYASURI, LEMBATA, NUSA TENGGARA TIMUR",1,28,168,196
https://kawalpemilu.org#57527,"KALIKUR, BUYASURI, LEMBATA, NUSA TENGGARA TIMUR",2,27,147,174
https://kawalpemilu.org#57527,"KALIKUR, BUYASURI, LEMBATA, NUSA TENGGARA TIMUR",3,12,174,186
https://kawalpemilu.org#57527,"KALIKUR, BUYASURI, LEMBATA, NUSA TENGGARA TIMUR",4,22,139,161
https://kawalpemilu.org#57528,"BEANG, BUYASURI, LEMBATA, NUSA TENGGARA TIMUR",1,83,29,112
https://kawalpemilu.org#57528,"BEANG, BUYASURI, LEMBATA, NUSA TENGGARA TIMUR",2,34,103,137
https://kawalpemilu.org#57529,"BENIHADING II, BUYASURI, LEMBATA, NUSA TENGGARA TIMUR",1,157,73,230
https://kawalpemilu.org#57529,"BENIHADING II, BUYASURI, LEMBATA, NUSA TENGGARA TIMUR",2,147,51,198
https://kawalpemilu.org#57529,"BENIHADING II, BUYASURI, LEMBATA, NUSA TENGGARA TIMUR",3,151,43,194
https://kawalpemilu.org#57530,"TOBOTANI, BUYASURI, LEMBATA, NUSA TENGGARA TIMUR",1,19,194,213
https://kawalpemilu.org#57530,"TOBOTANI, BUYASURI, LEMBATA, NUSA TENGGARA TIMUR",2,25,42,67
https://kawalpemilu.org#57531,"TUBUNG WALANG, BUYASURI, LEMBATA, NUSA TENGGARA TIMUR",1,208,11,219
https://kawalpemilu.org#57532,"RUMANG, BUYASURI, LEMBATA, NUSA TENGGARA TIMUR",1,64,88,152
https://kawalpemilu.org#57532,"RUMANG, BUYASURI, LEMBATA, NUSA TENGGARA TIMUR",2,43,96,139
https://kawalpemilu.org#57533,"ATU WALUPANG, BUYASURI, LEMBATA, NUSA TENGGARA TIMUR",1,47,104,151
https://kawalpemilu.org#57533,"ATU WALUPANG, BUYASURI, LEMBATA, NUSA TENGGARA TIMUR",2,23,92,115
https://kawalpemilu.org#57535,"ALAP ATADEI, WULANDONI, LEMBATA, NUSA TENGGARA TIMUR",1,67,17,84
https://kawalpemilu.org#57535,"ALAP ATADEI, WULANDONI, LEMBATA, NUSA TENGGARA TIMUR",2,131,4,135
https://kawalpemilu.org#57536,"ATAKERA, WULANDONI, LEMBATA, NUSA TENGGARA TIMUR",1,158,22,180
https://kawalpemilu.org#57536,"ATAKERA, WULANDONI, LEMBATA, NUSA TENGGARA TIMUR",2,193,2,195
https://kawalpemilu.org#57537,"LEWORAJAN, WULANDONI, LEMBATA, NUSA TENGGARA TIMUR",1,66,163,229
https://kawalpemilu.org#57537,"LEWORAJAN, WULANDONI, LEMBATA, NUSA TENGGARA TIMUR",2,34,152,186
https://kawalpemilu.org#57538,"PANTAI HARAPAN, WULANDONI, LEMBATA, NUSA TENGGARA TIMUR",1,47,160,207
https://kawalpemilu.org#57538,"PANTAI HARAPAN, WULANDONI, LEMBATA, NUSA TENGGARA TIMUR",2,21,171,192
https://kawalpemilu.org#57539,"PUOR, WULANDONI, LEMBATA, NUSA TENGGARA TIMUR",1,241,8,249
https://kawalpemilu.org#57540,"IMULOLONG, WULANDONI, LEMBATA, NUSA TENGGARA TIMUR",1,255,8,263
https://kawalpemilu.org#57541,"LAMALERA B, WULANDONI, LEMBATA, NUSA TENGGARA TIMUR",1,160,6,166
https://kawalpemilu.org#57541,"LAMALERA B, WULANDONI, LEMBATA, NUSA TENGGARA TIMUR",2,170,1,171
https://kawalpemilu.org#57541,"LAMALERA B, WULANDONI, LEMBATA, NUSA TENGGARA TIMUR",3,120,11,131
https://kawalpemilu.org#57542,"LAMALERA A, WULANDONI, LEMBATA, NUSA TENGGARA TIMUR",1,213,10,223
https://kawalpemilu.org#57542,"LAMALERA A, WULANDONI, LEMBATA, NUSA TENGGARA TIMUR",2,131,6,137
https://kawalpemilu.org#57543,"LELATA, WULANDONI, LEMBATA, NUSA TENGGARA TIMUR",1,211,5,216
https://kawalpemilu.org#57544,"WULANDONI, WULANDONI, LEMBATA, NUSA TENGGARA TIMUR",1,218,2,220
https://kawalpemilu.org#57544,"WULANDONI, WULANDONI, LEMBATA, NUSA TENGGARA TIMUR",2,121,7,128
https://kawalpemilu.org#57545,"BELOBAO, WULANDONI, LEMBATA, NUSA TENGGARA TIMUR",1,222,8,230
https://kawalpemilu.org#57545,"BELOBAO, WULANDONI, LEMBATA, NUSA TENGGARA TIMUR",2,102,2,104
https://kawalpemilu.org#57546,"POSIWATU, WULANDONI, LEMBATA, NUSA TENGGARA TIMUR",1,190,7,197
https://kawalpemilu.org#57547,"PUOR B, WULANDONI, LEMBATA, NUSA TENGGARA TIMUR",1,130,13,143
https://kawalpemilu.org#57547,"PUOR B, WULANDONI, LEMBATA, NUSA TENGGARA TIMUR",2,139,23,162
https://kawalpemilu.org#57548,"ATAILI, WULANDONI, LEMBATA, NUSA TENGGARA TIMUR",1,175,1,176
https://kawalpemilu.org#57549,"TAPOBALI, WULANDONI, LEMBATA, NUSA TENGGARA TIMUR",1,130,1,131
https://kawalpemilu.org#57549,"TAPOBALI, WULANDONI, LEMBATA, NUSA TENGGARA TIMUR",2,51,1,52
https://kawalpemilu.org#57551,"TODANARA, ILE APE TIMUR, LEMBATA, NUSA TENGGARA TIMUR",1,163,10,173
https://kawalpemilu.org#57551,"TODANARA, ILE APE TIMUR, LEMBATA, NUSA TENGGARA TIMUR",2,144,6,150
https://kawalpemilu.org#57552,"JONTONA, ILE APE TIMUR, LEMBATA, NUSA TENGGARA TIMUR",1,151,11,162
https://kawalpemilu.org#57552,"JONTONA, ILE APE TIMUR, LEMBATA, NUSA TENGGARA TIMUR",2,150,13,163
https://kawalpemilu.org#57552,"JONTONA, ILE APE TIMUR, LEMBATA, NUSA TENGGARA TIMUR",3,150,4,154
https://kawalpemilu.org#57552,"JONTONA, ILE APE TIMUR, LEMBATA, NUSA TENGGARA TIMUR",4,138,13,151
https://kawalpemilu.org#57553,"LAMAWOLO, ILE APE TIMUR, LEMBATA, NUSA TENGGARA TIMUR",1,247,3,250
https://kawalpemilu.org#57554,"LAMATOKAN, ILE APE TIMUR, LEMBATA, NUSA TENGGARA TIMUR",1,138,11,149
https://kawalpemilu.org#57554,"LAMATOKAN, ILE APE TIMUR, LEMBATA, NUSA TENGGARA TIMUR",2,128,2,130
https://kawalpemilu.org#57554,"LAMATOKAN, ILE APE TIMUR, LEMBATA, NUSA TENGGARA TIMUR",3,195,16,211
https://kawalpemilu.org#57554,"LAMATOKAN, ILE APE TIMUR, LEMBATA, NUSA TENGGARA TIMUR",4,151,7,158
https://kawalpemilu.org#57555,"BAO LALI DULI, ILE APE TIMUR, LEMBATA, NUSA TENGGARA TIMUR",1,119,2,121
https://kawalpemilu.org#57556,"LAMAAU, ILE APE TIMUR, LEMBATA, NUSA TENGGARA TIMUR",1,117,38,155
https://kawalpemilu.org#57557,"AULESA, ILE APE TIMUR, LEMBATA, NUSA TENGGARA TIMUR",1,200,1,201
https://kawalpemilu.org#57557,"AULESA, ILE APE TIMUR, LEMBATA, NUSA TENGGARA TIMUR",2,143,4,147
https://kawalpemilu.org#57558,"WAIMATAN, ILE APE TIMUR, LEMBATA, NUSA TENGGARA TIMUR",1,116,8,124
https://kawalpemilu.org#57558,"WAIMATAN, ILE APE TIMUR, LEMBATA, NUSA TENGGARA TIMUR",2,117,9,126
https://kawalpemilu.org#57559,"LAMAGUTE, ILE APE TIMUR, LEMBATA, NUSA TENGGARA TIMUR",1,209,6,215
https://kawalpemilu.org#57562,"OESELI, ROTE BARAT DAYA, ROTE NDAO, NUSA TENGGARA TIMUR",1,163,6,169
https://kawalpemilu.org#57562,"OESELI, ROTE BARAT DAYA, ROTE NDAO, NUSA TENGGARA TIMUR",2,175,5,180
https://kawalpemilu.org#57562,"OESELI, ROTE BARAT DAYA, ROTE NDAO, NUSA TENGGARA TIMUR",3,169,6,175
https://kawalpemilu.org#57562,"OESELI, ROTE BARAT DAYA, ROTE NDAO, NUSA TENGGARA TIMUR",4,173,2,175
https://kawalpemilu.org#57562,"OESELI, ROTE BARAT DAYA, ROTE NDAO, NUSA TENGGARA TIMUR",5,105,49,154
https://kawalpemilu.org#57563,"OEBOU, ROTE BARAT DAYA, ROTE NDAO, NUSA TENGGARA TIMUR",1,168,15,183
https://kawalpemilu.org#57563,"OEBOU, ROTE BARAT DAYA, ROTE NDAO, NUSA TENGGARA TIMUR",2,192,16,208
https://kawalpemilu.org#57563,"OEBOU, ROTE BARAT DAYA, ROTE NDAO, NUSA TENGGARA TIMUR",3,85,3,88
https://kawalpemilu.org#57563,"OEBOU, ROTE BARAT DAYA, ROTE NDAO, NUSA TENGGARA TIMUR",4,136,3,139
https://kawalpemilu.org#57564,"LALUKOEN, ROTE BARAT DAYA, ROTE NDAO, NUSA TENGGARA TIMUR",1,202,1,203
https://kawalpemilu.org#57564,"LALUKOEN, ROTE BARAT DAYA, ROTE NDAO, NUSA TENGGARA TIMUR",2,210,0,210
https://kawalpemilu.org#57564,"LALUKOEN, ROTE BARAT DAYA, ROTE NDAO, NUSA TENGGARA TIMUR",3,193,1,194
https://kawalpemilu.org#57564,"LALUKOEN, ROTE BARAT DAYA, ROTE NDAO, NUSA TENGGARA TIMUR",4,175,1,176
https://kawalpemilu.org#57565,"OEHANDI, ROTE BARAT DAYA, ROTE NDAO, NUSA TENGGARA TIMUR",1,171,7,178
https://kawalpemilu.org#57565,"OEHANDI, ROTE BARAT DAYA, ROTE NDAO, NUSA TENGGARA TIMUR",2,164,3,167
https://kawalpemilu.org#57565,"OEHANDI, ROTE BARAT DAYA, ROTE NDAO, NUSA TENGGARA TIMUR",3,191,10,201
https://kawalpemilu.org#57565,"OEHANDI, ROTE BARAT DAYA, ROTE NDAO, NUSA TENGGARA TIMUR",4,191,3,194
https://kawalpemilu.org#57566,"OETEFU, ROTE BARAT DAYA, ROTE NDAO, NUSA TENGGARA TIMUR",1,207,7,214
https://kawalpemilu.org#57566,"OETEFU, ROTE BARAT DAYA, ROTE NDAO, NUSA TENGGARA TIMUR",2,201,6,207
https://kawalpemilu.org#57566,"OETEFU, ROTE BARAT DAYA, ROTE NDAO, NUSA TENGGARA TIMUR",3,104,1,105
https://kawalpemilu.org#57566,"OETEFU, ROTE BARAT DAYA, ROTE NDAO, NUSA TENGGARA TIMUR",4,221,9,230
https://kawalpemilu.org#57567,"BATUTUA, ROTE BARAT DAYA, ROTE NDAO, NUSA TENGGARA TIMUR",1,140,65,205
https://kawalpemilu.org#57567,"BATUTUA, ROTE BARAT DAYA, ROTE NDAO, NUSA TENGGARA TIMUR",2,164,11,175
https://kawalpemilu.org#57567,"BATUTUA, ROTE BARAT DAYA, ROTE NDAO, NUSA TENGGARA TIMUR",3,133,7,140
https://kawalpemilu.org#57568,"MEOAIN, ROTE BARAT DAYA, ROTE NDAO, NUSA TENGGARA TIMUR",1,171,9,180
https://kawalpemilu.org#57568,"MEOAIN, ROTE BARAT DAYA, ROTE NDAO, NUSA TENGGARA TIMUR",2,172,3,175
https://kawalpemilu.org#57568,"MEOAIN, ROTE BARAT DAYA, ROTE NDAO, NUSA TENGGARA TIMUR",3,109,5,114
https://kawalpemilu.org#57569,"OEBAFOK, ROTE BARAT DAYA, ROTE NDAO, NUSA TENGGARA TIMUR",2,196,4,200
https://kawalpemilu.org#57569,"OEBAFOK, ROTE BARAT DAYA, ROTE NDAO, NUSA TENGGARA TIMUR",3,214,2,216
https://kawalpemilu.org#57569,"OEBAFOK, ROTE BARAT DAYA, ROTE NDAO, NUSA TENGGARA TIMUR",4,163,3,166
https://kawalpemilu.org#57569,"OEBAFOK, ROTE BARAT DAYA, ROTE NDAO, NUSA TENGGARA TIMUR",5,57,2,59
https://kawalpemilu.org#57570,"OEBATU, ROTE BARAT DAYA, ROTE NDAO, NUSA TENGGARA TIMUR",1,233,7,240
https://kawalpemilu.org#57570,"OEBATU, ROTE BARAT DAYA, ROTE NDAO, NUSA TENGGARA TIMUR",2,230,4,234
https://kawalpemilu.org#57570,"OEBATU, ROTE BARAT DAYA, ROTE NDAO, NUSA TENGGARA TIMUR",3,199,4,203
https://kawalpemilu.org#57571,"MBOKAK, ROTE BARAT DAYA, ROTE NDAO, NUSA TENGGARA TIMUR",1,208,3,211
https://kawalpemilu.org#57571,"MBOKAK, ROTE BARAT DAYA, ROTE NDAO, NUSA TENGGARA TIMUR",2,143,0,143
https://kawalpemilu.org#57571,"MBOKAK, ROTE BARAT DAYA, ROTE NDAO, NUSA TENGGARA TIMUR",3,192,5,201
https://kawalpemilu.org#57572,"LEKIK, ROTE BARAT DAYA, ROTE NDAO, NUSA TENGGARA TIMUR",1,148,3,151
https://kawalpemilu.org#57572,"LEKIK, ROTE BARAT DAYA, ROTE NDAO, NUSA TENGGARA TIMUR",2,86,5,94
https://kawalpemilu.org#57572,"LEKIK, ROTE BARAT DAYA, ROTE NDAO, NUSA TENGGARA TIMUR",3,107,1,108
https://kawalpemilu.org#57573,"DOLASI, ROTE BARAT DAYA, ROTE NDAO, NUSA TENGGARA TIMUR",1,195,7,202
https://kawalpemilu.org#57573,"DOLASI, ROTE BARAT DAYA, ROTE NDAO, NUSA TENGGARA TIMUR",2,169,2,171
https://kawalpemilu.org#57573,"DOLASI, ROTE BARAT DAYA, ROTE NDAO, NUSA TENGGARA TIMUR",3,152,3,155
https://kawalpemilu.org#57574,"OELASIN, ROTE BARAT DAYA, ROTE NDAO, NUSA TENGGARA TIMUR",1,155,7,162
https://kawalpemilu.org#57574,"OELASIN, ROTE BARAT DAYA, ROTE NDAO, NUSA TENGGARA TIMUR",2,169,20,189
https://kawalpemilu.org#57574,"OELASIN, ROTE BARAT DAYA, ROTE NDAO, NUSA TENGGARA TIMUR",3,127,2,129
https://kawalpemilu.org#57574,"OELASIN, ROTE BARAT DAYA, ROTE NDAO, NUSA TENGGARA TIMUR",4,112,4,116
https://kawalpemilu.org#57574,"OELASIN, ROTE BARAT DAYA, ROTE NDAO, NUSA TENGGARA TIMUR",5,136,8,144
https://kawalpemilu.org#85198,"LANDU, ROTE BARAT DAYA, ROTE NDAO, NUSA TENGGARA TIMUR",1,147,0,147
https://kawalpemilu.org#85198,"LANDU, ROTE BARAT DAYA, ROTE NDAO, NUSA TENGGARA TIMUR",2,32,1,33
https://kawalpemilu.org#85198,"LANDU, ROTE BARAT DAYA, ROTE NDAO, NUSA TENGGARA TIMUR",3,130,2,132
https://kawalpemilu.org#931352,"DALEK ESA, ROTE BARAT DAYA, ROTE NDAO, NUSA TENGGARA TIMUR",1,59,4,63
https://kawalpemilu.org#931352,"DALEK ESA, ROTE BARAT DAYA, ROTE NDAO, NUSA TENGGARA TIMUR",2,113,6,119
https://kawalpemilu.org#931352,"DALEK ESA, ROTE BARAT DAYA, ROTE NDAO, NUSA TENGGARA TIMUR",3,138,7,145
https://kawalpemilu.org#931353,"FUAFUNI, ROTE BARAT DAYA, ROTE NDAO, NUSA TENGGARA TIMUR",1,128,2,130
https://kawalpemilu.org#931353,"FUAFUNI, ROTE BARAT DAYA, ROTE NDAO, NUSA TENGGARA TIMUR",2,173,9,182
https://kawalpemilu.org#931353,"FUAFUNI, ROTE BARAT DAYA, ROTE NDAO, NUSA TENGGARA TIMUR",3,143,2,145
https://kawalpemilu.org#931354,"LENTERA, ROTE BARAT DAYA, ROTE NDAO, NUSA TENGGARA TIMUR",1,201,9,210
https://kawalpemilu.org#931354,"LENTERA, ROTE BARAT DAYA, ROTE NDAO, NUSA TENGGARA TIMUR",2,171,3,174
https://kawalpemilu.org#931354,"LENTERA, ROTE BARAT DAYA, ROTE NDAO, NUSA TENGGARA TIMUR",3,170,0,170
https://kawalpemilu.org#931354,"LENTERA, ROTE BARAT DAYA, ROTE NDAO, NUSA TENGGARA TIMUR",4,108,0,108
https://kawalpemilu.org#931354,"LENTERA, ROTE BARAT DAYA, ROTE NDAO, NUSA TENGGARA TIMUR",5,131,1,131
https://kawalpemilu.org#931355,"SAKUBATUN, ROTE BARAT DAYA, ROTE NDAO, NUSA TENGGARA TIMUR",1,195,11,206
https://kawalpemilu.org#931355,"SAKUBATUN, ROTE BARAT DAYA, ROTE NDAO, NUSA TENGGARA TIMUR",2,177,5,182
https://kawalpemilu.org#931356,"SANGGANDOLU, ROTE BARAT DAYA, ROTE NDAO, NUSA TENGGARA TIMUR",1,164,6,170
https://kawalpemilu.org#931356,"SANGGANDOLU, ROTE BARAT DAYA, ROTE NDAO, NUSA TENGGARA TIMUR",2,163,2,165
https://kawalpemilu.org#57576,"BUSALANGGA, ROTE BARAT LAUT, ROTE NDAO, NUSA TENGGARA TIMUR",1,188,28,216
https://kawalpemilu.org#57576,"BUSALANGGA, ROTE BARAT LAUT, ROTE NDAO, NUSA TENGGARA TIMUR",2,227,20,247
https://kawalpemilu.org#57576,"BUSALANGGA, ROTE BARAT LAUT, ROTE NDAO, NUSA TENGGARA TIMUR",3,116,11,127
https://kawalpemilu.org#57576,"BUSALANGGA, ROTE BARAT LAUT, ROTE NDAO, NUSA TENGGARA TIMUR",4,183,21,204
https://kawalpemilu.org#57577,"TEMAS, ROTE BARAT LAUT, ROTE NDAO, NUSA TENGGARA TIMUR",1,168,7,175
https://kawalpemilu.org#57577,"TEMAS, ROTE BARAT LAUT, ROTE NDAO, NUSA TENGGARA TIMUR",2,161,13,174
https://kawalpemilu.org#57577,"TEMAS, ROTE BARAT LAUT, ROTE NDAO, NUSA TENGGARA TIMUR",3,168,6,174
https://kawalpemilu.org#57577,"TEMAS, ROTE BARAT LAUT, ROTE NDAO, NUSA TENGGARA TIMUR",4,190,0,190
https://kawalpemilu.org#57578,"BONI, ROTE BARAT LAUT, ROTE NDAO, NUSA TENGGARA TIMUR",1,232,3,235
https://kawalpemilu.org#57578,"BONI, ROTE BARAT LAUT, ROTE NDAO, NUSA TENGGARA TIMUR",2,248,5,253
https://kawalpemilu.org#57579,"OELUA, ROTE BARAT LAUT, ROTE NDAO, NUSA TENGGARA TIMUR",1,137,38,175
https://kawalpemilu.org#57579,"OELUA, ROTE BARAT LAUT, ROTE NDAO, NUSA TENGGARA TIMUR",2,145,29,174
https://kawalpemilu.org#57579,"OELUA, ROTE BARAT LAUT, ROTE NDAO, NUSA TENGGARA TIMUR",3,61,131,192
https://kawalpemilu.org#57579,"OELUA, ROTE BARAT LAUT, ROTE NDAO, NUSA TENGGARA TIMUR",4,83,108,191
https://kawalpemilu.org#57579,"OELUA, ROTE BARAT LAUT, ROTE NDAO, NUSA TENGGARA TIMUR",5,170,13,183
https://kawalpemilu.org#57580,"MODOSINAL, ROTE BARAT LAUT, ROTE NDAO, NUSA TENGGARA TIMUR",1,197,20,217
https://kawalpemilu.org#57580,"MODOSINAL, ROTE BARAT LAUT, ROTE NDAO, NUSA TENGGARA TIMUR",2,207,5,212
https://kawalpemilu.org#57580,"MODOSINAL, ROTE BARAT LAUT, ROTE NDAO, NUSA TENGGARA TIMUR",3,133,8,141
https://kawalpemilu.org#57580,"MODOSINAL, ROTE BARAT LAUT, ROTE NDAO, NUSA TENGGARA TIMUR",4,94,10,104
https://kawalpemilu.org#57580,"MODOSINAL, ROTE BARAT LAUT, ROTE NDAO, NUSA TENGGARA TIMUR",5,84,11,95
https://kawalpemilu.org#57581,"NETENAEN, ROTE BARAT LAUT, ROTE NDAO, NUSA TENGGARA TIMUR",1,178,17,195
https://kawalpemilu.org#57581,"NETENAEN, ROTE BARAT LAUT, ROTE NDAO, NUSA TENGGARA TIMUR",2,134,10,144
https://kawalpemilu.org#57581,"NETENAEN, ROTE BARAT LAUT, ROTE NDAO, NUSA TENGGARA TIMUR",3,134,2,136
https://kawalpemilu.org#57582,"LIDOR, ROTE BARAT LAUT, ROTE NDAO, NUSA TENGGARA TIMUR",1,206,10,216
https://kawalpemilu.org#57582,"LIDOR, ROTE BARAT LAUT, ROTE NDAO, NUSA TENGGARA TIMUR",2,205,6,211
https://kawalpemilu.org#57583,"TOLAMA, ROTE BARAT LAUT, ROTE NDAO, NUSA TENGGARA TIMUR",1,176,4,180
https://kawalpemilu.org#57583,"TOLAMA, ROTE BARAT LAUT, ROTE NDAO, NUSA TENGGARA TIMUR",2,161,4,165
https://kawalpemilu.org#57583,"TOLAMA, ROTE BARAT LAUT, ROTE NDAO, NUSA TENGGARA TIMUR",3,124,8,132
https://kawalpemilu.org#57583,"TOLAMA, ROTE BARAT LAUT, ROTE NDAO, NUSA TENGGARA TIMUR",4,157,3,160
https://kawalpemilu.org#57584,"INGGUINAK, ROTE BARAT LAUT, ROTE NDAO, NUSA TENGGARA TIMUR",1,156,6,162
https://kawalpemilu.org#57584,"INGGUINAK, ROTE BARAT LAUT, ROTE NDAO, NUSA TENGGARA TIMUR",2,170,21,191
https://kawalpemilu.org#57584,"INGGUINAK, ROTE BARAT LAUT, ROTE NDAO, NUSA TENGGARA TIMUR",3,150,46,196
https://kawalpemilu.org#57584,"INGGUINAK, ROTE BARAT LAUT, ROTE NDAO, NUSA TENGGARA TIMUR",4,166,27,193
https://kawalpemilu.org#57585,"OETUTULU, ROTE BARAT LAUT, ROTE NDAO, NUSA TENGGARA TIMUR",1,195,11,206
https://kawalpemilu.org#57585,"OETUTULU, ROTE BARAT LAUT, ROTE NDAO, NUSA TENGGARA TIMUR",2,198,15,213
https://kawalpemilu.org#57585,"OETUTULU, ROTE BARAT LAUT, ROTE NDAO, NUSA TENGGARA TIMUR",3,159,4,163
https://kawalpemilu.org#57585,"OETUTULU, ROTE BARAT LAUT, ROTE NDAO, NUSA TENGGARA TIMUR",4,100,7,107
https://kawalpemilu.org#57586,"DAUDOLU, ROTE BARAT LAUT, ROTE NDAO, NUSA TENGGARA TIMUR",1,158,6,164
https://kawalpemilu.org#57586,"DAUDOLU, ROTE BARAT LAUT, ROTE NDAO, NUSA TENGGARA TIMUR",2,142,2,144
https://kawalpemilu.org#57586,"DAUDOLU, ROTE BARAT LAUT, ROTE NDAO, NUSA TENGGARA TIMUR",3,161,7,168
https://kawalpemilu.org#57586,"DAUDOLU, ROTE BARAT LAUT, ROTE NDAO, NUSA TENGGARA TIMUR",4,186,8,194
https://kawalpemilu.org#57587,"OEBELA, ROTE BARAT LAUT, ROTE NDAO, NUSA TENGGARA TIMUR",1,142,6,148
https://kawalpemilu.org#57587,"OEBELA, ROTE BARAT LAUT, ROTE NDAO, NUSA TENGGARA TIMUR",2,155,5,160
https://kawalpemilu.org#57587,"OEBELA, ROTE BARAT LAUT, ROTE NDAO, NUSA TENGGARA TIMUR",3,140,7,147
https://kawalpemilu.org#90757,"TUALIMA, ROTE BARAT LAUT, ROTE NDAO, NUSA TENGGARA TIMUR",1,174,5,179
https://kawalpemilu.org#90757,"TUALIMA, ROTE BARAT LAUT, ROTE NDAO, NUSA TENGGARA TIMUR",2,114,8,122
https://kawalpemilu.org#931357,"BALAOLI, ROTE BARAT LAUT, ROTE NDAO, NUSA TENGGARA TIMUR",1,128,11,139
https://kawalpemilu.org#931357,"BALAOLI, ROTE BARAT LAUT, ROTE NDAO, NUSA TENGGARA TIMUR",2,159,7,166
https://kawalpemilu.org#931357,"BALAOLI, ROTE BARAT LAUT, ROTE NDAO, NUSA TENGGARA TIMUR",3,149,6,155
https://kawalpemilu.org#931358,"BUSALANGGA BARAT, ROTE BARAT LAUT, ROTE NDAO, NUSA TENGGARA TIMUR",1,195,4,199
https://kawalpemilu.org#931358,"BUSALANGGA BARAT, ROTE BARAT LAUT, ROTE NDAO, NUSA TENGGARA TIMUR",2,178,4,182
https://kawalpemilu.org#931358,"BUSALANGGA BARAT, ROTE BARAT LAUT, ROTE NDAO, NUSA TENGGARA TIMUR",3,168,4,172
https://kawalpemilu.org#931359,"BUSALANGGA TIMUR, ROTE BARAT LAUT, ROTE NDAO, NUSA TENGGARA TIMUR",1,187,4,191
https://kawalpemilu.org#931359,"BUSALANGGA TIMUR, ROTE BARAT LAUT, ROTE NDAO, NUSA TENGGARA TIMUR",2,233,4,237
https://kawalpemilu.org#931359,"BUSALANGGA TIMUR, ROTE BARAT LAUT, ROTE NDAO, NUSA TENGGARA TIMUR",3,183,15,198
https://kawalpemilu.org#931360,"HOLULAI, ROTE BARAT LAUT, ROTE NDAO, NUSA TENGGARA TIMUR",1,136,12,148
https://kawalpemilu.org#931360,"HOLULAI, ROTE BARAT LAUT, ROTE NDAO, NUSA TENGGARA TIMUR",2,173,9,182
https://kawalpemilu.org#931360,"HOLULAI, ROTE BARAT LAUT, ROTE NDAO, NUSA TENGGARA TIMUR",3,158,4,162
https://kawalpemilu.org#931361,"HUNDIHUK, ROTE BARAT LAUT, ROTE NDAO, NUSA TENGGARA TIMUR",1,169,9,178
https://kawalpemilu.org#931361,"HUNDIHUK, ROTE BARAT LAUT, ROTE NDAO, NUSA TENGGARA TIMUR",2,136,25,161
https://kawalpemilu.org#931361,"HUNDIHUK, ROTE BARAT LAUT, ROTE NDAO, NUSA TENGGARA TIMUR",3,127,15,142
https://kawalpemilu.org#931361,"HUNDIHUK, ROTE BARAT LAUT, ROTE NDAO, NUSA TENGGARA TIMUR",4,154,14,168
https://kawalpemilu.org#931362,"MUNDEK, ROTE BARAT LAUT, ROTE NDAO, NUSA TENGGARA TIMUR",1,189,14,203
https://kawalpemilu.org#931362,"MUNDEK, ROTE BARAT LAUT, ROTE NDAO, NUSA TENGGARA TIMUR",2,201,4,205
https://kawalpemilu.org#931363,"OEBOLE, ROTE BARAT LAUT, ROTE NDAO, NUSA TENGGARA TIMUR",1,175,3,178
https://kawalpemilu.org#931363,"OEBOLE, ROTE BARAT LAUT, ROTE NDAO, NUSA TENGGARA TIMUR",2,186,11,197
https://kawalpemilu.org#931364,"SAINDULE, ROTE BARAT LAUT, ROTE NDAO, NUSA TENGGARA TIMUR",1,171,11,182
https://kawalpemilu.org#931364,"SAINDULE, ROTE BARAT LAUT, ROTE NDAO, NUSA TENGGARA TIMUR",2,168,7,175
https://kawalpemilu.org#931365,"TASILO, ROTE BARAT LAUT, ROTE NDAO, NUSA TENGGARA TIMUR",1,154,17,171
https://kawalpemilu.org#931365,"TASILO, ROTE BARAT LAUT, ROTE NDAO, NUSA TENGGARA TIMUR",2,143,10,153
https://kawalpemilu.org#931365,"TASILO, ROTE BARAT LAUT, ROTE NDAO, NUSA TENGGARA TIMUR",3,107,9,116
https://kawalpemilu.org#57589,"NAMODALE, LOBALAIN, ROTE NDAO, NUSA TENGGARA TIMUR",1,134,99,233
https://kawalpemilu.org#57589,"NAMODALE, LOBALAIN, ROTE NDAO, NUSA TENGGARA TIMUR",2,193,48,241
https://kawalpemilu.org#57589,"NAMODALE, LOBALAIN, ROTE NDAO, NUSA TENGGARA TIMUR",3,170,24,194
https://kawalpemilu.org#57589,"NAMODALE, LOBALAIN, ROTE NDAO, NUSA TENGGARA TIMUR",4,169,45,214
https://kawalpemilu.org#57589,"NAMODALE, LOBALAIN, ROTE NDAO, NUSA TENGGARA TIMUR",5,195,15,210
https://kawalpemilu.org#57589,"NAMODALE, LOBALAIN, ROTE NDAO, NUSA TENGGARA TIMUR",6,180,52,232
https://kawalpemilu.org#57589,"NAMODALE, LOBALAIN, ROTE NDAO, NUSA TENGGARA TIMUR",7,188,22,210
https://kawalpemilu.org#57590,"MOKDALE, LOBALAIN, ROTE NDAO, NUSA TENGGARA TIMUR",1,232,8,240
https://kawalpemilu.org#57590,"MOKDALE, LOBALAIN, ROTE NDAO, NUSA TENGGARA TIMUR",2,226,20,246
https://kawalpemilu.org#57590,"MOKDALE, LOBALAIN, ROTE NDAO, NUSA TENGGARA TIMUR",3,244,20,264
https://kawalpemilu.org#57590,"MOKDALE, LOBALAIN, ROTE NDAO, NUSA TENGGARA TIMUR",4,218,31,249
https://kawalpemilu.org#57590,"MOKDALE, LOBALAIN, ROTE NDAO, NUSA TENGGARA TIMUR",5,213,27,240
https://kawalpemilu.org#57590,"MOKDALE, LOBALAIN, ROTE NDAO, NUSA TENGGARA TIMUR",6,180,49,229
https://kawalpemilu.org#57590,"MOKDALE, LOBALAIN, ROTE NDAO, NUSA TENGGARA TIMUR",7,222,13,235
https://kawalpemilu.org#57590,"MOKDALE, LOBALAIN, ROTE NDAO, NUSA TENGGARA TIMUR",8,220,13,233
https://kawalpemilu.org#57590,"MOKDALE, LOBALAIN, ROTE NDAO, NUSA TENGGARA TIMUR",9,180,16,196
https://kawalpemilu.org#57590,"MOKDALE, LOBALAIN, ROTE NDAO, NUSA TENGGARA TIMUR",10,230,12,242
https://kawalpemilu.org#57591,"METINA, LOBALAIN, ROTE NDAO, NUSA TENGGARA TIMUR",1,201,35,236
https://kawalpemilu.org#57591,"METINA, LOBALAIN, ROTE NDAO, NUSA TENGGARA TIMUR",2,194,36,230
https://kawalpemilu.org#57591,"METINA, LOBALAIN, ROTE NDAO, NUSA TENGGARA TIMUR",3,107,97,204
https://kawalpemilu.org#57591,"METINA, LOBALAIN, ROTE NDAO, NUSA TENGGARA TIMUR",4,189,35,224
https://kawalpemilu.org#57591,"METINA, LOBALAIN, ROTE NDAO, NUSA TENGGARA TIMUR",5,235,11,246
https://kawalpemilu.org#57591,"METINA, LOBALAIN, ROTE NDAO, NUSA TENGGARA TIMUR",6,165,43,208
https://kawalpemilu.org#57591,"METINA, LOBALAIN, ROTE NDAO, NUSA TENGGARA TIMUR",7,187,24,211
https://kawalpemilu.org#57592,"KULI, LOBALAIN, ROTE NDAO, NUSA TENGGARA TIMUR",1,116,1,117
https://kawalpemilu.org#57592,"KULI, LOBALAIN, ROTE NDAO, NUSA TENGGARA TIMUR",2,129,12,141
https://kawalpemilu.org#57592,"KULI, LOBALAIN, ROTE NDAO, NUSA TENGGARA TIMUR",3,153,11,164
https://kawalpemilu.org#57592,"KULI, LOBALAIN, ROTE NDAO, NUSA TENGGARA TIMUR",4,185,16,201
https://kawalpemilu.org#57593,"BEBALAIN, LOBALAIN, ROTE NDAO, NUSA TENGGARA TIMUR",1,137,5,142
https://kawalpemilu.org#57593,"BEBALAIN, LOBALAIN, ROTE NDAO, NUSA TENGGARA TIMUR",2,161,7,168
https://kawalpemilu.org#57593,"BEBALAIN, LOBALAIN, ROTE NDAO, NUSA TENGGARA TIMUR",3,159,2,161
https://kawalpemilu.org#57594,"KOLOBOLON, LOBALAIN, ROTE NDAO, NUSA TENGGARA TIMUR",1,176,3,179
https://kawalpemilu.org#57594,"KOLOBOLON, LOBALAIN, ROTE NDAO, NUSA TENGGARA TIMUR",2,192,2,194
https://kawalpemilu.org#57594,"KOLOBOLON, LOBALAIN, ROTE NDAO, NUSA TENGGARA TIMUR",3,186,4,190
https://kawalpemilu.org#57595,"HELEBEIK, LOBALAIN, ROTE NDAO, NUSA TENGGARA TIMUR",1,256,10,266
https://kawalpemilu.org#57595,"HELEBEIK, LOBALAIN, ROTE NDAO, NUSA TENGGARA TIMUR",2,166,5,171
https://kawalpemilu.org#57595,"HELEBEIK, LOBALAIN, ROTE NDAO, NUSA TENGGARA TIMUR",3,124,3,127
https://kawalpemilu.org#57595,"HELEBEIK, LOBALAIN, ROTE NDAO, NUSA TENGGARA TIMUR",4,156,0,156
https://kawalpemilu.org#57595,"HELEBEIK, LOBALAIN, ROTE NDAO, NUSA TENGGARA TIMUR",5,235,7,242
https://kawalpemilu.org#57596,"SANGGAOEN, LOBALAIN, ROTE NDAO, NUSA TENGGARA TIMUR",1,187,15,202
https://kawalpemilu.org#57596,"SANGGAOEN, LOBALAIN, ROTE NDAO, NUSA TENGGARA TIMUR",2,233,10,243
https://kawalpemilu.org#57596,"SANGGAOEN, LOBALAIN, ROTE NDAO, NUSA TENGGARA TIMUR",3,218,11,229
https://kawalpemilu.org#57596,"SANGGAOEN, LOBALAIN, ROTE NDAO, NUSA TENGGARA TIMUR",4,221,18,239
https://kawalpemilu.org#57597,"HOLOAMA, LOBALAIN, ROTE NDAO, NUSA TENGGARA TIMUR",1,189,8,197
https://kawalpemilu.org#57597,"HOLOAMA, LOBALAIN, ROTE NDAO, NUSA TENGGARA TIMUR",2,193,7,200
https://kawalpemilu.org#57597,"HOLOAMA, LOBALAIN, ROTE NDAO, NUSA TENGGARA TIMUR",3,182,17,199
https://kawalpemilu.org#57597,"HOLOAMA, LOBALAIN, ROTE NDAO, NUSA TENGGARA TIMUR",4,173,15,188
https://kawalpemilu.org#57598,"TUANATUK, LOBALAIN, ROTE NDAO, NUSA TENGGARA TIMUR",1,191,22,213
https://kawalpemilu.org#57598,"TUANATUK, LOBALAIN, ROTE NDAO, NUSA TENGGARA TIMUR",2,116,4,120
https://kawalpemilu.org#57598,"TUANATUK, LOBALAIN, ROTE NDAO, NUSA TENGGARA TIMUR",3,112,1,113
https://kawalpemilu.org#57599,"OELUNGGU, LOBALAIN, ROTE NDAO, NUSA TENGGARA TIMUR",1,207,7,214
https://kawalpemilu.org#57599,"OELUNGGU, LOBALAIN, ROTE NDAO, NUSA TENGGARA TIMUR",2,216,12,228
https://kawalpemilu.org#57599,"OELUNGGU, LOBALAIN, ROTE NDAO, NUSA TENGGARA TIMUR",3,195,7,202
https://kawalpemilu.org#57599,"OELUNGGU, LOBALAIN, ROTE NDAO, NUSA TENGGARA TIMUR",4,172,3,175
https://kawalpemilu.org#57600,"OEMATAMBOLI, LOBALAIN, ROTE NDAO, NUSA TENGGARA TIMUR",1,174,20,194
https://kawalpemilu.org#57600,"OEMATAMBOLI, LOBALAIN, ROTE NDAO, NUSA TENGGARA TIMUR",2,131,14,145
https://kawalpemilu.org#57600,"OEMATAMBOLI, LOBALAIN, ROTE NDAO, NUSA TENGGARA TIMUR",3,159,15,174
https://kawalpemilu.org#57600,"OEMATAMBOLI, LOBALAIN, ROTE NDAO, NUSA TENGGARA TIMUR",4,113,19,132
https://kawalpemilu.org#57601,"SUELAIN, LOBALAIN, ROTE NDAO, NUSA TENGGARA TIMUR",1,180,2,182
https://kawalpemilu.org#57601,"SUELAIN, LOBALAIN, ROTE NDAO, NUSA TENGGARA TIMUR",2,210,7,217
https://kawalpemilu.org#57602,"BAADALE, LOBALAIN, ROTE NDAO, NUSA TENGGARA TIMUR",1,175,13,188
https://kawalpemilu.org#57602,"BAADALE, LOBALAIN, ROTE NDAO, NUSA TENGGARA TIMUR",2,193,3,196
https://kawalpemilu.org#57602,"BAADALE, LOBALAIN, ROTE NDAO, NUSA TENGGARA TIMUR",3,142,13,155
https://kawalpemilu.org#57602,"BAADALE, LOBALAIN, ROTE NDAO, NUSA TENGGARA TIMUR",4,139,10,149
https://kawalpemilu.org#931344,"KULI AISELE, LOBALAIN, ROTE NDAO, NUSA TENGGARA TIMUR",1,192,24,216
https://kawalpemilu.org#931344,"KULI AISELE, LOBALAIN, ROTE NDAO, NUSA TENGGARA TIMUR",2,209,5,214
https://kawalpemilu.org#931345,"LEKUNIK, LOBALAIN, ROTE NDAO, NUSA TENGGARA TIMUR",1,165,31,196
https://kawalpemilu.org#931345,"LEKUNIK, LOBALAIN, ROTE NDAO, NUSA TENGGARA TIMUR",2,210,7,217
https://kawalpemilu.org#931346,"LOLEOEN, LOBALAIN, ROTE NDAO, NUSA TENGGARA TIMUR",1,128,2,130
https://kawalpemilu.org#931346,"LOLEOEN, LOBALAIN, ROTE NDAO, NUSA TENGGARA TIMUR",2,120,5,125
https://kawalpemilu.org#931346,"LOLEOEN, LOBALAIN, ROTE NDAO, NUSA TENGGARA TIMUR",3,150,4,154
https://kawalpemilu.org#931347,"OELEKA, LOBALAIN, ROTE NDAO, NUSA TENGGARA TIMUR",1,203,15,218
https://kawalpemilu.org#931347,"OELEKA, LOBALAIN, ROTE NDAO, NUSA TENGGARA TIMUR",2,131,7,138
https://kawalpemilu.org#931347,"OELEKA, LOBALAIN, ROTE NDAO, NUSA TENGGARA TIMUR",3,162,5,167
https://kawalpemilu.org#57604,"ONATALI, ROTE TENGAH, ROTE NDAO, NUSA TENGGARA TIMUR",1,189,26,215
https://kawalpemilu.org#57604,"ONATALI, ROTE TENGAH, ROTE NDAO, NUSA TENGGARA TIMUR",2,184,47,231
https://kawalpemilu.org#57604,"ONATALI, ROTE TENGAH, ROTE NDAO, NUSA TENGGARA TIMUR",3,166,17,183
https://kawalpemilu.org#57604,"ONATALI, ROTE TENGAH, ROTE NDAO, NUSA TENGGARA TIMUR",4,107,15,122
https://kawalpemilu.org#57604,"ONATALI, ROTE TENGAH, ROTE NDAO, NUSA TENGGARA TIMUR",5,124,10,134
https://kawalpemilu.org#57605,"MAUBESI, ROTE TENGAH, ROTE NDAO, NUSA TENGGARA TIMUR",1,168,25,193
https://kawalpemilu.org#57605,"MAUBESI, ROTE TENGAH, ROTE NDAO, NUSA TENGGARA TIMUR",2,143,34,177
https://kawalpemilu.org#57605,"MAUBESI, ROTE TENGAH, ROTE NDAO, NUSA TENGGARA TIMUR",3,146,50,196
https://kawalpemilu.org#57605,"MAUBESI, ROTE TENGAH, ROTE NDAO, NUSA TENGGARA TIMUR",4,144,30,174
https://kawalpemilu.org#57606,"NGGODIMEDA, ROTE TENGAH, ROTE NDAO, NUSA TENGGARA TIMUR",1,172,9,181
https://kawalpemilu.org#57606,"NGGODIMEDA, ROTE TENGAH, ROTE NDAO, NUSA TENGGARA TIMUR",2,147,8,155
https://kawalpemilu.org#57606,"NGGODIMEDA, ROTE TENGAH, ROTE NDAO, NUSA TENGGARA TIMUR",3,164,8,172
https://kawalpemilu.org#57607,"LIMAKOLI, ROTE TENGAH, ROTE NDAO, NUSA TENGGARA TIMUR",1,159,0,159
https://kawalpemilu.org#57607,"LIMAKOLI, ROTE TENGAH, ROTE NDAO, NUSA TENGGARA TIMUR",2,138,4,142
https://kawalpemilu.org#57608,"LIDAMANU, ROTE TENGAH, ROTE NDAO, NUSA TENGGARA TIMUR",1,159,7,166
https://kawalpemilu.org#57608,"LIDAMANU, ROTE TENGAH, ROTE NDAO, NUSA TENGGARA TIMUR",2,172,9,181
https://kawalpemilu.org#57608,"LIDAMANU, ROTE TENGAH, ROTE NDAO, NUSA TENGGARA TIMUR",3,141,14,155
https://kawalpemilu.org#57608,"LIDAMANU, ROTE TENGAH, ROTE NDAO, NUSA TENGGARA TIMUR",4,133,38,171
https://kawalpemilu.org#57608,"LIDAMANU, ROTE TENGAH, ROTE NDAO, NUSA TENGGARA TIMUR",5,106,1,107
https://kawalpemilu.org#57609,"SUEBELA, ROTE TENGAH, ROTE NDAO, NUSA TENGGARA TIMUR",1,165,9,174
https://kawalpemilu.org#57609,"SUEBELA, ROTE TENGAH, ROTE NDAO, NUSA TENGGARA TIMUR",2,231,8,239
https://kawalpemilu.org#57609,"SUEBELA, ROTE TENGAH, ROTE NDAO, NUSA TENGGARA TIMUR",3,116,17,133
https://kawalpemilu.org#57610,"LIDABESI, ROTE TENGAH, ROTE NDAO, NUSA TENGGARA TIMUR",1,152,18,170
https://kawalpemilu.org#57610,"LIDABESI, ROTE TENGAH, ROTE NDAO, NUSA TENGGARA TIMUR",2,170,17,187
https://kawalpemilu.org#57610,"LIDABESI, ROTE TENGAH, ROTE NDAO, NUSA TENGGARA TIMUR",3,171,24,195
https://kawalpemilu.org#931368,"SIOMEDA, ROTE TENGAH, ROTE NDAO, NUSA TENGGARA TIMUR",1,187,29,216
https://kawalpemilu.org#931368,"SIOMEDA, ROTE TENGAH, ROTE NDAO, NUSA TENGGARA TIMUR",2,153,40,193
https://kawalpemilu.org#57612,"OLAFULIHAA, PANTAI BARU, ROTE NDAO, NUSA TENGGARA TIMUR",1,212,15,227
https://kawalpemilu.org#57612,"OLAFULIHAA, PANTAI BARU, ROTE NDAO, NUSA TENGGARA TIMUR",2,190,40,230
https://kawalpemilu.org#57612,"OLAFULIHAA, PANTAI BARU, ROTE NDAO, NUSA TENGGARA TIMUR",3,211,12,223
https://kawalpemilu.org#57613,"NUSAKDALE, PANTAI BARU, ROTE NDAO, NUSA TENGGARA TIMUR",1,202,39,241
https://kawalpemilu.org#57613,"NUSAKDALE, PANTAI BARU, ROTE NDAO, NUSA TENGGARA TIMUR",2,218,3,221
https://kawalpemilu.org#57613,"NUSAKDALE, PANTAI BARU, ROTE NDAO, NUSA TENGGARA TIMUR",3,101,2,103
https://kawalpemilu.org#57614,"BATULILOK, PANTAI BARU, ROTE NDAO, NUSA TENGGARA TIMUR",1,175,16,191
https://kawalpemilu.org#57614,"BATULILOK, PANTAI BARU, ROTE NDAO, NUSA TENGGARA TIMUR",2,219,18,237
https://kawalpemilu.org#57615,"LENUPETU, PANTAI BARU, ROTE NDAO, NUSA TENGGARA TIMUR",1,235,6,241
https://kawalpemilu.org#57615,"LENUPETU, PANTAI BARU, ROTE NDAO, NUSA TENGGARA TIMUR",2,56,0,56
https://kawalpemilu.org#57616,"SONIMANU, PANTAI BARU, ROTE NDAO, NUSA TENGGARA TIMUR",1,156,9,165
https://kawalpemilu.org#57616,"SONIMANU, PANTAI BARU, ROTE NDAO, NUSA TENGGARA TIMUR",2,157,4,161
https://kawalpemilu.org#57617,"OEBAU, PANTAI BARU, ROTE NDAO, NUSA TENGGARA TIMUR",1,189,3,192
https://kawalpemilu.org#57617,"OEBAU, PANTAI BARU, ROTE NDAO, NUSA TENGGARA TIMUR",2,142,1,143
https://kawalpemilu.org#57617,"OEBAU, PANTAI BARU, ROTE NDAO, NUSA TENGGARA TIMUR",3,166,8,174
https://kawalpemilu.org#57618,"OELEDO, PANTAI BARU, ROTE NDAO, NUSA TENGGARA TIMUR",1,158,50,208
https://kawalpemilu.org#57618,"OELEDO, PANTAI BARU, ROTE NDAO, NUSA TENGGARA TIMUR",2,185,13,198
https://kawalpemilu.org#57619,"KEOEN, PANTAI BARU, ROTE NDAO, NUSA TENGGARA TIMUR",1,205,8,213
https://kawalpemilu.org#57619,"KEOEN, PANTAI BARU, ROTE NDAO, NUSA TENGGARA TIMUR",2,211,6,217
https://kawalpemilu.org#57619,"KEOEN, PANTAI BARU, ROTE NDAO, NUSA TENGGARA TIMUR",3,134,2,136
https://kawalpemilu.org#57619,"KEOEN, PANTAI BARU, ROTE NDAO, NUSA TENGGARA TIMUR",4,141,3,144
https://kawalpemilu.org#57620,"EDALODE, PANTAI BARU, ROTE NDAO, NUSA TENGGARA TIMUR",1,206,3,209
https://kawalpemilu.org#57620,"EDALODE, PANTAI BARU, ROTE NDAO, NUSA TENGGARA TIMUR",2,212,4,216
https://kawalpemilu.org#57620,"EDALODE, PANTAI BARU, ROTE NDAO, NUSA TENGGARA TIMUR",3,165,6,171
https://kawalpemilu.org#57621,"TUNGGANAMO, PANTAI BARU, ROTE NDAO, NUSA TENGGARA TIMUR",1,197,12,209
https://kawalpemilu.org#57621,"TUNGGANAMO, PANTAI BARU, ROTE NDAO, NUSA TENGGARA TIMUR",2,206,10,216
https://kawalpemilu.org#57621,"TUNGGANAMO, PANTAI BARU, ROTE NDAO, NUSA TENGGARA TIMUR",3,212,11,223
https://kawalpemilu.org#57621,"TUNGGANAMO, PANTAI BARU, ROTE NDAO, NUSA TENGGARA TIMUR",4,213,10,223
https://kawalpemilu.org#931342,"TESABELA, PANTAI BARU, ROTE NDAO, NUSA TENGGARA TIMUR",1,170,6,176
https://kawalpemilu.org#931342,"TESABELA, PANTAI BARU, ROTE NDAO, NUSA TENGGARA TIMUR",2,210,7,217
https://kawalpemilu.org#931342,"TESABELA, PANTAI BARU, ROTE NDAO, NUSA TENGGARA TIMUR",3,207,10,217
https://kawalpemilu.org#931348,"FATELILO, PANTAI BARU, ROTE NDAO, NUSA TENGGARA TIMUR",1,198,5,203
https://kawalpemilu.org#931348,"FATELILO, PANTAI BARU, ROTE NDAO, NUSA TENGGARA TIMUR",2,126,8,134
https://kawalpemilu.org#931349,"LEKONA, PANTAI BARU, ROTE NDAO, NUSA TENGGARA TIMUR",1,223,1,224
https://kawalpemilu.org#931349,"LEKONA, PANTAI BARU, ROTE NDAO, NUSA TENGGARA TIMUR",2,216,6,222
https://kawalpemilu.org#931350,"OENGGAE, PANTAI BARU, ROTE NDAO, NUSA TENGGARA TIMUR",1,203,14,217
https://kawalpemilu.org#931350,"OENGGAE, PANTAI BARU, ROTE NDAO, NUSA TENGGARA TIMUR",2,93,121,214
https://kawalpemilu.org#931351,"OFALANGGA, PANTAI BARU, ROTE NDAO, NUSA TENGGARA TIMUR",1,230,12,242
https://kawalpemilu.org#931351,"OFALANGGA, PANTAI BARU, ROTE NDAO, NUSA TENGGARA TIMUR",2,93,6,99
https://kawalpemilu.org#57624,"LONDALUSI, ROTE TIMUR, ROTE NDAO, NUSA TENGGARA TIMUR",1,211,4,215
https://kawalpemilu.org#57624,"LONDALUSI, ROTE TIMUR, ROTE NDAO, NUSA TENGGARA TIMUR",2,202,9,211
https://kawalpemilu.org#57624,"LONDALUSI, ROTE TIMUR, ROTE NDAO, NUSA TENGGARA TIMUR",3,216,12,228
https://kawalpemilu.org#57625,"MUKEKUKU, ROTE TIMUR, ROTE NDAO, NUSA TENGGARA TIMUR",1,185,24,209
https://kawalpemilu.org#57625,"MUKEKUKU, ROTE TIMUR, ROTE NDAO, NUSA TENGGARA TIMUR",2,178,13,191
https://kawalpemilu.org#57625,"MUKEKUKU, ROTE TIMUR, ROTE NDAO, NUSA TENGGARA TIMUR",3,141,4,145
https://kawalpemilu.org#57626,"FAIFUA, ROTE TIMUR, ROTE NDAO, NUSA TENGGARA TIMUR",1,161,5,166
https://kawalpemilu.org#57626,"FAIFUA, ROTE TIMUR, ROTE NDAO, NUSA TENGGARA TIMUR",2,175,7,182
https://kawalpemilu.org#57626,"FAIFUA, ROTE TIMUR, ROTE NDAO, NUSA TENGGARA TIMUR",3,157,1,158
https://kawalpemilu.org#57627,"HUNDIHOPO, ROTE TIMUR, ROTE NDAO, NUSA TENGGARA TIMUR",1,162,7,169
https://kawalpemilu.org#57627,"HUNDIHOPO, ROTE TIMUR, ROTE NDAO, NUSA TENGGARA TIMUR",2,162,10,172
https://kawalpemilu.org#57627,"HUNDIHOPO, ROTE TIMUR, ROTE NDAO, NUSA TENGGARA TIMUR",3,152,7,159
https://kawalpemilu.org#57628,"SERUBEBA, ROTE TIMUR, ROTE NDAO, NUSA TENGGARA TIMUR",1,148,6,154
https://kawalpemilu.org#57628,"SERUBEBA, ROTE TIMUR, ROTE NDAO, NUSA TENGGARA TIMUR",2,180,7,187
https://kawalpemilu.org#57628,"SERUBEBA, ROTE TIMUR, ROTE NDAO, NUSA TENGGARA TIMUR",3,200,6,206
https://kawalpemilu.org#57628,"SERUBEBA, ROTE TIMUR, ROTE NDAO, NUSA TENGGARA TIMUR",4,154,12,166
https://kawalpemilu.org#57628,"SERUBEBA, ROTE TIMUR, ROTE NDAO, NUSA TENGGARA TIMUR",5,221,0,221
https://kawalpemilu.org#57629,"LAKAMOLA, ROTE TIMUR, ROTE NDAO, NUSA TENGGARA TIMUR",1,111,11,122
https://kawalpemilu.org#57629,"LAKAMOLA, ROTE TIMUR, ROTE NDAO, NUSA TENGGARA TIMUR",2,189,10,199
https://kawalpemilu.org#57629,"LAKAMOLA, ROTE TIMUR, ROTE NDAO, NUSA TENGGARA TIMUR",3,226,5,231
https://kawalpemilu.org#57630,"MATASIO, ROTE TIMUR, ROTE NDAO, NUSA TENGGARA TIMUR",1,155,5,160
https://kawalpemilu.org#57630,"MATASIO, ROTE TIMUR, ROTE NDAO, NUSA TENGGARA TIMUR",2,175,7,182
https://kawalpemilu.org#57630,"MATASIO, ROTE TIMUR, ROTE NDAO, NUSA TENGGARA TIMUR",3,128,1,129
https://kawalpemilu.org#931369,"BATEFALU, ROTE TIMUR, ROTE NDAO, NUSA TENGGARA TIMUR",1,178,8,186
https://kawalpemilu.org#931369,"BATEFALU, ROTE TIMUR, ROTE NDAO, NUSA TENGGARA TIMUR",2,171,8,179
https://kawalpemilu.org#931369,"BATEFALU, ROTE TIMUR, ROTE NDAO, NUSA TENGGARA TIMUR",3,171,5,176
https://kawalpemilu.org#931369,"BATEFALU, ROTE TIMUR, ROTE NDAO, NUSA TENGGARA TIMUR",4,131,0,131
https://kawalpemilu.org#931370,"MATANAE, ROTE TIMUR, ROTE NDAO, NUSA TENGGARA TIMUR",1,141,2,143
https://kawalpemilu.org#931370,"MATANAE, ROTE TIMUR, ROTE NDAO, NUSA TENGGARA TIMUR",2,151,9,160
https://kawalpemilu.org#931370,"MATANAE, ROTE TIMUR, ROTE NDAO, NUSA TENGGARA TIMUR",3,187,4,191
https://kawalpemilu.org#931371,"PAPELA, ROTE TIMUR, ROTE NDAO, NUSA TENGGARA TIMUR",1,46,145,191
https://kawalpemilu.org#931371,"PAPELA, ROTE TIMUR, ROTE NDAO, NUSA TENGGARA TIMUR",2,59,115,174
https://kawalpemilu.org#931371,"PAPELA, ROTE TIMUR, ROTE NDAO, NUSA TENGGARA TIMUR",3,67,140,207
https://kawalpemilu.org#931371,"PAPELA, ROTE TIMUR, ROTE NDAO, NUSA TENGGARA TIMUR",4,77,139,216
https://kawalpemilu.org#931371,"PAPELA, ROTE TIMUR, ROTE NDAO, NUSA TENGGARA TIMUR",5,106,94,200
https://kawalpemilu.org#931372,"PENGODUA, ROTE TIMUR, ROTE NDAO, NUSA TENGGARA TIMUR",1,149,8,157
https://kawalpemilu.org#931372,"PENGODUA, ROTE TIMUR, ROTE NDAO, NUSA TENGGARA TIMUR",2,171,10,181
https://kawalpemilu.org#931372,"PENGODUA, ROTE TIMUR, ROTE NDAO, NUSA TENGGARA TIMUR",3,126,7,133
https://kawalpemilu.org#931372,"PENGODUA, ROTE TIMUR, ROTE NDAO, NUSA TENGGARA TIMUR",4,150,3,153
https://kawalpemilu.org#57635,"SEDEOEN, ROTE BARAT, ROTE NDAO, NUSA TENGGARA TIMUR",1,247,7,254
https://kawalpemilu.org#57635,"SEDEOEN, ROTE BARAT, ROTE NDAO, NUSA TENGGARA TIMUR",2,168,9,177
https://kawalpemilu.org#57635,"SEDEOEN, ROTE BARAT, ROTE NDAO, NUSA TENGGARA TIMUR",3,204,5,209
https://kawalpemilu.org#57636,"NEMBERALA, ROTE BARAT, ROTE NDAO, NUSA TENGGARA TIMUR",1,233,10,243
https://kawalpemilu.org#57636,"NEMBERALA, ROTE BARAT, ROTE NDAO, NUSA TENGGARA TIMUR",2,206,5,211
https://kawalpemilu.org#57636,"NEMBERALA, ROTE BARAT, ROTE NDAO, NUSA TENGGARA TIMUR",3,244,5,249
https://kawalpemilu.org#57637,"OENGGAUT, ROTE BARAT, ROTE NDAO, NUSA TENGGARA TIMUR",1,201,3,204
https://kawalpemilu.org#57637,"OENGGAUT, ROTE BARAT, ROTE NDAO, NUSA TENGGARA TIMUR",3,220,9,229
https://kawalpemilu.org#57638,"BOA, ROTE BARAT, ROTE NDAO, NUSA TENGGARA TIMUR",1,193,2,195
https://kawalpemilu.org#57638,"BOA, ROTE BARAT, ROTE NDAO, NUSA TENGGARA TIMUR",2,253,3,256
https://kawalpemilu.org#57639,"OENITAS, ROTE BARAT, ROTE NDAO, NUSA TENGGARA TIMUR",1,205,8,213
https://kawalpemilu.org#57639,"OENITAS, ROTE BARAT, ROTE NDAO, NUSA TENGGARA TIMUR",2,169,5,174
https://kawalpemilu.org#57639,"OENITAS, ROTE BARAT, ROTE NDAO, NUSA TENGGARA TIMUR",3,159,9,168
https://kawalpemilu.org#57639,"OENITAS, ROTE BARAT, ROTE NDAO, NUSA TENGGARA TIMUR",4,195,3,198
https://kawalpemilu.org#57639,"OENITAS, ROTE BARAT, ROTE NDAO, NUSA TENGGARA TIMUR",5,195,1,196
https://kawalpemilu.org#57640,"OELOLOT, ROTE BARAT, ROTE NDAO, NUSA TENGGARA TIMUR",1,248,11,259
https://kawalpemilu.org#57640,"OELOLOT, ROTE BARAT, ROTE NDAO, NUSA TENGGARA TIMUR",2,213,14,227
https://kawalpemilu.org#57640,"OELOLOT, ROTE BARAT, ROTE NDAO, NUSA TENGGARA TIMUR",3,182,13,195
https://kawalpemilu.org#57641,"MBUEAIN, ROTE BARAT, ROTE NDAO, NUSA TENGGARA TIMUR",1,151,34,185
https://kawalpemilu.org#57641,"MBUEAIN, ROTE BARAT, ROTE NDAO, NUSA TENGGARA TIMUR",2,130,15,145
https://kawalpemilu.org#57641,"MBUEAIN, ROTE BARAT, ROTE NDAO, NUSA TENGGARA TIMUR",3,130,28,158
https://kawalpemilu.org#57644,"LENGUSELU, ROTE SELATAN, ROTE NDAO, NUSA TENGGARA TIMUR",1,158,2,160
https://kawalpemilu.org#57644,"LENGUSELU, ROTE SELATAN, ROTE NDAO, NUSA TENGGARA TIMUR",2,124,12,136
https://kawalpemilu.org#57645,"DALEHOLU, ROTE SELATAN, ROTE NDAO, NUSA TENGGARA TIMUR",1,136,24,160
https://kawalpemilu.org#57645,"DALEHOLU, ROTE SELATAN, ROTE NDAO, NUSA TENGGARA TIMUR",2,147,17,164
https://kawalpemilu.org#57645,"DALEHOLU, ROTE SELATAN, ROTE NDAO, NUSA TENGGARA TIMUR",3,137,21,158
https://kawalpemilu.org#57645,"DALEHOLU, ROTE SELATAN, ROTE NDAO, NUSA TENGGARA TIMUR",4,146,23,169
https://kawalpemilu.org#57646,"DODAEK, ROTE SELATAN, ROTE NDAO, NUSA TENGGARA TIMUR",1,78,63,141
https://kawalpemilu.org#57646,"DODAEK, ROTE SELATAN, ROTE NDAO, NUSA TENGGARA TIMUR",2,53,89,142
https://kawalpemilu.org#57647,"TEBOLE, ROTE SELATAN, ROTE NDAO, NUSA TENGGARA TIMUR",1,166,13,179
https://kawalpemilu.org#57647,"TEBOLE, ROTE SELATAN, ROTE NDAO, NUSA TENGGARA TIMUR",2,177,18,195
https://kawalpemilu.org#57647,"TEBOLE, ROTE SELATAN, ROTE NDAO, NUSA TENGGARA TIMUR",3,172,26,198
https://kawalpemilu.org#57648,"INAOE, ROTE SELATAN, ROTE NDAO, NUSA TENGGARA TIMUR",1,200,12,212
https://kawalpemilu.org#57648,"INAOE, ROTE SELATAN, ROTE NDAO, NUSA TENGGARA TIMUR",2,186,8,194
https://kawalpemilu.org#931366,"NGGELODAE, ROTE SELATAN, ROTE NDAO, NUSA TENGGARA TIMUR",1,163,5,168
https://kawalpemilu.org#931366,"NGGELODAE, ROTE SELATAN, ROTE NDAO, NUSA TENGGARA TIMUR",2,160,1,161
https://kawalpemilu.org#931367,"PILASUE, ROTE SELATAN, ROTE NDAO, NUSA TENGGARA TIMUR",1,156,1,157
https://kawalpemilu.org#931367,"PILASUE, ROTE SELATAN, ROTE NDAO, NUSA TENGGARA TIMUR",2,134,7,141
https://kawalpemilu.org#931367,"PILASUE, ROTE SELATAN, ROTE NDAO, NUSA TENGGARA TIMUR",3,164,7,171
https://kawalpemilu.org#85199,"MBALI LENDEIKI, NDAO NUSE, ROTE NDAO, NUSA TENGGARA TIMUR",1,188,8,196
https://kawalpemilu.org#85199,"MBALI LENDEIKI, NDAO NUSE, ROTE NDAO, NUSA TENGGARA TIMUR",2,199,4,203
https://kawalpemilu.org#85200,"ANARAE, NDAO NUSE, ROTE NDAO, NUSA TENGGARA TIMUR",1,202,1,203
https://kawalpemilu.org#85200,"ANARAE, NDAO NUSE, ROTE NDAO, NUSA TENGGARA TIMUR",2,127,1,128
https://kawalpemilu.org#85201,"MBIU LOMBO, NDAO NUSE, ROTE NDAO, NUSA TENGGARA TIMUR",1,159,3,162
https://kawalpemilu.org#85201,"MBIU LOMBO, NDAO NUSE, ROTE NDAO, NUSA TENGGARA TIMUR",2,142,2,144
https://kawalpemilu.org#85202,"NUSE, NDAO NUSE, ROTE NDAO, NUSA TENGGARA TIMUR",1,222,7,229
https://kawalpemilu.org#85203,"NDAONUSE, NDAO NUSE, ROTE NDAO, NUSA TENGGARA TIMUR",1,128,21,149
https://kawalpemilu.org#85203,"NDAONUSE, NDAO NUSE, ROTE NDAO, NUSA TENGGARA TIMUR",2,144,34,178
https://kawalpemilu.org#85203,"NDAONUSE, NDAO NUSE, ROTE NDAO, NUSA TENGGARA TIMUR",3,156,2,158
https://kawalpemilu.org#85203,"NDAONUSE, NDAO NUSE, ROTE NDAO, NUSA TENGGARA TIMUR",4,158,0,158
https://kawalpemilu.org#57631,"DAIAMA, LANDU LEKO, ROTE NDAO, NUSA TENGGARA TIMUR",1,129,4,133
https://kawalpemilu.org#57631,"DAIAMA, LANDU LEKO, ROTE NDAO, NUSA TENGGARA TIMUR",2,136,8,144
https://kawalpemilu.org#57631,"DAIAMA, LANDU LEKO, ROTE NDAO, NUSA TENGGARA TIMUR",3,117,2,119
https://kawalpemilu.org#57631,"DAIAMA, LANDU LEKO, ROTE NDAO, NUSA TENGGARA TIMUR",4,183,5,188
https://kawalpemilu.org#57632,"SOTIMORI, LANDU LEKO, ROTE NDAO, NUSA TENGGARA TIMUR",1,87,4,91
https://kawalpemilu.org#57632,"SOTIMORI, LANDU LEKO, ROTE NDAO, NUSA TENGGARA TIMUR",2,197,3,200
https://kawalpemilu.org#57633,"BOLATENA, LANDU LEKO, ROTE NDAO, NUSA TENGGARA TIMUR",1,187,6,193
https://kawalpemilu.org#57633,"BOLATENA, LANDU LEKO, ROTE NDAO, NUSA TENGGARA TIMUR",2,140,7,147
https://kawalpemilu.org#57633,"BOLATENA, LANDU LEKO, ROTE NDAO, NUSA TENGGARA TIMUR",3,118,7,125
https://kawalpemilu.org#85204,"DAEURENDALE, LANDU LEKO, ROTE NDAO, NUSA TENGGARA TIMUR",1,178,19,197
https://kawalpemilu.org#85204,"DAEURENDALE, LANDU LEKO, ROTE NDAO, NUSA TENGGARA TIMUR",2,83,20,103
https://kawalpemilu.org#85204,"DAEURENDALE, LANDU LEKO, ROTE NDAO, NUSA TENGGARA TIMUR",3,85,11,96
https://kawalpemilu.org#85205,"PUKUAFU, LANDU LEKO, ROTE NDAO, NUSA TENGGARA TIMUR",1,114,4,118
https://kawalpemilu.org#85205,"PUKUAFU, LANDU LEKO, ROTE NDAO, NUSA TENGGARA TIMUR",2,108,2,110
https://kawalpemilu.org#90758,"LIFULEO, LANDU LEKO, ROTE NDAO, NUSA TENGGARA TIMUR",1,102,1,103
https://kawalpemilu.org#90758,"LIFULEO, LANDU LEKO, ROTE NDAO, NUSA TENGGARA TIMUR",2,112,1,113
https://kawalpemilu.org#90758,"LIFULEO, LANDU LEKO, ROTE NDAO, NUSA TENGGARA TIMUR",3,209,7,216
https://kawalpemilu.org#931343,"TENA LAI, LANDU LEKO, ROTE NDAO, NUSA TENGGARA TIMUR",1,94,2,96
https://kawalpemilu.org#931343,"TENA LAI, LANDU LEKO, ROTE NDAO, NUSA TENGGARA TIMUR",2,143,12,155
https://kawalpemilu.org#57651,"BARI, MACANG PACAR, MANGGARAI BARAT, NUSA TENGGARA TIMUR",1,175,36,211
https://kawalpemilu.org#57651,"BARI, MACANG PACAR, MANGGARAI BARAT, NUSA TENGGARA TIMUR",2,112,95,207
https://kawalpemilu.org#57651,"BARI, MACANG PACAR, MANGGARAI BARAT, NUSA TENGGARA TIMUR",3,85,95,180
https://kawalpemilu.org#57651,"BARI, MACANG PACAR, MANGGARAI BARAT, NUSA TENGGARA TIMUR",4,48,132,180
https://kawalpemilu.org#57651,"BARI, MACANG PACAR, MANGGARAI BARAT, NUSA TENGGARA TIMUR",5,74,83,157
https://kawalpemilu.org#57651,"BARI, MACANG PACAR, MANGGARAI BARAT, NUSA TENGGARA TIMUR",6,48,101,149
https://kawalpemilu.org#57652,"ROKAP, MACANG PACAR, MANGGARAI BARAT, NUSA TENGGARA TIMUR",1,206,2,208
https://kawalpemilu.org#57652,"ROKAP, MACANG PACAR, MANGGARAI BARAT, NUSA TENGGARA TIMUR",2,108,3,111
https://kawalpemilu.org#57652,"ROKAP, MACANG PACAR, MANGGARAI BARAT, NUSA TENGGARA TIMUR",3,148,2,150
https://kawalpemilu.org#57653,"MBAKUNG, MACANG PACAR, MANGGARAI BARAT, NUSA TENGGARA TIMUR",1,149,6,155
https://kawalpemilu.org#57653,"MBAKUNG, MACANG PACAR, MANGGARAI BARAT, NUSA TENGGARA TIMUR",2,107,4,111
https://kawalpemilu.org#57653,"MBAKUNG, MACANG PACAR, MANGGARAI BARAT, NUSA TENGGARA TIMUR",3,241,15,256
https://kawalpemilu.org#57653,"MBAKUNG, MACANG PACAR, MANGGARAI BARAT, NUSA TENGGARA TIMUR",4,166,1,167
https://kawalpemilu.org#57654,"NGGILAT, MACANG PACAR, MANGGARAI BARAT, NUSA TENGGARA TIMUR",1,101,3,104
https://kawalpemilu.org#57654,"NGGILAT, MACANG PACAR, MANGGARAI BARAT, NUSA TENGGARA TIMUR",2,158,6,164
https://kawalpemilu.org#57654,"NGGILAT, MACANG PACAR, MANGGARAI BARAT, NUSA TENGGARA TIMUR",3,142,7,149
https://kawalpemilu.org#57654,"NGGILAT, MACANG PACAR, MANGGARAI BARAT, NUSA TENGGARA TIMUR",4,157,8,165
https://kawalpemilu.org#57655,"REGO, MACANG PACAR, MANGGARAI BARAT, NUSA TENGGARA TIMUR",1,241,5,246
https://kawalpemilu.org#57655,"REGO, MACANG PACAR, MANGGARAI BARAT, NUSA TENGGARA TIMUR",2,167,5,172
https://kawalpemilu.org#57655,"REGO, MACANG PACAR, MANGGARAI BARAT, NUSA TENGGARA TIMUR",3,151,9,160
https://kawalpemilu.org#57655,"REGO, MACANG PACAR, MANGGARAI BARAT, NUSA TENGGARA TIMUR",4,248,8,256
https://kawalpemilu.org#57656,"WONTONG, MACANG PACAR, MANGGARAI BARAT, NUSA TENGGARA TIMUR",1,250,18,268
https://kawalpemilu.org#57656,"WONTONG, MACANG PACAR, MANGGARAI BARAT, NUSA TENGGARA TIMUR",2,161,5,166
https://kawalpemilu.org#57656,"WONTONG, MACANG PACAR, MANGGARAI BARAT, NUSA TENGGARA TIMUR",3,139,8,147
https://kawalpemilu.org#57656,"WONTONG, MACANG PACAR, MANGGARAI BARAT, NUSA TENGGARA TIMUR",4,132,3,135
https://kawalpemilu.org#57657,"RABA, MACANG PACAR, MANGGARAI BARAT, NUSA TENGGARA TIMUR",1,157,7,164
https://kawalpemilu.org#57657,"RABA, MACANG PACAR, MANGGARAI BARAT, NUSA TENGGARA TIMUR",2,150,4,154
https://kawalpemilu.org#57657,"RABA, MACANG PACAR, MANGGARAI BARAT, NUSA TENGGARA TIMUR",3,148,2,150
https://kawalpemilu.org#57657,"RABA, MACANG PACAR, MANGGARAI BARAT, NUSA TENGGARA TIMUR",4,170,19,189
https://kawalpemilu.org#57658,"NANGA KANTOR, MACANG PACAR, MANGGARAI BARAT, NUSA TENGGARA TIMUR",1,153,8,161
https://kawalpemilu.org#57658,"NANGA KANTOR, MACANG PACAR, MANGGARAI BARAT, NUSA TENGGARA TIMUR",2,181,7,188
https://kawalpemilu.org#57658,"NANGA KANTOR, MACANG PACAR, MANGGARAI BARAT, NUSA TENGGARA TIMUR",3,166,7,173
https://kawalpemilu.org#57658,"NANGA KANTOR, MACANG PACAR, MANGGARAI BARAT, NUSA TENGGARA TIMUR",4,142,8,150
https://kawalpemilu.org#927893,"SARAENARU, MACANG PACAR, MANGGARAI BARAT, NUSA TENGGARA TIMUR",1,79,151,230
https://kawalpemilu.org#927894,"WATU BARU, MACANG PACAR, MANGGARAI BARAT, NUSA TENGGARA TIMUR",1,169,2,171
https://kawalpemilu.org#927894,"WATU BARU, MACANG PACAR, MANGGARAI BARAT, NUSA TENGGARA TIMUR",2,223,12,235
https://kawalpemilu.org#927894,"WATU BARU, MACANG PACAR, MANGGARAI BARAT, NUSA TENGGARA TIMUR",3,134,6,140
https://kawalpemilu.org#927894,"WATU BARU, MACANG PACAR, MANGGARAI BARAT, NUSA TENGGARA TIMUR",4,99,4,103
https://kawalpemilu.org#927895,"LEWAT, MACANG PACAR, MANGGARAI BARAT, NUSA TENGGARA TIMUR",1,152,13,165
https://kawalpemilu.org#927895,"LEWAT, MACANG PACAR, MANGGARAI BARAT, NUSA TENGGARA TIMUR",2,127,3,130
https://kawalpemilu.org#927895,"LEWAT, MACANG PACAR, MANGGARAI BARAT, NUSA TENGGARA TIMUR",3,193,4,197
https://kawalpemilu.org#927895,"LEWAT, MACANG PACAR, MANGGARAI BARAT, NUSA TENGGARA TIMUR",4,192,2,194
https://kawalpemilu.org#927895,"LEWAT, MACANG PACAR, MANGGARAI BARAT, NUSA TENGGARA TIMUR",5,107,8,115
https://kawalpemilu.org#57665,"GOLO RU'U, KUWUS, MANGGARAI BARAT, NUSA TENGGARA TIMUR",1,142,8,150
https://kawalpemilu.org#57665,"GOLO RU'U, KUWUS, MANGGARAI BARAT, NUSA TENGGARA TIMUR",2,175,6,181
https://kawalpemilu.org#57665,"GOLO RU'U, KUWUS, MANGGARAI BARAT, NUSA TENGGARA TIMUR",3,189,4,193
https://kawalpemilu.org#57666,"NANTAL, KUWUS, MANGGARAI BARAT, NUSA TENGGARA TIMUR",3,235,11,246
https://kawalpemilu.org#57668,"COAL, KUWUS, MANGGARAI BARAT, NUSA TENGGARA TIMUR",1,138,5,143
https://kawalpemilu.org#57668,"COAL, KUWUS, MANGGARAI BARAT, NUSA TENGGARA TIMUR",2,166,10,176
https://kawalpemilu.org#57668,"COAL, KUWUS, MANGGARAI BARAT, NUSA TENGGARA TIMUR",3,158,11,169
https://kawalpemilu.org#57668,"COAL, KUWUS, MANGGARAI BARAT, NUSA TENGGARA TIMUR",4,119,9,128
https://kawalpemilu.org#57668,"COAL, KUWUS, MANGGARAI BARAT, NUSA TENGGARA TIMUR",5,77,7,84
https://kawalpemilu.org#57683,"COMPANG SUKA, KUWUS, MANGGARAI BARAT, NUSA TENGGARA TIMUR",1,254,48,302
https://kawalpemilu.org#57683,"COMPANG SUKA, KUWUS, MANGGARAI BARAT, NUSA TENGGARA TIMUR",2,163,7,170
https://kawalpemilu.org#57684,"BENTENG SURU, KUWUS, MANGGARAI BARAT, NUSA TENGGARA TIMUR",1,171,10,181
https://kawalpemilu.org#57684,"BENTENG SURU, KUWUS, MANGGARAI BARAT, NUSA TENGGARA TIMUR",2,163,10,173
https://kawalpemilu.org#57684,"BENTENG SURU, KUWUS, MANGGARAI BARAT, NUSA TENGGARA TIMUR",3,177,11,188
https://kawalpemilu.org#57684,"BENTENG SURU, KUWUS, MANGGARAI BARAT, NUSA TENGGARA TIMUR",4,193,14,207
https://kawalpemilu.org#57684,"BENTENG SURU, KUWUS, MANGGARAI BARAT, NUSA TENGGARA TIMUR",5,186,9,195
https://kawalpemilu.org#927907,"BANGKA LEWAT, KUWUS, MANGGARAI BARAT, NUSA TENGGARA TIMUR",1,198,2,200
https://kawalpemilu.org#927907,"BANGKA LEWAT, KUWUS, MANGGARAI BARAT, NUSA TENGGARA TIMUR",2,199,5,204
https://kawalpemilu.org#927907,"BANGKA LEWAT, KUWUS, MANGGARAI BARAT, NUSA TENGGARA TIMUR",3,193,9,202
https://kawalpemilu.org#927909,"GOLO PUA, KUWUS, MANGGARAI BARAT, NUSA TENGGARA TIMUR",1,215,10,225
https://kawalpemilu.org#927909,"GOLO PUA, KUWUS, MANGGARAI BARAT, NUSA TENGGARA TIMUR",2,139,8,147
https://kawalpemilu.org#57693,"TANGGE, LEMBOR, MANGGARAI BARAT, NUSA TENGGARA TIMUR",1,150,26,176
https://kawalpemilu.org#57693,"TANGGE, LEMBOR, MANGGARAI BARAT, NUSA TENGGARA TIMUR",2,129,22,151
https://kawalpemilu.org#57693,"TANGGE, LEMBOR, MANGGARAI BARAT, NUSA TENGGARA TIMUR",3,182,15,197
https://kawalpemilu.org#57693,"TANGGE, LEMBOR, MANGGARAI BARAT, NUSA TENGGARA TIMUR",4,149,37,186
https://kawalpemilu.org#57693,"TANGGE, LEMBOR, MANGGARAI BARAT, NUSA TENGGARA TIMUR",5,122,62,184
https://kawalpemilu.org#57693,"TANGGE, LEMBOR, MANGGARAI BARAT, NUSA TENGGARA TIMUR",6,139,43,182
https://kawalpemilu.org#57693,"TANGGE, LEMBOR, MANGGARAI BARAT, NUSA TENGGARA TIMUR",7,140,26,166
https://kawalpemilu.org#57693,"TANGGE, LEMBOR, MANGGARAI BARAT, NUSA TENGGARA TIMUR",8,133,9,142
https://kawalpemilu.org#57693,"TANGGE, LEMBOR, MANGGARAI BARAT, NUSA TENGGARA TIMUR",9,140,18,158
https://kawalpemilu.org#57693,"TANGGE, LEMBOR, MANGGARAI BARAT, NUSA TENGGARA TIMUR",10,171,34,205
https://kawalpemilu.org#57693,"TANGGE, LEMBOR, MANGGARAI BARAT, NUSA TENGGARA TIMUR",11,168,19,187
https://kawalpemilu.org#57693,"TANGGE, LEMBOR, MANGGARAI BARAT, NUSA TENGGARA TIMUR",12,124,10,134
https://kawalpemilu.org#57693,"TANGGE, LEMBOR, MANGGARAI BARAT, NUSA TENGGARA TIMUR",13,181,8,189
https://kawalpemilu.org#57693,"TANGGE, LEMBOR, MANGGARAI BARAT, NUSA TENGGARA TIMUR",14,138,97,235
https://kawalpemilu.org#57693,"TANGGE, LEMBOR, MANGGARAI BARAT, NUSA TENGGARA TIMUR",15,66,117,183
https://kawalpemilu.org#57693,"TANGGE, LEMBOR, MANGGARAI BARAT, NUSA TENGGARA TIMUR",16,113,81,194
https://kawalpemilu.org#57693,"TANGGE, LEMBOR, MANGGARAI BARAT, NUSA TENGGARA TIMUR",17,97,115,212
https://kawalpemilu.org#57696,"WAE WAKO, LEMBOR, MANGGARAI BARAT, NUSA TENGGARA TIMUR",1,107,64,171
https://kawalpemilu.org#57696,"WAE WAKO, LEMBOR, MANGGARAI BARAT, NUSA TENGGARA TIMUR",2,149,49,198
https://kawalpemilu.org#57696,"WAE WAKO, LEMBOR, MANGGARAI BARAT, NUSA TENGGARA TIMUR",3,100,54,154
https://kawalpemilu.org#57696,"WAE WAKO, LEMBOR, MANGGARAI BARAT, NUSA TENGGARA TIMUR",4,122,17,139
https://kawalpemilu.org#57697,"WAE KANTA, LEMBOR, MANGGARAI BARAT, NUSA TENGGARA TIMUR",1,210,8,218
https://kawalpemilu.org#57697,"WAE KANTA, LEMBOR, MANGGARAI BARAT, NUSA TENGGARA TIMUR",2,182,10,192
https://kawalpemilu.org#57697,"WAE KANTA, LEMBOR, MANGGARAI BARAT, NUSA TENGGARA TIMUR",3,203,2,205
https://kawalpemilu.org#57697,"WAE KANTA, LEMBOR, MANGGARAI BARAT, NUSA TENGGARA TIMUR",4,106,3,109
https://kawalpemilu.org#57697,"WAE KANTA, LEMBOR, MANGGARAI BARAT, NUSA TENGGARA TIMUR",5,202,5,207
https://kawalpemilu.org#57697,"WAE KANTA, LEMBOR, MANGGARAI BARAT, NUSA TENGGARA TIMUR",6,167,4,171
https://kawalpemilu.org#57697,"WAE KANTA, LEMBOR, MANGGARAI BARAT, NUSA TENGGARA TIMUR",7,231,13,244
https://kawalpemilu.org#57699,"WAE BANGKA, LEMBOR, MANGGARAI BARAT, NUSA TENGGARA TIMUR",1,115,2,117
https://kawalpemilu.org#57699,"WAE BANGKA, LEMBOR, MANGGARAI BARAT, NUSA TENGGARA TIMUR",2,155,3,158
https://kawalpemilu.org#57699,"WAE BANGKA, LEMBOR, MANGGARAI BARAT, NUSA TENGGARA TIMUR",3,128,9,137
https://kawalpemilu.org#57699,"WAE BANGKA, LEMBOR, MANGGARAI BARAT, NUSA TENGGARA TIMUR",4,199,3,202
https://kawalpemilu.org#57699,"WAE BANGKA, LEMBOR, MANGGARAI BARAT, NUSA TENGGARA TIMUR",5,192,4,196
https://kawalpemilu.org#57699,"WAE BANGKA, LEMBOR, MANGGARAI BARAT, NUSA TENGGARA TIMUR",6,190,4,194
https://kawalpemilu.org#57699,"WAE BANGKA, LEMBOR, MANGGARAI BARAT, NUSA TENGGARA TIMUR",7,155,3,158
https://kawalpemilu.org#57700,"PONG MAJOK, LEMBOR, MANGGARAI BARAT, NUSA TENGGARA TIMUR",1,144,7,151
https://kawalpemilu.org#57700,"PONG MAJOK, LEMBOR, MANGGARAI BARAT, NUSA TENGGARA TIMUR",2,94,2,96
https://kawalpemilu.org#57700,"PONG MAJOK, LEMBOR, MANGGARAI BARAT, NUSA TENGGARA TIMUR",3,248,9,257
https://kawalpemilu.org#57700,"PONG MAJOK, LEMBOR, MANGGARAI BARAT, NUSA TENGGARA TIMUR",4,175,4,179
https://kawalpemilu.org#57700,"PONG MAJOK, LEMBOR, MANGGARAI BARAT, NUSA TENGGARA TIMUR",5,158,1,159
https://kawalpemilu.org#57700,"PONG MAJOK, LEMBOR, MANGGARAI BARAT, NUSA TENGGARA TIMUR",6,189,16,205
https://kawalpemilu.org#57700,"PONG MAJOK, LEMBOR, MANGGARAI BARAT, NUSA TENGGARA TIMUR",7,229,13,242
https://kawalpemilu.org#57701,"DALENG, LEMBOR, MANGGARAI BARAT, NUSA TENGGARA TIMUR",1,132,1,133
https://kawalpemilu.org#57701,"DALENG, LEMBOR, MANGGARAI BARAT, NUSA TENGGARA TIMUR",2,138,10,148
https://kawalpemilu.org#57701,"DALENG, LEMBOR, MANGGARAI BARAT, NUSA TENGGARA TIMUR",3,204,3,207
https://kawalpemilu.org#57701,"DALENG, LEMBOR, MANGGARAI BARAT, NUSA TENGGARA TIMUR",4,199,17,216
https://kawalpemilu.org#57701,"DALENG, LEMBOR, MANGGARAI BARAT, NUSA TENGGARA TIMUR",5,209,5,214
https://kawalpemilu.org#57701,"DALENG, LEMBOR, MANGGARAI BARAT, NUSA TENGGARA TIMUR",6,207,12,219
https://kawalpemilu.org#57701,"DALENG, LEMBOR, MANGGARAI BARAT, NUSA TENGGARA TIMUR",7,234,7,241
https://kawalpemilu.org#57701,"DALENG, LEMBOR, MANGGARAI BARAT, NUSA TENGGARA TIMUR",8,159,13,172
https://kawalpemilu.org#57701,"DALENG, LEMBOR, MANGGARAI BARAT, NUSA TENGGARA TIMUR",9,89,6,95
https://kawalpemilu.org#57709,"PONDO, LEMBOR, MANGGARAI BARAT, NUSA TENGGARA TIMUR",1,199,6,205
https://kawalpemilu.org#57709,"PONDO, LEMBOR, MANGGARAI BARAT, NUSA TENGGARA TIMUR",2,138,3,141
https://kawalpemilu.org#57709,"PONDO, LEMBOR, MANGGARAI BARAT, NUSA TENGGARA TIMUR",3,102,10,112
https://kawalpemilu.org#57709,"PONDO, LEMBOR, MANGGARAI BARAT, NUSA TENGGARA TIMUR",4,171,6,177
https://kawalpemilu.org#57709,"PONDO, LEMBOR, MANGGARAI BARAT, NUSA TENGGARA TIMUR",5,205,17,222
https://kawalpemilu.org#57709,"PONDO, LEMBOR, MANGGARAI BARAT, NUSA TENGGARA TIMUR",6,138,12,150
https://kawalpemilu.org#57710,"POCO RUTANG, LEMBOR, MANGGARAI BARAT, NUSA TENGGARA TIMUR",1,213,16,229
https://kawalpemilu.org#57710,"POCO RUTANG, LEMBOR, MANGGARAI BARAT, NUSA TENGGARA TIMUR",2,164,7,171
https://kawalpemilu.org#57710,"POCO RUTANG, LEMBOR, MANGGARAI BARAT, NUSA TENGGARA TIMUR",3,185,10,195
https://kawalpemilu.org#57710,"POCO RUTANG, LEMBOR, MANGGARAI BARAT, NUSA TENGGARA TIMUR",4,143,11,154
https://kawalpemilu.org#57710,"POCO RUTANG, LEMBOR, MANGGARAI BARAT, NUSA TENGGARA TIMUR",5,101,4,105
https://kawalpemilu.org#57710,"POCO RUTANG, LEMBOR, MANGGARAI BARAT, NUSA TENGGARA TIMUR",6,105,60,165
https://kawalpemilu.org#57710,"POCO RUTANG, LEMBOR, MANGGARAI BARAT, NUSA TENGGARA TIMUR",7,123,57,180
https://kawalpemilu.org#57711,"NGANCAR, LEMBOR, MANGGARAI BARAT, NUSA TENGGARA TIMUR",1,152,14,166
https://kawalpemilu.org#57711,"NGANCAR, LEMBOR, MANGGARAI BARAT, NUSA TENGGARA TIMUR",2,0,0,0
https://kawalpemilu.org#57711,"NGANCAR, LEMBOR, MANGGARAI BARAT, NUSA TENGGARA TIMUR",3,121,3,124
https://kawalpemilu.org#57711,"NGANCAR, LEMBOR, MANGGARAI BARAT, NUSA TENGGARA TIMUR",4,169,7,176
https://kawalpemilu.org#57711,"NGANCAR, LEMBOR, MANGGARAI BARAT, NUSA TENGGARA TIMUR",5,0,0,0
https://kawalpemilu.org#57711,"NGANCAR, LEMBOR, MANGGARAI BARAT, NUSA TENGGARA TIMUR",6,148,2,150
https://kawalpemilu.org#927912,"GOLO NDEWENG, LEMBOR, MANGGARAI BARAT, NUSA TENGGARA TIMUR",1,188,12,200
https://kawalpemilu.org#927912,"GOLO NDEWENG, LEMBOR, MANGGARAI BARAT, NUSA TENGGARA TIMUR",2,117,8,125
https://kawalpemilu.org#927912,"GOLO NDEWENG, LEMBOR, MANGGARAI BARAT, NUSA TENGGARA TIMUR",3,128,7,135
https://kawalpemilu.org#927912,"GOLO NDEWENG, LEMBOR, MANGGARAI BARAT, NUSA TENGGARA TIMUR",4,152,7,159
https://kawalpemilu.org#927913,"WAE MOWOL, LEMBOR, MANGGARAI BARAT, NUSA TENGGARA TIMUR",1,132,9,141
https://kawalpemilu.org#927913,"WAE MOWOL, LEMBOR, MANGGARAI BARAT, NUSA TENGGARA TIMUR",2,191,3,194
https://kawalpemilu.org#927913,"WAE MOWOL, LEMBOR, MANGGARAI BARAT, NUSA TENGGARA TIMUR",3,96,3,99
https://kawalpemilu.org#927913,"WAE MOWOL, LEMBOR, MANGGARAI BARAT, NUSA TENGGARA TIMUR",4,120,6,126
https://kawalpemilu.org#927913,"WAE MOWOL, LEMBOR, MANGGARAI BARAT, NUSA TENGGARA TIMUR",5,120,6,126
https://kawalpemilu.org#927913,"WAE MOWOL, LEMBOR, MANGGARAI BARAT, NUSA TENGGARA TIMUR",6,130,6,136
https://kawalpemilu.org#927914,"LIANG SOLA, LEMBOR, MANGGARAI BARAT, NUSA TENGGARA TIMUR",1,170,14,184
https://kawalpemilu.org#927914,"LIANG SOLA, LEMBOR, MANGGARAI BARAT, NUSA TENGGARA TIMUR",2,145,6,151
https://kawalpemilu.org#927914,"LIANG SOLA, LEMBOR, MANGGARAI BARAT, NUSA TENGGARA TIMUR",3,221,7,228
https://kawalpemilu.org#927914,"LIANG SOLA, LEMBOR, MANGGARAI BARAT, NUSA TENGGARA TIMUR",4,206,9,215
https://kawalpemilu.org#57715,"GOLO NDARING, SANO NGGOANG, MANGGARAI BARAT, NUSA TENGGARA TIMUR",1,143,15,158
https://kawalpemilu.org#57715,"GOLO NDARING, SANO NGGOANG, MANGGARAI BARAT, NUSA TENGGARA TIMUR",2,100,33,133
https://kawalpemilu.org#57715,"GOLO NDARING, SANO NGGOANG, MANGGARAI BARAT, NUSA TENGGARA TIMUR",3,127,22,149
https://kawalpemilu.org#57715,"GOLO NDARING, SANO NGGOANG, MANGGARAI BARAT, NUSA TENGGARA TIMUR",4,78,3,81
https://kawalpemilu.org#57719,"GOLO KEMPO, SANO NGGOANG, MANGGARAI BARAT, NUSA TENGGARA TIMUR",1,139,5,144
https://kawalpemilu.org#57719,"GOLO KEMPO, SANO NGGOANG, MANGGARAI BARAT, NUSA TENGGARA TIMUR",2,141,26,167
https://kawalpemilu.org#57722,"GOLO MANTING, SANO NGGOANG, MANGGARAI BARAT, NUSA TENGGARA TIMUR",1,145,69,214
https://kawalpemilu.org#57722,"GOLO MANTING, SANO NGGOANG, MANGGARAI BARAT, NUSA TENGGARA TIMUR",2,195,14,209
https://kawalpemilu.org#57722,"GOLO MANTING, SANO NGGOANG, MANGGARAI BARAT, NUSA TENGGARA TIMUR",3,134,13,147
https://kawalpemilu.org#57723,"MATA WAE, SANO NGGOANG, MANGGARAI BARAT, NUSA TENGGARA TIMUR",1,81,79,160
https://kawalpemilu.org#57723,"MATA WAE, SANO NGGOANG, MANGGARAI BARAT, NUSA TENGGARA TIMUR",2,27,44,71
https://kawalpemilu.org#57723,"MATA WAE, SANO NGGOANG, MANGGARAI BARAT, NUSA TENGGARA TIMUR",3,61,88,149
https://kawalpemilu.org#57723,"MATA WAE, SANO NGGOANG, MANGGARAI BARAT, NUSA TENGGARA TIMUR",4,22,94,116
https://kawalpemilu.org#57723,"MATA WAE, SANO NGGOANG, MANGGARAI BARAT, NUSA TENGGARA TIMUR",5,126,32,158
https://kawalpemilu.org#57723,"MATA WAE, SANO NGGOANG, MANGGARAI BARAT, NUSA TENGGARA TIMUR",6,31,32,63
https://kawalpemilu.org#57725,"NAMPAR MACING, SANO NGGOANG, MANGGARAI BARAT, NUSA TENGGARA TIMUR",1,112,12,124
https://kawalpemilu.org#57725,"NAMPAR MACING, SANO NGGOANG, MANGGARAI BARAT, NUSA TENGGARA TIMUR",2,132,16,148
https://kawalpemilu.org#57725,"NAMPAR MACING, SANO NGGOANG, MANGGARAI BARAT, NUSA TENGGARA TIMUR",3,178,5,183
https://kawalpemilu.org#57725,"NAMPAR MACING, SANO NGGOANG, MANGGARAI BARAT, NUSA TENGGARA TIMUR",4,77,19,96
https://kawalpemilu.org#57725,"NAMPAR MACING, SANO NGGOANG, MANGGARAI BARAT, NUSA TENGGARA TIMUR",5,111,8,119
https://kawalpemilu.org#57725,"NAMPAR MACING, SANO NGGOANG, MANGGARAI BARAT, NUSA TENGGARA TIMUR",6,90,4,94
https://kawalpemilu.org#57725,"NAMPAR MACING, SANO NGGOANG, MANGGARAI BARAT, NUSA TENGGARA TIMUR",7,146,9,155
https://kawalpemilu.org#57728,"WAE SANO, SANO NGGOANG, MANGGARAI BARAT, NUSA TENGGARA TIMUR",1,90,11,101
https://kawalpemilu.org#57728,"WAE SANO, SANO NGGOANG, MANGGARAI BARAT, NUSA TENGGARA TIMUR",2,60,2,62
https://kawalpemilu.org#57728,"WAE SANO, SANO NGGOANG, MANGGARAI BARAT, NUSA TENGGARA TIMUR",3,117,18,135
https://kawalpemilu.org#57728,"WAE SANO, SANO NGGOANG, MANGGARAI BARAT, NUSA TENGGARA TIMUR",4,90,16,106
https://kawalpemilu.org#57728,"WAE SANO, SANO NGGOANG, MANGGARAI BARAT, NUSA TENGGARA TIMUR",5,142,12,154
https://kawalpemilu.org#57728,"WAE SANO, SANO NGGOANG, MANGGARAI BARAT, NUSA TENGGARA TIMUR",6,72,6,78
https://kawalpemilu.org#57730,"GOLO MBU, SANO NGGOANG, MANGGARAI BARAT, NUSA TENGGARA TIMUR",1,186,12,198
https://kawalpemilu.org#57730,"GOLO MBU, SANO NGGOANG, MANGGARAI BARAT, NUSA TENGGARA TIMUR",2,190,33,223
https://kawalpemilu.org#57730,"GOLO MBU, SANO NGGOANG, MANGGARAI BARAT, NUSA TENGGARA TIMUR",3,170,47,217
https://kawalpemilu.org#57730,"GOLO MBU, SANO NGGOANG, MANGGARAI BARAT, NUSA TENGGARA TIMUR",4,84,6,90
https://kawalpemilu.org#57731,"GOLO LELENG, SANO NGGOANG, MANGGARAI BARAT, NUSA TENGGARA TIMUR",1,183,42,225
https://kawalpemilu.org#57731,"GOLO LELENG, SANO NGGOANG, MANGGARAI BARAT, NUSA TENGGARA TIMUR",2,76,7,83
https://kawalpemilu.org#57731,"GOLO LELENG, SANO NGGOANG, MANGGARAI BARAT, NUSA TENGGARA TIMUR",3,131,18,149
https://kawalpemilu.org#57731,"GOLO LELENG, SANO NGGOANG, MANGGARAI BARAT, NUSA TENGGARA TIMUR",4,187,22,209
https://kawalpemilu.org#57731,"GOLO LELENG, SANO NGGOANG, MANGGARAI BARAT, NUSA TENGGARA TIMUR",5,170,18,188
https://kawalpemilu.org#57732,"SANO NGGOANG, SANO NGGOANG, MANGGARAI BARAT, NUSA TENGGARA TIMUR",1,82,6,88
https://kawalpemilu.org#57732,"SANO NGGOANG, SANO NGGOANG, MANGGARAI BARAT, NUSA TENGGARA TIMUR",2,144,25,169
https://kawalpemilu.org#57732,"SANO NGGOANG, SANO NGGOANG, MANGGARAI BARAT, NUSA TENGGARA TIMUR",3,189,50,239
https://kawalpemilu.org#57732,"SANO NGGOANG, SANO NGGOANG, MANGGARAI BARAT, NUSA TENGGARA TIMUR",4,79,15,94
https://kawalpemilu.org#57734,"WAE LOLOS, SANO NGGOANG, MANGGARAI BARAT, NUSA TENGGARA TIMUR",1,108,18,126
https://kawalpemilu.org#57734,"WAE LOLOS, SANO NGGOANG, MANGGARAI BARAT, NUSA TENGGARA TIMUR",2,93,2,95
https://kawalpemilu.org#57734,"WAE LOLOS, SANO NGGOANG, MANGGARAI BARAT, NUSA TENGGARA TIMUR",3,38,2,40
https://kawalpemilu.org#57734,"WAE LOLOS, SANO NGGOANG, MANGGARAI BARAT, NUSA TENGGARA TIMUR",4,98,8,106
https://kawalpemilu.org#57738,"GOLO SENGANG, SANO NGGOANG, MANGGARAI BARAT, NUSA TENGGARA TIMUR",1,77,50,127
https://kawalpemilu.org#57738,"GOLO SENGANG, SANO NGGOANG, MANGGARAI BARAT, NUSA TENGGARA TIMUR",2,63,138,201
https://kawalpemilu.org#57738,"GOLO SENGANG, SANO NGGOANG, MANGGARAI BARAT, NUSA TENGGARA TIMUR",3,87,47,134
https://kawalpemilu.org#927915,"WATU PANGGAL, SANO NGGOANG, MANGGARAI BARAT, NUSA TENGGARA TIMUR",1,158,20,178
https://kawalpemilu.org#927915,"WATU PANGGAL, SANO NGGOANG, MANGGARAI BARAT, NUSA TENGGARA TIMUR",2,62,3,65
https://kawalpemilu.org#927916,"POCO GOLO KEMPO, SANO NGGOANG, MANGGARAI BARAT, NUSA TENGGARA TIMUR",1,55,55,110
https://kawalpemilu.org#927916,"POCO GOLO KEMPO, SANO NGGOANG, MANGGARAI BARAT, NUSA TENGGARA TIMUR",2,58,28,86
https://kawalpemilu.org#927916,"POCO GOLO KEMPO, SANO NGGOANG, MANGGARAI BARAT, NUSA TENGGARA TIMUR",3,112,4,116
https://kawalpemilu.org#927917,"GOLO KONDENG, SANO NGGOANG, MANGGARAI BARAT, NUSA TENGGARA TIMUR",1,120,20,140
https://kawalpemilu.org#927917,"GOLO KONDENG, SANO NGGOANG, MANGGARAI BARAT, NUSA TENGGARA TIMUR",2,91,6,97
https://kawalpemilu.org#927917,"GOLO KONDENG, SANO NGGOANG, MANGGARAI BARAT, NUSA TENGGARA TIMUR",3,60,5,65
https://kawalpemilu.org#927918,"PULAU NUNCUNG, SANO NGGOANG, MANGGARAI BARAT, NUSA TENGGARA TIMUR",1,172,8,180
https://kawalpemilu.org#927918,"PULAU NUNCUNG, SANO NGGOANG, MANGGARAI BARAT, NUSA TENGGARA TIMUR",2,121,15,136
https://kawalpemilu.org#57740,"WAE KELAMBU, KOMODO, MANGGARAI BARAT, NUSA TENGGARA TIMUR",1,207,7,214
https://kawalpemilu.org#57740,"WAE KELAMBU, KOMODO, MANGGARAI BARAT, NUSA TENGGARA TIMUR",2,182,25,207
https://kawalpemilu.org#57740,"WAE KELAMBU, KOMODO, MANGGARAI BARAT, NUSA TENGGARA TIMUR",3,159,77,236
https://kawalpemilu.org#57740,"WAE KELAMBU, KOMODO, MANGGARAI BARAT, NUSA TENGGARA TIMUR",4,111,53,164
https://kawalpemilu.org#57740,"WAE KELAMBU, KOMODO, MANGGARAI BARAT, NUSA TENGGARA TIMUR",5,185,47,232
https://kawalpemilu.org#57740,"WAE KELAMBU, KOMODO, MANGGARAI BARAT, NUSA TENGGARA TIMUR",6,209,9,218
https://kawalpemilu.org#57740,"WAE KELAMBU, KOMODO, MANGGARAI BARAT, NUSA TENGGARA TIMUR",7,200,15,215
https://kawalpemilu.org#57740,"WAE KELAMBU, KOMODO, MANGGARAI BARAT, NUSA TENGGARA TIMUR",8,92,115,207
https://kawalpemilu.org#57740,"WAE KELAMBU, KOMODO, MANGGARAI BARAT, NUSA TENGGARA TIMUR",9,208,24,232
https://kawalpemilu.org#57740,"WAE KELAMBU, KOMODO, MANGGARAI BARAT, NUSA TENGGARA TIMUR",10,168,3,171
https://kawalpemilu.org#57740,"WAE KELAMBU, KOMODO, MANGGARAI BARAT, NUSA TENGGARA TIMUR",11,230,9,239
https://kawalpemilu.org#57740,"WAE KELAMBU, KOMODO, MANGGARAI BARAT, NUSA TENGGARA TIMUR",12,180,5,185
https://kawalpemilu.org#57740,"WAE KELAMBU, KOMODO, MANGGARAI BARAT, NUSA TENGGARA TIMUR",13,211,9,220
https://kawalpemilu.org#57740,"WAE KELAMBU, KOMODO, MANGGARAI BARAT, NUSA TENGGARA TIMUR",14,237,11,248
https://kawalpemilu.org#57740,"WAE KELAMBU, KOMODO, MANGGARAI BARAT, NUSA TENGGARA TIMUR",15,217,8,225
https://kawalpemilu.org#57740,"WAE KELAMBU, KOMODO, MANGGARAI BARAT, NUSA TENGGARA TIMUR",16,135,14,149
https://kawalpemilu.org#57741,"LABUAN BAJO, KOMODO, MANGGARAI BARAT, NUSA TENGGARA TIMUR",1,85,69,154
https://kawalpemilu.org#57741,"LABUAN BAJO, KOMODO, MANGGARAI BARAT, NUSA TENGGARA TIMUR",2,118,86,204
https://kawalpemilu.org#57741,"LABUAN BAJO, KOMODO, MANGGARAI BARAT, NUSA TENGGARA TIMUR",3,125,38,163
https://kawalpemilu.org#57741,"LABUAN BAJO, KOMODO, MANGGARAI BARAT, NUSA TENGGARA TIMUR",4,124,54,178
https://kawalpemilu.org#57741,"LABUAN BAJO, KOMODO, MANGGARAI BARAT, NUSA TENGGARA TIMUR",5,169,84,253
https://kawalpemilu.org#57741,"LABUAN BAJO, KOMODO, MANGGARAI BARAT, NUSA TENGGARA TIMUR",6,76,149,225
https://kawalpemilu.org#57741,"LABUAN BAJO, KOMODO, MANGGARAI BARAT, NUSA TENGGARA TIMUR",7,47,109,156
https://kawalpemilu.org#57741,"LABUAN BAJO, KOMODO, MANGGARAI BARAT, NUSA TENGGARA TIMUR",8,91,136,227
https://kawalpemilu.org#57741,"LABUAN BAJO, KOMODO, MANGGARAI BARAT, NUSA TENGGARA TIMUR",9,61,93,154
https://kawalpemilu.org#57741,"LABUAN BAJO, KOMODO, MANGGARAI BARAT, NUSA TENGGARA TIMUR",10,75,105,180
https://kawalpemilu.org#57741,"LABUAN BAJO, KOMODO, MANGGARAI BARAT, NUSA TENGGARA TIMUR",11,50,53,103
https://kawalpemilu.org#57741,"LABUAN BAJO, KOMODO, MANGGARAI BARAT, NUSA TENGGARA TIMUR",12,75,79,154
https://kawalpemilu.org#57741,"LABUAN BAJO, KOMODO, MANGGARAI BARAT, NUSA TENGGARA TIMUR",13,67,144,211
https://kawalpemilu.org#57741,"LABUAN BAJO, KOMODO, MANGGARAI BARAT, NUSA TENGGARA TIMUR",14,136,56,192
https://kawalpemilu.org#57741,"LABUAN BAJO, KOMODO, MANGGARAI BARAT, NUSA TENGGARA TIMUR",15,161,81,242
https://kawalpemilu.org#57741,"LABUAN BAJO, KOMODO, MANGGARAI BARAT, NUSA TENGGARA TIMUR",16,134,66,200
https://kawalpemilu.org#57741,"LABUAN BAJO, KOMODO, MANGGARAI BARAT, NUSA TENGGARA TIMUR",17,165,10,175
https://kawalpemilu.org#57742,"KOMODO, KOMODO, MANGGARAI BARAT, NUSA TENGGARA TIMUR",1,61,109,170
https://kawalpemilu.org#57742,"KOMODO, KOMODO, MANGGARAI BARAT, NUSA TENGGARA TIMUR",2,65,106,171
https://kawalpemilu.org#57742,"KOMODO, KOMODO, MANGGARAI BARAT, NUSA TENGGARA TIMUR",3,51,65,116
https://kawalpemilu.org#57742,"KOMODO, KOMODO, MANGGARAI BARAT, NUSA TENGGARA TIMUR",4,78,88,166
https://kawalpemilu.org#57742,"KOMODO, KOMODO, MANGGARAI BARAT, NUSA TENGGARA TIMUR",5,0,0,0
https://kawalpemilu.org#57742,"KOMODO, KOMODO, MANGGARAI BARAT, NUSA TENGGARA TIMUR",6,64,60,124
https://kawalpemilu.org#57743,"PASIR PUTIH, KOMODO, MANGGARAI BARAT, NUSA TENGGARA TIMUR",1,16,196,212
https://kawalpemilu.org#57743,"PASIR PUTIH, KOMODO, MANGGARAI BARAT, NUSA TENGGARA TIMUR",2,17,253,270
https://kawalpemilu.org#57743,"PASIR PUTIH, KOMODO, MANGGARAI BARAT, NUSA TENGGARA TIMUR",3,15,233,248
https://kawalpemilu.org#57743,"PASIR PUTIH, KOMODO, MANGGARAI BARAT, NUSA TENGGARA TIMUR",4,25,198,223
https://kawalpemilu.org#57743,"PASIR PUTIH, KOMODO, MANGGARAI BARAT, NUSA TENGGARA TIMUR",5,22,219,241
https://kawalpemilu.org#57745,"GOLO MORI, KOMODO, MANGGARAI BARAT, NUSA TENGGARA TIMUR",1,57,165,222
https://kawalpemilu.org#57745,"GOLO MORI, KOMODO, MANGGARAI BARAT, NUSA TENGGARA TIMUR",2,35,147,182
https://kawalpemilu.org#57745,"GOLO MORI, KOMODO, MANGGARAI BARAT, NUSA TENGGARA TIMUR",3,47,204,251
https://kawalpemilu.org#57745,"GOLO MORI, KOMODO, MANGGARAI BARAT, NUSA TENGGARA TIMUR",4,57,81,138
https://kawalpemilu.org#57745,"GOLO MORI, KOMODO, MANGGARAI BARAT, NUSA TENGGARA TIMUR",5,43,84,127
https://kawalpemilu.org#57745,"GOLO MORI, KOMODO, MANGGARAI BARAT, NUSA TENGGARA TIMUR",6,36,62,98
https://kawalpemilu.org#57746,"WARLOKA, KOMODO, MANGGARAI BARAT, NUSA TENGGARA TIMUR",1,27,148,175
https://kawalpemilu.org#57746,"WARLOKA, KOMODO, MANGGARAI BARAT, NUSA TENGGARA TIMUR",2,26,128,154
https://kawalpemilu.org#57746,"WARLOKA, KOMODO, MANGGARAI BARAT, NUSA TENGGARA TIMUR",3,184,5,189
https://kawalpemilu.org#57746,"WARLOKA, KOMODO, MANGGARAI BARAT, NUSA TENGGARA TIMUR",4,59,210,269
https://kawalpemilu.org#57746,"WARLOKA, KOMODO, MANGGARAI BARAT, NUSA TENGGARA TIMUR",5,73,167,240
https://kawalpemilu.org#57747,"GOLO BILAS, KOMODO, MANGGARAI BARAT, NUSA TENGGARA TIMUR",1,74,100,174
https://kawalpemilu.org#57747,"GOLO BILAS, KOMODO, MANGGARAI BARAT, NUSA TENGGARA TIMUR",2,115,120,235
https://kawalpemilu.org#57747,"GOLO BILAS, KOMODO, MANGGARAI BARAT, NUSA TENGGARA TIMUR",3,141,94,235
https://kawalpemilu.org#57747,"GOLO BILAS, KOMODO, MANGGARAI BARAT, NUSA TENGGARA TIMUR",4,87,109,196
https://kawalpemilu.org#57747,"GOLO BILAS, KOMODO, MANGGARAI BARAT, NUSA TENGGARA TIMUR",5,73,150,223
https://kawalpemilu.org#57747,"GOLO BILAS, KOMODO, MANGGARAI BARAT, NUSA TENGGARA TIMUR",6,31,73,104
https://kawalpemilu.org#57747,"GOLO BILAS, KOMODO, MANGGARAI BARAT, NUSA TENGGARA TIMUR",7,199,14,213
https://kawalpemilu.org#57747,"GOLO BILAS, KOMODO, MANGGARAI BARAT, NUSA TENGGARA TIMUR",8,172,5,177
https://kawalpemilu.org#57747,"GOLO BILAS, KOMODO, MANGGARAI BARAT, NUSA TENGGARA TIMUR",9,136,1,137
https://kawalpemilu.org#57747,"GOLO BILAS, KOMODO, MANGGARAI BARAT, NUSA TENGGARA TIMUR",10,190,4,194
https://kawalpemilu.org#57747,"GOLO BILAS, KOMODO, MANGGARAI BARAT, NUSA TENGGARA TIMUR",11,174,4,178
https://kawalpemilu.org#57747,"GOLO BILAS, KOMODO, MANGGARAI BARAT, NUSA TENGGARA TIMUR",12,167,6,173
https://kawalpemilu.org#57748,"MACANG TANGGAR, KOMODO, MANGGARAI BARAT, NUSA TENGGARA TIMUR",1,137,102,239
https://kawalpemilu.org#57748,"MACANG TANGGAR, KOMODO, MANGGARAI BARAT, NUSA TENGGARA TIMUR",2,71,165,236
https://kawalpemilu.org#57748,"MACANG TANGGAR, KOMODO, MANGGARAI BARAT, NUSA TENGGARA TIMUR",3,34,93,127
https://kawalpemilu.org#57748,"MACANG TANGGAR, KOMODO, MANGGARAI BARAT, NUSA TENGGARA TIMUR",4,17,167,184
https://kawalpemilu.org#57748,"MACANG TANGGAR, KOMODO, MANGGARAI BARAT, NUSA TENGGARA TIMUR",5,79,31,110
https://kawalpemilu.org#57748,"MACANG TANGGAR, KOMODO, MANGGARAI BARAT, NUSA TENGGARA TIMUR",6,115,31,146
https://kawalpemilu.org#57748,"MACANG TANGGAR, KOMODO, MANGGARAI BARAT, NUSA TENGGARA TIMUR",7,105,88,193
https://kawalpemilu.org#57748,"MACANG TANGGAR, KOMODO, MANGGARAI BARAT, NUSA TENGGARA TIMUR",8,113,26,139
https://kawalpemilu.org#57748,"MACANG TANGGAR, KOMODO, MANGGARAI BARAT, NUSA TENGGARA TIMUR",9,135,3,138
https://kawalpemilu.org#57748,"MACANG TANGGAR, KOMODO, MANGGARAI BARAT, NUSA TENGGARA TIMUR",10,182,9,191
https://kawalpemilu.org#57750,"GOLO PONGKOR, KOMODO, MANGGARAI BARAT, NUSA TENGGARA TIMUR",1,160,76,236
https://kawalpemilu.org#57750,"GOLO PONGKOR, KOMODO, MANGGARAI BARAT, NUSA TENGGARA TIMUR",2,177,10,187
https://kawalpemilu.org#57750,"GOLO PONGKOR, KOMODO, MANGGARAI BARAT, NUSA TENGGARA TIMUR",3,112,9,121
https://kawalpemilu.org#57751,"NGGORANG, KOMODO, MANGGARAI BARAT, NUSA TENGGARA TIMUR",1,127,58,185
https://kawalpemilu.org#57751,"NGGORANG, KOMODO, MANGGARAI BARAT, NUSA TENGGARA TIMUR",2,115,61,176
https://kawalpemilu.org#57751,"NGGORANG, KOMODO, MANGGARAI BARAT, NUSA TENGGARA TIMUR",3,94,70,164
https://kawalpemilu.org#57751,"NGGORANG, KOMODO, MANGGARAI BARAT, NUSA TENGGARA TIMUR",4,117,45,162
https://kawalpemilu.org#57751,"NGGORANG, KOMODO, MANGGARAI BARAT, NUSA TENGGARA TIMUR",5,156,5,161
https://kawalpemilu.org#57751,"NGGORANG, KOMODO, MANGGARAI BARAT, NUSA TENGGARA TIMUR",6,143,6,149
https://kawalpemilu.org#57752,"PAPAGARANG, KOMODO, MANGGARAI BARAT, NUSA TENGGARA TIMUR",1,77,144,221
https://kawalpemilu.org#57752,"PAPAGARANG, KOMODO, MANGGARAI BARAT, NUSA TENGGARA TIMUR",2,83,106,189
https://kawalpemilu.org#57752,"PAPAGARANG, KOMODO, MANGGARAI BARAT, NUSA TENGGARA TIMUR",3,61,152,213
https://kawalpemilu.org#57752,"PAPAGARANG, KOMODO, MANGGARAI BARAT, NUSA TENGGARA TIMUR",4,27,170,197
https://kawalpemilu.org#57753,"BATU CERMIN, KOMODO, MANGGARAI BARAT, NUSA TENGGARA TIMUR",1,258,12,270
https://kawalpemilu.org#57753,"BATU CERMIN, KOMODO, MANGGARAI BARAT, NUSA TENGGARA TIMUR",2,170,19,189
https://kawalpemilu.org#57753,"BATU CERMIN, KOMODO, MANGGARAI BARAT, NUSA TENGGARA TIMUR",3,174,3,177
https://kawalpemilu.org#57753,"BATU CERMIN, KOMODO, MANGGARAI BARAT, NUSA TENGGARA TIMUR",4,142,5,147
https://kawalpemilu.org#57753,"BATU CERMIN, KOMODO, MANGGARAI BARAT, NUSA TENGGARA TIMUR",5,186,11,197
https://kawalpemilu.org#57753,"BATU CERMIN, KOMODO, MANGGARAI BARAT, NUSA TENGGARA TIMUR",6,146,10,156
https://kawalpemilu.org#57753,"BATU CERMIN, KOMODO, MANGGARAI BARAT, NUSA TENGGARA TIMUR",7,222,7,229
https://kawalpemilu.org#57753,"BATU CERMIN, KOMODO, MANGGARAI BARAT, NUSA TENGGARA TIMUR",8,210,9,219
https://kawalpemilu.org#57753,"BATU CERMIN, KOMODO, MANGGARAI BARAT, NUSA TENGGARA TIMUR",9,142,7,149
https://kawalpemilu.org#57753,"BATU CERMIN, KOMODO, MANGGARAI BARAT, NUSA TENGGARA TIMUR",10,192,14,206
https://kawalpemilu.org#57753,"BATU CERMIN, KOMODO, MANGGARAI BARAT, NUSA TENGGARA TIMUR",11,207,8,215
https://kawalpemilu.org#57753,"BATU CERMIN, KOMODO, MANGGARAI BARAT, NUSA TENGGARA TIMUR",12,260,18,278
https://kawalpemilu.org#57753,"BATU CERMIN, KOMODO, MANGGARAI BARAT, NUSA TENGGARA TIMUR",13,0,0,0
https://kawalpemilu.org#57754,"GORONTALO, KOMODO, MANGGARAI BARAT, NUSA TENGGARA TIMUR",6,215,51,266
https://kawalpemilu.org#57754,"GORONTALO, KOMODO, MANGGARAI BARAT, NUSA TENGGARA TIMUR",8,77,129,206
https://kawalpemilu.org#57754,"GORONTALO, KOMODO, MANGGARAI BARAT, NUSA TENGGARA TIMUR",12,69,98,167
https://kawalpemilu.org#57754,"GORONTALO, KOMODO, MANGGARAI BARAT, NUSA TENGGARA TIMUR",13,232,19,251
https://kawalpemilu.org#57754,"GORONTALO, KOMODO, MANGGARAI BARAT, NUSA TENGGARA TIMUR",14,204,47,251
https://kawalpemilu.org#57754,"GORONTALO, KOMODO, MANGGARAI BARAT, NUSA TENGGARA TIMUR",15,219,40,259
https://kawalpemilu.org#57755,"TIWU NAMPAR, KOMODO, MANGGARAI BARAT, NUSA TENGGARA TIMUR",1,134,69,203
https://kawalpemilu.org#57755,"TIWU NAMPAR, KOMODO, MANGGARAI BARAT, NUSA TENGGARA TIMUR",2,125,105,230
https://kawalpemilu.org#57755,"TIWU NAMPAR, KOMODO, MANGGARAI BARAT, NUSA TENGGARA TIMUR",3,109,79,188
https://kawalpemilu.org#927919,"SERAYA MARANNU, KOMODO, MANGGARAI BARAT, NUSA TENGGARA TIMUR",1,36,136,172
https://kawalpemilu.org#927919,"SERAYA MARANNU, KOMODO, MANGGARAI BARAT, NUSA TENGGARA TIMUR",2,56,116,172
https://kawalpemilu.org#927920,"COMPANG LONGGO, KOMODO, MANGGARAI BARAT, NUSA TENGGARA TIMUR",1,177,17,194
https://kawalpemilu.org#927920,"COMPANG LONGGO, KOMODO, MANGGARAI BARAT, NUSA TENGGARA TIMUR",2,210,18,228
https://kawalpemilu.org#927920,"COMPANG LONGGO, KOMODO, MANGGARAI BARAT, NUSA TENGGARA TIMUR",3,104,58,162
https://kawalpemilu.org#927920,"COMPANG LONGGO, KOMODO, MANGGARAI BARAT, NUSA TENGGARA TIMUR",4,100,20,120
https://kawalpemilu.org#927921,"PANTAR, KOMODO, MANGGARAI BARAT, NUSA TENGGARA TIMUR",1,213,33,246
https://kawalpemilu.org#57757,"MBUIT, BOLENG, MANGGARAI BARAT, NUSA TENGGARA TIMUR",1,173,69,242
https://kawalpemilu.org#57757,"MBUIT, BOLENG, MANGGARAI BARAT, NUSA TENGGARA TIMUR",2,79,28,107
https://kawalpemilu.org#57757,"MBUIT, BOLENG, MANGGARAI BARAT, NUSA TENGGARA TIMUR",3,210,29,239
https://kawalpemilu.org#57757,"MBUIT, BOLENG, MANGGARAI BARAT, NUSA TENGGARA TIMUR",4,136,40,176
https://kawalpemilu.org#57757,"MBUIT, BOLENG, MANGGARAI BARAT, NUSA TENGGARA TIMUR",5,163,12,175
https://kawalpemilu.org#57757,"MBUIT, BOLENG, MANGGARAI BARAT, NUSA TENGGARA TIMUR",6,108,10,118
https://kawalpemilu.org#57757,"MBUIT, BOLENG, MANGGARAI BARAT, NUSA TENGGARA TIMUR",7,150,28,178
https://kawalpemilu.org#57757,"MBUIT, BOLENG, MANGGARAI BARAT, NUSA TENGGARA TIMUR",8,150,41,191
https://kawalpemilu.org#57757,"MBUIT, BOLENG, MANGGARAI BARAT, NUSA TENGGARA TIMUR",9,155,11,166
https://kawalpemilu.org#57757,"MBUIT, BOLENG, MANGGARAI BARAT, NUSA TENGGARA TIMUR",10,200,19,219
https://kawalpemilu.org#57758,"GOLO KETAK, BOLENG, MANGGARAI BARAT, NUSA TENGGARA TIMUR",1,144,18,162
https://kawalpemilu.org#57758,"GOLO KETAK, BOLENG, MANGGARAI BARAT, NUSA TENGGARA TIMUR",2,218,11,229
https://kawalpemilu.org#57758,"GOLO KETAK, BOLENG, MANGGARAI BARAT, NUSA TENGGARA TIMUR",3,148,42,190
https://kawalpemilu.org#57758,"GOLO KETAK, BOLENG, MANGGARAI BARAT, NUSA TENGGARA TIMUR",4,115,13,128
https://kawalpemilu.org#57758,"GOLO KETAK, BOLENG, MANGGARAI BARAT, NUSA TENGGARA TIMUR",5,136,62,198
https://kawalpemilu.org#57758,"GOLO KETAK, BOLENG, MANGGARAI BARAT, NUSA TENGGARA TIMUR",6,157,31,188
https://kawalpemilu.org#57759,"POTA WANGKA, BOLENG, MANGGARAI BARAT, NUSA TENGGARA TIMUR",1,165,1,166
https://kawalpemilu.org#57759,"POTA WANGKA, BOLENG, MANGGARAI BARAT, NUSA TENGGARA TIMUR",2,142,4,146
https://kawalpemilu.org#57759,"POTA WANGKA, BOLENG, MANGGARAI BARAT, NUSA TENGGARA TIMUR",3,158,8,166
https://kawalpemilu.org#57759,"POTA WANGKA, BOLENG, MANGGARAI BARAT, NUSA TENGGARA TIMUR",4,104,7,111
https://kawalpemilu.org#57760,"TANJUNG BOLENG, BOLENG, MANGGARAI BARAT, NUSA TENGGARA TIMUR",1,57,145,202
https://kawalpemilu.org#57760,"TANJUNG BOLENG, BOLENG, MANGGARAI BARAT, NUSA TENGGARA TIMUR",3,127,106,233
https://kawalpemilu.org#57760,"TANJUNG BOLENG, BOLENG, MANGGARAI BARAT, NUSA TENGGARA TIMUR",4,182,13,195
https://kawalpemilu.org#57760,"TANJUNG BOLENG, BOLENG, MANGGARAI BARAT, NUSA TENGGARA TIMUR",5,191,9,200
https://kawalpemilu.org#57760,"TANJUNG BOLENG, BOLENG, MANGGARAI BARAT, NUSA TENGGARA TIMUR",6,140,6,146
https://kawalpemilu.org#57760,"TANJUNG BOLENG, BOLENG, MANGGARAI BARAT, NUSA TENGGARA TIMUR",7,108,16,124
https://kawalpemilu.org#57761,"GOLO SEPANG, BOLENG, MANGGARAI BARAT, NUSA TENGGARA TIMUR",1,14,191,205
https://kawalpemilu.org#57761,"GOLO SEPANG, BOLENG, MANGGARAI BARAT, NUSA TENGGARA TIMUR",2,15,172,187
https://kawalpemilu.org#57761,"GOLO SEPANG, BOLENG, MANGGARAI BARAT, NUSA TENGGARA TIMUR",3,52,163,215
https://kawalpemilu.org#57761,"GOLO SEPANG, BOLENG, MANGGARAI BARAT, NUSA TENGGARA TIMUR",4,20,24,44
https://kawalpemilu.org#57761,"GOLO SEPANG, BOLENG, MANGGARAI BARAT, NUSA TENGGARA TIMUR",5,56,142,198
https://kawalpemilu.org#57761,"GOLO SEPANG, BOLENG, MANGGARAI BARAT, NUSA TENGGARA TIMUR",6,144,94,238
https://kawalpemilu.org#57761,"GOLO SEPANG, BOLENG, MANGGARAI BARAT, NUSA TENGGARA TIMUR",7,192,35,227
https://kawalpemilu.org#57761,"GOLO SEPANG, BOLENG, MANGGARAI BARAT, NUSA TENGGARA TIMUR",8,159,6,165
https://kawalpemilu.org#57761,"GOLO SEPANG, BOLENG, MANGGARAI BARAT, NUSA TENGGARA TIMUR",9,170,14,184
https://kawalpemilu.org#57761,"GOLO SEPANG, BOLENG, MANGGARAI BARAT, NUSA TENGGARA TIMUR",10,189,26,215
https://kawalpemilu.org#57761,"GOLO SEPANG, BOLENG, MANGGARAI BARAT, NUSA TENGGARA TIMUR",11,87,2,89
https://kawalpemilu.org#57762,"PONTIANAK, BOLENG, MANGGARAI BARAT, NUSA TENGGARA TIMUR",1,39,202,241
https://kawalpemilu.org#57762,"PONTIANAK, BOLENG, MANGGARAI BARAT, NUSA TENGGARA TIMUR",2,46,209,255
https://kawalpemilu.org#57762,"PONTIANAK, BOLENG, MANGGARAI BARAT, NUSA TENGGARA TIMUR",3,27,127,154
https://kawalpemilu.org#57762,"PONTIANAK, BOLENG, MANGGARAI BARAT, NUSA TENGGARA TIMUR",4,16,74,90
https://kawalpemilu.org#57763,"SEPANG, BOLENG, MANGGARAI BARAT, NUSA TENGGARA TIMUR",1,215,23,238
https://kawalpemilu.org#57763,"SEPANG, BOLENG, MANGGARAI BARAT, NUSA TENGGARA TIMUR",3,199,27,226
https://kawalpemilu.org#57763,"SEPANG, BOLENG, MANGGARAI BARAT, NUSA TENGGARA TIMUR",4,190,30,220
https://kawalpemilu.org#57765,"BATU TIGA, BOLENG, MANGGARAI BARAT, NUSA TENGGARA TIMUR",1,91,40,131
https://kawalpemilu.org#57765,"BATU TIGA, BOLENG, MANGGARAI BARAT, NUSA TENGGARA TIMUR",2,90,78,168
https://kawalpemilu.org#57765,"BATU TIGA, BOLENG, MANGGARAI BARAT, NUSA TENGGARA TIMUR",3,50,144,194
https://kawalpemilu.org#57765,"BATU TIGA, BOLENG, MANGGARAI BARAT, NUSA TENGGARA TIMUR",4,13,95,108
https://kawalpemilu.org#57765,"BATU TIGA, BOLENG, MANGGARAI BARAT, NUSA TENGGARA TIMUR",5,34,125,159
https://kawalpemilu.org#57765,"BATU TIGA, BOLENG, MANGGARAI BARAT, NUSA TENGGARA TIMUR",6,48,107,155
https://kawalpemilu.org#927922,"GOLO NOBO, BOLENG, MANGGARAI BARAT, NUSA TENGGARA TIMUR",2,103,2,105
https://kawalpemilu.org#927923,"BEO SEPANG, BOLENG, MANGGARAI BARAT, NUSA TENGGARA TIMUR",1,206,13,219
https://kawalpemilu.org#927923,"BEO SEPANG, BOLENG, MANGGARAI BARAT, NUSA TENGGARA TIMUR",2,157,26,183
https://kawalpemilu.org#57767,"GOLO RONGGOT, WELAK, MANGGARAI BARAT, NUSA TENGGARA TIMUR",1,206,12,218
https://kawalpemilu.org#57767,"GOLO RONGGOT, WELAK, MANGGARAI BARAT, NUSA TENGGARA TIMUR",2,131,21,152
https://kawalpemilu.org#57767,"GOLO RONGGOT, WELAK, MANGGARAI BARAT, NUSA TENGGARA TIMUR",3,162,25,187
https://kawalpemilu.org#57767,"GOLO RONGGOT, WELAK, MANGGARAI BARAT, NUSA TENGGARA TIMUR",4,202,11,213
https://kawalpemilu.org#57767,"GOLO RONGGOT, WELAK, MANGGARAI BARAT, NUSA TENGGARA TIMUR",5,168,23,191
https://kawalpemilu.org#57767,"GOLO RONGGOT, WELAK, MANGGARAI BARAT, NUSA TENGGARA TIMUR",6,140,10,150
https://kawalpemilu.org#57767,"GOLO RONGGOT, WELAK, MANGGARAI BARAT, NUSA TENGGARA TIMUR",7,153,15,168
https://kawalpemilu.org#57768,"SEMANG, WELAK, MANGGARAI BARAT, NUSA TENGGARA TIMUR",1,131,13,144
https://kawalpemilu.org#57768,"SEMANG, WELAK, MANGGARAI BARAT, NUSA TENGGARA TIMUR",2,112,5,117
https://kawalpemilu.org#57768,"SEMANG, WELAK, MANGGARAI BARAT, NUSA TENGGARA TIMUR",3,101,6,107
https://kawalpemilu.org#57768,"SEMANG, WELAK, MANGGARAI BARAT, NUSA TENGGARA TIMUR",4,127,1,128
https://kawalpemilu.org#57768,"SEMANG, WELAK, MANGGARAI BARAT, NUSA TENGGARA TIMUR",5,191,7,198
https://kawalpemilu.org#57768,"SEMANG, WELAK, MANGGARAI BARAT, NUSA TENGGARA TIMUR",6,169,12,181
https://kawalpemilu.org#57768,"SEMANG, WELAK, MANGGARAI BARAT, NUSA TENGGARA TIMUR",7,92,15,107
https://kawalpemilu.org#57768,"SEMANG, WELAK, MANGGARAI BARAT, NUSA TENGGARA TIMUR",8,117,1,118
https://kawalpemilu.org#57768,"SEMANG, WELAK, MANGGARAI BARAT, NUSA TENGGARA TIMUR",9,165,10,175
https://kawalpemilu.org#57769,"DUNTA, WELAK, MANGGARAI BARAT, NUSA TENGGARA TIMUR",1,131,17,148
https://kawalpemilu.org#57769,"DUNTA, WELAK, MANGGARAI BARAT, NUSA TENGGARA TIMUR",2,111,17,128
https://kawalpemilu.org#57769,"DUNTA, WELAK, MANGGARAI BARAT, NUSA TENGGARA TIMUR",3,177,18,195
https://kawalpemilu.org#57770,"GURUNG, WELAK, MANGGARAI BARAT, NUSA TENGGARA TIMUR",1,198,26,224
https://kawalpemilu.org#57770,"GURUNG, WELAK, MANGGARAI BARAT, NUSA TENGGARA TIMUR",2,175,23,198
https://kawalpemilu.org#57770,"GURUNG, WELAK, MANGGARAI BARAT, NUSA TENGGARA TIMUR",3,113,19,132
https://kawalpemilu.org#57771,"ORONG, WELAK, MANGGARAI BARAT, NUSA TENGGARA TIMUR",1,188,9,197
https://kawalpemilu.org#57771,"ORONG, WELAK, MANGGARAI BARAT, NUSA TENGGARA TIMUR",2,107,19,126
https://kawalpemilu.org#57771,"ORONG, WELAK, MANGGARAI BARAT, NUSA TENGGARA TIMUR",3,118,13,131
https://kawalpemilu.org#57771,"ORONG, WELAK, MANGGARAI BARAT, NUSA TENGGARA TIMUR",4,151,0,151
https://kawalpemilu.org#57771,"ORONG, WELAK, MANGGARAI BARAT, NUSA TENGGARA TIMUR",5,156,20,176
https://kawalpemilu.org#57772,"PONG WELAK, WELAK, MANGGARAI BARAT, NUSA TENGGARA TIMUR",1,150,10,160
https://kawalpemilu.org#57772,"PONG WELAK, WELAK, MANGGARAI BARAT, NUSA TENGGARA TIMUR",2,140,23,163
https://kawalpemilu.org#57772,"PONG WELAK, WELAK, MANGGARAI BARAT, NUSA TENGGARA TIMUR",3,130,17,147
https://kawalpemilu.org#57773,"GALANG, WELAK, MANGGARAI BARAT, NUSA TENGGARA TIMUR",1,114,18,132
https://kawalpemilu.org#57773,"GALANG, WELAK, MANGGARAI BARAT, NUSA TENGGARA TIMUR",2,140,18,158
https://kawalpemilu.org#57773,"GALANG, WELAK, MANGGARAI BARAT, NUSA TENGGARA TIMUR",3,200,17,217
https://kawalpemilu.org#57773,"GALANG, WELAK, MANGGARAI BARAT, NUSA TENGGARA TIMUR",4,175,15,190
https://kawalpemilu.org#57773,"GALANG, WELAK, MANGGARAI BARAT, NUSA TENGGARA TIMUR",5,94,23,117
https://kawalpemilu.org#57773,"GALANG, WELAK, MANGGARAI BARAT, NUSA TENGGARA TIMUR",6,117,10,127
https://kawalpemilu.org#57774,"REHAK, WELAK, MANGGARAI BARAT, NUSA TENGGARA TIMUR",1,174,12,186
https://kawalpemilu.org#57774,"REHAK, WELAK, MANGGARAI BARAT, NUSA TENGGARA TIMUR",2,129,5,134
https://kawalpemilu.org#57774,"REHAK, WELAK, MANGGARAI BARAT, NUSA TENGGARA TIMUR",3,130,5,135
https://kawalpemilu.org#57774,"REHAK, WELAK, MANGGARAI BARAT, NUSA TENGGARA TIMUR",5,125,6,131
https://kawalpemilu.org#57775,"WATU UMPU, WELAK, MANGGARAI BARAT, NUSA TENGGARA TIMUR",1,161,10,171
https://kawalpemilu.org#57775,"WATU UMPU, WELAK, MANGGARAI BARAT, NUSA TENGGARA TIMUR",2,186,20,206
https://kawalpemilu.org#57775,"WATU UMPU, WELAK, MANGGARAI BARAT, NUSA TENGGARA TIMUR",3,164,14,178
https://kawalpemilu.org#57776,"PENGKA, WELAK, MANGGARAI BARAT, NUSA TENGGARA TIMUR",1,185,4,189
https://kawalpemilu.org#57776,"PENGKA, WELAK, MANGGARAI BARAT, NUSA TENGGARA TIMUR",2,136,5,141
https://kawalpemilu.org#57776,"PENGKA, WELAK, MANGGARAI BARAT, NUSA TENGGARA TIMUR",3,126,11,137
https://kawalpemilu.org#57777,"LALE, WELAK, MANGGARAI BARAT, NUSA TENGGARA TIMUR",1,0,0,0
https://kawalpemilu.org#57777,"LALE, WELAK, MANGGARAI BARAT, NUSA TENGGARA TIMUR",2,133,15,148
https://kawalpemilu.org#57777,"LALE, WELAK, MANGGARAI BARAT, NUSA TENGGARA TIMUR",3,125,8,133
https://kawalpemilu.org#57777,"LALE, WELAK, MANGGARAI BARAT, NUSA TENGGARA TIMUR",4,140,13,153
https://kawalpemilu.org#57777,"LALE, WELAK, MANGGARAI BARAT, NUSA TENGGARA TIMUR",5,216,15,231
https://kawalpemilu.org#927924,"WEWA, WELAK, MANGGARAI BARAT, NUSA TENGGARA TIMUR",1,156,4,160
https://kawalpemilu.org#927924,"WEWA, WELAK, MANGGARAI BARAT, NUSA TENGGARA TIMUR",2,158,11,169
https://kawalpemilu.org#927924,"WEWA, WELAK, MANGGARAI BARAT, NUSA TENGGARA TIMUR",3,219,8,227
https://kawalpemilu.org#927925,"ROBO, WELAK, MANGGARAI BARAT, NUSA TENGGARA TIMUR",1,218,11,229
https://kawalpemilu.org#927925,"ROBO, WELAK, MANGGARAI BARAT, NUSA TENGGARA TIMUR",2,144,18,162
https://kawalpemilu.org#927925,"ROBO, WELAK, MANGGARAI BARAT, NUSA TENGGARA TIMUR",3,223,7,230
https://kawalpemilu.org#927926,"RACANG WELAK, WELAK, MANGGARAI BARAT, NUSA TENGGARA TIMUR",1,142,21,163
https://kawalpemilu.org#927926,"RACANG WELAK, WELAK, MANGGARAI BARAT, NUSA TENGGARA TIMUR",2,144,30,174
https://kawalpemilu.org#927926,"RACANG WELAK, WELAK, MANGGARAI BARAT, NUSA TENGGARA TIMUR",3,119,91,210
https://kawalpemilu.org#927926,"RACANG WELAK, WELAK, MANGGARAI BARAT, NUSA TENGGARA TIMUR",4,108,21,129
https://kawalpemilu.org#927926,"RACANG WELAK, WELAK, MANGGARAI BARAT, NUSA TENGGARA TIMUR",5,124,20,144
https://kawalpemilu.org#927927,"GOLO NDARI, WELAK, MANGGARAI BARAT, NUSA TENGGARA TIMUR",1,201,22,223
https://kawalpemilu.org#927927,"GOLO NDARI, WELAK, MANGGARAI BARAT, NUSA TENGGARA TIMUR",2,119,8,127
https://kawalpemilu.org#927928,"SEWAR, WELAK, MANGGARAI BARAT, NUSA TENGGARA TIMUR",1,134,18,152
https://kawalpemilu.org#927928,"SEWAR, WELAK, MANGGARAI BARAT, NUSA TENGGARA TIMUR",2,149,13,162
https://kawalpemilu.org#57673,"TENTANG, NDOSO, MANGGARAI BARAT, NUSA TENGGARA TIMUR",1,204,6,210
https://kawalpemilu.org#57673,"TENTANG, NDOSO, MANGGARAI BARAT, NUSA TENGGARA TIMUR",2,238,2,240
https://kawalpemilu.org#57673,"TENTANG, NDOSO, MANGGARAI BARAT, NUSA TENGGARA TIMUR",3,144,5,149
https://kawalpemilu.org#57673,"TENTANG, NDOSO, MANGGARAI BARAT, NUSA TENGGARA TIMUR",4,225,6,231
https://kawalpemilu.org#57673,"TENTANG, NDOSO, MANGGARAI BARAT, NUSA TENGGARA TIMUR",5,240,6,246
https://kawalpemilu.org#57673,"TENTANG, NDOSO, MANGGARAI BARAT, NUSA TENGGARA TIMUR",6,204,10,214
https://kawalpemilu.org#57673,"TENTANG, NDOSO, MANGGARAI BARAT, NUSA TENGGARA TIMUR",7,151,5,156
https://kawalpemilu.org#57675,"WANING, NDOSO, MANGGARAI BARAT, NUSA TENGGARA TIMUR",1,214,12,226
https://kawalpemilu.org#57675,"WANING, NDOSO, MANGGARAI BARAT, NUSA TENGGARA TIMUR",2,205,11,216
https://kawalpemilu.org#57675,"WANING, NDOSO, MANGGARAI BARAT, NUSA TENGGARA TIMUR",3,230,8,238
https://kawalpemilu.org#57675,"WANING, NDOSO, MANGGARAI BARAT, NUSA TENGGARA TIMUR",4,182,17,199
https://kawalpemilu.org#57679,"NDOSO, NDOSO, MANGGARAI BARAT, NUSA TENGGARA TIMUR",3,157,1,158
https://kawalpemilu.org#57679,"NDOSO, NDOSO, MANGGARAI BARAT, NUSA TENGGARA TIMUR",4,85,7,92
https://kawalpemilu.org#57679,"NDOSO, NDOSO, MANGGARAI BARAT, NUSA TENGGARA TIMUR",5,109,4,113
https://kawalpemilu.org#57679,"NDOSO, NDOSO, MANGGARAI BARAT, NUSA TENGGARA TIMUR",6,162,11,173
https://kawalpemilu.org#57682,"PONG NARANG, NDOSO, MANGGARAI BARAT, NUSA TENGGARA TIMUR",1,0,0,0
https://kawalpemilu.org#57682,"PONG NARANG, NDOSO, MANGGARAI BARAT, NUSA TENGGARA TIMUR",2,184,4,188
https://kawalpemilu.org#57682,"PONG NARANG, NDOSO, MANGGARAI BARAT, NUSA TENGGARA TIMUR",3,36,3,39
https://kawalpemilu.org#57682,"PONG NARANG, NDOSO, MANGGARAI BARAT, NUSA TENGGARA TIMUR",4,158,8,166
https://kawalpemilu.org#57682,"PONG NARANG, NDOSO, MANGGARAI BARAT, NUSA TENGGARA TIMUR",5,193,8,201
https://kawalpemilu.org#57685,"LUMUT, NDOSO, MANGGARAI BARAT, NUSA TENGGARA TIMUR",1,225,20,245
https://kawalpemilu.org#57685,"LUMUT, NDOSO, MANGGARAI BARAT, NUSA TENGGARA TIMUR",2,148,6,154
https://kawalpemilu.org#57685,"LUMUT, NDOSO, MANGGARAI BARAT, NUSA TENGGARA TIMUR",3,205,5,210
https://kawalpemilu.org#57685,"LUMUT, NDOSO, MANGGARAI BARAT, NUSA TENGGARA TIMUR",4,234,6,240
https://kawalpemilu.org#57686,"MOMOL, NDOSO, MANGGARAI BARAT, NUSA TENGGARA TIMUR",1,185,6,191
https://kawalpemilu.org#57686,"MOMOL, NDOSO, MANGGARAI BARAT, NUSA TENGGARA TIMUR",2,225,12,237
https://kawalpemilu.org#57686,"MOMOL, NDOSO, MANGGARAI BARAT, NUSA TENGGARA TIMUR",3,180,7,187
https://kawalpemilu.org#57688,"KASONG, NDOSO, MANGGARAI BARAT, NUSA TENGGARA TIMUR",1,101,38,139
https://kawalpemilu.org#57688,"KASONG, NDOSO, MANGGARAI BARAT, NUSA TENGGARA TIMUR",2,202,9,211
https://kawalpemilu.org#927930,"GOLO KELI, NDOSO, MANGGARAI BARAT, NUSA TENGGARA TIMUR",1,109,8,117
https://kawalpemilu.org#927930,"GOLO KELI, NDOSO, MANGGARAI BARAT, NUSA TENGGARA TIMUR",2,176,9,185
https://kawalpemilu.org#927930,"GOLO KELI, NDOSO, MANGGARAI BARAT, NUSA TENGGARA TIMUR",3,206,8,214
https://kawalpemilu.org#927930,"GOLO KELI, NDOSO, MANGGARAI BARAT, NUSA TENGGARA TIMUR",4,201,22,223
https://kawalpemilu.org#927931,"GOLO BORE, NDOSO, MANGGARAI BARAT, NUSA TENGGARA TIMUR",1,127,3,130
https://kawalpemilu.org#927931,"GOLO BORE, NDOSO, MANGGARAI BARAT, NUSA TENGGARA TIMUR",2,0,0,0
https://kawalpemilu.org#927931,"GOLO BORE, NDOSO, MANGGARAI BARAT, NUSA TENGGARA TIMUR",3,126,5,131
https://kawalpemilu.org#927932,"PATENG LESU, NDOSO, MANGGARAI BARAT, NUSA TENGGARA TIMUR",1,179,5,184
https://kawalpemilu.org#927932,"PATENG LESU, NDOSO, MANGGARAI BARAT, NUSA TENGGARA TIMUR",2,188,3,191
https://kawalpemilu.org#927932,"PATENG LESU, NDOSO, MANGGARAI BARAT, NUSA TENGGARA TIMUR",3,100,6,106
https://kawalpemilu.org#927934,"GOLO RU'A, NDOSO, MANGGARAI BARAT, NUSA TENGGARA TIMUR",1,127,2,129
https://kawalpemilu.org#927934,"GOLO RU'A, NDOSO, MANGGARAI BARAT, NUSA TENGGARA TIMUR",2,188,1,189
https://kawalpemilu.org#927934,"GOLO RU'A, NDOSO, MANGGARAI BARAT, NUSA TENGGARA TIMUR",3,183,21,204
https://kawalpemilu.org#927934,"GOLO RU'A, NDOSO, MANGGARAI BARAT, NUSA TENGGARA TIMUR",4,199,1,200
https://kawalpemilu.org#927934,"GOLO RU'A, NDOSO, MANGGARAI BARAT, NUSA TENGGARA TIMUR",5,157,2,159
https://kawalpemilu.org#57694,"NANGA LILI, LEMBOR SELATAN, MANGGARAI BARAT, NUSA TENGGARA TIMUR",1,20,149,169
https://kawalpemilu.org#57694,"NANGA LILI, LEMBOR SELATAN, MANGGARAI BARAT, NUSA TENGGARA TIMUR",2,28,128,156
https://kawalpemilu.org#57694,"NANGA LILI, LEMBOR SELATAN, MANGGARAI BARAT, NUSA TENGGARA TIMUR",3,102,81,183
https://kawalpemilu.org#57694,"NANGA LILI, LEMBOR SELATAN, MANGGARAI BARAT, NUSA TENGGARA TIMUR",4,35,134,169
https://kawalpemilu.org#57694,"NANGA LILI, LEMBOR SELATAN, MANGGARAI BARAT, NUSA TENGGARA TIMUR",5,40,115,155
https://kawalpemilu.org#57694,"NANGA LILI, LEMBOR SELATAN, MANGGARAI BARAT, NUSA TENGGARA TIMUR",6,45,108,153
https://kawalpemilu.org#57694,"NANGA LILI, LEMBOR SELATAN, MANGGARAI BARAT, NUSA TENGGARA TIMUR",7,44,162,206
https://kawalpemilu.org#57694,"NANGA LILI, LEMBOR SELATAN, MANGGARAI BARAT, NUSA TENGGARA TIMUR",8,137,46,183
https://kawalpemilu.org#57695,"NANGA BERE, LEMBOR SELATAN, MANGGARAI BARAT, NUSA TENGGARA TIMUR",1,45,78,123
https://kawalpemilu.org#57695,"NANGA BERE, LEMBOR SELATAN, MANGGARAI BARAT, NUSA TENGGARA TIMUR",2,47,69,116
https://kawalpemilu.org#57695,"NANGA BERE, LEMBOR SELATAN, MANGGARAI BARAT, NUSA TENGGARA TIMUR",3,99,50,149
https://kawalpemilu.org#57695,"NANGA BERE, LEMBOR SELATAN, MANGGARAI BARAT, NUSA TENGGARA TIMUR",4,66,85,151
https://kawalpemilu.org#57695,"NANGA BERE, LEMBOR SELATAN, MANGGARAI BARAT, NUSA TENGGARA TIMUR",5,20,39,59
https://kawalpemilu.org#57702,"KAKOR, LEMBOR SELATAN, MANGGARAI BARAT, NUSA TENGGARA TIMUR",1,137,46,183
https://kawalpemilu.org#57702,"KAKOR, LEMBOR SELATAN, MANGGARAI BARAT, NUSA TENGGARA TIMUR",2,190,15,205
https://kawalpemilu.org#57702,"KAKOR, LEMBOR SELATAN, MANGGARAI BARAT, NUSA TENGGARA TIMUR",3,173,7,180
https://kawalpemilu.org#57702,"KAKOR, LEMBOR SELATAN, MANGGARAI BARAT, NUSA TENGGARA TIMUR",4,144,22,166
https://kawalpemilu.org#57702,"KAKOR, LEMBOR SELATAN, MANGGARAI BARAT, NUSA TENGGARA TIMUR",5,158,21,179
https://kawalpemilu.org#57702,"KAKOR, LEMBOR SELATAN, MANGGARAI BARAT, NUSA TENGGARA TIMUR",6,171,18,189
https://kawalpemilu.org#57703,"LALONG, LEMBOR SELATAN, MANGGARAI BARAT, NUSA TENGGARA TIMUR",1,145,14,159
https://kawalpemilu.org#57703,"LALONG, LEMBOR SELATAN, MANGGARAI BARAT, NUSA TENGGARA TIMUR",2,161,14,175
https://kawalpemilu.org#57703,"LALONG, LEMBOR SELATAN, MANGGARAI BARAT, NUSA TENGGARA TIMUR",3,97,11,108
https://kawalpemilu.org#57703,"LALONG, LEMBOR SELATAN, MANGGARAI BARAT, NUSA TENGGARA TIMUR",4,112,9,121
https://kawalpemilu.org#57703,"LALONG, LEMBOR SELATAN, MANGGARAI BARAT, NUSA TENGGARA TIMUR",5,102,20,122
https://kawalpemilu.org#57703,"LALONG, LEMBOR SELATAN, MANGGARAI BARAT, NUSA TENGGARA TIMUR",6,112,16,128
https://kawalpemilu.org#57703,"LALONG, LEMBOR SELATAN, MANGGARAI BARAT, NUSA TENGGARA TIMUR",7,218,5,223
https://kawalpemilu.org#57704,"MUNTING, LEMBOR SELATAN, MANGGARAI BARAT, NUSA TENGGARA TIMUR",1,158,20,178
https://kawalpemilu.org#57704,"MUNTING, LEMBOR SELATAN, MANGGARAI BARAT, NUSA TENGGARA TIMUR",2,168,19,187
https://kawalpemilu.org#57704,"MUNTING, LEMBOR SELATAN, MANGGARAI BARAT, NUSA TENGGARA TIMUR",3,140,6,146
https://kawalpemilu.org#57704,"MUNTING, LEMBOR SELATAN, MANGGARAI BARAT, NUSA TENGGARA TIMUR",4,172,8,180
https://kawalpemilu.org#57704,"MUNTING, LEMBOR SELATAN, MANGGARAI BARAT, NUSA TENGGARA TIMUR",5,186,11,197
https://kawalpemilu.org#57705,"SURUNUMBENG, LEMBOR SELATAN, MANGGARAI BARAT, NUSA TENGGARA TIMUR",1,170,17,187
https://kawalpemilu.org#57705,"SURUNUMBENG, LEMBOR SELATAN, MANGGARAI BARAT, NUSA TENGGARA TIMUR",2,159,29,188
https://kawalpemilu.org#57705,"SURUNUMBENG, LEMBOR SELATAN, MANGGARAI BARAT, NUSA TENGGARA TIMUR",3,106,15,121
https://kawalpemilu.org#57705,"SURUNUMBENG, LEMBOR SELATAN, MANGGARAI BARAT, NUSA TENGGARA TIMUR",4,120,21,141
https://kawalpemilu.org#57705,"SURUNUMBENG, LEMBOR SELATAN, MANGGARAI BARAT, NUSA TENGGARA TIMUR",5,136,34,170
https://kawalpemilu.org#57706,"REPI, LEMBOR SELATAN, MANGGARAI BARAT, NUSA TENGGARA TIMUR",1,182,13,195
https://kawalpemilu.org#57706,"REPI, LEMBOR SELATAN, MANGGARAI BARAT, NUSA TENGGARA TIMUR",2,203,11,214
https://kawalpemilu.org#57706,"REPI, LEMBOR SELATAN, MANGGARAI BARAT, NUSA TENGGARA TIMUR",3,123,8,131
https://kawalpemilu.org#57706,"REPI, LEMBOR SELATAN, MANGGARAI BARAT, NUSA TENGGARA TIMUR",4,168,17,185
https://kawalpemilu.org#57706,"REPI, LEMBOR SELATAN, MANGGARAI BARAT, NUSA TENGGARA TIMUR",5,60,3,63
https://kawalpemilu.org#57707,"BENTENG DEWA, LEMBOR SELATAN, MANGGARAI BARAT, NUSA TENGGARA TIMUR",1,47,75,122
https://kawalpemilu.org#57707,"BENTENG DEWA, LEMBOR SELATAN, MANGGARAI BARAT, NUSA TENGGARA TIMUR",2,126,30,156
https://kawalpemilu.org#57707,"BENTENG DEWA, LEMBOR SELATAN, MANGGARAI BARAT, NUSA TENGGARA TIMUR",3,80,44,124
https://kawalpemilu.org#57707,"BENTENG DEWA, LEMBOR SELATAN, MANGGARAI BARAT, NUSA TENGGARA TIMUR",4,97,140,237
https://kawalpemilu.org#57707,"BENTENG DEWA, LEMBOR SELATAN, MANGGARAI BARAT, NUSA TENGGARA TIMUR",5,171,34,205
https://kawalpemilu.org#57712,"WAE MOSE, LEMBOR SELATAN, MANGGARAI BARAT, NUSA TENGGARA TIMUR",1,216,11,227
https://kawalpemilu.org#57712,"WAE MOSE, LEMBOR SELATAN, MANGGARAI BARAT, NUSA TENGGARA TIMUR",2,201,17,218
https://kawalpemilu.org#57713,"WATU WAJA, LEMBOR SELATAN, MANGGARAI BARAT, NUSA TENGGARA TIMUR",1,157,6,163
https://kawalpemilu.org#57713,"WATU WAJA, LEMBOR SELATAN, MANGGARAI BARAT, NUSA TENGGARA TIMUR",2,157,11,168
https://kawalpemilu.org#57713,"WATU WAJA, LEMBOR SELATAN, MANGGARAI BARAT, NUSA TENGGARA TIMUR",3,156,9,165
https://kawalpemilu.org#927935,"WATU TIRI, LEMBOR SELATAN, MANGGARAI BARAT, NUSA TENGGARA TIMUR",1,161,21,182
https://kawalpemilu.org#927935,"WATU TIRI, LEMBOR SELATAN, MANGGARAI BARAT, NUSA TENGGARA TIMUR",2,190,33,223
https://kawalpemilu.org#927935,"WATU TIRI, LEMBOR SELATAN, MANGGARAI BARAT, NUSA TENGGARA TIMUR",3,176,15,191
https://kawalpemilu.org#927935,"WATU TIRI, LEMBOR SELATAN, MANGGARAI BARAT, NUSA TENGGARA TIMUR",4,160,20,180
https://kawalpemilu.org#927935,"WATU TIRI, LEMBOR SELATAN, MANGGARAI BARAT, NUSA TENGGARA TIMUR",5,101,13,114
https://kawalpemilu.org#927937,"WATU RAMBUNG, LEMBOR SELATAN, MANGGARAI BARAT, NUSA TENGGARA TIMUR",1,232,12,244
https://kawalpemilu.org#927937,"WATU RAMBUNG, LEMBOR SELATAN, MANGGARAI BARAT, NUSA TENGGARA TIMUR",2,219,17,236
https://kawalpemilu.org#927937,"WATU RAMBUNG, LEMBOR SELATAN, MANGGARAI BARAT, NUSA TENGGARA TIMUR",3,139,17,156
https://kawalpemilu.org#927937,"WATU RAMBUNG, LEMBOR SELATAN, MANGGARAI BARAT, NUSA TENGGARA TIMUR",4,142,19,161
https://kawalpemilu.org#927937,"WATU RAMBUNG, LEMBOR SELATAN, MANGGARAI BARAT, NUSA TENGGARA TIMUR",5,187,26,213
https://kawalpemilu.org#927937,"WATU RAMBUNG, LEMBOR SELATAN, MANGGARAI BARAT, NUSA TENGGARA TIMUR",6,63,10,73
https://kawalpemilu.org#927937,"WATU RAMBUNG, LEMBOR SELATAN, MANGGARAI BARAT, NUSA TENGGARA TIMUR",7,87,9,96
https://kawalpemilu.org#927938,"LENDONG, LEMBOR SELATAN, MANGGARAI BARAT, NUSA TENGGARA TIMUR",1,193,22,215
https://kawalpemilu.org#927938,"LENDONG, LEMBOR SELATAN, MANGGARAI BARAT, NUSA TENGGARA TIMUR",2,235,16,251
https://kawalpemilu.org#927938,"LENDONG, LEMBOR SELATAN, MANGGARAI BARAT, NUSA TENGGARA TIMUR",3,188,28,216
https://kawalpemilu.org#927938,"LENDONG, LEMBOR SELATAN, MANGGARAI BARAT, NUSA TENGGARA TIMUR",4,189,14,203
https://kawalpemilu.org#927939,"MODO, LEMBOR SELATAN, MANGGARAI BARAT, NUSA TENGGARA TIMUR",1,216,15,231
https://kawalpemilu.org#57716,"GOLO SEMBEA, MBELILING, MANGGARAI BARAT, NUSA TENGGARA TIMUR",1,114,26,140
https://kawalpemilu.org#57716,"GOLO SEMBEA, MBELILING, MANGGARAI BARAT, NUSA TENGGARA TIMUR",3,74,0,74
https://kawalpemilu.org#57716,"GOLO SEMBEA, MBELILING, MANGGARAI BARAT, NUSA TENGGARA TIMUR",4,123,4,127
https://kawalpemilu.org#57716,"GOLO SEMBEA, MBELILING, MANGGARAI BARAT, NUSA TENGGARA TIMUR",5,71,22,93
https://kawalpemilu.org#57716,"GOLO SEMBEA, MBELILING, MANGGARAI BARAT, NUSA TENGGARA TIMUR",6,104,17,121
https://kawalpemilu.org#57717,"KEMPO, MBELILING, MANGGARAI BARAT, NUSA TENGGARA TIMUR",1,139,33,172
https://kawalpemilu.org#57717,"KEMPO, MBELILING, MANGGARAI BARAT, NUSA TENGGARA TIMUR",2,145,22,167
https://kawalpemilu.org#57717,"KEMPO, MBELILING, MANGGARAI BARAT, NUSA TENGGARA TIMUR",3,127,24,151
https://kawalpemilu.org#57717,"KEMPO, MBELILING, MANGGARAI BARAT, NUSA TENGGARA TIMUR",4,67,3,70
https://kawalpemilu.org#57717,"KEMPO, MBELILING, MANGGARAI BARAT, NUSA TENGGARA TIMUR",5,87,5,92
https://kawalpemilu.org#57718,"GOLO DESAT, MBELILING, MANGGARAI BARAT, NUSA TENGGARA TIMUR",1,116,7,123
https://kawalpemilu.org#57718,"GOLO DESAT, MBELILING, MANGGARAI BARAT, NUSA TENGGARA TIMUR",2,125,13,138
https://kawalpemilu.org#57720,"LIANG NDARA, MBELILING, MANGGARAI BARAT, NUSA TENGGARA TIMUR",1,225,15,240
https://kawalpemilu.org#57720,"LIANG NDARA, MBELILING, MANGGARAI BARAT, NUSA TENGGARA TIMUR",2,155,8,163
https://kawalpemilu.org#57720,"LIANG NDARA, MBELILING, MANGGARAI BARAT, NUSA TENGGARA TIMUR",3,83,34,117
https://kawalpemilu.org#57720,"LIANG NDARA, MBELILING, MANGGARAI BARAT, NUSA TENGGARA TIMUR",4,123,4,127
https://kawalpemilu.org#57721,"CUNCA LOLOS, MBELILING, MANGGARAI BARAT, NUSA TENGGARA TIMUR",1,212,9,221
https://kawalpemilu.org#57721,"CUNCA LOLOS, MBELILING, MANGGARAI BARAT, NUSA TENGGARA TIMUR",2,121,6,127
https://kawalpemilu.org#57724,"TIWI RIWUNG, MBELILING, MANGGARAI BARAT, NUSA TENGGARA TIMUR",1,173,35,208
https://kawalpemilu.org#57724,"TIWI RIWUNG, MBELILING, MANGGARAI BARAT, NUSA TENGGARA TIMUR",2,206,22,228
https://kawalpemilu.org#57724,"TIWI RIWUNG, MBELILING, MANGGARAI BARAT, NUSA TENGGARA TIMUR",3,56,20,76
https://kawalpemilu.org#57724,"TIWI RIWUNG, MBELILING, MANGGARAI BARAT, NUSA TENGGARA TIMUR",4,77,6,83
https://kawalpemilu.org#57726,"CUNCA WULANG, MBELILING, MANGGARAI BARAT, NUSA TENGGARA TIMUR",1,190,31,221
https://kawalpemilu.org#57726,"CUNCA WULANG, MBELILING, MANGGARAI BARAT, NUSA TENGGARA TIMUR",2,145,5,150
https://kawalpemilu.org#57726,"CUNCA WULANG, MBELILING, MANGGARAI BARAT, NUSA TENGGARA TIMUR",3,177,10,187
https://kawalpemilu.org#57727,"WATU WANGKA, MBELILING, MANGGARAI BARAT, NUSA TENGGARA TIMUR",1,144,38,182
https://kawalpemilu.org#57727,"WATU WANGKA, MBELILING, MANGGARAI BARAT, NUSA TENGGARA TIMUR",2,146,24,170
https://kawalpemilu.org#57727,"WATU WANGKA, MBELILING, MANGGARAI BARAT, NUSA TENGGARA TIMUR",3,100,2,102
https://kawalpemilu.org#57727,"WATU WANGKA, MBELILING, MANGGARAI BARAT, NUSA TENGGARA TIMUR",4,85,21,106
https://kawalpemilu.org#57727,"WATU WANGKA, MBELILING, MANGGARAI BARAT, NUSA TENGGARA TIMUR",5,170,11,181
https://kawalpemilu.org#57729,"GOLO NDOAL, MBELILING, MANGGARAI BARAT, NUSA TENGGARA TIMUR",1,28,109,137
https://kawalpemilu.org#57729,"GOLO NDOAL, MBELILING, MANGGARAI BARAT, NUSA TENGGARA TIMUR",2,127,18,145
https://kawalpemilu.org#57729,"GOLO NDOAL, MBELILING, MANGGARAI BARAT, NUSA TENGGARA TIMUR",3,101,3,104
https://kawalpemilu.org#57729,"GOLO NDOAL, MBELILING, MANGGARAI BARAT, NUSA TENGGARA TIMUR",4,91,24,115
https://kawalpemilu.org#57729,"GOLO NDOAL, MBELILING, MANGGARAI BARAT, NUSA TENGGARA TIMUR",5,90,24,114
https://kawalpemilu.org#57733,"GOLO DAMU, MBELILING, MANGGARAI BARAT, NUSA TENGGARA TIMUR",1,90,3,93
https://kawalpemilu.org#57733,"GOLO DAMU, MBELILING, MANGGARAI BARAT, NUSA TENGGARA TIMUR",2,116,5,121
https://kawalpemilu.org#57733,"GOLO DAMU, MBELILING, MANGGARAI BARAT, NUSA TENGGARA TIMUR",3,122,9,131
https://kawalpemilu.org#57733,"GOLO DAMU, MBELILING, MANGGARAI BARAT, NUSA TENGGARA TIMUR",4,157,14,171
https://kawalpemilu.org#57735,"TANDONG BELANG, MBELILING, MANGGARAI BARAT, NUSA TENGGARA TIMUR",1,216,8,224
https://kawalpemilu.org#57735,"TANDONG BELANG, MBELILING, MANGGARAI BARAT, NUSA TENGGARA TIMUR",2,200,19,219
https://kawalpemilu.org#57736,"WAE JARE, MBELILING, MANGGARAI BARAT, NUSA TENGGARA TIMUR",1,79,52,131
https://kawalpemilu.org#57736,"WAE JARE, MBELILING, MANGGARAI BARAT, NUSA TENGGARA TIMUR",2,131,24,155
https://kawalpemilu.org#57736,"WAE JARE, MBELILING, MANGGARAI BARAT, NUSA TENGGARA TIMUR",3,86,3,89
https://kawalpemilu.org#57736,"WAE JARE, MBELILING, MANGGARAI BARAT, NUSA TENGGARA TIMUR",4,81,5,86
https://kawalpemilu.org#57736,"WAE JARE, MBELILING, MANGGARAI BARAT, NUSA TENGGARA TIMUR",5,34,14,48
https://kawalpemilu.org#57737,"GOLO TANTONG, MBELILING, MANGGARAI BARAT, NUSA TENGGARA TIMUR",1,96,11,107
https://kawalpemilu.org#57737,"GOLO TANTONG, MBELILING, MANGGARAI BARAT, NUSA TENGGARA TIMUR",2,135,13,148
https://kawalpemilu.org#57737,"GOLO TANTONG, MBELILING, MANGGARAI BARAT, NUSA TENGGARA TIMUR",3,77,38,115
https://kawalpemilu.org#927940,"COMPANG LIANG NDARA, MBELILING, MANGGARAI BARAT, NUSA TENGGARA TIMUR",1,140,10,150
https://kawalpemilu.org#927940,"COMPANG LIANG NDARA, MBELILING, MANGGARAI BARAT, NUSA TENGGARA TIMUR",2,108,18,126
https://kawalpemilu.org#927941,"WATU GALANG, MBELILING, MANGGARAI BARAT, NUSA TENGGARA TIMUR",1,112,4,116
https://kawalpemilu.org#927941,"WATU GALANG, MBELILING, MANGGARAI BARAT, NUSA TENGGARA TIMUR",2,77,4,81
https://kawalpemilu.org#57659,"KOMBO, PACAR, MANGGARAI BARAT, NUSA TENGGARA TIMUR",1,0,0,0
https://kawalpemilu.org#57659,"KOMBO, PACAR, MANGGARAI BARAT, NUSA TENGGARA TIMUR",2,101,3,104
https://kawalpemilu.org#57659,"KOMBO, PACAR, MANGGARAI BARAT, NUSA TENGGARA TIMUR",3,232,8,240
https://kawalpemilu.org#57660,"PACAR, PACAR, MANGGARAI BARAT, NUSA TENGGARA TIMUR",1,159,3,162
https://kawalpemilu.org#57660,"PACAR, PACAR, MANGGARAI BARAT, NUSA TENGGARA TIMUR",2,119,3,122
https://kawalpemilu.org#57660,"PACAR, PACAR, MANGGARAI BARAT, NUSA TENGGARA TIMUR",3,132,6,138
https://kawalpemilu.org#57660,"PACAR, PACAR, MANGGARAI BARAT, NUSA TENGGARA TIMUR",4,158,5,163
https://kawalpemilu.org#57660,"PACAR, PACAR, MANGGARAI BARAT, NUSA TENGGARA TIMUR",5,169,8,177
https://kawalpemilu.org#57660,"PACAR, PACAR, MANGGARAI BARAT, NUSA TENGGARA TIMUR",6,140,13,153
https://kawalpemilu.org#57660,"PACAR, PACAR, MANGGARAI BARAT, NUSA TENGGARA TIMUR",7,170,13,183
https://kawalpemilu.org#57661,"GOLO LAJANG, PACAR, MANGGARAI BARAT, NUSA TENGGARA TIMUR",1,147,7,154
https://kawalpemilu.org#57661,"GOLO LAJANG, PACAR, MANGGARAI BARAT, NUSA TENGGARA TIMUR",2,131,7,138
https://kawalpemilu.org#57661,"GOLO LAJANG, PACAR, MANGGARAI BARAT, NUSA TENGGARA TIMUR",3,111,3,114
https://kawalpemilu.org#57661,"GOLO LAJANG, PACAR, MANGGARAI BARAT, NUSA TENGGARA TIMUR",4,170,5,175
https://kawalpemilu.org#57661,"GOLO LAJANG, PACAR, MANGGARAI BARAT, NUSA TENGGARA TIMUR",5,82,1,83
https://kawalpemilu.org#57662,"COMPANG, PACAR, MANGGARAI BARAT, NUSA TENGGARA TIMUR",1,205,5,210
https://kawalpemilu.org#57662,"COMPANG, PACAR, MANGGARAI BARAT, NUSA TENGGARA TIMUR",2,197,27,224
https://kawalpemilu.org#57662,"COMPANG, PACAR, MANGGARAI BARAT, NUSA TENGGARA TIMUR",3,212,5,217
https://kawalpemilu.org#57662,"COMPANG, PACAR, MANGGARAI BARAT, NUSA TENGGARA TIMUR",4,156,3,159
https://kawalpemilu.org#57662,"COMPANG, PACAR, MANGGARAI BARAT, NUSA TENGGARA TIMUR",5,177,4,181
https://kawalpemilu.org#57662,"COMPANG, PACAR, MANGGARAI BARAT, NUSA TENGGARA TIMUR",6,119,14,133
https://kawalpemilu.org#57662,"COMPANG, PACAR, MANGGARAI BARAT, NUSA TENGGARA TIMUR",7,186,7,193
https://kawalpemilu.org#57662,"COMPANG, PACAR, MANGGARAI BARAT, NUSA TENGGARA TIMUR",8,108,0,108
https://kawalpemilu.org#57663,"LOHA, PACAR, MANGGARAI BARAT, NUSA TENGGARA TIMUR",2,152,6,158
https://kawalpemilu.org#57663,"LOHA, PACAR, MANGGARAI BARAT, NUSA TENGGARA TIMUR",3,83,4,87
https://kawalpemilu.org#57663,"LOHA, PACAR, MANGGARAI BARAT, NUSA TENGGARA TIMUR",4,138,17,155
https://kawalpemilu.org#927898,"KOMBO TENGAH, PACAR, MANGGARAI BARAT, NUSA TENGGARA TIMUR",1,107,3,110
https://kawalpemilu.org#927898,"KOMBO TENGAH, PACAR, MANGGARAI BARAT, NUSA TENGGARA TIMUR",2,144,12,156
https://kawalpemilu.org#927898,"KOMBO TENGAH, PACAR, MANGGARAI BARAT, NUSA TENGGARA TIMUR",3,123,2,125
https://kawalpemilu.org#927899,"KOMBO SELATAN, PACAR, MANGGARAI BARAT, NUSA TENGGARA TIMUR",1,218,9,227
https://kawalpemilu.org#927899,"KOMBO SELATAN, PACAR, MANGGARAI BARAT, NUSA TENGGARA TIMUR",2,103,2,105
https://kawalpemilu.org#927899,"KOMBO SELATAN, PACAR, MANGGARAI BARAT, NUSA TENGGARA TIMUR",3,185,7,192
https://kawalpemilu.org#927899,"KOMBO SELATAN, PACAR, MANGGARAI BARAT, NUSA TENGGARA TIMUR",4,171,11,182
https://kawalpemilu.org#927902,"GOLO LAJANG BARAT, PACAR, MANGGARAI BARAT, NUSA TENGGARA TIMUR",1,118,5,123
https://kawalpemilu.org#927902,"GOLO LAJANG BARAT, PACAR, MANGGARAI BARAT, NUSA TENGGARA TIMUR",2,98,0,98
https://kawalpemilu.org#927902,"GOLO LAJANG BARAT, PACAR, MANGGARAI BARAT, NUSA TENGGARA TIMUR",3,163,7,170
https://kawalpemilu.org#927902,"GOLO LAJANG BARAT, PACAR, MANGGARAI BARAT, NUSA TENGGARA TIMUR",4,161,3,164
https://kawalpemilu.org#927902,"GOLO LAJANG BARAT, PACAR, MANGGARAI BARAT, NUSA TENGGARA TIMUR",5,139,7,146
https://kawalpemilu.org#927902,"GOLO LAJANG BARAT, PACAR, MANGGARAI BARAT, NUSA TENGGARA TIMUR",6,120,7,127
https://kawalpemilu.org#927904,"PONG KOLONG, PACAR, MANGGARAI BARAT, NUSA TENGGARA TIMUR",1,150,6,156
https://kawalpemilu.org#927904,"PONG KOLONG, PACAR, MANGGARAI BARAT, NUSA TENGGARA TIMUR",2,115,8,123
https://kawalpemilu.org#927905,"BENTENG NDOPE, PACAR, MANGGARAI BARAT, NUSA TENGGARA TIMUR",1,216,6,222
https://kawalpemilu.org#927905,"BENTENG NDOPE, PACAR, MANGGARAI BARAT, NUSA TENGGARA TIMUR",2,155,9,164
https://kawalpemilu.org#927905,"BENTENG NDOPE, PACAR, MANGGARAI BARAT, NUSA TENGGARA TIMUR",3,219,11,230
https://kawalpemilu.org#57667,"KOLANG, KUWUS BARAT, MANGGARAI BARAT, NUSA TENGGARA TIMUR",1,145,3,148
https://kawalpemilu.org#57667,"KOLANG, KUWUS BARAT, MANGGARAI BARAT, NUSA TENGGARA TIMUR",2,171,1,172
https://kawalpemilu.org#57667,"KOLANG, KUWUS BARAT, MANGGARAI BARAT, NUSA TENGGARA TIMUR",3,171,10,181
https://kawalpemilu.org#57669,"GOLO RIWU, KUWUS BARAT, MANGGARAI BARAT, NUSA TENGGARA TIMUR",1,161,6,167
https://kawalpemilu.org#57669,"GOLO RIWU, KUWUS BARAT, MANGGARAI BARAT, NUSA TENGGARA TIMUR",2,190,10,200
https://kawalpemilu.org#57669,"GOLO RIWU, KUWUS BARAT, MANGGARAI BARAT, NUSA TENGGARA TIMUR",3,196,12,208
https://kawalpemilu.org#57678,"RANGGU, KUWUS BARAT, MANGGARAI BARAT, NUSA TENGGARA TIMUR",1,224,4,228
https://kawalpemilu.org#57678,"RANGGU, KUWUS BARAT, MANGGARAI BARAT, NUSA TENGGARA TIMUR",2,189,6,195
https://kawalpemilu.org#57678,"RANGGU, KUWUS BARAT, MANGGARAI BARAT, NUSA TENGGARA TIMUR",3,158,0,158
https://kawalpemilu.org#57678,"RANGGU, KUWUS BARAT, MANGGARAI BARAT, NUSA TENGGARA TIMUR",4,123,6,129
https://kawalpemilu.org#57680,"GOLO LEWE, KUWUS BARAT, MANGGARAI BARAT, NUSA TENGGARA TIMUR",1,226,3,229
https://kawalpemilu.org#57680,"GOLO LEWE, KUWUS BARAT, MANGGARAI BARAT, NUSA TENGGARA TIMUR",2,267,6,273
https://kawalpemilu.org#57680,"GOLO LEWE, KUWUS BARAT, MANGGARAI BARAT, NUSA TENGGARA TIMUR",3,122,2,124
https://kawalpemilu.org#57680,"GOLO LEWE, KUWUS BARAT, MANGGARAI BARAT, NUSA TENGGARA TIMUR",4,100,8,108
https://kawalpemilu.org#57680,"GOLO LEWE, KUWUS BARAT, MANGGARAI BARAT, NUSA TENGGARA TIMUR",5,0,0,0
https://kawalpemilu.org#57680,"GOLO LEWE, KUWUS BARAT, MANGGARAI BARAT, NUSA TENGGARA TIMUR",6,119,8,127
https://kawalpemilu.org#57681,"TUENG, KUWUS BARAT, MANGGARAI BARAT, NUSA TENGGARA TIMUR",1,124,0,124
https://kawalpemilu.org#57681,"TUENG, KUWUS BARAT, MANGGARAI BARAT, NUSA TENGGARA TIMUR",2,133,1,134
https://kawalpemilu.org#57681,"TUENG, KUWUS BARAT, MANGGARAI BARAT, NUSA TENGGARA TIMUR",3,164,1,165
https://kawalpemilu.org#57681,"TUENG, KUWUS BARAT, MANGGARAI BARAT, NUSA TENGGARA TIMUR",4,283,2,285
https://kawalpemilu.org#57689,"GOLO WEDONG, KUWUS BARAT, MANGGARAI BARAT, NUSA TENGGARA TIMUR",1,140,5,145
https://kawalpemilu.org#57689,"GOLO WEDONG, KUWUS BARAT, MANGGARAI BARAT, NUSA TENGGARA TIMUR",2,164,18,182
https://kawalpemilu.org#57689,"GOLO WEDONG, KUWUS BARAT, MANGGARAI BARAT, NUSA TENGGARA TIMUR",3,120,1,121
https://kawalpemilu.org#57689,"GOLO WEDONG, KUWUS BARAT, MANGGARAI BARAT, NUSA TENGGARA TIMUR",4,140,0,140
https://kawalpemilu.org#57690,"TENGKU, KUWUS BARAT, MANGGARAI BARAT, NUSA TENGGARA TIMUR",1,237,5,242
https://kawalpemilu.org#57690,"TENGKU, KUWUS BARAT, MANGGARAI BARAT, NUSA TENGGARA TIMUR",2,218,3,221
https://kawalpemilu.org#57691,"COMPANG KULES, KUWUS BARAT, MANGGARAI BARAT, NUSA TENGGARA TIMUR",1,131,1,132
https://kawalpemilu.org#57691,"COMPANG KULES, KUWUS BARAT, MANGGARAI BARAT, NUSA TENGGARA TIMUR",2,167,9,176
https://kawalpemilu.org#57691,"COMPANG KULES, KUWUS BARAT, MANGGARAI BARAT, NUSA TENGGARA TIMUR",3,108,1,109
https://kawalpemilu.org#57691,"COMPANG KULES, KUWUS BARAT, MANGGARAI BARAT, NUSA TENGGARA TIMUR",4,98,8,106
https://kawalpemilu.org#57691,"COMPANG KULES, KUWUS BARAT, MANGGARAI BARAT, NUSA TENGGARA TIMUR",5,121,8,129
https://kawalpemilu.org#927906,"SOMPANG KOLANG, KUWUS BARAT, MANGGARAI BARAT, NUSA TENGGARA TIMUR",1,207,2,209
https://kawalpemilu.org#927906,"SOMPANG KOLANG, KUWUS BARAT, MANGGARAI BARAT, NUSA TENGGARA TIMUR",2,182,4,186
https://kawalpemilu.org#927908,"WAJUR, KUWUS BARAT, MANGGARAI BARAT, NUSA TENGGARA TIMUR",1,183,10,193
https://kawalpemilu.org#927908,"WAJUR, KUWUS BARAT, MANGGARAI BARAT, NUSA TENGGARA TIMUR",2,146,8,154
https://kawalpemilu.org#57780,"DHAWE, AESESA, NAGEKEO, NUSA TENGGARA TIMUR",1,201,6,207
https://kawalpemilu.org#57780,"DHAWE, AESESA, NAGEKEO, NUSA TENGGARA TIMUR",2,162,3,165
https://kawalpemilu.org#57780,"DHAWE, AESESA, NAGEKEO, NUSA TENGGARA TIMUR",3,185,5,190
https://kawalpemilu.org#57780,"DHAWE, AESESA, NAGEKEO, NUSA TENGGARA TIMUR",4,144,2,146
https://kawalpemilu.org#57780,"DHAWE, AESESA, NAGEKEO, NUSA TENGGARA TIMUR",5,109,4,113
https://kawalpemilu.org#57780,"DHAWE, AESESA, NAGEKEO, NUSA TENGGARA TIMUR",6,231,10,241
https://kawalpemilu.org#57781,"MBAY I, AESESA, NAGEKEO, NUSA TENGGARA TIMUR",1,87,145,232
https://kawalpemilu.org#57781,"MBAY I, AESESA, NAGEKEO, NUSA TENGGARA TIMUR",2,64,199,263
https://kawalpemilu.org#57781,"MBAY I, AESESA, NAGEKEO, NUSA TENGGARA TIMUR",3,34,170,204
https://kawalpemilu.org#57781,"MBAY I, AESESA, NAGEKEO, NUSA TENGGARA TIMUR",4,67,152,219
https://kawalpemilu.org#57781,"MBAY I, AESESA, NAGEKEO, NUSA TENGGARA TIMUR",5,125,132,257
https://kawalpemilu.org#57781,"MBAY I, AESESA, NAGEKEO, NUSA TENGGARA TIMUR",6,78,168,246
https://kawalpemilu.org#57781,"MBAY I, AESESA, NAGEKEO, NUSA TENGGARA TIMUR",7,0,0,183
https://kawalpemilu.org#57781,"MBAY I, AESESA, NAGEKEO, NUSA TENGGARA TIMUR",8,59,157,216
https://kawalpemilu.org#57781,"MBAY I, AESESA, NAGEKEO, NUSA TENGGARA TIMUR",9,67,137,204
https://kawalpemilu.org#57782,"TOWAK, AESESA, NAGEKEO, NUSA TENGGARA TIMUR",1,230,2,232
https://kawalpemilu.org#57782,"TOWAK, AESESA, NAGEKEO, NUSA TENGGARA TIMUR",2,183,9,192
https://kawalpemilu.org#57782,"TOWAK, AESESA, NAGEKEO, NUSA TENGGARA TIMUR",3,158,9,167
https://kawalpemilu.org#57783,"MBAY II, AESESA, NAGEKEO, NUSA TENGGARA TIMUR",1,207,37,244
https://kawalpemilu.org#57783,"MBAY II, AESESA, NAGEKEO, NUSA TENGGARA TIMUR",2,208,22,230
https://kawalpemilu.org#57783,"MBAY II, AESESA, NAGEKEO, NUSA TENGGARA TIMUR",4,213,11,224
https://kawalpemilu.org#57784,"DANGA, AESESA, NAGEKEO, NUSA TENGGARA TIMUR",1,220,18,238
https://kawalpemilu.org#57784,"DANGA, AESESA, NAGEKEO, NUSA TENGGARA TIMUR",2,234,11,245
https://kawalpemilu.org#57784,"DANGA, AESESA, NAGEKEO, NUSA TENGGARA TIMUR",3,184,22,206
https://kawalpemilu.org#57784,"DANGA, AESESA, NAGEKEO, NUSA TENGGARA TIMUR",4,175,39,214
https://kawalpemilu.org#57784,"DANGA, AESESA, NAGEKEO, NUSA TENGGARA TIMUR",5,217,31,248
https://kawalpemilu.org#57784,"DANGA, AESESA, NAGEKEO, NUSA TENGGARA TIMUR",6,127,83,210
https://kawalpemilu.org#57784,"DANGA, AESESA, NAGEKEO, NUSA TENGGARA TIMUR",7,183,9,192
https://kawalpemilu.org#57784,"DANGA, AESESA, NAGEKEO, NUSA TENGGARA TIMUR",8,227,24,251
https://kawalpemilu.org#57784,"DANGA, AESESA, NAGEKEO, NUSA TENGGARA TIMUR",9,222,19,241
https://kawalpemilu.org#57784,"DANGA, AESESA, NAGEKEO, NUSA TENGGARA TIMUR",10,202,20,222
https://kawalpemilu.org#57784,"DANGA, AESESA, NAGEKEO, NUSA TENGGARA TIMUR",11,192,24,216
https://kawalpemilu.org#57784,"DANGA, AESESA, NAGEKEO, NUSA TENGGARA TIMUR",12,216,12,228
https://kawalpemilu.org#57784,"DANGA, AESESA, NAGEKEO, NUSA TENGGARA TIMUR",13,210,11,221
https://kawalpemilu.org#57784,"DANGA, AESESA, NAGEKEO, NUSA TENGGARA TIMUR",14,208,30,238
https://kawalpemilu.org#57784,"DANGA, AESESA, NAGEKEO, NUSA TENGGARA TIMUR",15,241,1,242
https://kawalpemilu.org#57784,"DANGA, AESESA, NAGEKEO, NUSA TENGGARA TIMUR",16,215,17,232
https://kawalpemilu.org#57784,"DANGA, AESESA, NAGEKEO, NUSA TENGGARA TIMUR",17,164,14,178
https://kawalpemilu.org#57784,"DANGA, AESESA, NAGEKEO, NUSA TENGGARA TIMUR",18,204,18,222
https://kawalpemilu.org#57784,"DANGA, AESESA, NAGEKEO, NUSA TENGGARA TIMUR",19,194,4,198
https://kawalpemilu.org#57784,"DANGA, AESESA, NAGEKEO, NUSA TENGGARA TIMUR",20,70,17,87
https://kawalpemilu.org#57785,"LAPE, AESESA, NAGEKEO, NUSA TENGGARA TIMUR",1,213,10,223
https://kawalpemilu.org#57785,"LAPE, AESESA, NAGEKEO, NUSA TENGGARA TIMUR",2,230,7,237
https://kawalpemilu.org#57785,"LAPE, AESESA, NAGEKEO, NUSA TENGGARA TIMUR",3,210,3,213
https://kawalpemilu.org#57785,"LAPE, AESESA, NAGEKEO, NUSA TENGGARA TIMUR",4,116,3,119
https://kawalpemilu.org#57785,"LAPE, AESESA, NAGEKEO, NUSA TENGGARA TIMUR",5,217,3,220
https://kawalpemilu.org#57785,"LAPE, AESESA, NAGEKEO, NUSA TENGGARA TIMUR",6,234,4,238
https://kawalpemilu.org#57785,"LAPE, AESESA, NAGEKEO, NUSA TENGGARA TIMUR",7,173,2,175
https://kawalpemilu.org#57785,"LAPE, AESESA, NAGEKEO, NUSA TENGGARA TIMUR",8,214,1,215
https://kawalpemilu.org#57785,"LAPE, AESESA, NAGEKEO, NUSA TENGGARA TIMUR",9,207,2,209
https://kawalpemilu.org#57786,"LABOLEWA, AESESA, NAGEKEO, NUSA TENGGARA TIMUR",1,188,16,204
https://kawalpemilu.org#57786,"LABOLEWA, AESESA, NAGEKEO, NUSA TENGGARA TIMUR",2,203,1,204
https://kawalpemilu.org#57786,"LABOLEWA, AESESA, NAGEKEO, NUSA TENGGARA TIMUR",3,228,6,234
https://kawalpemilu.org#57786,"LABOLEWA, AESESA, NAGEKEO, NUSA TENGGARA TIMUR",4,173,1,174
https://kawalpemilu.org#57786,"LABOLEWA, AESESA, NAGEKEO, NUSA TENGGARA TIMUR",5,170,2,172
https://kawalpemilu.org#57787,"TEDAMUDE, AESESA, NAGEKEO, NUSA TENGGARA TIMUR",1,239,11,250
https://kawalpemilu.org#57787,"TEDAMUDE, AESESA, NAGEKEO, NUSA TENGGARA TIMUR",2,187,6,193
https://kawalpemilu.org#57788,"NGGOLONIO, AESESA, NAGEKEO, NUSA TENGGARA TIMUR",1,159,4,163
https://kawalpemilu.org#57788,"NGGOLONIO, AESESA, NAGEKEO, NUSA TENGGARA TIMUR",2,226,9,235
https://kawalpemilu.org#57788,"NGGOLONIO, AESESA, NAGEKEO, NUSA TENGGARA TIMUR",3,200,8,208
https://kawalpemilu.org#57788,"NGGOLONIO, AESESA, NAGEKEO, NUSA TENGGARA TIMUR",5,140,1,141
https://kawalpemilu.org#57789,"OLAIA, AESESA, NAGEKEO, NUSA TENGGARA TIMUR",1,0,0,0
https://kawalpemilu.org#57789,"OLAIA, AESESA, NAGEKEO, NUSA TENGGARA TIMUR",2,194,10,204
https://kawalpemilu.org#57789,"OLAIA, AESESA, NAGEKEO, NUSA TENGGARA TIMUR",3,225,2,227
https://kawalpemilu.org#57789,"OLAIA, AESESA, NAGEKEO, NUSA TENGGARA TIMUR",4,219,5,224
https://kawalpemilu.org#57790,"AERAMO, AESESA, NAGEKEO, NUSA TENGGARA TIMUR",1,192,17,209
https://kawalpemilu.org#57790,"AERAMO, AESESA, NAGEKEO, NUSA TENGGARA TIMUR",2,205,20,225
https://kawalpemilu.org#57790,"AERAMO, AESESA, NAGEKEO, NUSA TENGGARA TIMUR",3,191,11,202
https://kawalpemilu.org#57790,"AERAMO, AESESA, NAGEKEO, NUSA TENGGARA TIMUR",4,184,28,212
https://kawalpemilu.org#57790,"AERAMO, AESESA, NAGEKEO, NUSA TENGGARA TIMUR",5,208,12,220
https://kawalpemilu.org#57790,"AERAMO, AESESA, NAGEKEO, NUSA TENGGARA TIMUR",6,208,8,216
https://kawalpemilu.org#57790,"AERAMO, AESESA, NAGEKEO, NUSA TENGGARA TIMUR",7,195,4,199
https://kawalpemilu.org#57790,"AERAMO, AESESA, NAGEKEO, NUSA TENGGARA TIMUR",8,182,8,190
https://kawalpemilu.org#57790,"AERAMO, AESESA, NAGEKEO, NUSA TENGGARA TIMUR",9,171,56,227
https://kawalpemilu.org#57790,"AERAMO, AESESA, NAGEKEO, NUSA TENGGARA TIMUR",10,225,9,234
https://kawalpemilu.org#57790,"AERAMO, AESESA, NAGEKEO, NUSA TENGGARA TIMUR",11,196,10,206
https://kawalpemilu.org#57790,"AERAMO, AESESA, NAGEKEO, NUSA TENGGARA TIMUR",12,165,7,172
https://kawalpemilu.org#57790,"AERAMO, AESESA, NAGEKEO, NUSA TENGGARA TIMUR",13,48,6,54
https://kawalpemilu.org#57791,"MARAPOKOT, AESESA, NAGEKEO, NUSA TENGGARA TIMUR",1,136,82,218
https://kawalpemilu.org#57791,"MARAPOKOT, AESESA, NAGEKEO, NUSA TENGGARA TIMUR",2,143,78,221
https://kawalpemilu.org#57791,"MARAPOKOT, AESESA, NAGEKEO, NUSA TENGGARA TIMUR",3,185,13,198
https://kawalpemilu.org#57791,"MARAPOKOT, AESESA, NAGEKEO, NUSA TENGGARA TIMUR",4,167,2,169
https://kawalpemilu.org#57791,"MARAPOKOT, AESESA, NAGEKEO, NUSA TENGGARA TIMUR",5,140,20,160
https://kawalpemilu.org#57792,"TONGGURAMBANG, AESESA, NAGEKEO, NUSA TENGGARA TIMUR",1,50,94,144
https://kawalpemilu.org#57792,"TONGGURAMBANG, AESESA, NAGEKEO, NUSA TENGGARA TIMUR",2,94,137,231
https://kawalpemilu.org#57792,"TONGGURAMBANG, AESESA, NAGEKEO, NUSA TENGGARA TIMUR",3,164,73,237
https://kawalpemilu.org#57792,"TONGGURAMBANG, AESESA, NAGEKEO, NUSA TENGGARA TIMUR",4,152,18,170
https://kawalpemilu.org#57793,"WAEKOKAK, AESESA, NAGEKEO, NUSA TENGGARA TIMUR",1,142,33,175
https://kawalpemilu.org#57793,"WAEKOKAK, AESESA, NAGEKEO, NUSA TENGGARA TIMUR",2,121,55,176
https://kawalpemilu.org#57793,"WAEKOKAK, AESESA, NAGEKEO, NUSA TENGGARA TIMUR",3,133,32,165
https://kawalpemilu.org#57793,"WAEKOKAK, AESESA, NAGEKEO, NUSA TENGGARA TIMUR",4,161,20,181
https://kawalpemilu.org#57793,"WAEKOKAK, AESESA, NAGEKEO, NUSA TENGGARA TIMUR",5,174,5,179
https://kawalpemilu.org#57794,"NGEGEDHAWE, AESESA, NAGEKEO, NUSA TENGGARA TIMUR",1,205,13,218
https://kawalpemilu.org#57794,"NGEGEDHAWE, AESESA, NAGEKEO, NUSA TENGGARA TIMUR",2,210,6,216
https://kawalpemilu.org#57794,"NGEGEDHAWE, AESESA, NAGEKEO, NUSA TENGGARA TIMUR",3,85,3,88
https://kawalpemilu.org#57795,"TEDAKISA, AESESA, NAGEKEO, NUSA TENGGARA TIMUR",1,132,2,134
https://kawalpemilu.org#57795,"TEDAKISA, AESESA, NAGEKEO, NUSA TENGGARA TIMUR",2,206,2,208
https://kawalpemilu.org#57795,"TEDAKISA, AESESA, NAGEKEO, NUSA TENGGARA TIMUR",3,160,7,167
https://kawalpemilu.org#57796,"NGGOLOMBAY, AESESA, NAGEKEO, NUSA TENGGARA TIMUR",1,135,108,243
https://kawalpemilu.org#57796,"NGGOLOMBAY, AESESA, NAGEKEO, NUSA TENGGARA TIMUR",2,117,101,218
https://kawalpemilu.org#57796,"NGGOLOMBAY, AESESA, NAGEKEO, NUSA TENGGARA TIMUR",3,70,11,81
https://kawalpemilu.org#57797,"NANGADHERO, AESESA, NAGEKEO, NUSA TENGGARA TIMUR",1,152,57,209
https://kawalpemilu.org#57797,"NANGADHERO, AESESA, NAGEKEO, NUSA TENGGARA TIMUR",2,150,52,202
https://kawalpemilu.org#57797,"NANGADHERO, AESESA, NAGEKEO, NUSA TENGGARA TIMUR",4,136,66,202
https://kawalpemilu.org#57799,"NANGARORO, NANGARORO, NAGEKEO, NUSA TENGGARA TIMUR",1,149,2,151
https://kawalpemilu.org#57799,"NANGARORO, NANGARORO, NAGEKEO, NUSA TENGGARA TIMUR",2,178,48,226
https://kawalpemilu.org#57799,"NANGARORO, NANGARORO, NAGEKEO, NUSA TENGGARA TIMUR",3,213,18,231
https://kawalpemilu.org#57799,"NANGARORO, NANGARORO, NAGEKEO, NUSA TENGGARA TIMUR",4,204,5,209
https://kawalpemilu.org#57799,"NANGARORO, NANGARORO, NAGEKEO, NUSA TENGGARA TIMUR",5,177,6,183
https://kawalpemilu.org#57799,"NANGARORO, NANGARORO, NAGEKEO, NUSA TENGGARA TIMUR",6,135,3,138
https://kawalpemilu.org#57799,"NANGARORO, NANGARORO, NAGEKEO, NUSA TENGGARA TIMUR",7,208,2,210
https://kawalpemilu.org#57799,"NANGARORO, NANGARORO, NAGEKEO, NUSA TENGGARA TIMUR",8,150,84,234
https://kawalpemilu.org#57800,"PODENURA, NANGARORO, NAGEKEO, NUSA TENGGARA TIMUR",1,144,59,203
https://kawalpemilu.org#57800,"PODENURA, NANGARORO, NAGEKEO, NUSA TENGGARA TIMUR",2,163,5,168
https://kawalpemilu.org#57800,"PODENURA, NANGARORO, NAGEKEO, NUSA TENGGARA TIMUR",3,98,0,98
https://kawalpemilu.org#57801,"TONGGO, NANGARORO, NAGEKEO, NUSA TENGGARA TIMUR",1,113,50,163
https://kawalpemilu.org#57801,"TONGGO, NANGARORO, NAGEKEO, NUSA TENGGARA TIMUR",2,19,97,116
https://kawalpemilu.org#57801,"TONGGO, NANGARORO, NAGEKEO, NUSA TENGGARA TIMUR",3,108,0,108
https://kawalpemilu.org#57802,"WOKODEKORORO, NANGARORO, NAGEKEO, NUSA TENGGARA TIMUR",1,147,1,148
https://kawalpemilu.org#57802,"WOKODEKORORO, NANGARORO, NAGEKEO, NUSA TENGGARA TIMUR",2,169,4,173
https://kawalpemilu.org#57803,"RITI, NANGARORO, NAGEKEO, NUSA TENGGARA TIMUR",1,123,1,124
https://kawalpemilu.org#57803,"RITI, NANGARORO, NAGEKEO, NUSA TENGGARA TIMUR",2,177,6,183
https://kawalpemilu.org#57803,"RITI, NANGARORO, NAGEKEO, NUSA TENGGARA TIMUR",3,188,2,190
https://kawalpemilu.org#57803,"RITI, NANGARORO, NAGEKEO, NUSA TENGGARA TIMUR",4,230,3,233
https://kawalpemilu.org#57803,"RITI, NANGARORO, NAGEKEO, NUSA TENGGARA TIMUR",5,82,1,83
https://kawalpemilu.org#57804,"KOTAKEO, NANGARORO, NAGEKEO, NUSA TENGGARA TIMUR",1,197,3,200
https://kawalpemilu.org#57804,"KOTAKEO, NANGARORO, NAGEKEO, NUSA TENGGARA TIMUR",2,126,2,128
https://kawalpemilu.org#57804,"KOTAKEO, NANGARORO, NAGEKEO, NUSA TENGGARA TIMUR",3,157,1,158
https://kawalpemilu.org#57805,"PAGOMOGO, NANGARORO, NAGEKEO, NUSA TENGGARA TIMUR",1,215,3,218
https://kawalpemilu.org#57805,"PAGOMOGO, NANGARORO, NAGEKEO, NUSA TENGGARA TIMUR",2,193,4,197
https://kawalpemilu.org#57805,"PAGOMOGO, NANGARORO, NAGEKEO, NUSA TENGGARA TIMUR",3,213,3,216
https://kawalpemilu.org#57805,"PAGOMOGO, NANGARORO, NAGEKEO, NUSA TENGGARA TIMUR",4,195,0,195
https://kawalpemilu.org#57806,"DEGALEA, NANGARORO, NAGEKEO, NUSA TENGGARA TIMUR",1,226,7,233
https://kawalpemilu.org#57806,"DEGALEA, NANGARORO, NAGEKEO, NUSA TENGGARA TIMUR",2,203,5,208
https://kawalpemilu.org#57807,"ULUPULU, NANGARORO, NAGEKEO, NUSA TENGGARA TIMUR",1,177,2,179
https://kawalpemilu.org#57807,"ULUPULU, NANGARORO, NAGEKEO, NUSA TENGGARA TIMUR",2,161,3,164
https://kawalpemilu.org#57807,"ULUPULU, NANGARORO, NAGEKEO, NUSA TENGGARA TIMUR",3,146,4,150
https://kawalpemilu.org#57807,"ULUPULU, NANGARORO, NAGEKEO, NUSA TENGGARA TIMUR",4,168,4,172
https://kawalpemilu.org#57807,"ULUPULU, NANGARORO, NAGEKEO, NUSA TENGGARA TIMUR",5,71,3,74
https://kawalpemilu.org#57808,"BIDOA, NANGARORO, NAGEKEO, NUSA TENGGARA TIMUR",1,161,5,166
https://kawalpemilu.org#57808,"BIDOA, NANGARORO, NAGEKEO, NUSA TENGGARA TIMUR",2,202,0,202
https://kawalpemilu.org#57808,"BIDOA, NANGARORO, NAGEKEO, NUSA TENGGARA TIMUR",3,194,3,197
https://kawalpemilu.org#57809,"UTETOTO, NANGARORO, NAGEKEO, NUSA TENGGARA TIMUR",1,134,6,140
https://kawalpemilu.org#57809,"UTETOTO, NANGARORO, NAGEKEO, NUSA TENGGARA TIMUR",2,125,5,130
https://kawalpemilu.org#57809,"UTETOTO, NANGARORO, NAGEKEO, NUSA TENGGARA TIMUR",3,127,5,132
https://kawalpemilu.org#57810,"NATAUTE, NANGARORO, NAGEKEO, NUSA TENGGARA TIMUR",1,207,14,221
https://kawalpemilu.org#57810,"NATAUTE, NANGARORO, NAGEKEO, NUSA TENGGARA TIMUR",2,135,2,137
https://kawalpemilu.org#57811,"WOEDOA, NANGARORO, NAGEKEO, NUSA TENGGARA TIMUR",1,181,5,186
https://kawalpemilu.org#57811,"WOEDOA, NANGARORO, NAGEKEO, NUSA TENGGARA TIMUR",2,163,2,165
https://kawalpemilu.org#57811,"WOEDOA, NANGARORO, NAGEKEO, NUSA TENGGARA TIMUR",3,139,4,143
https://kawalpemilu.org#57812,"WOEWUTU, NANGARORO, NAGEKEO, NUSA TENGGARA TIMUR",1,194,9,203
https://kawalpemilu.org#57812,"WOEWUTU, NANGARORO, NAGEKEO, NUSA TENGGARA TIMUR",2,38,176,214
https://kawalpemilu.org#57812,"WOEWUTU, NANGARORO, NAGEKEO, NUSA TENGGARA TIMUR",3,130,3,133
https://kawalpemilu.org#57813,"ULUPULU I, NANGARORO, NAGEKEO, NUSA TENGGARA TIMUR",1,196,8,204
https://kawalpemilu.org#57813,"ULUPULU I, NANGARORO, NAGEKEO, NUSA TENGGARA TIMUR",2,160,9,169
https://kawalpemilu.org#57813,"ULUPULU I, NANGARORO, NAGEKEO, NUSA TENGGARA TIMUR",3,156,7,163
https://kawalpemilu.org#57813,"ULUPULU I, NANGARORO, NAGEKEO, NUSA TENGGARA TIMUR",4,147,8,155
https://kawalpemilu.org#85206,"WOKOWOE, NANGARORO, NAGEKEO, NUSA TENGGARA TIMUR",1,192,2,194
https://kawalpemilu.org#85206,"WOKOWOE, NANGARORO, NAGEKEO, NUSA TENGGARA TIMUR",2,207,14,221
https://kawalpemilu.org#85207,"KOTAKEO I, NANGARORO, NAGEKEO, NUSA TENGGARA TIMUR",1,153,1,154
https://kawalpemilu.org#85207,"KOTAKEO I, NANGARORO, NAGEKEO, NUSA TENGGARA TIMUR",2,166,3,169
https://kawalpemilu.org#85207,"KOTAKEO I, NANGARORO, NAGEKEO, NUSA TENGGARA TIMUR",3,160,1,161
https://kawalpemilu.org#85208,"KOTAKEO II, NANGARORO, NAGEKEO, NUSA TENGGARA TIMUR",1,177,1,178
https://kawalpemilu.org#85208,"KOTAKEO II, NANGARORO, NAGEKEO, NUSA TENGGARA TIMUR",2,211,3,214
https://kawalpemilu.org#85209,"ODAUTE, NANGARORO, NAGEKEO, NUSA TENGGARA TIMUR",1,94,0,94
https://kawalpemilu.org#85209,"ODAUTE, NANGARORO, NAGEKEO, NUSA TENGGARA TIMUR",2,127,2,129
https://kawalpemilu.org#57815,"NATANAGE, BOAWAE, NAGEKEO, NUSA TENGGARA TIMUR",1,160,5,165
https://kawalpemilu.org#57815,"NATANAGE, BOAWAE, NAGEKEO, NUSA TENGGARA TIMUR",2,208,2,210
https://kawalpemilu.org#57815,"NATANAGE, BOAWAE, NAGEKEO, NUSA TENGGARA TIMUR",3,162,31,193
https://kawalpemilu.org#57815,"NATANAGE, BOAWAE, NAGEKEO, NUSA TENGGARA TIMUR",4,183,19,202
https://kawalpemilu.org#57815,"NATANAGE, BOAWAE, NAGEKEO, NUSA TENGGARA TIMUR",5,114,6,120
https://kawalpemilu.org#57815,"NATANAGE, BOAWAE, NAGEKEO, NUSA TENGGARA TIMUR",7,170,1,171
https://kawalpemilu.org#57815,"NATANAGE, BOAWAE, NAGEKEO, NUSA TENGGARA TIMUR",8,174,1,175
https://kawalpemilu.org#57816,"NAGESAPADHI, BOAWAE, NAGEKEO, NUSA TENGGARA TIMUR",1,203,8,211
https://kawalpemilu.org#57816,"NAGESAPADHI, BOAWAE, NAGEKEO, NUSA TENGGARA TIMUR",2,165,10,175
https://kawalpemilu.org#57816,"NAGESAPADHI, BOAWAE, NAGEKEO, NUSA TENGGARA TIMUR",3,247,11,258
https://kawalpemilu.org#57816,"NAGESAPADHI, BOAWAE, NAGEKEO, NUSA TENGGARA TIMUR",4,195,15,210
https://kawalpemilu.org#57816,"NAGESAPADHI, BOAWAE, NAGEKEO, NUSA TENGGARA TIMUR",5,212,2,214
https://kawalpemilu.org#57817,"NAGEOGA, BOAWAE, NAGEKEO, NUSA TENGGARA TIMUR",1,175,12,187
https://kawalpemilu.org#57817,"NAGEOGA, BOAWAE, NAGEKEO, NUSA TENGGARA TIMUR",2,174,7,181
https://kawalpemilu.org#57817,"NAGEOGA, BOAWAE, NAGEKEO, NUSA TENGGARA TIMUR",3,219,7,226
https://kawalpemilu.org#57817,"NAGEOGA, BOAWAE, NAGEKEO, NUSA TENGGARA TIMUR",4,223,14,237
https://kawalpemilu.org#57817,"NAGEOGA, BOAWAE, NAGEKEO, NUSA TENGGARA TIMUR",6,136,8,144
https://kawalpemilu.org#57817,"NAGEOGA, BOAWAE, NAGEKEO, NUSA TENGGARA TIMUR",7,168,5,173
https://kawalpemilu.org#57817,"NAGEOGA, BOAWAE, NAGEKEO, NUSA TENGGARA TIMUR",8,140,4,144
https://kawalpemilu.org#57818,"WOLOPOGO, BOAWAE, NAGEKEO, NUSA TENGGARA TIMUR",1,243,5,248
https://kawalpemilu.org#57818,"WOLOPOGO, BOAWAE, NAGEKEO, NUSA TENGGARA TIMUR",2,246,2,248
https://kawalpemilu.org#57818,"WOLOPOGO, BOAWAE, NAGEKEO, NUSA TENGGARA TIMUR",3,227,3,230
https://kawalpemilu.org#57819,"REGA, BOAWAE, NAGEKEO, NUSA TENGGARA TIMUR",1,194,1,195
https://kawalpemilu.org#57819,"REGA, BOAWAE, NAGEKEO, NUSA TENGGARA TIMUR",2,203,5,208
https://kawalpemilu.org#57819,"REGA, BOAWAE, NAGEKEO, NUSA TENGGARA TIMUR",3,213,8,221
https://kawalpemilu.org#57819,"REGA, BOAWAE, NAGEKEO, NUSA TENGGARA TIMUR",4,198,3,201
https://kawalpemilu.org#57819,"REGA, BOAWAE, NAGEKEO, NUSA TENGGARA TIMUR",5,197,6,203
https://kawalpemilu.org#57819,"REGA, BOAWAE, NAGEKEO, NUSA TENGGARA TIMUR",6,213,11,224
https://kawalpemilu.org#57819,"REGA, BOAWAE, NAGEKEO, NUSA TENGGARA TIMUR",7,192,9,201
https://kawalpemilu.org#57820,"RATONGAMOBO, BOAWAE, NAGEKEO, NUSA TENGGARA TIMUR",1,193,10,203
https://kawalpemilu.org#57820,"RATONGAMOBO, BOAWAE, NAGEKEO, NUSA TENGGARA TIMUR",2,217,7,224
https://kawalpemilu.org#57820,"RATONGAMOBO, BOAWAE, NAGEKEO, NUSA TENGGARA TIMUR",3,199,4,203
https://kawalpemilu.org#57820,"RATONGAMOBO, BOAWAE, NAGEKEO, NUSA TENGGARA TIMUR",4,173,7,180
https://kawalpemilu.org#57820,"RATONGAMOBO, BOAWAE, NAGEKEO, NUSA TENGGARA TIMUR",5,167,4,171
https://kawalpemilu.org#57820,"RATONGAMOBO, BOAWAE, NAGEKEO, NUSA TENGGARA TIMUR",6,158,9,167
https://kawalpemilu.org#57821,"OLAKILE, BOAWAE, NAGEKEO, NUSA TENGGARA TIMUR",1,205,3,208
https://kawalpemilu.org#57821,"OLAKILE, BOAWAE, NAGEKEO, NUSA TENGGARA TIMUR",2,153,0,153
https://kawalpemilu.org#57821,"OLAKILE, BOAWAE, NAGEKEO, NUSA TENGGARA TIMUR",3,209,2,211
https://kawalpemilu.org#57823,"ROWA, BOAWAE, NAGEKEO, NUSA TENGGARA TIMUR",1,154,4,158
https://kawalpemilu.org#57823,"ROWA, BOAWAE, NAGEKEO, NUSA TENGGARA TIMUR",2,199,3,202
https://kawalpemilu.org#57823,"ROWA, BOAWAE, NAGEKEO, NUSA TENGGARA TIMUR",3,180,1,181
https://kawalpemilu.org#57823,"ROWA, BOAWAE, NAGEKEO, NUSA TENGGARA TIMUR",4,189,6,195
https://kawalpemilu.org#57824,"SOLO, BOAWAE, NAGEKEO, NUSA TENGGARA TIMUR",1,232,7,239
https://kawalpemilu.org#57824,"SOLO, BOAWAE, NAGEKEO, NUSA TENGGARA TIMUR",2,223,13,236
https://kawalpemilu.org#57825,"LEGUDERU, BOAWAE, NAGEKEO, NUSA TENGGARA TIMUR",1,181,3,184
https://kawalpemilu.org#57825,"LEGUDERU, BOAWAE, NAGEKEO, NUSA TENGGARA TIMUR",2,181,16,197
https://kawalpemilu.org#57825,"LEGUDERU, BOAWAE, NAGEKEO, NUSA TENGGARA TIMUR",3,239,6,245
https://kawalpemilu.org#57826,"NAGERAWE, BOAWAE, NAGEKEO, NUSA TENGGARA TIMUR",1,159,12,171
https://kawalpemilu.org#57826,"NAGERAWE, BOAWAE, NAGEKEO, NUSA TENGGARA TIMUR",2,155,5,160
https://kawalpemilu.org#57826,"NAGERAWE, BOAWAE, NAGEKEO, NUSA TENGGARA TIMUR",3,162,8,170
https://kawalpemilu.org#57827,"KELEWAE, BOAWAE, NAGEKEO, NUSA TENGGARA TIMUR",1,190,26,216
https://kawalpemilu.org#57827,"KELEWAE, BOAWAE, NAGEKEO, NUSA TENGGARA TIMUR",2,129,12,141
https://kawalpemilu.org#57827,"KELEWAE, BOAWAE, NAGEKEO, NUSA TENGGARA TIMUR",3,199,3,202
https://kawalpemilu.org#57827,"KELEWAE, BOAWAE, NAGEKEO, NUSA TENGGARA TIMUR",4,164,0,165
https://kawalpemilu.org#57827,"KELEWAE, BOAWAE, NAGEKEO, NUSA TENGGARA TIMUR",5,139,6,145
https://kawalpemilu.org#57828,"KELIMADO, BOAWAE, NAGEKEO, NUSA TENGGARA TIMUR",1,176,1,177
https://kawalpemilu.org#57828,"KELIMADO, BOAWAE, NAGEKEO, NUSA TENGGARA TIMUR",2,176,2,178
https://kawalpemilu.org#57828,"KELIMADO, BOAWAE, NAGEKEO, NUSA TENGGARA TIMUR",3,173,4,177
https://kawalpemilu.org#57828,"KELIMADO, BOAWAE, NAGEKEO, NUSA TENGGARA TIMUR",4,166,5,171
https://kawalpemilu.org#57828,"KELIMADO, BOAWAE, NAGEKEO, NUSA TENGGARA TIMUR",5,172,4,176
https://kawalpemilu.org#57829,"MULAKOLI, BOAWAE, NAGEKEO, NUSA TENGGARA TIMUR",1,200,6,206
https://kawalpemilu.org#57829,"MULAKOLI, BOAWAE, NAGEKEO, NUSA TENGGARA TIMUR",2,185,2,187
https://kawalpemilu.org#57829,"MULAKOLI, BOAWAE, NAGEKEO, NUSA TENGGARA TIMUR",3,175,0,175
https://kawalpemilu.org#57829,"MULAKOLI, BOAWAE, NAGEKEO, NUSA TENGGARA TIMUR",4,196,2,198
https://kawalpemilu.org#57830,"WEA AU, BOAWAE, NAGEKEO, NUSA TENGGARA TIMUR",1,180,3,183
https://kawalpemilu.org#57830,"WEA AU, BOAWAE, NAGEKEO, NUSA TENGGARA TIMUR",2,190,1,191
https://kawalpemilu.org#57830,"WEA AU, BOAWAE, NAGEKEO, NUSA TENGGARA TIMUR",3,186,23,209
https://kawalpemilu.org#57831,"RAJA, BOAWAE, NAGEKEO, NUSA TENGGARA TIMUR",1,184,7,191
https://kawalpemilu.org#57831,"RAJA, BOAWAE, NAGEKEO, NUSA TENGGARA TIMUR",2,218,5,223
https://kawalpemilu.org#57831,"RAJA, BOAWAE, NAGEKEO, NUSA TENGGARA TIMUR",3,193,3,196
https://kawalpemilu.org#57831,"RAJA, BOAWAE, NAGEKEO, NUSA TENGGARA TIMUR",4,189,3,192
https://kawalpemilu.org#57832,"WOLOWEA, BOAWAE, NAGEKEO, NUSA TENGGARA TIMUR",1,192,5,197
https://kawalpemilu.org#57832,"WOLOWEA, BOAWAE, NAGEKEO, NUSA TENGGARA TIMUR",3,190,6,196
https://kawalpemilu.org#57833,"GERODHERE, BOAWAE, NAGEKEO, NUSA TENGGARA TIMUR",1,185,3,188
https://kawalpemilu.org#57833,"GERODHERE, BOAWAE, NAGEKEO, NUSA TENGGARA TIMUR",2,195,7,202
https://kawalpemilu.org#57833,"GERODHERE, BOAWAE, NAGEKEO, NUSA TENGGARA TIMUR",3,120,5,125
https://kawalpemilu.org#57833,"GERODHERE, BOAWAE, NAGEKEO, NUSA TENGGARA TIMUR",4,98,1,99
https://kawalpemilu.org#57834,"DHEREISA, BOAWAE, NAGEKEO, NUSA TENGGARA TIMUR",1,237,8,245
https://kawalpemilu.org#57834,"DHEREISA, BOAWAE, NAGEKEO, NUSA TENGGARA TIMUR",2,235,7,242
https://kawalpemilu.org#57835,"RIGI, BOAWAE, NAGEKEO, NUSA TENGGARA TIMUR",1,168,10,178
https://kawalpemilu.org#57835,"RIGI, BOAWAE, NAGEKEO, NUSA TENGGARA TIMUR",2,181,1,182
https://kawalpemilu.org#57835,"RIGI, BOAWAE, NAGEKEO, NUSA TENGGARA TIMUR",3,113,5,118
https://kawalpemilu.org#57837,"FOCOLODORAWE, BOAWAE, NAGEKEO, NUSA TENGGARA TIMUR",1,191,4,195
https://kawalpemilu.org#57837,"FOCOLODORAWE, BOAWAE, NAGEKEO, NUSA TENGGARA TIMUR",2,160,7,167
https://kawalpemilu.org#85210,"WOLOWEA TIMUR, BOAWAE, NAGEKEO, NUSA TENGGARA TIMUR",1,159,4,163
https://kawalpemilu.org#85210,"WOLOWEA TIMUR, BOAWAE, NAGEKEO, NUSA TENGGARA TIMUR",2,170,5,175
https://kawalpemilu.org#85211,"WOLOWEA BARAT, BOAWAE, NAGEKEO, NUSA TENGGARA TIMUR",1,183,18,201
https://kawalpemilu.org#85211,"WOLOWEA BARAT, BOAWAE, NAGEKEO, NUSA TENGGARA TIMUR",2,207,3,210
https://kawalpemilu.org#85212,"RAJA TIMUR, BOAWAE, NAGEKEO, NUSA TENGGARA TIMUR",1,203,2,205
https://kawalpemilu.org#85212,"RAJA TIMUR, BOAWAE, NAGEKEO, NUSA TENGGARA TIMUR",2,142,2,144
https://kawalpemilu.org#85212,"RAJA TIMUR, BOAWAE, NAGEKEO, NUSA TENGGARA TIMUR",3,188,6,194
https://kawalpemilu.org#85213,"RAJA SELATAN, BOAWAE, NAGEKEO, NUSA TENGGARA TIMUR",1,172,6,178
https://kawalpemilu.org#85213,"RAJA SELATAN, BOAWAE, NAGEKEO, NUSA TENGGARA TIMUR",2,154,4,158
https://kawalpemilu.org#85213,"RAJA SELATAN, BOAWAE, NAGEKEO, NUSA TENGGARA TIMUR",3,153,4,157
https://kawalpemilu.org#92334,"NATANAGE TIMUR, BOAWAE, NAGEKEO, NUSA TENGGARA TIMUR",1,245,8,253
https://kawalpemilu.org#92334,"NATANAGE TIMUR, BOAWAE, NAGEKEO, NUSA TENGGARA TIMUR",2,221,17,238
https://kawalpemilu.org#92334,"NATANAGE TIMUR, BOAWAE, NAGEKEO, NUSA TENGGARA TIMUR",3,216,19,235
https://kawalpemilu.org#92334,"NATANAGE TIMUR, BOAWAE, NAGEKEO, NUSA TENGGARA TIMUR",4,156,4,160
https://kawalpemilu.org#92334,"NATANAGE TIMUR, BOAWAE, NAGEKEO, NUSA TENGGARA TIMUR",5,191,6,197
https://kawalpemilu.org#92335,"ALORAWE, BOAWAE, NAGEKEO, NUSA TENGGARA TIMUR",2,121,1,122
https://kawalpemilu.org#57839,"MAUPONGGO, MAUPONGGO, NAGEKEO, NUSA TENGGARA TIMUR",1,0,0,0
https://kawalpemilu.org#57839,"MAUPONGGO, MAUPONGGO, NAGEKEO, NUSA TENGGARA TIMUR",2,168,52,220
https://kawalpemilu.org#57840,"BELA, MAUPONGGO, NAGEKEO, NUSA TENGGARA TIMUR",1,207,8,215
https://kawalpemilu.org#57840,"BELA, MAUPONGGO, NAGEKEO, NUSA TENGGARA TIMUR",2,183,1,184
https://kawalpemilu.org#57840,"BELA, MAUPONGGO, NAGEKEO, NUSA TENGGARA TIMUR",3,158,15,173
https://kawalpemilu.org#57841,"WOLOKISA, MAUPONGGO, NAGEKEO, NUSA TENGGARA TIMUR",1,188,12,200
https://kawalpemilu.org#57841,"WOLOKISA, MAUPONGGO, NAGEKEO, NUSA TENGGARA TIMUR",2,195,23,218
https://kawalpemilu.org#57841,"WOLOKISA, MAUPONGGO, NAGEKEO, NUSA TENGGARA TIMUR",3,210,8,218
https://kawalpemilu.org#57842,"WULIWALO, MAUPONGGO, NAGEKEO, NUSA TENGGARA TIMUR",1,126,7,133
https://kawalpemilu.org#57842,"WULIWALO, MAUPONGGO, NAGEKEO, NUSA TENGGARA TIMUR",2,203,7,210
https://kawalpemilu.org#57842,"WULIWALO, MAUPONGGO, NAGEKEO, NUSA TENGGARA TIMUR",3,205,10,215
https://kawalpemilu.org#57843,"MAUKELI, MAUPONGGO, NAGEKEO, NUSA TENGGARA TIMUR",1,183,20,203
https://kawalpemilu.org#57843,"MAUKELI, MAUPONGGO, NAGEKEO, NUSA TENGGARA TIMUR",2,76,42,118
https://kawalpemilu.org#57843,"MAUKELI, MAUPONGGO, NAGEKEO, NUSA TENGGARA TIMUR",3,116,69,185
https://kawalpemilu.org#57844,"AEWOE, MAUPONGGO, NAGEKEO, NUSA TENGGARA TIMUR",1,149,65,214
https://kawalpemilu.org#57844,"AEWOE, MAUPONGGO, NAGEKEO, NUSA TENGGARA TIMUR",2,154,6,160
https://kawalpemilu.org#57845,"WOLOTELU, MAUPONGGO, NAGEKEO, NUSA TENGGARA TIMUR",1,25,86,111
https://kawalpemilu.org#57845,"WOLOTELU, MAUPONGGO, NAGEKEO, NUSA TENGGARA TIMUR",2,106,51,157
https://kawalpemilu.org#57845,"WOLOTELU, MAUPONGGO, NAGEKEO, NUSA TENGGARA TIMUR",3,213,5,218
https://kawalpemilu.org#57846,"SAWU, MAUPONGGO, NAGEKEO, NUSA TENGGARA TIMUR",1,159,4,163
https://kawalpemilu.org#57846,"SAWU, MAUPONGGO, NAGEKEO, NUSA TENGGARA TIMUR",2,182,2,184
https://kawalpemilu.org#57846,"SAWU, MAUPONGGO, NAGEKEO, NUSA TENGGARA TIMUR",3,153,5,158
https://kawalpemilu.org#57846,"SAWU, MAUPONGGO, NAGEKEO, NUSA TENGGARA TIMUR",4,103,2,105
https://kawalpemilu.org#57846,"SAWU, MAUPONGGO, NAGEKEO, NUSA TENGGARA TIMUR",5,160,2,162
https://kawalpemilu.org#57847,"JAWAPOGO, MAUPONGGO, NAGEKEO, NUSA TENGGARA TIMUR",1,146,2,148
https://kawalpemilu.org#57847,"JAWAPOGO, MAUPONGGO, NAGEKEO, NUSA TENGGARA TIMUR",2,156,7,163
https://kawalpemilu.org#57847,"JAWAPOGO, MAUPONGGO, NAGEKEO, NUSA TENGGARA TIMUR",3,155,4,159
https://kawalpemilu.org#57847,"JAWAPOGO, MAUPONGGO, NAGEKEO, NUSA TENGGARA TIMUR",4,192,5,197
https://kawalpemilu.org#57847,"JAWAPOGO, MAUPONGGO, NAGEKEO, NUSA TENGGARA TIMUR",5,140,1,141
https://kawalpemilu.org#57848,"ULULOGA, MAUPONGGO, NAGEKEO, NUSA TENGGARA TIMUR",1,132,2,134
https://kawalpemilu.org#57848,"ULULOGA, MAUPONGGO, NAGEKEO, NUSA TENGGARA TIMUR",2,151,2,153
https://kawalpemilu.org#57848,"ULULOGA, MAUPONGGO, NAGEKEO, NUSA TENGGARA TIMUR",3,206,4,210
https://kawalpemilu.org#57849,"LODAOLO, MAUPONGGO, NAGEKEO, NUSA TENGGARA TIMUR",1,171,4,175
https://kawalpemilu.org#57849,"LODAOLO, MAUPONGGO, NAGEKEO, NUSA TENGGARA TIMUR",2,128,2,130
https://kawalpemilu.org#57849,"LODAOLO, MAUPONGGO, NAGEKEO, NUSA TENGGARA TIMUR",3,176,2,178
https://kawalpemilu.org#57849,"LODAOLO, MAUPONGGO, NAGEKEO, NUSA TENGGARA TIMUR",4,132,0,132
https://kawalpemilu.org#57850,"WOLOEDE, MAUPONGGO, NAGEKEO, NUSA TENGGARA TIMUR",1,159,0,159
https://kawalpemilu.org#57850,"WOLOEDE, MAUPONGGO, NAGEKEO, NUSA TENGGARA TIMUR",2,149,2,151
https://kawalpemilu.org#57850,"WOLOEDE, MAUPONGGO, NAGEKEO, NUSA TENGGARA TIMUR",3,125,2,127
https://kawalpemilu.org#57851,"WOEWOLO, MAUPONGGO, NAGEKEO, NUSA TENGGARA TIMUR",1,148,2,150
https://kawalpemilu.org#57851,"WOEWOLO, MAUPONGGO, NAGEKEO, NUSA TENGGARA TIMUR",2,134,6,140
https://kawalpemilu.org#57851,"WOEWOLO, MAUPONGGO, NAGEKEO, NUSA TENGGARA TIMUR",3,191,6,197
https://kawalpemilu.org#57851,"WOEWOLO, MAUPONGGO, NAGEKEO, NUSA TENGGARA TIMUR",4,193,2,195
https://kawalpemilu.org#57852,"SELALEJO, MAUPONGGO, NAGEKEO, NUSA TENGGARA TIMUR",1,241,7,248
https://kawalpemilu.org#57852,"SELALEJO, MAUPONGGO, NAGEKEO, NUSA TENGGARA TIMUR",2,155,4,159
https://kawalpemilu.org#57852,"SELALEJO, MAUPONGGO, NAGEKEO, NUSA TENGGARA TIMUR",3,199,5,204
https://kawalpemilu.org#57852,"SELALEJO, MAUPONGGO, NAGEKEO, NUSA TENGGARA TIMUR",4,141,10,151
https://kawalpemilu.org#57853,"UA, MAUPONGGO, NAGEKEO, NUSA TENGGARA TIMUR",1,123,5,128
https://kawalpemilu.org#57853,"UA, MAUPONGGO, NAGEKEO, NUSA TENGGARA TIMUR",3,148,3,151
https://kawalpemilu.org#57853,"UA, MAUPONGGO, NAGEKEO, NUSA TENGGARA TIMUR",4,170,4,174
https://kawalpemilu.org#57853,"UA, MAUPONGGO, NAGEKEO, NUSA TENGGARA TIMUR",5,221,15,236
https://kawalpemilu.org#57853,"UA, MAUPONGGO, NAGEKEO, NUSA TENGGARA TIMUR",6,104,5,109
https://kawalpemilu.org#57854,"KOTAGANA, MAUPONGGO, NAGEKEO, NUSA TENGGARA TIMUR",1,223,10,233
https://kawalpemilu.org#57854,"KOTAGANA, MAUPONGGO, NAGEKEO, NUSA TENGGARA TIMUR",2,173,13,186
https://kawalpemilu.org#57854,"KOTAGANA, MAUPONGGO, NAGEKEO, NUSA TENGGARA TIMUR",3,124,4,128
https://kawalpemilu.org#57855,"LOKALABA, MAUPONGGO, NAGEKEO, NUSA TENGGARA TIMUR",1,38,103,141
https://kawalpemilu.org#57855,"LOKALABA, MAUPONGGO, NAGEKEO, NUSA TENGGARA TIMUR",2,52,178,230
https://kawalpemilu.org#57855,"LOKALABA, MAUPONGGO, NAGEKEO, NUSA TENGGARA TIMUR",3,162,3,165
https://kawalpemilu.org#57855,"LOKALABA, MAUPONGGO, NAGEKEO, NUSA TENGGARA TIMUR",4,169,3,172
https://kawalpemilu.org#57856,"LAJAWAJO, MAUPONGGO, NAGEKEO, NUSA TENGGARA TIMUR",1,239,1,240
https://kawalpemilu.org#57856,"LAJAWAJO, MAUPONGGO, NAGEKEO, NUSA TENGGARA TIMUR",2,193,0,193
https://kawalpemilu.org#57856,"LAJAWAJO, MAUPONGGO, NAGEKEO, NUSA TENGGARA TIMUR",3,171,6,177
https://kawalpemilu.org#57857,"KELIWATULEWA, MAUPONGGO, NAGEKEO, NUSA TENGGARA TIMUR",1,155,19,174
https://kawalpemilu.org#57857,"KELIWATULEWA, MAUPONGGO, NAGEKEO, NUSA TENGGARA TIMUR",2,148,12,160
https://kawalpemilu.org#57858,"WOLOLELU, MAUPONGGO, NAGEKEO, NUSA TENGGARA TIMUR",1,191,16,207
https://kawalpemilu.org#85214,"SELALEJO TIMUR, MAUPONGGO, NAGEKEO, NUSA TENGGARA TIMUR",1,141,3,144
https://kawalpemilu.org#57860,"TENDATOTO, WOLOWAE, NAGEKEO, NUSA TENGGARA TIMUR",1,214,10,224
https://kawalpemilu.org#57860,"TENDATOTO, WOLOWAE, NAGEKEO, NUSA TENGGARA TIMUR",2,183,10,193
https://kawalpemilu.org#57860,"TENDATOTO, WOLOWAE, NAGEKEO, NUSA TENGGARA TIMUR",3,187,11,198
https://kawalpemilu.org#57861,"TOTOMALA, WOLOWAE, NAGEKEO, NUSA TENGGARA TIMUR",1,204,5,209
https://kawalpemilu.org#57861,"TOTOMALA, WOLOWAE, NAGEKEO, NUSA TENGGARA TIMUR",2,188,7,195
https://kawalpemilu.org#57861,"TOTOMALA, WOLOWAE, NAGEKEO, NUSA TENGGARA TIMUR",3,210,9,219
https://kawalpemilu.org#57862,"TENDAKINDE, WOLOWAE, NAGEKEO, NUSA TENGGARA TIMUR",2,229,29,258
https://kawalpemilu.org#57862,"TENDAKINDE, WOLOWAE, NAGEKEO, NUSA TENGGARA TIMUR",3,41,167,208
https://kawalpemilu.org#57862,"TENDAKINDE, WOLOWAE, NAGEKEO, NUSA TENGGARA TIMUR",4,38,107,145
https://kawalpemilu.org#57863,"ANAKOLI, WOLOWAE, NAGEKEO, NUSA TENGGARA TIMUR",1,172,7,179
https://kawalpemilu.org#57863,"ANAKOLI, WOLOWAE, NAGEKEO, NUSA TENGGARA TIMUR",2,182,5,187
https://kawalpemilu.org#57864,"NATATOTO, WOLOWAE, NAGEKEO, NUSA TENGGARA TIMUR",1,251,6,257
https://kawalpemilu.org#57864,"NATATOTO, WOLOWAE, NAGEKEO, NUSA TENGGARA TIMUR",2,176,4,180
https://kawalpemilu.org#57864,"NATATOTO, WOLOWAE, NAGEKEO, NUSA TENGGARA TIMUR",3,133,5,138
https://kawalpemilu.org#57866,"WITUROMBAUA, KEO TENGAH, NAGEKEO, NUSA TENGGARA TIMUR",1,164,28,192
https://kawalpemilu.org#57866,"WITUROMBAUA, KEO TENGAH, NAGEKEO, NUSA TENGGARA TIMUR",2,186,11,197
https://kawalpemilu.org#57866,"WITUROMBAUA, KEO TENGAH, NAGEKEO, NUSA TENGGARA TIMUR",3,105,1,106
https://kawalpemilu.org#57866,"WITUROMBAUA, KEO TENGAH, NAGEKEO, NUSA TENGGARA TIMUR",4,159,8,167
https://kawalpemilu.org#57867,"LEWANGERA, KEO TENGAH, NAGEKEO, NUSA TENGGARA TIMUR",1,185,7,192
https://kawalpemilu.org#57867,"LEWANGERA, KEO TENGAH, NAGEKEO, NUSA TENGGARA TIMUR",2,194,5,199
https://kawalpemilu.org#57867,"LEWANGERA, KEO TENGAH, NAGEKEO, NUSA TENGGARA TIMUR",3,144,2,146
https://kawalpemilu.org#57868,"WAJO, KEO TENGAH, NAGEKEO, NUSA TENGGARA TIMUR",1,209,2,211
https://kawalpemilu.org#57868,"WAJO, KEO TENGAH, NAGEKEO, NUSA TENGGARA TIMUR",2,123,6,129
https://kawalpemilu.org#57868,"WAJO, KEO TENGAH, NAGEKEO, NUSA TENGGARA TIMUR",3,218,4,222
https://kawalpemilu.org#57868,"WAJO, KEO TENGAH, NAGEKEO, NUSA TENGGARA TIMUR",4,142,1,143
https://kawalpemilu.org#57869,"KOTOWUJI TIMUR, KEO TENGAH, NAGEKEO, NUSA TENGGARA TIMUR",1,165,7,172
https://kawalpemilu.org#57869,"KOTOWUJI TIMUR, KEO TENGAH, NAGEKEO, NUSA TENGGARA TIMUR",2,195,4,199
https://kawalpemilu.org#57869,"KOTOWUJI TIMUR, KEO TENGAH, NAGEKEO, NUSA TENGGARA TIMUR",3,214,12,226
https://kawalpemilu.org#57870,"KOTOWUJI BARAT, KEO TENGAH, NAGEKEO, NUSA TENGGARA TIMUR",1,209,7,216
https://kawalpemilu.org#57870,"KOTOWUJI BARAT, KEO TENGAH, NAGEKEO, NUSA TENGGARA TIMUR",2,115,3,118
https://kawalpemilu.org#57870,"KOTOWUJI BARAT, KEO TENGAH, NAGEKEO, NUSA TENGGARA TIMUR",3,101,5,106
https://kawalpemilu.org#57871,"MBAENUAMURI, KEO TENGAH, NAGEKEO, NUSA TENGGARA TIMUR",1,183,27,210
https://kawalpemilu.org#57871,"MBAENUAMURI, KEO TENGAH, NAGEKEO, NUSA TENGGARA TIMUR",2,192,3,195
https://kawalpemilu.org#57871,"MBAENUAMURI, KEO TENGAH, NAGEKEO, NUSA TENGGARA TIMUR",3,96,0,96
https://kawalpemilu.org#57871,"MBAENUAMURI, KEO TENGAH, NAGEKEO, NUSA TENGGARA TIMUR",4,215,20,235
https://kawalpemilu.org#57872,"UDIWOROWATU, KEO TENGAH, NAGEKEO, NUSA TENGGARA TIMUR",1,63,69,132
https://kawalpemilu.org#57872,"UDIWOROWATU, KEO TENGAH, NAGEKEO, NUSA TENGGARA TIMUR",2,137,2,139
https://kawalpemilu.org#57872,"UDIWOROWATU, KEO TENGAH, NAGEKEO, NUSA TENGGARA TIMUR",3,164,5,169
https://kawalpemilu.org#57873,"KOTODIRUMALI, KEO TENGAH, NAGEKEO, NUSA TENGGARA TIMUR",1,4,189,193
https://kawalpemilu.org#57873,"KOTODIRUMALI, KEO TENGAH, NAGEKEO, NUSA TENGGARA TIMUR",2,165,12,177
https://kawalpemilu.org#57873,"KOTODIRUMALI, KEO TENGAH, NAGEKEO, NUSA TENGGARA TIMUR",3,98,4,102
https://kawalpemilu.org#57873,"KOTODIRUMALI, KEO TENGAH, NAGEKEO, NUSA TENGGARA TIMUR",4,220,3,223
https://kawalpemilu.org#57874,"PAUTOLA, KEO TENGAH, NAGEKEO, NUSA TENGGARA TIMUR",1,221,3,224
https://kawalpemilu.org#57874,"PAUTOLA, KEO TENGAH, NAGEKEO, NUSA TENGGARA TIMUR",2,167,5,172
https://kawalpemilu.org#57874,"PAUTOLA, KEO TENGAH, NAGEKEO, NUSA TENGGARA TIMUR",3,162,1,163
https://kawalpemilu.org#57875,"LADOLIMA, KEO TENGAH, NAGEKEO, NUSA TENGGARA TIMUR",1,166,4,170
https://kawalpemilu.org#57875,"LADOLIMA, KEO TENGAH, NAGEKEO, NUSA TENGGARA TIMUR",2,137,4,141
https://kawalpemilu.org#57875,"LADOLIMA, KEO TENGAH, NAGEKEO, NUSA TENGGARA TIMUR",3,142,2,144
https://kawalpemilu.org#57876,"KELI, KEO TENGAH, NAGEKEO, NUSA TENGGARA TIMUR",1,197,7,204
https://kawalpemilu.org#57876,"KELI, KEO TENGAH, NAGEKEO, NUSA TENGGARA TIMUR",2,103,26,129
https://kawalpemilu.org#57876,"KELI, KEO TENGAH, NAGEKEO, NUSA TENGGARA TIMUR",3,85,9,94
https://kawalpemilu.org#57877,"NGERA, KEO TENGAH, NAGEKEO, NUSA TENGGARA TIMUR",1,157,6,163
https://kawalpemilu.org#57877,"NGERA, KEO TENGAH, NAGEKEO, NUSA TENGGARA TIMUR",2,150,2,152
https://kawalpemilu.org#57877,"NGERA, KEO TENGAH, NAGEKEO, NUSA TENGGARA TIMUR",3,136,10,146
https://kawalpemilu.org#57878,"LADOLIMA TIMUR, KEO TENGAH, NAGEKEO, NUSA TENGGARA TIMUR",1,158,1,159
https://kawalpemilu.org#57878,"LADOLIMA TIMUR, KEO TENGAH, NAGEKEO, NUSA TENGGARA TIMUR",2,225,2,227
https://kawalpemilu.org#57878,"LADOLIMA TIMUR, KEO TENGAH, NAGEKEO, NUSA TENGGARA TIMUR",3,196,1,197
https://kawalpemilu.org#57879,"LADOLIMA UTARA, KEO TENGAH, NAGEKEO, NUSA TENGGARA TIMUR",1,215,5,220
https://kawalpemilu.org#57879,"LADOLIMA UTARA, KEO TENGAH, NAGEKEO, NUSA TENGGARA TIMUR",2,179,3,182
https://kawalpemilu.org#85215,"WAJO TIMUR, KEO TENGAH, NAGEKEO, NUSA TENGGARA TIMUR",1,171,3,174
https://kawalpemilu.org#85215,"WAJO TIMUR, KEO TENGAH, NAGEKEO, NUSA TENGGARA TIMUR",2,139,0,0
https://kawalpemilu.org#85216,"PAUMALI, KEO TENGAH, NAGEKEO, NUSA TENGGARA TIMUR",1,130,1,131
https://kawalpemilu.org#85216,"PAUMALI, KEO TENGAH, NAGEKEO, NUSA TENGGARA TIMUR",2,63,1,64
https://kawalpemilu.org#57881,"RENDUBUTOWE, AESESA SELATAN, NAGEKEO, NUSA TENGGARA TIMUR",1,95,2,97
https://kawalpemilu.org#57881,"RENDUBUTOWE, AESESA SELATAN, NAGEKEO, NUSA TENGGARA TIMUR",2,183,9,192
https://kawalpemilu.org#57881,"RENDUBUTOWE, AESESA SELATAN, NAGEKEO, NUSA TENGGARA TIMUR",3,177,0,177
https://kawalpemilu.org#57881,"RENDUBUTOWE, AESESA SELATAN, NAGEKEO, NUSA TENGGARA TIMUR",4,159,4,163
https://kawalpemilu.org#57882,"TENGATIBA, AESESA SELATAN, NAGEKEO, NUSA TENGGARA TIMUR",1,249,10,259
https://kawalpemilu.org#57882,"TENGATIBA, AESESA SELATAN, NAGEKEO, NUSA TENGGARA TIMUR",2,182,5,187
https://kawalpemilu.org#57882,"TENGATIBA, AESESA SELATAN, NAGEKEO, NUSA TENGGARA TIMUR",3,157,13,170
https://kawalpemilu.org#57882,"TENGATIBA, AESESA SELATAN, NAGEKEO, NUSA TENGGARA TIMUR",4,213,6,219
https://kawalpemilu.org#57882,"TENGATIBA, AESESA SELATAN, NAGEKEO, NUSA TENGGARA TIMUR",5,159,12,171
https://kawalpemilu.org#57882,"TENGATIBA, AESESA SELATAN, NAGEKEO, NUSA TENGGARA TIMUR",6,89,1,90
https://kawalpemilu.org#57882,"TENGATIBA, AESESA SELATAN, NAGEKEO, NUSA TENGGARA TIMUR",8,99,4,103
https://kawalpemilu.org#57883,"LANGEDHAWE, AESESA SELATAN, NAGEKEO, NUSA TENGGARA TIMUR",1,229,5,234
https://kawalpemilu.org#57883,"LANGEDHAWE, AESESA SELATAN, NAGEKEO, NUSA TENGGARA TIMUR",2,102,1,103
https://kawalpemilu.org#57884,"RENDUTENO, AESESA SELATAN, NAGEKEO, NUSA TENGGARA TIMUR",1,233,6,229
https://kawalpemilu.org#57884,"RENDUTENO, AESESA SELATAN, NAGEKEO, NUSA TENGGARA TIMUR",2,108,4,112
https://kawalpemilu.org#57884,"RENDUTENO, AESESA SELATAN, NAGEKEO, NUSA TENGGARA TIMUR",3,91,1,92
https://kawalpemilu.org#57885,"RENDUWAWO, AESESA SELATAN, NAGEKEO, NUSA TENGGARA TIMUR",1,229,6,235
https://kawalpemilu.org#57885,"RENDUWAWO, AESESA SELATAN, NAGEKEO, NUSA TENGGARA TIMUR",2,202,4,206
https://kawalpemilu.org#85217,"WAJOMARA, AESESA SELATAN, NAGEKEO, NUSA TENGGARA TIMUR",1,162,8,170
https://kawalpemilu.org#85217,"WAJOMARA, AESESA SELATAN, NAGEKEO, NUSA TENGGARA TIMUR",2,56,1,57
https://kawalpemilu.org#85218,"RENDU TUTUBHADA, AESESA SELATAN, NAGEKEO, NUSA TENGGARA TIMUR",1,222,5,227
https://kawalpemilu.org#85218,"RENDU TUTUBHADA, AESESA SELATAN, NAGEKEO, NUSA TENGGARA TIMUR",2,227,6,233
https://kawalpemilu.org#57888,"MAKATA KERI, KATIKU TANA, SUMBA TENGAH, NUSA TENGGARA TIMUR",1,157,25,182
https://kawalpemilu.org#57888,"MAKATA KERI, KATIKU TANA, SUMBA TENGAH, NUSA TENGGARA TIMUR",2,148,11,159
https://kawalpemilu.org#57888,"MAKATA KERI, KATIKU TANA, SUMBA TENGAH, NUSA TENGGARA TIMUR",3,131,7,138
https://kawalpemilu.org#57888,"MAKATA KERI, KATIKU TANA, SUMBA TENGAH, NUSA TENGGARA TIMUR",4,141,4,145
https://kawalpemilu.org#57888,"MAKATA KERI, KATIKU TANA, SUMBA TENGAH, NUSA TENGGARA TIMUR",5,131,1,132
https://kawalpemilu.org#57888,"MAKATA KERI, KATIKU TANA, SUMBA TENGAH, NUSA TENGGARA TIMUR",6,125,4,129
https://kawalpemilu.org#57889,"KABELA WUNTU, KATIKU TANA, SUMBA TENGAH, NUSA TENGGARA TIMUR",1,184,4,188
https://kawalpemilu.org#57889,"KABELA WUNTU, KATIKU TANA, SUMBA TENGAH, NUSA TENGGARA TIMUR",2,195,19,214
https://kawalpemilu.org#57889,"KABELA WUNTU, KATIKU TANA, SUMBA TENGAH, NUSA TENGGARA TIMUR",3,164,13,177
https://kawalpemilu.org#57889,"KABELA WUNTU, KATIKU TANA, SUMBA TENGAH, NUSA TENGGARA TIMUR",4,92,5,97
https://kawalpemilu.org#57890,"MATA WOGA, KATIKU TANA, SUMBA TENGAH, NUSA TENGGARA TIMUR",1,181,12,193
https://kawalpemilu.org#57890,"MATA WOGA, KATIKU TANA, SUMBA TENGAH, NUSA TENGGARA TIMUR",2,205,18,223
https://kawalpemilu.org#57890,"MATA WOGA, KATIKU TANA, SUMBA TENGAH, NUSA TENGGARA TIMUR",3,213,5,218
https://kawalpemilu.org#57891,"UMBU RIRI, KATIKU TANA, SUMBA TENGAH, NUSA TENGGARA TIMUR",1,190,5,195
https://kawalpemilu.org#57891,"UMBU RIRI, KATIKU TANA, SUMBA TENGAH, NUSA TENGGARA TIMUR",2,138,10,148
https://kawalpemilu.org#57891,"UMBU RIRI, KATIKU TANA, SUMBA TENGAH, NUSA TENGGARA TIMUR",3,196,14,210
https://kawalpemilu.org#57892,"ANAKALANG, KATIKU TANA, SUMBA TENGAH, NUSA TENGGARA TIMUR",1,188,16,204
https://kawalpemilu.org#57892,"ANAKALANG, KATIKU TANA, SUMBA TENGAH, NUSA TENGGARA TIMUR",2,177,3,180
https://kawalpemilu.org#57892,"ANAKALANG, KATIKU TANA, SUMBA TENGAH, NUSA TENGGARA TIMUR",3,126,30,156
https://kawalpemilu.org#57892,"ANAKALANG, KATIKU TANA, SUMBA TENGAH, NUSA TENGGARA TIMUR",4,79,44,123
https://kawalpemilu.org#57892,"ANAKALANG, KATIKU TANA, SUMBA TENGAH, NUSA TENGGARA TIMUR",5,169,16,185
https://kawalpemilu.org#57892,"ANAKALANG, KATIKU TANA, SUMBA TENGAH, NUSA TENGGARA TIMUR",6,179,20,199
https://kawalpemilu.org#57892,"ANAKALANG, KATIKU TANA, SUMBA TENGAH, NUSA TENGGARA TIMUR",7,214,19,233
https://kawalpemilu.org#57892,"ANAKALANG, KATIKU TANA, SUMBA TENGAH, NUSA TENGGARA TIMUR",8,186,23,209
https://kawalpemilu.org#57892,"ANAKALANG, KATIKU TANA, SUMBA TENGAH, NUSA TENGGARA TIMUR",9,156,4,160
https://kawalpemilu.org#57892,"ANAKALANG, KATIKU TANA, SUMBA TENGAH, NUSA TENGGARA TIMUR",10,120,40,160
https://kawalpemilu.org#89666,"DEWA JARA, KATIKU TANA, SUMBA TENGAH, NUSA TENGGARA TIMUR",1,178,7,185
https://kawalpemilu.org#89666,"DEWA JARA, KATIKU TANA, SUMBA TENGAH, NUSA TENGGARA TIMUR",2,184,7,191
https://kawalpemilu.org#89666,"DEWA JARA, KATIKU TANA, SUMBA TENGAH, NUSA TENGGARA TIMUR",3,170,12,182
https://kawalpemilu.org#89666,"DEWA JARA, KATIKU TANA, SUMBA TENGAH, NUSA TENGGARA TIMUR",4,133,11,144
https://kawalpemilu.org#89667,"MATA REDI, KATIKU TANA, SUMBA TENGAH, NUSA TENGGARA TIMUR",1,146,4,150
https://kawalpemilu.org#89667,"MATA REDI, KATIKU TANA, SUMBA TENGAH, NUSA TENGGARA TIMUR",2,131,8,139
https://kawalpemilu.org#89667,"MATA REDI, KATIKU TANA, SUMBA TENGAH, NUSA TENGGARA TIMUR",3,157,9,166
https://kawalpemilu.org#57894,"WANGGA WAIYENGU, UMBU RATU NGGAY BARAT, SUMBA TENGAH, NUSA TENGGARA TIMUR",1,151,8,159
https://kawalpemilu.org#57894,"WANGGA WAIYENGU, UMBU RATU NGGAY BARAT, SUMBA TENGAH, NUSA TENGGARA TIMUR",2,106,5,111
https://kawalpemilu.org#57894,"WANGGA WAIYENGU, UMBU RATU NGGAY BARAT, SUMBA TENGAH, NUSA TENGGARA TIMUR",3,82,5,87
https://kawalpemilu.org#57894,"WANGGA WAIYENGU, UMBU RATU NGGAY BARAT, SUMBA TENGAH, NUSA TENGGARA TIMUR",4,81,5,86
https://kawalpemilu.org#57895,"PRAIMADETA, UMBU RATU NGGAY BARAT, SUMBA TENGAH, NUSA TENGGARA TIMUR",1,161,5,166
https://kawalpemilu.org#57895,"PRAIMADETA, UMBU RATU NGGAY BARAT, SUMBA TENGAH, NUSA TENGGARA TIMUR",3,129,7,136
https://kawalpemilu.org#57896,"PONDOK, UMBU RATU NGGAY BARAT, SUMBA TENGAH, NUSA TENGGARA TIMUR",1,123,5,128
https://kawalpemilu.org#57896,"PONDOK, UMBU RATU NGGAY BARAT, SUMBA TENGAH, NUSA TENGGARA TIMUR",2,153,5,158
https://kawalpemilu.org#57896,"PONDOK, UMBU RATU NGGAY BARAT, SUMBA TENGAH, NUSA TENGGARA TIMUR",3,149,9,158
https://kawalpemilu.org#57896,"PONDOK, UMBU RATU NGGAY BARAT, SUMBA TENGAH, NUSA TENGGARA TIMUR",4,117,2,119
https://kawalpemilu.org#57897,"MADERI, UMBU RATU NGGAY BARAT, SUMBA TENGAH, NUSA TENGGARA TIMUR",2,142,9,151
https://kawalpemilu.org#57897,"MADERI, UMBU RATU NGGAY BARAT, SUMBA TENGAH, NUSA TENGGARA TIMUR",3,130,8,138
https://kawalpemilu.org#57897,"MADERI, UMBU RATU NGGAY BARAT, SUMBA TENGAH, NUSA TENGGARA TIMUR",4,135,6,141
https://kawalpemilu.org#57898,"ANAJIAKA, UMBU RATU NGGAY BARAT, SUMBA TENGAH, NUSA TENGGARA TIMUR",1,150,18,168
https://kawalpemilu.org#57898,"ANAJIAKA, UMBU RATU NGGAY BARAT, SUMBA TENGAH, NUSA TENGGARA TIMUR",2,134,0,134
https://kawalpemilu.org#57898,"ANAJIAKA, UMBU RATU NGGAY BARAT, SUMBA TENGAH, NUSA TENGGARA TIMUR",3,176,14,190
https://kawalpemilu.org#57898,"ANAJIAKA, UMBU RATU NGGAY BARAT, SUMBA TENGAH, NUSA TENGGARA TIMUR",4,111,2,113
https://kawalpemilu.org#57899,"WAIRASA, UMBU RATU NGGAY BARAT, SUMBA TENGAH, NUSA TENGGARA TIMUR",1,192,28,220
https://kawalpemilu.org#57899,"WAIRASA, UMBU RATU NGGAY BARAT, SUMBA TENGAH, NUSA TENGGARA TIMUR",2,160,20,180
https://kawalpemilu.org#57899,"WAIRASA, UMBU RATU NGGAY BARAT, SUMBA TENGAH, NUSA TENGGARA TIMUR",3,102,11,113
https://kawalpemilu.org#57899,"WAIRASA, UMBU RATU NGGAY BARAT, SUMBA TENGAH, NUSA TENGGARA TIMUR",4,158,4,162
https://kawalpemilu.org#57899,"WAIRASA, UMBU RATU NGGAY BARAT, SUMBA TENGAH, NUSA TENGGARA TIMUR",5,147,23,170
https://kawalpemilu.org#57899,"WAIRASA, UMBU RATU NGGAY BARAT, SUMBA TENGAH, NUSA TENGGARA TIMUR",6,210,20,230
https://kawalpemilu.org#57899,"WAIRASA, UMBU RATU NGGAY BARAT, SUMBA TENGAH, NUSA TENGGARA TIMUR",7,125,5,130
https://kawalpemilu.org#57899,"WAIRASA, UMBU RATU NGGAY BARAT, SUMBA TENGAH, NUSA TENGGARA TIMUR",8,93,6,99
https://kawalpemilu.org#57900,"UMBU KAWOLU, UMBU RATU NGGAY BARAT, SUMBA TENGAH, NUSA TENGGARA TIMUR",1,76,0,76
https://kawalpemilu.org#57900,"UMBU KAWOLU, UMBU RATU NGGAY BARAT, SUMBA TENGAH, NUSA TENGGARA TIMUR",2,127,3,130
https://kawalpemilu.org#57900,"UMBU KAWOLU, UMBU RATU NGGAY BARAT, SUMBA TENGAH, NUSA TENGGARA TIMUR",3,138,2,140
https://kawalpemilu.org#57900,"UMBU KAWOLU, UMBU RATU NGGAY BARAT, SUMBA TENGAH, NUSA TENGGARA TIMUR",4,128,5,133
https://kawalpemilu.org#57901,"UMBU MAMIJUK, UMBU RATU NGGAY BARAT, SUMBA TENGAH, NUSA TENGGARA TIMUR",1,136,16,152
https://kawalpemilu.org#57901,"UMBU MAMIJUK, UMBU RATU NGGAY BARAT, SUMBA TENGAH, NUSA TENGGARA TIMUR",2,119,14,133
https://kawalpemilu.org#57901,"UMBU MAMIJUK, UMBU RATU NGGAY BARAT, SUMBA TENGAH, NUSA TENGGARA TIMUR",3,135,20,155
https://kawalpemilu.org#57901,"UMBU MAMIJUK, UMBU RATU NGGAY BARAT, SUMBA TENGAH, NUSA TENGGARA TIMUR",4,141,24,165
https://kawalpemilu.org#57901,"UMBU MAMIJUK, UMBU RATU NGGAY BARAT, SUMBA TENGAH, NUSA TENGGARA TIMUR",5,150,7,157
https://kawalpemilu.org#57902,"UMBU PABAL, UMBU RATU NGGAY BARAT, SUMBA TENGAH, NUSA TENGGARA TIMUR",1,166,10,176
https://kawalpemilu.org#57902,"UMBU PABAL, UMBU RATU NGGAY BARAT, SUMBA TENGAH, NUSA TENGGARA TIMUR",2,152,16,168
https://kawalpemilu.org#57902,"UMBU PABAL, UMBU RATU NGGAY BARAT, SUMBA TENGAH, NUSA TENGGARA TIMUR",3,148,4,152
https://kawalpemilu.org#57902,"UMBU PABAL, UMBU RATU NGGAY BARAT, SUMBA TENGAH, NUSA TENGGARA TIMUR",4,132,5,137
https://kawalpemilu.org#57902,"UMBU PABAL, UMBU RATU NGGAY BARAT, SUMBA TENGAH, NUSA TENGGARA TIMUR",5,84,6,90
https://kawalpemilu.org#57903,"UMBU LANGANG, UMBU RATU NGGAY BARAT, SUMBA TENGAH, NUSA TENGGARA TIMUR",1,155,7,162
https://kawalpemilu.org#57903,"UMBU LANGANG, UMBU RATU NGGAY BARAT, SUMBA TENGAH, NUSA TENGGARA TIMUR",2,116,7,123
https://kawalpemilu.org#57903,"UMBU LANGANG, UMBU RATU NGGAY BARAT, SUMBA TENGAH, NUSA TENGGARA TIMUR",3,142,4,146
https://kawalpemilu.org#57904,"SAMBALI LOKU, UMBU RATU NGGAY BARAT, SUMBA TENGAH, NUSA TENGGARA TIMUR",1,159,7,166
https://kawalpemilu.org#57904,"SAMBALI LOKU, UMBU RATU NGGAY BARAT, SUMBA TENGAH, NUSA TENGGARA TIMUR",2,119,10,129
https://kawalpemilu.org#57904,"SAMBALI LOKU, UMBU RATU NGGAY BARAT, SUMBA TENGAH, NUSA TENGGARA TIMUR",3,85,9,94
https://kawalpemilu.org#57904,"SAMBALI LOKU, UMBU RATU NGGAY BARAT, SUMBA TENGAH, NUSA TENGGARA TIMUR",4,171,7,178
https://kawalpemilu.org#85219,"UMBU PABAL SELATAN, UMBU RATU NGGAY BARAT, SUMBA TENGAH, NUSA TENGGARA TIMUR",1,180,9,189
https://kawalpemilu.org#85219,"UMBU PABAL SELATAN, UMBU RATU NGGAY BARAT, SUMBA TENGAH, NUSA TENGGARA TIMUR",2,173,4,177
https://kawalpemilu.org#85220,"ANAPALU, UMBU RATU NGGAY BARAT, SUMBA TENGAH, NUSA TENGGARA TIMUR",1,190,9,199
https://kawalpemilu.org#85220,"ANAPALU, UMBU RATU NGGAY BARAT, SUMBA TENGAH, NUSA TENGGARA TIMUR",2,167,9,176
https://kawalpemilu.org#85220,"ANAPALU, UMBU RATU NGGAY BARAT, SUMBA TENGAH, NUSA TENGGARA TIMUR",3,126,4,130
https://kawalpemilu.org#85221,"DAHA ELU, UMBU RATU NGGAY BARAT, SUMBA TENGAH, NUSA TENGGARA TIMUR",1,70,9,79
https://kawalpemilu.org#85221,"DAHA ELU, UMBU RATU NGGAY BARAT, SUMBA TENGAH, NUSA TENGGARA TIMUR",2,175,19,194
https://kawalpemilu.org#85221,"DAHA ELU, UMBU RATU NGGAY BARAT, SUMBA TENGAH, NUSA TENGGARA TIMUR",3,111,9,120
https://kawalpemilu.org#85222,"DEWA TANA, UMBU RATU NGGAY BARAT, SUMBA TENGAH, NUSA TENGGARA TIMUR",1,0,0,0
https://kawalpemilu.org#85222,"DEWA TANA, UMBU RATU NGGAY BARAT, SUMBA TENGAH, NUSA TENGGARA TIMUR",2,102,11,113
https://kawalpemilu.org#85222,"DEWA TANA, UMBU RATU NGGAY BARAT, SUMBA TENGAH, NUSA TENGGARA TIMUR",3,145,9,154
https://kawalpemilu.org#85223,"HOLUR KAMBATA, UMBU RATU NGGAY BARAT, SUMBA TENGAH, NUSA TENGGARA TIMUR",1,90,18,108
https://kawalpemilu.org#85223,"HOLUR KAMBATA, UMBU RATU NGGAY BARAT, SUMBA TENGAH, NUSA TENGGARA TIMUR",3,95,8,103
https://kawalpemilu.org#85224,"MATA WAIKAJAWI, UMBU RATU NGGAY BARAT, SUMBA TENGAH, NUSA TENGGARA TIMUR",1,154,7,161
https://kawalpemilu.org#85224,"MATA WAIKAJAWI, UMBU RATU NGGAY BARAT, SUMBA TENGAH, NUSA TENGGARA TIMUR",2,164,10,174
https://kawalpemilu.org#85224,"MATA WAIKAJAWI, UMBU RATU NGGAY BARAT, SUMBA TENGAH, NUSA TENGGARA TIMUR",3,74,6,80
https://kawalpemilu.org#92336,"UMBU JODU, UMBU RATU NGGAY BARAT, SUMBA TENGAH, NUSA TENGGARA TIMUR",1,153,1,154
https://kawalpemilu.org#92336,"UMBU JODU, UMBU RATU NGGAY BARAT, SUMBA TENGAH, NUSA TENGGARA TIMUR",2,167,4,171
https://kawalpemilu.org#92336,"UMBU JODU, UMBU RATU NGGAY BARAT, SUMBA TENGAH, NUSA TENGGARA TIMUR",3,157,10,167
https://kawalpemilu.org#57906,"WENDEWA TIMUR, MAMBORO, SUMBA TENGAH, NUSA TENGGARA TIMUR",1,160,9,169
https://kawalpemilu.org#57906,"WENDEWA TIMUR, MAMBORO, SUMBA TENGAH, NUSA TENGGARA TIMUR",2,159,8,167
https://kawalpemilu.org#57906,"WENDEWA TIMUR, MAMBORO, SUMBA TENGAH, NUSA TENGGARA TIMUR",3,181,10,191
https://kawalpemilu.org#57906,"WENDEWA TIMUR, MAMBORO, SUMBA TENGAH, NUSA TENGGARA TIMUR",4,168,15,183
https://kawalpemilu.org#57907,"WENDEWA SELATAN, MAMBORO, SUMBA TENGAH, NUSA TENGGARA TIMUR",1,223,3,226
https://kawalpemilu.org#57907,"WENDEWA SELATAN, MAMBORO, SUMBA TENGAH, NUSA TENGGARA TIMUR",2,111,10,121
https://kawalpemilu.org#57907,"WENDEWA SELATAN, MAMBORO, SUMBA TENGAH, NUSA TENGGARA TIMUR",3,134,8,142
https://kawalpemilu.org#57907,"WENDEWA SELATAN, MAMBORO, SUMBA TENGAH, NUSA TENGGARA TIMUR",4,172,3,175
https://kawalpemilu.org#57907,"WENDEWA SELATAN, MAMBORO, SUMBA TENGAH, NUSA TENGGARA TIMUR",5,183,6,189
https://kawalpemilu.org#57908,"WENDEWA UTARA, MAMBORO, SUMBA TENGAH, NUSA TENGGARA TIMUR",1,22,103,125
https://kawalpemilu.org#57908,"WENDEWA UTARA, MAMBORO, SUMBA TENGAH, NUSA TENGGARA TIMUR",2,32,172,204
https://kawalpemilu.org#57908,"WENDEWA UTARA, MAMBORO, SUMBA TENGAH, NUSA TENGGARA TIMUR",3,35,130,165
https://kawalpemilu.org#57908,"WENDEWA UTARA, MAMBORO, SUMBA TENGAH, NUSA TENGGARA TIMUR",4,26,97,123
https://kawalpemilu.org#57908,"WENDEWA UTARA, MAMBORO, SUMBA TENGAH, NUSA TENGGARA TIMUR",5,39,132,171
https://kawalpemilu.org#57908,"WENDEWA UTARA, MAMBORO, SUMBA TENGAH, NUSA TENGGARA TIMUR",6,72,131,203
https://kawalpemilu.org#57908,"WENDEWA UTARA, MAMBORO, SUMBA TENGAH, NUSA TENGGARA TIMUR",7,90,1,91
https://kawalpemilu.org#57909,"WENDEWA BARAT, MAMBORO, SUMBA TENGAH, NUSA TENGGARA TIMUR",1,113,13,126
https://kawalpemilu.org#57909,"WENDEWA BARAT, MAMBORO, SUMBA TENGAH, NUSA TENGGARA TIMUR",2,124,7,131
https://kawalpemilu.org#57909,"WENDEWA BARAT, MAMBORO, SUMBA TENGAH, NUSA TENGGARA TIMUR",3,136,7,143
https://kawalpemilu.org#57909,"WENDEWA BARAT, MAMBORO, SUMBA TENGAH, NUSA TENGGARA TIMUR",4,84,7,91
https://kawalpemilu.org#57910,"CENDANA, MAMBORO, SUMBA TENGAH, NUSA TENGGARA TIMUR",1,226,10,236
https://kawalpemilu.org#57910,"CENDANA, MAMBORO, SUMBA TENGAH, NUSA TENGGARA TIMUR",2,106,3,109
https://kawalpemilu.org#57910,"CENDANA, MAMBORO, SUMBA TENGAH, NUSA TENGGARA TIMUR",3,149,4,153
https://kawalpemilu.org#57910,"CENDANA, MAMBORO, SUMBA TENGAH, NUSA TENGGARA TIMUR",4,166,0,166
https://kawalpemilu.org#57911,"WEE LURI, MAMBORO, SUMBA TENGAH, NUSA TENGGARA TIMUR",1,113,1,114
https://kawalpemilu.org#57911,"WEE LURI, MAMBORO, SUMBA TENGAH, NUSA TENGGARA TIMUR",2,128,4,132
https://kawalpemilu.org#57911,"WEE LURI, MAMBORO, SUMBA TENGAH, NUSA TENGGARA TIMUR",3,107,0,107
https://kawalpemilu.org#57911,"WEE LURI, MAMBORO, SUMBA TENGAH, NUSA TENGGARA TIMUR",4,116,4,120
https://kawalpemilu.org#57912,"OLE ATE, MAMBORO, SUMBA TENGAH, NUSA TENGGARA TIMUR",1,131,6,137
https://kawalpemilu.org#57912,"OLE ATE, MAMBORO, SUMBA TENGAH, NUSA TENGGARA TIMUR",2,106,5,111
https://kawalpemilu.org#57912,"OLE ATE, MAMBORO, SUMBA TENGAH, NUSA TENGGARA TIMUR",3,165,17,182
https://kawalpemilu.org#57912,"OLE ATE, MAMBORO, SUMBA TENGAH, NUSA TENGGARA TIMUR",4,182,29,211
https://kawalpemilu.org#57913,"MANU WOLU, MAMBORO, SUMBA TENGAH, NUSA TENGGARA TIMUR",1,149,8,157
https://kawalpemilu.org#57913,"MANU WOLU, MAMBORO, SUMBA TENGAH, NUSA TENGGARA TIMUR",2,154,4,158
https://kawalpemilu.org#57913,"MANU WOLU, MAMBORO, SUMBA TENGAH, NUSA TENGGARA TIMUR",3,161,11,172
https://kawalpemilu.org#57913,"MANU WOLU, MAMBORO, SUMBA TENGAH, NUSA TENGGARA TIMUR",4,139,31,170
https://kawalpemilu.org#57913,"MANU WOLU, MAMBORO, SUMBA TENGAH, NUSA TENGGARA TIMUR",5,155,6,161
https://kawalpemilu.org#57913,"MANU WOLU, MAMBORO, SUMBA TENGAH, NUSA TENGGARA TIMUR",6,140,8,148
https://kawalpemilu.org#57914,"WATU ASA, MAMBORO, SUMBA TENGAH, NUSA TENGGARA TIMUR",1,139,16,155
https://kawalpemilu.org#57914,"WATU ASA, MAMBORO, SUMBA TENGAH, NUSA TENGGARA TIMUR",2,127,8,135
https://kawalpemilu.org#57914,"WATU ASA, MAMBORO, SUMBA TENGAH, NUSA TENGGARA TIMUR",3,117,13,130
https://kawalpemilu.org#85225,"BONDO SULLA, MAMBORO, SUMBA TENGAH, NUSA TENGGARA TIMUR",1,147,12,159
https://kawalpemilu.org#85225,"BONDO SULLA, MAMBORO, SUMBA TENGAH, NUSA TENGGARA TIMUR",3,125,2,127
https://kawalpemilu.org#85226,"SUSU WENDEWA, MAMBORO, SUMBA TENGAH, NUSA TENGGARA TIMUR",1,178,10,188
https://kawalpemilu.org#85226,"SUSU WENDEWA, MAMBORO, SUMBA TENGAH, NUSA TENGGARA TIMUR",2,81,5,86
https://kawalpemilu.org#85226,"SUSU WENDEWA, MAMBORO, SUMBA TENGAH, NUSA TENGGARA TIMUR",3,211,3,214
https://kawalpemilu.org#85226,"SUSU WENDEWA, MAMBORO, SUMBA TENGAH, NUSA TENGGARA TIMUR",4,95,7,102
https://kawalpemilu.org#85227,"OLE DEWA, MAMBORO, SUMBA TENGAH, NUSA TENGGARA TIMUR",1,125,15,140
https://kawalpemilu.org#85227,"OLE DEWA, MAMBORO, SUMBA TENGAH, NUSA TENGGARA TIMUR",2,137,15,152
https://kawalpemilu.org#85227,"OLE DEWA, MAMBORO, SUMBA TENGAH, NUSA TENGGARA TIMUR",3,136,15,151
https://kawalpemilu.org#85227,"OLE DEWA, MAMBORO, SUMBA TENGAH, NUSA TENGGARA TIMUR",4,85,8,93
https://kawalpemilu.org#85228,"CENDANA BARAT, MAMBORO, SUMBA TENGAH, NUSA TENGGARA TIMUR",1,190,7,197
https://kawalpemilu.org#85228,"CENDANA BARAT, MAMBORO, SUMBA TENGAH, NUSA TENGGARA TIMUR",2,112,8,120
https://kawalpemilu.org#85228,"CENDANA BARAT, MAMBORO, SUMBA TENGAH, NUSA TENGGARA TIMUR",3,142,4,146
https://kawalpemilu.org#57916,"MBILUR PANGADU, UMBU RATU NGGAY, SUMBA TENGAH, NUSA TENGGARA TIMUR",1,70,9,79
https://kawalpemilu.org#57916,"MBILUR PANGADU, UMBU RATU NGGAY, SUMBA TENGAH, NUSA TENGGARA TIMUR",2,163,6,169
https://kawalpemilu.org#57916,"MBILUR PANGADU, UMBU RATU NGGAY, SUMBA TENGAH, NUSA TENGGARA TIMUR",3,206,6,212
https://kawalpemilu.org#57917,"SORU, UMBU RATU NGGAY, SUMBA TENGAH, NUSA TENGGARA TIMUR",1,120,10,130
https://kawalpemilu.org#57917,"SORU, UMBU RATU NGGAY, SUMBA TENGAH, NUSA TENGGARA TIMUR",2,165,21,186
https://kawalpemilu.org#57917,"SORU, UMBU RATU NGGAY, SUMBA TENGAH, NUSA TENGGARA TIMUR",3,141,12,153
https://kawalpemilu.org#57918,"PRAI KAROKU DJANGGA, UMBU RATU NGGAY, SUMBA TENGAH, NUSA TENGGARA TIMUR",1,156,15,171
https://kawalpemilu.org#57918,"PRAI KAROKU DJANGGA, UMBU RATU NGGAY, SUMBA TENGAH, NUSA TENGGARA TIMUR",2,139,5,144
https://kawalpemilu.org#57918,"PRAI KAROKU DJANGGA, UMBU RATU NGGAY, SUMBA TENGAH, NUSA TENGGARA TIMUR",3,129,17,146
https://kawalpemilu.org#57919,"BOLU BOKAT, UMBU RATU NGGAY, SUMBA TENGAH, NUSA TENGGARA TIMUR",1,127,10,137
https://kawalpemilu.org#57919,"BOLU BOKAT, UMBU RATU NGGAY, SUMBA TENGAH, NUSA TENGGARA TIMUR",2,128,20,148
https://kawalpemilu.org#57919,"BOLU BOKAT, UMBU RATU NGGAY, SUMBA TENGAH, NUSA TENGGARA TIMUR",3,137,17,154
https://kawalpemilu.org#57920,"MARA DESA, UMBU RATU NGGAY, SUMBA TENGAH, NUSA TENGGARA TIMUR",1,100,7,107
https://kawalpemilu.org#57920,"MARA DESA, UMBU RATU NGGAY, SUMBA TENGAH, NUSA TENGGARA TIMUR",2,100,4,104
https://kawalpemilu.org#57920,"MARA DESA, UMBU RATU NGGAY, SUMBA TENGAH, NUSA TENGGARA TIMUR",3,82,1,83
https://kawalpemilu.org#57921,"WELUK PRAI MEMANG, UMBU RATU NGGAY, SUMBA TENGAH, NUSA TENGGARA TIMUR",1,195,16,211
https://kawalpemilu.org#57921,"WELUK PRAI MEMANG, UMBU RATU NGGAY, SUMBA TENGAH, NUSA TENGGARA TIMUR",2,128,18,146
https://kawalpemilu.org#57921,"WELUK PRAI MEMANG, UMBU RATU NGGAY, SUMBA TENGAH, NUSA TENGGARA TIMUR",3,126,6,132
https://kawalpemilu.org#57922,"LENANG, UMBU RATU NGGAY, SUMBA TENGAH, NUSA TENGGARA TIMUR",1,163,10,173
https://kawalpemilu.org#57922,"LENANG, UMBU RATU NGGAY, SUMBA TENGAH, NUSA TENGGARA TIMUR",2,175,8,183
https://kawalpemilu.org#57922,"LENANG, UMBU RATU NGGAY, SUMBA TENGAH, NUSA TENGGARA TIMUR",3,192,2,194
https://kawalpemilu.org#57923,"TANA MBANAS, UMBU RATU NGGAY, SUMBA TENGAH, NUSA TENGGARA TIMUR",1,169,11,180
https://kawalpemilu.org#57923,"TANA MBANAS, UMBU RATU NGGAY, SUMBA TENGAH, NUSA TENGGARA TIMUR",2,192,17,209
https://kawalpemilu.org#57923,"TANA MBANAS, UMBU RATU NGGAY, SUMBA TENGAH, NUSA TENGGARA TIMUR",3,147,3,150
https://kawalpemilu.org#57923,"TANA MBANAS, UMBU RATU NGGAY, SUMBA TENGAH, NUSA TENGGARA TIMUR",4,108,3,111
https://kawalpemilu.org#57924,"PADIRA TANA, UMBU RATU NGGAY, SUMBA TENGAH, NUSA TENGGARA TIMUR",1,149,6,155
https://kawalpemilu.org#57924,"PADIRA TANA, UMBU RATU NGGAY, SUMBA TENGAH, NUSA TENGGARA TIMUR",2,133,10,143
https://kawalpemilu.org#57924,"PADIRA TANA, UMBU RATU NGGAY, SUMBA TENGAH, NUSA TENGGARA TIMUR",3,121,8,129
https://kawalpemilu.org#57924,"PADIRA TANA, UMBU RATU NGGAY, SUMBA TENGAH, NUSA TENGGARA TIMUR",4,106,3,109
https://kawalpemilu.org#57925,"NGADU BOLU, UMBU RATU NGGAY, SUMBA TENGAH, NUSA TENGGARA TIMUR",1,100,12,112
https://kawalpemilu.org#57925,"NGADU BOLU, UMBU RATU NGGAY, SUMBA TENGAH, NUSA TENGGARA TIMUR",2,119,11,130
https://kawalpemilu.org#57925,"NGADU BOLU, UMBU RATU NGGAY, SUMBA TENGAH, NUSA TENGGARA TIMUR",3,104,0,104
https://kawalpemilu.org#57926,"BOLU BOKAT UTARA, UMBU RATU NGGAY, SUMBA TENGAH, NUSA TENGGARA TIMUR",1,127,0,127
https://kawalpemilu.org#57926,"BOLU BOKAT UTARA, UMBU RATU NGGAY, SUMBA TENGAH, NUSA TENGGARA TIMUR",2,144,8,152
https://kawalpemilu.org#57926,"BOLU BOKAT UTARA, UMBU RATU NGGAY, SUMBA TENGAH, NUSA TENGGARA TIMUR",3,89,3,92
https://kawalpemilu.org#85229,"MARADESA TIMUR, UMBU RATU NGGAY, SUMBA TENGAH, NUSA TENGGARA TIMUR",1,44,4,48
https://kawalpemilu.org#85229,"MARADESA TIMUR, UMBU RATU NGGAY, SUMBA TENGAH, NUSA TENGGARA TIMUR",2,111,4,115
https://kawalpemilu.org#85229,"MARADESA TIMUR, UMBU RATU NGGAY, SUMBA TENGAH, NUSA TENGGARA TIMUR",3,68,3,71
https://kawalpemilu.org#85230,"MARADESA SELATAN, UMBU RATU NGGAY, SUMBA TENGAH, NUSA TENGGARA TIMUR",1,93,0,93
https://kawalpemilu.org#85230,"MARADESA SELATAN, UMBU RATU NGGAY, SUMBA TENGAH, NUSA TENGGARA TIMUR",2,65,1,66
https://kawalpemilu.org#85230,"MARADESA SELATAN, UMBU RATU NGGAY, SUMBA TENGAH, NUSA TENGGARA TIMUR",3,79,7,86
https://kawalpemilu.org#85231,"TANA MBANAS SELATAN, UMBU RATU NGGAY, SUMBA TENGAH, NUSA TENGGARA TIMUR",1,171,6,177
https://kawalpemilu.org#85231,"TANA MBANAS SELATAN, UMBU RATU NGGAY, SUMBA TENGAH, NUSA TENGGARA TIMUR",2,140,5,145
https://kawalpemilu.org#85231,"TANA MBANAS SELATAN, UMBU RATU NGGAY, SUMBA TENGAH, NUSA TENGGARA TIMUR",3,143,12,155
https://kawalpemilu.org#85232,"TANA MBANAS BARAT, UMBU RATU NGGAY, SUMBA TENGAH, NUSA TENGGARA TIMUR",1,107,3,110
https://kawalpemilu.org#85232,"TANA MBANAS BARAT, UMBU RATU NGGAY, SUMBA TENGAH, NUSA TENGGARA TIMUR",2,71,3,74
https://kawalpemilu.org#85232,"TANA MBANAS BARAT, UMBU RATU NGGAY, SUMBA TENGAH, NUSA TENGGARA TIMUR",3,85,7,92
https://kawalpemilu.org#85233,"NGADU OLU, UMBU RATU NGGAY, SUMBA TENGAH, NUSA TENGGARA TIMUR",1,81,5,86
https://kawalpemilu.org#85233,"NGADU OLU, UMBU RATU NGGAY, SUMBA TENGAH, NUSA TENGGARA TIMUR",2,111,12,123
https://kawalpemilu.org#85233,"NGADU OLU, UMBU RATU NGGAY, SUMBA TENGAH, NUSA TENGGARA TIMUR",3,172,2,174
https://kawalpemilu.org#85234,"LENANG SELATAN, UMBU RATU NGGAY, SUMBA TENGAH, NUSA TENGGARA TIMUR",1,145,12,157
https://kawalpemilu.org#85234,"LENANG SELATAN, UMBU RATU NGGAY, SUMBA TENGAH, NUSA TENGGARA TIMUR",2,182,14,196
https://kawalpemilu.org#85234,"LENANG SELATAN, UMBU RATU NGGAY, SUMBA TENGAH, NUSA TENGGARA TIMUR",3,136,1,137
https://kawalpemilu.org#85235,"BOLUBOKAT BARAT, UMBU RATU NGGAY, SUMBA TENGAH, NUSA TENGGARA TIMUR",1,77,9,86
https://kawalpemilu.org#85235,"BOLUBOKAT BARAT, UMBU RATU NGGAY, SUMBA TENGAH, NUSA TENGGARA TIMUR",2,151,4,155
https://kawalpemilu.org#85235,"BOLUBOKAT BARAT, UMBU RATU NGGAY, SUMBA TENGAH, NUSA TENGGARA TIMUR",3,70,4,74
https://kawalpemilu.org#57928,"KONDA MALOBA, KATIKU TANA SELATAN, SUMBA TENGAH, NUSA TENGGARA TIMUR",1,128,2,130
https://kawalpemilu.org#57928,"KONDA MALOBA, KATIKU TANA SELATAN, SUMBA TENGAH, NUSA TENGGARA TIMUR",2,144,14,158
https://kawalpemilu.org#57929,"TANAMODU, KATIKU TANA SELATAN, SUMBA TENGAH, NUSA TENGGARA TIMUR",1,213,19,232
https://kawalpemilu.org#57929,"TANAMODU, KATIKU TANA SELATAN, SUMBA TENGAH, NUSA TENGGARA TIMUR",2,218,18,236
https://kawalpemilu.org#57929,"TANAMODU, KATIKU TANA SELATAN, SUMBA TENGAH, NUSA TENGGARA TIMUR",3,193,18,211
https://kawalpemilu.org#57929,"TANAMODU, KATIKU TANA SELATAN, SUMBA TENGAH, NUSA TENGGARA TIMUR",4,177,18,195
https://kawalpemilu.org#57930,"MALINJAK, KATIKU TANA SELATAN, SUMBA TENGAH, NUSA TENGGARA TIMUR",1,171,20,191
https://kawalpemilu.org#57930,"MALINJAK, KATIKU TANA SELATAN, SUMBA TENGAH, NUSA TENGGARA TIMUR",2,191,14,205
https://kawalpemilu.org#57930,"MALINJAK, KATIKU TANA SELATAN, SUMBA TENGAH, NUSA TENGGARA TIMUR",3,171,21,192
https://kawalpemilu.org#57930,"MALINJAK, KATIKU TANA SELATAN, SUMBA TENGAH, NUSA TENGGARA TIMUR",4,200,19,219
https://kawalpemilu.org#57930,"MALINJAK, KATIKU TANA SELATAN, SUMBA TENGAH, NUSA TENGGARA TIMUR",5,173,24,197
https://kawalpemilu.org#57931,"WAI LAWA, KATIKU TANA SELATAN, SUMBA TENGAH, NUSA TENGGARA TIMUR",1,190,7,197
https://kawalpemilu.org#57931,"WAI LAWA, KATIKU TANA SELATAN, SUMBA TENGAH, NUSA TENGGARA TIMUR",2,151,4,155
https://kawalpemilu.org#57931,"WAI LAWA, KATIKU TANA SELATAN, SUMBA TENGAH, NUSA TENGGARA TIMUR",3,158,3,161
https://kawalpemilu.org#57931,"WAI LAWA, KATIKU TANA SELATAN, SUMBA TENGAH, NUSA TENGGARA TIMUR",4,151,14,165
https://kawalpemilu.org#57931,"WAI LAWA, KATIKU TANA SELATAN, SUMBA TENGAH, NUSA TENGGARA TIMUR",5,181,28,209
https://kawalpemilu.org#57932,"DAMEKA, KATIKU TANA SELATAN, SUMBA TENGAH, NUSA TENGGARA TIMUR",1,187,15,202
https://kawalpemilu.org#57932,"DAMEKA, KATIKU TANA SELATAN, SUMBA TENGAH, NUSA TENGGARA TIMUR",2,186,10,196
https://kawalpemilu.org#57932,"DAMEKA, KATIKU TANA SELATAN, SUMBA TENGAH, NUSA TENGGARA TIMUR",3,211,10,221
https://kawalpemilu.org#57932,"DAMEKA, KATIKU TANA SELATAN, SUMBA TENGAH, NUSA TENGGARA TIMUR",4,132,8,140
https://kawalpemilu.org#57933,"WAI MANU, KATIKU TANA SELATAN, SUMBA TENGAH, NUSA TENGGARA TIMUR",1,192,15,207
https://kawalpemilu.org#57933,"WAI MANU, KATIKU TANA SELATAN, SUMBA TENGAH, NUSA TENGGARA TIMUR",2,190,9,199
https://kawalpemilu.org#57933,"WAI MANU, KATIKU TANA SELATAN, SUMBA TENGAH, NUSA TENGGARA TIMUR",3,62,7,69
https://kawalpemilu.org#57933,"WAI MANU, KATIKU TANA SELATAN, SUMBA TENGAH, NUSA TENGGARA TIMUR",4,164,17,181
https://kawalpemilu.org#57934,"MANURARA, KATIKU TANA SELATAN, SUMBA TENGAH, NUSA TENGGARA TIMUR",1,168,14,182
https://kawalpemilu.org#57934,"MANURARA, KATIKU TANA SELATAN, SUMBA TENGAH, NUSA TENGGARA TIMUR",2,183,3,186
https://kawalpemilu.org#57934,"MANURARA, KATIKU TANA SELATAN, SUMBA TENGAH, NUSA TENGGARA TIMUR",3,211,7,218
https://kawalpemilu.org#85236,"DASA ELU, KATIKU TANA SELATAN, SUMBA TENGAH, NUSA TENGGARA TIMUR",1,200,11,211
https://kawalpemilu.org#85236,"DASA ELU, KATIKU TANA SELATAN, SUMBA TENGAH, NUSA TENGGARA TIMUR",2,223,3,226
https://kawalpemilu.org#85236,"DASA ELU, KATIKU TANA SELATAN, SUMBA TENGAH, NUSA TENGGARA TIMUR",3,187,17,204
https://kawalpemilu.org#85236,"DASA ELU, KATIKU TANA SELATAN, SUMBA TENGAH, NUSA TENGGARA TIMUR",4,126,22,148
https://kawalpemilu.org#85236,"DASA ELU, KATIKU TANA SELATAN, SUMBA TENGAH, NUSA TENGGARA TIMUR",5,196,15,211
https://kawalpemilu.org#85237,"OKA WACU, KATIKU TANA SELATAN, SUMBA TENGAH, NUSA TENGGARA TIMUR",1,156,15,171
https://kawalpemilu.org#85237,"OKA WACU, KATIKU TANA SELATAN, SUMBA TENGAH, NUSA TENGGARA TIMUR",2,166,9,175
https://kawalpemilu.org#57939,"BONDO BOGHILA, LOURA, SUMBA BARAT DAYA, NUSA TENGGARA TIMUR",1,173,8,181
https://kawalpemilu.org#57939,"BONDO BOGHILA, LOURA, SUMBA BARAT DAYA, NUSA TENGGARA TIMUR",2,143,3,146
https://kawalpemilu.org#57939,"BONDO BOGHILA, LOURA, SUMBA BARAT DAYA, NUSA TENGGARA TIMUR",3,182,9,191
https://kawalpemilu.org#57940,"LETE KONDA, LOURA, SUMBA BARAT DAYA, NUSA TENGGARA TIMUR",1,199,3,203
https://kawalpemilu.org#57940,"LETE KONDA, LOURA, SUMBA BARAT DAYA, NUSA TENGGARA TIMUR",2,182,10,192
https://kawalpemilu.org#57940,"LETE KONDA, LOURA, SUMBA BARAT DAYA, NUSA TENGGARA TIMUR",3,157,85,242
https://kawalpemilu.org#57940,"LETE KONDA, LOURA, SUMBA BARAT DAYA, NUSA TENGGARA TIMUR",4,143,58,201
https://kawalpemilu.org#57941,"KARUNI, LOURA, SUMBA BARAT DAYA, NUSA TENGGARA TIMUR",1,233,4,237
https://kawalpemilu.org#57941,"KARUNI, LOURA, SUMBA BARAT DAYA, NUSA TENGGARA TIMUR",2,200,4,204
https://kawalpemilu.org#57941,"KARUNI, LOURA, SUMBA BARAT DAYA, NUSA TENGGARA TIMUR",3,233,3,236
https://kawalpemilu.org#57941,"KARUNI, LOURA, SUMBA BARAT DAYA, NUSA TENGGARA TIMUR",5,175,2,177
https://kawalpemilu.org#57942,"TOTOK, LOURA, SUMBA BARAT DAYA, NUSA TENGGARA TIMUR",1,144,21,165
https://kawalpemilu.org#57942,"TOTOK, LOURA, SUMBA BARAT DAYA, NUSA TENGGARA TIMUR",2,162,11,173
https://kawalpemilu.org#57942,"TOTOK, LOURA, SUMBA BARAT DAYA, NUSA TENGGARA TIMUR",3,174,9,183
https://kawalpemilu.org#57942,"TOTOK, LOURA, SUMBA BARAT DAYA, NUSA TENGGARA TIMUR",4,132,21,153
https://kawalpemilu.org#57942,"TOTOK, LOURA, SUMBA BARAT DAYA, NUSA TENGGARA TIMUR",5,118,10,128
https://kawalpemilu.org#57942,"TOTOK, LOURA, SUMBA BARAT DAYA, NUSA TENGGARA TIMUR",6,172,10,182
https://kawalpemilu.org#57947,"RAMA DANA, LOURA, SUMBA BARAT DAYA, NUSA TENGGARA TIMUR",1,223,2,225
https://kawalpemilu.org#57947,"RAMA DANA, LOURA, SUMBA BARAT DAYA, NUSA TENGGARA TIMUR",2,173,5,178
https://kawalpemilu.org#57947,"RAMA DANA, LOURA, SUMBA BARAT DAYA, NUSA TENGGARA TIMUR",3,235,9,244
https://kawalpemilu.org#57947,"RAMA DANA, LOURA, SUMBA BARAT DAYA, NUSA TENGGARA TIMUR",4,191,13,204
https://kawalpemilu.org#57947,"RAMA DANA, LOURA, SUMBA BARAT DAYA, NUSA TENGGARA TIMUR",5,214,10,224
https://kawalpemilu.org#57947,"RAMA DANA, LOURA, SUMBA BARAT DAYA, NUSA TENGGARA TIMUR",6,192,4,196
https://kawalpemilu.org#57948,"WEE MANANDA, LOURA, SUMBA BARAT DAYA, NUSA TENGGARA TIMUR",1,283,0,283
https://kawalpemilu.org#57948,"WEE MANANDA, LOURA, SUMBA BARAT DAYA, NUSA TENGGARA TIMUR",2,189,0,189
https://kawalpemilu.org#57948,"WEE MANANDA, LOURA, SUMBA BARAT DAYA, NUSA TENGGARA TIMUR",3,265,0,265
https://kawalpemilu.org#57948,"WEE MANANDA, LOURA, SUMBA BARAT DAYA, NUSA TENGGARA TIMUR",4,140,5,145
https://kawalpemilu.org#90857,"POGO TENA, LOURA, SUMBA BARAT DAYA, NUSA TENGGARA TIMUR",1,172,13,185
https://kawalpemilu.org#90857,"POGO TENA, LOURA, SUMBA BARAT DAYA, NUSA TENGGARA TIMUR",2,128,5,133
https://kawalpemilu.org#90857,"POGO TENA, LOURA, SUMBA BARAT DAYA, NUSA TENGGARA TIMUR",3,159,14,173
https://kawalpemilu.org#90857,"POGO TENA, LOURA, SUMBA BARAT DAYA, NUSA TENGGARA TIMUR",4,217,7,224
https://kawalpemilu.org#90857,"POGO TENA, LOURA, SUMBA BARAT DAYA, NUSA TENGGARA TIMUR",5,193,1,194
https://kawalpemilu.org#90858,"PAYOLA UMBU, LOURA, SUMBA BARAT DAYA, NUSA TENGGARA TIMUR",1,238,7,245
https://kawalpemilu.org#90858,"PAYOLA UMBU, LOURA, SUMBA BARAT DAYA, NUSA TENGGARA TIMUR",2,228,10,238
https://kawalpemilu.org#90858,"PAYOLA UMBU, LOURA, SUMBA BARAT DAYA, NUSA TENGGARA TIMUR",3,215,3,218
https://kawalpemilu.org#90858,"PAYOLA UMBU, LOURA, SUMBA BARAT DAYA, NUSA TENGGARA TIMUR",4,272,6,278
https://kawalpemilu.org#90859,"WEE KAMBALA, LOURA, SUMBA BARAT DAYA, NUSA TENGGARA TIMUR",1,192,1,193
https://kawalpemilu.org#90859,"WEE KAMBALA, LOURA, SUMBA BARAT DAYA, NUSA TENGGARA TIMUR",2,175,3,178
https://kawalpemilu.org#90860,"LOKO KALADA, LOURA, SUMBA BARAT DAYA, NUSA TENGGARA TIMUR",1,197,7,204
https://kawalpemilu.org#90860,"LOKO KALADA, LOURA, SUMBA BARAT DAYA, NUSA TENGGARA TIMUR",2,209,9,218
https://kawalpemilu.org#930822,"LETE KONDA SELATAN, LOURA, SUMBA BARAT DAYA, NUSA TENGGARA TIMUR",1,187,5,192
https://kawalpemilu.org#930822,"LETE KONDA SELATAN, LOURA, SUMBA BARAT DAYA, NUSA TENGGARA TIMUR",2,180,4,184
https://kawalpemilu.org#930822,"LETE KONDA SELATAN, LOURA, SUMBA BARAT DAYA, NUSA TENGGARA TIMUR",3,219,2,221
https://kawalpemilu.org#930822,"LETE KONDA SELATAN, LOURA, SUMBA BARAT DAYA, NUSA TENGGARA TIMUR",4,185,4,189
https://kawalpemilu.org#57950,"MALI MADA, WEWEWA UTARA, SUMBA BARAT DAYA, NUSA TENGGARA TIMUR",1,115,2,117
https://kawalpemilu.org#57950,"MALI MADA, WEWEWA UTARA, SUMBA BARAT DAYA, NUSA TENGGARA TIMUR",2,125,3,128
https://kawalpemilu.org#57950,"MALI MADA, WEWEWA UTARA, SUMBA BARAT DAYA, NUSA TENGGARA TIMUR",3,129,3,132
https://kawalpemilu.org#57950,"MALI MADA, WEWEWA UTARA, SUMBA BARAT DAYA, NUSA TENGGARA TIMUR",4,90,0,90
https://kawalpemilu.org#57951,"WANO TALLA, WEWEWA UTARA, SUMBA BARAT DAYA, NUSA TENGGARA TIMUR",1,145,3,148
https://kawalpemilu.org#57951,"WANO TALLA, WEWEWA UTARA, SUMBA BARAT DAYA, NUSA TENGGARA TIMUR",2,137,2,139
https://kawalpemilu.org#57951,"WANO TALLA, WEWEWA UTARA, SUMBA BARAT DAYA, NUSA TENGGARA TIMUR",3,85,0,85
https://kawalpemilu.org#57952,"WEE PABOBA, WEWEWA UTARA, SUMBA BARAT DAYA, NUSA TENGGARA TIMUR",1,189,0,189
https://kawalpemilu.org#57952,"WEE PABOBA, WEWEWA UTARA, SUMBA BARAT DAYA, NUSA TENGGARA TIMUR",2,93,2,95
https://kawalpemilu.org#57952,"WEE PABOBA, WEWEWA UTARA, SUMBA BARAT DAYA, NUSA TENGGARA TIMUR",3,141,1,142
https://kawalpemilu.org#57952,"WEE PABOBA, WEWEWA UTARA, SUMBA BARAT DAYA, NUSA TENGGARA TIMUR",4,95,5,100
https://kawalpemilu.org#57952,"WEE PABOBA, WEWEWA UTARA, SUMBA BARAT DAYA, NUSA TENGGARA TIMUR",5,105,6,111
https://kawalpemilu.org#57952,"WEE PABOBA, WEWEWA UTARA, SUMBA BARAT DAYA, NUSA TENGGARA TIMUR",6,83,4,87
https://kawalpemilu.org#57952,"WEE PABOBA, WEWEWA UTARA, SUMBA BARAT DAYA, NUSA TENGGARA TIMUR",7,79,5,84
https://kawalpemilu.org#57952,"WEE PABOBA, WEWEWA UTARA, SUMBA BARAT DAYA, NUSA TENGGARA TIMUR",8,110,4,114
https://kawalpemilu.org#57952,"WEE PABOBA, WEWEWA UTARA, SUMBA BARAT DAYA, NUSA TENGGARA TIMUR",9,68,0,68
https://kawalpemilu.org#57952,"WEE PABOBA, WEWEWA UTARA, SUMBA BARAT DAYA, NUSA TENGGARA TIMUR",10,82,1,83
https://kawalpemilu.org#57953,"MATA LOKO, WEWEWA UTARA, SUMBA BARAT DAYA, NUSA TENGGARA TIMUR",1,152,5,157
https://kawalpemilu.org#57953,"MATA LOKO, WEWEWA UTARA, SUMBA BARAT DAYA, NUSA TENGGARA TIMUR",2,240,0,240
https://kawalpemilu.org#57953,"MATA LOKO, WEWEWA UTARA, SUMBA BARAT DAYA, NUSA TENGGARA TIMUR",3,196,1,197
https://kawalpemilu.org#57954,"WEE NAMBA, WEWEWA UTARA, SUMBA BARAT DAYA, NUSA TENGGARA TIMUR",1,159,1,160
https://kawalpemilu.org#57954,"WEE NAMBA, WEWEWA UTARA, SUMBA BARAT DAYA, NUSA TENGGARA TIMUR",2,136,3,139
https://kawalpemilu.org#57954,"WEE NAMBA, WEWEWA UTARA, SUMBA BARAT DAYA, NUSA TENGGARA TIMUR",3,211,9,220
https://kawalpemilu.org#57954,"WEE NAMBA, WEWEWA UTARA, SUMBA BARAT DAYA, NUSA TENGGARA TIMUR",4,217,0,217
https://kawalpemilu.org#57955,"PUU POTTO, WEWEWA UTARA, SUMBA BARAT DAYA, NUSA TENGGARA TIMUR",1,176,4,180
https://kawalpemilu.org#57955,"PUU POTTO, WEWEWA UTARA, SUMBA BARAT DAYA, NUSA TENGGARA TIMUR",2,105,3,108
https://kawalpemilu.org#57955,"PUU POTTO, WEWEWA UTARA, SUMBA BARAT DAYA, NUSA TENGGARA TIMUR",3,110,1,111
https://kawalpemilu.org#57955,"PUU POTTO, WEWEWA UTARA, SUMBA BARAT DAYA, NUSA TENGGARA TIMUR",4,148,0,148
https://kawalpemilu.org#930823,"BODO PONDA, WEWEWA UTARA, SUMBA BARAT DAYA, NUSA TENGGARA TIMUR",1,191,0,191
https://kawalpemilu.org#930823,"BODO PONDA, WEWEWA UTARA, SUMBA BARAT DAYA, NUSA TENGGARA TIMUR",2,111,1,112
https://kawalpemilu.org#930823,"BODO PONDA, WEWEWA UTARA, SUMBA BARAT DAYA, NUSA TENGGARA TIMUR",3,195,1,196
https://kawalpemilu.org#930824,"REDA WANO, WEWEWA UTARA, SUMBA BARAT DAYA, NUSA TENGGARA TIMUR",1,150,44,194
https://kawalpemilu.org#930824,"REDA WANO, WEWEWA UTARA, SUMBA BARAT DAYA, NUSA TENGGARA TIMUR",2,83,0,83
https://kawalpemilu.org#930824,"REDA WANO, WEWEWA UTARA, SUMBA BARAT DAYA, NUSA TENGGARA TIMUR",3,94,0,94
https://kawalpemilu.org#930824,"REDA WANO, WEWEWA UTARA, SUMBA BARAT DAYA, NUSA TENGGARA TIMUR",4,167,0,167
https://kawalpemilu.org#930825,"ODI PAURATA, WEWEWA UTARA, SUMBA BARAT DAYA, NUSA TENGGARA TIMUR",1,125,0,125
https://kawalpemilu.org#930825,"ODI PAURATA, WEWEWA UTARA, SUMBA BARAT DAYA, NUSA TENGGARA TIMUR",2,221,0,221
https://kawalpemilu.org#930825,"ODI PAURATA, WEWEWA UTARA, SUMBA BARAT DAYA, NUSA TENGGARA TIMUR",3,204,0,204
https://kawalpemilu.org#930825,"ODI PAURATA, WEWEWA UTARA, SUMBA BARAT DAYA, NUSA TENGGARA TIMUR",4,152,1,153
https://kawalpemilu.org#930826,"PANDUA TANA, WEWEWA UTARA, SUMBA BARAT DAYA, NUSA TENGGARA TIMUR",1,121,1,122
https://kawalpemilu.org#930826,"PANDUA TANA, WEWEWA UTARA, SUMBA BARAT DAYA, NUSA TENGGARA TIMUR",2,120,1,121
https://kawalpemilu.org#930826,"PANDUA TANA, WEWEWA UTARA, SUMBA BARAT DAYA, NUSA TENGGARA TIMUR",3,180,3,183
https://kawalpemilu.org#930827,"DJELA MANU, WEWEWA UTARA, SUMBA BARAT DAYA, NUSA TENGGARA TIMUR",1,118,4,122
https://kawalpemilu.org#930827,"DJELA MANU, WEWEWA UTARA, SUMBA BARAT DAYA, NUSA TENGGARA TIMUR",2,96,1,97
https://kawalpemilu.org#930827,"DJELA MANU, WEWEWA UTARA, SUMBA BARAT DAYA, NUSA TENGGARA TIMUR",3,133,1,134
https://kawalpemilu.org#930827,"DJELA MANU, WEWEWA UTARA, SUMBA BARAT DAYA, NUSA TENGGARA TIMUR",4,93,2,95
https://kawalpemilu.org#930827,"DJELA MANU, WEWEWA UTARA, SUMBA BARAT DAYA, NUSA TENGGARA TIMUR",5,152,3,155
https://kawalpemilu.org#930827,"DJELA MANU, WEWEWA UTARA, SUMBA BARAT DAYA, NUSA TENGGARA TIMUR",6,0,0,0
https://kawalpemilu.org#930828,"MAWO MALITI, WEWEWA UTARA, SUMBA BARAT DAYA, NUSA TENGGARA TIMUR",1,193,0,193
https://kawalpemilu.org#930828,"MAWO MALITI, WEWEWA UTARA, SUMBA BARAT DAYA, NUSA TENGGARA TIMUR",2,156,0,156
https://kawalpemilu.org#930828,"MAWO MALITI, WEWEWA UTARA, SUMBA BARAT DAYA, NUSA TENGGARA TIMUR",3,149,0,149
https://kawalpemilu.org#57957,"KALEMBU NDARA MANE, WEWEWA TIMUR, SUMBA BARAT DAYA, NUSA TENGGARA TIMUR",1,178,0,178
https://kawalpemilu.org#57957,"KALEMBU NDARA MANE, WEWEWA TIMUR, SUMBA BARAT DAYA, NUSA TENGGARA TIMUR",2,301,0,301
https://kawalpemilu.org#57957,"KALEMBU NDARA MANE, WEWEWA TIMUR, SUMBA BARAT DAYA, NUSA TENGGARA TIMUR",3,0,0,0
https://kawalpemilu.org#57957,"KALEMBU NDARA MANE, WEWEWA TIMUR, SUMBA BARAT DAYA, NUSA TENGGARA TIMUR",4,0,0,0
https://kawalpemilu.org#57958,"TEMA TANA, WEWEWA TIMUR, SUMBA BARAT DAYA, NUSA TENGGARA TIMUR",1,252,2,254
https://kawalpemilu.org#57958,"TEMA TANA, WEWEWA TIMUR, SUMBA BARAT DAYA, NUSA TENGGARA TIMUR",2,250,0,250
https://kawalpemilu.org#57958,"TEMA TANA, WEWEWA TIMUR, SUMBA BARAT DAYA, NUSA TENGGARA TIMUR",3,221,0,221
https://kawalpemilu.org#57958,"TEMA TANA, WEWEWA TIMUR, SUMBA BARAT DAYA, NUSA TENGGARA TIMUR",4,245,5,250
https://kawalpemilu.org#57958,"TEMA TANA, WEWEWA TIMUR, SUMBA BARAT DAYA, NUSA TENGGARA TIMUR",5,226,0,226
https://kawalpemilu.org#57961,"MAREDA KALADA, WEWEWA TIMUR, SUMBA BARAT DAYA, NUSA TENGGARA TIMUR",1,214,0,214
https://kawalpemilu.org#57961,"MAREDA KALADA, WEWEWA TIMUR, SUMBA BARAT DAYA, NUSA TENGGARA TIMUR",2,176,1,177
https://kawalpemilu.org#57961,"MAREDA KALADA, WEWEWA TIMUR, SUMBA BARAT DAYA, NUSA TENGGARA TIMUR",3,225,4,229
https://kawalpemilu.org#57961,"MAREDA KALADA, WEWEWA TIMUR, SUMBA BARAT DAYA, NUSA TENGGARA TIMUR",4,214,4,218
https://kawalpemilu.org#57961,"MAREDA KALADA, WEWEWA TIMUR, SUMBA BARAT DAYA, NUSA TENGGARA TIMUR",5,192,3,195
https://kawalpemilu.org#57962,"PADA EWETA, WEWEWA TIMUR, SUMBA BARAT DAYA, NUSA TENGGARA TIMUR",1,181,2,183
https://kawalpemilu.org#57962,"PADA EWETA, WEWEWA TIMUR, SUMBA BARAT DAYA, NUSA TENGGARA TIMUR",2,230,0,230
https://kawalpemilu.org#57962,"PADA EWETA, WEWEWA TIMUR, SUMBA BARAT DAYA, NUSA TENGGARA TIMUR",3,228,4,232
https://kawalpemilu.org#57962,"PADA EWETA, WEWEWA TIMUR, SUMBA BARAT DAYA, NUSA TENGGARA TIMUR",4,129,1,130
https://kawalpemilu.org#57962,"PADA EWETA, WEWEWA TIMUR, SUMBA BARAT DAYA, NUSA TENGGARA TIMUR",5,175,0,175
https://kawalpemilu.org#57968,"WEE LIMBU, WEWEWA TIMUR, SUMBA BARAT DAYA, NUSA TENGGARA TIMUR",1,271,1,272
https://kawalpemilu.org#57968,"WEE LIMBU, WEWEWA TIMUR, SUMBA BARAT DAYA, NUSA TENGGARA TIMUR",2,212,46,258
https://kawalpemilu.org#57968,"WEE LIMBU, WEWEWA TIMUR, SUMBA BARAT DAYA, NUSA TENGGARA TIMUR",3,241,17,258
https://kawalpemilu.org#57968,"WEE LIMBU, WEWEWA TIMUR, SUMBA BARAT DAYA, NUSA TENGGARA TIMUR",4,245,20,265
https://kawalpemilu.org#57968,"WEE LIMBU, WEWEWA TIMUR, SUMBA BARAT DAYA, NUSA TENGGARA TIMUR",5,260,0,260
https://kawalpemilu.org#57968,"WEE LIMBU, WEWEWA TIMUR, SUMBA BARAT DAYA, NUSA TENGGARA TIMUR",6,110,2,112
https://kawalpemilu.org#57968,"WEE LIMBU, WEWEWA TIMUR, SUMBA BARAT DAYA, NUSA TENGGARA TIMUR",7,240,13,253
https://kawalpemilu.org#57968,"WEE LIMBU, WEWEWA TIMUR, SUMBA BARAT DAYA, NUSA TENGGARA TIMUR",8,147,5,152
https://kawalpemilu.org#57969,"LETE KOMOUNA, WEWEWA TIMUR, SUMBA BARAT DAYA, NUSA TENGGARA TIMUR",1,270,0,270
https://kawalpemilu.org#57969,"LETE KOMOUNA, WEWEWA TIMUR, SUMBA BARAT DAYA, NUSA TENGGARA TIMUR",2,269,0,269
https://kawalpemilu.org#57969,"LETE KOMOUNA, WEWEWA TIMUR, SUMBA BARAT DAYA, NUSA TENGGARA TIMUR",3,274,0,274
https://kawalpemilu.org#57969,"LETE KOMOUNA, WEWEWA TIMUR, SUMBA BARAT DAYA, NUSA TENGGARA TIMUR",4,173,0,173
https://kawalpemilu.org#57970,"MATA PYAWU, WEWEWA TIMUR, SUMBA BARAT DAYA, NUSA TENGGARA TIMUR",1,273,2,275
https://kawalpemilu.org#57970,"MATA PYAWU, WEWEWA TIMUR, SUMBA BARAT DAYA, NUSA TENGGARA TIMUR",2,204,4,208
https://kawalpemilu.org#57970,"MATA PYAWU, WEWEWA TIMUR, SUMBA BARAT DAYA, NUSA TENGGARA TIMUR",3,248,0,248
https://kawalpemilu.org#57970,"MATA PYAWU, WEWEWA TIMUR, SUMBA BARAT DAYA, NUSA TENGGARA TIMUR",4,225,1,226
https://kawalpemilu.org#57971,"WEE LIMA, WEWEWA TIMUR, SUMBA BARAT DAYA, NUSA TENGGARA TIMUR",1,263,4,267
https://kawalpemilu.org#57971,"WEE LIMA, WEWEWA TIMUR, SUMBA BARAT DAYA, NUSA TENGGARA TIMUR",2,235,3,238
https://kawalpemilu.org#57971,"WEE LIMA, WEWEWA TIMUR, SUMBA BARAT DAYA, NUSA TENGGARA TIMUR",3,220,12,232
https://kawalpemilu.org#57974,"DIKIRA, WEWEWA TIMUR, SUMBA BARAT DAYA, NUSA TENGGARA TIMUR",1,261,0,261
https://kawalpemilu.org#57974,"DIKIRA, WEWEWA TIMUR, SUMBA BARAT DAYA, NUSA TENGGARA TIMUR",2,261,0,261
https://kawalpemilu.org#57974,"DIKIRA, WEWEWA TIMUR, SUMBA BARAT DAYA, NUSA TENGGARA TIMUR",3,263,0,263
https://kawalpemilu.org#57974,"DIKIRA, WEWEWA TIMUR, SUMBA BARAT DAYA, NUSA TENGGARA TIMUR",4,149,0,149
https://kawalpemilu.org#57976,"DANGGA MANGU, WEWEWA TIMUR, SUMBA BARAT DAYA, NUSA TENGGARA TIMUR",1,0,0,0
https://kawalpemilu.org#57976,"DANGGA MANGU, WEWEWA TIMUR, SUMBA BARAT DAYA, NUSA TENGGARA TIMUR",2,276,3,279
https://kawalpemilu.org#57976,"DANGGA MANGU, WEWEWA TIMUR, SUMBA BARAT DAYA, NUSA TENGGARA TIMUR",5,156,28,184
https://kawalpemilu.org#930829,"MAINDA OLE, WEWEWA TIMUR, SUMBA BARAT DAYA, NUSA TENGGARA TIMUR",1,243,6,249
https://kawalpemilu.org#930829,"MAINDA OLE, WEWEWA TIMUR, SUMBA BARAT DAYA, NUSA TENGGARA TIMUR",2,236,9,245
https://kawalpemilu.org#930829,"MAINDA OLE, WEWEWA TIMUR, SUMBA BARAT DAYA, NUSA TENGGARA TIMUR",3,167,5,172
https://kawalpemilu.org#930830,"KADI WANO, WEWEWA TIMUR, SUMBA BARAT DAYA, NUSA TENGGARA TIMUR",1,268,0,268
https://kawalpemilu.org#930830,"KADI WANO, WEWEWA TIMUR, SUMBA BARAT DAYA, NUSA TENGGARA TIMUR",2,257,9,266
https://kawalpemilu.org#930830,"KADI WANO, WEWEWA TIMUR, SUMBA BARAT DAYA, NUSA TENGGARA TIMUR",3,276,0,276
https://kawalpemilu.org#930830,"KADI WANO, WEWEWA TIMUR, SUMBA BARAT DAYA, NUSA TENGGARA TIMUR",4,268,0,268
https://kawalpemilu.org#930830,"KADI WANO, WEWEWA TIMUR, SUMBA BARAT DAYA, NUSA TENGGARA TIMUR",5,276,10,286
https://kawalpemilu.org#930831,"NYURA LELE, WEWEWA TIMUR, SUMBA BARAT DAYA, NUSA TENGGARA TIMUR",1,248,15,263
https://kawalpemilu.org#930831,"NYURA LELE, WEWEWA TIMUR, SUMBA BARAT DAYA, NUSA TENGGARA TIMUR",2,241,0,241
https://kawalpemilu.org#930831,"NYURA LELE, WEWEWA TIMUR, SUMBA BARAT DAYA, NUSA TENGGARA TIMUR",3,294,1,295
https://kawalpemilu.org#930832,"LELE MAYA, WEWEWA TIMUR, SUMBA BARAT DAYA, NUSA TENGGARA TIMUR",1,258,3,261
https://kawalpemilu.org#930832,"LELE MAYA, WEWEWA TIMUR, SUMBA BARAT DAYA, NUSA TENGGARA TIMUR",2,235,35,270
https://kawalpemilu.org#930833,"MALITI DARI, WEWEWA TIMUR, SUMBA BARAT DAYA, NUSA TENGGARA TIMUR",1,259,0,259
https://kawalpemilu.org#930833,"MALITI DARI, WEWEWA TIMUR, SUMBA BARAT DAYA, NUSA TENGGARA TIMUR",2,263,0,263
https://kawalpemilu.org#930833,"MALITI DARI, WEWEWA TIMUR, SUMBA BARAT DAYA, NUSA TENGGARA TIMUR",3,205,0,205
https://kawalpemilu.org#930834,"MAWO DANA, WEWEWA TIMUR, SUMBA BARAT DAYA, NUSA TENGGARA TIMUR",1,262,0,262
https://kawalpemilu.org#930834,"MAWO DANA, WEWEWA TIMUR, SUMBA BARAT DAYA, NUSA TENGGARA TIMUR",2,242,2,242
https://kawalpemilu.org#930834,"MAWO DANA, WEWEWA TIMUR, SUMBA BARAT DAYA, NUSA TENGGARA TIMUR",3,197,4,201
https://kawalpemilu.org#930835,"DEDE PADA, WEWEWA TIMUR, SUMBA BARAT DAYA, NUSA TENGGARA TIMUR",1,267,0,267
https://kawalpemilu.org#930835,"DEDE PADA, WEWEWA TIMUR, SUMBA BARAT DAYA, NUSA TENGGARA TIMUR",2,240,22,262
https://kawalpemilu.org#930835,"DEDE PADA, WEWEWA TIMUR, SUMBA BARAT DAYA, NUSA TENGGARA TIMUR",3,263,0,263
https://kawalpemilu.org#930835,"DEDE PADA, WEWEWA TIMUR, SUMBA BARAT DAYA, NUSA TENGGARA TIMUR",4,165,2,167
https://kawalpemilu.org#930836,"MATA WEE LIMA, WEWEWA TIMUR, SUMBA BARAT DAYA, NUSA TENGGARA TIMUR",1,221,0,221
https://kawalpemilu.org#930836,"MATA WEE LIMA, WEWEWA TIMUR, SUMBA BARAT DAYA, NUSA TENGGARA TIMUR",2,219,12,231
https://kawalpemilu.org#930836,"MATA WEE LIMA, WEWEWA TIMUR, SUMBA BARAT DAYA, NUSA TENGGARA TIMUR",3,219,10,229
https://kawalpemilu.org#930836,"MATA WEE LIMA, WEWEWA TIMUR, SUMBA BARAT DAYA, NUSA TENGGARA TIMUR",4,150,0,150
https://kawalpemilu.org#930837,"KADI WONE, WEWEWA TIMUR, SUMBA BARAT DAYA, NUSA TENGGARA TIMUR",1,284,0,284
https://kawalpemilu.org#930837,"KADI WONE, WEWEWA TIMUR, SUMBA BARAT DAYA, NUSA TENGGARA TIMUR",2,283,2,285
https://kawalpemilu.org#930837,"KADI WONE, WEWEWA TIMUR, SUMBA BARAT DAYA, NUSA TENGGARA TIMUR",3,295,0,295
https://kawalpemilu.org#930837,"KADI WONE, WEWEWA TIMUR, SUMBA BARAT DAYA, NUSA TENGGARA TIMUR",4,178,0,178
https://kawalpemilu.org#57978,"WAIMANGURA, WEWEWA BARAT, SUMBA BARAT DAYA, NUSA TENGGARA TIMUR",1,255,33,288
https://kawalpemilu.org#57978,"WAIMANGURA, WEWEWA BARAT, SUMBA BARAT DAYA, NUSA TENGGARA TIMUR",2,245,20,265
https://kawalpemilu.org#57978,"WAIMANGURA, WEWEWA BARAT, SUMBA BARAT DAYA, NUSA TENGGARA TIMUR",3,235,26,261
https://kawalpemilu.org#57978,"WAIMANGURA, WEWEWA BARAT, SUMBA BARAT DAYA, NUSA TENGGARA TIMUR",4,171,20,191
https://kawalpemilu.org#57978,"WAIMANGURA, WEWEWA BARAT, SUMBA BARAT DAYA, NUSA TENGGARA TIMUR",5,235,11,246
https://kawalpemilu.org#57978,"WAIMANGURA, WEWEWA BARAT, SUMBA BARAT DAYA, NUSA TENGGARA TIMUR",6,187,9,196
https://kawalpemilu.org#57978,"WAIMANGURA, WEWEWA BARAT, SUMBA BARAT DAYA, NUSA TENGGARA TIMUR",7,200,16,216
https://kawalpemilu.org#57978,"WAIMANGURA, WEWEWA BARAT, SUMBA BARAT DAYA, NUSA TENGGARA TIMUR",8,177,8,185
https://kawalpemilu.org#57978,"WAIMANGURA, WEWEWA BARAT, SUMBA BARAT DAYA, NUSA TENGGARA TIMUR",9,175,12,187
https://kawalpemilu.org#57978,"WAIMANGURA, WEWEWA BARAT, SUMBA BARAT DAYA, NUSA TENGGARA TIMUR",10,176,2,178
https://kawalpemilu.org#57978,"WAIMANGURA, WEWEWA BARAT, SUMBA BARAT DAYA, NUSA TENGGARA TIMUR",11,52,2,54
https://kawalpemilu.org#57979,"KALEMBU WERI, WEWEWA BARAT, SUMBA BARAT DAYA, NUSA TENGGARA TIMUR",1,306,0,306
https://kawalpemilu.org#57979,"KALEMBU WERI, WEWEWA BARAT, SUMBA BARAT DAYA, NUSA TENGGARA TIMUR",2,288,0,288
https://kawalpemilu.org#57979,"KALEMBU WERI, WEWEWA BARAT, SUMBA BARAT DAYA, NUSA TENGGARA TIMUR",3,303,0,303
https://kawalpemilu.org#57979,"KALEMBU WERI, WEWEWA BARAT, SUMBA BARAT DAYA, NUSA TENGGARA TIMUR",4,296,0,296
https://kawalpemilu.org#57980,"WALI ATE, WEWEWA BARAT, SUMBA BARAT DAYA, NUSA TENGGARA TIMUR",1,214,0,214
https://kawalpemilu.org#57980,"WALI ATE, WEWEWA BARAT, SUMBA BARAT DAYA, NUSA TENGGARA TIMUR",2,183,13,196
https://kawalpemilu.org#57980,"WALI ATE, WEWEWA BARAT, SUMBA BARAT DAYA, NUSA TENGGARA TIMUR",3,197,0,197
https://kawalpemilu.org#57980,"WALI ATE, WEWEWA BARAT, SUMBA BARAT DAYA, NUSA TENGGARA TIMUR",4,234,4,238
https://kawalpemilu.org#57980,"WALI ATE, WEWEWA BARAT, SUMBA BARAT DAYA, NUSA TENGGARA TIMUR",5,233,0,233
https://kawalpemilu.org#57980,"WALI ATE, WEWEWA BARAT, SUMBA BARAT DAYA, NUSA TENGGARA TIMUR",6,222,0,222
https://kawalpemilu.org#57980,"WALI ATE, WEWEWA BARAT, SUMBA BARAT DAYA, NUSA TENGGARA TIMUR",7,137,4,143
https://kawalpemilu.org#57980,"WALI ATE, WEWEWA BARAT, SUMBA BARAT DAYA, NUSA TENGGARA TIMUR",8,129,0,129
https://kawalpemilu.org#57981,"KABALI DANA, WEWEWA BARAT, SUMBA BARAT DAYA, NUSA TENGGARA TIMUR",1,230,2,232
https://kawalpemilu.org#57981,"KABALI DANA, WEWEWA BARAT, SUMBA BARAT DAYA, NUSA TENGGARA TIMUR",2,192,6,198
https://kawalpemilu.org#57981,"KABALI DANA, WEWEWA BARAT, SUMBA BARAT DAYA, NUSA TENGGARA TIMUR",3,166,2,168
https://kawalpemilu.org#57981,"KABALI DANA, WEWEWA BARAT, SUMBA BARAT DAYA, NUSA TENGGARA TIMUR",4,228,2,230
https://kawalpemilu.org#57981,"KABALI DANA, WEWEWA BARAT, SUMBA BARAT DAYA, NUSA TENGGARA TIMUR",5,156,9,165
https://kawalpemilu.org#57981,"KABALI DANA, WEWEWA BARAT, SUMBA BARAT DAYA, NUSA TENGGARA TIMUR",6,224,8,232
https://kawalpemilu.org#57981,"KABALI DANA, WEWEWA BARAT, SUMBA BARAT DAYA, NUSA TENGGARA TIMUR",7,187,4,191
https://kawalpemilu.org#57982,"WEE KOMBAKA, WEWEWA BARAT, SUMBA BARAT DAYA, NUSA TENGGARA TIMUR",1,298,1,299
https://kawalpemilu.org#57982,"WEE KOMBAKA, WEWEWA BARAT, SUMBA BARAT DAYA, NUSA TENGGARA TIMUR",2,245,41,286
https://kawalpemilu.org#57982,"WEE KOMBAKA, WEWEWA BARAT, SUMBA BARAT DAYA, NUSA TENGGARA TIMUR",3,162,4,166
https://kawalpemilu.org#57982,"WEE KOMBAKA, WEWEWA BARAT, SUMBA BARAT DAYA, NUSA TENGGARA TIMUR",4,250,1,251
https://kawalpemilu.org#57982,"WEE KOMBAKA, WEWEWA BARAT, SUMBA BARAT DAYA, NUSA TENGGARA TIMUR",5,232,0,232
https://kawalpemilu.org#57982,"WEE KOMBAKA, WEWEWA BARAT, SUMBA BARAT DAYA, NUSA TENGGARA TIMUR",6,280,6,286
https://kawalpemilu.org#57982,"WEE KOMBAKA, WEWEWA BARAT, SUMBA BARAT DAYA, NUSA TENGGARA TIMUR",7,195,1,196
https://kawalpemilu.org#57982,"WEE KOMBAKA, WEWEWA BARAT, SUMBA BARAT DAYA, NUSA TENGGARA TIMUR",8,145,2,147
https://kawalpemilu.org#57983,"MAROKOTA, WEWEWA BARAT, SUMBA BARAT DAYA, NUSA TENGGARA TIMUR",1,270,5,275
https://kawalpemilu.org#57983,"MAROKOTA, WEWEWA BARAT, SUMBA BARAT DAYA, NUSA TENGGARA TIMUR",2,204,3,207
https://kawalpemilu.org#57983,"MAROKOTA, WEWEWA BARAT, SUMBA BARAT DAYA, NUSA TENGGARA TIMUR",3,207,3,210
https://kawalpemilu.org#57983,"MAROKOTA, WEWEWA BARAT, SUMBA BARAT DAYA, NUSA TENGGARA TIMUR",4,179,4,183
https://kawalpemilu.org#57983,"MAROKOTA, WEWEWA BARAT, SUMBA BARAT DAYA, NUSA TENGGARA TIMUR",6,201,2,203
https://kawalpemilu.org#57983,"MAROKOTA, WEWEWA BARAT, SUMBA BARAT DAYA, NUSA TENGGARA TIMUR",7,138,6,144
https://kawalpemilu.org#57983,"MAROKOTA, WEWEWA BARAT, SUMBA BARAT DAYA, NUSA TENGGARA TIMUR",8,168,3,171
https://kawalpemilu.org#57984,"WATU LABARA, WEWEWA BARAT, SUMBA BARAT DAYA, NUSA TENGGARA TIMUR",1,203,10,213
https://kawalpemilu.org#57984,"WATU LABARA, WEWEWA BARAT, SUMBA BARAT DAYA, NUSA TENGGARA TIMUR",2,202,14,216
https://kawalpemilu.org#57984,"WATU LABARA, WEWEWA BARAT, SUMBA BARAT DAYA, NUSA TENGGARA TIMUR",3,256,0,256
https://kawalpemilu.org#57984,"WATU LABARA, WEWEWA BARAT, SUMBA BARAT DAYA, NUSA TENGGARA TIMUR",4,102,5,107
https://kawalpemilu.org#57985,"KALIMBU TILU, WEWEWA BARAT, SUMBA BARAT DAYA, NUSA TENGGARA TIMUR",1,278,20,298
https://kawalpemilu.org#57985,"KALIMBU TILU, WEWEWA BARAT, SUMBA BARAT DAYA, NUSA TENGGARA TIMUR",2,297,0,297
https://kawalpemilu.org#57985,"KALIMBU TILU, WEWEWA BARAT, SUMBA BARAT DAYA, NUSA TENGGARA TIMUR",3,298,0,298
https://kawalpemilu.org#57985,"KALIMBU TILU, WEWEWA BARAT, SUMBA BARAT DAYA, NUSA TENGGARA TIMUR",4,296,2,298
https://kawalpemilu.org#57985,"KALIMBU TILU, WEWEWA BARAT, SUMBA BARAT DAYA, NUSA TENGGARA TIMUR",5,300,0,300
https://kawalpemilu.org#57985,"KALIMBU TILU, WEWEWA BARAT, SUMBA BARAT DAYA, NUSA TENGGARA TIMUR",6,245,53,298
https://kawalpemilu.org#57985,"KALIMBU TILU, WEWEWA BARAT, SUMBA BARAT DAYA, NUSA TENGGARA TIMUR",7,269,0,269
https://kawalpemilu.org#57988,"MENNE ATE, WEWEWA BARAT, SUMBA BARAT DAYA, NUSA TENGGARA TIMUR",1,275,0,275
https://kawalpemilu.org#57988,"MENNE ATE, WEWEWA BARAT, SUMBA BARAT DAYA, NUSA TENGGARA TIMUR",2,285,0,285
https://kawalpemilu.org#57988,"MENNE ATE, WEWEWA BARAT, SUMBA BARAT DAYA, NUSA TENGGARA TIMUR",3,202,0,202
https://kawalpemilu.org#57988,"MENNE ATE, WEWEWA BARAT, SUMBA BARAT DAYA, NUSA TENGGARA TIMUR",4,229,1,230
https://kawalpemilu.org#57988,"MENNE ATE, WEWEWA BARAT, SUMBA BARAT DAYA, NUSA TENGGARA TIMUR",5,228,0,228
https://kawalpemilu.org#57989,"REDA PADA, WEWEWA BARAT, SUMBA BARAT DAYA, NUSA TENGGARA TIMUR",1,243,6,249
https://kawalpemilu.org#57989,"REDA PADA, WEWEWA BARAT, SUMBA BARAT DAYA, NUSA TENGGARA TIMUR",2,232,7,239
https://kawalpemilu.org#57989,"REDA PADA, WEWEWA BARAT, SUMBA BARAT DAYA, NUSA TENGGARA TIMUR",3,141,6,147
https://kawalpemilu.org#57989,"REDA PADA, WEWEWA BARAT, SUMBA BARAT DAYA, NUSA TENGGARA TIMUR",4,78,1,79
https://kawalpemilu.org#57990,"RABA EGE, WEWEWA BARAT, SUMBA BARAT DAYA, NUSA TENGGARA TIMUR",1,288,7,295
https://kawalpemilu.org#57990,"RABA EGE, WEWEWA BARAT, SUMBA BARAT DAYA, NUSA TENGGARA TIMUR",2,304,0,304
https://kawalpemilu.org#57990,"RABA EGE, WEWEWA BARAT, SUMBA BARAT DAYA, NUSA TENGGARA TIMUR",3,296,4,300
https://kawalpemilu.org#57990,"RABA EGE, WEWEWA BARAT, SUMBA BARAT DAYA, NUSA TENGGARA TIMUR",4,184,4,188
https://kawalpemilu.org#57990,"RABA EGE, WEWEWA BARAT, SUMBA BARAT DAYA, NUSA TENGGARA TIMUR",5,270,2,272
https://kawalpemilu.org#57990,"RABA EGE, WEWEWA BARAT, SUMBA BARAT DAYA, NUSA TENGGARA TIMUR",6,122,1,123
https://kawalpemilu.org#90862,"KALAKI KAMBE, WEWEWA BARAT, SUMBA BARAT DAYA, NUSA TENGGARA TIMUR",1,195,5,200
https://kawalpemilu.org#90862,"KALAKI KAMBE, WEWEWA BARAT, SUMBA BARAT DAYA, NUSA TENGGARA TIMUR",2,176,7,183
https://kawalpemilu.org#90862,"KALAKI KAMBE, WEWEWA BARAT, SUMBA BARAT DAYA, NUSA TENGGARA TIMUR",3,208,6,214
https://kawalpemilu.org#90862,"KALAKI KAMBE, WEWEWA BARAT, SUMBA BARAT DAYA, NUSA TENGGARA TIMUR",4,173,6,179
https://kawalpemilu.org#90863,"KALEMBU KANAIKA, WEWEWA BARAT, SUMBA BARAT DAYA, NUSA TENGGARA TIMUR",1,262,1,263
https://kawalpemilu.org#90863,"KALEMBU KANAIKA, WEWEWA BARAT, SUMBA BARAT DAYA, NUSA TENGGARA TIMUR",2,183,3,186
https://kawalpemilu.org#90863,"KALEMBU KANAIKA, WEWEWA BARAT, SUMBA BARAT DAYA, NUSA TENGGARA TIMUR",3,250,9,259
https://kawalpemilu.org#90864,"LAGA LETE, WEWEWA BARAT, SUMBA BARAT DAYA, NUSA TENGGARA TIMUR",1,159,6,165
https://kawalpemilu.org#90864,"LAGA LETE, WEWEWA BARAT, SUMBA BARAT DAYA, NUSA TENGGARA TIMUR",2,189,0,189
https://kawalpemilu.org#90864,"LAGA LETE, WEWEWA BARAT, SUMBA BARAT DAYA, NUSA TENGGARA TIMUR",3,236,25,261
https://kawalpemilu.org#90864,"LAGA LETE, WEWEWA BARAT, SUMBA BARAT DAYA, NUSA TENGGARA TIMUR",4,181,2,183
https://kawalpemilu.org#90865,"WEE KURA, WEWEWA BARAT, SUMBA BARAT DAYA, NUSA TENGGARA TIMUR",1,166,0,166
https://kawalpemilu.org#90865,"WEE KURA, WEWEWA BARAT, SUMBA BARAT DAYA, NUSA TENGGARA TIMUR",2,172,0,172
https://kawalpemilu.org#90865,"WEE KURA, WEWEWA BARAT, SUMBA BARAT DAYA, NUSA TENGGARA TIMUR",3,109,5,114
https://kawalpemilu.org#90866,"LUA KOBA, WEWEWA BARAT, SUMBA BARAT DAYA, NUSA TENGGARA TIMUR",1,191,3,194
https://kawalpemilu.org#90866,"LUA KOBA, WEWEWA BARAT, SUMBA BARAT DAYA, NUSA TENGGARA TIMUR",2,259,13,272
https://kawalpemilu.org#90866,"LUA KOBA, WEWEWA BARAT, SUMBA BARAT DAYA, NUSA TENGGARA TIMUR",3,193,0,193
https://kawalpemilu.org#90866,"LUA KOBA, WEWEWA BARAT, SUMBA BARAT DAYA, NUSA TENGGARA TIMUR",4,299,2,301
https://kawalpemilu.org#90866,"LUA KOBA, WEWEWA BARAT, SUMBA BARAT DAYA, NUSA TENGGARA TIMUR",5,203,2,205
https://kawalpemilu.org#90866,"LUA KOBA, WEWEWA BARAT, SUMBA BARAT DAYA, NUSA TENGGARA TIMUR",6,188,6,194
https://kawalpemilu.org#90866,"LUA KOBA, WEWEWA BARAT, SUMBA BARAT DAYA, NUSA TENGGARA TIMUR",7,239,8,247
https://kawalpemilu.org#90867,"TAWO RARA, WEWEWA BARAT, SUMBA BARAT DAYA, NUSA TENGGARA TIMUR",1,200,5,205
https://kawalpemilu.org#90867,"TAWO RARA, WEWEWA BARAT, SUMBA BARAT DAYA, NUSA TENGGARA TIMUR",2,189,6,195
https://kawalpemilu.org#90867,"TAWO RARA, WEWEWA BARAT, SUMBA BARAT DAYA, NUSA TENGGARA TIMUR",3,204,1,205
https://kawalpemilu.org#90867,"TAWO RARA, WEWEWA BARAT, SUMBA BARAT DAYA, NUSA TENGGARA TIMUR",4,139,0,139
https://kawalpemilu.org#90867,"TAWO RARA, WEWEWA BARAT, SUMBA BARAT DAYA, NUSA TENGGARA TIMUR",5,160,3,163
https://kawalpemilu.org#930838,"SANGU ATE, WEWEWA BARAT, SUMBA BARAT DAYA, NUSA TENGGARA TIMUR",1,197,1,198
https://kawalpemilu.org#930838,"SANGU ATE, WEWEWA BARAT, SUMBA BARAT DAYA, NUSA TENGGARA TIMUR",2,166,2,168
https://kawalpemilu.org#930838,"SANGU ATE, WEWEWA BARAT, SUMBA BARAT DAYA, NUSA TENGGARA TIMUR",3,150,9,159
https://kawalpemilu.org#930838,"SANGU ATE, WEWEWA BARAT, SUMBA BARAT DAYA, NUSA TENGGARA TIMUR",4,165,0,165
https://kawalpemilu.org#930839,"LOLO OLE, WEWEWA BARAT, SUMBA BARAT DAYA, NUSA TENGGARA TIMUR",1,192,12,204
https://kawalpemilu.org#930839,"LOLO OLE, WEWEWA BARAT, SUMBA BARAT DAYA, NUSA TENGGARA TIMUR",2,275,22,297
https://kawalpemilu.org#930839,"LOLO OLE, WEWEWA BARAT, SUMBA BARAT DAYA, NUSA TENGGARA TIMUR",3,223,28,251
https://kawalpemilu.org#930840,"PERO, WEWEWA BARAT, SUMBA BARAT DAYA, NUSA TENGGARA TIMUR",1,183,3,186
https://kawalpemilu.org#930840,"PERO, WEWEWA BARAT, SUMBA BARAT DAYA, NUSA TENGGARA TIMUR",2,201,3,204
https://kawalpemilu.org#930840,"PERO, WEWEWA BARAT, SUMBA BARAT DAYA, NUSA TENGGARA TIMUR",3,159,4,163
https://kawalpemilu.org#930840,"PERO, WEWEWA BARAT, SUMBA BARAT DAYA, NUSA TENGGARA TIMUR",4,120,3,123
https://kawalpemilu.org#57993,"BURU DEILO, WEWEWA SELATAN, SUMBA BARAT DAYA, NUSA TENGGARA TIMUR",1,194,7,201
https://kawalpemilu.org#57993,"BURU DEILO, WEWEWA SELATAN, SUMBA BARAT DAYA, NUSA TENGGARA TIMUR",2,180,1,181
https://kawalpemilu.org#57993,"BURU DEILO, WEWEWA SELATAN, SUMBA BARAT DAYA, NUSA TENGGARA TIMUR",3,119,0,119
https://kawalpemilu.org#57993,"BURU DEILO, WEWEWA SELATAN, SUMBA BARAT DAYA, NUSA TENGGARA TIMUR",4,191,6,197
https://kawalpemilu.org#57993,"BURU DEILO, WEWEWA SELATAN, SUMBA BARAT DAYA, NUSA TENGGARA TIMUR",5,178,1,179
https://kawalpemilu.org#57993,"BURU DEILO, WEWEWA SELATAN, SUMBA BARAT DAYA, NUSA TENGGARA TIMUR",6,201,9,210
https://kawalpemilu.org#57993,"BURU DEILO, WEWEWA SELATAN, SUMBA BARAT DAYA, NUSA TENGGARA TIMUR",7,190,4,194
https://kawalpemilu.org#57994,"WERI LOLO, WEWEWA SELATAN, SUMBA BARAT DAYA, NUSA TENGGARA TIMUR",1,287,0,287
https://kawalpemilu.org#57994,"WERI LOLO, WEWEWA SELATAN, SUMBA BARAT DAYA, NUSA TENGGARA TIMUR",2,249,14,263
https://kawalpemilu.org#57994,"WERI LOLO, WEWEWA SELATAN, SUMBA BARAT DAYA, NUSA TENGGARA TIMUR",3,281,0,281
https://kawalpemilu.org#57994,"WERI LOLO, WEWEWA SELATAN, SUMBA BARAT DAYA, NUSA TENGGARA TIMUR",4,281,7,288
https://kawalpemilu.org#57994,"WERI LOLO, WEWEWA SELATAN, SUMBA BARAT DAYA, NUSA TENGGARA TIMUR",5,263,0,263
https://kawalpemilu.org#57994,"WERI LOLO, WEWEWA SELATAN, SUMBA BARAT DAYA, NUSA TENGGARA TIMUR",6,280,7,287
https://kawalpemilu.org#57995,"BURU KAGHU, WEWEWA SELATAN, SUMBA BARAT DAYA, NUSA TENGGARA TIMUR",1,299,0,299
https://kawalpemilu.org#57995,"BURU KAGHU, WEWEWA SELATAN, SUMBA BARAT DAYA, NUSA TENGGARA TIMUR",2,273,0,273
https://kawalpemilu.org#57995,"BURU KAGHU, WEWEWA SELATAN, SUMBA BARAT DAYA, NUSA TENGGARA TIMUR",4,278,0,278
https://kawalpemilu.org#57995,"BURU KAGHU, WEWEWA SELATAN, SUMBA BARAT DAYA, NUSA TENGGARA TIMUR",5,287,2,289
https://kawalpemilu.org#57995,"BURU KAGHU, WEWEWA SELATAN, SUMBA BARAT DAYA, NUSA TENGGARA TIMUR",6,265,22,287
https://kawalpemilu.org#57996,"DENDUKA, WEWEWA SELATAN, SUMBA BARAT DAYA, NUSA TENGGARA TIMUR",1,190,17,207
https://kawalpemilu.org#57996,"DENDUKA, WEWEWA SELATAN, SUMBA BARAT DAYA, NUSA TENGGARA TIMUR",2,274,3,277
https://kawalpemilu.org#57996,"DENDUKA, WEWEWA SELATAN, SUMBA BARAT DAYA, NUSA TENGGARA TIMUR",3,283,8,291
https://kawalpemilu.org#57996,"DENDUKA, WEWEWA SELATAN, SUMBA BARAT DAYA, NUSA TENGGARA TIMUR",4,253,38,291
https://kawalpemilu.org#57996,"DENDUKA, WEWEWA SELATAN, SUMBA BARAT DAYA, NUSA TENGGARA TIMUR",5,264,13,277
https://kawalpemilu.org#57996,"DENDUKA, WEWEWA SELATAN, SUMBA BARAT DAYA, NUSA TENGGARA TIMUR",6,229,16,245
https://kawalpemilu.org#57996,"DENDUKA, WEWEWA SELATAN, SUMBA BARAT DAYA, NUSA TENGGARA TIMUR",7,157,21,178
https://kawalpemilu.org#57997,"BONDO BELA, WEWEWA SELATAN, SUMBA BARAT DAYA, NUSA TENGGARA TIMUR",1,266,2,268
https://kawalpemilu.org#57997,"BONDO BELA, WEWEWA SELATAN, SUMBA BARAT DAYA, NUSA TENGGARA TIMUR",2,151,5,156
https://kawalpemilu.org#57997,"BONDO BELA, WEWEWA SELATAN, SUMBA BARAT DAYA, NUSA TENGGARA TIMUR",3,221,29,250
https://kawalpemilu.org#57997,"BONDO BELA, WEWEWA SELATAN, SUMBA BARAT DAYA, NUSA TENGGARA TIMUR",4,217,22,239
https://kawalpemilu.org#57998,"DELO, WEWEWA SELATAN, SUMBA BARAT DAYA, NUSA TENGGARA TIMUR",1,282,15,297
https://kawalpemilu.org#57998,"DELO, WEWEWA SELATAN, SUMBA BARAT DAYA, NUSA TENGGARA TIMUR",2,278,14,292
https://kawalpemilu.org#57998,"DELO, WEWEWA SELATAN, SUMBA BARAT DAYA, NUSA TENGGARA TIMUR",3,280,5,285
https://kawalpemilu.org#57998,"DELO, WEWEWA SELATAN, SUMBA BARAT DAYA, NUSA TENGGARA TIMUR",4,284,8,292
https://kawalpemilu.org#57998,"DELO, WEWEWA SELATAN, SUMBA BARAT DAYA, NUSA TENGGARA TIMUR",5,265,7,272
https://kawalpemilu.org#57999,"TANA TEKE, WEWEWA SELATAN, SUMBA BARAT DAYA, NUSA TENGGARA TIMUR",1,178,9,187
https://kawalpemilu.org#57999,"TANA TEKE, WEWEWA SELATAN, SUMBA BARAT DAYA, NUSA TENGGARA TIMUR",2,184,6,190
https://kawalpemilu.org#57999,"TANA TEKE, WEWEWA SELATAN, SUMBA BARAT DAYA, NUSA TENGGARA TIMUR",3,181,3,184
https://kawalpemilu.org#57999,"TANA TEKE, WEWEWA SELATAN, SUMBA BARAT DAYA, NUSA TENGGARA TIMUR",4,152,4,156
https://kawalpemilu.org#57999,"TANA TEKE, WEWEWA SELATAN, SUMBA BARAT DAYA, NUSA TENGGARA TIMUR",5,183,10,193
https://kawalpemilu.org#57999,"TANA TEKE, WEWEWA SELATAN, SUMBA BARAT DAYA, NUSA TENGGARA TIMUR",6,159,8,167
https://kawalpemilu.org#57999,"TANA TEKE, WEWEWA SELATAN, SUMBA BARAT DAYA, NUSA TENGGARA TIMUR",7,108,6,114
https://kawalpemilu.org#57999,"TANA TEKE, WEWEWA SELATAN, SUMBA BARAT DAYA, NUSA TENGGARA TIMUR",8,143,1,144
https://kawalpemilu.org#57999,"TANA TEKE, WEWEWA SELATAN, SUMBA BARAT DAYA, NUSA TENGGARA TIMUR",9,250,4,254
https://kawalpemilu.org#57999,"TANA TEKE, WEWEWA SELATAN, SUMBA BARAT DAYA, NUSA TENGGARA TIMUR",10,193,6,199
https://kawalpemilu.org#57999,"TANA TEKE, WEWEWA SELATAN, SUMBA BARAT DAYA, NUSA TENGGARA TIMUR",11,157,7,164
https://kawalpemilu.org#57999,"TANA TEKE, WEWEWA SELATAN, SUMBA BARAT DAYA, NUSA TENGGARA TIMUR",12,146,0,146
https://kawalpemilu.org#57999,"TANA TEKE, WEWEWA SELATAN, SUMBA BARAT DAYA, NUSA TENGGARA TIMUR",13,173,3,176
https://kawalpemilu.org#58000,"BONDO UKKA, WEWEWA SELATAN, SUMBA BARAT DAYA, NUSA TENGGARA TIMUR",1,223,2,225
https://kawalpemilu.org#58000,"BONDO UKKA, WEWEWA SELATAN, SUMBA BARAT DAYA, NUSA TENGGARA TIMUR",2,220,2,222
https://kawalpemilu.org#58000,"BONDO UKKA, WEWEWA SELATAN, SUMBA BARAT DAYA, NUSA TENGGARA TIMUR",3,234,0,234
https://kawalpemilu.org#90868,"UMBU WANGU, WEWEWA SELATAN, SUMBA BARAT DAYA, NUSA TENGGARA TIMUR",1,275,2,277
https://kawalpemilu.org#90868,"UMBU WANGU, WEWEWA SELATAN, SUMBA BARAT DAYA, NUSA TENGGARA TIMUR",2,181,3,184
https://kawalpemilu.org#90868,"UMBU WANGU, WEWEWA SELATAN, SUMBA BARAT DAYA, NUSA TENGGARA TIMUR",3,216,8,224
https://kawalpemilu.org#90868,"UMBU WANGU, WEWEWA SELATAN, SUMBA BARAT DAYA, NUSA TENGGARA TIMUR",4,221,0,221
https://kawalpemilu.org#90869,"MILLA ATE, WEWEWA SELATAN, SUMBA BARAT DAYA, NUSA TENGGARA TIMUR",1,217,0,217
https://kawalpemilu.org#90869,"MILLA ATE, WEWEWA SELATAN, SUMBA BARAT DAYA, NUSA TENGGARA TIMUR",2,289,0,289
https://kawalpemilu.org#90870,"RITA BARU, WEWEWA SELATAN, SUMBA BARAT DAYA, NUSA TENGGARA TIMUR",1,271,9,280
https://kawalpemilu.org#90870,"RITA BARU, WEWEWA SELATAN, SUMBA BARAT DAYA, NUSA TENGGARA TIMUR",2,253,19,272
https://kawalpemilu.org#90870,"RITA BARU, WEWEWA SELATAN, SUMBA BARAT DAYA, NUSA TENGGARA TIMUR",3,221,24,245
https://kawalpemilu.org#90871,"MANDUNGO, WEWEWA SELATAN, SUMBA BARAT DAYA, NUSA TENGGARA TIMUR",1,130,8,138
https://kawalpemilu.org#90871,"MANDUNGO, WEWEWA SELATAN, SUMBA BARAT DAYA, NUSA TENGGARA TIMUR",2,183,7,190
https://kawalpemilu.org#90871,"MANDUNGO, WEWEWA SELATAN, SUMBA BARAT DAYA, NUSA TENGGARA TIMUR",3,157,2,159
https://kawalpemilu.org#90871,"MANDUNGO, WEWEWA SELATAN, SUMBA BARAT DAYA, NUSA TENGGARA TIMUR",4,172,0,172
https://kawalpemilu.org#930841,"WEE WULLA, WEWEWA SELATAN, SUMBA BARAT DAYA, NUSA TENGGARA TIMUR",1,156,7,163
https://kawalpemilu.org#930841,"WEE WULLA, WEWEWA SELATAN, SUMBA BARAT DAYA, NUSA TENGGARA TIMUR",2,227,2,229
https://kawalpemilu.org#930841,"WEE WULLA, WEWEWA SELATAN, SUMBA BARAT DAYA, NUSA TENGGARA TIMUR",3,246,6,252
https://kawalpemilu.org#930842,"WEE BAGHE, WEWEWA SELATAN, SUMBA BARAT DAYA, NUSA TENGGARA TIMUR",1,278,0,278
https://kawalpemilu.org#930842,"WEE BAGHE, WEWEWA SELATAN, SUMBA BARAT DAYA, NUSA TENGGARA TIMUR",2,189,0,189
https://kawalpemilu.org#930842,"WEE BAGHE, WEWEWA SELATAN, SUMBA BARAT DAYA, NUSA TENGGARA TIMUR",3,221,0,221
https://kawalpemilu.org#930842,"WEE BAGHE, WEWEWA SELATAN, SUMBA BARAT DAYA, NUSA TENGGARA TIMUR",4,225,0,225
https://kawalpemilu.org#58002,"DINJO, KODI BANGEDO, SUMBA BARAT DAYA, NUSA TENGGARA TIMUR",1,167,6,173
https://kawalpemilu.org#58002,"DINJO, KODI BANGEDO, SUMBA BARAT DAYA, NUSA TENGGARA TIMUR",2,138,5,143
https://kawalpemilu.org#58002,"DINJO, KODI BANGEDO, SUMBA BARAT DAYA, NUSA TENGGARA TIMUR",3,122,10,132
https://kawalpemilu.org#58002,"DINJO, KODI BANGEDO, SUMBA BARAT DAYA, NUSA TENGGARA TIMUR",4,161,5,166
https://kawalpemilu.org#58003,"LETE LOKO, KODI BANGEDO, SUMBA BARAT DAYA, NUSA TENGGARA TIMUR",1,189,15,204
https://kawalpemilu.org#58003,"LETE LOKO, KODI BANGEDO, SUMBA BARAT DAYA, NUSA TENGGARA TIMUR",2,152,36,188
https://kawalpemilu.org#58003,"LETE LOKO, KODI BANGEDO, SUMBA BARAT DAYA, NUSA TENGGARA TIMUR",3,149,23,172
https://kawalpemilu.org#58003,"LETE LOKO, KODI BANGEDO, SUMBA BARAT DAYA, NUSA TENGGARA TIMUR",4,181,1,182
https://kawalpemilu.org#58004,"WALLA NDIMU, KODI BANGEDO, SUMBA BARAT DAYA, NUSA TENGGARA TIMUR",1,159,12,171
https://kawalpemilu.org#58004,"WALLA NDIMU, KODI BANGEDO, SUMBA BARAT DAYA, NUSA TENGGARA TIMUR",2,156,11,167
https://kawalpemilu.org#58004,"WALLA NDIMU, KODI BANGEDO, SUMBA BARAT DAYA, NUSA TENGGARA TIMUR",3,210,7,217
https://kawalpemilu.org#58004,"WALLA NDIMU, KODI BANGEDO, SUMBA BARAT DAYA, NUSA TENGGARA TIMUR",4,147,5,152
https://kawalpemilu.org#58007,"WAIKADADA, KODI BANGEDO, SUMBA BARAT DAYA, NUSA TENGGARA TIMUR",1,192,15,207
https://kawalpemilu.org#58007,"WAIKADADA, KODI BANGEDO, SUMBA BARAT DAYA, NUSA TENGGARA TIMUR",2,173,33,206
https://kawalpemilu.org#58007,"WAIKADADA, KODI BANGEDO, SUMBA BARAT DAYA, NUSA TENGGARA TIMUR",3,186,14,200
https://kawalpemilu.org#58011,"RADA LOKO, KODI BANGEDO, SUMBA BARAT DAYA, NUSA TENGGARA TIMUR",1,189,6,195
https://kawalpemilu.org#58011,"RADA LOKO, KODI BANGEDO, SUMBA BARAT DAYA, NUSA TENGGARA TIMUR",2,149,5,154
https://kawalpemilu.org#58011,"RADA LOKO, KODI BANGEDO, SUMBA BARAT DAYA, NUSA TENGGARA TIMUR",3,133,5,138
https://kawalpemilu.org#58011,"RADA LOKO, KODI BANGEDO, SUMBA BARAT DAYA, NUSA TENGGARA TIMUR",4,154,24,178
https://kawalpemilu.org#58012,"MATA KAPORE, KODI BANGEDO, SUMBA BARAT DAYA, NUSA TENGGARA TIMUR",1,258,14,272
https://kawalpemilu.org#58012,"MATA KAPORE, KODI BANGEDO, SUMBA BARAT DAYA, NUSA TENGGARA TIMUR",2,242,16,258
https://kawalpemilu.org#58012,"MATA KAPORE, KODI BANGEDO, SUMBA BARAT DAYA, NUSA TENGGARA TIMUR",3,188,27,215
https://kawalpemilu.org#58012,"MATA KAPORE, KODI BANGEDO, SUMBA BARAT DAYA, NUSA TENGGARA TIMUR",4,208,81,289
https://kawalpemilu.org#58013,"UMBU NGEDO, KODI BANGEDO, SUMBA BARAT DAYA, NUSA TENGGARA TIMUR",1,136,11,147
https://kawalpemilu.org#58013,"UMBU NGEDO, KODI BANGEDO, SUMBA BARAT DAYA, NUSA TENGGARA TIMUR",2,121,9,130
https://kawalpemilu.org#58013,"UMBU NGEDO, KODI BANGEDO, SUMBA BARAT DAYA, NUSA TENGGARA TIMUR",3,133,5,138
https://kawalpemilu.org#58013,"UMBU NGEDO, KODI BANGEDO, SUMBA BARAT DAYA, NUSA TENGGARA TIMUR",4,146,19,165
https://kawalpemilu.org#90873,"WAIMAKAHA, KODI BANGEDO, SUMBA BARAT DAYA, NUSA TENGGARA TIMUR",1,223,17,240
https://kawalpemilu.org#90873,"WAIMAKAHA, KODI BANGEDO, SUMBA BARAT DAYA, NUSA TENGGARA TIMUR",2,283,7,290
https://kawalpemilu.org#90873,"WAIMAKAHA, KODI BANGEDO, SUMBA BARAT DAYA, NUSA TENGGARA TIMUR",3,214,15,229
https://kawalpemilu.org#90883,"ANA GOGKA, KODI BANGEDO, SUMBA BARAT DAYA, NUSA TENGGARA TIMUR",1,197,6,203
https://kawalpemilu.org#90883,"ANA GOGKA, KODI BANGEDO, SUMBA BARAT DAYA, NUSA TENGGARA TIMUR",2,224,6,230
https://kawalpemilu.org#90883,"ANA GOGKA, KODI BANGEDO, SUMBA BARAT DAYA, NUSA TENGGARA TIMUR",3,282,1,283
https://kawalpemilu.org#90884,"WAIKANINYO, KODI BANGEDO, SUMBA BARAT DAYA, NUSA TENGGARA TIMUR",1,150,2,152
https://kawalpemilu.org#90884,"WAIKANINYO, KODI BANGEDO, SUMBA BARAT DAYA, NUSA TENGGARA TIMUR",2,146,4,150
https://kawalpemilu.org#90884,"WAIKANINYO, KODI BANGEDO, SUMBA BARAT DAYA, NUSA TENGGARA TIMUR",3,141,9,150
https://kawalpemilu.org#90885,"WAIPADDI, KODI BANGEDO, SUMBA BARAT DAYA, NUSA TENGGARA TIMUR",1,194,6,200
https://kawalpemilu.org#90885,"WAIPADDI, KODI BANGEDO, SUMBA BARAT DAYA, NUSA TENGGARA TIMUR",2,168,17,185
https://kawalpemilu.org#90885,"WAIPADDI, KODI BANGEDO, SUMBA BARAT DAYA, NUSA TENGGARA TIMUR",3,202,20,222
https://kawalpemilu.org#90886,"DELU DEPA, KODI BANGEDO, SUMBA BARAT DAYA, NUSA TENGGARA TIMUR",1,195,14,209
https://kawalpemilu.org#90886,"DELU DEPA, KODI BANGEDO, SUMBA BARAT DAYA, NUSA TENGGARA TIMUR",2,176,4,180
https://kawalpemilu.org#90887,"MERE KEHE, KODI BANGEDO, SUMBA BARAT DAYA, NUSA TENGGARA TIMUR",1,204,16,220
https://kawalpemilu.org#90887,"MERE KEHE, KODI BANGEDO, SUMBA BARAT DAYA, NUSA TENGGARA TIMUR",2,196,21,217
https://kawalpemilu.org#90887,"MERE KEHE, KODI BANGEDO, SUMBA BARAT DAYA, NUSA TENGGARA TIMUR",3,153,20,173
https://kawalpemilu.org#90887,"MERE KEHE, KODI BANGEDO, SUMBA BARAT DAYA, NUSA TENGGARA TIMUR",4,158,28,186
https://kawalpemilu.org#91308,"WAIMARINGI, KODI BANGEDO, SUMBA BARAT DAYA, NUSA TENGGARA TIMUR",1,165,23,188
https://kawalpemilu.org#91308,"WAIMARINGI, KODI BANGEDO, SUMBA BARAT DAYA, NUSA TENGGARA TIMUR",2,164,19,183
https://kawalpemilu.org#91308,"WAIMARINGI, KODI BANGEDO, SUMBA BARAT DAYA, NUSA TENGGARA TIMUR",3,187,8,195
https://kawalpemilu.org#91332,"TANA METE, KODI BANGEDO, SUMBA BARAT DAYA, NUSA TENGGARA TIMUR",1,219,9,228
https://kawalpemilu.org#91332,"TANA METE, KODI BANGEDO, SUMBA BARAT DAYA, NUSA TENGGARA TIMUR",2,230,18,248
https://kawalpemilu.org#91332,"TANA METE, KODI BANGEDO, SUMBA BARAT DAYA, NUSA TENGGARA TIMUR",3,250,22,278
https://kawalpemilu.org#91332,"TANA METE, KODI BANGEDO, SUMBA BARAT DAYA, NUSA TENGGARA TIMUR",4,215,6,221
https://kawalpemilu.org#91333,"MANU TOGHI, KODI BANGEDO, SUMBA BARAT DAYA, NUSA TENGGARA TIMUR",1,141,9,150
https://kawalpemilu.org#91333,"MANU TOGHI, KODI BANGEDO, SUMBA BARAT DAYA, NUSA TENGGARA TIMUR",2,136,8,144
https://kawalpemilu.org#91333,"MANU TOGHI, KODI BANGEDO, SUMBA BARAT DAYA, NUSA TENGGARA TIMUR",3,111,7,118
https://kawalpemilu.org#91334,"KARANG INDAH, KODI BANGEDO, SUMBA BARAT DAYA, NUSA TENGGARA TIMUR",1,230,7,237
https://kawalpemilu.org#91334,"KARANG INDAH, KODI BANGEDO, SUMBA BARAT DAYA, NUSA TENGGARA TIMUR",2,226,10,236
https://kawalpemilu.org#91335,"RADA MALANDO, KODI BANGEDO, SUMBA BARAT DAYA, NUSA TENGGARA TIMUR",1,228,7,235
https://kawalpemilu.org#91335,"RADA MALANDO, KODI BANGEDO, SUMBA BARAT DAYA, NUSA TENGGARA TIMUR",2,188,8,196
https://kawalpemilu.org#91335,"RADA MALANDO, KODI BANGEDO, SUMBA BARAT DAYA, NUSA TENGGARA TIMUR",3,188,21,209
https://kawalpemilu.org#930843,"BONDO BALLA, KODI BANGEDO, SUMBA BARAT DAYA, NUSA TENGGARA TIMUR",1,140,6,146
https://kawalpemilu.org#930843,"BONDO BALLA, KODI BANGEDO, SUMBA BARAT DAYA, NUSA TENGGARA TIMUR",2,142,3,145
https://kawalpemilu.org#930844,"MALITI BONDO ATE, KODI BANGEDO, SUMBA BARAT DAYA, NUSA TENGGARA TIMUR",1,178,13,191
https://kawalpemilu.org#930844,"MALITI BONDO ATE, KODI BANGEDO, SUMBA BARAT DAYA, NUSA TENGGARA TIMUR",2,181,10,191
https://kawalpemilu.org#930844,"MALITI BONDO ATE, KODI BANGEDO, SUMBA BARAT DAYA, NUSA TENGGARA TIMUR",3,169,6,175
https://kawalpemilu.org#930845,"ANA LEWE, KODI BANGEDO, SUMBA BARAT DAYA, NUSA TENGGARA TIMUR",1,138,9,147
https://kawalpemilu.org#930845,"ANA LEWE, KODI BANGEDO, SUMBA BARAT DAYA, NUSA TENGGARA TIMUR",2,121,9,130
https://kawalpemilu.org#58016,"BONDO KODI, KODI, SUMBA BARAT DAYA, NUSA TENGGARA TIMUR",1,180,7,187
https://kawalpemilu.org#58016,"BONDO KODI, KODI, SUMBA BARAT DAYA, NUSA TENGGARA TIMUR",2,185,6,191
https://kawalpemilu.org#58016,"BONDO KODI, KODI, SUMBA BARAT DAYA, NUSA TENGGARA TIMUR",3,159,11,170
https://kawalpemilu.org#58016,"BONDO KODI, KODI, SUMBA BARAT DAYA, NUSA TENGGARA TIMUR",4,143,10,153
https://kawalpemilu.org#58016,"BONDO KODI, KODI, SUMBA BARAT DAYA, NUSA TENGGARA TIMUR",5,107,6,113
https://kawalpemilu.org#58017,"ATE DALO, KODI, SUMBA BARAT DAYA, NUSA TENGGARA TIMUR",1,181,23,204
https://kawalpemilu.org#58017,"ATE DALO, KODI, SUMBA BARAT DAYA, NUSA TENGGARA TIMUR",2,195,20,215
https://kawalpemilu.org#58017,"ATE DALO, KODI, SUMBA BARAT DAYA, NUSA TENGGARA TIMUR",3,171,29,200
https://kawalpemilu.org#58017,"ATE DALO, KODI, SUMBA BARAT DAYA, NUSA TENGGARA TIMUR",4,121,8,129
https://kawalpemilu.org#58017,"ATE DALO, KODI, SUMBA BARAT DAYA, NUSA TENGGARA TIMUR",5,156,6,162
https://kawalpemilu.org#58017,"ATE DALO, KODI, SUMBA BARAT DAYA, NUSA TENGGARA TIMUR",6,183,12,195
https://kawalpemilu.org#58017,"ATE DALO, KODI, SUMBA BARAT DAYA, NUSA TENGGARA TIMUR",7,190,20,210
https://kawalpemilu.org#58017,"ATE DALO, KODI, SUMBA BARAT DAYA, NUSA TENGGARA TIMUR",8,120,2,122
https://kawalpemilu.org#58018,"HAMONGGO LELE, KODI, SUMBA BARAT DAYA, NUSA TENGGARA TIMUR",1,155,12,167
https://kawalpemilu.org#58018,"HAMONGGO LELE, KODI, SUMBA BARAT DAYA, NUSA TENGGARA TIMUR",2,148,19,167
https://kawalpemilu.org#58018,"HAMONGGO LELE, KODI, SUMBA BARAT DAYA, NUSA TENGGARA TIMUR",3,135,10,145
https://kawalpemilu.org#58018,"HAMONGGO LELE, KODI, SUMBA BARAT DAYA, NUSA TENGGARA TIMUR",4,121,6,127
https://kawalpemilu.org#58019,"HOMBA RANDE, KODI, SUMBA BARAT DAYA, NUSA TENGGARA TIMUR",1,218,18,236
https://kawalpemilu.org#58019,"HOMBA RANDE, KODI, SUMBA BARAT DAYA, NUSA TENGGARA TIMUR",2,153,2,155
https://kawalpemilu.org#58019,"HOMBA RANDE, KODI, SUMBA BARAT DAYA, NUSA TENGGARA TIMUR",3,177,9,186
https://kawalpemilu.org#58019,"HOMBA RANDE, KODI, SUMBA BARAT DAYA, NUSA TENGGARA TIMUR",4,244,7,251
https://kawalpemilu.org#58019,"HOMBA RANDE, KODI, SUMBA BARAT DAYA, NUSA TENGGARA TIMUR",5,155,10,165
https://kawalpemilu.org#58019,"HOMBA RANDE, KODI, SUMBA BARAT DAYA, NUSA TENGGARA TIMUR",6,215,8,223
https://kawalpemilu.org#58019,"HOMBA RANDE, KODI, SUMBA BARAT DAYA, NUSA TENGGARA TIMUR",7,82,3,85
https://kawalpemilu.org#58020,"PERO BATANG, KODI, SUMBA BARAT DAYA, NUSA TENGGARA TIMUR",1,158,12,170
https://kawalpemilu.org#58020,"PERO BATANG, KODI, SUMBA BARAT DAYA, NUSA TENGGARA TIMUR",2,150,17,167
https://kawalpemilu.org#58020,"PERO BATANG, KODI, SUMBA BARAT DAYA, NUSA TENGGARA TIMUR",3,112,4,116
https://kawalpemilu.org#58020,"PERO BATANG, KODI, SUMBA BARAT DAYA, NUSA TENGGARA TIMUR",4,83,4,87
https://kawalpemilu.org#58021,"WURA HOMBA, KODI, SUMBA BARAT DAYA, NUSA TENGGARA TIMUR",1,178,19,197
https://kawalpemilu.org#58021,"WURA HOMBA, KODI, SUMBA BARAT DAYA, NUSA TENGGARA TIMUR",2,126,3,129
https://kawalpemilu.org#58021,"WURA HOMBA, KODI, SUMBA BARAT DAYA, NUSA TENGGARA TIMUR",3,211,4,215
https://kawalpemilu.org#58021,"WURA HOMBA, KODI, SUMBA BARAT DAYA, NUSA TENGGARA TIMUR",4,207,10,217
https://kawalpemilu.org#58021,"WURA HOMBA, KODI, SUMBA BARAT DAYA, NUSA TENGGARA TIMUR",5,279,5,284
https://kawalpemilu.org#58021,"WURA HOMBA, KODI, SUMBA BARAT DAYA, NUSA TENGGARA TIMUR",6,187,18,205
https://kawalpemilu.org#58021,"WURA HOMBA, KODI, SUMBA BARAT DAYA, NUSA TENGGARA TIMUR",7,186,13,199
https://kawalpemilu.org#58022,"KOKI, KODI, SUMBA BARAT DAYA, NUSA TENGGARA TIMUR",1,129,11,140
https://kawalpemilu.org#58022,"KOKI, KODI, SUMBA BARAT DAYA, NUSA TENGGARA TIMUR",2,137,5,142
https://kawalpemilu.org#58022,"KOKI, KODI, SUMBA BARAT DAYA, NUSA TENGGARA TIMUR",3,126,2,128
https://kawalpemilu.org#58022,"KOKI, KODI, SUMBA BARAT DAYA, NUSA TENGGARA TIMUR",4,66,0,66
https://kawalpemilu.org#58023,"KAPAKA MADETA, KODI, SUMBA BARAT DAYA, NUSA TENGGARA TIMUR",1,210,5,215
https://kawalpemilu.org#58023,"KAPAKA MADETA, KODI, SUMBA BARAT DAYA, NUSA TENGGARA TIMUR",2,153,6,159
https://kawalpemilu.org#58023,"KAPAKA MADETA, KODI, SUMBA BARAT DAYA, NUSA TENGGARA TIMUR",3,161,5,166
https://kawalpemilu.org#58023,"KAPAKA MADETA, KODI, SUMBA BARAT DAYA, NUSA TENGGARA TIMUR",4,181,8,189
https://kawalpemilu.org#58023,"KAPAKA MADETA, KODI, SUMBA BARAT DAYA, NUSA TENGGARA TIMUR",5,228,0,228
https://kawalpemilu.org#58023,"KAPAKA MADETA, KODI, SUMBA BARAT DAYA, NUSA TENGGARA TIMUR",6,185,1,186
https://kawalpemilu.org#58023,"KAPAKA MADETA, KODI, SUMBA BARAT DAYA, NUSA TENGGARA TIMUR",7,228,0,228
https://kawalpemilu.org#58024,"KAWANGO HARI, KODI, SUMBA BARAT DAYA, NUSA TENGGARA TIMUR",1,155,4,159
https://kawalpemilu.org#58024,"KAWANGO HARI, KODI, SUMBA BARAT DAYA, NUSA TENGGARA TIMUR",2,165,3,168
https://kawalpemilu.org#58024,"KAWANGO HARI, KODI, SUMBA BARAT DAYA, NUSA TENGGARA TIMUR",3,169,2,171
https://kawalpemilu.org#58024,"KAWANGO HARI, KODI, SUMBA BARAT DAYA, NUSA TENGGARA TIMUR",4,143,5,148
https://kawalpemilu.org#58024,"KAWANGO HARI, KODI, SUMBA BARAT DAYA, NUSA TENGGARA TIMUR",5,136,8,144
https://kawalpemilu.org#58024,"KAWANGO HARI, KODI, SUMBA BARAT DAYA, NUSA TENGGARA TIMUR",6,115,4,119
https://kawalpemilu.org#58025,"ONGGOL, KODI, SUMBA BARAT DAYA, NUSA TENGGARA TIMUR",1,122,17,139
https://kawalpemilu.org#58025,"ONGGOL, KODI, SUMBA BARAT DAYA, NUSA TENGGARA TIMUR",2,128,4,132
https://kawalpemilu.org#58025,"ONGGOL, KODI, SUMBA BARAT DAYA, NUSA TENGGARA TIMUR",3,137,4,141
https://kawalpemilu.org#58025,"ONGGOL, KODI, SUMBA BARAT DAYA, NUSA TENGGARA TIMUR",4,100,7,107
https://kawalpemilu.org#58025,"ONGGOL, KODI, SUMBA BARAT DAYA, NUSA TENGGARA TIMUR",5,129,5,134
https://kawalpemilu.org#58025,"ONGGOL, KODI, SUMBA BARAT DAYA, NUSA TENGGARA TIMUR",6,71,3,74
https://kawalpemilu.org#58025,"ONGGOL, KODI, SUMBA BARAT DAYA, NUSA TENGGARA TIMUR",7,58,2,60
https://kawalpemilu.org#58026,"MALI LHA, KODI, SUMBA BARAT DAYA, NUSA TENGGARA TIMUR",1,117,11,128
https://kawalpemilu.org#58026,"MALI LHA, KODI, SUMBA BARAT DAYA, NUSA TENGGARA TIMUR",2,118,15,133
https://kawalpemilu.org#58026,"MALI LHA, KODI, SUMBA BARAT DAYA, NUSA TENGGARA TIMUR",3,145,8,153
https://kawalpemilu.org#58026,"MALI LHA, KODI, SUMBA BARAT DAYA, NUSA TENGGARA TIMUR",4,123,12,135
https://kawalpemilu.org#58026,"MALI LHA, KODI, SUMBA BARAT DAYA, NUSA TENGGARA TIMUR",5,130,8,138
https://kawalpemilu.org#58026,"MALI LHA, KODI, SUMBA BARAT DAYA, NUSA TENGGARA TIMUR",6,131,5,136
https://kawalpemilu.org#90876,"WATU WONA, KODI, SUMBA BARAT DAYA, NUSA TENGGARA TIMUR",1,119,3,122
https://kawalpemilu.org#90876,"WATU WONA, KODI, SUMBA BARAT DAYA, NUSA TENGGARA TIMUR",2,134,8,142
https://kawalpemilu.org#90876,"WATU WONA, KODI, SUMBA BARAT DAYA, NUSA TENGGARA TIMUR",3,107,7,114
https://kawalpemilu.org#90876,"WATU WONA, KODI, SUMBA BARAT DAYA, NUSA TENGGARA TIMUR",4,126,5,131
https://kawalpemilu.org#90876,"WATU WONA, KODI, SUMBA BARAT DAYA, NUSA TENGGARA TIMUR",5,124,9,133
https://kawalpemilu.org#90876,"WATU WONA, KODI, SUMBA BARAT DAYA, NUSA TENGGARA TIMUR",6,101,5,106
https://kawalpemilu.org#90877,"TANJUNG KAROSO, KODI, SUMBA BARAT DAYA, NUSA TENGGARA TIMUR",1,143,8,151
https://kawalpemilu.org#90877,"TANJUNG KAROSO, KODI, SUMBA BARAT DAYA, NUSA TENGGARA TIMUR",2,198,12,210
https://kawalpemilu.org#90877,"TANJUNG KAROSO, KODI, SUMBA BARAT DAYA, NUSA TENGGARA TIMUR",3,198,10,208
https://kawalpemilu.org#90877,"TANJUNG KAROSO, KODI, SUMBA BARAT DAYA, NUSA TENGGARA TIMUR",4,180,16,196
https://kawalpemilu.org#90877,"TANJUNG KAROSO, KODI, SUMBA BARAT DAYA, NUSA TENGGARA TIMUR",5,172,12,184
https://kawalpemilu.org#90878,"PERO KONDA, KODI, SUMBA BARAT DAYA, NUSA TENGGARA TIMUR",1,66,146,212
https://kawalpemilu.org#90878,"PERO KONDA, KODI, SUMBA BARAT DAYA, NUSA TENGGARA TIMUR",2,48,193,241
https://kawalpemilu.org#90878,"PERO KONDA, KODI, SUMBA BARAT DAYA, NUSA TENGGARA TIMUR",3,44,181,225
https://kawalpemilu.org#930846,"HOMBA RICA, KODI, SUMBA BARAT DAYA, NUSA TENGGARA TIMUR",1,114,2,116
https://kawalpemilu.org#930846,"HOMBA RICA, KODI, SUMBA BARAT DAYA, NUSA TENGGARA TIMUR",2,110,4,114
https://kawalpemilu.org#930846,"HOMBA RICA, KODI, SUMBA BARAT DAYA, NUSA TENGGARA TIMUR",3,114,5,119
https://kawalpemilu.org#930846,"HOMBA RICA, KODI, SUMBA BARAT DAYA, NUSA TENGGARA TIMUR",4,122,4,126
https://kawalpemilu.org#930846,"HOMBA RICA, KODI, SUMBA BARAT DAYA, NUSA TENGGARA TIMUR",5,122,4,126
https://kawalpemilu.org#930847,"ANA KAKA, KODI, SUMBA BARAT DAYA, NUSA TENGGARA TIMUR",1,126,11,137
https://kawalpemilu.org#930847,"ANA KAKA, KODI, SUMBA BARAT DAYA, NUSA TENGGARA TIMUR",2,115,7,122
https://kawalpemilu.org#930848,"OLE ATE, KODI, SUMBA BARAT DAYA, NUSA TENGGARA TIMUR",1,129,2,131
https://kawalpemilu.org#930848,"OLE ATE, KODI, SUMBA BARAT DAYA, NUSA TENGGARA TIMUR",2,177,3,180
https://kawalpemilu.org#930848,"OLE ATE, KODI, SUMBA BARAT DAYA, NUSA TENGGARA TIMUR",3,286,10,296
https://kawalpemilu.org#930848,"OLE ATE, KODI, SUMBA BARAT DAYA, NUSA TENGGARA TIMUR",4,191,4,195
https://kawalpemilu.org#930848,"OLE ATE, KODI, SUMBA BARAT DAYA, NUSA TENGGARA TIMUR",5,172,7,179
https://kawalpemilu.org#930848,"OLE ATE, KODI, SUMBA BARAT DAYA, NUSA TENGGARA TIMUR",6,120,3,123
https://kawalpemilu.org#930849,"KADOKI HORO, KODI, SUMBA BARAT DAYA, NUSA TENGGARA TIMUR",1,141,3,144
https://kawalpemilu.org#930849,"KADOKI HORO, KODI, SUMBA BARAT DAYA, NUSA TENGGARA TIMUR",2,120,2,122
https://kawalpemilu.org#930849,"KADOKI HORO, KODI, SUMBA BARAT DAYA, NUSA TENGGARA TIMUR",3,138,4,142
https://kawalpemilu.org#930849,"KADOKI HORO, KODI, SUMBA BARAT DAYA, NUSA TENGGARA TIMUR",4,79,2,81
https://kawalpemilu.org#930850,"ANA ENGGE, KODI, SUMBA BARAT DAYA, NUSA TENGGARA TIMUR",1,134,20,154
https://kawalpemilu.org#930850,"ANA ENGGE, KODI, SUMBA BARAT DAYA, NUSA TENGGARA TIMUR",2,132,12,144
https://kawalpemilu.org#930850,"ANA ENGGE, KODI, SUMBA BARAT DAYA, NUSA TENGGARA TIMUR",3,156,4,160
https://kawalpemilu.org#930850,"ANA ENGGE, KODI, SUMBA BARAT DAYA, NUSA TENGGARA TIMUR",4,124,5,129
https://kawalpemilu.org#58028,"HOHA WUNGO, KODI UTARA, SUMBA BARAT DAYA, NUSA TENGGARA TIMUR",1,160,13,173
https://kawalpemilu.org#58028,"HOHA WUNGO, KODI UTARA, SUMBA BARAT DAYA, NUSA TENGGARA TIMUR",2,142,14,156
https://kawalpemilu.org#58028,"HOHA WUNGO, KODI UTARA, SUMBA BARAT DAYA, NUSA TENGGARA TIMUR",3,168,7,175
https://kawalpemilu.org#58028,"HOHA WUNGO, KODI UTARA, SUMBA BARAT DAYA, NUSA TENGGARA TIMUR",4,126,13,139
https://kawalpemilu.org#58028,"HOHA WUNGO, KODI UTARA, SUMBA BARAT DAYA, NUSA TENGGARA TIMUR",5,153,2,155
https://kawalpemilu.org#58028,"HOHA WUNGO, KODI UTARA, SUMBA BARAT DAYA, NUSA TENGGARA TIMUR",6,135,10,145
https://kawalpemilu.org#58028,"HOHA WUNGO, KODI UTARA, SUMBA BARAT DAYA, NUSA TENGGARA TIMUR",7,131,7,138
https://kawalpemilu.org#58028,"HOHA WUNGO, KODI UTARA, SUMBA BARAT DAYA, NUSA TENGGARA TIMUR",8,162,7,169
https://kawalpemilu.org#58028,"HOHA WUNGO, KODI UTARA, SUMBA BARAT DAYA, NUSA TENGGARA TIMUR",9,84,5,89
https://kawalpemilu.org#58029,"HOMBA KARIPIT, KODI UTARA, SUMBA BARAT DAYA, NUSA TENGGARA TIMUR",1,232,1,233
https://kawalpemilu.org#58029,"HOMBA KARIPIT, KODI UTARA, SUMBA BARAT DAYA, NUSA TENGGARA TIMUR",2,252,0,252
https://kawalpemilu.org#58029,"HOMBA KARIPIT, KODI UTARA, SUMBA BARAT DAYA, NUSA TENGGARA TIMUR",3,218,3,221
https://kawalpemilu.org#58029,"HOMBA KARIPIT, KODI UTARA, SUMBA BARAT DAYA, NUSA TENGGARA TIMUR",4,182,4,186
https://kawalpemilu.org#58030,"WAILABUBUR, KODI UTARA, SUMBA BARAT DAYA, NUSA TENGGARA TIMUR",1,184,2,186
https://kawalpemilu.org#58030,"WAILABUBUR, KODI UTARA, SUMBA BARAT DAYA, NUSA TENGGARA TIMUR",2,139,13,152
https://kawalpemilu.org#58030,"WAILABUBUR, KODI UTARA, SUMBA BARAT DAYA, NUSA TENGGARA TIMUR",3,157,12,169
https://kawalpemilu.org#58030,"WAILABUBUR, KODI UTARA, SUMBA BARAT DAYA, NUSA TENGGARA TIMUR",4,141,3,144
https://kawalpemilu.org#58031,"KORI, KODI UTARA, SUMBA BARAT DAYA, NUSA TENGGARA TIMUR",1,0,0,0
https://kawalpemilu.org#58031,"KORI, KODI UTARA, SUMBA BARAT DAYA, NUSA TENGGARA TIMUR",2,157,12,169
https://kawalpemilu.org#58031,"KORI, KODI UTARA, SUMBA BARAT DAYA, NUSA TENGGARA TIMUR",3,159,10,169
https://kawalpemilu.org#58031,"KORI, KODI UTARA, SUMBA BARAT DAYA, NUSA TENGGARA TIMUR",4,200,17,217
https://kawalpemilu.org#58031,"KORI, KODI UTARA, SUMBA BARAT DAYA, NUSA TENGGARA TIMUR",5,192,5,197
https://kawalpemilu.org#58031,"KORI, KODI UTARA, SUMBA BARAT DAYA, NUSA TENGGARA TIMUR",6,207,4,211
https://kawalpemilu.org#58031,"KORI, KODI UTARA, SUMBA BARAT DAYA, NUSA TENGGARA TIMUR",7,152,11,163
https://kawalpemilu.org#58031,"KORI, KODI UTARA, SUMBA BARAT DAYA, NUSA TENGGARA TIMUR",8,149,17,166
https://kawalpemilu.org#58031,"KORI, KODI UTARA, SUMBA BARAT DAYA, NUSA TENGGARA TIMUR",9,224,14,238
https://kawalpemilu.org#58031,"KORI, KODI UTARA, SUMBA BARAT DAYA, NUSA TENGGARA TIMUR",10,152,12,164
https://kawalpemilu.org#58031,"KORI, KODI UTARA, SUMBA BARAT DAYA, NUSA TENGGARA TIMUR",11,64,10,74
https://kawalpemilu.org#58031,"KORI, KODI UTARA, SUMBA BARAT DAYA, NUSA TENGGARA TIMUR",12,74,2,76
https://kawalpemilu.org#58032,"KALENA RONGO, KODI UTARA, SUMBA BARAT DAYA, NUSA TENGGARA TIMUR",1,168,6,174
https://kawalpemilu.org#58032,"KALENA RONGO, KODI UTARA, SUMBA BARAT DAYA, NUSA TENGGARA TIMUR",2,177,10,187
https://kawalpemilu.org#58032,"KALENA RONGO, KODI UTARA, SUMBA BARAT DAYA, NUSA TENGGARA TIMUR",3,176,18,194
https://kawalpemilu.org#58032,"KALENA RONGO, KODI UTARA, SUMBA BARAT DAYA, NUSA TENGGARA TIMUR",4,218,5,223
https://kawalpemilu.org#58032,"KALENA RONGO, KODI UTARA, SUMBA BARAT DAYA, NUSA TENGGARA TIMUR",5,181,5,186
https://kawalpemilu.org#58032,"KALENA RONGO, KODI UTARA, SUMBA BARAT DAYA, NUSA TENGGARA TIMUR",6,95,9,104
https://kawalpemilu.org#58032,"KALENA RONGO, KODI UTARA, SUMBA BARAT DAYA, NUSA TENGGARA TIMUR",7,50,4,54
https://kawalpemilu.org#58033,"WAIHOLO, KODI UTARA, SUMBA BARAT DAYA, NUSA TENGGARA TIMUR",1,157,11,168
https://kawalpemilu.org#58033,"WAIHOLO, KODI UTARA, SUMBA BARAT DAYA, NUSA TENGGARA TIMUR",2,202,4,206
https://kawalpemilu.org#58033,"WAIHOLO, KODI UTARA, SUMBA BARAT DAYA, NUSA TENGGARA TIMUR",3,191,1,192
https://kawalpemilu.org#58033,"WAIHOLO, KODI UTARA, SUMBA BARAT DAYA, NUSA TENGGARA TIMUR",4,186,5,191
https://kawalpemilu.org#58033,"WAIHOLO, KODI UTARA, SUMBA BARAT DAYA, NUSA TENGGARA TIMUR",5,163,5,168
https://kawalpemilu.org#58033,"WAIHOLO, KODI UTARA, SUMBA BARAT DAYA, NUSA TENGGARA TIMUR",6,191,4,195
https://kawalpemilu.org#58033,"WAIHOLO, KODI UTARA, SUMBA BARAT DAYA, NUSA TENGGARA TIMUR",7,160,18,178
https://kawalpemilu.org#58033,"WAIHOLO, KODI UTARA, SUMBA BARAT DAYA, NUSA TENGGARA TIMUR",8,67,4,71
https://kawalpemilu.org#58034,"NOHA, KODI UTARA, SUMBA BARAT DAYA, NUSA TENGGARA TIMUR",1,159,4,163
https://kawalpemilu.org#58034,"NOHA, KODI UTARA, SUMBA BARAT DAYA, NUSA TENGGARA TIMUR",2,152,1,153
https://kawalpemilu.org#58034,"NOHA, KODI UTARA, SUMBA BARAT DAYA, NUSA TENGGARA TIMUR",3,168,7,175
https://kawalpemilu.org#58034,"NOHA, KODI UTARA, SUMBA BARAT DAYA, NUSA TENGGARA TIMUR",4,130,2,132
https://kawalpemilu.org#58035,"MANGGANIPI, KODI UTARA, SUMBA BARAT DAYA, NUSA TENGGARA TIMUR",1,223,7,230
https://kawalpemilu.org#58035,"MANGGANIPI, KODI UTARA, SUMBA BARAT DAYA, NUSA TENGGARA TIMUR",2,159,11,170
https://kawalpemilu.org#58035,"MANGGANIPI, KODI UTARA, SUMBA BARAT DAYA, NUSA TENGGARA TIMUR",3,191,9,200
https://kawalpemilu.org#58035,"MANGGANIPI, KODI UTARA, SUMBA BARAT DAYA, NUSA TENGGARA TIMUR",4,145,6,151
https://kawalpemilu.org#58035,"MANGGANIPI, KODI UTARA, SUMBA BARAT DAYA, NUSA TENGGARA TIMUR",5,161,3,164
https://kawalpemilu.org#58035,"MANGGANIPI, KODI UTARA, SUMBA BARAT DAYA, NUSA TENGGARA TIMUR",6,145,9,154
https://kawalpemilu.org#58035,"MANGGANIPI, KODI UTARA, SUMBA BARAT DAYA, NUSA TENGGARA TIMUR",7,186,3,189
https://kawalpemilu.org#58035,"MANGGANIPI, KODI UTARA, SUMBA BARAT DAYA, NUSA TENGGARA TIMUR",8,142,6,148
https://kawalpemilu.org#58036,"KANDU WELA, KODI UTARA, SUMBA BARAT DAYA, NUSA TENGGARA TIMUR",1,201,9,210
https://kawalpemilu.org#58036,"KANDU WELA, KODI UTARA, SUMBA BARAT DAYA, NUSA TENGGARA TIMUR",2,178,7,185
https://kawalpemilu.org#58036,"KANDU WELA, KODI UTARA, SUMBA BARAT DAYA, NUSA TENGGARA TIMUR",3,185,12,197
https://kawalpemilu.org#58036,"KANDU WELA, KODI UTARA, SUMBA BARAT DAYA, NUSA TENGGARA TIMUR",4,244,7,251
https://kawalpemilu.org#58036,"KANDU WELA, KODI UTARA, SUMBA BARAT DAYA, NUSA TENGGARA TIMUR",5,193,9,202
https://kawalpemilu.org#58036,"KANDU WELA, KODI UTARA, SUMBA BARAT DAYA, NUSA TENGGARA TIMUR",6,193,7,200
https://kawalpemilu.org#58036,"KANDU WELA, KODI UTARA, SUMBA BARAT DAYA, NUSA TENGGARA TIMUR",7,131,7,138
https://kawalpemilu.org#58037,"BILA CENGE, KODI UTARA, SUMBA BARAT DAYA, NUSA TENGGARA TIMUR",1,206,6,212
https://kawalpemilu.org#58037,"BILA CENGE, KODI UTARA, SUMBA BARAT DAYA, NUSA TENGGARA TIMUR",2,170,3,173
https://kawalpemilu.org#58037,"BILA CENGE, KODI UTARA, SUMBA BARAT DAYA, NUSA TENGGARA TIMUR",4,195,8,203
https://kawalpemilu.org#58037,"BILA CENGE, KODI UTARA, SUMBA BARAT DAYA, NUSA TENGGARA TIMUR",5,154,4,158
https://kawalpemilu.org#58037,"BILA CENGE, KODI UTARA, SUMBA BARAT DAYA, NUSA TENGGARA TIMUR",6,125,2,127
https://kawalpemilu.org#58038,"BUKAMBERO, KODI UTARA, SUMBA BARAT DAYA, NUSA TENGGARA TIMUR",1,171,9,180
https://kawalpemilu.org#58038,"BUKAMBERO, KODI UTARA, SUMBA BARAT DAYA, NUSA TENGGARA TIMUR",2,161,3,164
https://kawalpemilu.org#58038,"BUKAMBERO, KODI UTARA, SUMBA BARAT DAYA, NUSA TENGGARA TIMUR",3,159,3,162
https://kawalpemilu.org#58038,"BUKAMBERO, KODI UTARA, SUMBA BARAT DAYA, NUSA TENGGARA TIMUR",4,156,7,163
https://kawalpemilu.org#58038,"BUKAMBERO, KODI UTARA, SUMBA BARAT DAYA, NUSA TENGGARA TIMUR",5,123,18,141
https://kawalpemilu.org#58038,"BUKAMBERO, KODI UTARA, SUMBA BARAT DAYA, NUSA TENGGARA TIMUR",6,154,16,170
https://kawalpemilu.org#58038,"BUKAMBERO, KODI UTARA, SUMBA BARAT DAYA, NUSA TENGGARA TIMUR",7,152,3,155
https://kawalpemilu.org#58038,"BUKAMBERO, KODI UTARA, SUMBA BARAT DAYA, NUSA TENGGARA TIMUR",8,119,2,121
https://kawalpemilu.org#90888,"HOMBA PARE, KODI UTARA, SUMBA BARAT DAYA, NUSA TENGGARA TIMUR",1,209,4,213
https://kawalpemilu.org#90888,"HOMBA PARE, KODI UTARA, SUMBA BARAT DAYA, NUSA TENGGARA TIMUR",2,184,20,204
https://kawalpemilu.org#90888,"HOMBA PARE, KODI UTARA, SUMBA BARAT DAYA, NUSA TENGGARA TIMUR",3,157,18,175
https://kawalpemilu.org#90888,"HOMBA PARE, KODI UTARA, SUMBA BARAT DAYA, NUSA TENGGARA TIMUR",4,147,11,158
https://kawalpemilu.org#90888,"HOMBA PARE, KODI UTARA, SUMBA BARAT DAYA, NUSA TENGGARA TIMUR",5,153,11,164
https://kawalpemilu.org#90889,"MAGHO LINYO, KODI UTARA, SUMBA BARAT DAYA, NUSA TENGGARA TIMUR",1,157,6,163
https://kawalpemilu.org#90889,"MAGHO LINYO, KODI UTARA, SUMBA BARAT DAYA, NUSA TENGGARA TIMUR",2,160,4,164
https://kawalpemilu.org#90889,"MAGHO LINYO, KODI UTARA, SUMBA BARAT DAYA, NUSA TENGGARA TIMUR",3,127,6,133
https://kawalpemilu.org#90889,"MAGHO LINYO, KODI UTARA, SUMBA BARAT DAYA, NUSA TENGGARA TIMUR",4,49,4,53
https://kawalpemilu.org#90890,"WEE WELLA, KODI UTARA, SUMBA BARAT DAYA, NUSA TENGGARA TIMUR",1,223,6,229
https://kawalpemilu.org#90890,"WEE WELLA, KODI UTARA, SUMBA BARAT DAYA, NUSA TENGGARA TIMUR",2,206,3,209
https://kawalpemilu.org#90890,"WEE WELLA, KODI UTARA, SUMBA BARAT DAYA, NUSA TENGGARA TIMUR",3,154,4,158
https://kawalpemilu.org#90890,"WEE WELLA, KODI UTARA, SUMBA BARAT DAYA, NUSA TENGGARA TIMUR",4,139,2,141
https://kawalpemilu.org#90890,"WEE WELLA, KODI UTARA, SUMBA BARAT DAYA, NUSA TENGGARA TIMUR",5,128,7,135
https://kawalpemilu.org#90891,"KADU ETA, KODI UTARA, SUMBA BARAT DAYA, NUSA TENGGARA TIMUR",1,183,15,198
https://kawalpemilu.org#90891,"KADU ETA, KODI UTARA, SUMBA BARAT DAYA, NUSA TENGGARA TIMUR",2,187,15,202
https://kawalpemilu.org#90891,"KADU ETA, KODI UTARA, SUMBA BARAT DAYA, NUSA TENGGARA TIMUR",3,174,23,197
https://kawalpemilu.org#90891,"KADU ETA, KODI UTARA, SUMBA BARAT DAYA, NUSA TENGGARA TIMUR",4,172,15,187
https://kawalpemilu.org#90891,"KADU ETA, KODI UTARA, SUMBA BARAT DAYA, NUSA TENGGARA TIMUR",5,168,5,173
https://kawalpemilu.org#90891,"KADU ETA, KODI UTARA, SUMBA BARAT DAYA, NUSA TENGGARA TIMUR",6,143,16,159
https://kawalpemilu.org#90891,"KADU ETA, KODI UTARA, SUMBA BARAT DAYA, NUSA TENGGARA TIMUR",7,154,3,157
https://kawalpemilu.org#90892,"KADAGHU TANA, KODI UTARA, SUMBA BARAT DAYA, NUSA TENGGARA TIMUR",1,163,20,183
https://kawalpemilu.org#90892,"KADAGHU TANA, KODI UTARA, SUMBA BARAT DAYA, NUSA TENGGARA TIMUR",2,241,4,245
https://kawalpemilu.org#90892,"KADAGHU TANA, KODI UTARA, SUMBA BARAT DAYA, NUSA TENGGARA TIMUR",3,180,3,183
https://kawalpemilu.org#90892,"KADAGHU TANA, KODI UTARA, SUMBA BARAT DAYA, NUSA TENGGARA TIMUR",4,167,1,168
https://kawalpemilu.org#90892,"KADAGHU TANA, KODI UTARA, SUMBA BARAT DAYA, NUSA TENGGARA TIMUR",5,216,6,222
https://kawalpemilu.org#90892,"KADAGHU TANA, KODI UTARA, SUMBA BARAT DAYA, NUSA TENGGARA TIMUR",6,220,3,223
https://kawalpemilu.org#90892,"KADAGHU TANA, KODI UTARA, SUMBA BARAT DAYA, NUSA TENGGARA TIMUR",7,158,8,166
https://kawalpemilu.org#90892,"KADAGHU TANA, KODI UTARA, SUMBA BARAT DAYA, NUSA TENGGARA TIMUR",8,231,10,241
https://kawalpemilu.org#90893,"HAMELI ATE, KODI UTARA, SUMBA BARAT DAYA, NUSA TENGGARA TIMUR",1,211,8,219
https://kawalpemilu.org#90893,"HAMELI ATE, KODI UTARA, SUMBA BARAT DAYA, NUSA TENGGARA TIMUR",2,192,19,211
https://kawalpemilu.org#90893,"HAMELI ATE, KODI UTARA, SUMBA BARAT DAYA, NUSA TENGGARA TIMUR",3,166,4,170
https://kawalpemilu.org#90893,"HAMELI ATE, KODI UTARA, SUMBA BARAT DAYA, NUSA TENGGARA TIMUR",4,181,20,201
https://kawalpemilu.org#90893,"HAMELI ATE, KODI UTARA, SUMBA BARAT DAYA, NUSA TENGGARA TIMUR",5,202,5,207
https://kawalpemilu.org#90893,"HAMELI ATE, KODI UTARA, SUMBA BARAT DAYA, NUSA TENGGARA TIMUR",6,200,8,208
https://kawalpemilu.org#90893,"HAMELI ATE, KODI UTARA, SUMBA BARAT DAYA, NUSA TENGGARA TIMUR",7,204,14,218
https://kawalpemilu.org#90893,"HAMELI ATE, KODI UTARA, SUMBA BARAT DAYA, NUSA TENGGARA TIMUR",8,114,7,121
https://kawalpemilu.org#90894,"WAITARU, KODI UTARA, SUMBA BARAT DAYA, NUSA TENGGARA TIMUR",1,238,5,243
https://kawalpemilu.org#90894,"WAITARU, KODI UTARA, SUMBA BARAT DAYA, NUSA TENGGARA TIMUR",2,212,6,218
https://kawalpemilu.org#90894,"WAITARU, KODI UTARA, SUMBA BARAT DAYA, NUSA TENGGARA TIMUR",3,151,8,159
https://kawalpemilu.org#90894,"WAITARU, KODI UTARA, SUMBA BARAT DAYA, NUSA TENGGARA TIMUR",4,193,2,195
https://kawalpemilu.org#90894,"WAITARU, KODI UTARA, SUMBA BARAT DAYA, NUSA TENGGARA TIMUR",5,160,13,173
https://kawalpemilu.org#930851,"NANGGA MUTU, KODI UTARA, SUMBA BARAT DAYA, NUSA TENGGARA TIMUR",1,176,4,180
https://kawalpemilu.org#930851,"NANGGA MUTU, KODI UTARA, SUMBA BARAT DAYA, NUSA TENGGARA TIMUR",2,199,2,201
https://kawalpemilu.org#930851,"NANGGA MUTU, KODI UTARA, SUMBA BARAT DAYA, NUSA TENGGARA TIMUR",3,140,5,145
https://kawalpemilu.org#930851,"NANGGA MUTU, KODI UTARA, SUMBA BARAT DAYA, NUSA TENGGARA TIMUR",4,132,13,145
https://kawalpemilu.org#930852,"LIMBU KEMBE, KODI UTARA, SUMBA BARAT DAYA, NUSA TENGGARA TIMUR",1,272,8,280
https://kawalpemilu.org#930852,"LIMBU KEMBE, KODI UTARA, SUMBA BARAT DAYA, NUSA TENGGARA TIMUR",2,224,2,1
https://kawalpemilu.org#930852,"LIMBU KEMBE, KODI UTARA, SUMBA BARAT DAYA, NUSA TENGGARA TIMUR",3,172,4,176
https://kawalpemilu.org#930852,"LIMBU KEMBE, KODI UTARA, SUMBA BARAT DAYA, NUSA TENGGARA TIMUR",4,90,8,98
https://kawalpemilu.org#930853,"MORO MANDUYO, KODI UTARA, SUMBA BARAT DAYA, NUSA TENGGARA TIMUR",1,197,12,209
https://kawalpemilu.org#930853,"MORO MANDUYO, KODI UTARA, SUMBA BARAT DAYA, NUSA TENGGARA TIMUR",2,175,10,185
https://kawalpemilu.org#930853,"MORO MANDUYO, KODI UTARA, SUMBA BARAT DAYA, NUSA TENGGARA TIMUR",3,174,13,187
https://kawalpemilu.org#930853,"MORO MANDUYO, KODI UTARA, SUMBA BARAT DAYA, NUSA TENGGARA TIMUR",4,156,14,170
https://kawalpemilu.org#930853,"MORO MANDUYO, KODI UTARA, SUMBA BARAT DAYA, NUSA TENGGARA TIMUR",5,160,10,170
https://kawalpemilu.org#57937,"WAITABULA, KOTA TAMBOLAKA, SUMBA BARAT DAYA, NUSA TENGGARA TIMUR",1,186,5,191
https://kawalpemilu.org#57937,"WAITABULA, KOTA TAMBOLAKA, SUMBA BARAT DAYA, NUSA TENGGARA TIMUR",2,189,6,195
https://kawalpemilu.org#57937,"WAITABULA, KOTA TAMBOLAKA, SUMBA BARAT DAYA, NUSA TENGGARA TIMUR",3,200,2,202
https://kawalpemilu.org#57937,"WAITABULA, KOTA TAMBOLAKA, SUMBA BARAT DAYA, NUSA TENGGARA TIMUR",4,202,6,208
https://kawalpemilu.org#57937,"WAITABULA, KOTA TAMBOLAKA, SUMBA BARAT DAYA, NUSA TENGGARA TIMUR",5,215,8,223
https://kawalpemilu.org#57937,"WAITABULA, KOTA TAMBOLAKA, SUMBA BARAT DAYA, NUSA TENGGARA TIMUR",6,163,3,166
https://kawalpemilu.org#57937,"WAITABULA, KOTA TAMBOLAKA, SUMBA BARAT DAYA, NUSA TENGGARA TIMUR",7,192,3,195
https://kawalpemilu.org#57937,"WAITABULA, KOTA TAMBOLAKA, SUMBA BARAT DAYA, NUSA TENGGARA TIMUR",8,212,2,214
https://kawalpemilu.org#57937,"WAITABULA, KOTA TAMBOLAKA, SUMBA BARAT DAYA, NUSA TENGGARA TIMUR",9,290,8,298
https://kawalpemilu.org#57937,"WAITABULA, KOTA TAMBOLAKA, SUMBA BARAT DAYA, NUSA TENGGARA TIMUR",10,127,23,150
https://kawalpemilu.org#57938,"LANGGA LERO, KOTA TAMBOLAKA, SUMBA BARAT DAYA, NUSA TENGGARA TIMUR",1,255,11,266
https://kawalpemilu.org#57938,"LANGGA LERO, KOTA TAMBOLAKA, SUMBA BARAT DAYA, NUSA TENGGARA TIMUR",2,229,10,239
https://kawalpemilu.org#57938,"LANGGA LERO, KOTA TAMBOLAKA, SUMBA BARAT DAYA, NUSA TENGGARA TIMUR",3,254,10,264
https://kawalpemilu.org#57938,"LANGGA LERO, KOTA TAMBOLAKA, SUMBA BARAT DAYA, NUSA TENGGARA TIMUR",4,217,30,247
https://kawalpemilu.org#57938,"LANGGA LERO, KOTA TAMBOLAKA, SUMBA BARAT DAYA, NUSA TENGGARA TIMUR",5,186,31,217
https://kawalpemilu.org#57938,"LANGGA LERO, KOTA TAMBOLAKA, SUMBA BARAT DAYA, NUSA TENGGARA TIMUR",6,140,136,276
https://kawalpemilu.org#57938,"LANGGA LERO, KOTA TAMBOLAKA, SUMBA BARAT DAYA, NUSA TENGGARA TIMUR",7,208,11,219
https://kawalpemilu.org#57938,"LANGGA LERO, KOTA TAMBOLAKA, SUMBA BARAT DAYA, NUSA TENGGARA TIMUR",8,141,58,199
https://kawalpemilu.org#57943,"WEE PANGALI, KOTA TAMBOLAKA, SUMBA BARAT DAYA, NUSA TENGGARA TIMUR",1,176,11,187
https://kawalpemilu.org#57943,"WEE PANGALI, KOTA TAMBOLAKA, SUMBA BARAT DAYA, NUSA TENGGARA TIMUR",2,207,4,211
https://kawalpemilu.org#57943,"WEE PANGALI, KOTA TAMBOLAKA, SUMBA BARAT DAYA, NUSA TENGGARA TIMUR",3,213,9,222
https://kawalpemilu.org#57943,"WEE PANGALI, KOTA TAMBOLAKA, SUMBA BARAT DAYA, NUSA TENGGARA TIMUR",4,210,11,221
https://kawalpemilu.org#57943,"WEE PANGALI, KOTA TAMBOLAKA, SUMBA BARAT DAYA, NUSA TENGGARA TIMUR",5,204,17,221
https://kawalpemilu.org#57943,"WEE PANGALI, KOTA TAMBOLAKA, SUMBA BARAT DAYA, NUSA TENGGARA TIMUR",6,185,7,192
https://kawalpemilu.org#57943,"WEE PANGALI, KOTA TAMBOLAKA, SUMBA BARAT DAYA, NUSA TENGGARA TIMUR",7,205,2,207
https://kawalpemilu.org#57944,"RADA MATA, KOTA TAMBOLAKA, SUMBA BARAT DAYA, NUSA TENGGARA TIMUR",1,182,42,224
https://kawalpemilu.org#57944,"RADA MATA, KOTA TAMBOLAKA, SUMBA BARAT DAYA, NUSA TENGGARA TIMUR",2,174,17,191
https://kawalpemilu.org#57944,"RADA MATA, KOTA TAMBOLAKA, SUMBA BARAT DAYA, NUSA TENGGARA TIMUR",3,234,9,243
https://kawalpemilu.org#57944,"RADA MATA, KOTA TAMBOLAKA, SUMBA BARAT DAYA, NUSA TENGGARA TIMUR",4,184,2,186
https://kawalpemilu.org#57944,"RADA MATA, KOTA TAMBOLAKA, SUMBA BARAT DAYA, NUSA TENGGARA TIMUR",5,161,7,168
https://kawalpemilu.org#57944,"RADA MATA, KOTA TAMBOLAKA, SUMBA BARAT DAYA, NUSA TENGGARA TIMUR",6,209,13,222
https://kawalpemilu.org#57944,"RADA MATA, KOTA TAMBOLAKA, SUMBA BARAT DAYA, NUSA TENGGARA TIMUR",7,179,21,200
https://kawalpemilu.org#57944,"RADA MATA, KOTA TAMBOLAKA, SUMBA BARAT DAYA, NUSA TENGGARA TIMUR",8,127,95,222
https://kawalpemilu.org#57944,"RADA MATA, KOTA TAMBOLAKA, SUMBA BARAT DAYA, NUSA TENGGARA TIMUR",9,94,154,248
https://kawalpemilu.org#57944,"RADA MATA, KOTA TAMBOLAKA, SUMBA BARAT DAYA, NUSA TENGGARA TIMUR",10,63,182,244
https://kawalpemilu.org#57944,"RADA MATA, KOTA TAMBOLAKA, SUMBA BARAT DAYA, NUSA TENGGARA TIMUR",11,100,100,200
https://kawalpemilu.org#57944,"RADA MATA, KOTA TAMBOLAKA, SUMBA BARAT DAYA, NUSA TENGGARA TIMUR",12,129,43,172
https://kawalpemilu.org#57945,"KALENA WANO, KOTA TAMBOLAKA, SUMBA BARAT DAYA, NUSA TENGGARA TIMUR",1,213,5,218
https://kawalpemilu.org#57945,"KALENA WANO, KOTA TAMBOLAKA, SUMBA BARAT DAYA, NUSA TENGGARA TIMUR",2,160,9,169
https://kawalpemilu.org#57945,"KALENA WANO, KOTA TAMBOLAKA, SUMBA BARAT DAYA, NUSA TENGGARA TIMUR",3,198,2,200
https://kawalpemilu.org#57945,"KALENA WANO, KOTA TAMBOLAKA, SUMBA BARAT DAYA, NUSA TENGGARA TIMUR",4,180,2,182
https://kawalpemilu.org#57945,"KALENA WANO, KOTA TAMBOLAKA, SUMBA BARAT DAYA, NUSA TENGGARA TIMUR",5,132,5,137
https://kawalpemilu.org#57946,"WEE LONDA, KOTA TAMBOLAKA, SUMBA BARAT DAYA, NUSA TENGGARA TIMUR",1,172,9,181
https://kawalpemilu.org#57946,"WEE LONDA, KOTA TAMBOLAKA, SUMBA BARAT DAYA, NUSA TENGGARA TIMUR",2,187,4,191
https://kawalpemilu.org#57946,"WEE LONDA, KOTA TAMBOLAKA, SUMBA BARAT DAYA, NUSA TENGGARA TIMUR",3,207,5,212
https://kawalpemilu.org#57946,"WEE LONDA, KOTA TAMBOLAKA, SUMBA BARAT DAYA, NUSA TENGGARA TIMUR",4,184,7,191
https://kawalpemilu.org#57946,"WEE LONDA, KOTA TAMBOLAKA, SUMBA BARAT DAYA, NUSA TENGGARA TIMUR",5,180,5,185
https://kawalpemilu.org#57946,"WEE LONDA, KOTA TAMBOLAKA, SUMBA BARAT DAYA, NUSA TENGGARA TIMUR",6,183,11,194
https://kawalpemilu.org#57946,"WEE LONDA, KOTA TAMBOLAKA, SUMBA BARAT DAYA, NUSA TENGGARA TIMUR",7,184,9,193
https://kawalpemilu.org#57946,"WEE LONDA, KOTA TAMBOLAKA, SUMBA BARAT DAYA, NUSA TENGGARA TIMUR",8,217,5,222
https://kawalpemilu.org#57986,"WATU KAWULA, KOTA TAMBOLAKA, SUMBA BARAT DAYA, NUSA TENGGARA TIMUR",1,181,1,182
https://kawalpemilu.org#57986,"WATU KAWULA, KOTA TAMBOLAKA, SUMBA BARAT DAYA, NUSA TENGGARA TIMUR",2,193,2,195
https://kawalpemilu.org#57986,"WATU KAWULA, KOTA TAMBOLAKA, SUMBA BARAT DAYA, NUSA TENGGARA TIMUR",3,224,4,228
https://kawalpemilu.org#57986,"WATU KAWULA, KOTA TAMBOLAKA, SUMBA BARAT DAYA, NUSA TENGGARA TIMUR",4,218,0,218
https://kawalpemilu.org#57986,"WATU KAWULA, KOTA TAMBOLAKA, SUMBA BARAT DAYA, NUSA TENGGARA TIMUR",5,218,27,245
https://kawalpemilu.org#57986,"WATU KAWULA, KOTA TAMBOLAKA, SUMBA BARAT DAYA, NUSA TENGGARA TIMUR",6,196,13,209
https://kawalpemilu.org#57986,"WATU KAWULA, KOTA TAMBOLAKA, SUMBA BARAT DAYA, NUSA TENGGARA TIMUR",7,242,0,242
https://kawalpemilu.org#57986,"WATU KAWULA, KOTA TAMBOLAKA, SUMBA BARAT DAYA, NUSA TENGGARA TIMUR",8,147,5,152
https://kawalpemilu.org#57986,"WATU KAWULA, KOTA TAMBOLAKA, SUMBA BARAT DAYA, NUSA TENGGARA TIMUR",9,139,6,145
https://kawalpemilu.org#57987,"WEE RENA, KOTA TAMBOLAKA, SUMBA BARAT DAYA, NUSA TENGGARA TIMUR",1,250,7,257
https://kawalpemilu.org#57987,"WEE RENA, KOTA TAMBOLAKA, SUMBA BARAT DAYA, NUSA TENGGARA TIMUR",2,185,3,188
https://kawalpemilu.org#57987,"WEE RENA, KOTA TAMBOLAKA, SUMBA BARAT DAYA, NUSA TENGGARA TIMUR",3,157,1,158
https://kawalpemilu.org#57987,"WEE RENA, KOTA TAMBOLAKA, SUMBA BARAT DAYA, NUSA TENGGARA TIMUR",4,182,1,183
https://kawalpemilu.org#57987,"WEE RENA, KOTA TAMBOLAKA, SUMBA BARAT DAYA, NUSA TENGGARA TIMUR",5,225,2,227
https://kawalpemilu.org#57991,"KADI PADA, KOTA TAMBOLAKA, SUMBA BARAT DAYA, NUSA TENGGARA TIMUR",1,211,3,214
https://kawalpemilu.org#57991,"KADI PADA, KOTA TAMBOLAKA, SUMBA BARAT DAYA, NUSA TENGGARA TIMUR",2,237,5,242
https://kawalpemilu.org#57991,"KADI PADA, KOTA TAMBOLAKA, SUMBA BARAT DAYA, NUSA TENGGARA TIMUR",3,174,4,178
https://kawalpemilu.org#57991,"KADI PADA, KOTA TAMBOLAKA, SUMBA BARAT DAYA, NUSA TENGGARA TIMUR",4,119,4,123
https://kawalpemilu.org#57991,"KADI PADA, KOTA TAMBOLAKA, SUMBA BARAT DAYA, NUSA TENGGARA TIMUR",5,148,5,153
https://kawalpemilu.org#57991,"KADI PADA, KOTA TAMBOLAKA, SUMBA BARAT DAYA, NUSA TENGGARA TIMUR",6,164,4,168
https://kawalpemilu.org#57991,"KADI PADA, KOTA TAMBOLAKA, SUMBA BARAT DAYA, NUSA TENGGARA TIMUR",7,120,2,122
https://kawalpemilu.org#57991,"KADI PADA, KOTA TAMBOLAKA, SUMBA BARAT DAYA, NUSA TENGGARA TIMUR",8,150,2,152
https://kawalpemilu.org#58039,"KALEMBU KAHA, KOTA TAMBOLAKA, SUMBA BARAT DAYA, NUSA TENGGARA TIMUR",1,164,19,183
https://kawalpemilu.org#58039,"KALEMBU KAHA, KOTA TAMBOLAKA, SUMBA BARAT DAYA, NUSA TENGGARA TIMUR",2,134,8,142
https://kawalpemilu.org#58039,"KALEMBU KAHA, KOTA TAMBOLAKA, SUMBA BARAT DAYA, NUSA TENGGARA TIMUR",3,175,7,182
https://kawalpemilu.org#58039,"KALEMBU KAHA, KOTA TAMBOLAKA, SUMBA BARAT DAYA, NUSA TENGGARA TIMUR",4,163,13,176
https://kawalpemilu.org#58039,"KALEMBU KAHA, KOTA TAMBOLAKA, SUMBA BARAT DAYA, NUSA TENGGARA TIMUR",5,144,14,158
https://kawalpemilu.org#58039,"KALEMBU KAHA, KOTA TAMBOLAKA, SUMBA BARAT DAYA, NUSA TENGGARA TIMUR",6,181,16,197
https://kawalpemilu.org#58039,"KALEMBU KAHA, KOTA TAMBOLAKA, SUMBA BARAT DAYA, NUSA TENGGARA TIMUR",7,211,10,221
https://kawalpemilu.org#57959,"LOMBU, WEWEWA TENGAH, SUMBA BARAT DAYA, NUSA TENGGARA TIMUR",1,246,0,246
https://kawalpemilu.org#57959,"LOMBU, WEWEWA TENGAH, SUMBA BARAT DAYA, NUSA TENGGARA TIMUR",2,250,0,250
https://kawalpemilu.org#57959,"LOMBU, WEWEWA TENGAH, SUMBA BARAT DAYA, NUSA TENGGARA TIMUR",4,294,2,296
https://kawalpemilu.org#57959,"LOMBU, WEWEWA TENGAH, SUMBA BARAT DAYA, NUSA TENGGARA TIMUR",5,201,2,203
https://kawalpemilu.org#57959,"LOMBU, WEWEWA TENGAH, SUMBA BARAT DAYA, NUSA TENGGARA TIMUR",6,114,0,114
https://kawalpemilu.org#57959,"LOMBU, WEWEWA TENGAH, SUMBA BARAT DAYA, NUSA TENGGARA TIMUR",7,176,1,177
https://kawalpemilu.org#57959,"LOMBU, WEWEWA TENGAH, SUMBA BARAT DAYA, NUSA TENGGARA TIMUR",8,239,6,245
https://kawalpemilu.org#57959,"LOMBU, WEWEWA TENGAH, SUMBA BARAT DAYA, NUSA TENGGARA TIMUR",9,171,0,171
https://kawalpemilu.org#57959,"LOMBU, WEWEWA TENGAH, SUMBA BARAT DAYA, NUSA TENGGARA TIMUR",10,196,0,196
https://kawalpemilu.org#57959,"LOMBU, WEWEWA TENGAH, SUMBA BARAT DAYA, NUSA TENGGARA TIMUR",11,124,0,124
https://kawalpemilu.org#57960,"KALINGARA, WEWEWA TENGAH, SUMBA BARAT DAYA, NUSA TENGGARA TIMUR",1,269,1,270
https://kawalpemilu.org#57960,"KALINGARA, WEWEWA TENGAH, SUMBA BARAT DAYA, NUSA TENGGARA TIMUR",2,245,0,245
https://kawalpemilu.org#57960,"KALINGARA, WEWEWA TENGAH, SUMBA BARAT DAYA, NUSA TENGGARA TIMUR",3,215,1,216
https://kawalpemilu.org#57960,"KALINGARA, WEWEWA TENGAH, SUMBA BARAT DAYA, NUSA TENGGARA TIMUR",4,298,2,300
https://kawalpemilu.org#57960,"KALINGARA, WEWEWA TENGAH, SUMBA BARAT DAYA, NUSA TENGGARA TIMUR",5,290,2,292
https://kawalpemilu.org#57960,"KALINGARA, WEWEWA TENGAH, SUMBA BARAT DAYA, NUSA TENGGARA TIMUR",6,237,1,238
https://kawalpemilu.org#57960,"KALINGARA, WEWEWA TENGAH, SUMBA BARAT DAYA, NUSA TENGGARA TIMUR",7,99,2,101
https://kawalpemilu.org#57960,"KALINGARA, WEWEWA TENGAH, SUMBA BARAT DAYA, NUSA TENGGARA TIMUR",8,277,20,297
https://kawalpemilu.org#57963,"OMBA RADE, WEWEWA TENGAH, SUMBA BARAT DAYA, NUSA TENGGARA TIMUR",1,243,0,243
https://kawalpemilu.org#57963,"OMBA RADE, WEWEWA TENGAH, SUMBA BARAT DAYA, NUSA TENGGARA TIMUR",2,233,1,234
https://kawalpemilu.org#57963,"OMBA RADE, WEWEWA TENGAH, SUMBA BARAT DAYA, NUSA TENGGARA TIMUR",3,204,2,206
https://kawalpemilu.org#57963,"OMBA RADE, WEWEWA TENGAH, SUMBA BARAT DAYA, NUSA TENGGARA TIMUR",4,195,2,197
https://kawalpemilu.org#57963,"OMBA RADE, WEWEWA TENGAH, SUMBA BARAT DAYA, NUSA TENGGARA TIMUR",5,169,1,170
https://kawalpemilu.org#57963,"OMBA RADE, WEWEWA TENGAH, SUMBA BARAT DAYA, NUSA TENGGARA TIMUR",6,154,4,158
https://kawalpemilu.org#57963,"OMBA RADE, WEWEWA TENGAH, SUMBA BARAT DAYA, NUSA TENGGARA TIMUR",7,291,0,291
https://kawalpemilu.org#57964,"EKA PATA, WEWEWA TENGAH, SUMBA BARAT DAYA, NUSA TENGGARA TIMUR",1,290,0,290
https://kawalpemilu.org#57964,"EKA PATA, WEWEWA TENGAH, SUMBA BARAT DAYA, NUSA TENGGARA TIMUR",2,226,0,226
https://kawalpemilu.org#57964,"EKA PATA, WEWEWA TENGAH, SUMBA BARAT DAYA, NUSA TENGGARA TIMUR",3,0,0,0
https://kawalpemilu.org#57964,"EKA PATA, WEWEWA TENGAH, SUMBA BARAT DAYA, NUSA TENGGARA TIMUR",4,194,0,194
https://kawalpemilu.org#57965,"TANGGABA, WEWEWA TENGAH, SUMBA BARAT DAYA, NUSA TENGGARA TIMUR",1,270,0,270
https://kawalpemilu.org#57965,"TANGGABA, WEWEWA TENGAH, SUMBA BARAT DAYA, NUSA TENGGARA TIMUR",2,230,2,232
https://kawalpemilu.org#57965,"TANGGABA, WEWEWA TENGAH, SUMBA BARAT DAYA, NUSA TENGGARA TIMUR",3,248,5,253
https://kawalpemilu.org#57965,"TANGGABA, WEWEWA TENGAH, SUMBA BARAT DAYA, NUSA TENGGARA TIMUR",4,258,18,276
https://kawalpemilu.org#57965,"TANGGABA, WEWEWA TENGAH, SUMBA BARAT DAYA, NUSA TENGGARA TIMUR",5,135,5,140
https://kawalpemilu.org#57966,"WEE RAME, WEWEWA TENGAH, SUMBA BARAT DAYA, NUSA TENGGARA TIMUR",1,237,14,251
https://kawalpemilu.org#57966,"WEE RAME, WEWEWA TENGAH, SUMBA BARAT DAYA, NUSA TENGGARA TIMUR",2,225,7,232
https://kawalpemilu.org#57966,"WEE RAME, WEWEWA TENGAH, SUMBA BARAT DAYA, NUSA TENGGARA TIMUR",3,220,27,247
https://kawalpemilu.org#57966,"WEE RAME, WEWEWA TENGAH, SUMBA BARAT DAYA, NUSA TENGGARA TIMUR",4,100,9,109
https://kawalpemilu.org#57966,"WEE RAME, WEWEWA TENGAH, SUMBA BARAT DAYA, NUSA TENGGARA TIMUR",5,259,0,259
https://kawalpemilu.org#57966,"WEE RAME, WEWEWA TENGAH, SUMBA BARAT DAYA, NUSA TENGGARA TIMUR",6,173,2,175
https://kawalpemilu.org#57966,"WEE RAME, WEWEWA TENGAH, SUMBA BARAT DAYA, NUSA TENGGARA TIMUR",7,276,5,281
https://kawalpemilu.org#57967,"WEE KOKORA, WEWEWA TENGAH, SUMBA BARAT DAYA, NUSA TENGGARA TIMUR",1,251,2,253
https://kawalpemilu.org#57967,"WEE KOKORA, WEWEWA TENGAH, SUMBA BARAT DAYA, NUSA TENGGARA TIMUR",2,152,7,159
https://kawalpemilu.org#57967,"WEE KOKORA, WEWEWA TENGAH, SUMBA BARAT DAYA, NUSA TENGGARA TIMUR",3,240,2,242
https://kawalpemilu.org#57967,"WEE KOKORA, WEWEWA TENGAH, SUMBA BARAT DAYA, NUSA TENGGARA TIMUR",4,243,0,243
https://kawalpemilu.org#57967,"WEE KOKORA, WEWEWA TENGAH, SUMBA BARAT DAYA, NUSA TENGGARA TIMUR",5,126,16,142
https://kawalpemilu.org#57967,"WEE KOKORA, WEWEWA TENGAH, SUMBA BARAT DAYA, NUSA TENGGARA TIMUR",6,274,14,288
https://kawalpemilu.org#57972,"WEE PATANDO, WEWEWA TENGAH, SUMBA BARAT DAYA, NUSA TENGGARA TIMUR",1,170,5,175
https://kawalpemilu.org#57972,"WEE PATANDO, WEWEWA TENGAH, SUMBA BARAT DAYA, NUSA TENGGARA TIMUR",2,229,2,231
https://kawalpemilu.org#57972,"WEE PATANDO, WEWEWA TENGAH, SUMBA BARAT DAYA, NUSA TENGGARA TIMUR",3,255,2,257
https://kawalpemilu.org#57972,"WEE PATANDO, WEWEWA TENGAH, SUMBA BARAT DAYA, NUSA TENGGARA TIMUR",4,247,3,250
https://kawalpemilu.org#57972,"WEE PATANDO, WEWEWA TENGAH, SUMBA BARAT DAYA, NUSA TENGGARA TIMUR",5,233,2,235
https://kawalpemilu.org#57972,"WEE PATANDO, WEWEWA TENGAH, SUMBA BARAT DAYA, NUSA TENGGARA TIMUR",6,247,0,247
https://kawalpemilu.org#57972,"WEE PATANDO, WEWEWA TENGAH, SUMBA BARAT DAYA, NUSA TENGGARA TIMUR",7,265,2,267
https://kawalpemilu.org#57973,"BOLORA, WEWEWA TENGAH, SUMBA BARAT DAYA, NUSA TENGGARA TIMUR",1,196,1,197
https://kawalpemilu.org#57973,"BOLORA, WEWEWA TENGAH, SUMBA BARAT DAYA, NUSA TENGGARA TIMUR",2,257,0,257
https://kawalpemilu.org#57973,"BOLORA, WEWEWA TENGAH, SUMBA BARAT DAYA, NUSA TENGGARA TIMUR",3,291,0,291
https://kawalpemilu.org#57975,"KANELU, WEWEWA TENGAH, SUMBA BARAT DAYA, NUSA TENGGARA TIMUR",1,187,2,189
https://kawalpemilu.org#57975,"KANELU, WEWEWA TENGAH, SUMBA BARAT DAYA, NUSA TENGGARA TIMUR",2,197,2,199
https://kawalpemilu.org#57975,"KANELU, WEWEWA TENGAH, SUMBA BARAT DAYA, NUSA TENGGARA TIMUR",3,247,0,247
https://kawalpemilu.org#57975,"KANELU, WEWEWA TENGAH, SUMBA BARAT DAYA, NUSA TENGGARA TIMUR",4,94,0,94
https://kawalpemilu.org#930854,"MEREDA WUNI, WEWEWA TENGAH, SUMBA BARAT DAYA, NUSA TENGGARA TIMUR",1,295,0,295
https://kawalpemilu.org#930854,"MEREDA WUNI, WEWEWA TENGAH, SUMBA BARAT DAYA, NUSA TENGGARA TIMUR",2,261,0,261
https://kawalpemilu.org#930854,"MEREDA WUNI, WEWEWA TENGAH, SUMBA BARAT DAYA, NUSA TENGGARA TIMUR",3,217,46,263
https://kawalpemilu.org#930854,"MEREDA WUNI, WEWEWA TENGAH, SUMBA BARAT DAYA, NUSA TENGGARA TIMUR",4,118,0,118
https://kawalpemilu.org#930854,"MEREDA WUNI, WEWEWA TENGAH, SUMBA BARAT DAYA, NUSA TENGGARA TIMUR",5,199,101,300
https://kawalpemilu.org#930855,"MATA WEE KARORO, WEWEWA TENGAH, SUMBA BARAT DAYA, NUSA TENGGARA TIMUR",1,176,20,196
https://kawalpemilu.org#930855,"MATA WEE KARORO, WEWEWA TENGAH, SUMBA BARAT DAYA, NUSA TENGGARA TIMUR",2,131,0,131
https://kawalpemilu.org#930855,"MATA WEE KARORO, WEWEWA TENGAH, SUMBA BARAT DAYA, NUSA TENGGARA TIMUR",3,217,0,217
https://kawalpemilu.org#930855,"MATA WEE KARORO, WEWEWA TENGAH, SUMBA BARAT DAYA, NUSA TENGGARA TIMUR",4,223,5,228
https://kawalpemilu.org#930856,"GOLLU SAPI, WEWEWA TENGAH, SUMBA BARAT DAYA, NUSA TENGGARA TIMUR",1,162,2,164
https://kawalpemilu.org#930856,"GOLLU SAPI, WEWEWA TENGAH, SUMBA BARAT DAYA, NUSA TENGGARA TIMUR",2,168,6,174
https://kawalpemilu.org#930856,"GOLLU SAPI, WEWEWA TENGAH, SUMBA BARAT DAYA, NUSA TENGGARA TIMUR",3,158,1,159
https://kawalpemilu.org#930856,"GOLLU SAPI, WEWEWA TENGAH, SUMBA BARAT DAYA, NUSA TENGGARA TIMUR",4,130,0,130
https://kawalpemilu.org#930856,"GOLLU SAPI, WEWEWA TENGAH, SUMBA BARAT DAYA, NUSA TENGGARA TIMUR",5,220,6,226
https://kawalpemilu.org#930857,"MATA LOMBU, WEWEWA TENGAH, SUMBA BARAT DAYA, NUSA TENGGARA TIMUR",1,292,1,293
https://kawalpemilu.org#930857,"MATA LOMBU, WEWEWA TENGAH, SUMBA BARAT DAYA, NUSA TENGGARA TIMUR",2,191,0,191
https://kawalpemilu.org#930857,"MATA LOMBU, WEWEWA TENGAH, SUMBA BARAT DAYA, NUSA TENGGARA TIMUR",3,250,0,250
https://kawalpemilu.org#930857,"MATA LOMBU, WEWEWA TENGAH, SUMBA BARAT DAYA, NUSA TENGGARA TIMUR",4,284,6,290
https://kawalpemilu.org#930857,"MATA LOMBU, WEWEWA TENGAH, SUMBA BARAT DAYA, NUSA TENGGARA TIMUR",5,291,2,293
https://kawalpemilu.org#930858,"KADI ROMA, WEWEWA TENGAH, SUMBA BARAT DAYA, NUSA TENGGARA TIMUR",1,215,4,219
https://kawalpemilu.org#930858,"KADI ROMA, WEWEWA TENGAH, SUMBA BARAT DAYA, NUSA TENGGARA TIMUR",2,196,4,200
https://kawalpemilu.org#930858,"KADI ROMA, WEWEWA TENGAH, SUMBA BARAT DAYA, NUSA TENGGARA TIMUR",3,173,3,176
https://kawalpemilu.org#930859,"BONDO DELO, WEWEWA TENGAH, SUMBA BARAT DAYA, NUSA TENGGARA TIMUR",1,290,0,290
https://kawalpemilu.org#930859,"BONDO DELO, WEWEWA TENGAH, SUMBA BARAT DAYA, NUSA TENGGARA TIMUR",2,237,6,243
https://kawalpemilu.org#930860,"LETE WUNGANA, WEWEWA TENGAH, SUMBA BARAT DAYA, NUSA TENGGARA TIMUR",1,185,3,188
https://kawalpemilu.org#930860,"LETE WUNGANA, WEWEWA TENGAH, SUMBA BARAT DAYA, NUSA TENGGARA TIMUR",2,224,0,224
https://kawalpemilu.org#930860,"LETE WUNGANA, WEWEWA TENGAH, SUMBA BARAT DAYA, NUSA TENGGARA TIMUR",3,200,2,202
https://kawalpemilu.org#930860,"LETE WUNGANA, WEWEWA TENGAH, SUMBA BARAT DAYA, NUSA TENGGARA TIMUR",4,106,0,106
https://kawalpemilu.org#930861,"LIMBU WATU, WEWEWA TENGAH, SUMBA BARAT DAYA, NUSA TENGGARA TIMUR",1,133,4,137
https://kawalpemilu.org#930861,"LIMBU WATU, WEWEWA TENGAH, SUMBA BARAT DAYA, NUSA TENGGARA TIMUR",2,157,6,163
https://kawalpemilu.org#930861,"LIMBU WATU, WEWEWA TENGAH, SUMBA BARAT DAYA, NUSA TENGGARA TIMUR",3,129,3,132
https://kawalpemilu.org#930861,"LIMBU WATU, WEWEWA TENGAH, SUMBA BARAT DAYA, NUSA TENGGARA TIMUR",4,89,5,94
https://kawalpemilu.org#930862,"KIKU BOKO, WEWEWA TENGAH, SUMBA BARAT DAYA, NUSA TENGGARA TIMUR",1,150,2,152
https://kawalpemilu.org#930862,"KIKU BOKO, WEWEWA TENGAH, SUMBA BARAT DAYA, NUSA TENGGARA TIMUR",2,147,1,148
https://kawalpemilu.org#930863,"TARRA MATA, WEWEWA TENGAH, SUMBA BARAT DAYA, NUSA TENGGARA TIMUR",1,252,0,252
https://kawalpemilu.org#930863,"TARRA MATA, WEWEWA TENGAH, SUMBA BARAT DAYA, NUSA TENGGARA TIMUR",2,145,2,147
https://kawalpemilu.org#930863,"TARRA MATA, WEWEWA TENGAH, SUMBA BARAT DAYA, NUSA TENGGARA TIMUR",3,254,5,259
https://kawalpemilu.org#930863,"TARRA MATA, WEWEWA TENGAH, SUMBA BARAT DAYA, NUSA TENGGARA TIMUR",4,196,3,199
https://kawalpemilu.org#58005,"WAIHA, KODI BALAGHAR, SUMBA BARAT DAYA, NUSA TENGGARA TIMUR",1,277,8,285
https://kawalpemilu.org#58005,"WAIHA, KODI BALAGHAR, SUMBA BARAT DAYA, NUSA TENGGARA TIMUR",2,174,33,207
https://kawalpemilu.org#58005,"WAIHA, KODI BALAGHAR, SUMBA BARAT DAYA, NUSA TENGGARA TIMUR",3,190,3,193
https://kawalpemilu.org#58005,"WAIHA, KODI BALAGHAR, SUMBA BARAT DAYA, NUSA TENGGARA TIMUR",4,206,3,209
https://kawalpemilu.org#58005,"WAIHA, KODI BALAGHAR, SUMBA BARAT DAYA, NUSA TENGGARA TIMUR",5,271,9,280
https://kawalpemilu.org#58006,"PANENGGO EDE, KODI BALAGHAR, SUMBA BARAT DAYA, NUSA TENGGARA TIMUR",1,183,6,189
https://kawalpemilu.org#58006,"PANENGGO EDE, KODI BALAGHAR, SUMBA BARAT DAYA, NUSA TENGGARA TIMUR",2,180,8,188
https://kawalpemilu.org#58006,"PANENGGO EDE, KODI BALAGHAR, SUMBA BARAT DAYA, NUSA TENGGARA TIMUR",3,160,11,171
https://kawalpemilu.org#58008,"WAIKARARA, KODI BALAGHAR, SUMBA BARAT DAYA, NUSA TENGGARA TIMUR",1,178,10,188
https://kawalpemilu.org#58008,"WAIKARARA, KODI BALAGHAR, SUMBA BARAT DAYA, NUSA TENGGARA TIMUR",2,199,8,207
https://kawalpemilu.org#58008,"WAIKARARA, KODI BALAGHAR, SUMBA BARAT DAYA, NUSA TENGGARA TIMUR",3,233,14,247
https://kawalpemilu.org#58008,"WAIKARARA, KODI BALAGHAR, SUMBA BARAT DAYA, NUSA TENGGARA TIMUR",4,258,17,275
https://kawalpemilu.org#58008,"WAIKARARA, KODI BALAGHAR, SUMBA BARAT DAYA, NUSA TENGGARA TIMUR",5,209,16,225
https://kawalpemilu.org#58009,"WAILANGIRA, KODI BALAGHAR, SUMBA BARAT DAYA, NUSA TENGGARA TIMUR",1,194,8,202
https://kawalpemilu.org#58009,"WAILANGIRA, KODI BALAGHAR, SUMBA BARAT DAYA, NUSA TENGGARA TIMUR",2,240,4,244
https://kawalpemilu.org#58009,"WAILANGIRA, KODI BALAGHAR, SUMBA BARAT DAYA, NUSA TENGGARA TIMUR",3,244,3,247
https://kawalpemilu.org#58009,"WAILANGIRA, KODI BALAGHAR, SUMBA BARAT DAYA, NUSA TENGGARA TIMUR",4,201,4,205
https://kawalpemilu.org#58010,"KAHALE, KODI BALAGHAR, SUMBA BARAT DAYA, NUSA TENGGARA TIMUR",1,282,8,290
https://kawalpemilu.org#58010,"KAHALE, KODI BALAGHAR, SUMBA BARAT DAYA, NUSA TENGGARA TIMUR",2,253,40,293
https://kawalpemilu.org#58010,"KAHALE, KODI BALAGHAR, SUMBA BARAT DAYA, NUSA TENGGARA TIMUR",3,297,1,298
https://kawalpemilu.org#58010,"KAHALE, KODI BALAGHAR, SUMBA BARAT DAYA, NUSA TENGGARA TIMUR",4,257,11,268
https://kawalpemilu.org#58014,"WAINYAPU, KODI BALAGHAR, SUMBA BARAT DAYA, NUSA TENGGARA TIMUR",1,210,3,213
https://kawalpemilu.org#58014,"WAINYAPU, KODI BALAGHAR, SUMBA BARAT DAYA, NUSA TENGGARA TIMUR",2,222,7,229
https://kawalpemilu.org#58014,"WAINYAPU, KODI BALAGHAR, SUMBA BARAT DAYA, NUSA TENGGARA TIMUR",3,243,0,243
https://kawalpemilu.org#58014,"WAINYAPU, KODI BALAGHAR, SUMBA BARAT DAYA, NUSA TENGGARA TIMUR",4,210,5,215
https://kawalpemilu.org#58014,"WAINYAPU, KODI BALAGHAR, SUMBA BARAT DAYA, NUSA TENGGARA TIMUR",5,244,1,245
https://kawalpemilu.org#930864,"LOKO TALI, KODI BALAGHAR, SUMBA BARAT DAYA, NUSA TENGGARA TIMUR",1,152,7,159
https://kawalpemilu.org#930864,"LOKO TALI, KODI BALAGHAR, SUMBA BARAT DAYA, NUSA TENGGARA TIMUR",2,181,3,184
https://kawalpemilu.org#930864,"LOKO TALI, KODI BALAGHAR, SUMBA BARAT DAYA, NUSA TENGGARA TIMUR",3,143,4,147
https://kawalpemilu.org#930865,"WAIPAKOLO, KODI BALAGHAR, SUMBA BARAT DAYA, NUSA TENGGARA TIMUR",1,206,9,215
https://kawalpemilu.org#930865,"WAIPAKOLO, KODI BALAGHAR, SUMBA BARAT DAYA, NUSA TENGGARA TIMUR",2,173,2,175
https://kawalpemilu.org#58042,"NAMOSAIN, ALAK, KOTA KUPANG, NUSA TENGGARA TIMUR",1,141,7,148
https://kawalpemilu.org#58042,"NAMOSAIN, ALAK, KOTA KUPANG, NUSA TENGGARA TIMUR",2,149,12,161
https://kawalpemilu.org#58042,"NAMOSAIN, ALAK, KOTA KUPANG, NUSA TENGGARA TIMUR",3,137,87,224
https://kawalpemilu.org#58042,"NAMOSAIN, ALAK, KOTA KUPANG, NUSA TENGGARA TIMUR",4,130,33,163
https://kawalpemilu.org#58042,"NAMOSAIN, ALAK, KOTA KUPANG, NUSA TENGGARA TIMUR",5,139,18,157
https://kawalpemilu.org#58042,"NAMOSAIN, ALAK, KOTA KUPANG, NUSA TENGGARA TIMUR",6,180,5,185
https://kawalpemilu.org#58042,"NAMOSAIN, ALAK, KOTA KUPANG, NUSA TENGGARA TIMUR",7,177,19,196
https://kawalpemilu.org#58042,"NAMOSAIN, ALAK, KOTA KUPANG, NUSA TENGGARA TIMUR",8,164,7,171
https://kawalpemilu.org#58042,"NAMOSAIN, ALAK, KOTA KUPANG, NUSA TENGGARA TIMUR",9,144,27,171
https://kawalpemilu.org#58042,"NAMOSAIN, ALAK, KOTA KUPANG, NUSA TENGGARA TIMUR",10,154,20,174
https://kawalpemilu.org#58042,"NAMOSAIN, ALAK, KOTA KUPANG, NUSA TENGGARA TIMUR",11,83,22,105
https://kawalpemilu.org#58042,"NAMOSAIN, ALAK, KOTA KUPANG, NUSA TENGGARA TIMUR",12,160,26,186
https://kawalpemilu.org#58042,"NAMOSAIN, ALAK, KOTA KUPANG, NUSA TENGGARA TIMUR",13,172,19,191
https://kawalpemilu.org#58042,"NAMOSAIN, ALAK, KOTA KUPANG, NUSA TENGGARA TIMUR",14,123,93,216
https://kawalpemilu.org#58042,"NAMOSAIN, ALAK, KOTA KUPANG, NUSA TENGGARA TIMUR",15,76,146,222
https://kawalpemilu.org#58042,"NAMOSAIN, ALAK, KOTA KUPANG, NUSA TENGGARA TIMUR",16,67,74,141
https://kawalpemilu.org#58042,"NAMOSAIN, ALAK, KOTA KUPANG, NUSA TENGGARA TIMUR",17,59,38,97
https://kawalpemilu.org#58042,"NAMOSAIN, ALAK, KOTA KUPANG, NUSA TENGGARA TIMUR",18,189,30,219
https://kawalpemilu.org#58042,"NAMOSAIN, ALAK, KOTA KUPANG, NUSA TENGGARA TIMUR",19,200,25,225
https://kawalpemilu.org#58042,"NAMOSAIN, ALAK, KOTA KUPANG, NUSA TENGGARA TIMUR",20,67,124,191
https://kawalpemilu.org#58042,"NAMOSAIN, ALAK, KOTA KUPANG, NUSA TENGGARA TIMUR",21,73,137,210
https://kawalpemilu.org#58042,"NAMOSAIN, ALAK, KOTA KUPANG, NUSA TENGGARA TIMUR",22,28,142,170
https://kawalpemilu.org#58042,"NAMOSAIN, ALAK, KOTA KUPANG, NUSA TENGGARA TIMUR",23,29,222,251
https://kawalpemilu.org#58042,"NAMOSAIN, ALAK, KOTA KUPANG, NUSA TENGGARA TIMUR",24,46,183,229
https://kawalpemilu.org#58042,"NAMOSAIN, ALAK, KOTA KUPANG, NUSA TENGGARA TIMUR",25,129,54,183
https://kawalpemilu.org#58042,"NAMOSAIN, ALAK, KOTA KUPANG, NUSA TENGGARA TIMUR",26,84,77,161
https://kawalpemilu.org#58042,"NAMOSAIN, ALAK, KOTA KUPANG, NUSA TENGGARA TIMUR",27,114,38,152
https://kawalpemilu.org#58042,"NAMOSAIN, ALAK, KOTA KUPANG, NUSA TENGGARA TIMUR",28,96,30,126
https://kawalpemilu.org#58042,"NAMOSAIN, ALAK, KOTA KUPANG, NUSA TENGGARA TIMUR",29,183,26,209
https://kawalpemilu.org#58042,"NAMOSAIN, ALAK, KOTA KUPANG, NUSA TENGGARA TIMUR",30,172,15,187
https://kawalpemilu.org#58042,"NAMOSAIN, ALAK, KOTA KUPANG, NUSA TENGGARA TIMUR",31,174,1,175
https://kawalpemilu.org#58042,"NAMOSAIN, ALAK, KOTA KUPANG, NUSA TENGGARA TIMUR",32,179,19,198
https://kawalpemilu.org#58042,"NAMOSAIN, ALAK, KOTA KUPANG, NUSA TENGGARA TIMUR",33,157,25,182
https://kawalpemilu.org#58043,"NUNBAUN SABU, ALAK, KOTA KUPANG, NUSA TENGGARA TIMUR",1,84,4,88
https://kawalpemilu.org#58043,"NUNBAUN SABU, ALAK, KOTA KUPANG, NUSA TENGGARA TIMUR",2,140,10,150
https://kawalpemilu.org#58043,"NUNBAUN SABU, ALAK, KOTA KUPANG, NUSA TENGGARA TIMUR",3,100,69,169
https://kawalpemilu.org#58043,"NUNBAUN SABU, ALAK, KOTA KUPANG, NUSA TENGGARA TIMUR",4,103,3,106
https://kawalpemilu.org#58043,"NUNBAUN SABU, ALAK, KOTA KUPANG, NUSA TENGGARA TIMUR",5,101,2,103
https://kawalpemilu.org#58043,"NUNBAUN SABU, ALAK, KOTA KUPANG, NUSA TENGGARA TIMUR",6,230,5,235
https://kawalpemilu.org#58043,"NUNBAUN SABU, ALAK, KOTA KUPANG, NUSA TENGGARA TIMUR",7,142,7,149
https://kawalpemilu.org#58043,"NUNBAUN SABU, ALAK, KOTA KUPANG, NUSA TENGGARA TIMUR",8,123,4,127
https://kawalpemilu.org#58043,"NUNBAUN SABU, ALAK, KOTA KUPANG, NUSA TENGGARA TIMUR",9,128,32,160
https://kawalpemilu.org#58043,"NUNBAUN SABU, ALAK, KOTA KUPANG, NUSA TENGGARA TIMUR",10,113,24,137
https://kawalpemilu.org#58043,"NUNBAUN SABU, ALAK, KOTA KUPANG, NUSA TENGGARA TIMUR",11,186,26,212
https://kawalpemilu.org#58043,"NUNBAUN SABU, ALAK, KOTA KUPANG, NUSA TENGGARA TIMUR",12,180,49,229
https://kawalpemilu.org#58043,"NUNBAUN SABU, ALAK, KOTA KUPANG, NUSA TENGGARA TIMUR",13,166,74,240
https://kawalpemilu.org#58043,"NUNBAUN SABU, ALAK, KOTA KUPANG, NUSA TENGGARA TIMUR",14,146,7,153
https://kawalpemilu.org#58043,"NUNBAUN SABU, ALAK, KOTA KUPANG, NUSA TENGGARA TIMUR",15,62,37,99
https://kawalpemilu.org#58044,"NUNBAUN DELHA, ALAK, KOTA KUPANG, NUSA TENGGARA TIMUR",1,153,21,174
https://kawalpemilu.org#58044,"NUNBAUN DELHA, ALAK, KOTA KUPANG, NUSA TENGGARA TIMUR",2,172,3,175
https://kawalpemilu.org#58044,"NUNBAUN DELHA, ALAK, KOTA KUPANG, NUSA TENGGARA TIMUR",3,151,4,155
https://kawalpemilu.org#58044,"NUNBAUN DELHA, ALAK, KOTA KUPANG, NUSA TENGGARA TIMUR",4,159,9,168
https://kawalpemilu.org#58044,"NUNBAUN DELHA, ALAK, KOTA KUPANG, NUSA TENGGARA TIMUR",5,182,4,186
https://kawalpemilu.org#58044,"NUNBAUN DELHA, ALAK, KOTA KUPANG, NUSA TENGGARA TIMUR",6,144,14,158
https://kawalpemilu.org#58044,"NUNBAUN DELHA, ALAK, KOTA KUPANG, NUSA TENGGARA TIMUR",7,163,3,166
https://kawalpemilu.org#58044,"NUNBAUN DELHA, ALAK, KOTA KUPANG, NUSA TENGGARA TIMUR",8,147,9,156
https://kawalpemilu.org#58044,"NUNBAUN DELHA, ALAK, KOTA KUPANG, NUSA TENGGARA TIMUR",9,172,8,180
https://kawalpemilu.org#58044,"NUNBAUN DELHA, ALAK, KOTA KUPANG, NUSA TENGGARA TIMUR",10,207,10,217
https://kawalpemilu.org#58044,"NUNBAUN DELHA, ALAK, KOTA KUPANG, NUSA TENGGARA TIMUR",11,153,6,159
https://kawalpemilu.org#58044,"NUNBAUN DELHA, ALAK, KOTA KUPANG, NUSA TENGGARA TIMUR",12,154,5,159
https://kawalpemilu.org#58044,"NUNBAUN DELHA, ALAK, KOTA KUPANG, NUSA TENGGARA TIMUR",13,137,7,144
https://kawalpemilu.org#58044,"NUNBAUN DELHA, ALAK, KOTA KUPANG, NUSA TENGGARA TIMUR",14,131,9,140
https://kawalpemilu.org#58045,"NUNHILA, ALAK, KOTA KUPANG, NUSA TENGGARA TIMUR",1,183,9,192
https://kawalpemilu.org#58045,"NUNHILA, ALAK, KOTA KUPANG, NUSA TENGGARA TIMUR",2,134,4,138
https://kawalpemilu.org#58045,"NUNHILA, ALAK, KOTA KUPANG, NUSA TENGGARA TIMUR",3,149,7,156
https://kawalpemilu.org#58045,"NUNHILA, ALAK, KOTA KUPANG, NUSA TENGGARA TIMUR",4,107,3,110
https://kawalpemilu.org#58045,"NUNHILA, ALAK, KOTA KUPANG, NUSA TENGGARA TIMUR",5,213,8,221
https://kawalpemilu.org#58045,"NUNHILA, ALAK, KOTA KUPANG, NUSA TENGGARA TIMUR",6,152,8,160
https://kawalpemilu.org#58045,"NUNHILA, ALAK, KOTA KUPANG, NUSA TENGGARA TIMUR",7,114,9,123
https://kawalpemilu.org#58045,"NUNHILA, ALAK, KOTA KUPANG, NUSA TENGGARA TIMUR",8,108,6,114
https://kawalpemilu.org#58045,"NUNHILA, ALAK, KOTA KUPANG, NUSA TENGGARA TIMUR",9,185,14,199
https://kawalpemilu.org#58045,"NUNHILA, ALAK, KOTA KUPANG, NUSA TENGGARA TIMUR",10,100,5,105
https://kawalpemilu.org#58045,"NUNHILA, ALAK, KOTA KUPANG, NUSA TENGGARA TIMUR",11,201,3,204
https://kawalpemilu.org#58046,"FATUFETO, ALAK, KOTA KUPANG, NUSA TENGGARA TIMUR",1,122,18,140
https://kawalpemilu.org#58046,"FATUFETO, ALAK, KOTA KUPANG, NUSA TENGGARA TIMUR",2,92,39,131
https://kawalpemilu.org#58046,"FATUFETO, ALAK, KOTA KUPANG, NUSA TENGGARA TIMUR",3,42,60,102
https://kawalpemilu.org#58046,"FATUFETO, ALAK, KOTA KUPANG, NUSA TENGGARA TIMUR",4,156,26,182
https://kawalpemilu.org#58046,"FATUFETO, ALAK, KOTA KUPANG, NUSA TENGGARA TIMUR",5,145,9,154
https://kawalpemilu.org#58046,"FATUFETO, ALAK, KOTA KUPANG, NUSA TENGGARA TIMUR",6,144,19,163
https://kawalpemilu.org#58046,"FATUFETO, ALAK, KOTA KUPANG, NUSA TENGGARA TIMUR",7,159,2,161
https://kawalpemilu.org#58046,"FATUFETO, ALAK, KOTA KUPANG, NUSA TENGGARA TIMUR",8,155,10,165
https://kawalpemilu.org#58046,"FATUFETO, ALAK, KOTA KUPANG, NUSA TENGGARA TIMUR",9,177,6,183
https://kawalpemilu.org#58046,"FATUFETO, ALAK, KOTA KUPANG, NUSA TENGGARA TIMUR",10,185,1,186
https://kawalpemilu.org#58046,"FATUFETO, ALAK, KOTA KUPANG, NUSA TENGGARA TIMUR",11,146,10,156
https://kawalpemilu.org#58046,"FATUFETO, ALAK, KOTA KUPANG, NUSA TENGGARA TIMUR",12,150,7,157
https://kawalpemilu.org#58046,"FATUFETO, ALAK, KOTA KUPANG, NUSA TENGGARA TIMUR",13,215,10,225
https://kawalpemilu.org#58046,"FATUFETO, ALAK, KOTA KUPANG, NUSA TENGGARA TIMUR",14,157,1,158
https://kawalpemilu.org#58046,"FATUFETO, ALAK, KOTA KUPANG, NUSA TENGGARA TIMUR",15,153,7,160
https://kawalpemilu.org#58046,"FATUFETO, ALAK, KOTA KUPANG, NUSA TENGGARA TIMUR",16,145,5,150
https://kawalpemilu.org#58046,"FATUFETO, ALAK, KOTA KUPANG, NUSA TENGGARA TIMUR",17,150,13,163
https://kawalpemilu.org#58047,"MANUTAPEN, ALAK, KOTA KUPANG, NUSA TENGGARA TIMUR",1,181,9,190
https://kawalpemilu.org#58047,"MANUTAPEN, ALAK, KOTA KUPANG, NUSA TENGGARA TIMUR",2,160,13,173
https://kawalpemilu.org#58047,"MANUTAPEN, ALAK, KOTA KUPANG, NUSA TENGGARA TIMUR",3,187,6,193
https://kawalpemilu.org#58047,"MANUTAPEN, ALAK, KOTA KUPANG, NUSA TENGGARA TIMUR",4,162,5,167
https://kawalpemilu.org#58047,"MANUTAPEN, ALAK, KOTA KUPANG, NUSA TENGGARA TIMUR",5,168,10,178
https://kawalpemilu.org#58047,"MANUTAPEN, ALAK, KOTA KUPANG, NUSA TENGGARA TIMUR",6,245,9,254
https://kawalpemilu.org#58047,"MANUTAPEN, ALAK, KOTA KUPANG, NUSA TENGGARA TIMUR",8,175,6,181
https://kawalpemilu.org#58047,"MANUTAPEN, ALAK, KOTA KUPANG, NUSA TENGGARA TIMUR",9,182,11,193
https://kawalpemilu.org#58047,"MANUTAPEN, ALAK, KOTA KUPANG, NUSA TENGGARA TIMUR",10,140,7,147
https://kawalpemilu.org#58047,"MANUTAPEN, ALAK, KOTA KUPANG, NUSA TENGGARA TIMUR",11,115,7,122
https://kawalpemilu.org#58047,"MANUTAPEN, ALAK, KOTA KUPANG, NUSA TENGGARA TIMUR",12,179,7,186
https://kawalpemilu.org#58047,"MANUTAPEN, ALAK, KOTA KUPANG, NUSA TENGGARA TIMUR",13,170,10,180
https://kawalpemilu.org#58047,"MANUTAPEN, ALAK, KOTA KUPANG, NUSA TENGGARA TIMUR",14,178,7,185
https://kawalpemilu.org#58047,"MANUTAPEN, ALAK, KOTA KUPANG, NUSA TENGGARA TIMUR",15,186,6,192
https://kawalpemilu.org#58047,"MANUTAPEN, ALAK, KOTA KUPANG, NUSA TENGGARA TIMUR",16,166,9,175
https://kawalpemilu.org#58047,"MANUTAPEN, ALAK, KOTA KUPANG, NUSA TENGGARA TIMUR",17,193,9,202
https://kawalpemilu.org#58047,"MANUTAPEN, ALAK, KOTA KUPANG, NUSA TENGGARA TIMUR",18,162,10,172
https://kawalpemilu.org#58047,"MANUTAPEN, ALAK, KOTA KUPANG, NUSA TENGGARA TIMUR",19,180,14,194
https://kawalpemilu.org#58047,"MANUTAPEN, ALAK, KOTA KUPANG, NUSA TENGGARA TIMUR",20,178,6,184
https://kawalpemilu.org#58047,"MANUTAPEN, ALAK, KOTA KUPANG, NUSA TENGGARA TIMUR",21,162,17,179
https://kawalpemilu.org#58047,"MANUTAPEN, ALAK, KOTA KUPANG, NUSA TENGGARA TIMUR",22,150,26,176
https://kawalpemilu.org#58047,"MANUTAPEN, ALAK, KOTA KUPANG, NUSA TENGGARA TIMUR",23,153,31,184
https://kawalpemilu.org#58048,"MANTASI, ALAK, KOTA KUPANG, NUSA TENGGARA TIMUR",1,95,10,105
https://kawalpemilu.org#58048,"MANTASI, ALAK, KOTA KUPANG, NUSA TENGGARA TIMUR",2,117,24,141
https://kawalpemilu.org#58048,"MANTASI, ALAK, KOTA KUPANG, NUSA TENGGARA TIMUR",3,83,54,137
https://kawalpemilu.org#58048,"MANTASI, ALAK, KOTA KUPANG, NUSA TENGGARA TIMUR",4,153,15,168
https://kawalpemilu.org#58049,"ALAK, ALAK, KOTA KUPANG, NUSA TENGGARA TIMUR",1,170,11,181
https://kawalpemilu.org#58049,"ALAK, ALAK, KOTA KUPANG, NUSA TENGGARA TIMUR",2,139,43,182
https://kawalpemilu.org#58049,"ALAK, ALAK, KOTA KUPANG, NUSA TENGGARA TIMUR",3,134,38,172
https://kawalpemilu.org#58049,"ALAK, ALAK, KOTA KUPANG, NUSA TENGGARA TIMUR",4,76,59,135
https://kawalpemilu.org#58049,"ALAK, ALAK, KOTA KUPANG, NUSA TENGGARA TIMUR",5,98,50,148
https://kawalpemilu.org#58049,"ALAK, ALAK, KOTA KUPANG, NUSA TENGGARA TIMUR",6,169,32,201
https://kawalpemilu.org#58049,"ALAK, ALAK, KOTA KUPANG, NUSA TENGGARA TIMUR",7,133,73,206
https://kawalpemilu.org#58049,"ALAK, ALAK, KOTA KUPANG, NUSA TENGGARA TIMUR",8,133,7,140
https://kawalpemilu.org#58049,"ALAK, ALAK, KOTA KUPANG, NUSA TENGGARA TIMUR",9,123,22,145
https://kawalpemilu.org#58049,"ALAK, ALAK, KOTA KUPANG, NUSA TENGGARA TIMUR",10,49,17,66
https://kawalpemilu.org#58049,"ALAK, ALAK, KOTA KUPANG, NUSA TENGGARA TIMUR",11,105,25,130
https://kawalpemilu.org#58049,"ALAK, ALAK, KOTA KUPANG, NUSA TENGGARA TIMUR",12,82,10,92
https://kawalpemilu.org#58049,"ALAK, ALAK, KOTA KUPANG, NUSA TENGGARA TIMUR",13,128,29,157
https://kawalpemilu.org#58049,"ALAK, ALAK, KOTA KUPANG, NUSA TENGGARA TIMUR",14,218,15,233
https://kawalpemilu.org#58049,"ALAK, ALAK, KOTA KUPANG, NUSA TENGGARA TIMUR",15,104,24,128
https://kawalpemilu.org#58049,"ALAK, ALAK, KOTA KUPANG, NUSA TENGGARA TIMUR",16,105,22,127
https://kawalpemilu.org#58049,"ALAK, ALAK, KOTA KUPANG, NUSA TENGGARA TIMUR",17,93,28,121
https://kawalpemilu.org#58049,"ALAK, ALAK, KOTA KUPANG, NUSA TENGGARA TIMUR",18,190,14,204
https://kawalpemilu.org#58049,"ALAK, ALAK, KOTA KUPANG, NUSA TENGGARA TIMUR",19,122,1,123
https://kawalpemilu.org#58049,"ALAK, ALAK, KOTA KUPANG, NUSA TENGGARA TIMUR",20,114,46,160
https://kawalpemilu.org#58049,"ALAK, ALAK, KOTA KUPANG, NUSA TENGGARA TIMUR",21,180,14,194
https://kawalpemilu.org#58049,"ALAK, ALAK, KOTA KUPANG, NUSA TENGGARA TIMUR",22,189,22,211
https://kawalpemilu.org#58049,"ALAK, ALAK, KOTA KUPANG, NUSA TENGGARA TIMUR",23,159,3,162
https://kawalpemilu.org#58050,"BATU PLAT, ALAK, KOTA KUPANG, NUSA TENGGARA TIMUR",1,157,6,163
https://kawalpemilu.org#58050,"BATU PLAT, ALAK, KOTA KUPANG, NUSA TENGGARA TIMUR",2,139,5,144
https://kawalpemilu.org#58050,"BATU PLAT, ALAK, KOTA KUPANG, NUSA TENGGARA TIMUR",3,121,6,127
https://kawalpemilu.org#58050,"BATU PLAT, ALAK, KOTA KUPANG, NUSA TENGGARA TIMUR",4,148,3,151
https://kawalpemilu.org#58050,"BATU PLAT, ALAK, KOTA KUPANG, NUSA TENGGARA TIMUR",5,221,41,262
https://kawalpemilu.org#58050,"BATU PLAT, ALAK, KOTA KUPANG, NUSA TENGGARA TIMUR",6,133,12,145
https://kawalpemilu.org#58050,"BATU PLAT, ALAK, KOTA KUPANG, NUSA TENGGARA TIMUR",7,160,7,167
https://kawalpemilu.org#58050,"BATU PLAT, ALAK, KOTA KUPANG, NUSA TENGGARA TIMUR",8,162,24,186
https://kawalpemilu.org#58050,"BATU PLAT, ALAK, KOTA KUPANG, NUSA TENGGARA TIMUR",9,140,3,143
https://kawalpemilu.org#58050,"BATU PLAT, ALAK, KOTA KUPANG, NUSA TENGGARA TIMUR",10,131,8,139
https://kawalpemilu.org#58050,"BATU PLAT, ALAK, KOTA KUPANG, NUSA TENGGARA TIMUR",11,142,14,156
https://kawalpemilu.org#58050,"BATU PLAT, ALAK, KOTA KUPANG, NUSA TENGGARA TIMUR",12,146,3,149
https://kawalpemilu.org#58050,"BATU PLAT, ALAK, KOTA KUPANG, NUSA TENGGARA TIMUR",13,203,7,210
https://kawalpemilu.org#58050,"BATU PLAT, ALAK, KOTA KUPANG, NUSA TENGGARA TIMUR",14,176,5,181
https://kawalpemilu.org#58050,"BATU PLAT, ALAK, KOTA KUPANG, NUSA TENGGARA TIMUR",15,206,2,208
https://kawalpemilu.org#58050,"BATU PLAT, ALAK, KOTA KUPANG, NUSA TENGGARA TIMUR",16,195,2,197
https://kawalpemilu.org#58050,"BATU PLAT, ALAK, KOTA KUPANG, NUSA TENGGARA TIMUR",17,216,12,228
https://kawalpemilu.org#58051,"MANULAI II, ALAK, KOTA KUPANG, NUSA TENGGARA TIMUR",1,208,9,217
https://kawalpemilu.org#58051,"MANULAI II, ALAK, KOTA KUPANG, NUSA TENGGARA TIMUR",2,201,11,212
https://kawalpemilu.org#58051,"MANULAI II, ALAK, KOTA KUPANG, NUSA TENGGARA TIMUR",3,194,8,202
https://kawalpemilu.org#58051,"MANULAI II, ALAK, KOTA KUPANG, NUSA TENGGARA TIMUR",4,182,11,1
https://kawalpemilu.org#58051,"MANULAI II, ALAK, KOTA KUPANG, NUSA TENGGARA TIMUR",5,169,20,189
https://kawalpemilu.org#58051,"MANULAI II, ALAK, KOTA KUPANG, NUSA TENGGARA TIMUR",6,194,14,208
https://kawalpemilu.org#58051,"MANULAI II, ALAK, KOTA KUPANG, NUSA TENGGARA TIMUR",7,226,11,237
https://kawalpemilu.org#58051,"MANULAI II, ALAK, KOTA KUPANG, NUSA TENGGARA TIMUR",8,218,16,234
https://kawalpemilu.org#58051,"MANULAI II, ALAK, KOTA KUPANG, NUSA TENGGARA TIMUR",9,176,13,189
https://kawalpemilu.org#58051,"MANULAI II, ALAK, KOTA KUPANG, NUSA TENGGARA TIMUR",10,179,14,193
https://kawalpemilu.org#58051,"MANULAI II, ALAK, KOTA KUPANG, NUSA TENGGARA TIMUR",11,160,11,171
https://kawalpemilu.org#58051,"MANULAI II, ALAK, KOTA KUPANG, NUSA TENGGARA TIMUR",12,148,20,168
https://kawalpemilu.org#58051,"MANULAI II, ALAK, KOTA KUPANG, NUSA TENGGARA TIMUR",13,162,6,168
https://kawalpemilu.org#58051,"MANULAI II, ALAK, KOTA KUPANG, NUSA TENGGARA TIMUR",14,235,6,241
https://kawalpemilu.org#58051,"MANULAI II, ALAK, KOTA KUPANG, NUSA TENGGARA TIMUR",15,114,14,128
https://kawalpemilu.org#58051,"MANULAI II, ALAK, KOTA KUPANG, NUSA TENGGARA TIMUR",16,150,22,172
https://kawalpemilu.org#58052,"NAIONI, ALAK, KOTA KUPANG, NUSA TENGGARA TIMUR",1,174,20,194
https://kawalpemilu.org#58052,"NAIONI, ALAK, KOTA KUPANG, NUSA TENGGARA TIMUR",2,163,6,169
https://kawalpemilu.org#58052,"NAIONI, ALAK, KOTA KUPANG, NUSA TENGGARA TIMUR",3,154,9,163
https://kawalpemilu.org#58052,"NAIONI, ALAK, KOTA KUPANG, NUSA TENGGARA TIMUR",4,139,5,144
https://kawalpemilu.org#58052,"NAIONI, ALAK, KOTA KUPANG, NUSA TENGGARA TIMUR",5,135,8,143
https://kawalpemilu.org#58052,"NAIONI, ALAK, KOTA KUPANG, NUSA TENGGARA TIMUR",6,196,5,201
https://kawalpemilu.org#58052,"NAIONI, ALAK, KOTA KUPANG, NUSA TENGGARA TIMUR",7,177,4,181
https://kawalpemilu.org#58052,"NAIONI, ALAK, KOTA KUPANG, NUSA TENGGARA TIMUR",8,195,4,199
https://kawalpemilu.org#58053,"PENKASE OELETA, ALAK, KOTA KUPANG, NUSA TENGGARA TIMUR",1,147,25,172
https://kawalpemilu.org#58053,"PENKASE OELETA, ALAK, KOTA KUPANG, NUSA TENGGARA TIMUR",2,140,31,171
https://kawalpemilu.org#58053,"PENKASE OELETA, ALAK, KOTA KUPANG, NUSA TENGGARA TIMUR",3,176,54,230
https://kawalpemilu.org#58053,"PENKASE OELETA, ALAK, KOTA KUPANG, NUSA TENGGARA TIMUR",4,91,32,123
https://kawalpemilu.org#58053,"PENKASE OELETA, ALAK, KOTA KUPANG, NUSA TENGGARA TIMUR",5,232,30,262
https://kawalpemilu.org#58053,"PENKASE OELETA, ALAK, KOTA KUPANG, NUSA TENGGARA TIMUR",6,249,12,261
https://kawalpemilu.org#58053,"PENKASE OELETA, ALAK, KOTA KUPANG, NUSA TENGGARA TIMUR",7,128,79,207
https://kawalpemilu.org#58053,"PENKASE OELETA, ALAK, KOTA KUPANG, NUSA TENGGARA TIMUR",8,228,46,274
https://kawalpemilu.org#58053,"PENKASE OELETA, ALAK, KOTA KUPANG, NUSA TENGGARA TIMUR",9,91,104,195
https://kawalpemilu.org#58053,"PENKASE OELETA, ALAK, KOTA KUPANG, NUSA TENGGARA TIMUR",10,116,66,182
https://kawalpemilu.org#58053,"PENKASE OELETA, ALAK, KOTA KUPANG, NUSA TENGGARA TIMUR",11,86,106,192
https://kawalpemilu.org#58053,"PENKASE OELETA, ALAK, KOTA KUPANG, NUSA TENGGARA TIMUR",12,119,100,219
https://kawalpemilu.org#58053,"PENKASE OELETA, ALAK, KOTA KUPANG, NUSA TENGGARA TIMUR",13,162,12,174
https://kawalpemilu.org#58053,"PENKASE OELETA, ALAK, KOTA KUPANG, NUSA TENGGARA TIMUR",14,57,80,137
https://kawalpemilu.org#58053,"PENKASE OELETA, ALAK, KOTA KUPANG, NUSA TENGGARA TIMUR",15,141,79,220
https://kawalpemilu.org#58053,"PENKASE OELETA, ALAK, KOTA KUPANG, NUSA TENGGARA TIMUR",16,83,130,213
https://kawalpemilu.org#58053,"PENKASE OELETA, ALAK, KOTA KUPANG, NUSA TENGGARA TIMUR",17,158,107,265
https://kawalpemilu.org#58053,"PENKASE OELETA, ALAK, KOTA KUPANG, NUSA TENGGARA TIMUR",18,56,61,117
https://kawalpemilu.org#58053,"PENKASE OELETA, ALAK, KOTA KUPANG, NUSA TENGGARA TIMUR",19,115,62,177
https://kawalpemilu.org#58053,"PENKASE OELETA, ALAK, KOTA KUPANG, NUSA TENGGARA TIMUR",20,133,93,226
https://kawalpemilu.org#58053,"PENKASE OELETA, ALAK, KOTA KUPANG, NUSA TENGGARA TIMUR",21,169,23,192
https://kawalpemilu.org#58055,"OEPURA, MAULAFA, KOTA KUPANG, NUSA TENGGARA TIMUR",1,228,15,243
https://kawalpemilu.org#58055,"OEPURA, MAULAFA, KOTA KUPANG, NUSA TENGGARA TIMUR",2,176,53,229
https://kawalpemilu.org#58055,"OEPURA, MAULAFA, KOTA KUPANG, NUSA TENGGARA TIMUR",3,192,6,198
https://kawalpemilu.org#58055,"OEPURA, MAULAFA, KOTA KUPANG, NUSA TENGGARA TIMUR",4,184,28,212
https://kawalpemilu.org#58055,"OEPURA, MAULAFA, KOTA KUPANG, NUSA TENGGARA TIMUR",5,117,13,130
https://kawalpemilu.org#58055,"OEPURA, MAULAFA, KOTA KUPANG, NUSA TENGGARA TIMUR",6,222,22,244
https://kawalpemilu.org#58055,"OEPURA, MAULAFA, KOTA KUPANG, NUSA TENGGARA TIMUR",7,200,24,224
https://kawalpemilu.org#58055,"OEPURA, MAULAFA, KOTA KUPANG, NUSA TENGGARA TIMUR",8,165,20,185
https://kawalpemilu.org#58055,"OEPURA, MAULAFA, KOTA KUPANG, NUSA TENGGARA TIMUR",9,174,10,184
https://kawalpemilu.org#58055,"OEPURA, MAULAFA, KOTA KUPANG, NUSA TENGGARA TIMUR",10,196,18,214
https://kawalpemilu.org#58055,"OEPURA, MAULAFA, KOTA KUPANG, NUSA TENGGARA TIMUR",11,223,18,241
https://kawalpemilu.org#58055,"OEPURA, MAULAFA, KOTA KUPANG, NUSA TENGGARA TIMUR",12,157,7,164
https://kawalpemilu.org#58055,"OEPURA, MAULAFA, KOTA KUPANG, NUSA TENGGARA TIMUR",13,141,12,153
https://kawalpemilu.org#58055,"OEPURA, MAULAFA, KOTA KUPANG, NUSA TENGGARA TIMUR",14,136,10,146
https://kawalpemilu.org#58055,"OEPURA, MAULAFA, KOTA KUPANG, NUSA TENGGARA TIMUR",15,232,11,243
https://kawalpemilu.org#58055,"OEPURA, MAULAFA, KOTA KUPANG, NUSA TENGGARA TIMUR",16,166,1,167
https://kawalpemilu.org#58055,"OEPURA, MAULAFA, KOTA KUPANG, NUSA TENGGARA TIMUR",17,178,13,191
https://kawalpemilu.org#58055,"OEPURA, MAULAFA, KOTA KUPANG, NUSA TENGGARA TIMUR",18,177,19,196
https://kawalpemilu.org#58055,"OEPURA, MAULAFA, KOTA KUPANG, NUSA TENGGARA TIMUR",19,134,13,147
https://kawalpemilu.org#58055,"OEPURA, MAULAFA, KOTA KUPANG, NUSA TENGGARA TIMUR",20,190,19,209
https://kawalpemilu.org#58055,"OEPURA, MAULAFA, KOTA KUPANG, NUSA TENGGARA TIMUR",21,169,10,179
https://kawalpemilu.org#58055,"OEPURA, MAULAFA, KOTA KUPANG, NUSA TENGGARA TIMUR",22,195,31,226
https://kawalpemilu.org#58055,"OEPURA, MAULAFA, KOTA KUPANG, NUSA TENGGARA TIMUR",23,174,10,184
https://kawalpemilu.org#58055,"OEPURA, MAULAFA, KOTA KUPANG, NUSA TENGGARA TIMUR",24,117,12,129
https://kawalpemilu.org#58055,"OEPURA, MAULAFA, KOTA KUPANG, NUSA TENGGARA TIMUR",25,189,13,202
https://kawalpemilu.org#58055,"OEPURA, MAULAFA, KOTA KUPANG, NUSA TENGGARA TIMUR",26,207,27,234
https://kawalpemilu.org#58055,"OEPURA, MAULAFA, KOTA KUPANG, NUSA TENGGARA TIMUR",27,175,15,190
https://kawalpemilu.org#58055,"OEPURA, MAULAFA, KOTA KUPANG, NUSA TENGGARA TIMUR",28,164,52,216
https://kawalpemilu.org#58055,"OEPURA, MAULAFA, KOTA KUPANG, NUSA TENGGARA TIMUR",29,178,10,188
https://kawalpemilu.org#58055,"OEPURA, MAULAFA, KOTA KUPANG, NUSA TENGGARA TIMUR",30,101,7,108
https://kawalpemilu.org#58055,"OEPURA, MAULAFA, KOTA KUPANG, NUSA TENGGARA TIMUR",31,171,19,190
https://kawalpemilu.org#58055,"OEPURA, MAULAFA, KOTA KUPANG, NUSA TENGGARA TIMUR",32,158,11,169
https://kawalpemilu.org#58055,"OEPURA, MAULAFA, KOTA KUPANG, NUSA TENGGARA TIMUR",33,145,7,152
https://kawalpemilu.org#58055,"OEPURA, MAULAFA, KOTA KUPANG, NUSA TENGGARA TIMUR",34,134,4,138
https://kawalpemilu.org#58055,"OEPURA, MAULAFA, KOTA KUPANG, NUSA TENGGARA TIMUR",35,216,14,230
https://kawalpemilu.org#58055,"OEPURA, MAULAFA, KOTA KUPANG, NUSA TENGGARA TIMUR",36,134,8,142
https://kawalpemilu.org#58055,"OEPURA, MAULAFA, KOTA KUPANG, NUSA TENGGARA TIMUR",37,134,3,137
https://kawalpemilu.org#58055,"OEPURA, MAULAFA, KOTA KUPANG, NUSA TENGGARA TIMUR",38,146,20,166
https://kawalpemilu.org#58055,"OEPURA, MAULAFA, KOTA KUPANG, NUSA TENGGARA TIMUR",39,139,25,164
https://kawalpemilu.org#58055,"OEPURA, MAULAFA, KOTA KUPANG, NUSA TENGGARA TIMUR",40,148,6,154
https://kawalpemilu.org#58055,"OEPURA, MAULAFA, KOTA KUPANG, NUSA TENGGARA TIMUR",41,133,14,147
https://kawalpemilu.org#58055,"OEPURA, MAULAFA, KOTA KUPANG, NUSA TENGGARA TIMUR",42,190,9,199
https://kawalpemilu.org#58055,"OEPURA, MAULAFA, KOTA KUPANG, NUSA TENGGARA TIMUR",43,156,19,175
https://kawalpemilu.org#58055,"OEPURA, MAULAFA, KOTA KUPANG, NUSA TENGGARA TIMUR",44,143,15,158
https://kawalpemilu.org#58055,"OEPURA, MAULAFA, KOTA KUPANG, NUSA TENGGARA TIMUR",45,129,7,136
https://kawalpemilu.org#58055,"OEPURA, MAULAFA, KOTA KUPANG, NUSA TENGGARA TIMUR",46,141,21,162
https://kawalpemilu.org#58056,"MAULAFA, MAULAFA, KOTA KUPANG, NUSA TENGGARA TIMUR",1,216,21,237
https://kawalpemilu.org#58056,"MAULAFA, MAULAFA, KOTA KUPANG, NUSA TENGGARA TIMUR",2,228,13,241
https://kawalpemilu.org#58056,"MAULAFA, MAULAFA, KOTA KUPANG, NUSA TENGGARA TIMUR",3,187,18,205
https://kawalpemilu.org#58056,"MAULAFA, MAULAFA, KOTA KUPANG, NUSA TENGGARA TIMUR",4,123,7,130
https://kawalpemilu.org#58056,"MAULAFA, MAULAFA, KOTA KUPANG, NUSA TENGGARA TIMUR",5,205,9,214
https://kawalpemilu.org#58056,"MAULAFA, MAULAFA, KOTA KUPANG, NUSA TENGGARA TIMUR",6,220,15,235
https://kawalpemilu.org#58056,"MAULAFA, MAULAFA, KOTA KUPANG, NUSA TENGGARA TIMUR",7,158,15,173
https://kawalpemilu.org#58056,"MAULAFA, MAULAFA, KOTA KUPANG, NUSA TENGGARA TIMUR",8,149,13,162
https://kawalpemilu.org#58056,"MAULAFA, MAULAFA, KOTA KUPANG, NUSA TENGGARA TIMUR",9,217,13,230
https://kawalpemilu.org#58056,"MAULAFA, MAULAFA, KOTA KUPANG, NUSA TENGGARA TIMUR",10,102,0,102
https://kawalpemilu.org#58056,"MAULAFA, MAULAFA, KOTA KUPANG, NUSA TENGGARA TIMUR",11,235,29,264
https://kawalpemilu.org#58056,"MAULAFA, MAULAFA, KOTA KUPANG, NUSA TENGGARA TIMUR",12,203,15,218
https://kawalpemilu.org#58056,"MAULAFA, MAULAFA, KOTA KUPANG, NUSA TENGGARA TIMUR",13,249,17,266
https://kawalpemilu.org#58056,"MAULAFA, MAULAFA, KOTA KUPANG, NUSA TENGGARA TIMUR",14,168,18,186
https://kawalpemilu.org#58056,"MAULAFA, MAULAFA, KOTA KUPANG, NUSA TENGGARA TIMUR",15,168,5,173
https://kawalpemilu.org#58056,"MAULAFA, MAULAFA, KOTA KUPANG, NUSA TENGGARA TIMUR",16,227,17,244
https://kawalpemilu.org#58056,"MAULAFA, MAULAFA, KOTA KUPANG, NUSA TENGGARA TIMUR",17,231,28,259
https://kawalpemilu.org#58056,"MAULAFA, MAULAFA, KOTA KUPANG, NUSA TENGGARA TIMUR",18,162,24,186
https://kawalpemilu.org#58056,"MAULAFA, MAULAFA, KOTA KUPANG, NUSA TENGGARA TIMUR",19,150,19,169
https://kawalpemilu.org#58056,"MAULAFA, MAULAFA, KOTA KUPANG, NUSA TENGGARA TIMUR",20,202,6,208
https://kawalpemilu.org#58056,"MAULAFA, MAULAFA, KOTA KUPANG, NUSA TENGGARA TIMUR",21,145,8,153
https://kawalpemilu.org#58056,"MAULAFA, MAULAFA, KOTA KUPANG, NUSA TENGGARA TIMUR",22,191,9,200
https://kawalpemilu.org#58056,"MAULAFA, MAULAFA, KOTA KUPANG, NUSA TENGGARA TIMUR",23,141,19,160
https://kawalpemilu.org#58056,"MAULAFA, MAULAFA, KOTA KUPANG, NUSA TENGGARA TIMUR",25,217,10,227
https://kawalpemilu.org#58056,"MAULAFA, MAULAFA, KOTA KUPANG, NUSA TENGGARA TIMUR",26,220,11,231
https://kawalpemilu.org#58056,"MAULAFA, MAULAFA, KOTA KUPANG, NUSA TENGGARA TIMUR",27,184,22,206
https://kawalpemilu.org#58056,"MAULAFA, MAULAFA, KOTA KUPANG, NUSA TENGGARA TIMUR",28,149,15,164
https://kawalpemilu.org#58056,"MAULAFA, MAULAFA, KOTA KUPANG, NUSA TENGGARA TIMUR",29,163,11,174
https://kawalpemilu.org#58056,"MAULAFA, MAULAFA, KOTA KUPANG, NUSA TENGGARA TIMUR",30,242,15,257
https://kawalpemilu.org#58056,"MAULAFA, MAULAFA, KOTA KUPANG, NUSA TENGGARA TIMUR",31,221,16,237
https://kawalpemilu.org#58057,"PENFUI, MAULAFA, KOTA KUPANG, NUSA TENGGARA TIMUR",1,200,38,238
https://kawalpemilu.org#58057,"PENFUI, MAULAFA, KOTA KUPANG, NUSA TENGGARA TIMUR",2,135,17,152
https://kawalpemilu.org#58057,"PENFUI, MAULAFA, KOTA KUPANG, NUSA TENGGARA TIMUR",3,121,10,131
https://kawalpemilu.org#58057,"PENFUI, MAULAFA, KOTA KUPANG, NUSA TENGGARA TIMUR",4,123,9,132
https://kawalpemilu.org#58057,"PENFUI, MAULAFA, KOTA KUPANG, NUSA TENGGARA TIMUR",5,136,5,141
https://kawalpemilu.org#58057,"PENFUI, MAULAFA, KOTA KUPANG, NUSA TENGGARA TIMUR",6,158,10,168
https://kawalpemilu.org#58057,"PENFUI, MAULAFA, KOTA KUPANG, NUSA TENGGARA TIMUR",7,156,11,167
https://kawalpemilu.org#58057,"PENFUI, MAULAFA, KOTA KUPANG, NUSA TENGGARA TIMUR",8,0,0,0
https://kawalpemilu.org#58057,"PENFUI, MAULAFA, KOTA KUPANG, NUSA TENGGARA TIMUR",9,143,2,145
https://kawalpemilu.org#58057,"PENFUI, MAULAFA, KOTA KUPANG, NUSA TENGGARA TIMUR",10,152,5,157
https://kawalpemilu.org#58057,"PENFUI, MAULAFA, KOTA KUPANG, NUSA TENGGARA TIMUR",11,141,5,146
https://kawalpemilu.org#58057,"PENFUI, MAULAFA, KOTA KUPANG, NUSA TENGGARA TIMUR",12,119,64,183
https://kawalpemilu.org#58057,"PENFUI, MAULAFA, KOTA KUPANG, NUSA TENGGARA TIMUR",13,158,4,162
https://kawalpemilu.org#58057,"PENFUI, MAULAFA, KOTA KUPANG, NUSA TENGGARA TIMUR",14,166,5,171
https://kawalpemilu.org#58057,"PENFUI, MAULAFA, KOTA KUPANG, NUSA TENGGARA TIMUR",15,220,18,238
https://kawalpemilu.org#58057,"PENFUI, MAULAFA, KOTA KUPANG, NUSA TENGGARA TIMUR",16,141,19,160
https://kawalpemilu.org#58057,"PENFUI, MAULAFA, KOTA KUPANG, NUSA TENGGARA TIMUR",17,163,10,173
https://kawalpemilu.org#58058,"NAIMATA, MAULAFA, KOTA KUPANG, NUSA TENGGARA TIMUR",1,209,10,219
https://kawalpemilu.org#58058,"NAIMATA, MAULAFA, KOTA KUPANG, NUSA TENGGARA TIMUR",2,176,12,188
https://kawalpemilu.org#58058,"NAIMATA, MAULAFA, KOTA KUPANG, NUSA TENGGARA TIMUR",3,175,10,185
https://kawalpemilu.org#58058,"NAIMATA, MAULAFA, KOTA KUPANG, NUSA TENGGARA TIMUR",4,164,15,179
https://kawalpemilu.org#58058,"NAIMATA, MAULAFA, KOTA KUPANG, NUSA TENGGARA TIMUR",5,192,13,205
https://kawalpemilu.org#58058,"NAIMATA, MAULAFA, KOTA KUPANG, NUSA TENGGARA TIMUR",6,183,6,189
https://kawalpemilu.org#58058,"NAIMATA, MAULAFA, KOTA KUPANG, NUSA TENGGARA TIMUR",7,167,7,174
https://kawalpemilu.org#58058,"NAIMATA, MAULAFA, KOTA KUPANG, NUSA TENGGARA TIMUR",8,195,5,200
https://kawalpemilu.org#58058,"NAIMATA, MAULAFA, KOTA KUPANG, NUSA TENGGARA TIMUR",9,214,1,215
https://kawalpemilu.org#58058,"NAIMATA, MAULAFA, KOTA KUPANG, NUSA TENGGARA TIMUR",10,186,3,189
https://kawalpemilu.org#58058,"NAIMATA, MAULAFA, KOTA KUPANG, NUSA TENGGARA TIMUR",11,158,11,169
https://kawalpemilu.org#58058,"NAIMATA, MAULAFA, KOTA KUPANG, NUSA TENGGARA TIMUR",12,148,5,153
https://kawalpemilu.org#58059,"BELLO, MAULAFA, KOTA KUPANG, NUSA TENGGARA TIMUR",1,175,12,187
https://kawalpemilu.org#58059,"BELLO, MAULAFA, KOTA KUPANG, NUSA TENGGARA TIMUR",2,173,13,186
https://kawalpemilu.org#58059,"BELLO, MAULAFA, KOTA KUPANG, NUSA TENGGARA TIMUR",3,151,11,162
https://kawalpemilu.org#58059,"BELLO, MAULAFA, KOTA KUPANG, NUSA TENGGARA TIMUR",4,130,5,135
https://kawalpemilu.org#58059,"BELLO, MAULAFA, KOTA KUPANG, NUSA TENGGARA TIMUR",5,206,18,224
https://kawalpemilu.org#58059,"BELLO, MAULAFA, KOTA KUPANG, NUSA TENGGARA TIMUR",6,177,11,188
https://kawalpemilu.org#58059,"BELLO, MAULAFA, KOTA KUPANG, NUSA TENGGARA TIMUR",7,226,9,235
https://kawalpemilu.org#58059,"BELLO, MAULAFA, KOTA KUPANG, NUSA TENGGARA TIMUR",9,207,38,245
https://kawalpemilu.org#58059,"BELLO, MAULAFA, KOTA KUPANG, NUSA TENGGARA TIMUR",10,141,15,156
https://kawalpemilu.org#58059,"BELLO, MAULAFA, KOTA KUPANG, NUSA TENGGARA TIMUR",11,201,26,227
https://kawalpemilu.org#58059,"BELLO, MAULAFA, KOTA KUPANG, NUSA TENGGARA TIMUR",12,228,35,263
https://kawalpemilu.org#58059,"BELLO, MAULAFA, KOTA KUPANG, NUSA TENGGARA TIMUR",13,158,4,162
https://kawalpemilu.org#58059,"BELLO, MAULAFA, KOTA KUPANG, NUSA TENGGARA TIMUR",14,160,8,168
https://kawalpemilu.org#58059,"BELLO, MAULAFA, KOTA KUPANG, NUSA TENGGARA TIMUR",15,91,14,105
https://kawalpemilu.org#58060,"FATUKOA, MAULAFA, KOTA KUPANG, NUSA TENGGARA TIMUR",1,229,8,237
https://kawalpemilu.org#58060,"FATUKOA, MAULAFA, KOTA KUPANG, NUSA TENGGARA TIMUR",2,140,14,154
https://kawalpemilu.org#58060,"FATUKOA, MAULAFA, KOTA KUPANG, NUSA TENGGARA TIMUR",3,157,12,169
https://kawalpemilu.org#58060,"FATUKOA, MAULAFA, KOTA KUPANG, NUSA TENGGARA TIMUR",4,201,19,220
https://kawalpemilu.org#58060,"FATUKOA, MAULAFA, KOTA KUPANG, NUSA TENGGARA TIMUR",5,202,23,225
https://kawalpemilu.org#58060,"FATUKOA, MAULAFA, KOTA KUPANG, NUSA TENGGARA TIMUR",6,184,66,250
https://kawalpemilu.org#58060,"FATUKOA, MAULAFA, KOTA KUPANG, NUSA TENGGARA TIMUR",7,174,12,186
https://kawalpemilu.org#58060,"FATUKOA, MAULAFA, KOTA KUPANG, NUSA TENGGARA TIMUR",8,165,4,169
https://kawalpemilu.org#58060,"FATUKOA, MAULAFA, KOTA KUPANG, NUSA TENGGARA TIMUR",9,156,12,168
https://kawalpemilu.org#58060,"FATUKOA, MAULAFA, KOTA KUPANG, NUSA TENGGARA TIMUR",10,216,6,222
https://kawalpemilu.org#58060,"FATUKOA, MAULAFA, KOTA KUPANG, NUSA TENGGARA TIMUR",12,101,2,103
https://kawalpemilu.org#58060,"FATUKOA, MAULAFA, KOTA KUPANG, NUSA TENGGARA TIMUR",13,130,3,133
https://kawalpemilu.org#58060,"FATUKOA, MAULAFA, KOTA KUPANG, NUSA TENGGARA TIMUR",14,137,1,138
https://kawalpemilu.org#58061,"KOLHUA, MAULAFA, KOTA KUPANG, NUSA TENGGARA TIMUR",1,178,20,198
https://kawalpemilu.org#58061,"KOLHUA, MAULAFA, KOTA KUPANG, NUSA TENGGARA TIMUR",2,147,13,160
https://kawalpemilu.org#58061,"KOLHUA, MAULAFA, KOTA KUPANG, NUSA TENGGARA TIMUR",3,127,44,171
https://kawalpemilu.org#58061,"KOLHUA, MAULAFA, KOTA KUPANG, NUSA TENGGARA TIMUR",4,136,28,164
https://kawalpemilu.org#58061,"KOLHUA, MAULAFA, KOTA KUPANG, NUSA TENGGARA TIMUR",5,134,21,155
https://kawalpemilu.org#58061,"KOLHUA, MAULAFA, KOTA KUPANG, NUSA TENGGARA TIMUR",6,129,29,158
https://kawalpemilu.org#58061,"KOLHUA, MAULAFA, KOTA KUPANG, NUSA TENGGARA TIMUR",7,147,43,190
https://kawalpemilu.org#58061,"KOLHUA, MAULAFA, KOTA KUPANG, NUSA TENGGARA TIMUR",8,149,33,182
https://kawalpemilu.org#58061,"KOLHUA, MAULAFA, KOTA KUPANG, NUSA TENGGARA TIMUR",9,102,31,133
https://kawalpemilu.org#58061,"KOLHUA, MAULAFA, KOTA KUPANG, NUSA TENGGARA TIMUR",10,213,21,234
https://kawalpemilu.org#58061,"KOLHUA, MAULAFA, KOTA KUPANG, NUSA TENGGARA TIMUR",11,175,16,191
https://kawalpemilu.org#58061,"KOLHUA, MAULAFA, KOTA KUPANG, NUSA TENGGARA TIMUR",12,203,28,231
https://kawalpemilu.org#58061,"KOLHUA, MAULAFA, KOTA KUPANG, NUSA TENGGARA TIMUR",13,183,25,208
https://kawalpemilu.org#58061,"KOLHUA, MAULAFA, KOTA KUPANG, NUSA TENGGARA TIMUR",14,208,38,246
https://kawalpemilu.org#58061,"KOLHUA, MAULAFA, KOTA KUPANG, NUSA TENGGARA TIMUR",15,135,20,155
https://kawalpemilu.org#58061,"KOLHUA, MAULAFA, KOTA KUPANG, NUSA TENGGARA TIMUR",16,127,9,136
https://kawalpemilu.org#58061,"KOLHUA, MAULAFA, KOTA KUPANG, NUSA TENGGARA TIMUR",17,204,28,232
https://kawalpemilu.org#58061,"KOLHUA, MAULAFA, KOTA KUPANG, NUSA TENGGARA TIMUR",18,230,16,246
https://kawalpemilu.org#58061,"KOLHUA, MAULAFA, KOTA KUPANG, NUSA TENGGARA TIMUR",19,199,18,217
https://kawalpemilu.org#58061,"KOLHUA, MAULAFA, KOTA KUPANG, NUSA TENGGARA TIMUR",20,195,7,202
https://kawalpemilu.org#58061,"KOLHUA, MAULAFA, KOTA KUPANG, NUSA TENGGARA TIMUR",21,170,8,178
https://kawalpemilu.org#58061,"KOLHUA, MAULAFA, KOTA KUPANG, NUSA TENGGARA TIMUR",22,206,27,233
https://kawalpemilu.org#58061,"KOLHUA, MAULAFA, KOTA KUPANG, NUSA TENGGARA TIMUR",23,138,22,160
https://kawalpemilu.org#58062,"SIKUMANA, MAULAFA, KOTA KUPANG, NUSA TENGGARA TIMUR",1,114,6,120
https://kawalpemilu.org#58062,"SIKUMANA, MAULAFA, KOTA KUPANG, NUSA TENGGARA TIMUR",2,156,20,176
https://kawalpemilu.org#58062,"SIKUMANA, MAULAFA, KOTA KUPANG, NUSA TENGGARA TIMUR",3,221,22,243
https://kawalpemilu.org#58062,"SIKUMANA, MAULAFA, KOTA KUPANG, NUSA TENGGARA TIMUR",4,218,16,234
https://kawalpemilu.org#58062,"SIKUMANA, MAULAFA, KOTA KUPANG, NUSA TENGGARA TIMUR",6,212,10,222
https://kawalpemilu.org#58062,"SIKUMANA, MAULAFA, KOTA KUPANG, NUSA TENGGARA TIMUR",7,168,14,182
https://kawalpemilu.org#58062,"SIKUMANA, MAULAFA, KOTA KUPANG, NUSA TENGGARA TIMUR",8,182,1,183
https://kawalpemilu.org#58062,"SIKUMANA, MAULAFA, KOTA KUPANG, NUSA TENGGARA TIMUR",9,192,10,202
https://kawalpemilu.org#58062,"SIKUMANA, MAULAFA, KOTA KUPANG, NUSA TENGGARA TIMUR",10,214,16,230
https://kawalpemilu.org#58062,"SIKUMANA, MAULAFA, KOTA KUPANG, NUSA TENGGARA TIMUR",11,130,11,141
https://kawalpemilu.org#58062,"SIKUMANA, MAULAFA, KOTA KUPANG, NUSA TENGGARA TIMUR",12,133,8,141
https://kawalpemilu.org#58062,"SIKUMANA, MAULAFA, KOTA KUPANG, NUSA TENGGARA TIMUR",13,126,8,134
https://kawalpemilu.org#58062,"SIKUMANA, MAULAFA, KOTA KUPANG, NUSA TENGGARA TIMUR",14,203,10,213
https://kawalpemilu.org#58062,"SIKUMANA, MAULAFA, KOTA KUPANG, NUSA TENGGARA TIMUR",15,162,15,177
https://kawalpemilu.org#58062,"SIKUMANA, MAULAFA, KOTA KUPANG, NUSA TENGGARA TIMUR",16,155,2,157
https://kawalpemilu.org#58062,"SIKUMANA, MAULAFA, KOTA KUPANG, NUSA TENGGARA TIMUR",17,125,9,134
https://kawalpemilu.org#58062,"SIKUMANA, MAULAFA, KOTA KUPANG, NUSA TENGGARA TIMUR",18,132,14,146
https://kawalpemilu.org#58062,"SIKUMANA, MAULAFA, KOTA KUPANG, NUSA TENGGARA TIMUR",19,136,7,143
https://kawalpemilu.org#58062,"SIKUMANA, MAULAFA, KOTA KUPANG, NUSA TENGGARA TIMUR",20,124,14,138
https://kawalpemilu.org#58062,"SIKUMANA, MAULAFA, KOTA KUPANG, NUSA TENGGARA TIMUR",21,174,18,192
https://kawalpemilu.org#58062,"SIKUMANA, MAULAFA, KOTA KUPANG, NUSA TENGGARA TIMUR",22,152,11,163
https://kawalpemilu.org#58062,"SIKUMANA, MAULAFA, KOTA KUPANG, NUSA TENGGARA TIMUR",23,201,6,207
https://kawalpemilu.org#58062,"SIKUMANA, MAULAFA, KOTA KUPANG, NUSA TENGGARA TIMUR",24,217,10,227
https://kawalpemilu.org#58062,"SIKUMANA, MAULAFA, KOTA KUPANG, NUSA TENGGARA TIMUR",25,245,13,258
https://kawalpemilu.org#58062,"SIKUMANA, MAULAFA, KOTA KUPANG, NUSA TENGGARA TIMUR",26,195,23,218
https://kawalpemilu.org#58062,"SIKUMANA, MAULAFA, KOTA KUPANG, NUSA TENGGARA TIMUR",27,203,5,208
https://kawalpemilu.org#58062,"SIKUMANA, MAULAFA, KOTA KUPANG, NUSA TENGGARA TIMUR",28,215,12,227
https://kawalpemilu.org#58062,"SIKUMANA, MAULAFA, KOTA KUPANG, NUSA TENGGARA TIMUR",29,237,12,249
https://kawalpemilu.org#58062,"SIKUMANA, MAULAFA, KOTA KUPANG, NUSA TENGGARA TIMUR",30,199,8,207
https://kawalpemilu.org#58062,"SIKUMANA, MAULAFA, KOTA KUPANG, NUSA TENGGARA TIMUR",31,217,7,224
https://kawalpemilu.org#58062,"SIKUMANA, MAULAFA, KOTA KUPANG, NUSA TENGGARA TIMUR",32,203,35,238
https://kawalpemilu.org#58062,"SIKUMANA, MAULAFA, KOTA KUPANG, NUSA TENGGARA TIMUR",33,178,19,197
https://kawalpemilu.org#58062,"SIKUMANA, MAULAFA, KOTA KUPANG, NUSA TENGGARA TIMUR",34,222,5,227
https://kawalpemilu.org#58062,"SIKUMANA, MAULAFA, KOTA KUPANG, NUSA TENGGARA TIMUR",35,218,12,230
https://kawalpemilu.org#58062,"SIKUMANA, MAULAFA, KOTA KUPANG, NUSA TENGGARA TIMUR",36,159,20,179
https://kawalpemilu.org#58062,"SIKUMANA, MAULAFA, KOTA KUPANG, NUSA TENGGARA TIMUR",37,178,16,194
https://kawalpemilu.org#58062,"SIKUMANA, MAULAFA, KOTA KUPANG, NUSA TENGGARA TIMUR",38,244,24,268
https://kawalpemilu.org#58062,"SIKUMANA, MAULAFA, KOTA KUPANG, NUSA TENGGARA TIMUR",39,231,14,245
https://kawalpemilu.org#58062,"SIKUMANA, MAULAFA, KOTA KUPANG, NUSA TENGGARA TIMUR",40,216,12,228
https://kawalpemilu.org#58062,"SIKUMANA, MAULAFA, KOTA KUPANG, NUSA TENGGARA TIMUR",41,167,22,189
https://kawalpemilu.org#58062,"SIKUMANA, MAULAFA, KOTA KUPANG, NUSA TENGGARA TIMUR",42,195,28,223
https://kawalpemilu.org#58062,"SIKUMANA, MAULAFA, KOTA KUPANG, NUSA TENGGARA TIMUR",43,111,15,126
https://kawalpemilu.org#58062,"SIKUMANA, MAULAFA, KOTA KUPANG, NUSA TENGGARA TIMUR",44,120,18,138
https://kawalpemilu.org#58062,"SIKUMANA, MAULAFA, KOTA KUPANG, NUSA TENGGARA TIMUR",45,146,10,156
https://kawalpemilu.org#58062,"SIKUMANA, MAULAFA, KOTA KUPANG, NUSA TENGGARA TIMUR",46,141,27,168
https://kawalpemilu.org#58062,"SIKUMANA, MAULAFA, KOTA KUPANG, NUSA TENGGARA TIMUR",47,123,18,141
https://kawalpemilu.org#58062,"SIKUMANA, MAULAFA, KOTA KUPANG, NUSA TENGGARA TIMUR",48,133,5,138
https://kawalpemilu.org#58062,"SIKUMANA, MAULAFA, KOTA KUPANG, NUSA TENGGARA TIMUR",49,153,9,162
https://kawalpemilu.org#58062,"SIKUMANA, MAULAFA, KOTA KUPANG, NUSA TENGGARA TIMUR",50,170,8,178
https://kawalpemilu.org#58063,"NAIKOLAN, MAULAFA, KOTA KUPANG, NUSA TENGGARA TIMUR",1,119,15,134
https://kawalpemilu.org#58063,"NAIKOLAN, MAULAFA, KOTA KUPANG, NUSA TENGGARA TIMUR",2,128,12,140
https://kawalpemilu.org#58063,"NAIKOLAN, MAULAFA, KOTA KUPANG, NUSA TENGGARA TIMUR",3,127,28,155
https://kawalpemilu.org#58063,"NAIKOLAN, MAULAFA, KOTA KUPANG, NUSA TENGGARA TIMUR",4,146,15,161
https://kawalpemilu.org#58063,"NAIKOLAN, MAULAFA, KOTA KUPANG, NUSA TENGGARA TIMUR",5,156,7,163
https://kawalpemilu.org#58063,"NAIKOLAN, MAULAFA, KOTA KUPANG, NUSA TENGGARA TIMUR",6,183,26,209
https://kawalpemilu.org#58063,"NAIKOLAN, MAULAFA, KOTA KUPANG, NUSA TENGGARA TIMUR",7,153,56,209
https://kawalpemilu.org#58063,"NAIKOLAN, MAULAFA, KOTA KUPANG, NUSA TENGGARA TIMUR",8,146,10,156
https://kawalpemilu.org#58063,"NAIKOLAN, MAULAFA, KOTA KUPANG, NUSA TENGGARA TIMUR",9,227,23,250
https://kawalpemilu.org#58063,"NAIKOLAN, MAULAFA, KOTA KUPANG, NUSA TENGGARA TIMUR",10,153,5,158
https://kawalpemilu.org#58063,"NAIKOLAN, MAULAFA, KOTA KUPANG, NUSA TENGGARA TIMUR",11,128,9,137
https://kawalpemilu.org#58063,"NAIKOLAN, MAULAFA, KOTA KUPANG, NUSA TENGGARA TIMUR",12,130,3,133
https://kawalpemilu.org#58063,"NAIKOLAN, MAULAFA, KOTA KUPANG, NUSA TENGGARA TIMUR",13,158,13,171
https://kawalpemilu.org#58063,"NAIKOLAN, MAULAFA, KOTA KUPANG, NUSA TENGGARA TIMUR",15,117,10,127
https://kawalpemilu.org#58063,"NAIKOLAN, MAULAFA, KOTA KUPANG, NUSA TENGGARA TIMUR",16,192,16,208
https://kawalpemilu.org#58063,"NAIKOLAN, MAULAFA, KOTA KUPANG, NUSA TENGGARA TIMUR",17,144,7,151
https://kawalpemilu.org#58063,"NAIKOLAN, MAULAFA, KOTA KUPANG, NUSA TENGGARA TIMUR",18,144,34,178
https://kawalpemilu.org#58063,"NAIKOLAN, MAULAFA, KOTA KUPANG, NUSA TENGGARA TIMUR",19,124,13,137
https://kawalpemilu.org#58063,"NAIKOLAN, MAULAFA, KOTA KUPANG, NUSA TENGGARA TIMUR",20,146,14,160
https://kawalpemilu.org#58063,"NAIKOLAN, MAULAFA, KOTA KUPANG, NUSA TENGGARA TIMUR",21,214,29,243
https://kawalpemilu.org#58063,"NAIKOLAN, MAULAFA, KOTA KUPANG, NUSA TENGGARA TIMUR",22,200,29,229
https://kawalpemilu.org#58063,"NAIKOLAN, MAULAFA, KOTA KUPANG, NUSA TENGGARA TIMUR",23,115,18,133
https://kawalpemilu.org#58063,"NAIKOLAN, MAULAFA, KOTA KUPANG, NUSA TENGGARA TIMUR",24,98,10,108
https://kawalpemilu.org#58065,"KELAPA LIMA, KELAPA LIMA, KOTA KUPANG, NUSA TENGGARA TIMUR",1,67,62,129
https://kawalpemilu.org#58065,"KELAPA LIMA, KELAPA LIMA, KOTA KUPANG, NUSA TENGGARA TIMUR",2,212,24,236
https://kawalpemilu.org#58065,"KELAPA LIMA, KELAPA LIMA, KOTA KUPANG, NUSA TENGGARA TIMUR",3,226,19,245
https://kawalpemilu.org#58065,"KELAPA LIMA, KELAPA LIMA, KOTA KUPANG, NUSA TENGGARA TIMUR",4,233,18,251
https://kawalpemilu.org#58065,"KELAPA LIMA, KELAPA LIMA, KOTA KUPANG, NUSA TENGGARA TIMUR",5,210,22,232
https://kawalpemilu.org#58065,"KELAPA LIMA, KELAPA LIMA, KOTA KUPANG, NUSA TENGGARA TIMUR",6,225,21,246
https://kawalpemilu.org#58065,"KELAPA LIMA, KELAPA LIMA, KOTA KUPANG, NUSA TENGGARA TIMUR",7,201,41,242
https://kawalpemilu.org#58065,"KELAPA LIMA, KELAPA LIMA, KOTA KUPANG, NUSA TENGGARA TIMUR",8,114,12,126
https://kawalpemilu.org#58065,"KELAPA LIMA, KELAPA LIMA, KOTA KUPANG, NUSA TENGGARA TIMUR",9,123,10,133
https://kawalpemilu.org#58065,"KELAPA LIMA, KELAPA LIMA, KOTA KUPANG, NUSA TENGGARA TIMUR",10,117,16,133
https://kawalpemilu.org#58065,"KELAPA LIMA, KELAPA LIMA, KOTA KUPANG, NUSA TENGGARA TIMUR",11,181,33,214
https://kawalpemilu.org#58065,"KELAPA LIMA, KELAPA LIMA, KOTA KUPANG, NUSA TENGGARA TIMUR",12,137,72,209
https://kawalpemilu.org#58065,"KELAPA LIMA, KELAPA LIMA, KOTA KUPANG, NUSA TENGGARA TIMUR",13,205,14,219
https://kawalpemilu.org#58065,"KELAPA LIMA, KELAPA LIMA, KOTA KUPANG, NUSA TENGGARA TIMUR",14,196,22,218
https://kawalpemilu.org#58065,"KELAPA LIMA, KELAPA LIMA, KOTA KUPANG, NUSA TENGGARA TIMUR",15,183,20,203
https://kawalpemilu.org#58065,"KELAPA LIMA, KELAPA LIMA, KOTA KUPANG, NUSA TENGGARA TIMUR",16,160,22,182
https://kawalpemilu.org#58065,"KELAPA LIMA, KELAPA LIMA, KOTA KUPANG, NUSA TENGGARA TIMUR",17,147,33,180
https://kawalpemilu.org#58065,"KELAPA LIMA, KELAPA LIMA, KOTA KUPANG, NUSA TENGGARA TIMUR",18,187,36,223
https://kawalpemilu.org#58065,"KELAPA LIMA, KELAPA LIMA, KOTA KUPANG, NUSA TENGGARA TIMUR",19,217,28,245
https://kawalpemilu.org#58065,"KELAPA LIMA, KELAPA LIMA, KOTA KUPANG, NUSA TENGGARA TIMUR",20,158,7,165
https://kawalpemilu.org#58065,"KELAPA LIMA, KELAPA LIMA, KOTA KUPANG, NUSA TENGGARA TIMUR",21,140,7,147
https://kawalpemilu.org#58065,"KELAPA LIMA, KELAPA LIMA, KOTA KUPANG, NUSA TENGGARA TIMUR",22,124,34,158
https://kawalpemilu.org#58065,"KELAPA LIMA, KELAPA LIMA, KOTA KUPANG, NUSA TENGGARA TIMUR",23,117,27,144
https://kawalpemilu.org#58065,"KELAPA LIMA, KELAPA LIMA, KOTA KUPANG, NUSA TENGGARA TIMUR",24,164,19,183
https://kawalpemilu.org#58065,"KELAPA LIMA, KELAPA LIMA, KOTA KUPANG, NUSA TENGGARA TIMUR",25,174,31,205
https://kawalpemilu.org#58065,"KELAPA LIMA, KELAPA LIMA, KOTA KUPANG, NUSA TENGGARA TIMUR",26,168,21,189
https://kawalpemilu.org#58065,"KELAPA LIMA, KELAPA LIMA, KOTA KUPANG, NUSA TENGGARA TIMUR",27,195,19,214
https://kawalpemilu.org#58065,"KELAPA LIMA, KELAPA LIMA, KOTA KUPANG, NUSA TENGGARA TIMUR",28,231,24,255
https://kawalpemilu.org#58065,"KELAPA LIMA, KELAPA LIMA, KOTA KUPANG, NUSA TENGGARA TIMUR",29,198,21,219
https://kawalpemilu.org#58065,"KELAPA LIMA, KELAPA LIMA, KOTA KUPANG, NUSA TENGGARA TIMUR",30,166,54,220
https://kawalpemilu.org#58065,"KELAPA LIMA, KELAPA LIMA, KOTA KUPANG, NUSA TENGGARA TIMUR",31,99,13,112
https://kawalpemilu.org#58065,"KELAPA LIMA, KELAPA LIMA, KOTA KUPANG, NUSA TENGGARA TIMUR",32,147,17,164
https://kawalpemilu.org#58065,"KELAPA LIMA, KELAPA LIMA, KOTA KUPANG, NUSA TENGGARA TIMUR",33,206,46,252
https://kawalpemilu.org#58065,"KELAPA LIMA, KELAPA LIMA, KOTA KUPANG, NUSA TENGGARA TIMUR",34,183,26,209
https://kawalpemilu.org#58065,"KELAPA LIMA, KELAPA LIMA, KOTA KUPANG, NUSA TENGGARA TIMUR",35,153,33,186
https://kawalpemilu.org#58065,"KELAPA LIMA, KELAPA LIMA, KOTA KUPANG, NUSA TENGGARA TIMUR",36,143,15,158
https://kawalpemilu.org#58065,"KELAPA LIMA, KELAPA LIMA, KOTA KUPANG, NUSA TENGGARA TIMUR",37,0,0,0
https://kawalpemilu.org#58066,"OESAPA, KELAPA LIMA, KOTA KUPANG, NUSA TENGGARA TIMUR",1,224,10,234
https://kawalpemilu.org#58066,"OESAPA, KELAPA LIMA, KOTA KUPANG, NUSA TENGGARA TIMUR",2,213,8,221
https://kawalpemilu.org#58066,"OESAPA, KELAPA LIMA, KOTA KUPANG, NUSA TENGGARA TIMUR",3,196,6,202
https://kawalpemilu.org#58066,"OESAPA, KELAPA LIMA, KOTA KUPANG, NUSA TENGGARA TIMUR",4,204,2,206
https://kawalpemilu.org#58066,"OESAPA, KELAPA LIMA, KOTA KUPANG, NUSA TENGGARA TIMUR",5,195,3,198
https://kawalpemilu.org#58066,"OESAPA, KELAPA LIMA, KOTA KUPANG, NUSA TENGGARA TIMUR",6,99,21,120
https://kawalpemilu.org#58066,"OESAPA, KELAPA LIMA, KOTA KUPANG, NUSA TENGGARA TIMUR",7,223,7,230
https://kawalpemilu.org#58066,"OESAPA, KELAPA LIMA, KOTA KUPANG, NUSA TENGGARA TIMUR",8,123,17,140
https://kawalpemilu.org#58066,"OESAPA, KELAPA LIMA, KOTA KUPANG, NUSA TENGGARA TIMUR",9,224,8,232
https://kawalpemilu.org#58066,"OESAPA, KELAPA LIMA, KOTA KUPANG, NUSA TENGGARA TIMUR",10,216,13,229
https://kawalpemilu.org#58066,"OESAPA, KELAPA LIMA, KOTA KUPANG, NUSA TENGGARA TIMUR",11,157,16,173
https://kawalpemilu.org#58066,"OESAPA, KELAPA LIMA, KOTA KUPANG, NUSA TENGGARA TIMUR",12,176,19,195
https://kawalpemilu.org#58066,"OESAPA, KELAPA LIMA, KOTA KUPANG, NUSA TENGGARA TIMUR",13,106,6,112
https://kawalpemilu.org#58066,"OESAPA, KELAPA LIMA, KOTA KUPANG, NUSA TENGGARA TIMUR",14,121,5,126
https://kawalpemilu.org#58066,"OESAPA, KELAPA LIMA, KOTA KUPANG, NUSA TENGGARA TIMUR",15,97,6,103
https://kawalpemilu.org#58066,"OESAPA, KELAPA LIMA, KOTA KUPANG, NUSA TENGGARA TIMUR",16,86,6,92
https://kawalpemilu.org#58066,"OESAPA, KELAPA LIMA, KOTA KUPANG, NUSA TENGGARA TIMUR",17,122,5,127
https://kawalpemilu.org#58066,"OESAPA, KELAPA LIMA, KOTA KUPANG, NUSA TENGGARA TIMUR",18,66,5,71
https://kawalpemilu.org#58066,"OESAPA, KELAPA LIMA, KOTA KUPANG, NUSA TENGGARA TIMUR",19,59,2,61
https://kawalpemilu.org#58066,"OESAPA, KELAPA LIMA, KOTA KUPANG, NUSA TENGGARA TIMUR",20,159,9,168
https://kawalpemilu.org#58066,"OESAPA, KELAPA LIMA, KOTA KUPANG, NUSA TENGGARA TIMUR",21,129,8,137
https://kawalpemilu.org#58066,"OESAPA, KELAPA LIMA, KOTA KUPANG, NUSA TENGGARA TIMUR",22,120,12,132
https://kawalpemilu.org#58066,"OESAPA, KELAPA LIMA, KOTA KUPANG, NUSA TENGGARA TIMUR",23,93,7,100
https://kawalpemilu.org#58066,"OESAPA, KELAPA LIMA, KOTA KUPANG, NUSA TENGGARA TIMUR",24,108,3,111
https://kawalpemilu.org#58066,"OESAPA, KELAPA LIMA, KOTA KUPANG, NUSA TENGGARA TIMUR",25,195,27,222
https://kawalpemilu.org#58066,"OESAPA, KELAPA LIMA, KOTA KUPANG, NUSA TENGGARA TIMUR",26,163,7,170
https://kawalpemilu.org#58066,"OESAPA, KELAPA LIMA, KOTA KUPANG, NUSA TENGGARA TIMUR",27,128,4,132
https://kawalpemilu.org#58066,"OESAPA, KELAPA LIMA, KOTA KUPANG, NUSA TENGGARA TIMUR",28,155,6,161
https://kawalpemilu.org#58066,"OESAPA, KELAPA LIMA, KOTA KUPANG, NUSA TENGGARA TIMUR",29,125,3,128
https://kawalpemilu.org#58066,"OESAPA, KELAPA LIMA, KOTA KUPANG, NUSA TENGGARA TIMUR",30,135,7,142
https://kawalpemilu.org#58066,"OESAPA, KELAPA LIMA, KOTA KUPANG, NUSA TENGGARA TIMUR",31,156,7,163
https://kawalpemilu.org#58066,"OESAPA, KELAPA LIMA, KOTA KUPANG, NUSA TENGGARA TIMUR",32,191,14,205
https://kawalpemilu.org#58066,"OESAPA, KELAPA LIMA, KOTA KUPANG, NUSA TENGGARA TIMUR",33,166,13,179
https://kawalpemilu.org#58066,"OESAPA, KELAPA LIMA, KOTA KUPANG, NUSA TENGGARA TIMUR",34,88,0,88
https://kawalpemilu.org#58066,"OESAPA, KELAPA LIMA, KOTA KUPANG, NUSA TENGGARA TIMUR",35,183,3,186
https://kawalpemilu.org#58066,"OESAPA, KELAPA LIMA, KOTA KUPANG, NUSA TENGGARA TIMUR",36,117,15,132
https://kawalpemilu.org#58066,"OESAPA, KELAPA LIMA, KOTA KUPANG, NUSA TENGGARA TIMUR",37,127,13,140
https://kawalpemilu.org#58066,"OESAPA, KELAPA LIMA, KOTA KUPANG, NUSA TENGGARA TIMUR",38,87,2,89
https://kawalpemilu.org#58066,"OESAPA, KELAPA LIMA, KOTA KUPANG, NUSA TENGGARA TIMUR",39,107,9,116
https://kawalpemilu.org#58066,"OESAPA, KELAPA LIMA, KOTA KUPANG, NUSA TENGGARA TIMUR",40,62,2,64
https://kawalpemilu.org#58066,"OESAPA, KELAPA LIMA, KOTA KUPANG, NUSA TENGGARA TIMUR",41,193,15,208
https://kawalpemilu.org#58066,"OESAPA, KELAPA LIMA, KOTA KUPANG, NUSA TENGGARA TIMUR",42,148,51,199
https://kawalpemilu.org#58066,"OESAPA, KELAPA LIMA, KOTA KUPANG, NUSA TENGGARA TIMUR",43,117,41,158
https://kawalpemilu.org#58066,"OESAPA, KELAPA LIMA, KOTA KUPANG, NUSA TENGGARA TIMUR",44,122,66,188
https://kawalpemilu.org#58066,"OESAPA, KELAPA LIMA, KOTA KUPANG, NUSA TENGGARA TIMUR",45,120,109,229
https://kawalpemilu.org#58066,"OESAPA, KELAPA LIMA, KOTA KUPANG, NUSA TENGGARA TIMUR",46,146,89,235
https://kawalpemilu.org#58066,"OESAPA, KELAPA LIMA, KOTA KUPANG, NUSA TENGGARA TIMUR",47,68,5,73
https://kawalpemilu.org#58066,"OESAPA, KELAPA LIMA, KOTA KUPANG, NUSA TENGGARA TIMUR",48,117,9,126
https://kawalpemilu.org#58066,"OESAPA, KELAPA LIMA, KOTA KUPANG, NUSA TENGGARA TIMUR",49,142,27,169
https://kawalpemilu.org#58066,"OESAPA, KELAPA LIMA, KOTA KUPANG, NUSA TENGGARA TIMUR",50,99,39,138
https://kawalpemilu.org#58066,"OESAPA, KELAPA LIMA, KOTA KUPANG, NUSA TENGGARA TIMUR",51,131,29,160
https://kawalpemilu.org#58066,"OESAPA, KELAPA LIMA, KOTA KUPANG, NUSA TENGGARA TIMUR",52,114,14,128
https://kawalpemilu.org#58066,"OESAPA, KELAPA LIMA, KOTA KUPANG, NUSA TENGGARA TIMUR",53,84,76,160
https://kawalpemilu.org#58066,"OESAPA, KELAPA LIMA, KOTA KUPANG, NUSA TENGGARA TIMUR",54,181,7,188
https://kawalpemilu.org#58066,"OESAPA, KELAPA LIMA, KOTA KUPANG, NUSA TENGGARA TIMUR",55,145,12,157
https://kawalpemilu.org#58066,"OESAPA, KELAPA LIMA, KOTA KUPANG, NUSA TENGGARA TIMUR",56,157,15,172
https://kawalpemilu.org#58066,"OESAPA, KELAPA LIMA, KOTA KUPANG, NUSA TENGGARA TIMUR",57,84,5,89
https://kawalpemilu.org#58066,"OESAPA, KELAPA LIMA, KOTA KUPANG, NUSA TENGGARA TIMUR",58,143,12,155
https://kawalpemilu.org#58066,"OESAPA, KELAPA LIMA, KOTA KUPANG, NUSA TENGGARA TIMUR",59,105,21,126
https://kawalpemilu.org#58066,"OESAPA, KELAPA LIMA, KOTA KUPANG, NUSA TENGGARA TIMUR",60,142,18,160
https://kawalpemilu.org#58066,"OESAPA, KELAPA LIMA, KOTA KUPANG, NUSA TENGGARA TIMUR",61,192,21,213
https://kawalpemilu.org#58066,"OESAPA, KELAPA LIMA, KOTA KUPANG, NUSA TENGGARA TIMUR",62,118,9,127
https://kawalpemilu.org#58066,"OESAPA, KELAPA LIMA, KOTA KUPANG, NUSA TENGGARA TIMUR",63,130,6,136
https://kawalpemilu.org#58066,"OESAPA, KELAPA LIMA, KOTA KUPANG, NUSA TENGGARA TIMUR",64,183,30,213
https://kawalpemilu.org#58066,"OESAPA, KELAPA LIMA, KOTA KUPANG, NUSA TENGGARA TIMUR",65,207,19,226
https://kawalpemilu.org#58066,"OESAPA, KELAPA LIMA, KOTA KUPANG, NUSA TENGGARA TIMUR",66,213,11,224
https://kawalpemilu.org#58066,"OESAPA, KELAPA LIMA, KOTA KUPANG, NUSA TENGGARA TIMUR",67,214,23,237
https://kawalpemilu.org#58066,"OESAPA, KELAPA LIMA, KOTA KUPANG, NUSA TENGGARA TIMUR",68,123,17,140
https://kawalpemilu.org#58066,"OESAPA, KELAPA LIMA, KOTA KUPANG, NUSA TENGGARA TIMUR",69,161,35,196
https://kawalpemilu.org#58066,"OESAPA, KELAPA LIMA, KOTA KUPANG, NUSA TENGGARA TIMUR",70,207,20,227
https://kawalpemilu.org#58066,"OESAPA, KELAPA LIMA, KOTA KUPANG, NUSA TENGGARA TIMUR",71,198,20,218
https://kawalpemilu.org#58067,"LASIANA, KELAPA LIMA, KOTA KUPANG, NUSA TENGGARA TIMUR",1,195,23,218
https://kawalpemilu.org#58067,"LASIANA, KELAPA LIMA, KOTA KUPANG, NUSA TENGGARA TIMUR",2,186,4,190
https://kawalpemilu.org#58067,"LASIANA, KELAPA LIMA, KOTA KUPANG, NUSA TENGGARA TIMUR",3,145,11,156
https://kawalpemilu.org#58067,"LASIANA, KELAPA LIMA, KOTA KUPANG, NUSA TENGGARA TIMUR",4,174,13,187
https://kawalpemilu.org#58067,"LASIANA, KELAPA LIMA, KOTA KUPANG, NUSA TENGGARA TIMUR",5,183,26,209
https://kawalpemilu.org#58067,"LASIANA, KELAPA LIMA, KOTA KUPANG, NUSA TENGGARA TIMUR",6,103,35,138
https://kawalpemilu.org#58067,"LASIANA, KELAPA LIMA, KOTA KUPANG, NUSA TENGGARA TIMUR",7,72,47,119
https://kawalpemilu.org#58067,"LASIANA, KELAPA LIMA, KOTA KUPANG, NUSA TENGGARA TIMUR",8,166,2,168
https://kawalpemilu.org#58067,"LASIANA, KELAPA LIMA, KOTA KUPANG, NUSA TENGGARA TIMUR",9,162,4,166
https://kawalpemilu.org#58067,"LASIANA, KELAPA LIMA, KOTA KUPANG, NUSA TENGGARA TIMUR",10,209,3,212
https://kawalpemilu.org#58067,"LASIANA, KELAPA LIMA, KOTA KUPANG, NUSA TENGGARA TIMUR",11,121,4,125
https://kawalpemilu.org#58067,"LASIANA, KELAPA LIMA, KOTA KUPANG, NUSA TENGGARA TIMUR",12,128,6,134
https://kawalpemilu.org#58067,"LASIANA, KELAPA LIMA, KOTA KUPANG, NUSA TENGGARA TIMUR",13,57,3,60
https://kawalpemilu.org#58067,"LASIANA, KELAPA LIMA, KOTA KUPANG, NUSA TENGGARA TIMUR",14,91,14,105
https://kawalpemilu.org#58067,"LASIANA, KELAPA LIMA, KOTA KUPANG, NUSA TENGGARA TIMUR",15,203,18,221
https://kawalpemilu.org#58067,"LASIANA, KELAPA LIMA, KOTA KUPANG, NUSA TENGGARA TIMUR",16,220,19,239
https://kawalpemilu.org#58067,"LASIANA, KELAPA LIMA, KOTA KUPANG, NUSA TENGGARA TIMUR",17,204,6,210
https://kawalpemilu.org#58067,"LASIANA, KELAPA LIMA, KOTA KUPANG, NUSA TENGGARA TIMUR",18,236,12,248
https://kawalpemilu.org#58067,"LASIANA, KELAPA LIMA, KOTA KUPANG, NUSA TENGGARA TIMUR",19,197,12,209
https://kawalpemilu.org#58067,"LASIANA, KELAPA LIMA, KOTA KUPANG, NUSA TENGGARA TIMUR",20,126,1,127
https://kawalpemilu.org#58067,"LASIANA, KELAPA LIMA, KOTA KUPANG, NUSA TENGGARA TIMUR",21,122,15,137
https://kawalpemilu.org#58067,"LASIANA, KELAPA LIMA, KOTA KUPANG, NUSA TENGGARA TIMUR",22,132,3,135
https://kawalpemilu.org#58067,"LASIANA, KELAPA LIMA, KOTA KUPANG, NUSA TENGGARA TIMUR",23,161,4,165
https://kawalpemilu.org#58067,"LASIANA, KELAPA LIMA, KOTA KUPANG, NUSA TENGGARA TIMUR",24,123,11,134
https://kawalpemilu.org#58067,"LASIANA, KELAPA LIMA, KOTA KUPANG, NUSA TENGGARA TIMUR",25,142,5,147
https://kawalpemilu.org#58067,"LASIANA, KELAPA LIMA, KOTA KUPANG, NUSA TENGGARA TIMUR",26,197,12,209
https://kawalpemilu.org#58067,"LASIANA, KELAPA LIMA, KOTA KUPANG, NUSA TENGGARA TIMUR",27,142,12,154
https://kawalpemilu.org#58067,"LASIANA, KELAPA LIMA, KOTA KUPANG, NUSA TENGGARA TIMUR",28,204,10,214
https://kawalpemilu.org#58067,"LASIANA, KELAPA LIMA, KOTA KUPANG, NUSA TENGGARA TIMUR",29,138,13,151
https://kawalpemilu.org#58067,"LASIANA, KELAPA LIMA, KOTA KUPANG, NUSA TENGGARA TIMUR",30,151,7,158
https://kawalpemilu.org#58067,"LASIANA, KELAPA LIMA, KOTA KUPANG, NUSA TENGGARA TIMUR",31,135,10,145
https://kawalpemilu.org#58067,"LASIANA, KELAPA LIMA, KOTA KUPANG, NUSA TENGGARA TIMUR",32,162,9,171
https://kawalpemilu.org#58067,"LASIANA, KELAPA LIMA, KOTA KUPANG, NUSA TENGGARA TIMUR",33,107,7,114
https://kawalpemilu.org#58067,"LASIANA, KELAPA LIMA, KOTA KUPANG, NUSA TENGGARA TIMUR",34,138,8,146
https://kawalpemilu.org#58067,"LASIANA, KELAPA LIMA, KOTA KUPANG, NUSA TENGGARA TIMUR",35,114,3,117
https://kawalpemilu.org#58067,"LASIANA, KELAPA LIMA, KOTA KUPANG, NUSA TENGGARA TIMUR",36,112,3,115
https://kawalpemilu.org#58067,"LASIANA, KELAPA LIMA, KOTA KUPANG, NUSA TENGGARA TIMUR",37,134,9,143
https://kawalpemilu.org#58067,"LASIANA, KELAPA LIMA, KOTA KUPANG, NUSA TENGGARA TIMUR",38,147,2,149
https://kawalpemilu.org#58067,"LASIANA, KELAPA LIMA, KOTA KUPANG, NUSA TENGGARA TIMUR",39,219,10,229
https://kawalpemilu.org#58067,"LASIANA, KELAPA LIMA, KOTA KUPANG, NUSA TENGGARA TIMUR",40,160,9,169
https://kawalpemilu.org#58068,"OESAPA BARAT, KELAPA LIMA, KOTA KUPANG, NUSA TENGGARA TIMUR",1,211,14,225
https://kawalpemilu.org#58068,"OESAPA BARAT, KELAPA LIMA, KOTA KUPANG, NUSA TENGGARA TIMUR",2,234,9,243
https://kawalpemilu.org#58068,"OESAPA BARAT, KELAPA LIMA, KOTA KUPANG, NUSA TENGGARA TIMUR",3,216,16,232
https://kawalpemilu.org#58068,"OESAPA BARAT, KELAPA LIMA, KOTA KUPANG, NUSA TENGGARA TIMUR",4,146,19,165
https://kawalpemilu.org#58068,"OESAPA BARAT, KELAPA LIMA, KOTA KUPANG, NUSA TENGGARA TIMUR",5,172,12,184
https://kawalpemilu.org#58068,"OESAPA BARAT, KELAPA LIMA, KOTA KUPANG, NUSA TENGGARA TIMUR",6,191,16,207
https://kawalpemilu.org#58068,"OESAPA BARAT, KELAPA LIMA, KOTA KUPANG, NUSA TENGGARA TIMUR",7,197,11,208
https://kawalpemilu.org#58068,"OESAPA BARAT, KELAPA LIMA, KOTA KUPANG, NUSA TENGGARA TIMUR",8,182,27,209
https://kawalpemilu.org#58068,"OESAPA BARAT, KELAPA LIMA, KOTA KUPANG, NUSA TENGGARA TIMUR",9,192,20,212
https://kawalpemilu.org#58068,"OESAPA BARAT, KELAPA LIMA, KOTA KUPANG, NUSA TENGGARA TIMUR",10,136,8,144
https://kawalpemilu.org#58068,"OESAPA BARAT, KELAPA LIMA, KOTA KUPANG, NUSA TENGGARA TIMUR",11,139,10,149
https://kawalpemilu.org#58068,"OESAPA BARAT, KELAPA LIMA, KOTA KUPANG, NUSA TENGGARA TIMUR",12,191,18,209
https://kawalpemilu.org#58068,"OESAPA BARAT, KELAPA LIMA, KOTA KUPANG, NUSA TENGGARA TIMUR",13,135,11,146
https://kawalpemilu.org#58068,"OESAPA BARAT, KELAPA LIMA, KOTA KUPANG, NUSA TENGGARA TIMUR",14,221,9,230
https://kawalpemilu.org#58068,"OESAPA BARAT, KELAPA LIMA, KOTA KUPANG, NUSA TENGGARA TIMUR",15,158,13,171
https://kawalpemilu.org#58068,"OESAPA BARAT, KELAPA LIMA, KOTA KUPANG, NUSA TENGGARA TIMUR",16,255,6,261
https://kawalpemilu.org#58068,"OESAPA BARAT, KELAPA LIMA, KOTA KUPANG, NUSA TENGGARA TIMUR",17,200,24,224
https://kawalpemilu.org#58068,"OESAPA BARAT, KELAPA LIMA, KOTA KUPANG, NUSA TENGGARA TIMUR",18,163,11,174
https://kawalpemilu.org#58068,"OESAPA BARAT, KELAPA LIMA, KOTA KUPANG, NUSA TENGGARA TIMUR",19,135,3,138
https://kawalpemilu.org#58068,"OESAPA BARAT, KELAPA LIMA, KOTA KUPANG, NUSA TENGGARA TIMUR",20,166,9,175
https://kawalpemilu.org#58068,"OESAPA BARAT, KELAPA LIMA, KOTA KUPANG, NUSA TENGGARA TIMUR",21,191,5,196
https://kawalpemilu.org#58068,"OESAPA BARAT, KELAPA LIMA, KOTA KUPANG, NUSA TENGGARA TIMUR",22,156,15,171
https://kawalpemilu.org#58068,"OESAPA BARAT, KELAPA LIMA, KOTA KUPANG, NUSA TENGGARA TIMUR",23,156,22,178
https://kawalpemilu.org#58068,"OESAPA BARAT, KELAPA LIMA, KOTA KUPANG, NUSA TENGGARA TIMUR",24,176,14,190
https://kawalpemilu.org#58068,"OESAPA BARAT, KELAPA LIMA, KOTA KUPANG, NUSA TENGGARA TIMUR",25,143,30,173
https://kawalpemilu.org#58069,"OESAPA SELATAN, KELAPA LIMA, KOTA KUPANG, NUSA TENGGARA TIMUR",1,154,38,192
https://kawalpemilu.org#58069,"OESAPA SELATAN, KELAPA LIMA, KOTA KUPANG, NUSA TENGGARA TIMUR",2,210,34,244
https://kawalpemilu.org#58069,"OESAPA SELATAN, KELAPA LIMA, KOTA KUPANG, NUSA TENGGARA TIMUR",3,126,15,141
https://kawalpemilu.org#58069,"OESAPA SELATAN, KELAPA LIMA, KOTA KUPANG, NUSA TENGGARA TIMUR",4,129,11,140
https://kawalpemilu.org#58069,"OESAPA SELATAN, KELAPA LIMA, KOTA KUPANG, NUSA TENGGARA TIMUR",5,117,18,135
https://kawalpemilu.org#58069,"OESAPA SELATAN, KELAPA LIMA, KOTA KUPANG, NUSA TENGGARA TIMUR",6,71,26,97
https://kawalpemilu.org#58069,"OESAPA SELATAN, KELAPA LIMA, KOTA KUPANG, NUSA TENGGARA TIMUR",7,60,7,67
https://kawalpemilu.org#58069,"OESAPA SELATAN, KELAPA LIMA, KOTA KUPANG, NUSA TENGGARA TIMUR",8,107,10,117
https://kawalpemilu.org#58069,"OESAPA SELATAN, KELAPA LIMA, KOTA KUPANG, NUSA TENGGARA TIMUR",9,94,8,102
https://kawalpemilu.org#58069,"OESAPA SELATAN, KELAPA LIMA, KOTA KUPANG, NUSA TENGGARA TIMUR",10,142,21,163
https://kawalpemilu.org#58069,"OESAPA SELATAN, KELAPA LIMA, KOTA KUPANG, NUSA TENGGARA TIMUR",11,115,1,116
https://kawalpemilu.org#58069,"OESAPA SELATAN, KELAPA LIMA, KOTA KUPANG, NUSA TENGGARA TIMUR",12,86,16,102
https://kawalpemilu.org#58069,"OESAPA SELATAN, KELAPA LIMA, KOTA KUPANG, NUSA TENGGARA TIMUR",13,148,15,163
https://kawalpemilu.org#58069,"OESAPA SELATAN, KELAPA LIMA, KOTA KUPANG, NUSA TENGGARA TIMUR",14,126,21,147
https://kawalpemilu.org#58069,"OESAPA SELATAN, KELAPA LIMA, KOTA KUPANG, NUSA TENGGARA TIMUR",15,58,39,97
https://kawalpemilu.org#58069,"OESAPA SELATAN, KELAPA LIMA, KOTA KUPANG, NUSA TENGGARA TIMUR",16,59,42,101
https://kawalpemilu.org#58069,"OESAPA SELATAN, KELAPA LIMA, KOTA KUPANG, NUSA TENGGARA TIMUR",17,68,30,98
https://kawalpemilu.org#58071,"OEBOBO, OEBOBO, KOTA KUPANG, NUSA TENGGARA TIMUR",1,196,5,201
https://kawalpemilu.org#58071,"OEBOBO, OEBOBO, KOTA KUPANG, NUSA TENGGARA TIMUR",2,210,18,228
https://kawalpemilu.org#58071,"OEBOBO, OEBOBO, KOTA KUPANG, NUSA TENGGARA TIMUR",3,164,22,186
https://kawalpemilu.org#58071,"OEBOBO, OEBOBO, KOTA KUPANG, NUSA TENGGARA TIMUR",4,122,15,138
https://kawalpemilu.org#58071,"OEBOBO, OEBOBO, KOTA KUPANG, NUSA TENGGARA TIMUR",5,121,43,164
https://kawalpemilu.org#58071,"OEBOBO, OEBOBO, KOTA KUPANG, NUSA TENGGARA TIMUR",6,180,35,215
https://kawalpemilu.org#58071,"OEBOBO, OEBOBO, KOTA KUPANG, NUSA TENGGARA TIMUR",7,126,23,149
https://kawalpemilu.org#58071,"OEBOBO, OEBOBO, KOTA KUPANG, NUSA TENGGARA TIMUR",8,146,9,155
https://kawalpemilu.org#58071,"OEBOBO, OEBOBO, KOTA KUPANG, NUSA TENGGARA TIMUR",9,150,5,155
https://kawalpemilu.org#58071,"OEBOBO, OEBOBO, KOTA KUPANG, NUSA TENGGARA TIMUR",10,182,8,190
https://kawalpemilu.org#58071,"OEBOBO, OEBOBO, KOTA KUPANG, NUSA TENGGARA TIMUR",11,111,5,116
https://kawalpemilu.org#58071,"OEBOBO, OEBOBO, KOTA KUPANG, NUSA TENGGARA TIMUR",12,179,6,185
https://kawalpemilu.org#58071,"OEBOBO, OEBOBO, KOTA KUPANG, NUSA TENGGARA TIMUR",13,222,16,0
https://kawalpemilu.org#58071,"OEBOBO, OEBOBO, KOTA KUPANG, NUSA TENGGARA TIMUR",14,178,15,193
https://kawalpemilu.org#58071,"OEBOBO, OEBOBO, KOTA KUPANG, NUSA TENGGARA TIMUR",15,155,2,157
https://kawalpemilu.org#58071,"OEBOBO, OEBOBO, KOTA KUPANG, NUSA TENGGARA TIMUR",16,150,14,164
https://kawalpemilu.org#58071,"OEBOBO, OEBOBO, KOTA KUPANG, NUSA TENGGARA TIMUR",17,135,10,145
https://kawalpemilu.org#58071,"OEBOBO, OEBOBO, KOTA KUPANG, NUSA TENGGARA TIMUR",18,99,18,117
https://kawalpemilu.org#58071,"OEBOBO, OEBOBO, KOTA KUPANG, NUSA TENGGARA TIMUR",19,171,40,211
https://kawalpemilu.org#58071,"OEBOBO, OEBOBO, KOTA KUPANG, NUSA TENGGARA TIMUR",20,219,12,231
https://kawalpemilu.org#58071,"OEBOBO, OEBOBO, KOTA KUPANG, NUSA TENGGARA TIMUR",21,227,19,246
https://kawalpemilu.org#58071,"OEBOBO, OEBOBO, KOTA KUPANG, NUSA TENGGARA TIMUR",22,223,13,236
https://kawalpemilu.org#58071,"OEBOBO, OEBOBO, KOTA KUPANG, NUSA TENGGARA TIMUR",23,227,17,244
https://kawalpemilu.org#58071,"OEBOBO, OEBOBO, KOTA KUPANG, NUSA TENGGARA TIMUR",24,195,6,201
https://kawalpemilu.org#58071,"OEBOBO, OEBOBO, KOTA KUPANG, NUSA TENGGARA TIMUR",25,159,17,176
https://kawalpemilu.org#58071,"OEBOBO, OEBOBO, KOTA KUPANG, NUSA TENGGARA TIMUR",26,145,10,155
https://kawalpemilu.org#58071,"OEBOBO, OEBOBO, KOTA KUPANG, NUSA TENGGARA TIMUR",27,175,22,197
https://kawalpemilu.org#58071,"OEBOBO, OEBOBO, KOTA KUPANG, NUSA TENGGARA TIMUR",28,150,4,154
https://kawalpemilu.org#58071,"OEBOBO, OEBOBO, KOTA KUPANG, NUSA TENGGARA TIMUR",29,131,16,147
https://kawalpemilu.org#58071,"OEBOBO, OEBOBO, KOTA KUPANG, NUSA TENGGARA TIMUR",30,158,5,163
https://kawalpemilu.org#58071,"OEBOBO, OEBOBO, KOTA KUPANG, NUSA TENGGARA TIMUR",31,192,2,194
https://kawalpemilu.org#58071,"OEBOBO, OEBOBO, KOTA KUPANG, NUSA TENGGARA TIMUR",32,120,5,125
https://kawalpemilu.org#58071,"OEBOBO, OEBOBO, KOTA KUPANG, NUSA TENGGARA TIMUR",33,180,7,187
https://kawalpemilu.org#58071,"OEBOBO, OEBOBO, KOTA KUPANG, NUSA TENGGARA TIMUR",34,183,5,188
https://kawalpemilu.org#58071,"OEBOBO, OEBOBO, KOTA KUPANG, NUSA TENGGARA TIMUR",35,165,4,169
https://kawalpemilu.org#58071,"OEBOBO, OEBOBO, KOTA KUPANG, NUSA TENGGARA TIMUR",36,154,10,164
https://kawalpemilu.org#58072,"OETETE, OEBOBO, KOTA KUPANG, NUSA TENGGARA TIMUR",1,168,19,187
https://kawalpemilu.org#58072,"OETETE, OEBOBO, KOTA KUPANG, NUSA TENGGARA TIMUR",2,162,15,177
https://kawalpemilu.org#58072,"OETETE, OEBOBO, KOTA KUPANG, NUSA TENGGARA TIMUR",3,203,5,208
https://kawalpemilu.org#58072,"OETETE, OEBOBO, KOTA KUPANG, NUSA TENGGARA TIMUR",4,177,12,189
https://kawalpemilu.org#58072,"OETETE, OEBOBO, KOTA KUPANG, NUSA TENGGARA TIMUR",5,211,5,216
https://kawalpemilu.org#58072,"OETETE, OEBOBO, KOTA KUPANG, NUSA TENGGARA TIMUR",6,179,7,186
https://kawalpemilu.org#58072,"OETETE, OEBOBO, KOTA KUPANG, NUSA TENGGARA TIMUR",7,253,22,275
https://kawalpemilu.org#58072,"OETETE, OEBOBO, KOTA KUPANG, NUSA TENGGARA TIMUR",8,176,13,189
https://kawalpemilu.org#58072,"OETETE, OEBOBO, KOTA KUPANG, NUSA TENGGARA TIMUR",9,141,14,155
https://kawalpemilu.org#58072,"OETETE, OEBOBO, KOTA KUPANG, NUSA TENGGARA TIMUR",10,160,10,170
https://kawalpemilu.org#58072,"OETETE, OEBOBO, KOTA KUPANG, NUSA TENGGARA TIMUR",11,131,10,141
https://kawalpemilu.org#58072,"OETETE, OEBOBO, KOTA KUPANG, NUSA TENGGARA TIMUR",12,252,35,287
https://kawalpemilu.org#58072,"OETETE, OEBOBO, KOTA KUPANG, NUSA TENGGARA TIMUR",13,265,10,275
https://kawalpemilu.org#58072,"OETETE, OEBOBO, KOTA KUPANG, NUSA TENGGARA TIMUR",14,115,15,130
https://kawalpemilu.org#58072,"OETETE, OEBOBO, KOTA KUPANG, NUSA TENGGARA TIMUR",15,129,14,143
https://kawalpemilu.org#58072,"OETETE, OEBOBO, KOTA KUPANG, NUSA TENGGARA TIMUR",16,231,13,244
https://kawalpemilu.org#58072,"OETETE, OEBOBO, KOTA KUPANG, NUSA TENGGARA TIMUR",17,188,4,192
https://kawalpemilu.org#58072,"OETETE, OEBOBO, KOTA KUPANG, NUSA TENGGARA TIMUR",18,201,2,203
https://kawalpemilu.org#58072,"OETETE, OEBOBO, KOTA KUPANG, NUSA TENGGARA TIMUR",19,123,9,132
https://kawalpemilu.org#58073,"OEBUFU, OEBOBO, KOTA KUPANG, NUSA TENGGARA TIMUR",1,135,29,164
https://kawalpemilu.org#58073,"OEBUFU, OEBOBO, KOTA KUPANG, NUSA TENGGARA TIMUR",2,155,9,164
https://kawalpemilu.org#58073,"OEBUFU, OEBOBO, KOTA KUPANG, NUSA TENGGARA TIMUR",4,259,14,273
https://kawalpemilu.org#58073,"OEBUFU, OEBOBO, KOTA KUPANG, NUSA TENGGARA TIMUR",5,172,22,194
https://kawalpemilu.org#58073,"OEBUFU, OEBOBO, KOTA KUPANG, NUSA TENGGARA TIMUR",6,183,10,193
https://kawalpemilu.org#58073,"OEBUFU, OEBOBO, KOTA KUPANG, NUSA TENGGARA TIMUR",7,160,3,163
https://kawalpemilu.org#58073,"OEBUFU, OEBOBO, KOTA KUPANG, NUSA TENGGARA TIMUR",8,237,11,248
https://kawalpemilu.org#58073,"OEBUFU, OEBOBO, KOTA KUPANG, NUSA TENGGARA TIMUR",9,259,6,265
https://kawalpemilu.org#58073,"OEBUFU, OEBOBO, KOTA KUPANG, NUSA TENGGARA TIMUR",10,233,13,246
https://kawalpemilu.org#58073,"OEBUFU, OEBOBO, KOTA KUPANG, NUSA TENGGARA TIMUR",12,139,5,144
https://kawalpemilu.org#58073,"OEBUFU, OEBOBO, KOTA KUPANG, NUSA TENGGARA TIMUR",13,98,6,104
https://kawalpemilu.org#58073,"OEBUFU, OEBOBO, KOTA KUPANG, NUSA TENGGARA TIMUR",15,118,36,154
https://kawalpemilu.org#58073,"OEBUFU, OEBOBO, KOTA KUPANG, NUSA TENGGARA TIMUR",16,87,11,98
https://kawalpemilu.org#58073,"OEBUFU, OEBOBO, KOTA KUPANG, NUSA TENGGARA TIMUR",17,146,16,162
https://kawalpemilu.org#58073,"OEBUFU, OEBOBO, KOTA KUPANG, NUSA TENGGARA TIMUR",18,69,40,109
https://kawalpemilu.org#58073,"OEBUFU, OEBOBO, KOTA KUPANG, NUSA TENGGARA TIMUR",19,116,4,120
https://kawalpemilu.org#58073,"OEBUFU, OEBOBO, KOTA KUPANG, NUSA TENGGARA TIMUR",20,132,29,161
https://kawalpemilu.org#58073,"OEBUFU, OEBOBO, KOTA KUPANG, NUSA TENGGARA TIMUR",21,191,35,226
https://kawalpemilu.org#58073,"OEBUFU, OEBOBO, KOTA KUPANG, NUSA TENGGARA TIMUR",22,140,65,205
https://kawalpemilu.org#58073,"OEBUFU, OEBOBO, KOTA KUPANG, NUSA TENGGARA TIMUR",23,198,24,222
https://kawalpemilu.org#58073,"OEBUFU, OEBOBO, KOTA KUPANG, NUSA TENGGARA TIMUR",24,254,49,303
https://kawalpemilu.org#58073,"OEBUFU, OEBOBO, KOTA KUPANG, NUSA TENGGARA TIMUR",25,243,13,256
https://kawalpemilu.org#58073,"OEBUFU, OEBOBO, KOTA KUPANG, NUSA TENGGARA TIMUR",26,145,15,160
https://kawalpemilu.org#58073,"OEBUFU, OEBOBO, KOTA KUPANG, NUSA TENGGARA TIMUR",27,120,9,129
https://kawalpemilu.org#58073,"OEBUFU, OEBOBO, KOTA KUPANG, NUSA TENGGARA TIMUR",28,172,17,189
https://kawalpemilu.org#58073,"OEBUFU, OEBOBO, KOTA KUPANG, NUSA TENGGARA TIMUR",29,201,5,206
https://kawalpemilu.org#58073,"OEBUFU, OEBOBO, KOTA KUPANG, NUSA TENGGARA TIMUR",30,155,9,164
https://kawalpemilu.org#58073,"OEBUFU, OEBOBO, KOTA KUPANG, NUSA TENGGARA TIMUR",31,101,10,111
https://kawalpemilu.org#58073,"OEBUFU, OEBOBO, KOTA KUPANG, NUSA TENGGARA TIMUR",32,174,9,183
https://kawalpemilu.org#58073,"OEBUFU, OEBOBO, KOTA KUPANG, NUSA TENGGARA TIMUR",33,145,7,152
https://kawalpemilu.org#58073,"OEBUFU, OEBOBO, KOTA KUPANG, NUSA TENGGARA TIMUR",34,142,22,164
https://kawalpemilu.org#58073,"OEBUFU, OEBOBO, KOTA KUPANG, NUSA TENGGARA TIMUR",35,141,10,151
https://kawalpemilu.org#58073,"OEBUFU, OEBOBO, KOTA KUPANG, NUSA TENGGARA TIMUR",37,120,13,133
https://kawalpemilu.org#58073,"OEBUFU, OEBOBO, KOTA KUPANG, NUSA TENGGARA TIMUR",38,155,15,170
https://kawalpemilu.org#58073,"OEBUFU, OEBOBO, KOTA KUPANG, NUSA TENGGARA TIMUR",39,93,11,104
https://kawalpemilu.org#58073,"OEBUFU, OEBOBO, KOTA KUPANG, NUSA TENGGARA TIMUR",40,179,9,188
https://kawalpemilu.org#58073,"OEBUFU, OEBOBO, KOTA KUPANG, NUSA TENGGARA TIMUR",41,180,15,195
https://kawalpemilu.org#58073,"OEBUFU, OEBOBO, KOTA KUPANG, NUSA TENGGARA TIMUR",42,151,9,160
https://kawalpemilu.org#58073,"OEBUFU, OEBOBO, KOTA KUPANG, NUSA TENGGARA TIMUR",43,134,9,143
https://kawalpemilu.org#58073,"OEBUFU, OEBOBO, KOTA KUPANG, NUSA TENGGARA TIMUR",44,107,4,111
https://kawalpemilu.org#58073,"OEBUFU, OEBOBO, KOTA KUPANG, NUSA TENGGARA TIMUR",45,225,5,230
https://kawalpemilu.org#58073,"OEBUFU, OEBOBO, KOTA KUPANG, NUSA TENGGARA TIMUR",46,87,13,100
https://kawalpemilu.org#58073,"OEBUFU, OEBOBO, KOTA KUPANG, NUSA TENGGARA TIMUR",47,125,28,153
https://kawalpemilu.org#58073,"OEBUFU, OEBOBO, KOTA KUPANG, NUSA TENGGARA TIMUR",48,208,27,235
https://kawalpemilu.org#58074,"LILIBA, OEBOBO, KOTA KUPANG, NUSA TENGGARA TIMUR",1,147,10,157
https://kawalpemilu.org#58074,"LILIBA, OEBOBO, KOTA KUPANG, NUSA TENGGARA TIMUR",2,150,12,162
https://kawalpemilu.org#58074,"LILIBA, OEBOBO, KOTA KUPANG, NUSA TENGGARA TIMUR",3,178,2,180
https://kawalpemilu.org#58074,"LILIBA, OEBOBO, KOTA KUPANG, NUSA TENGGARA TIMUR",4,172,5,177
https://kawalpemilu.org#58074,"LILIBA, OEBOBO, KOTA KUPANG, NUSA TENGGARA TIMUR",5,189,12,201
https://kawalpemilu.org#58074,"LILIBA, OEBOBO, KOTA KUPANG, NUSA TENGGARA TIMUR",6,172,11,183
https://kawalpemilu.org#58074,"LILIBA, OEBOBO, KOTA KUPANG, NUSA TENGGARA TIMUR",7,162,9,171
https://kawalpemilu.org#58074,"LILIBA, OEBOBO, KOTA KUPANG, NUSA TENGGARA TIMUR",8,173,10,183
https://kawalpemilu.org#58074,"LILIBA, OEBOBO, KOTA KUPANG, NUSA TENGGARA TIMUR",9,212,17,229
https://kawalpemilu.org#58074,"LILIBA, OEBOBO, KOTA KUPANG, NUSA TENGGARA TIMUR",10,168,7,175
https://kawalpemilu.org#58074,"LILIBA, OEBOBO, KOTA KUPANG, NUSA TENGGARA TIMUR",11,149,12,161
https://kawalpemilu.org#58074,"LILIBA, OEBOBO, KOTA KUPANG, NUSA TENGGARA TIMUR",12,220,7,227
https://kawalpemilu.org#58074,"LILIBA, OEBOBO, KOTA KUPANG, NUSA TENGGARA TIMUR",13,203,25,228
https://kawalpemilu.org#58074,"LILIBA, OEBOBO, KOTA KUPANG, NUSA TENGGARA TIMUR",14,186,7,193
https://kawalpemilu.org#58074,"LILIBA, OEBOBO, KOTA KUPANG, NUSA TENGGARA TIMUR",15,169,10,179
https://kawalpemilu.org#58074,"LILIBA, OEBOBO, KOTA KUPANG, NUSA TENGGARA TIMUR",16,168,15,183
https://kawalpemilu.org#58074,"LILIBA, OEBOBO, KOTA KUPANG, NUSA TENGGARA TIMUR",17,240,19,259
https://kawalpemilu.org#58074,"LILIBA, OEBOBO, KOTA KUPANG, NUSA TENGGARA TIMUR",18,211,24,235
https://kawalpemilu.org#58074,"LILIBA, OEBOBO, KOTA KUPANG, NUSA TENGGARA TIMUR",19,146,22,168
https://kawalpemilu.org#58074,"LILIBA, OEBOBO, KOTA KUPANG, NUSA TENGGARA TIMUR",20,162,11,173
https://kawalpemilu.org#58074,"LILIBA, OEBOBO, KOTA KUPANG, NUSA TENGGARA TIMUR",21,148,13,161
https://kawalpemilu.org#58074,"LILIBA, OEBOBO, KOTA KUPANG, NUSA TENGGARA TIMUR",22,145,6,151
https://kawalpemilu.org#58074,"LILIBA, OEBOBO, KOTA KUPANG, NUSA TENGGARA TIMUR",23,170,13,183
https://kawalpemilu.org#58074,"LILIBA, OEBOBO, KOTA KUPANG, NUSA TENGGARA TIMUR",24,138,5,143
https://kawalpemilu.org#58074,"LILIBA, OEBOBO, KOTA KUPANG, NUSA TENGGARA TIMUR",25,127,19,146
https://kawalpemilu.org#58074,"LILIBA, OEBOBO, KOTA KUPANG, NUSA TENGGARA TIMUR",26,117,22,139
https://kawalpemilu.org#58074,"LILIBA, OEBOBO, KOTA KUPANG, NUSA TENGGARA TIMUR",27,160,16,176
https://kawalpemilu.org#58074,"LILIBA, OEBOBO, KOTA KUPANG, NUSA TENGGARA TIMUR",28,169,13,182
https://kawalpemilu.org#58074,"LILIBA, OEBOBO, KOTA KUPANG, NUSA TENGGARA TIMUR",29,186,24,210
https://kawalpemilu.org#58074,"LILIBA, OEBOBO, KOTA KUPANG, NUSA TENGGARA TIMUR",30,159,18,177
https://kawalpemilu.org#58074,"LILIBA, OEBOBO, KOTA KUPANG, NUSA TENGGARA TIMUR",31,153,6,159
https://kawalpemilu.org#58074,"LILIBA, OEBOBO, KOTA KUPANG, NUSA TENGGARA TIMUR",32,133,14,147
https://kawalpemilu.org#58074,"LILIBA, OEBOBO, KOTA KUPANG, NUSA TENGGARA TIMUR",33,169,11,180
https://kawalpemilu.org#58074,"LILIBA, OEBOBO, KOTA KUPANG, NUSA TENGGARA TIMUR",34,137,17,154
https://kawalpemilu.org#58074,"LILIBA, OEBOBO, KOTA KUPANG, NUSA TENGGARA TIMUR",35,132,15,147
https://kawalpemilu.org#58074,"LILIBA, OEBOBO, KOTA KUPANG, NUSA TENGGARA TIMUR",36,138,5,143
https://kawalpemilu.org#58074,"LILIBA, OEBOBO, KOTA KUPANG, NUSA TENGGARA TIMUR",37,121,11,132
https://kawalpemilu.org#58074,"LILIBA, OEBOBO, KOTA KUPANG, NUSA TENGGARA TIMUR",38,148,9,157
https://kawalpemilu.org#58074,"LILIBA, OEBOBO, KOTA KUPANG, NUSA TENGGARA TIMUR",39,176,5,181
https://kawalpemilu.org#58074,"LILIBA, OEBOBO, KOTA KUPANG, NUSA TENGGARA TIMUR",40,153,20,173
https://kawalpemilu.org#58074,"LILIBA, OEBOBO, KOTA KUPANG, NUSA TENGGARA TIMUR",41,137,15,152
https://kawalpemilu.org#58074,"LILIBA, OEBOBO, KOTA KUPANG, NUSA TENGGARA TIMUR",42,131,20,151
https://kawalpemilu.org#58074,"LILIBA, OEBOBO, KOTA KUPANG, NUSA TENGGARA TIMUR",43,153,12,165
https://kawalpemilu.org#58074,"LILIBA, OEBOBO, KOTA KUPANG, NUSA TENGGARA TIMUR",44,206,18,224
https://kawalpemilu.org#58074,"LILIBA, OEBOBO, KOTA KUPANG, NUSA TENGGARA TIMUR",46,170,9,179
https://kawalpemilu.org#58075,"FATULULI, OEBOBO, KOTA KUPANG, NUSA TENGGARA TIMUR",1,129,7,136
https://kawalpemilu.org#58075,"FATULULI, OEBOBO, KOTA KUPANG, NUSA TENGGARA TIMUR",2,130,14,144
https://kawalpemilu.org#58075,"FATULULI, OEBOBO, KOTA KUPANG, NUSA TENGGARA TIMUR",3,146,4,150
https://kawalpemilu.org#58075,"FATULULI, OEBOBO, KOTA KUPANG, NUSA TENGGARA TIMUR",4,144,1,145
https://kawalpemilu.org#58075,"FATULULI, OEBOBO, KOTA KUPANG, NUSA TENGGARA TIMUR",5,175,12,187
https://kawalpemilu.org#58075,"FATULULI, OEBOBO, KOTA KUPANG, NUSA TENGGARA TIMUR",6,194,19,213
https://kawalpemilu.org#58075,"FATULULI, OEBOBO, KOTA KUPANG, NUSA TENGGARA TIMUR",7,191,28,219
https://kawalpemilu.org#58075,"FATULULI, OEBOBO, KOTA KUPANG, NUSA TENGGARA TIMUR",8,202,20,222
https://kawalpemilu.org#58075,"FATULULI, OEBOBO, KOTA KUPANG, NUSA TENGGARA TIMUR",9,206,23,229
https://kawalpemilu.org#58075,"FATULULI, OEBOBO, KOTA KUPANG, NUSA TENGGARA TIMUR",10,162,32,194
https://kawalpemilu.org#58075,"FATULULI, OEBOBO, KOTA KUPANG, NUSA TENGGARA TIMUR",11,203,11,214
https://kawalpemilu.org#58075,"FATULULI, OEBOBO, KOTA KUPANG, NUSA TENGGARA TIMUR",12,226,21,247
https://kawalpemilu.org#58075,"FATULULI, OEBOBO, KOTA KUPANG, NUSA TENGGARA TIMUR",13,158,26,184
https://kawalpemilu.org#58075,"FATULULI, OEBOBO, KOTA KUPANG, NUSA TENGGARA TIMUR",14,180,29,209
https://kawalpemilu.org#58075,"FATULULI, OEBOBO, KOTA KUPANG, NUSA TENGGARA TIMUR",15,204,19,223
https://kawalpemilu.org#58075,"FATULULI, OEBOBO, KOTA KUPANG, NUSA TENGGARA TIMUR",16,152,17,169
https://kawalpemilu.org#58075,"FATULULI, OEBOBO, KOTA KUPANG, NUSA TENGGARA TIMUR",17,166,15,181
https://kawalpemilu.org#58075,"FATULULI, OEBOBO, KOTA KUPANG, NUSA TENGGARA TIMUR",18,173,18,191
https://kawalpemilu.org#58075,"FATULULI, OEBOBO, KOTA KUPANG, NUSA TENGGARA TIMUR",19,174,15,189
https://kawalpemilu.org#58075,"FATULULI, OEBOBO, KOTA KUPANG, NUSA TENGGARA TIMUR",20,188,5,193
https://kawalpemilu.org#58075,"FATULULI, OEBOBO, KOTA KUPANG, NUSA TENGGARA TIMUR",21,182,9,191
https://kawalpemilu.org#58075,"FATULULI, OEBOBO, KOTA KUPANG, NUSA TENGGARA TIMUR",22,205,12,217
https://kawalpemilu.org#58075,"FATULULI, OEBOBO, KOTA KUPANG, NUSA TENGGARA TIMUR",23,182,12,194
https://kawalpemilu.org#58075,"FATULULI, OEBOBO, KOTA KUPANG, NUSA TENGGARA TIMUR",24,120,20,140
https://kawalpemilu.org#58075,"FATULULI, OEBOBO, KOTA KUPANG, NUSA TENGGARA TIMUR",25,132,13,145
https://kawalpemilu.org#58075,"FATULULI, OEBOBO, KOTA KUPANG, NUSA TENGGARA TIMUR",27,167,17,184
https://kawalpemilu.org#58075,"FATULULI, OEBOBO, KOTA KUPANG, NUSA TENGGARA TIMUR",28,145,8,153
https://kawalpemilu.org#58075,"FATULULI, OEBOBO, KOTA KUPANG, NUSA TENGGARA TIMUR",29,127,12,139
https://kawalpemilu.org#58075,"FATULULI, OEBOBO, KOTA KUPANG, NUSA TENGGARA TIMUR",30,130,29,159
https://kawalpemilu.org#58075,"FATULULI, OEBOBO, KOTA KUPANG, NUSA TENGGARA TIMUR",31,127,13,140
https://kawalpemilu.org#58075,"FATULULI, OEBOBO, KOTA KUPANG, NUSA TENGGARA TIMUR",32,108,8,116
https://kawalpemilu.org#58075,"FATULULI, OEBOBO, KOTA KUPANG, NUSA TENGGARA TIMUR",33,198,20,218
https://kawalpemilu.org#58075,"FATULULI, OEBOBO, KOTA KUPANG, NUSA TENGGARA TIMUR",34,163,7,170
https://kawalpemilu.org#58075,"FATULULI, OEBOBO, KOTA KUPANG, NUSA TENGGARA TIMUR",35,182,39,221
https://kawalpemilu.org#58075,"FATULULI, OEBOBO, KOTA KUPANG, NUSA TENGGARA TIMUR",36,119,22,141
https://kawalpemilu.org#58075,"FATULULI, OEBOBO, KOTA KUPANG, NUSA TENGGARA TIMUR",37,196,56,252
https://kawalpemilu.org#58075,"FATULULI, OEBOBO, KOTA KUPANG, NUSA TENGGARA TIMUR",38,109,53,162
https://kawalpemilu.org#58075,"FATULULI, OEBOBO, KOTA KUPANG, NUSA TENGGARA TIMUR",39,198,24,222
https://kawalpemilu.org#58075,"FATULULI, OEBOBO, KOTA KUPANG, NUSA TENGGARA TIMUR",40,164,18,182
https://kawalpemilu.org#58075,"FATULULI, OEBOBO, KOTA KUPANG, NUSA TENGGARA TIMUR",41,37,5,42
https://kawalpemilu.org#58075,"FATULULI, OEBOBO, KOTA KUPANG, NUSA TENGGARA TIMUR",42,99,7,106
https://kawalpemilu.org#58075,"FATULULI, OEBOBO, KOTA KUPANG, NUSA TENGGARA TIMUR",43,67,0,67
https://kawalpemilu.org#58075,"FATULULI, OEBOBO, KOTA KUPANG, NUSA TENGGARA TIMUR",44,115,20,135
https://kawalpemilu.org#58075,"FATULULI, OEBOBO, KOTA KUPANG, NUSA TENGGARA TIMUR",45,97,14,111
https://kawalpemilu.org#58075,"FATULULI, OEBOBO, KOTA KUPANG, NUSA TENGGARA TIMUR",46,122,7,129
https://kawalpemilu.org#58075,"FATULULI, OEBOBO, KOTA KUPANG, NUSA TENGGARA TIMUR",47,107,15,122
https://kawalpemilu.org#58076,"KAYU PUTIH, OEBOBO, KOTA KUPANG, NUSA TENGGARA TIMUR",1,129,10,139
https://kawalpemilu.org#58076,"KAYU PUTIH, OEBOBO, KOTA KUPANG, NUSA TENGGARA TIMUR",2,158,22,180
https://kawalpemilu.org#58076,"KAYU PUTIH, OEBOBO, KOTA KUPANG, NUSA TENGGARA TIMUR",3,220,21,241
https://kawalpemilu.org#58076,"KAYU PUTIH, OEBOBO, KOTA KUPANG, NUSA TENGGARA TIMUR",4,103,1,104
https://kawalpemilu.org#58076,"KAYU PUTIH, OEBOBO, KOTA KUPANG, NUSA TENGGARA TIMUR",5,171,11,182
https://kawalpemilu.org#58076,"KAYU PUTIH, OEBOBO, KOTA KUPANG, NUSA TENGGARA TIMUR",6,169,34,203
https://kawalpemilu.org#58076,"KAYU PUTIH, OEBOBO, KOTA KUPANG, NUSA TENGGARA TIMUR",7,241,22,263
https://kawalpemilu.org#58076,"KAYU PUTIH, OEBOBO, KOTA KUPANG, NUSA TENGGARA TIMUR",8,226,43,269
https://kawalpemilu.org#58076,"KAYU PUTIH, OEBOBO, KOTA KUPANG, NUSA TENGGARA TIMUR",9,242,33,275
https://kawalpemilu.org#58076,"KAYU PUTIH, OEBOBO, KOTA KUPANG, NUSA TENGGARA TIMUR",11,87,42,129
https://kawalpemilu.org#58076,"KAYU PUTIH, OEBOBO, KOTA KUPANG, NUSA TENGGARA TIMUR",12,23,49,72
https://kawalpemilu.org#58076,"KAYU PUTIH, OEBOBO, KOTA KUPANG, NUSA TENGGARA TIMUR",13,59,41,100
https://kawalpemilu.org#58076,"KAYU PUTIH, OEBOBO, KOTA KUPANG, NUSA TENGGARA TIMUR",14,49,64,113
https://kawalpemilu.org#58076,"KAYU PUTIH, OEBOBO, KOTA KUPANG, NUSA TENGGARA TIMUR",15,165,25,190
https://kawalpemilu.org#58076,"KAYU PUTIH, OEBOBO, KOTA KUPANG, NUSA TENGGARA TIMUR",16,133,22,155
https://kawalpemilu.org#58076,"KAYU PUTIH, OEBOBO, KOTA KUPANG, NUSA TENGGARA TIMUR",17,120,22,142
https://kawalpemilu.org#58076,"KAYU PUTIH, OEBOBO, KOTA KUPANG, NUSA TENGGARA TIMUR",18,84,26,110
https://kawalpemilu.org#58076,"KAYU PUTIH, OEBOBO, KOTA KUPANG, NUSA TENGGARA TIMUR",19,158,17,175
https://kawalpemilu.org#58076,"KAYU PUTIH, OEBOBO, KOTA KUPANG, NUSA TENGGARA TIMUR",20,83,51,134
https://kawalpemilu.org#58076,"KAYU PUTIH, OEBOBO, KOTA KUPANG, NUSA TENGGARA TIMUR",21,177,33,210
https://kawalpemilu.org#58076,"KAYU PUTIH, OEBOBO, KOTA KUPANG, NUSA TENGGARA TIMUR",22,112,58,170
https://kawalpemilu.org#58076,"KAYU PUTIH, OEBOBO, KOTA KUPANG, NUSA TENGGARA TIMUR",23,86,87,173
https://kawalpemilu.org#58076,"KAYU PUTIH, OEBOBO, KOTA KUPANG, NUSA TENGGARA TIMUR",24,159,22,181
https://kawalpemilu.org#58076,"KAYU PUTIH, OEBOBO, KOTA KUPANG, NUSA TENGGARA TIMUR",25,110,75,185
https://kawalpemilu.org#58076,"KAYU PUTIH, OEBOBO, KOTA KUPANG, NUSA TENGGARA TIMUR",26,61,134,195
https://kawalpemilu.org#58076,"KAYU PUTIH, OEBOBO, KOTA KUPANG, NUSA TENGGARA TIMUR",27,65,112,177
https://kawalpemilu.org#58076,"KAYU PUTIH, OEBOBO, KOTA KUPANG, NUSA TENGGARA TIMUR",28,131,14,145
https://kawalpemilu.org#58076,"KAYU PUTIH, OEBOBO, KOTA KUPANG, NUSA TENGGARA TIMUR",29,135,14,149
https://kawalpemilu.org#58076,"KAYU PUTIH, OEBOBO, KOTA KUPANG, NUSA TENGGARA TIMUR",30,221,13,234
https://kawalpemilu.org#58076,"KAYU PUTIH, OEBOBO, KOTA KUPANG, NUSA TENGGARA TIMUR",31,135,5,140
https://kawalpemilu.org#58076,"KAYU PUTIH, OEBOBO, KOTA KUPANG, NUSA TENGGARA TIMUR",32,147,9,156
https://kawalpemilu.org#58077,"TUAK DAUN MERAH, OEBOBO, KOTA KUPANG, NUSA TENGGARA TIMUR",1,233,30,263
https://kawalpemilu.org#58077,"TUAK DAUN MERAH, OEBOBO, KOTA KUPANG, NUSA TENGGARA TIMUR",2,149,15,164
https://kawalpemilu.org#58077,"TUAK DAUN MERAH, OEBOBO, KOTA KUPANG, NUSA TENGGARA TIMUR",3,185,36,221
https://kawalpemilu.org#58077,"TUAK DAUN MERAH, OEBOBO, KOTA KUPANG, NUSA TENGGARA TIMUR",4,122,47,169
https://kawalpemilu.org#58077,"TUAK DAUN MERAH, OEBOBO, KOTA KUPANG, NUSA TENGGARA TIMUR",5,79,40,119
https://kawalpemilu.org#58077,"TUAK DAUN MERAH, OEBOBO, KOTA KUPANG, NUSA TENGGARA TIMUR",6,161,23,184
https://kawalpemilu.org#58077,"TUAK DAUN MERAH, OEBOBO, KOTA KUPANG, NUSA TENGGARA TIMUR",7,109,23,132
https://kawalpemilu.org#58077,"TUAK DAUN MERAH, OEBOBO, KOTA KUPANG, NUSA TENGGARA TIMUR",8,96,17,113
https://kawalpemilu.org#58077,"TUAK DAUN MERAH, OEBOBO, KOTA KUPANG, NUSA TENGGARA TIMUR",9,190,16,206
https://kawalpemilu.org#58077,"TUAK DAUN MERAH, OEBOBO, KOTA KUPANG, NUSA TENGGARA TIMUR",10,82,4,86
https://kawalpemilu.org#58077,"TUAK DAUN MERAH, OEBOBO, KOTA KUPANG, NUSA TENGGARA TIMUR",11,181,13,194
https://kawalpemilu.org#58077,"TUAK DAUN MERAH, OEBOBO, KOTA KUPANG, NUSA TENGGARA TIMUR",12,130,2,132
https://kawalpemilu.org#58077,"TUAK DAUN MERAH, OEBOBO, KOTA KUPANG, NUSA TENGGARA TIMUR",13,146,7,153
https://kawalpemilu.org#58077,"TUAK DAUN MERAH, OEBOBO, KOTA KUPANG, NUSA TENGGARA TIMUR",14,263,5,268
https://kawalpemilu.org#58077,"TUAK DAUN MERAH, OEBOBO, KOTA KUPANG, NUSA TENGGARA TIMUR",15,224,21,245
https://kawalpemilu.org#58077,"TUAK DAUN MERAH, OEBOBO, KOTA KUPANG, NUSA TENGGARA TIMUR",16,178,5,183
https://kawalpemilu.org#58077,"TUAK DAUN MERAH, OEBOBO, KOTA KUPANG, NUSA TENGGARA TIMUR",17,151,12,163
https://kawalpemilu.org#58077,"TUAK DAUN MERAH, OEBOBO, KOTA KUPANG, NUSA TENGGARA TIMUR",18,177,20,197
https://kawalpemilu.org#58077,"TUAK DAUN MERAH, OEBOBO, KOTA KUPANG, NUSA TENGGARA TIMUR",19,133,20,153
https://kawalpemilu.org#58077,"TUAK DAUN MERAH, OEBOBO, KOTA KUPANG, NUSA TENGGARA TIMUR",20,117,23,140
https://kawalpemilu.org#58077,"TUAK DAUN MERAH, OEBOBO, KOTA KUPANG, NUSA TENGGARA TIMUR",21,134,21,155
https://kawalpemilu.org#58077,"TUAK DAUN MERAH, OEBOBO, KOTA KUPANG, NUSA TENGGARA TIMUR",22,132,17,149
https://kawalpemilu.org#58077,"TUAK DAUN MERAH, OEBOBO, KOTA KUPANG, NUSA TENGGARA TIMUR",23,203,21,224
https://kawalpemilu.org#58077,"TUAK DAUN MERAH, OEBOBO, KOTA KUPANG, NUSA TENGGARA TIMUR",24,153,33,186
https://kawalpemilu.org#58077,"TUAK DAUN MERAH, OEBOBO, KOTA KUPANG, NUSA TENGGARA TIMUR",25,135,11,146
https://kawalpemilu.org#58077,"TUAK DAUN MERAH, OEBOBO, KOTA KUPANG, NUSA TENGGARA TIMUR",26,126,36,162
https://kawalpemilu.org#58077,"TUAK DAUN MERAH, OEBOBO, KOTA KUPANG, NUSA TENGGARA TIMUR",27,151,36,187
https://kawalpemilu.org#58080,"BAKUNASE, KOTA RAJA, KOTA KUPANG, NUSA TENGGARA TIMUR",1,93,20,113
https://kawalpemilu.org#58080,"BAKUNASE, KOTA RAJA, KOTA KUPANG, NUSA TENGGARA TIMUR",2,182,23,205
https://kawalpemilu.org#58080,"BAKUNASE, KOTA RAJA, KOTA KUPANG, NUSA TENGGARA TIMUR",3,241,15,256
https://kawalpemilu.org#58080,"BAKUNASE, KOTA RAJA, KOTA KUPANG, NUSA TENGGARA TIMUR",4,141,12,153
https://kawalpemilu.org#58080,"BAKUNASE, KOTA RAJA, KOTA KUPANG, NUSA TENGGARA TIMUR",5,119,13,132
https://kawalpemilu.org#58080,"BAKUNASE, KOTA RAJA, KOTA KUPANG, NUSA TENGGARA TIMUR",6,165,6,171
https://kawalpemilu.org#58080,"BAKUNASE, KOTA RAJA, KOTA KUPANG, NUSA TENGGARA TIMUR",7,175,11,186
https://kawalpemilu.org#58080,"BAKUNASE, KOTA RAJA, KOTA KUPANG, NUSA TENGGARA TIMUR",8,159,7,166
https://kawalpemilu.org#58080,"BAKUNASE, KOTA RAJA, KOTA KUPANG, NUSA TENGGARA TIMUR",9,149,4,153
https://kawalpemilu.org#58080,"BAKUNASE, KOTA RAJA, KOTA KUPANG, NUSA TENGGARA TIMUR",10,196,37,233
https://kawalpemilu.org#58080,"BAKUNASE, KOTA RAJA, KOTA KUPANG, NUSA TENGGARA TIMUR",11,157,6,163
https://kawalpemilu.org#58080,"BAKUNASE, KOTA RAJA, KOTA KUPANG, NUSA TENGGARA TIMUR",12,104,10,114
https://kawalpemilu.org#58080,"BAKUNASE, KOTA RAJA, KOTA KUPANG, NUSA TENGGARA TIMUR",13,141,2,143
https://kawalpemilu.org#58080,"BAKUNASE, KOTA RAJA, KOTA KUPANG, NUSA TENGGARA TIMUR",14,192,22,214
https://kawalpemilu.org#58080,"BAKUNASE, KOTA RAJA, KOTA KUPANG, NUSA TENGGARA TIMUR",15,125,4,129
https://kawalpemilu.org#58080,"BAKUNASE, KOTA RAJA, KOTA KUPANG, NUSA TENGGARA TIMUR",16,206,34,240
https://kawalpemilu.org#58081,"AIRNONA, KOTA RAJA, KOTA KUPANG, NUSA TENGGARA TIMUR",1,246,23,269
https://kawalpemilu.org#58081,"AIRNONA, KOTA RAJA, KOTA KUPANG, NUSA TENGGARA TIMUR",2,226,13,239
https://kawalpemilu.org#58081,"AIRNONA, KOTA RAJA, KOTA KUPANG, NUSA TENGGARA TIMUR",3,163,12,175
https://kawalpemilu.org#58081,"AIRNONA, KOTA RAJA, KOTA KUPANG, NUSA TENGGARA TIMUR",4,148,16,164
https://kawalpemilu.org#58081,"AIRNONA, KOTA RAJA, KOTA KUPANG, NUSA TENGGARA TIMUR",5,243,9,252
https://kawalpemilu.org#58081,"AIRNONA, KOTA RAJA, KOTA KUPANG, NUSA TENGGARA TIMUR",6,226,5,231
https://kawalpemilu.org#58081,"AIRNONA, KOTA RAJA, KOTA KUPANG, NUSA TENGGARA TIMUR",7,190,14,204
https://kawalpemilu.org#58081,"AIRNONA, KOTA RAJA, KOTA KUPANG, NUSA TENGGARA TIMUR",8,183,16,199
https://kawalpemilu.org#58081,"AIRNONA, KOTA RAJA, KOTA KUPANG, NUSA TENGGARA TIMUR",9,158,11,169
https://kawalpemilu.org#58081,"AIRNONA, KOTA RAJA, KOTA KUPANG, NUSA TENGGARA TIMUR",10,189,5,194
https://kawalpemilu.org#58081,"AIRNONA, KOTA RAJA, KOTA KUPANG, NUSA TENGGARA TIMUR",11,235,22,257
https://kawalpemilu.org#58081,"AIRNONA, KOTA RAJA, KOTA KUPANG, NUSA TENGGARA TIMUR",12,219,17,236
https://kawalpemilu.org#58081,"AIRNONA, KOTA RAJA, KOTA KUPANG, NUSA TENGGARA TIMUR",13,166,1,167
https://kawalpemilu.org#58081,"AIRNONA, KOTA RAJA, KOTA KUPANG, NUSA TENGGARA TIMUR",14,190,4,194
https://kawalpemilu.org#58081,"AIRNONA, KOTA RAJA, KOTA KUPANG, NUSA TENGGARA TIMUR",15,230,6,236
https://kawalpemilu.org#58081,"AIRNONA, KOTA RAJA, KOTA KUPANG, NUSA TENGGARA TIMUR",16,234,5,239
https://kawalpemilu.org#58081,"AIRNONA, KOTA RAJA, KOTA KUPANG, NUSA TENGGARA TIMUR",17,202,10,212
https://kawalpemilu.org#58081,"AIRNONA, KOTA RAJA, KOTA KUPANG, NUSA TENGGARA TIMUR",18,113,10,123
https://kawalpemilu.org#58081,"AIRNONA, KOTA RAJA, KOTA KUPANG, NUSA TENGGARA TIMUR",19,189,5,194
https://kawalpemilu.org#58081,"AIRNONA, KOTA RAJA, KOTA KUPANG, NUSA TENGGARA TIMUR",20,132,14,146
https://kawalpemilu.org#58081,"AIRNONA, KOTA RAJA, KOTA KUPANG, NUSA TENGGARA TIMUR",21,165,12,177
https://kawalpemilu.org#58082,"NAIKOTEN SATU, KOTA RAJA, KOTA KUPANG, NUSA TENGGARA TIMUR",1,164,20,184
https://kawalpemilu.org#58082,"NAIKOTEN SATU, KOTA RAJA, KOTA KUPANG, NUSA TENGGARA TIMUR",2,132,9,141
https://kawalpemilu.org#58082,"NAIKOTEN SATU, KOTA RAJA, KOTA KUPANG, NUSA TENGGARA TIMUR",3,89,14,103
https://kawalpemilu.org#58082,"NAIKOTEN SATU, KOTA RAJA, KOTA KUPANG, NUSA TENGGARA TIMUR",4,142,10,152
https://kawalpemilu.org#58082,"NAIKOTEN SATU, KOTA RAJA, KOTA KUPANG, NUSA TENGGARA TIMUR",5,143,18,161
https://kawalpemilu.org#58082,"NAIKOTEN SATU, KOTA RAJA, KOTA KUPANG, NUSA TENGGARA TIMUR",6,178,11,189
https://kawalpemilu.org#58082,"NAIKOTEN SATU, KOTA RAJA, KOTA KUPANG, NUSA TENGGARA TIMUR",7,237,22,259
https://kawalpemilu.org#58082,"NAIKOTEN SATU, KOTA RAJA, KOTA KUPANG, NUSA TENGGARA TIMUR",8,176,42,218
https://kawalpemilu.org#58082,"NAIKOTEN SATU, KOTA RAJA, KOTA KUPANG, NUSA TENGGARA TIMUR",9,146,6,152
https://kawalpemilu.org#58082,"NAIKOTEN SATU, KOTA RAJA, KOTA KUPANG, NUSA TENGGARA TIMUR",10,116,7,123
https://kawalpemilu.org#58082,"NAIKOTEN SATU, KOTA RAJA, KOTA KUPANG, NUSA TENGGARA TIMUR",11,120,16,136
https://kawalpemilu.org#58082,"NAIKOTEN SATU, KOTA RAJA, KOTA KUPANG, NUSA TENGGARA TIMUR",12,130,10,140
https://kawalpemilu.org#58082,"NAIKOTEN SATU, KOTA RAJA, KOTA KUPANG, NUSA TENGGARA TIMUR",13,142,6,148
https://kawalpemilu.org#58082,"NAIKOTEN SATU, KOTA RAJA, KOTA KUPANG, NUSA TENGGARA TIMUR",14,161,6,167
https://kawalpemilu.org#58082,"NAIKOTEN SATU, KOTA RAJA, KOTA KUPANG, NUSA TENGGARA TIMUR",15,160,9,169
https://kawalpemilu.org#58082,"NAIKOTEN SATU, KOTA RAJA, KOTA KUPANG, NUSA TENGGARA TIMUR",16,211,11,222
https://kawalpemilu.org#58082,"NAIKOTEN SATU, KOTA RAJA, KOTA KUPANG, NUSA TENGGARA TIMUR",17,209,17,226
https://kawalpemilu.org#58082,"NAIKOTEN SATU, KOTA RAJA, KOTA KUPANG, NUSA TENGGARA TIMUR",18,111,9,120
https://kawalpemilu.org#58082,"NAIKOTEN SATU, KOTA RAJA, KOTA KUPANG, NUSA TENGGARA TIMUR",19,84,25,109
https://kawalpemilu.org#58082,"NAIKOTEN SATU, KOTA RAJA, KOTA KUPANG, NUSA TENGGARA TIMUR",20,98,26,124
https://kawalpemilu.org#58082,"NAIKOTEN SATU, KOTA RAJA, KOTA KUPANG, NUSA TENGGARA TIMUR",21,163,41,204
https://kawalpemilu.org#58082,"NAIKOTEN SATU, KOTA RAJA, KOTA KUPANG, NUSA TENGGARA TIMUR",22,85,31,116
https://kawalpemilu.org#58082,"NAIKOTEN SATU, KOTA RAJA, KOTA KUPANG, NUSA TENGGARA TIMUR",23,128,40,168
https://kawalpemilu.org#58082,"NAIKOTEN SATU, KOTA RAJA, KOTA KUPANG, NUSA TENGGARA TIMUR",24,127,42,169
https://kawalpemilu.org#58082,"NAIKOTEN SATU, KOTA RAJA, KOTA KUPANG, NUSA TENGGARA TIMUR",25,60,57,117
https://kawalpemilu.org#58082,"NAIKOTEN SATU, KOTA RAJA, KOTA KUPANG, NUSA TENGGARA TIMUR",26,55,42,97
https://kawalpemilu.org#58082,"NAIKOTEN SATU, KOTA RAJA, KOTA KUPANG, NUSA TENGGARA TIMUR",28,147,7,154
https://kawalpemilu.org#58082,"NAIKOTEN SATU, KOTA RAJA, KOTA KUPANG, NUSA TENGGARA TIMUR",29,259,16,275
https://kawalpemilu.org#58082,"NAIKOTEN SATU, KOTA RAJA, KOTA KUPANG, NUSA TENGGARA TIMUR",30,208,36,244
https://kawalpemilu.org#58082,"NAIKOTEN SATU, KOTA RAJA, KOTA KUPANG, NUSA TENGGARA TIMUR",31,164,12,176
https://kawalpemilu.org#58082,"NAIKOTEN SATU, KOTA RAJA, KOTA KUPANG, NUSA TENGGARA TIMUR",32,175,22,197
https://kawalpemilu.org#58082,"NAIKOTEN SATU, KOTA RAJA, KOTA KUPANG, NUSA TENGGARA TIMUR",33,206,9,215
https://kawalpemilu.org#58083,"NAIKOTEN DUA, KOTA RAJA, KOTA KUPANG, NUSA TENGGARA TIMUR",1,134,7,141
https://kawalpemilu.org#58083,"NAIKOTEN DUA, KOTA RAJA, KOTA KUPANG, NUSA TENGGARA TIMUR",2,160,5,165
https://kawalpemilu.org#58083,"NAIKOTEN DUA, KOTA RAJA, KOTA KUPANG, NUSA TENGGARA TIMUR",3,163,26,189
https://kawalpemilu.org#58083,"NAIKOTEN DUA, KOTA RAJA, KOTA KUPANG, NUSA TENGGARA TIMUR",4,191,14,205
https://kawalpemilu.org#58083,"NAIKOTEN DUA, KOTA RAJA, KOTA KUPANG, NUSA TENGGARA TIMUR",5,192,18,210
https://kawalpemilu.org#58083,"NAIKOTEN DUA, KOTA RAJA, KOTA KUPANG, NUSA TENGGARA TIMUR",6,95,5,100
https://kawalpemilu.org#58083,"NAIKOTEN DUA, KOTA RAJA, KOTA KUPANG, NUSA TENGGARA TIMUR",7,113,17,130
https://kawalpemilu.org#58083,"NAIKOTEN DUA, KOTA RAJA, KOTA KUPANG, NUSA TENGGARA TIMUR",9,144,14,158
https://kawalpemilu.org#58084,"KUANINO, KOTA RAJA, KOTA KUPANG, NUSA TENGGARA TIMUR",1,172,33,205
https://kawalpemilu.org#58084,"KUANINO, KOTA RAJA, KOTA KUPANG, NUSA TENGGARA TIMUR",2,143,3,146
https://kawalpemilu.org#58084,"KUANINO, KOTA RAJA, KOTA KUPANG, NUSA TENGGARA TIMUR",3,173,9,182
https://kawalpemilu.org#58084,"KUANINO, KOTA RAJA, KOTA KUPANG, NUSA TENGGARA TIMUR",4,164,17,181
https://kawalpemilu.org#58084,"KUANINO, KOTA RAJA, KOTA KUPANG, NUSA TENGGARA TIMUR",5,120,8,128
https://kawalpemilu.org#58084,"KUANINO, KOTA RAJA, KOTA KUPANG, NUSA TENGGARA TIMUR",6,140,13,153
https://kawalpemilu.org#58084,"KUANINO, KOTA RAJA, KOTA KUPANG, NUSA TENGGARA TIMUR",7,168,13,181
https://kawalpemilu.org#58084,"KUANINO, KOTA RAJA, KOTA KUPANG, NUSA TENGGARA TIMUR",8,92,3,95
https://kawalpemilu.org#58084,"KUANINO, KOTA RAJA, KOTA KUPANG, NUSA TENGGARA TIMUR",9,205,23,228
https://kawalpemilu.org#58084,"KUANINO, KOTA RAJA, KOTA KUPANG, NUSA TENGGARA TIMUR",10,241,10,251
https://kawalpemilu.org#58084,"KUANINO, KOTA RAJA, KOTA KUPANG, NUSA TENGGARA TIMUR",11,205,16,221
https://kawalpemilu.org#58084,"KUANINO, KOTA RAJA, KOTA KUPANG, NUSA TENGGARA TIMUR",12,130,8,138
https://kawalpemilu.org#58084,"KUANINO, KOTA RAJA, KOTA KUPANG, NUSA TENGGARA TIMUR",13,144,9,153
https://kawalpemilu.org#58084,"KUANINO, KOTA RAJA, KOTA KUPANG, NUSA TENGGARA TIMUR",14,107,10,117
https://kawalpemilu.org#58084,"KUANINO, KOTA RAJA, KOTA KUPANG, NUSA TENGGARA TIMUR",15,211,6,217
https://kawalpemilu.org#58084,"KUANINO, KOTA RAJA, KOTA KUPANG, NUSA TENGGARA TIMUR",16,143,9,152
https://kawalpemilu.org#58084,"KUANINO, KOTA RAJA, KOTA KUPANG, NUSA TENGGARA TIMUR",18,118,8,126
https://kawalpemilu.org#58084,"KUANINO, KOTA RAJA, KOTA KUPANG, NUSA TENGGARA TIMUR",19,195,25,220
https://kawalpemilu.org#58084,"KUANINO, KOTA RAJA, KOTA KUPANG, NUSA TENGGARA TIMUR",20,62,125,187
https://kawalpemilu.org#58084,"KUANINO, KOTA RAJA, KOTA KUPANG, NUSA TENGGARA TIMUR",21,39,88,127
https://kawalpemilu.org#58084,"KUANINO, KOTA RAJA, KOTA KUPANG, NUSA TENGGARA TIMUR",22,23,57,80
https://kawalpemilu.org#58085,"NUNLEU, KOTA RAJA, KOTA KUPANG, NUSA TENGGARA TIMUR",1,185,22,207
https://kawalpemilu.org#58085,"NUNLEU, KOTA RAJA, KOTA KUPANG, NUSA TENGGARA TIMUR",2,248,12,260
https://kawalpemilu.org#58085,"NUNLEU, KOTA RAJA, KOTA KUPANG, NUSA TENGGARA TIMUR",3,193,10,203
https://kawalpemilu.org#58085,"NUNLEU, KOTA RAJA, KOTA KUPANG, NUSA TENGGARA TIMUR",4,137,10,147
https://kawalpemilu.org#58085,"NUNLEU, KOTA RAJA, KOTA KUPANG, NUSA TENGGARA TIMUR",5,230,5,235
https://kawalpemilu.org#58085,"NUNLEU, KOTA RAJA, KOTA KUPANG, NUSA TENGGARA TIMUR",6,127,6,133
https://kawalpemilu.org#58085,"NUNLEU, KOTA RAJA, KOTA KUPANG, NUSA TENGGARA TIMUR",7,127,9,136
https://kawalpemilu.org#58085,"NUNLEU, KOTA RAJA, KOTA KUPANG, NUSA TENGGARA TIMUR",8,148,0,148
https://kawalpemilu.org#58085,"NUNLEU, KOTA RAJA, KOTA KUPANG, NUSA TENGGARA TIMUR",9,154,7,161
https://kawalpemilu.org#58085,"NUNLEU, KOTA RAJA, KOTA KUPANG, NUSA TENGGARA TIMUR",10,153,8,161
https://kawalpemilu.org#58085,"NUNLEU, KOTA RAJA, KOTA KUPANG, NUSA TENGGARA TIMUR",11,162,13,175
https://kawalpemilu.org#58085,"NUNLEU, KOTA RAJA, KOTA KUPANG, NUSA TENGGARA TIMUR",12,200,17,217
https://kawalpemilu.org#58085,"NUNLEU, KOTA RAJA, KOTA KUPANG, NUSA TENGGARA TIMUR",13,172,18,190
https://kawalpemilu.org#58085,"NUNLEU, KOTA RAJA, KOTA KUPANG, NUSA TENGGARA TIMUR",15,232,6,238
https://kawalpemilu.org#58086,"FONTEIN, KOTA RAJA, KOTA KUPANG, NUSA TENGGARA TIMUR",1,122,66,188
https://kawalpemilu.org#58086,"FONTEIN, KOTA RAJA, KOTA KUPANG, NUSA TENGGARA TIMUR",2,145,7,152
https://kawalpemilu.org#58086,"FONTEIN, KOTA RAJA, KOTA KUPANG, NUSA TENGGARA TIMUR",3,154,7,161
https://kawalpemilu.org#58086,"FONTEIN, KOTA RAJA, KOTA KUPANG, NUSA TENGGARA TIMUR",4,214,7,221
https://kawalpemilu.org#58086,"FONTEIN, KOTA RAJA, KOTA KUPANG, NUSA TENGGARA TIMUR",5,219,4,223
https://kawalpemilu.org#58086,"FONTEIN, KOTA RAJA, KOTA KUPANG, NUSA TENGGARA TIMUR",6,221,6,227
https://kawalpemilu.org#58086,"FONTEIN, KOTA RAJA, KOTA KUPANG, NUSA TENGGARA TIMUR",7,195,16,211
https://kawalpemilu.org#58086,"FONTEIN, KOTA RAJA, KOTA KUPANG, NUSA TENGGARA TIMUR",8,119,9,128
https://kawalpemilu.org#58086,"FONTEIN, KOTA RAJA, KOTA KUPANG, NUSA TENGGARA TIMUR",9,119,10,129
https://kawalpemilu.org#58086,"FONTEIN, KOTA RAJA, KOTA KUPANG, NUSA TENGGARA TIMUR",10,156,14,170
https://kawalpemilu.org#58086,"FONTEIN, KOTA RAJA, KOTA KUPANG, NUSA TENGGARA TIMUR",11,104,34,138
https://kawalpemilu.org#58086,"FONTEIN, KOTA RAJA, KOTA KUPANG, NUSA TENGGARA TIMUR",12,125,107,232
https://kawalpemilu.org#58086,"FONTEIN, KOTA RAJA, KOTA KUPANG, NUSA TENGGARA TIMUR",13,217,5,222
https://kawalpemilu.org#58086,"FONTEIN, KOTA RAJA, KOTA KUPANG, NUSA TENGGARA TIMUR",14,138,9,147
https://kawalpemilu.org#92459,"BAKUNASE DUA, KOTA RAJA, KOTA KUPANG, NUSA TENGGARA TIMUR",1,111,6,117
https://kawalpemilu.org#92459,"BAKUNASE DUA, KOTA RAJA, KOTA KUPANG, NUSA TENGGARA TIMUR",2,204,22,226
https://kawalpemilu.org#92459,"BAKUNASE DUA, KOTA RAJA, KOTA KUPANG, NUSA TENGGARA TIMUR",3,165,17,182
https://kawalpemilu.org#92459,"BAKUNASE DUA, KOTA RAJA, KOTA KUPANG, NUSA TENGGARA TIMUR",4,142,8,150
https://kawalpemilu.org#92459,"BAKUNASE DUA, KOTA RAJA, KOTA KUPANG, NUSA TENGGARA TIMUR",5,176,49,225
https://kawalpemilu.org#92459,"BAKUNASE DUA, KOTA RAJA, KOTA KUPANG, NUSA TENGGARA TIMUR",6,178,12,190
https://kawalpemilu.org#92459,"BAKUNASE DUA, KOTA RAJA, KOTA KUPANG, NUSA TENGGARA TIMUR",7,224,15,239
https://kawalpemilu.org#92459,"BAKUNASE DUA, KOTA RAJA, KOTA KUPANG, NUSA TENGGARA TIMUR",8,192,14,206
https://kawalpemilu.org#92459,"BAKUNASE DUA, KOTA RAJA, KOTA KUPANG, NUSA TENGGARA TIMUR",9,189,23,212
https://kawalpemilu.org#92459,"BAKUNASE DUA, KOTA RAJA, KOTA KUPANG, NUSA TENGGARA TIMUR",10,133,3,136
https://kawalpemilu.org#92459,"BAKUNASE DUA, KOTA RAJA, KOTA KUPANG, NUSA TENGGARA TIMUR",11,224,28,252
https://kawalpemilu.org#92459,"BAKUNASE DUA, KOTA RAJA, KOTA KUPANG, NUSA TENGGARA TIMUR",12,208,16,224
https://kawalpemilu.org#92459,"BAKUNASE DUA, KOTA RAJA, KOTA KUPANG, NUSA TENGGARA TIMUR",13,181,8,189
https://kawalpemilu.org#92459,"BAKUNASE DUA, KOTA RAJA, KOTA KUPANG, NUSA TENGGARA TIMUR",14,220,6,226
https://kawalpemilu.org#92459,"BAKUNASE DUA, KOTA RAJA, KOTA KUPANG, NUSA TENGGARA TIMUR",15,259,6,265
https://kawalpemilu.org#92459,"BAKUNASE DUA, KOTA RAJA, KOTA KUPANG, NUSA TENGGARA TIMUR",16,139,7,146
https://kawalpemilu.org#92459,"BAKUNASE DUA, KOTA RAJA, KOTA KUPANG, NUSA TENGGARA TIMUR",17,146,4,150
https://kawalpemilu.org#92459,"BAKUNASE DUA, KOTA RAJA, KOTA KUPANG, NUSA TENGGARA TIMUR",18,168,12,180
https://kawalpemilu.org#92459,"BAKUNASE DUA, KOTA RAJA, KOTA KUPANG, NUSA TENGGARA TIMUR",19,151,8,159
https://kawalpemilu.org#92459,"BAKUNASE DUA, KOTA RAJA, KOTA KUPANG, NUSA TENGGARA TIMUR",20,166,8,174
https://kawalpemilu.org#58088,"AIRMATA, KOTA LAMA, KOTA KUPANG, NUSA TENGGARA TIMUR",2,36,133,169
https://kawalpemilu.org#58088,"AIRMATA, KOTA LAMA, KOTA KUPANG, NUSA TENGGARA TIMUR",3,41,153,194
https://kawalpemilu.org#58088,"AIRMATA, KOTA LAMA, KOTA KUPANG, NUSA TENGGARA TIMUR",4,33,157,190
https://kawalpemilu.org#58088,"AIRMATA, KOTA LAMA, KOTA KUPANG, NUSA TENGGARA TIMUR",5,26,127,153
https://kawalpemilu.org#58088,"AIRMATA, KOTA LAMA, KOTA KUPANG, NUSA TENGGARA TIMUR",6,166,4,170
https://kawalpemilu.org#58089,"LAI LAI BISI KOPAN, KOTA LAMA, KOTA KUPANG, NUSA TENGGARA TIMUR",1,140,14,154
https://kawalpemilu.org#58089,"LAI LAI BISI KOPAN, KOTA LAMA, KOTA KUPANG, NUSA TENGGARA TIMUR",2,105,1,106
https://kawalpemilu.org#58089,"LAI LAI BISI KOPAN, KOTA LAMA, KOTA KUPANG, NUSA TENGGARA TIMUR",3,104,34,138
https://kawalpemilu.org#58090,"BONIPOI, KOTA LAMA, KOTA KUPANG, NUSA TENGGARA TIMUR",1,90,116,206
https://kawalpemilu.org#58090,"BONIPOI, KOTA LAMA, KOTA KUPANG, NUSA TENGGARA TIMUR",2,32,84,116
https://kawalpemilu.org#58090,"BONIPOI, KOTA LAMA, KOTA KUPANG, NUSA TENGGARA TIMUR",3,71,62,133
https://kawalpemilu.org#58090,"BONIPOI, KOTA LAMA, KOTA KUPANG, NUSA TENGGARA TIMUR",4,107,73,180
https://kawalpemilu.org#58090,"BONIPOI, KOTA LAMA, KOTA KUPANG, NUSA TENGGARA TIMUR",5,122,37,159
https://kawalpemilu.org#58090,"BONIPOI, KOTA LAMA, KOTA KUPANG, NUSA TENGGARA TIMUR",6,141,43,184
https://kawalpemilu.org#58091,"SOLOR, KOTA LAMA, KOTA KUPANG, NUSA TENGGARA TIMUR",1,61,170,231
https://kawalpemilu.org#58091,"SOLOR, KOTA LAMA, KOTA KUPANG, NUSA TENGGARA TIMUR",2,52,120,172
https://kawalpemilu.org#58091,"SOLOR, KOTA LAMA, KOTA KUPANG, NUSA TENGGARA TIMUR",3,85,154,239
https://kawalpemilu.org#58091,"SOLOR, KOTA LAMA, KOTA KUPANG, NUSA TENGGARA TIMUR",4,60,78,138
https://kawalpemilu.org#58091,"SOLOR, KOTA LAMA, KOTA KUPANG, NUSA TENGGARA TIMUR",5,57,98,155
https://kawalpemilu.org#58091,"SOLOR, KOTA LAMA, KOTA KUPANG, NUSA TENGGARA TIMUR",6,75,108,183
https://kawalpemilu.org#58091,"SOLOR, KOTA LAMA, KOTA KUPANG, NUSA TENGGARA TIMUR",7,104,52,156
https://kawalpemilu.org#58091,"SOLOR, KOTA LAMA, KOTA KUPANG, NUSA TENGGARA TIMUR",8,100,45,145
https://kawalpemilu.org#58092,"TODE KISAR, KOTA LAMA, KOTA KUPANG, NUSA TENGGARA TIMUR",1,146,20,166
https://kawalpemilu.org#58092,"TODE KISAR, KOTA LAMA, KOTA KUPANG, NUSA TENGGARA TIMUR",2,149,16,165
https://kawalpemilu.org#58092,"TODE KISAR, KOTA LAMA, KOTA KUPANG, NUSA TENGGARA TIMUR",3,189,30,219
https://kawalpemilu.org#58093,"MERDEKA, KOTA LAMA, KOTA KUPANG, NUSA TENGGARA TIMUR",1,223,14,237
https://kawalpemilu.org#58093,"MERDEKA, KOTA LAMA, KOTA KUPANG, NUSA TENGGARA TIMUR",2,157,14,171
https://kawalpemilu.org#58093,"MERDEKA, KOTA LAMA, KOTA KUPANG, NUSA TENGGARA TIMUR",3,150,12,162
https://kawalpemilu.org#58093,"MERDEKA, KOTA LAMA, KOTA KUPANG, NUSA TENGGARA TIMUR",4,195,10,205
https://kawalpemilu.org#58093,"MERDEKA, KOTA LAMA, KOTA KUPANG, NUSA TENGGARA TIMUR",5,170,28,198
https://kawalpemilu.org#58094,"OEBA, KOTA LAMA, KOTA KUPANG, NUSA TENGGARA TIMUR",1,181,11,192
https://kawalpemilu.org#58094,"OEBA, KOTA LAMA, KOTA KUPANG, NUSA TENGGARA TIMUR",2,159,9,168
https://kawalpemilu.org#58094,"OEBA, KOTA LAMA, KOTA KUPANG, NUSA TENGGARA TIMUR",3,200,12,212
https://kawalpemilu.org#58094,"OEBA, KOTA LAMA, KOTA KUPANG, NUSA TENGGARA TIMUR",4,234,6,240
https://kawalpemilu.org#58094,"OEBA, KOTA LAMA, KOTA KUPANG, NUSA TENGGARA TIMUR",5,164,8,172
https://kawalpemilu.org#58094,"OEBA, KOTA LAMA, KOTA KUPANG, NUSA TENGGARA TIMUR",6,176,4,180
https://kawalpemilu.org#58094,"OEBA, KOTA LAMA, KOTA KUPANG, NUSA TENGGARA TIMUR",7,162,19,181
https://kawalpemilu.org#58094,"OEBA, KOTA LAMA, KOTA KUPANG, NUSA TENGGARA TIMUR",8,150,0,150
https://kawalpemilu.org#58094,"OEBA, KOTA LAMA, KOTA KUPANG, NUSA TENGGARA TIMUR",9,130,2,132
https://kawalpemilu.org#58094,"OEBA, KOTA LAMA, KOTA KUPANG, NUSA TENGGARA TIMUR",10,241,15,256
https://kawalpemilu.org#58094,"OEBA, KOTA LAMA, KOTA KUPANG, NUSA TENGGARA TIMUR",11,196,16,212
https://kawalpemilu.org#58094,"OEBA, KOTA LAMA, KOTA KUPANG, NUSA TENGGARA TIMUR",12,215,22,237
https://kawalpemilu.org#58094,"OEBA, KOTA LAMA, KOTA KUPANG, NUSA TENGGARA TIMUR",13,218,11,229
https://kawalpemilu.org#58095,"FATUBESI, KOTA LAMA, KOTA KUPANG, NUSA TENGGARA TIMUR",1,145,3,148
https://kawalpemilu.org#58095,"FATUBESI, KOTA LAMA, KOTA KUPANG, NUSA TENGGARA TIMUR",2,102,18,120
https://kawalpemilu.org#58095,"FATUBESI, KOTA LAMA, KOTA KUPANG, NUSA TENGGARA TIMUR",3,227,48,275
https://kawalpemilu.org#58095,"FATUBESI, KOTA LAMA, KOTA KUPANG, NUSA TENGGARA TIMUR",4,206,20,226
https://kawalpemilu.org#58095,"FATUBESI, KOTA LAMA, KOTA KUPANG, NUSA TENGGARA TIMUR",5,84,18,102
https://kawalpemilu.org#58095,"FATUBESI, KOTA LAMA, KOTA KUPANG, NUSA TENGGARA TIMUR",6,196,14,210
https://kawalpemilu.org#58095,"FATUBESI, KOTA LAMA, KOTA KUPANG, NUSA TENGGARA TIMUR",7,108,13,121
https://kawalpemilu.org#58095,"FATUBESI, KOTA LAMA, KOTA KUPANG, NUSA TENGGARA TIMUR",8,79,8,87
https://kawalpemilu.org#58095,"FATUBESI, KOTA LAMA, KOTA KUPANG, NUSA TENGGARA TIMUR",9,129,5,134
https://kawalpemilu.org#58095,"FATUBESI, KOTA LAMA, KOTA KUPANG, NUSA TENGGARA TIMUR",10,107,27,134
https://kawalpemilu.org#58095,"FATUBESI, KOTA LAMA, KOTA KUPANG, NUSA TENGGARA TIMUR",11,173,37,210
https://kawalpemilu.org#58095,"FATUBESI, KOTA LAMA, KOTA KUPANG, NUSA TENGGARA TIMUR",12,117,9,126
https://kawalpemilu.org#58095,"FATUBESI, KOTA LAMA, KOTA KUPANG, NUSA TENGGARA TIMUR",13,144,8,152
https://kawalpemilu.org#58095,"FATUBESI, KOTA LAMA, KOTA KUPANG, NUSA TENGGARA TIMUR",14,123,17,140
https://kawalpemilu.org#58095,"FATUBESI, KOTA LAMA, KOTA KUPANG, NUSA TENGGARA TIMUR",15,185,25,210
https://kawalpemilu.org#58095,"FATUBESI, KOTA LAMA, KOTA KUPANG, NUSA TENGGARA TIMUR",16,130,3,133
https://kawalpemilu.org#58096,"PASIR PANJANG, KOTA LAMA, KOTA KUPANG, NUSA TENGGARA TIMUR",1,196,22,218
https://kawalpemilu.org#58096,"PASIR PANJANG, KOTA LAMA, KOTA KUPANG, NUSA TENGGARA TIMUR",2,141,30,171
https://kawalpemilu.org#58096,"PASIR PANJANG, KOTA LAMA, KOTA KUPANG, NUSA TENGGARA TIMUR",3,131,19,150
https://kawalpemilu.org#58096,"PASIR PANJANG, KOTA LAMA, KOTA KUPANG, NUSA TENGGARA TIMUR",4,137,4,141
https://kawalpemilu.org#58096,"PASIR PANJANG, KOTA LAMA, KOTA KUPANG, NUSA TENGGARA TIMUR",5,128,15,143
https://kawalpemilu.org#58096,"PASIR PANJANG, KOTA LAMA, KOTA KUPANG, NUSA TENGGARA TIMUR",6,236,9,245
https://kawalpemilu.org#58096,"PASIR PANJANG, KOTA LAMA, KOTA KUPANG, NUSA TENGGARA TIMUR",7,123,7,130
https://kawalpemilu.org#58096,"PASIR PANJANG, KOTA LAMA, KOTA KUPANG, NUSA TENGGARA TIMUR",8,128,3,131
https://kawalpemilu.org#58096,"PASIR PANJANG, KOTA LAMA, KOTA KUPANG, NUSA TENGGARA TIMUR",9,174,13,187
https://kawalpemilu.org#58096,"PASIR PANJANG, KOTA LAMA, KOTA KUPANG, NUSA TENGGARA TIMUR",10,126,20,146
https://kawalpemilu.org#58096,"PASIR PANJANG, KOTA LAMA, KOTA KUPANG, NUSA TENGGARA TIMUR",11,177,23,200
https://kawalpemilu.org#58096,"PASIR PANJANG, KOTA LAMA, KOTA KUPANG, NUSA TENGGARA TIMUR",12,128,26,154
https://kawalpemilu.org#58096,"PASIR PANJANG, KOTA LAMA, KOTA KUPANG, NUSA TENGGARA TIMUR",13,98,33,131
https://kawalpemilu.org#58096,"PASIR PANJANG, KOTA LAMA, KOTA KUPANG, NUSA TENGGARA TIMUR",14,147,16,163
https://kawalpemilu.org#58096,"PASIR PANJANG, KOTA LAMA, KOTA KUPANG, NUSA TENGGARA TIMUR",15,121,7,128
https://kawalpemilu.org#58096,"PASIR PANJANG, KOTA LAMA, KOTA KUPANG, NUSA TENGGARA TIMUR",16,168,13,181
https://kawalpemilu.org#58096,"PASIR PANJANG, KOTA LAMA, KOTA KUPANG, NUSA TENGGARA TIMUR",17,222,16,238
https://kawalpemilu.org#58096,"PASIR PANJANG, KOTA LAMA, KOTA KUPANG, NUSA TENGGARA TIMUR",18,154,14,168
https://kawalpemilu.org#58096,"PASIR PANJANG, KOTA LAMA, KOTA KUPANG, NUSA TENGGARA TIMUR",19,124,15,139
https://kawalpemilu.org#58096,"PASIR PANJANG, KOTA LAMA, KOTA KUPANG, NUSA TENGGARA TIMUR",20,172,17,189
https://kawalpemilu.org#58096,"PASIR PANJANG, KOTA LAMA, KOTA KUPANG, NUSA TENGGARA TIMUR",21,180,14,194
https://kawalpemilu.org#58096,"PASIR PANJANG, KOTA LAMA, KOTA KUPANG, NUSA TENGGARA TIMUR",22,149,14,163
https://kawalpemilu.org#58097,"NEFONAEK, KOTA LAMA, KOTA KUPANG, NUSA TENGGARA TIMUR",1,159,29,188
https://kawalpemilu.org#58097,"NEFONAEK, KOTA LAMA, KOTA KUPANG, NUSA TENGGARA TIMUR",2,141,45,186
https://kawalpemilu.org#58097,"NEFONAEK, KOTA LAMA, KOTA KUPANG, NUSA TENGGARA TIMUR",3,145,58,203
https://kawalpemilu.org#58097,"NEFONAEK, KOTA LAMA, KOTA KUPANG, NUSA TENGGARA TIMUR",4,165,65,230
https://kawalpemilu.org#58097,"NEFONAEK, KOTA LAMA, KOTA KUPANG, NUSA TENGGARA TIMUR",5,113,37,150
https://kawalpemilu.org#58097,"NEFONAEK, KOTA LAMA, KOTA KUPANG, NUSA TENGGARA TIMUR",6,125,10,135
https://kawalpemilu.org#58097,"NEFONAEK, KOTA LAMA, KOTA KUPANG, NUSA TENGGARA TIMUR",7,176,20,196
https://kawalpemilu.org#58097,"NEFONAEK, KOTA LAMA, KOTA KUPANG, NUSA TENGGARA TIMUR",8,141,35,176
https://kawalpemilu.org#58097,"NEFONAEK, KOTA LAMA, KOTA KUPANG, NUSA TENGGARA TIMUR",9,125,28,153
https://kawalpemilu.org#58097,"NEFONAEK, KOTA LAMA, KOTA KUPANG, NUSA TENGGARA TIMUR",10,110,22,132
https://kawalpemilu.org#58097,"NEFONAEK, KOTA LAMA, KOTA KUPANG, NUSA TENGGARA TIMUR",11,145,79,224
https://kawalpemilu.org#58097,"NEFONAEK, KOTA LAMA, KOTA KUPANG, NUSA TENGGARA TIMUR",12,126,27,153
https://kawalpemilu.org#58097,"NEFONAEK, KOTA LAMA, KOTA KUPANG, NUSA TENGGARA TIMUR",13,113,14,127
https://kawalpemilu.org#58100,"KOTA NDORA, BORONG, MANGGARAI TIMUR, NUSA TENGGARA TIMUR",1,63,193,256
https://kawalpemilu.org#58100,"KOTA NDORA, BORONG, MANGGARAI TIMUR, NUSA TENGGARA TIMUR",2,78,179,257
https://kawalpemilu.org#58100,"KOTA NDORA, BORONG, MANGGARAI TIMUR, NUSA TENGGARA TIMUR",3,238,20,258
https://kawalpemilu.org#58100,"KOTA NDORA, BORONG, MANGGARAI TIMUR, NUSA TENGGARA TIMUR",4,251,15,266
https://kawalpemilu.org#58100,"KOTA NDORA, BORONG, MANGGARAI TIMUR, NUSA TENGGARA TIMUR",5,155,80,235
https://kawalpemilu.org#58100,"KOTA NDORA, BORONG, MANGGARAI TIMUR, NUSA TENGGARA TIMUR",6,227,17,244
https://kawalpemilu.org#58100,"KOTA NDORA, BORONG, MANGGARAI TIMUR, NUSA TENGGARA TIMUR",7,235,2,237
https://kawalpemilu.org#58100,"KOTA NDORA, BORONG, MANGGARAI TIMUR, NUSA TENGGARA TIMUR",8,222,3,225
https://kawalpemilu.org#58100,"KOTA NDORA, BORONG, MANGGARAI TIMUR, NUSA TENGGARA TIMUR",9,137,54,191
https://kawalpemilu.org#58100,"KOTA NDORA, BORONG, MANGGARAI TIMUR, NUSA TENGGARA TIMUR",10,58,153,211
https://kawalpemilu.org#58100,"KOTA NDORA, BORONG, MANGGARAI TIMUR, NUSA TENGGARA TIMUR",11,50,96,146
https://kawalpemilu.org#58100,"KOTA NDORA, BORONG, MANGGARAI TIMUR, NUSA TENGGARA TIMUR",12,190,12,202
https://kawalpemilu.org#58101,"RANA LOBA, BORONG, MANGGARAI TIMUR, NUSA TENGGARA TIMUR",1,228,12,240
https://kawalpemilu.org#58101,"RANA LOBA, BORONG, MANGGARAI TIMUR, NUSA TENGGARA TIMUR",2,164,11,175
https://kawalpemilu.org#58101,"RANA LOBA, BORONG, MANGGARAI TIMUR, NUSA TENGGARA TIMUR",3,124,69,193
https://kawalpemilu.org#58101,"RANA LOBA, BORONG, MANGGARAI TIMUR, NUSA TENGGARA TIMUR",4,152,25,177
https://kawalpemilu.org#58101,"RANA LOBA, BORONG, MANGGARAI TIMUR, NUSA TENGGARA TIMUR",5,91,79,170
https://kawalpemilu.org#58101,"RANA LOBA, BORONG, MANGGARAI TIMUR, NUSA TENGGARA TIMUR",6,107,54,161
https://kawalpemilu.org#58101,"RANA LOBA, BORONG, MANGGARAI TIMUR, NUSA TENGGARA TIMUR",7,242,8,250
https://kawalpemilu.org#58101,"RANA LOBA, BORONG, MANGGARAI TIMUR, NUSA TENGGARA TIMUR",8,235,13,248
https://kawalpemilu.org#58101,"RANA LOBA, BORONG, MANGGARAI TIMUR, NUSA TENGGARA TIMUR",9,169,62,231
https://kawalpemilu.org#58101,"RANA LOBA, BORONG, MANGGARAI TIMUR, NUSA TENGGARA TIMUR",10,125,100,225
https://kawalpemilu.org#58101,"RANA LOBA, BORONG, MANGGARAI TIMUR, NUSA TENGGARA TIMUR",11,126,29,155
https://kawalpemilu.org#58101,"RANA LOBA, BORONG, MANGGARAI TIMUR, NUSA TENGGARA TIMUR",12,50,28,78
https://kawalpemilu.org#58101,"RANA LOBA, BORONG, MANGGARAI TIMUR, NUSA TENGGARA TIMUR",13,58,15,73
https://kawalpemilu.org#58102,"NANGA LABANG, BORONG, MANGGARAI TIMUR, NUSA TENGGARA TIMUR",1,121,9,130
https://kawalpemilu.org#58102,"NANGA LABANG, BORONG, MANGGARAI TIMUR, NUSA TENGGARA TIMUR",2,142,16,158
https://kawalpemilu.org#58102,"NANGA LABANG, BORONG, MANGGARAI TIMUR, NUSA TENGGARA TIMUR",3,235,13,248
https://kawalpemilu.org#58102,"NANGA LABANG, BORONG, MANGGARAI TIMUR, NUSA TENGGARA TIMUR",4,177,10,187
https://kawalpemilu.org#58102,"NANGA LABANG, BORONG, MANGGARAI TIMUR, NUSA TENGGARA TIMUR",5,218,12,230
https://kawalpemilu.org#58102,"NANGA LABANG, BORONG, MANGGARAI TIMUR, NUSA TENGGARA TIMUR",6,171,17,188
https://kawalpemilu.org#58102,"NANGA LABANG, BORONG, MANGGARAI TIMUR, NUSA TENGGARA TIMUR",7,185,12,197
https://kawalpemilu.org#58102,"NANGA LABANG, BORONG, MANGGARAI TIMUR, NUSA TENGGARA TIMUR",8,88,74,162
https://kawalpemilu.org#58102,"NANGA LABANG, BORONG, MANGGARAI TIMUR, NUSA TENGGARA TIMUR",9,171,7,178
https://kawalpemilu.org#58105,"GURUNG LIWUT, BORONG, MANGGARAI TIMUR, NUSA TENGGARA TIMUR",1,206,10,216
https://kawalpemilu.org#58105,"GURUNG LIWUT, BORONG, MANGGARAI TIMUR, NUSA TENGGARA TIMUR",2,186,18,204
https://kawalpemilu.org#58105,"GURUNG LIWUT, BORONG, MANGGARAI TIMUR, NUSA TENGGARA TIMUR",3,170,21,191
https://kawalpemilu.org#58105,"GURUNG LIWUT, BORONG, MANGGARAI TIMUR, NUSA TENGGARA TIMUR",4,154,19,173
https://kawalpemilu.org#58105,"GURUNG LIWUT, BORONG, MANGGARAI TIMUR, NUSA TENGGARA TIMUR",5,172,29,201
https://kawalpemilu.org#58105,"GURUNG LIWUT, BORONG, MANGGARAI TIMUR, NUSA TENGGARA TIMUR",6,169,18,187
https://kawalpemilu.org#58105,"GURUNG LIWUT, BORONG, MANGGARAI TIMUR, NUSA TENGGARA TIMUR",7,136,19,155
https://kawalpemilu.org#58105,"GURUNG LIWUT, BORONG, MANGGARAI TIMUR, NUSA TENGGARA TIMUR",8,208,9,217
https://kawalpemilu.org#58106,"BENTENG RIWU, BORONG, MANGGARAI TIMUR, NUSA TENGGARA TIMUR",1,195,8,203
https://kawalpemilu.org#58106,"BENTENG RIWU, BORONG, MANGGARAI TIMUR, NUSA TENGGARA TIMUR",2,237,28,265
https://kawalpemilu.org#58106,"BENTENG RIWU, BORONG, MANGGARAI TIMUR, NUSA TENGGARA TIMUR",3,190,9,199
https://kawalpemilu.org#58106,"BENTENG RIWU, BORONG, MANGGARAI TIMUR, NUSA TENGGARA TIMUR",4,105,8,113
https://kawalpemilu.org#58106,"BENTENG RIWU, BORONG, MANGGARAI TIMUR, NUSA TENGGARA TIMUR",5,186,14,200
https://kawalpemilu.org#58106,"BENTENG RIWU, BORONG, MANGGARAI TIMUR, NUSA TENGGARA TIMUR",6,98,5,103
https://kawalpemilu.org#58107,"NGAMPANG MAS, BORONG, MANGGARAI TIMUR, NUSA TENGGARA TIMUR",1,186,20,206
https://kawalpemilu.org#58107,"NGAMPANG MAS, BORONG, MANGGARAI TIMUR, NUSA TENGGARA TIMUR",2,191,17,208
https://kawalpemilu.org#58107,"NGAMPANG MAS, BORONG, MANGGARAI TIMUR, NUSA TENGGARA TIMUR",3,176,14,190
https://kawalpemilu.org#58107,"NGAMPANG MAS, BORONG, MANGGARAI TIMUR, NUSA TENGGARA TIMUR",4,146,5,151
https://kawalpemilu.org#58110,"RANA MASAK, BORONG, MANGGARAI TIMUR, NUSA TENGGARA TIMUR",1,164,21,185
https://kawalpemilu.org#58110,"RANA MASAK, BORONG, MANGGARAI TIMUR, NUSA TENGGARA TIMUR",2,139,28,167
https://kawalpemilu.org#58110,"RANA MASAK, BORONG, MANGGARAI TIMUR, NUSA TENGGARA TIMUR",3,128,22,150
https://kawalpemilu.org#58110,"RANA MASAK, BORONG, MANGGARAI TIMUR, NUSA TENGGARA TIMUR",4,171,15,186
https://kawalpemilu.org#58110,"RANA MASAK, BORONG, MANGGARAI TIMUR, NUSA TENGGARA TIMUR",5,108,9,117
https://kawalpemilu.org#58111,"BENTENG RAJA, BORONG, MANGGARAI TIMUR, NUSA TENGGARA TIMUR",1,139,6,145
https://kawalpemilu.org#58111,"BENTENG RAJA, BORONG, MANGGARAI TIMUR, NUSA TENGGARA TIMUR",2,164,13,177
https://kawalpemilu.org#58111,"BENTENG RAJA, BORONG, MANGGARAI TIMUR, NUSA TENGGARA TIMUR",3,177,11,188
https://kawalpemilu.org#58111,"BENTENG RAJA, BORONG, MANGGARAI TIMUR, NUSA TENGGARA TIMUR",4,168,28,196
https://kawalpemilu.org#58111,"BENTENG RAJA, BORONG, MANGGARAI TIMUR, NUSA TENGGARA TIMUR",5,138,7,145
https://kawalpemilu.org#58111,"BENTENG RAJA, BORONG, MANGGARAI TIMUR, NUSA TENGGARA TIMUR",6,167,7,174
https://kawalpemilu.org#58115,"GOLO LALONG, BORONG, MANGGARAI TIMUR, NUSA TENGGARA TIMUR",1,199,11,210
https://kawalpemilu.org#58115,"GOLO LALONG, BORONG, MANGGARAI TIMUR, NUSA TENGGARA TIMUR",2,154,6,160
https://kawalpemilu.org#58118,"GOLO KANTAR, BORONG, MANGGARAI TIMUR, NUSA TENGGARA TIMUR",1,170,11,181
https://kawalpemilu.org#58118,"GOLO KANTAR, BORONG, MANGGARAI TIMUR, NUSA TENGGARA TIMUR",2,176,6,182
https://kawalpemilu.org#58118,"GOLO KANTAR, BORONG, MANGGARAI TIMUR, NUSA TENGGARA TIMUR",3,219,14,233
https://kawalpemilu.org#58118,"GOLO KANTAR, BORONG, MANGGARAI TIMUR, NUSA TENGGARA TIMUR",4,196,9,205
https://kawalpemilu.org#58118,"GOLO KANTAR, BORONG, MANGGARAI TIMUR, NUSA TENGGARA TIMUR",5,175,8,183
https://kawalpemilu.org#58119,"POCO RII, BORONG, MANGGARAI TIMUR, NUSA TENGGARA TIMUR",1,148,6,154
https://kawalpemilu.org#58119,"POCO RII, BORONG, MANGGARAI TIMUR, NUSA TENGGARA TIMUR",2,135,11,146
https://kawalpemilu.org#58119,"POCO RII, BORONG, MANGGARAI TIMUR, NUSA TENGGARA TIMUR",3,92,6,98
https://kawalpemilu.org#58119,"POCO RII, BORONG, MANGGARAI TIMUR, NUSA TENGGARA TIMUR",4,164,6,170
https://kawalpemilu.org#58119,"POCO RII, BORONG, MANGGARAI TIMUR, NUSA TENGGARA TIMUR",5,142,7,149
https://kawalpemilu.org#58119,"POCO RII, BORONG, MANGGARAI TIMUR, NUSA TENGGARA TIMUR",6,144,5,149
https://kawalpemilu.org#58119,"POCO RII, BORONG, MANGGARAI TIMUR, NUSA TENGGARA TIMUR",7,110,3,113
https://kawalpemilu.org#85238,"SATAR PEOT, BORONG, MANGGARAI TIMUR, NUSA TENGGARA TIMUR",1,167,17,184
https://kawalpemilu.org#85238,"SATAR PEOT, BORONG, MANGGARAI TIMUR, NUSA TENGGARA TIMUR",2,191,3,194
https://kawalpemilu.org#85238,"SATAR PEOT, BORONG, MANGGARAI TIMUR, NUSA TENGGARA TIMUR",3,159,17,176
https://kawalpemilu.org#85238,"SATAR PEOT, BORONG, MANGGARAI TIMUR, NUSA TENGGARA TIMUR",4,183,23,206
https://kawalpemilu.org#85238,"SATAR PEOT, BORONG, MANGGARAI TIMUR, NUSA TENGGARA TIMUR",5,183,26,209
https://kawalpemilu.org#85238,"SATAR PEOT, BORONG, MANGGARAI TIMUR, NUSA TENGGARA TIMUR",6,193,21,214
https://kawalpemilu.org#85238,"SATAR PEOT, BORONG, MANGGARAI TIMUR, NUSA TENGGARA TIMUR",7,195,12,207
https://kawalpemilu.org#85238,"SATAR PEOT, BORONG, MANGGARAI TIMUR, NUSA TENGGARA TIMUR",8,156,5,161
https://kawalpemilu.org#85238,"SATAR PEOT, BORONG, MANGGARAI TIMUR, NUSA TENGGARA TIMUR",9,168,14,182
https://kawalpemilu.org#85238,"SATAR PEOT, BORONG, MANGGARAI TIMUR, NUSA TENGGARA TIMUR",10,130,9,139
https://kawalpemilu.org#85238,"SATAR PEOT, BORONG, MANGGARAI TIMUR, NUSA TENGGARA TIMUR",11,159,5,164
https://kawalpemilu.org#85239,"BALUS PERMAI, BORONG, MANGGARAI TIMUR, NUSA TENGGARA TIMUR",1,121,87,208
https://kawalpemilu.org#85239,"BALUS PERMAI, BORONG, MANGGARAI TIMUR, NUSA TENGGARA TIMUR",2,113,139,252
https://kawalpemilu.org#85239,"BALUS PERMAI, BORONG, MANGGARAI TIMUR, NUSA TENGGARA TIMUR",3,151,19,170
https://kawalpemilu.org#85239,"BALUS PERMAI, BORONG, MANGGARAI TIMUR, NUSA TENGGARA TIMUR",4,95,7,102
https://kawalpemilu.org#85239,"BALUS PERMAI, BORONG, MANGGARAI TIMUR, NUSA TENGGARA TIMUR",5,112,63,175
https://kawalpemilu.org#85240,"GOLO LEDA, BORONG, MANGGARAI TIMUR, NUSA TENGGARA TIMUR",1,122,16,138
https://kawalpemilu.org#85240,"GOLO LEDA, BORONG, MANGGARAI TIMUR, NUSA TENGGARA TIMUR",2,162,20,182
https://kawalpemilu.org#85240,"GOLO LEDA, BORONG, MANGGARAI TIMUR, NUSA TENGGARA TIMUR",3,129,10,139
https://kawalpemilu.org#85240,"GOLO LEDA, BORONG, MANGGARAI TIMUR, NUSA TENGGARA TIMUR",4,49,7,56
https://kawalpemilu.org#85241,"COMPANG TENDA, BORONG, MANGGARAI TIMUR, NUSA TENGGARA TIMUR",1,189,4,193
https://kawalpemilu.org#85241,"COMPANG TENDA, BORONG, MANGGARAI TIMUR, NUSA TENGGARA TIMUR",2,79,11,90
https://kawalpemilu.org#85242,"BANGKA KANTAR, BORONG, MANGGARAI TIMUR, NUSA TENGGARA TIMUR",1,206,19,225
https://kawalpemilu.org#85242,"BANGKA KANTAR, BORONG, MANGGARAI TIMUR, NUSA TENGGARA TIMUR",2,116,36,152
https://kawalpemilu.org#85242,"BANGKA KANTAR, BORONG, MANGGARAI TIMUR, NUSA TENGGARA TIMUR",3,211,13,224
https://kawalpemilu.org#85242,"BANGKA KANTAR, BORONG, MANGGARAI TIMUR, NUSA TENGGARA TIMUR",4,165,12,177
https://kawalpemilu.org#85242,"BANGKA KANTAR, BORONG, MANGGARAI TIMUR, NUSA TENGGARA TIMUR",5,136,7,143
https://kawalpemilu.org#85242,"BANGKA KANTAR, BORONG, MANGGARAI TIMUR, NUSA TENGGARA TIMUR",6,196,12,208
https://kawalpemilu.org#85243,"COMPANG NDEJING, BORONG, MANGGARAI TIMUR, NUSA TENGGARA TIMUR",1,124,4,128
https://kawalpemilu.org#85243,"COMPANG NDEJING, BORONG, MANGGARAI TIMUR, NUSA TENGGARA TIMUR",2,198,8,206
https://kawalpemilu.org#85243,"COMPANG NDEJING, BORONG, MANGGARAI TIMUR, NUSA TENGGARA TIMUR",3,194,6,200
https://kawalpemilu.org#85243,"COMPANG NDEJING, BORONG, MANGGARAI TIMUR, NUSA TENGGARA TIMUR",4,165,9,174
https://kawalpemilu.org#85243,"COMPANG NDEJING, BORONG, MANGGARAI TIMUR, NUSA TENGGARA TIMUR",5,105,5,110
https://kawalpemilu.org#85243,"COMPANG NDEJING, BORONG, MANGGARAI TIMUR, NUSA TENGGARA TIMUR",6,97,1,98
https://kawalpemilu.org#85243,"COMPANG NDEJING, BORONG, MANGGARAI TIMUR, NUSA TENGGARA TIMUR",7,115,7,122
https://kawalpemilu.org#91318,"WALING, BORONG, MANGGARAI TIMUR, NUSA TENGGARA TIMUR",1,217,12,229
https://kawalpemilu.org#91318,"WALING, BORONG, MANGGARAI TIMUR, NUSA TENGGARA TIMUR",2,138,19,157
https://kawalpemilu.org#91318,"WALING, BORONG, MANGGARAI TIMUR, NUSA TENGGARA TIMUR",3,170,23,193
https://kawalpemilu.org#91318,"WALING, BORONG, MANGGARAI TIMUR, NUSA TENGGARA TIMUR",4,179,24,203
https://kawalpemilu.org#91318,"WALING, BORONG, MANGGARAI TIMUR, NUSA TENGGARA TIMUR",5,156,3,159
https://kawalpemilu.org#58122,"MANDOSAWU, POCO RANAKA, MANGGARAI TIMUR, NUSA TENGGARA TIMUR",1,182,8,190
https://kawalpemilu.org#58122,"MANDOSAWU, POCO RANAKA, MANGGARAI TIMUR, NUSA TENGGARA TIMUR",2,218,17,235
https://kawalpemilu.org#58122,"MANDOSAWU, POCO RANAKA, MANGGARAI TIMUR, NUSA TENGGARA TIMUR",3,216,10,226
https://kawalpemilu.org#58122,"MANDOSAWU, POCO RANAKA, MANGGARAI TIMUR, NUSA TENGGARA TIMUR",4,227,1,228
https://kawalpemilu.org#58122,"MANDOSAWU, POCO RANAKA, MANGGARAI TIMUR, NUSA TENGGARA TIMUR",5,97,3,100
https://kawalpemilu.org#58122,"MANDOSAWU, POCO RANAKA, MANGGARAI TIMUR, NUSA TENGGARA TIMUR",6,197,15,212
https://kawalpemilu.org#58122,"MANDOSAWU, POCO RANAKA, MANGGARAI TIMUR, NUSA TENGGARA TIMUR",7,169,14,183
https://kawalpemilu.org#58122,"MANDOSAWU, POCO RANAKA, MANGGARAI TIMUR, NUSA TENGGARA TIMUR",8,162,27,189
https://kawalpemilu.org#58122,"MANDOSAWU, POCO RANAKA, MANGGARAI TIMUR, NUSA TENGGARA TIMUR",9,158,5,163
https://kawalpemilu.org#58122,"MANDOSAWU, POCO RANAKA, MANGGARAI TIMUR, NUSA TENGGARA TIMUR",10,163,26,189
https://kawalpemilu.org#58123,"NGGALAK LELENG, POCO RANAKA, MANGGARAI TIMUR, NUSA TENGGARA TIMUR",1,167,9,176
https://kawalpemilu.org#58123,"NGGALAK LELENG, POCO RANAKA, MANGGARAI TIMUR, NUSA TENGGARA TIMUR",2,214,16,230
https://kawalpemilu.org#58123,"NGGALAK LELENG, POCO RANAKA, MANGGARAI TIMUR, NUSA TENGGARA TIMUR",3,143,12,155
https://kawalpemilu.org#58123,"NGGALAK LELENG, POCO RANAKA, MANGGARAI TIMUR, NUSA TENGGARA TIMUR",4,189,7,196
https://kawalpemilu.org#58124,"POCO LIA, POCO RANAKA, MANGGARAI TIMUR, NUSA TENGGARA TIMUR",1,243,10,253
https://kawalpemilu.org#58124,"POCO LIA, POCO RANAKA, MANGGARAI TIMUR, NUSA TENGGARA TIMUR",2,231,10,241
https://kawalpemilu.org#58124,"POCO LIA, POCO RANAKA, MANGGARAI TIMUR, NUSA TENGGARA TIMUR",3,136,6,142
https://kawalpemilu.org#58125,"POCONG, POCO RANAKA, MANGGARAI TIMUR, NUSA TENGGARA TIMUR",1,191,5,196
https://kawalpemilu.org#58125,"POCONG, POCO RANAKA, MANGGARAI TIMUR, NUSA TENGGARA TIMUR",2,213,6,219
https://kawalpemilu.org#58125,"POCONG, POCO RANAKA, MANGGARAI TIMUR, NUSA TENGGARA TIMUR",3,190,8,198
https://kawalpemilu.org#58125,"POCONG, POCO RANAKA, MANGGARAI TIMUR, NUSA TENGGARA TIMUR",4,231,11,242
https://kawalpemilu.org#58125,"POCONG, POCO RANAKA, MANGGARAI TIMUR, NUSA TENGGARA TIMUR",5,101,10,111
https://kawalpemilu.org#58126,"LENANG, POCO RANAKA, MANGGARAI TIMUR, NUSA TENGGARA TIMUR",1,159,11,170
https://kawalpemilu.org#58126,"LENANG, POCO RANAKA, MANGGARAI TIMUR, NUSA TENGGARA TIMUR",2,222,3,225
https://kawalpemilu.org#58126,"LENANG, POCO RANAKA, MANGGARAI TIMUR, NUSA TENGGARA TIMUR",3,208,6,214
https://kawalpemilu.org#58127,"MELO, POCO RANAKA, MANGGARAI TIMUR, NUSA TENGGARA TIMUR",1,239,5,244
https://kawalpemilu.org#58127,"MELO, POCO RANAKA, MANGGARAI TIMUR, NUSA TENGGARA TIMUR",2,156,6,162
https://kawalpemilu.org#58127,"MELO, POCO RANAKA, MANGGARAI TIMUR, NUSA TENGGARA TIMUR",3,201,9,210
https://kawalpemilu.org#58127,"MELO, POCO RANAKA, MANGGARAI TIMUR, NUSA TENGGARA TIMUR",4,149,5,154
https://kawalpemilu.org#58128,"LEONG, POCO RANAKA, MANGGARAI TIMUR, NUSA TENGGARA TIMUR",1,197,9,206
https://kawalpemilu.org#58128,"LEONG, POCO RANAKA, MANGGARAI TIMUR, NUSA TENGGARA TIMUR",2,173,9,182
https://kawalpemilu.org#58128,"LEONG, POCO RANAKA, MANGGARAI TIMUR, NUSA TENGGARA TIMUR",3,229,8,237
https://kawalpemilu.org#58128,"LEONG, POCO RANAKA, MANGGARAI TIMUR, NUSA TENGGARA TIMUR",4,203,6,209
https://kawalpemilu.org#58128,"LEONG, POCO RANAKA, MANGGARAI TIMUR, NUSA TENGGARA TIMUR",5,143,10,153
https://kawalpemilu.org#58128,"LEONG, POCO RANAKA, MANGGARAI TIMUR, NUSA TENGGARA TIMUR",6,201,7,208
https://kawalpemilu.org#58134,"BEA WAEK, POCO RANAKA, MANGGARAI TIMUR, NUSA TENGGARA TIMUR",1,115,10,125
https://kawalpemilu.org#58134,"BEA WAEK, POCO RANAKA, MANGGARAI TIMUR, NUSA TENGGARA TIMUR",2,228,6,234
https://kawalpemilu.org#58134,"BEA WAEK, POCO RANAKA, MANGGARAI TIMUR, NUSA TENGGARA TIMUR",3,126,5,131
https://kawalpemilu.org#58136,"GOLO LOBOS, POCO RANAKA, MANGGARAI TIMUR, NUSA TENGGARA TIMUR",1,164,20,184
https://kawalpemilu.org#58136,"GOLO LOBOS, POCO RANAKA, MANGGARAI TIMUR, NUSA TENGGARA TIMUR",2,198,16,214
https://kawalpemilu.org#58136,"GOLO LOBOS, POCO RANAKA, MANGGARAI TIMUR, NUSA TENGGARA TIMUR",3,181,10,191
https://kawalpemilu.org#58136,"GOLO LOBOS, POCO RANAKA, MANGGARAI TIMUR, NUSA TENGGARA TIMUR",4,153,17,170
https://kawalpemilu.org#58136,"GOLO LOBOS, POCO RANAKA, MANGGARAI TIMUR, NUSA TENGGARA TIMUR",5,138,20,158
https://kawalpemilu.org#58137,"BANGKA KULENG, POCO RANAKA, MANGGARAI TIMUR, NUSA TENGGARA TIMUR",1,141,8,149
https://kawalpemilu.org#58137,"BANGKA KULENG, POCO RANAKA, MANGGARAI TIMUR, NUSA TENGGARA TIMUR",2,192,10,202
https://kawalpemilu.org#58137,"BANGKA KULENG, POCO RANAKA, MANGGARAI TIMUR, NUSA TENGGARA TIMUR",3,165,7,172
https://kawalpemilu.org#58138,"BANGKA PAU, POCO RANAKA, MANGGARAI TIMUR, NUSA TENGGARA TIMUR",1,219,12,231
https://kawalpemilu.org#58138,"BANGKA PAU, POCO RANAKA, MANGGARAI TIMUR, NUSA TENGGARA TIMUR",2,206,20,226
https://kawalpemilu.org#58138,"BANGKA PAU, POCO RANAKA, MANGGARAI TIMUR, NUSA TENGGARA TIMUR",3,162,21,183
https://kawalpemilu.org#58139,"GOLO NDERU, POCO RANAKA, MANGGARAI TIMUR, NUSA TENGGARA TIMUR",1,175,4,179
https://kawalpemilu.org#58139,"GOLO NDERU, POCO RANAKA, MANGGARAI TIMUR, NUSA TENGGARA TIMUR",2,180,5,185
https://kawalpemilu.org#58139,"GOLO NDERU, POCO RANAKA, MANGGARAI TIMUR, NUSA TENGGARA TIMUR",3,167,2,169
https://kawalpemilu.org#58139,"GOLO NDERU, POCO RANAKA, MANGGARAI TIMUR, NUSA TENGGARA TIMUR",4,166,2,168
https://kawalpemilu.org#58140,"SATAR TESEM, POCO RANAKA, MANGGARAI TIMUR, NUSA TENGGARA TIMUR",1,209,10,219
https://kawalpemilu.org#58140,"SATAR TESEM, POCO RANAKA, MANGGARAI TIMUR, NUSA TENGGARA TIMUR",2,228,4,232
https://kawalpemilu.org#58140,"SATAR TESEM, POCO RANAKA, MANGGARAI TIMUR, NUSA TENGGARA TIMUR",3,201,9,210
https://kawalpemilu.org#58140,"SATAR TESEM, POCO RANAKA, MANGGARAI TIMUR, NUSA TENGGARA TIMUR",4,135,3,138
https://kawalpemilu.org#58141,"GURUNG TURI, POCO RANAKA, MANGGARAI TIMUR, NUSA TENGGARA TIMUR",1,136,10,146
https://kawalpemilu.org#58141,"GURUNG TURI, POCO RANAKA, MANGGARAI TIMUR, NUSA TENGGARA TIMUR",2,185,2,187
https://kawalpemilu.org#58141,"GURUNG TURI, POCO RANAKA, MANGGARAI TIMUR, NUSA TENGGARA TIMUR",3,145,1,146
https://kawalpemilu.org#58141,"GURUNG TURI, POCO RANAKA, MANGGARAI TIMUR, NUSA TENGGARA TIMUR",4,223,5,228
https://kawalpemilu.org#58141,"GURUNG TURI, POCO RANAKA, MANGGARAI TIMUR, NUSA TENGGARA TIMUR",5,176,1,177
https://kawalpemilu.org#58141,"GURUNG TURI, POCO RANAKA, MANGGARAI TIMUR, NUSA TENGGARA TIMUR",6,128,7,135
https://kawalpemilu.org#58142,"COMPANG LAHO, POCO RANAKA, MANGGARAI TIMUR, NUSA TENGGARA TIMUR",1,138,13,151
https://kawalpemilu.org#58142,"COMPANG LAHO, POCO RANAKA, MANGGARAI TIMUR, NUSA TENGGARA TIMUR",2,184,15,199
https://kawalpemilu.org#58142,"COMPANG LAHO, POCO RANAKA, MANGGARAI TIMUR, NUSA TENGGARA TIMUR",3,202,11,213
https://kawalpemilu.org#58142,"COMPANG LAHO, POCO RANAKA, MANGGARAI TIMUR, NUSA TENGGARA TIMUR",4,194,4,198
https://kawalpemilu.org#58143,"WATU LANUR, POCO RANAKA, MANGGARAI TIMUR, NUSA TENGGARA TIMUR",1,245,5,250
https://kawalpemilu.org#58143,"WATU LANUR, POCO RANAKA, MANGGARAI TIMUR, NUSA TENGGARA TIMUR",2,211,14,225
https://kawalpemilu.org#58143,"WATU LANUR, POCO RANAKA, MANGGARAI TIMUR, NUSA TENGGARA TIMUR",3,194,4,198
https://kawalpemilu.org#58143,"WATU LANUR, POCO RANAKA, MANGGARAI TIMUR, NUSA TENGGARA TIMUR",4,188,10,198
https://kawalpemilu.org#58149,"GOLO NDARI, POCO RANAKA, MANGGARAI TIMUR, NUSA TENGGARA TIMUR",1,105,13,118
https://kawalpemilu.org#58149,"GOLO NDARI, POCO RANAKA, MANGGARAI TIMUR, NUSA TENGGARA TIMUR",2,150,7,157
https://kawalpemilu.org#58149,"GOLO NDARI, POCO RANAKA, MANGGARAI TIMUR, NUSA TENGGARA TIMUR",3,149,8,157
https://kawalpemilu.org#58149,"GOLO NDARI, POCO RANAKA, MANGGARAI TIMUR, NUSA TENGGARA TIMUR",4,138,7,145
https://kawalpemilu.org#85244,"BANGKA LELENG, POCO RANAKA, MANGGARAI TIMUR, NUSA TENGGARA TIMUR",1,158,13,171
https://kawalpemilu.org#85244,"BANGKA LELENG, POCO RANAKA, MANGGARAI TIMUR, NUSA TENGGARA TIMUR",2,186,5,191
https://kawalpemilu.org#85244,"BANGKA LELENG, POCO RANAKA, MANGGARAI TIMUR, NUSA TENGGARA TIMUR",3,147,0,147
https://kawalpemilu.org#85244,"BANGKA LELENG, POCO RANAKA, MANGGARAI TIMUR, NUSA TENGGARA TIMUR",4,165,10,175
https://kawalpemilu.org#85245,"COMPANG WESANG, POCO RANAKA, MANGGARAI TIMUR, NUSA TENGGARA TIMUR",1,240,8,248
https://kawalpemilu.org#85245,"COMPANG WESANG, POCO RANAKA, MANGGARAI TIMUR, NUSA TENGGARA TIMUR",2,163,6,169
https://kawalpemilu.org#85245,"COMPANG WESANG, POCO RANAKA, MANGGARAI TIMUR, NUSA TENGGARA TIMUR",3,210,17,227
https://kawalpemilu.org#85246,"GOLO WUNE, POCO RANAKA, MANGGARAI TIMUR, NUSA TENGGARA TIMUR",1,192,11,203
https://kawalpemilu.org#85246,"GOLO WUNE, POCO RANAKA, MANGGARAI TIMUR, NUSA TENGGARA TIMUR",2,176,7,183
https://kawalpemilu.org#85246,"GOLO WUNE, POCO RANAKA, MANGGARAI TIMUR, NUSA TENGGARA TIMUR",3,156,6,162
https://kawalpemilu.org#85247,"LENTO, POCO RANAKA, MANGGARAI TIMUR, NUSA TENGGARA TIMUR",1,240,12,252
https://kawalpemilu.org#85247,"LENTO, POCO RANAKA, MANGGARAI TIMUR, NUSA TENGGARA TIMUR",2,172,8,180
https://kawalpemilu.org#85247,"LENTO, POCO RANAKA, MANGGARAI TIMUR, NUSA TENGGARA TIMUR",3,235,6,241
https://kawalpemilu.org#85248,"COMPANG WELUK, POCO RANAKA, MANGGARAI TIMUR, NUSA TENGGARA TIMUR",1,147,13,160
https://kawalpemilu.org#85248,"COMPANG WELUK, POCO RANAKA, MANGGARAI TIMUR, NUSA TENGGARA TIMUR",2,101,17,118
https://kawalpemilu.org#85248,"COMPANG WELUK, POCO RANAKA, MANGGARAI TIMUR, NUSA TENGGARA TIMUR",3,144,7,151
https://kawalpemilu.org#85249,"GOLO RENGKET, POCO RANAKA, MANGGARAI TIMUR, NUSA TENGGARA TIMUR",1,230,10,240
https://kawalpemilu.org#85249,"GOLO RENGKET, POCO RANAKA, MANGGARAI TIMUR, NUSA TENGGARA TIMUR",2,158,5,163
https://kawalpemilu.org#85249,"GOLO RENGKET, POCO RANAKA, MANGGARAI TIMUR, NUSA TENGGARA TIMUR",3,135,7,142
https://kawalpemilu.org#85249,"GOLO RENGKET, POCO RANAKA, MANGGARAI TIMUR, NUSA TENGGARA TIMUR",4,197,6,203
https://kawalpemilu.org#85250,"DENO, POCO RANAKA, MANGGARAI TIMUR, NUSA TENGGARA TIMUR",1,163,5,168
https://kawalpemilu.org#85250,"DENO, POCO RANAKA, MANGGARAI TIMUR, NUSA TENGGARA TIMUR",2,159,6,165
https://kawalpemilu.org#85250,"DENO, POCO RANAKA, MANGGARAI TIMUR, NUSA TENGGARA TIMUR",3,175,5,180
https://kawalpemilu.org#58151,"TENGKU LEDA, LAMBA LEDA, MANGGARAI TIMUR, NUSA TENGGARA TIMUR",1,178,11,189
https://kawalpemilu.org#58151,"TENGKU LEDA, LAMBA LEDA, MANGGARAI TIMUR, NUSA TENGGARA TIMUR",2,202,11,213
https://kawalpemilu.org#58151,"TENGKU LEDA, LAMBA LEDA, MANGGARAI TIMUR, NUSA TENGGARA TIMUR",3,230,10,240
https://kawalpemilu.org#58151,"TENGKU LEDA, LAMBA LEDA, MANGGARAI TIMUR, NUSA TENGGARA TIMUR",4,158,14,172
https://kawalpemilu.org#58151,"TENGKU LEDA, LAMBA LEDA, MANGGARAI TIMUR, NUSA TENGGARA TIMUR",5,205,13,218
https://kawalpemilu.org#58152,"TENGKU LAWAR, LAMBA LEDA, MANGGARAI TIMUR, NUSA TENGGARA TIMUR",1,211,14,225
https://kawalpemilu.org#58152,"TENGKU LAWAR, LAMBA LEDA, MANGGARAI TIMUR, NUSA TENGGARA TIMUR",2,224,7,231
https://kawalpemilu.org#58152,"TENGKU LAWAR, LAMBA LEDA, MANGGARAI TIMUR, NUSA TENGGARA TIMUR",3,203,24,227
https://kawalpemilu.org#58152,"TENGKU LAWAR, LAMBA LEDA, MANGGARAI TIMUR, NUSA TENGGARA TIMUR",4,45,3,48
https://kawalpemilu.org#58153,"GORENG MENI, LAMBA LEDA, MANGGARAI TIMUR, NUSA TENGGARA TIMUR",1,176,11,187
https://kawalpemilu.org#58153,"GORENG MENI, LAMBA LEDA, MANGGARAI TIMUR, NUSA TENGGARA TIMUR",2,208,6,214
https://kawalpemilu.org#58153,"GORENG MENI, LAMBA LEDA, MANGGARAI TIMUR, NUSA TENGGARA TIMUR",3,203,8,211
https://kawalpemilu.org#58154,"GOLO MUNGA, LAMBA LEDA, MANGGARAI TIMUR, NUSA TENGGARA TIMUR",1,206,12,218
https://kawalpemilu.org#58154,"GOLO MUNGA, LAMBA LEDA, MANGGARAI TIMUR, NUSA TENGGARA TIMUR",2,148,10,158
https://kawalpemilu.org#58154,"GOLO MUNGA, LAMBA LEDA, MANGGARAI TIMUR, NUSA TENGGARA TIMUR",3,143,5,148
https://kawalpemilu.org#58154,"GOLO MUNGA, LAMBA LEDA, MANGGARAI TIMUR, NUSA TENGGARA TIMUR",4,115,10,125
https://kawalpemilu.org#58155,"NAMPAR TABANG, LAMBA LEDA, MANGGARAI TIMUR, NUSA TENGGARA TIMUR",1,241,9,250
https://kawalpemilu.org#58155,"NAMPAR TABANG, LAMBA LEDA, MANGGARAI TIMUR, NUSA TENGGARA TIMUR",2,244,9,253
https://kawalpemilu.org#58155,"NAMPAR TABANG, LAMBA LEDA, MANGGARAI TIMUR, NUSA TENGGARA TIMUR",3,241,10,251
https://kawalpemilu.org#58155,"NAMPAR TABANG, LAMBA LEDA, MANGGARAI TIMUR, NUSA TENGGARA TIMUR",4,150,3,153
https://kawalpemilu.org#58155,"NAMPAR TABANG, LAMBA LEDA, MANGGARAI TIMUR, NUSA TENGGARA TIMUR",5,72,8,80
https://kawalpemilu.org#58156,"SATAR PUNDA, LAMBA LEDA, MANGGARAI TIMUR, NUSA TENGGARA TIMUR",1,231,10,241
https://kawalpemilu.org#58156,"SATAR PUNDA, LAMBA LEDA, MANGGARAI TIMUR, NUSA TENGGARA TIMUR",2,190,10,200
https://kawalpemilu.org#58156,"SATAR PUNDA, LAMBA LEDA, MANGGARAI TIMUR, NUSA TENGGARA TIMUR",3,151,12,163
https://kawalpemilu.org#58156,"SATAR PUNDA, LAMBA LEDA, MANGGARAI TIMUR, NUSA TENGGARA TIMUR",4,159,3,162
https://kawalpemilu.org#58156,"SATAR PUNDA, LAMBA LEDA, MANGGARAI TIMUR, NUSA TENGGARA TIMUR",5,184,10,194
https://kawalpemilu.org#58156,"SATAR PUNDA, LAMBA LEDA, MANGGARAI TIMUR, NUSA TENGGARA TIMUR",6,104,5,109
https://kawalpemilu.org#58157,"GOLO MANGUNG, LAMBA LEDA, MANGGARAI TIMUR, NUSA TENGGARA TIMUR",1,149,10,159
https://kawalpemilu.org#58157,"GOLO MANGUNG, LAMBA LEDA, MANGGARAI TIMUR, NUSA TENGGARA TIMUR",2,220,12,232
https://kawalpemilu.org#58157,"GOLO MANGUNG, LAMBA LEDA, MANGGARAI TIMUR, NUSA TENGGARA TIMUR",3,150,10,160
https://kawalpemilu.org#58157,"GOLO MANGUNG, LAMBA LEDA, MANGGARAI TIMUR, NUSA TENGGARA TIMUR",4,150,3,153
https://kawalpemilu.org#58157,"GOLO MANGUNG, LAMBA LEDA, MANGGARAI TIMUR, NUSA TENGGARA TIMUR",5,219,11,230
https://kawalpemilu.org#58157,"GOLO MANGUNG, LAMBA LEDA, MANGGARAI TIMUR, NUSA TENGGARA TIMUR",6,129,6,135
https://kawalpemilu.org#58158,"SATAR PADUT, LAMBA LEDA, MANGGARAI TIMUR, NUSA TENGGARA TIMUR",1,172,55,227
https://kawalpemilu.org#58158,"SATAR PADUT, LAMBA LEDA, MANGGARAI TIMUR, NUSA TENGGARA TIMUR",2,219,18,237
https://kawalpemilu.org#58158,"SATAR PADUT, LAMBA LEDA, MANGGARAI TIMUR, NUSA TENGGARA TIMUR",3,187,4,191
https://kawalpemilu.org#58158,"SATAR PADUT, LAMBA LEDA, MANGGARAI TIMUR, NUSA TENGGARA TIMUR",4,228,11,239
https://kawalpemilu.org#58158,"SATAR PADUT, LAMBA LEDA, MANGGARAI TIMUR, NUSA TENGGARA TIMUR",5,142,2,144
https://kawalpemilu.org#58158,"SATAR PADUT, LAMBA LEDA, MANGGARAI TIMUR, NUSA TENGGARA TIMUR",6,123,6,129
https://kawalpemilu.org#58158,"SATAR PADUT, LAMBA LEDA, MANGGARAI TIMUR, NUSA TENGGARA TIMUR",7,210,7,217
https://kawalpemilu.org#58159,"GOLO RENTUNG, LAMBA LEDA, MANGGARAI TIMUR, NUSA TENGGARA TIMUR",1,216,15,231
https://kawalpemilu.org#58159,"GOLO RENTUNG, LAMBA LEDA, MANGGARAI TIMUR, NUSA TENGGARA TIMUR",2,209,9,218
https://kawalpemilu.org#58159,"GOLO RENTUNG, LAMBA LEDA, MANGGARAI TIMUR, NUSA TENGGARA TIMUR",3,191,17,208
https://kawalpemilu.org#58160,"GOLO LEMBUR, LAMBA LEDA, MANGGARAI TIMUR, NUSA TENGGARA TIMUR",1,232,10,242
https://kawalpemilu.org#58160,"GOLO LEMBUR, LAMBA LEDA, MANGGARAI TIMUR, NUSA TENGGARA TIMUR",2,171,5,176
https://kawalpemilu.org#58160,"GOLO LEMBUR, LAMBA LEDA, MANGGARAI TIMUR, NUSA TENGGARA TIMUR",3,132,3,135
https://kawalpemilu.org#58161,"COMPANG NECAK, LAMBA LEDA, MANGGARAI TIMUR, NUSA TENGGARA TIMUR",1,131,22,153
https://kawalpemilu.org#58161,"COMPANG NECAK, LAMBA LEDA, MANGGARAI TIMUR, NUSA TENGGARA TIMUR",2,205,22,227
https://kawalpemilu.org#58161,"COMPANG NECAK, LAMBA LEDA, MANGGARAI TIMUR, NUSA TENGGARA TIMUR",3,156,17,173
https://kawalpemilu.org#58161,"COMPANG NECAK, LAMBA LEDA, MANGGARAI TIMUR, NUSA TENGGARA TIMUR",4,172,22,194
https://kawalpemilu.org#58162,"LENCUR, LAMBA LEDA, MANGGARAI TIMUR, NUSA TENGGARA TIMUR",1,122,9,131
https://kawalpemilu.org#58162,"LENCUR, LAMBA LEDA, MANGGARAI TIMUR, NUSA TENGGARA TIMUR",2,188,20,208
https://kawalpemilu.org#58162,"LENCUR, LAMBA LEDA, MANGGARAI TIMUR, NUSA TENGGARA TIMUR",3,103,8,111
https://kawalpemilu.org#58163,"COMPANG MEKAR, LAMBA LEDA, MANGGARAI TIMUR, NUSA TENGGARA TIMUR",1,189,14,203
https://kawalpemilu.org#58163,"COMPANG MEKAR, LAMBA LEDA, MANGGARAI TIMUR, NUSA TENGGARA TIMUR",2,196,7,203
https://kawalpemilu.org#58163,"COMPANG MEKAR, LAMBA LEDA, MANGGARAI TIMUR, NUSA TENGGARA TIMUR",3,219,16,235
https://kawalpemilu.org#58164,"COMPANG DERU, LAMBA LEDA, MANGGARAI TIMUR, NUSA TENGGARA TIMUR",1,158,8,166
https://kawalpemilu.org#58164,"COMPANG DERU, LAMBA LEDA, MANGGARAI TIMUR, NUSA TENGGARA TIMUR",2,193,22,215
https://kawalpemilu.org#58165,"LIANG DERUK, LAMBA LEDA, MANGGARAI TIMUR, NUSA TENGGARA TIMUR",1,203,36,239
https://kawalpemilu.org#58165,"LIANG DERUK, LAMBA LEDA, MANGGARAI TIMUR, NUSA TENGGARA TIMUR",2,78,19,97
https://kawalpemilu.org#58165,"LIANG DERUK, LAMBA LEDA, MANGGARAI TIMUR, NUSA TENGGARA TIMUR",3,116,9,125
https://kawalpemilu.org#58166,"GOLO NIMBUNG, LAMBA LEDA, MANGGARAI TIMUR, NUSA TENGGARA TIMUR",1,234,11,245
https://kawalpemilu.org#58166,"GOLO NIMBUNG, LAMBA LEDA, MANGGARAI TIMUR, NUSA TENGGARA TIMUR",2,154,4,158
https://kawalpemilu.org#58166,"GOLO NIMBUNG, LAMBA LEDA, MANGGARAI TIMUR, NUSA TENGGARA TIMUR",3,121,6,127
https://kawalpemilu.org#85251,"SATAR KAMPAS, LAMBA LEDA, MANGGARAI TIMUR, NUSA TENGGARA TIMUR",1,56,186,242
https://kawalpemilu.org#85251,"SATAR KAMPAS, LAMBA LEDA, MANGGARAI TIMUR, NUSA TENGGARA TIMUR",2,45,110,155
https://kawalpemilu.org#85251,"SATAR KAMPAS, LAMBA LEDA, MANGGARAI TIMUR, NUSA TENGGARA TIMUR",3,100,128,228
https://kawalpemilu.org#85251,"SATAR KAMPAS, LAMBA LEDA, MANGGARAI TIMUR, NUSA TENGGARA TIMUR",4,146,83,229
https://kawalpemilu.org#85251,"SATAR KAMPAS, LAMBA LEDA, MANGGARAI TIMUR, NUSA TENGGARA TIMUR",5,197,23,220
https://kawalpemilu.org#85251,"SATAR KAMPAS, LAMBA LEDA, MANGGARAI TIMUR, NUSA TENGGARA TIMUR",6,185,8,193
https://kawalpemilu.org#85252,"HAJU WANGI, LAMBA LEDA, MANGGARAI TIMUR, NUSA TENGGARA TIMUR",1,239,37,276
https://kawalpemilu.org#85252,"HAJU WANGI, LAMBA LEDA, MANGGARAI TIMUR, NUSA TENGGARA TIMUR",2,41,50,91
https://kawalpemilu.org#85252,"HAJU WANGI, LAMBA LEDA, MANGGARAI TIMUR, NUSA TENGGARA TIMUR",3,84,3,87
https://kawalpemilu.org#85253,"GOLO MUNGA BARAT, LAMBA LEDA, MANGGARAI TIMUR, NUSA TENGGARA TIMUR",1,258,17,275
https://kawalpemilu.org#85253,"GOLO MUNGA BARAT, LAMBA LEDA, MANGGARAI TIMUR, NUSA TENGGARA TIMUR",2,208,21,229
https://kawalpemilu.org#85253,"GOLO MUNGA BARAT, LAMBA LEDA, MANGGARAI TIMUR, NUSA TENGGARA TIMUR",3,140,7,147
https://kawalpemilu.org#85253,"GOLO MUNGA BARAT, LAMBA LEDA, MANGGARAI TIMUR, NUSA TENGGARA TIMUR",4,217,3,220
https://kawalpemilu.org#85254,"GORENG MENI UTARA, LAMBA LEDA, MANGGARAI TIMUR, NUSA TENGGARA TIMUR",1,150,20,170
https://kawalpemilu.org#85254,"GORENG MENI UTARA, LAMBA LEDA, MANGGARAI TIMUR, NUSA TENGGARA TIMUR",2,131,27,158
https://kawalpemilu.org#85255,"GOLO WONTONG, LAMBA LEDA, MANGGARAI TIMUR, NUSA TENGGARA TIMUR",1,219,6,225
https://kawalpemilu.org#85255,"GOLO WONTONG, LAMBA LEDA, MANGGARAI TIMUR, NUSA TENGGARA TIMUR",2,158,14,172
https://kawalpemilu.org#85255,"GOLO WONTONG, LAMBA LEDA, MANGGARAI TIMUR, NUSA TENGGARA TIMUR",3,134,3,137
https://kawalpemilu.org#85256,"GOLO PALENG, LAMBA LEDA, MANGGARAI TIMUR, NUSA TENGGARA TIMUR",1,240,17,257
https://kawalpemilu.org#85256,"GOLO PALENG, LAMBA LEDA, MANGGARAI TIMUR, NUSA TENGGARA TIMUR",2,101,12,113
https://kawalpemilu.org#85257,"SATAR PUNDA BARAT, LAMBA LEDA, MANGGARAI TIMUR, NUSA TENGGARA TIMUR",1,129,21,150
https://kawalpemilu.org#85257,"SATAR PUNDA BARAT, LAMBA LEDA, MANGGARAI TIMUR, NUSA TENGGARA TIMUR",2,65,158,223
https://kawalpemilu.org#85257,"SATAR PUNDA BARAT, LAMBA LEDA, MANGGARAI TIMUR, NUSA TENGGARA TIMUR",3,187,3,190
https://kawalpemilu.org#85257,"SATAR PUNDA BARAT, LAMBA LEDA, MANGGARAI TIMUR, NUSA TENGGARA TIMUR",4,223,14,237
https://kawalpemilu.org#85257,"SATAR PUNDA BARAT, LAMBA LEDA, MANGGARAI TIMUR, NUSA TENGGARA TIMUR",5,93,6,99
https://kawalpemilu.org#91319,"LAMBA KELI, LAMBA LEDA, MANGGARAI TIMUR, NUSA TENGGARA TIMUR",1,205,10,215
https://kawalpemilu.org#91319,"LAMBA KELI, LAMBA LEDA, MANGGARAI TIMUR, NUSA TENGGARA TIMUR",2,136,2,138
https://kawalpemilu.org#91319,"LAMBA KELI, LAMBA LEDA, MANGGARAI TIMUR, NUSA TENGGARA TIMUR",3,189,30,219
https://kawalpemilu.org#91319,"LAMBA KELI, LAMBA LEDA, MANGGARAI TIMUR, NUSA TENGGARA TIMUR",4,214,37,251
https://kawalpemilu.org#91319,"LAMBA KELI, LAMBA LEDA, MANGGARAI TIMUR, NUSA TENGGARA TIMUR",5,132,14,146
https://kawalpemilu.org#58168,"POTA, SAMBI RAMPAS, MANGGARAI TIMUR, NUSA TENGGARA TIMUR",1,95,104,199
https://kawalpemilu.org#58168,"POTA, SAMBI RAMPAS, MANGGARAI TIMUR, NUSA TENGGARA TIMUR",2,84,109,193
https://kawalpemilu.org#58168,"POTA, SAMBI RAMPAS, MANGGARAI TIMUR, NUSA TENGGARA TIMUR",3,30,183,213
https://kawalpemilu.org#58168,"POTA, SAMBI RAMPAS, MANGGARAI TIMUR, NUSA TENGGARA TIMUR",4,22,115,137
https://kawalpemilu.org#58168,"POTA, SAMBI RAMPAS, MANGGARAI TIMUR, NUSA TENGGARA TIMUR",5,67,165,232
https://kawalpemilu.org#58168,"POTA, SAMBI RAMPAS, MANGGARAI TIMUR, NUSA TENGGARA TIMUR",6,93,82,175
https://kawalpemilu.org#58168,"POTA, SAMBI RAMPAS, MANGGARAI TIMUR, NUSA TENGGARA TIMUR",7,26,177,203
https://kawalpemilu.org#58168,"POTA, SAMBI RAMPAS, MANGGARAI TIMUR, NUSA TENGGARA TIMUR",8,42,194,236
https://kawalpemilu.org#58168,"POTA, SAMBI RAMPAS, MANGGARAI TIMUR, NUSA TENGGARA TIMUR",9,54,172,226
https://kawalpemilu.org#58169,"GOLO WANGKUNG, SAMBI RAMPAS, MANGGARAI TIMUR, NUSA TENGGARA TIMUR",1,243,14,257
https://kawalpemilu.org#58169,"GOLO WANGKUNG, SAMBI RAMPAS, MANGGARAI TIMUR, NUSA TENGGARA TIMUR",2,187,36,223
https://kawalpemilu.org#58169,"GOLO WANGKUNG, SAMBI RAMPAS, MANGGARAI TIMUR, NUSA TENGGARA TIMUR",3,200,11,211
https://kawalpemilu.org#58169,"GOLO WANGKUNG, SAMBI RAMPAS, MANGGARAI TIMUR, NUSA TENGGARA TIMUR",4,138,13,151
https://kawalpemilu.org#58169,"GOLO WANGKUNG, SAMBI RAMPAS, MANGGARAI TIMUR, NUSA TENGGARA TIMUR",5,204,12,216
https://kawalpemilu.org#58170,"NANGA BARAS, SAMBI RAMPAS, MANGGARAI TIMUR, NUSA TENGGARA TIMUR",1,95,101,196
https://kawalpemilu.org#58170,"NANGA BARAS, SAMBI RAMPAS, MANGGARAI TIMUR, NUSA TENGGARA TIMUR",2,102,18,120
https://kawalpemilu.org#58170,"NANGA BARAS, SAMBI RAMPAS, MANGGARAI TIMUR, NUSA TENGGARA TIMUR",3,114,10,124
https://kawalpemilu.org#58170,"NANGA BARAS, SAMBI RAMPAS, MANGGARAI TIMUR, NUSA TENGGARA TIMUR",4,139,34,173
https://kawalpemilu.org#58171,"NANGA MBAUR, SAMBI RAMPAS, MANGGARAI TIMUR, NUSA TENGGARA TIMUR",1,23,191,214
https://kawalpemilu.org#58171,"NANGA MBAUR, SAMBI RAMPAS, MANGGARAI TIMUR, NUSA TENGGARA TIMUR",2,30,213,243
https://kawalpemilu.org#58171,"NANGA MBAUR, SAMBI RAMPAS, MANGGARAI TIMUR, NUSA TENGGARA TIMUR",3,21,236,257
https://kawalpemilu.org#58171,"NANGA MBAUR, SAMBI RAMPAS, MANGGARAI TIMUR, NUSA TENGGARA TIMUR",4,36,152,188
https://kawalpemilu.org#58171,"NANGA MBAUR, SAMBI RAMPAS, MANGGARAI TIMUR, NUSA TENGGARA TIMUR",5,41,173,214
https://kawalpemilu.org#58172,"NANGA MBALING, SAMBI RAMPAS, MANGGARAI TIMUR, NUSA TENGGARA TIMUR",1,13,214,227
https://kawalpemilu.org#58172,"NANGA MBALING, SAMBI RAMPAS, MANGGARAI TIMUR, NUSA TENGGARA TIMUR",2,6,102,108
https://kawalpemilu.org#58172,"NANGA MBALING, SAMBI RAMPAS, MANGGARAI TIMUR, NUSA TENGGARA TIMUR",3,88,149,237
https://kawalpemilu.org#58172,"NANGA MBALING, SAMBI RAMPAS, MANGGARAI TIMUR, NUSA TENGGARA TIMUR",4,136,88,224
https://kawalpemilu.org#58172,"NANGA MBALING, SAMBI RAMPAS, MANGGARAI TIMUR, NUSA TENGGARA TIMUR",5,16,68,84
https://kawalpemilu.org#58172,"NANGA MBALING, SAMBI RAMPAS, MANGGARAI TIMUR, NUSA TENGGARA TIMUR",6,1,79,80
https://kawalpemilu.org#58172,"NANGA MBALING, SAMBI RAMPAS, MANGGARAI TIMUR, NUSA TENGGARA TIMUR",7,123,24,147
https://kawalpemilu.org#58172,"NANGA MBALING, SAMBI RAMPAS, MANGGARAI TIMUR, NUSA TENGGARA TIMUR",8,148,13,161
https://kawalpemilu.org#58173,"BUTI, SAMBI RAMPAS, MANGGARAI TIMUR, NUSA TENGGARA TIMUR",1,207,9,216
https://kawalpemilu.org#58173,"BUTI, SAMBI RAMPAS, MANGGARAI TIMUR, NUSA TENGGARA TIMUR",2,215,8,223
https://kawalpemilu.org#58173,"BUTI, SAMBI RAMPAS, MANGGARAI TIMUR, NUSA TENGGARA TIMUR",3,112,2,114
https://kawalpemilu.org#58173,"BUTI, SAMBI RAMPAS, MANGGARAI TIMUR, NUSA TENGGARA TIMUR",4,229,11,240
https://kawalpemilu.org#58174,"GOLO NGAWAN, SAMBI RAMPAS, MANGGARAI TIMUR, NUSA TENGGARA TIMUR",1,80,71,151
https://kawalpemilu.org#58174,"GOLO NGAWAN, SAMBI RAMPAS, MANGGARAI TIMUR, NUSA TENGGARA TIMUR",2,149,82,231
https://kawalpemilu.org#58174,"GOLO NGAWAN, SAMBI RAMPAS, MANGGARAI TIMUR, NUSA TENGGARA TIMUR",3,111,59,170
https://kawalpemilu.org#58174,"GOLO NGAWAN, SAMBI RAMPAS, MANGGARAI TIMUR, NUSA TENGGARA TIMUR",4,109,88,197
https://kawalpemilu.org#58175,"SATAR NAWANG, SAMBI RAMPAS, MANGGARAI TIMUR, NUSA TENGGARA TIMUR",1,221,15,236
https://kawalpemilu.org#58175,"SATAR NAWANG, SAMBI RAMPAS, MANGGARAI TIMUR, NUSA TENGGARA TIMUR",2,148,10,158
https://kawalpemilu.org#58175,"SATAR NAWANG, SAMBI RAMPAS, MANGGARAI TIMUR, NUSA TENGGARA TIMUR",3,150,13,163
https://kawalpemilu.org#58176,"RANA MESE, SAMBI RAMPAS, MANGGARAI TIMUR, NUSA TENGGARA TIMUR",1,181,12,193
https://kawalpemilu.org#58176,"RANA MESE, SAMBI RAMPAS, MANGGARAI TIMUR, NUSA TENGGARA TIMUR",2,171,55,226
https://kawalpemilu.org#58176,"RANA MESE, SAMBI RAMPAS, MANGGARAI TIMUR, NUSA TENGGARA TIMUR",3,161,11,172
https://kawalpemilu.org#58176,"RANA MESE, SAMBI RAMPAS, MANGGARAI TIMUR, NUSA TENGGARA TIMUR",4,172,11,183
https://kawalpemilu.org#58176,"RANA MESE, SAMBI RAMPAS, MANGGARAI TIMUR, NUSA TENGGARA TIMUR",5,89,16,105
https://kawalpemilu.org#58176,"RANA MESE, SAMBI RAMPAS, MANGGARAI TIMUR, NUSA TENGGARA TIMUR",6,141,9,150
https://kawalpemilu.org#58177,"LADA MESE, SAMBI RAMPAS, MANGGARAI TIMUR, NUSA TENGGARA TIMUR",1,159,10,169
https://kawalpemilu.org#58177,"LADA MESE, SAMBI RAMPAS, MANGGARAI TIMUR, NUSA TENGGARA TIMUR",2,135,10,145
https://kawalpemilu.org#58178,"COMPANG CONGKAR, SAMBI RAMPAS, MANGGARAI TIMUR, NUSA TENGGARA TIMUR",1,239,8,247
https://kawalpemilu.org#58178,"COMPANG CONGKAR, SAMBI RAMPAS, MANGGARAI TIMUR, NUSA TENGGARA TIMUR",2,252,12,264
https://kawalpemilu.org#58178,"COMPANG CONGKAR, SAMBI RAMPAS, MANGGARAI TIMUR, NUSA TENGGARA TIMUR",3,97,3,100
https://kawalpemilu.org#58178,"COMPANG CONGKAR, SAMBI RAMPAS, MANGGARAI TIMUR, NUSA TENGGARA TIMUR",4,128,7,135
https://kawalpemilu.org#85258,"ULUNG BARAS, SAMBI RAMPAS, MANGGARAI TIMUR, NUSA TENGGARA TIMUR",1,198,22,220
https://kawalpemilu.org#85258,"ULUNG BARAS, SAMBI RAMPAS, MANGGARAI TIMUR, NUSA TENGGARA TIMUR",2,128,8,136
https://kawalpemilu.org#85258,"ULUNG BARAS, SAMBI RAMPAS, MANGGARAI TIMUR, NUSA TENGGARA TIMUR",3,141,39,180
https://kawalpemilu.org#85258,"ULUNG BARAS, SAMBI RAMPAS, MANGGARAI TIMUR, NUSA TENGGARA TIMUR",4,121,22,143
https://kawalpemilu.org#85258,"ULUNG BARAS, SAMBI RAMPAS, MANGGARAI TIMUR, NUSA TENGGARA TIMUR",5,89,15,104
https://kawalpemilu.org#85258,"ULUNG BARAS, SAMBI RAMPAS, MANGGARAI TIMUR, NUSA TENGGARA TIMUR",6,67,12,79
https://kawalpemilu.org#85259,"NAMPAR SEPANG, SAMBI RAMPAS, MANGGARAI TIMUR, NUSA TENGGARA TIMUR",1,4,165,169
https://kawalpemilu.org#85259,"NAMPAR SEPANG, SAMBI RAMPAS, MANGGARAI TIMUR, NUSA TENGGARA TIMUR",2,32,198,230
https://kawalpemilu.org#85259,"NAMPAR SEPANG, SAMBI RAMPAS, MANGGARAI TIMUR, NUSA TENGGARA TIMUR",3,120,104,224
https://kawalpemilu.org#85259,"NAMPAR SEPANG, SAMBI RAMPAS, MANGGARAI TIMUR, NUSA TENGGARA TIMUR",4,10,111,121
https://kawalpemilu.org#85260,"KEMBANG MEKAR, SAMBI RAMPAS, MANGGARAI TIMUR, NUSA TENGGARA TIMUR",1,206,36,242
https://kawalpemilu.org#85260,"KEMBANG MEKAR, SAMBI RAMPAS, MANGGARAI TIMUR, NUSA TENGGARA TIMUR",2,146,8,154
https://kawalpemilu.org#85261,"COMPANG LAWI, SAMBI RAMPAS, MANGGARAI TIMUR, NUSA TENGGARA TIMUR",1,156,81,237
https://kawalpemilu.org#85261,"COMPANG LAWI, SAMBI RAMPAS, MANGGARAI TIMUR, NUSA TENGGARA TIMUR",2,163,13,176
https://kawalpemilu.org#85261,"COMPANG LAWI, SAMBI RAMPAS, MANGGARAI TIMUR, NUSA TENGGARA TIMUR",3,203,8,211
https://kawalpemilu.org#85261,"COMPANG LAWI, SAMBI RAMPAS, MANGGARAI TIMUR, NUSA TENGGARA TIMUR",4,128,12,140
https://kawalpemilu.org#85261,"COMPANG LAWI, SAMBI RAMPAS, MANGGARAI TIMUR, NUSA TENGGARA TIMUR",5,213,10,223
https://kawalpemilu.org#85261,"COMPANG LAWI, SAMBI RAMPAS, MANGGARAI TIMUR, NUSA TENGGARA TIMUR",6,114,2,116
https://kawalpemilu.org#91320,"GOLO WANGKUNG BARAT, SAMBI RAMPAS, MANGGARAI TIMUR, NUSA TENGGARA TIMUR",1,213,17,230
https://kawalpemilu.org#91320,"GOLO WANGKUNG BARAT, SAMBI RAMPAS, MANGGARAI TIMUR, NUSA TENGGARA TIMUR",2,200,21,221
https://kawalpemilu.org#91321,"GOLO WANGKUNG UTARA, SAMBI RAMPAS, MANGGARAI TIMUR, NUSA TENGGARA TIMUR",1,131,16,147
https://kawalpemilu.org#91321,"GOLO WANGKUNG UTARA, SAMBI RAMPAS, MANGGARAI TIMUR, NUSA TENGGARA TIMUR",2,123,4,127
https://kawalpemilu.org#91321,"GOLO WANGKUNG UTARA, SAMBI RAMPAS, MANGGARAI TIMUR, NUSA TENGGARA TIMUR",3,80,8,88
https://kawalpemilu.org#91322,"WELA LADA, SAMBI RAMPAS, MANGGARAI TIMUR, NUSA TENGGARA TIMUR",1,190,13,203
https://kawalpemilu.org#91322,"WELA LADA, SAMBI RAMPAS, MANGGARAI TIMUR, NUSA TENGGARA TIMUR",2,205,23,228
https://kawalpemilu.org#91322,"WELA LADA, SAMBI RAMPAS, MANGGARAI TIMUR, NUSA TENGGARA TIMUR",3,210,13,223
https://kawalpemilu.org#91323,"GOLO PARI, SAMBI RAMPAS, MANGGARAI TIMUR, NUSA TENGGARA TIMUR",1,159,22,181
https://kawalpemilu.org#91323,"GOLO PARI, SAMBI RAMPAS, MANGGARAI TIMUR, NUSA TENGGARA TIMUR",2,121,13,134
https://kawalpemilu.org#91323,"GOLO PARI, SAMBI RAMPAS, MANGGARAI TIMUR, NUSA TENGGARA TIMUR",3,198,22,220
https://kawalpemilu.org#91324,"WEA, SAMBI RAMPAS, MANGGARAI TIMUR, NUSA TENGGARA TIMUR",1,183,11,194
https://kawalpemilu.org#91324,"WEA, SAMBI RAMPAS, MANGGARAI TIMUR, NUSA TENGGARA TIMUR",2,167,5,172
https://kawalpemilu.org#91324,"WEA, SAMBI RAMPAS, MANGGARAI TIMUR, NUSA TENGGARA TIMUR",3,121,6,127
https://kawalpemilu.org#58180,"TIWU KONDO, ELAR, MANGGARAI TIMUR, NUSA TENGGARA TIMUR",1,159,15,174
https://kawalpemilu.org#58180,"TIWU KONDO, ELAR, MANGGARAI TIMUR, NUSA TENGGARA TIMUR",2,140,33,173
https://kawalpemilu.org#58180,"TIWU KONDO, ELAR, MANGGARAI TIMUR, NUSA TENGGARA TIMUR",3,191,23,214
https://kawalpemilu.org#58180,"TIWU KONDO, ELAR, MANGGARAI TIMUR, NUSA TENGGARA TIMUR",4,129,29,158
https://kawalpemilu.org#58182,"LENGKO NAMUT, ELAR, MANGGARAI TIMUR, NUSA TENGGARA TIMUR",1,228,17,245
https://kawalpemilu.org#58182,"LENGKO NAMUT, ELAR, MANGGARAI TIMUR, NUSA TENGGARA TIMUR",2,196,10,206
https://kawalpemilu.org#58182,"LENGKO NAMUT, ELAR, MANGGARAI TIMUR, NUSA TENGGARA TIMUR",3,163,12,175
https://kawalpemilu.org#58183,"RANA KULAN, ELAR, MANGGARAI TIMUR, NUSA TENGGARA TIMUR",1,157,10,167
https://kawalpemilu.org#58183,"RANA KULAN, ELAR, MANGGARAI TIMUR, NUSA TENGGARA TIMUR",2,121,28,149
https://kawalpemilu.org#58184,"GOLO MUNDE, ELAR, MANGGARAI TIMUR, NUSA TENGGARA TIMUR",1,162,9,171
https://kawalpemilu.org#58184,"GOLO MUNDE, ELAR, MANGGARAI TIMUR, NUSA TENGGARA TIMUR",2,210,11,221
https://kawalpemilu.org#58184,"GOLO MUNDE, ELAR, MANGGARAI TIMUR, NUSA TENGGARA TIMUR",3,106,4,110
https://kawalpemilu.org#58185,"GOLO LEBO, ELAR, MANGGARAI TIMUR, NUSA TENGGARA TIMUR",1,239,17,256
https://kawalpemilu.org#58185,"GOLO LEBO, ELAR, MANGGARAI TIMUR, NUSA TENGGARA TIMUR",2,135,70,205
https://kawalpemilu.org#58185,"GOLO LEBO, ELAR, MANGGARAI TIMUR, NUSA TENGGARA TIMUR",3,96,59,155
https://kawalpemilu.org#58185,"GOLO LEBO, ELAR, MANGGARAI TIMUR, NUSA TENGGARA TIMUR",4,104,22,126
https://kawalpemilu.org#58186,"GOLO LIJUN, ELAR, MANGGARAI TIMUR, NUSA TENGGARA TIMUR",1,15,187,202
https://kawalpemilu.org#58186,"GOLO LIJUN, ELAR, MANGGARAI TIMUR, NUSA TENGGARA TIMUR",2,166,20,186
https://kawalpemilu.org#58186,"GOLO LIJUN, ELAR, MANGGARAI TIMUR, NUSA TENGGARA TIMUR",3,180,39,219
https://kawalpemilu.org#58186,"GOLO LIJUN, ELAR, MANGGARAI TIMUR, NUSA TENGGARA TIMUR",4,126,33,159
https://kawalpemilu.org#58190,"SISIR, ELAR, MANGGARAI TIMUR, NUSA TENGGARA TIMUR",1,198,28,226
https://kawalpemilu.org#58190,"SISIR, ELAR, MANGGARAI TIMUR, NUSA TENGGARA TIMUR",2,168,17,185
https://kawalpemilu.org#58196,"HAJU NGENDONG, ELAR, MANGGARAI TIMUR, NUSA TENGGARA TIMUR",1,179,11,190
https://kawalpemilu.org#58196,"HAJU NGENDONG, ELAR, MANGGARAI TIMUR, NUSA TENGGARA TIMUR",2,101,6,107
https://kawalpemilu.org#58196,"HAJU NGENDONG, ELAR, MANGGARAI TIMUR, NUSA TENGGARA TIMUR",3,196,12,208
https://kawalpemilu.org#58197,"LEGUR LAI, ELAR, MANGGARAI TIMUR, NUSA TENGGARA TIMUR",1,140,2,142
https://kawalpemilu.org#58197,"LEGUR LAI, ELAR, MANGGARAI TIMUR, NUSA TENGGARA TIMUR",2,212,18,230
https://kawalpemilu.org#58197,"LEGUR LAI, ELAR, MANGGARAI TIMUR, NUSA TENGGARA TIMUR",3,49,11,60
https://kawalpemilu.org#58198,"RANA GAPANG, ELAR, MANGGARAI TIMUR, NUSA TENGGARA TIMUR",1,260,11,271
https://kawalpemilu.org#58198,"RANA GAPANG, ELAR, MANGGARAI TIMUR, NUSA TENGGARA TIMUR",2,134,12,146
https://kawalpemilu.org#58198,"RANA GAPANG, ELAR, MANGGARAI TIMUR, NUSA TENGGARA TIMUR",3,182,11,193
https://kawalpemilu.org#58198,"RANA GAPANG, ELAR, MANGGARAI TIMUR, NUSA TENGGARA TIMUR",4,207,18,225
https://kawalpemilu.org#58199,"BITING, ELAR, MANGGARAI TIMUR, NUSA TENGGARA TIMUR",1,99,77,176
https://kawalpemilu.org#58199,"BITING, ELAR, MANGGARAI TIMUR, NUSA TENGGARA TIMUR",2,174,22,196
https://kawalpemilu.org#58199,"BITING, ELAR, MANGGARAI TIMUR, NUSA TENGGARA TIMUR",3,128,11,139
https://kawalpemilu.org#58199,"BITING, ELAR, MANGGARAI TIMUR, NUSA TENGGARA TIMUR",4,5,100,105
https://kawalpemilu.org#85262,"KAJU WANGI, ELAR, MANGGARAI TIMUR, NUSA TENGGARA TIMUR",1,119,13,132
https://kawalpemilu.org#85262,"KAJU WANGI, ELAR, MANGGARAI TIMUR, NUSA TENGGARA TIMUR",2,140,28,168
https://kawalpemilu.org#85262,"KAJU WANGI, ELAR, MANGGARAI TIMUR, NUSA TENGGARA TIMUR",3,137,26,163
https://kawalpemilu.org#85263,"WAE LOKOM, ELAR, MANGGARAI TIMUR, NUSA TENGGARA TIMUR",1,209,3,212
https://kawalpemilu.org#85263,"WAE LOKOM, ELAR, MANGGARAI TIMUR, NUSA TENGGARA TIMUR",2,213,5,218
https://kawalpemilu.org#91325,"COMPANG SOBA, ELAR, MANGGARAI TIMUR, NUSA TENGGARA TIMUR",1,198,2,200
https://kawalpemilu.org#91325,"COMPANG SOBA, ELAR, MANGGARAI TIMUR, NUSA TENGGARA TIMUR",2,101,99,200
https://kawalpemilu.org#91325,"COMPANG SOBA, ELAR, MANGGARAI TIMUR, NUSA TENGGARA TIMUR",3,29,77,106
https://kawalpemilu.org#91326,"COMPANG TEO, ELAR, MANGGARAI TIMUR, NUSA TENGGARA TIMUR",1,116,34,150
https://kawalpemilu.org#91326,"COMPANG TEO, ELAR, MANGGARAI TIMUR, NUSA TENGGARA TIMUR",2,116,90,206
https://kawalpemilu.org#91326,"COMPANG TEO, ELAR, MANGGARAI TIMUR, NUSA TENGGARA TIMUR",3,98,18,116
https://kawalpemilu.org#58202,"TANAH RATA, KOTA KOMBA, MANGGARAI TIMUR, NUSA TENGGARA TIMUR",1,184,12,196
https://kawalpemilu.org#58202,"TANAH RATA, KOTA KOMBA, MANGGARAI TIMUR, NUSA TENGGARA TIMUR",2,206,11,217
https://kawalpemilu.org#58202,"TANAH RATA, KOTA KOMBA, MANGGARAI TIMUR, NUSA TENGGARA TIMUR",3,263,6,269
https://kawalpemilu.org#58202,"TANAH RATA, KOTA KOMBA, MANGGARAI TIMUR, NUSA TENGGARA TIMUR",4,182,10,192
https://kawalpemilu.org#58202,"TANAH RATA, KOTA KOMBA, MANGGARAI TIMUR, NUSA TENGGARA TIMUR",5,184,15,199
https://kawalpemilu.org#58202,"TANAH RATA, KOTA KOMBA, MANGGARAI TIMUR, NUSA TENGGARA TIMUR",6,222,19,241
https://kawalpemilu.org#58202,"TANAH RATA, KOTA KOMBA, MANGGARAI TIMUR, NUSA TENGGARA TIMUR",7,194,13,207
https://kawalpemilu.org#58202,"TANAH RATA, KOTA KOMBA, MANGGARAI TIMUR, NUSA TENGGARA TIMUR",8,172,10,182
https://kawalpemilu.org#58202,"TANAH RATA, KOTA KOMBA, MANGGARAI TIMUR, NUSA TENGGARA TIMUR",9,220,11,231
https://kawalpemilu.org#58202,"TANAH RATA, KOTA KOMBA, MANGGARAI TIMUR, NUSA TENGGARA TIMUR",10,181,5,186
https://kawalpemilu.org#58202,"TANAH RATA, KOTA KOMBA, MANGGARAI TIMUR, NUSA TENGGARA TIMUR",11,155,4,159
https://kawalpemilu.org#58202,"TANAH RATA, KOTA KOMBA, MANGGARAI TIMUR, NUSA TENGGARA TIMUR",12,109,11,120
https://kawalpemilu.org#58203,"WATU NGGENE, KOTA KOMBA, MANGGARAI TIMUR, NUSA TENGGARA TIMUR",1,167,10,177
https://kawalpemilu.org#58203,"WATU NGGENE, KOTA KOMBA, MANGGARAI TIMUR, NUSA TENGGARA TIMUR",2,161,10,171
https://kawalpemilu.org#58203,"WATU NGGENE, KOTA KOMBA, MANGGARAI TIMUR, NUSA TENGGARA TIMUR",3,115,4,119
https://kawalpemilu.org#58203,"WATU NGGENE, KOTA KOMBA, MANGGARAI TIMUR, NUSA TENGGARA TIMUR",4,169,3,172
https://kawalpemilu.org#58203,"WATU NGGENE, KOTA KOMBA, MANGGARAI TIMUR, NUSA TENGGARA TIMUR",5,112,42,154
https://kawalpemilu.org#58203,"WATU NGGENE, KOTA KOMBA, MANGGARAI TIMUR, NUSA TENGGARA TIMUR",6,178,11,189
https://kawalpemilu.org#58203,"WATU NGGENE, KOTA KOMBA, MANGGARAI TIMUR, NUSA TENGGARA TIMUR",7,169,14,183
https://kawalpemilu.org#58203,"WATU NGGENE, KOTA KOMBA, MANGGARAI TIMUR, NUSA TENGGARA TIMUR",8,148,13,161
https://kawalpemilu.org#58203,"WATU NGGENE, KOTA KOMBA, MANGGARAI TIMUR, NUSA TENGGARA TIMUR",9,197,15,212
https://kawalpemilu.org#58203,"WATU NGGENE, KOTA KOMBA, MANGGARAI TIMUR, NUSA TENGGARA TIMUR",10,191,5,196
https://kawalpemilu.org#58203,"WATU NGGENE, KOTA KOMBA, MANGGARAI TIMUR, NUSA TENGGARA TIMUR",11,89,6,95
https://kawalpemilu.org#58203,"WATU NGGENE, KOTA KOMBA, MANGGARAI TIMUR, NUSA TENGGARA TIMUR",12,165,14,179
https://kawalpemilu.org#58203,"WATU NGGENE, KOTA KOMBA, MANGGARAI TIMUR, NUSA TENGGARA TIMUR",13,219,5,224
https://kawalpemilu.org#58204,"RONGGA KOE, KOTA KOMBA, MANGGARAI TIMUR, NUSA TENGGARA TIMUR",1,213,12,225
https://kawalpemilu.org#58204,"RONGGA KOE, KOTA KOMBA, MANGGARAI TIMUR, NUSA TENGGARA TIMUR",2,181,19,200
https://kawalpemilu.org#58204,"RONGGA KOE, KOTA KOMBA, MANGGARAI TIMUR, NUSA TENGGARA TIMUR",3,162,15,177
https://kawalpemilu.org#58204,"RONGGA KOE, KOTA KOMBA, MANGGARAI TIMUR, NUSA TENGGARA TIMUR",4,178,17,195
https://kawalpemilu.org#58204,"RONGGA KOE, KOTA KOMBA, MANGGARAI TIMUR, NUSA TENGGARA TIMUR",5,119,1,120
https://kawalpemilu.org#58204,"RONGGA KOE, KOTA KOMBA, MANGGARAI TIMUR, NUSA TENGGARA TIMUR",6,218,16,234
https://kawalpemilu.org#58204,"RONGGA KOE, KOTA KOMBA, MANGGARAI TIMUR, NUSA TENGGARA TIMUR",7,184,16,200
https://kawalpemilu.org#58204,"RONGGA KOE, KOTA KOMBA, MANGGARAI TIMUR, NUSA TENGGARA TIMUR",8,157,6,163
https://kawalpemilu.org#58204,"RONGGA KOE, KOTA KOMBA, MANGGARAI TIMUR, NUSA TENGGARA TIMUR",9,148,12,160
https://kawalpemilu.org#58205,"LEMBUR, KOTA KOMBA, MANGGARAI TIMUR, NUSA TENGGARA TIMUR",1,210,8,218
https://kawalpemilu.org#58205,"LEMBUR, KOTA KOMBA, MANGGARAI TIMUR, NUSA TENGGARA TIMUR",2,145,15,160
https://kawalpemilu.org#58205,"LEMBUR, KOTA KOMBA, MANGGARAI TIMUR, NUSA TENGGARA TIMUR",3,210,13,223
https://kawalpemilu.org#58205,"LEMBUR, KOTA KOMBA, MANGGARAI TIMUR, NUSA TENGGARA TIMUR",4,194,20,214
https://kawalpemilu.org#58205,"LEMBUR, KOTA KOMBA, MANGGARAI TIMUR, NUSA TENGGARA TIMUR",5,206,19,225
https://kawalpemilu.org#58205,"LEMBUR, KOTA KOMBA, MANGGARAI TIMUR, NUSA TENGGARA TIMUR",6,203,11,214
https://kawalpemilu.org#58205,"LEMBUR, KOTA KOMBA, MANGGARAI TIMUR, NUSA TENGGARA TIMUR",7,177,7,184
https://kawalpemilu.org#58205,"LEMBUR, KOTA KOMBA, MANGGARAI TIMUR, NUSA TENGGARA TIMUR",8,169,25,194
https://kawalpemilu.org#58205,"LEMBUR, KOTA KOMBA, MANGGARAI TIMUR, NUSA TENGGARA TIMUR",9,184,6,190
https://kawalpemilu.org#58205,"LEMBUR, KOTA KOMBA, MANGGARAI TIMUR, NUSA TENGGARA TIMUR",10,154,9,163
https://kawalpemilu.org#58206,"RUAN, KOTA KOMBA, MANGGARAI TIMUR, NUSA TENGGARA TIMUR",1,177,15,192
https://kawalpemilu.org#58206,"RUAN, KOTA KOMBA, MANGGARAI TIMUR, NUSA TENGGARA TIMUR",2,232,11,243
https://kawalpemilu.org#58206,"RUAN, KOTA KOMBA, MANGGARAI TIMUR, NUSA TENGGARA TIMUR",3,171,7,178
https://kawalpemilu.org#58206,"RUAN, KOTA KOMBA, MANGGARAI TIMUR, NUSA TENGGARA TIMUR",4,181,15,196
https://kawalpemilu.org#58206,"RUAN, KOTA KOMBA, MANGGARAI TIMUR, NUSA TENGGARA TIMUR",5,122,5,127
https://kawalpemilu.org#58206,"RUAN, KOTA KOMBA, MANGGARAI TIMUR, NUSA TENGGARA TIMUR",6,80,11,91
https://kawalpemilu.org#58206,"RUAN, KOTA KOMBA, MANGGARAI TIMUR, NUSA TENGGARA TIMUR",7,80,28,108
https://kawalpemilu.org#58207,"GOLO TOLANG, KOTA KOMBA, MANGGARAI TIMUR, NUSA TENGGARA TIMUR",1,163,12,175
https://kawalpemilu.org#58207,"GOLO TOLANG, KOTA KOMBA, MANGGARAI TIMUR, NUSA TENGGARA TIMUR",2,196,10,206
https://kawalpemilu.org#58207,"GOLO TOLANG, KOTA KOMBA, MANGGARAI TIMUR, NUSA TENGGARA TIMUR",3,197,9,206
https://kawalpemilu.org#58207,"GOLO TOLANG, KOTA KOMBA, MANGGARAI TIMUR, NUSA TENGGARA TIMUR",4,218,21,239
https://kawalpemilu.org#58207,"GOLO TOLANG, KOTA KOMBA, MANGGARAI TIMUR, NUSA TENGGARA TIMUR",5,153,11,164
https://kawalpemilu.org#58207,"GOLO TOLANG, KOTA KOMBA, MANGGARAI TIMUR, NUSA TENGGARA TIMUR",6,196,8,204
https://kawalpemilu.org#58208,"MBENGAN, KOTA KOMBA, MANGGARAI TIMUR, NUSA TENGGARA TIMUR",1,165,17,182
https://kawalpemilu.org#58208,"MBENGAN, KOTA KOMBA, MANGGARAI TIMUR, NUSA TENGGARA TIMUR",2,164,18,182
https://kawalpemilu.org#58208,"MBENGAN, KOTA KOMBA, MANGGARAI TIMUR, NUSA TENGGARA TIMUR",3,166,11,177
https://kawalpemilu.org#58208,"MBENGAN, KOTA KOMBA, MANGGARAI TIMUR, NUSA TENGGARA TIMUR",4,191,11,202
https://kawalpemilu.org#58208,"MBENGAN, KOTA KOMBA, MANGGARAI TIMUR, NUSA TENGGARA TIMUR",5,183,8,191
https://kawalpemilu.org#58208,"MBENGAN, KOTA KOMBA, MANGGARAI TIMUR, NUSA TENGGARA TIMUR",6,164,11,175
https://kawalpemilu.org#58208,"MBENGAN, KOTA KOMBA, MANGGARAI TIMUR, NUSA TENGGARA TIMUR",7,140,13,153
https://kawalpemilu.org#58209,"RANA KOLONG, KOTA KOMBA, MANGGARAI TIMUR, NUSA TENGGARA TIMUR",1,197,6,203
https://kawalpemilu.org#58209,"RANA KOLONG, KOTA KOMBA, MANGGARAI TIMUR, NUSA TENGGARA TIMUR",2,185,18,203
https://kawalpemilu.org#58209,"RANA KOLONG, KOTA KOMBA, MANGGARAI TIMUR, NUSA TENGGARA TIMUR",3,214,16,230
https://kawalpemilu.org#58209,"RANA KOLONG, KOTA KOMBA, MANGGARAI TIMUR, NUSA TENGGARA TIMUR",4,128,29,157
https://kawalpemilu.org#58209,"RANA KOLONG, KOTA KOMBA, MANGGARAI TIMUR, NUSA TENGGARA TIMUR",5,189,11,200
https://kawalpemilu.org#58209,"RANA KOLONG, KOTA KOMBA, MANGGARAI TIMUR, NUSA TENGGARA TIMUR",6,157,13,170
https://kawalpemilu.org#58209,"RANA KOLONG, KOTA KOMBA, MANGGARAI TIMUR, NUSA TENGGARA TIMUR",7,195,12,207
https://kawalpemilu.org#58210,"GUNUNG, KOTA KOMBA, MANGGARAI TIMUR, NUSA TENGGARA TIMUR",1,225,18,243
https://kawalpemilu.org#58210,"GUNUNG, KOTA KOMBA, MANGGARAI TIMUR, NUSA TENGGARA TIMUR",2,218,31,249
https://kawalpemilu.org#58210,"GUNUNG, KOTA KOMBA, MANGGARAI TIMUR, NUSA TENGGARA TIMUR",3,103,7,110
https://kawalpemilu.org#58210,"GUNUNG, KOTA KOMBA, MANGGARAI TIMUR, NUSA TENGGARA TIMUR",4,124,24,148
https://kawalpemilu.org#58210,"GUNUNG, KOTA KOMBA, MANGGARAI TIMUR, NUSA TENGGARA TIMUR",5,75,3,78
https://kawalpemilu.org#58210,"GUNUNG, KOTA KOMBA, MANGGARAI TIMUR, NUSA TENGGARA TIMUR",6,86,18,104
https://kawalpemilu.org#58210,"GUNUNG, KOTA KOMBA, MANGGARAI TIMUR, NUSA TENGGARA TIMUR",7,177,17,194
https://kawalpemilu.org#58211,"MOKEL, KOTA KOMBA, MANGGARAI TIMUR, NUSA TENGGARA TIMUR",1,196,43,239
https://kawalpemilu.org#58211,"MOKEL, KOTA KOMBA, MANGGARAI TIMUR, NUSA TENGGARA TIMUR",2,174,22,196
https://kawalpemilu.org#58211,"MOKEL, KOTA KOMBA, MANGGARAI TIMUR, NUSA TENGGARA TIMUR",3,196,14,210
https://kawalpemilu.org#58211,"MOKEL, KOTA KOMBA, MANGGARAI TIMUR, NUSA TENGGARA TIMUR",4,218,20,238
https://kawalpemilu.org#58211,"MOKEL, KOTA KOMBA, MANGGARAI TIMUR, NUSA TENGGARA TIMUR",5,149,20,169
https://kawalpemilu.org#58211,"MOKEL, KOTA KOMBA, MANGGARAI TIMUR, NUSA TENGGARA TIMUR",6,118,17,135
https://kawalpemilu.org#58212,"GOLO MENI, KOTA KOMBA, MANGGARAI TIMUR, NUSA TENGGARA TIMUR",1,175,31,206
https://kawalpemilu.org#58212,"GOLO MENI, KOTA KOMBA, MANGGARAI TIMUR, NUSA TENGGARA TIMUR",2,183,25,208
https://kawalpemilu.org#58212,"GOLO MENI, KOTA KOMBA, MANGGARAI TIMUR, NUSA TENGGARA TIMUR",3,145,24,169
https://kawalpemilu.org#58212,"GOLO MENI, KOTA KOMBA, MANGGARAI TIMUR, NUSA TENGGARA TIMUR",4,172,19,191
https://kawalpemilu.org#58212,"GOLO MENI, KOTA KOMBA, MANGGARAI TIMUR, NUSA TENGGARA TIMUR",5,184,34,218
https://kawalpemilu.org#58212,"GOLO MENI, KOTA KOMBA, MANGGARAI TIMUR, NUSA TENGGARA TIMUR",6,175,11,186
https://kawalpemilu.org#58212,"GOLO MENI, KOTA KOMBA, MANGGARAI TIMUR, NUSA TENGGARA TIMUR",7,155,10,165
https://kawalpemilu.org#58213,"RANA MBELING, KOTA KOMBA, MANGGARAI TIMUR, NUSA TENGGARA TIMUR",1,188,15,203
https://kawalpemilu.org#58213,"RANA MBELING, KOTA KOMBA, MANGGARAI TIMUR, NUSA TENGGARA TIMUR",2,168,19,187
https://kawalpemilu.org#58213,"RANA MBELING, KOTA KOMBA, MANGGARAI TIMUR, NUSA TENGGARA TIMUR",3,119,24,143
https://kawalpemilu.org#58213,"RANA MBELING, KOTA KOMBA, MANGGARAI TIMUR, NUSA TENGGARA TIMUR",4,175,3,178
https://kawalpemilu.org#58213,"RANA MBELING, KOTA KOMBA, MANGGARAI TIMUR, NUSA TENGGARA TIMUR",5,106,13,119
https://kawalpemilu.org#58213,"RANA MBELING, KOTA KOMBA, MANGGARAI TIMUR, NUSA TENGGARA TIMUR",6,97,9,106
https://kawalpemilu.org#58214,"GOLO NDERU, KOTA KOMBA, MANGGARAI TIMUR, NUSA TENGGARA TIMUR",1,158,14,172
https://kawalpemilu.org#58214,"GOLO NDERU, KOTA KOMBA, MANGGARAI TIMUR, NUSA TENGGARA TIMUR",2,180,4,184
https://kawalpemilu.org#58214,"GOLO NDERU, KOTA KOMBA, MANGGARAI TIMUR, NUSA TENGGARA TIMUR",3,188,14,202
https://kawalpemilu.org#58214,"GOLO NDERU, KOTA KOMBA, MANGGARAI TIMUR, NUSA TENGGARA TIMUR",4,173,2,175
https://kawalpemilu.org#58214,"GOLO NDERU, KOTA KOMBA, MANGGARAI TIMUR, NUSA TENGGARA TIMUR",5,103,7,110
https://kawalpemilu.org#58215,"KOMBA, KOTA KOMBA, MANGGARAI TIMUR, NUSA TENGGARA TIMUR",1,142,5,147
https://kawalpemilu.org#58215,"KOMBA, KOTA KOMBA, MANGGARAI TIMUR, NUSA TENGGARA TIMUR",2,184,9,193
https://kawalpemilu.org#58215,"KOMBA, KOTA KOMBA, MANGGARAI TIMUR, NUSA TENGGARA TIMUR",3,136,4,140
https://kawalpemilu.org#58215,"KOMBA, KOTA KOMBA, MANGGARAI TIMUR, NUSA TENGGARA TIMUR",4,161,9,170
https://kawalpemilu.org#58215,"KOMBA, KOTA KOMBA, MANGGARAI TIMUR, NUSA TENGGARA TIMUR",5,127,9,136
https://kawalpemilu.org#58215,"KOMBA, KOTA KOMBA, MANGGARAI TIMUR, NUSA TENGGARA TIMUR",6,181,9,190
https://kawalpemilu.org#58215,"KOMBA, KOTA KOMBA, MANGGARAI TIMUR, NUSA TENGGARA TIMUR",7,115,8,123
https://kawalpemilu.org#58216,"BAMO, KOTA KOMBA, MANGGARAI TIMUR, NUSA TENGGARA TIMUR",1,146,4,150
https://kawalpemilu.org#58216,"BAMO, KOTA KOMBA, MANGGARAI TIMUR, NUSA TENGGARA TIMUR",2,105,4,109
https://kawalpemilu.org#58216,"BAMO, KOTA KOMBA, MANGGARAI TIMUR, NUSA TENGGARA TIMUR",3,176,9,185
https://kawalpemilu.org#58216,"BAMO, KOTA KOMBA, MANGGARAI TIMUR, NUSA TENGGARA TIMUR",4,176,28,204
https://kawalpemilu.org#58216,"BAMO, KOTA KOMBA, MANGGARAI TIMUR, NUSA TENGGARA TIMUR",5,170,20,190
https://kawalpemilu.org#58216,"BAMO, KOTA KOMBA, MANGGARAI TIMUR, NUSA TENGGARA TIMUR",6,207,9,216
https://kawalpemilu.org#58216,"BAMO, KOTA KOMBA, MANGGARAI TIMUR, NUSA TENGGARA TIMUR",7,160,7,167
https://kawalpemilu.org#58217,"PONG RUAN, KOTA KOMBA, MANGGARAI TIMUR, NUSA TENGGARA TIMUR",1,183,9,192
https://kawalpemilu.org#58217,"PONG RUAN, KOTA KOMBA, MANGGARAI TIMUR, NUSA TENGGARA TIMUR",2,185,14,199
https://kawalpemilu.org#58217,"PONG RUAN, KOTA KOMBA, MANGGARAI TIMUR, NUSA TENGGARA TIMUR",3,180,20,200
https://kawalpemilu.org#58217,"PONG RUAN, KOTA KOMBA, MANGGARAI TIMUR, NUSA TENGGARA TIMUR",4,198,19,217
https://kawalpemilu.org#58217,"PONG RUAN, KOTA KOMBA, MANGGARAI TIMUR, NUSA TENGGARA TIMUR",5,187,16,203
https://kawalpemilu.org#58217,"PONG RUAN, KOTA KOMBA, MANGGARAI TIMUR, NUSA TENGGARA TIMUR",6,155,8,163
https://kawalpemilu.org#58217,"PONG RUAN, KOTA KOMBA, MANGGARAI TIMUR, NUSA TENGGARA TIMUR",7,185,15,200
https://kawalpemilu.org#58218,"PAAN LELENG, KOTA KOMBA, MANGGARAI TIMUR, NUSA TENGGARA TIMUR",1,210,14,224
https://kawalpemilu.org#58218,"PAAN LELENG, KOTA KOMBA, MANGGARAI TIMUR, NUSA TENGGARA TIMUR",2,183,17,200
https://kawalpemilu.org#58218,"PAAN LELENG, KOTA KOMBA, MANGGARAI TIMUR, NUSA TENGGARA TIMUR",3,165,14,179
https://kawalpemilu.org#58218,"PAAN LELENG, KOTA KOMBA, MANGGARAI TIMUR, NUSA TENGGARA TIMUR",4,117,15,132
https://kawalpemilu.org#58218,"PAAN LELENG, KOTA KOMBA, MANGGARAI TIMUR, NUSA TENGGARA TIMUR",5,180,26,206
https://kawalpemilu.org#85265,"RANA MBATA, KOTA KOMBA, MANGGARAI TIMUR, NUSA TENGGARA TIMUR",1,197,9,206
https://kawalpemilu.org#85265,"RANA MBATA, KOTA KOMBA, MANGGARAI TIMUR, NUSA TENGGARA TIMUR",2,191,6,197
https://kawalpemilu.org#85265,"RANA MBATA, KOTA KOMBA, MANGGARAI TIMUR, NUSA TENGGARA TIMUR",3,199,5,204
https://kawalpemilu.org#85265,"RANA MBATA, KOTA KOMBA, MANGGARAI TIMUR, NUSA TENGGARA TIMUR",4,150,21,171
https://kawalpemilu.org#85265,"RANA MBATA, KOTA KOMBA, MANGGARAI TIMUR, NUSA TENGGARA TIMUR",5,141,5,146
https://kawalpemilu.org#85265,"RANA MBATA, KOTA KOMBA, MANGGARAI TIMUR, NUSA TENGGARA TIMUR",6,139,4,143
https://kawalpemilu.org#85265,"RANA MBATA, KOTA KOMBA, MANGGARAI TIMUR, NUSA TENGGARA TIMUR",7,51,3,54
https://kawalpemilu.org#85266,"MOKEL MORID, KOTA KOMBA, MANGGARAI TIMUR, NUSA TENGGARA TIMUR",1,208,18,226
https://kawalpemilu.org#85266,"MOKEL MORID, KOTA KOMBA, MANGGARAI TIMUR, NUSA TENGGARA TIMUR",2,168,26,194
https://kawalpemilu.org#85266,"MOKEL MORID, KOTA KOMBA, MANGGARAI TIMUR, NUSA TENGGARA TIMUR",3,166,6,172
https://kawalpemilu.org#85266,"MOKEL MORID, KOTA KOMBA, MANGGARAI TIMUR, NUSA TENGGARA TIMUR",4,57,1,58
https://kawalpemilu.org#85267,"GOLO NDELE, KOTA KOMBA, MANGGARAI TIMUR, NUSA TENGGARA TIMUR",1,195,20,215
https://kawalpemilu.org#85267,"GOLO NDELE, KOTA KOMBA, MANGGARAI TIMUR, NUSA TENGGARA TIMUR",2,194,15,209
https://kawalpemilu.org#85267,"GOLO NDELE, KOTA KOMBA, MANGGARAI TIMUR, NUSA TENGGARA TIMUR",3,135,15,150
https://kawalpemilu.org#85267,"GOLO NDELE, KOTA KOMBA, MANGGARAI TIMUR, NUSA TENGGARA TIMUR",4,119,7,126
https://kawalpemilu.org#91315,"WATU PARI, KOTA KOMBA, MANGGARAI TIMUR, NUSA TENGGARA TIMUR",1,205,17,222
https://kawalpemilu.org#91315,"WATU PARI, KOTA KOMBA, MANGGARAI TIMUR, NUSA TENGGARA TIMUR",2,177,22,199
https://kawalpemilu.org#91315,"WATU PARI, KOTA KOMBA, MANGGARAI TIMUR, NUSA TENGGARA TIMUR",3,196,18,214
https://kawalpemilu.org#91316,"GUNUNG BARU, KOTA KOMBA, MANGGARAI TIMUR, NUSA TENGGARA TIMUR",1,178,23,201
https://kawalpemilu.org#91316,"GUNUNG BARU, KOTA KOMBA, MANGGARAI TIMUR, NUSA TENGGARA TIMUR",2,198,22,220
https://kawalpemilu.org#91316,"GUNUNG BARU, KOTA KOMBA, MANGGARAI TIMUR, NUSA TENGGARA TIMUR",3,211,34,245
https://kawalpemilu.org#91316,"GUNUNG BARU, KOTA KOMBA, MANGGARAI TIMUR, NUSA TENGGARA TIMUR",4,163,10,173
https://kawalpemilu.org#58103,"RONDO WOING, RANA MESE, MANGGARAI TIMUR, NUSA TENGGARA TIMUR",1,181,9,190
https://kawalpemilu.org#58103,"RONDO WOING, RANA MESE, MANGGARAI TIMUR, NUSA TENGGARA TIMUR",2,183,10,193
https://kawalpemilu.org#58103,"RONDO WOING, RANA MESE, MANGGARAI TIMUR, NUSA TENGGARA TIMUR",3,154,4,158
https://kawalpemilu.org#58104,"SANO LOKOM, RANA MESE, MANGGARAI TIMUR, NUSA TENGGARA TIMUR",1,123,2,125
https://kawalpemilu.org#58104,"SANO LOKOM, RANA MESE, MANGGARAI TIMUR, NUSA TENGGARA TIMUR",2,163,7,170
https://kawalpemilu.org#58104,"SANO LOKOM, RANA MESE, MANGGARAI TIMUR, NUSA TENGGARA TIMUR",3,129,6,135
https://kawalpemilu.org#58104,"SANO LOKOM, RANA MESE, MANGGARAI TIMUR, NUSA TENGGARA TIMUR",4,126,2,128
https://kawalpemilu.org#58108,"GOLO MELENG, RANA MESE, MANGGARAI TIMUR, NUSA TENGGARA TIMUR",1,173,7,180
https://kawalpemilu.org#58108,"GOLO MELENG, RANA MESE, MANGGARAI TIMUR, NUSA TENGGARA TIMUR",2,113,15,128
https://kawalpemilu.org#58108,"GOLO MELENG, RANA MESE, MANGGARAI TIMUR, NUSA TENGGARA TIMUR",3,136,7,143
https://kawalpemilu.org#58108,"GOLO MELENG, RANA MESE, MANGGARAI TIMUR, NUSA TENGGARA TIMUR",4,180,16,196
https://kawalpemilu.org#58108,"GOLO MELENG, RANA MESE, MANGGARAI TIMUR, NUSA TENGGARA TIMUR",5,131,17,148
https://kawalpemilu.org#58109,"BEA NGENCUNG, RANA MESE, MANGGARAI TIMUR, NUSA TENGGARA TIMUR",1,169,10,179
https://kawalpemilu.org#58109,"BEA NGENCUNG, RANA MESE, MANGGARAI TIMUR, NUSA TENGGARA TIMUR",2,109,14,123
https://kawalpemilu.org#58109,"BEA NGENCUNG, RANA MESE, MANGGARAI TIMUR, NUSA TENGGARA TIMUR",3,121,6,127
https://kawalpemilu.org#58109,"BEA NGENCUNG, RANA MESE, MANGGARAI TIMUR, NUSA TENGGARA TIMUR",4,128,37,165
https://kawalpemilu.org#58109,"BEA NGENCUNG, RANA MESE, MANGGARAI TIMUR, NUSA TENGGARA TIMUR",5,102,0,102
https://kawalpemilu.org#58112,"SITA, RANA MESE, MANGGARAI TIMUR, NUSA TENGGARA TIMUR",1,168,10,178
https://kawalpemilu.org#58112,"SITA, RANA MESE, MANGGARAI TIMUR, NUSA TENGGARA TIMUR",2,187,10,197
https://kawalpemilu.org#58112,"SITA, RANA MESE, MANGGARAI TIMUR, NUSA TENGGARA TIMUR",3,211,10,221
https://kawalpemilu.org#58112,"SITA, RANA MESE, MANGGARAI TIMUR, NUSA TENGGARA TIMUR",4,172,8,180
https://kawalpemilu.org#58112,"SITA, RANA MESE, MANGGARAI TIMUR, NUSA TENGGARA TIMUR",5,182,14,196
https://kawalpemilu.org#58112,"SITA, RANA MESE, MANGGARAI TIMUR, NUSA TENGGARA TIMUR",6,218,9,227
https://kawalpemilu.org#58112,"SITA, RANA MESE, MANGGARAI TIMUR, NUSA TENGGARA TIMUR",7,142,7,149
https://kawalpemilu.org#58112,"SITA, RANA MESE, MANGGARAI TIMUR, NUSA TENGGARA TIMUR",8,177,22,199
https://kawalpemilu.org#58113,"GOLO RUTUK, RANA MESE, MANGGARAI TIMUR, NUSA TENGGARA TIMUR",1,185,11,196
https://kawalpemilu.org#58113,"GOLO RUTUK, RANA MESE, MANGGARAI TIMUR, NUSA TENGGARA TIMUR",2,197,25,222
https://kawalpemilu.org#58113,"GOLO RUTUK, RANA MESE, MANGGARAI TIMUR, NUSA TENGGARA TIMUR",3,136,14,150
https://kawalpemilu.org#58114,"GOLO LONI, RANA MESE, MANGGARAI TIMUR, NUSA TENGGARA TIMUR",1,172,3,175
https://kawalpemilu.org#58114,"GOLO LONI, RANA MESE, MANGGARAI TIMUR, NUSA TENGGARA TIMUR",2,193,7,200
https://kawalpemilu.org#58114,"GOLO LONI, RANA MESE, MANGGARAI TIMUR, NUSA TENGGARA TIMUR",3,213,6,219
https://kawalpemilu.org#58116,"GOLO ROS, RANA MESE, MANGGARAI TIMUR, NUSA TENGGARA TIMUR",1,180,22,202
https://kawalpemilu.org#58116,"GOLO ROS, RANA MESE, MANGGARAI TIMUR, NUSA TENGGARA TIMUR",2,172,3,175
https://kawalpemilu.org#58116,"GOLO ROS, RANA MESE, MANGGARAI TIMUR, NUSA TENGGARA TIMUR",3,169,10,179
https://kawalpemilu.org#58116,"GOLO ROS, RANA MESE, MANGGARAI TIMUR, NUSA TENGGARA TIMUR",4,167,4,171
https://kawalpemilu.org#58116,"GOLO ROS, RANA MESE, MANGGARAI TIMUR, NUSA TENGGARA TIMUR",5,147,11,158
https://kawalpemilu.org#58117,"SATAR LAHING, RANA MESE, MANGGARAI TIMUR, NUSA TENGGARA TIMUR",1,238,8,246
https://kawalpemilu.org#58117,"SATAR LAHING, RANA MESE, MANGGARAI TIMUR, NUSA TENGGARA TIMUR",2,156,9,165
https://kawalpemilu.org#58117,"SATAR LAHING, RANA MESE, MANGGARAI TIMUR, NUSA TENGGARA TIMUR",3,232,13,245
https://kawalpemilu.org#58117,"SATAR LAHING, RANA MESE, MANGGARAI TIMUR, NUSA TENGGARA TIMUR",4,226,9,235
https://kawalpemilu.org#58120,"TOROK GOLO, RANA MESE, MANGGARAI TIMUR, NUSA TENGGARA TIMUR",1,200,2,202
https://kawalpemilu.org#58120,"TOROK GOLO, RANA MESE, MANGGARAI TIMUR, NUSA TENGGARA TIMUR",2,186,11,197
https://kawalpemilu.org#58120,"TOROK GOLO, RANA MESE, MANGGARAI TIMUR, NUSA TENGGARA TIMUR",3,184,1,185
https://kawalpemilu.org#85268,"WAE NGGORI, RANA MESE, MANGGARAI TIMUR, NUSA TENGGARA TIMUR",1,263,11,274
https://kawalpemilu.org#85268,"WAE NGGORI, RANA MESE, MANGGARAI TIMUR, NUSA TENGGARA TIMUR",2,168,8,176
https://kawalpemilu.org#85268,"WAE NGGORI, RANA MESE, MANGGARAI TIMUR, NUSA TENGGARA TIMUR",3,111,6,117
https://kawalpemilu.org#85269,"COMPANG KANTAR, RANA MESE, MANGGARAI TIMUR, NUSA TENGGARA TIMUR",1,134,14,148
https://kawalpemilu.org#85269,"COMPANG KANTAR, RANA MESE, MANGGARAI TIMUR, NUSA TENGGARA TIMUR",2,193,14,207
https://kawalpemilu.org#85269,"COMPANG KANTAR, RANA MESE, MANGGARAI TIMUR, NUSA TENGGARA TIMUR",3,106,7,113
https://kawalpemilu.org#85270,"WATU MORI, RANA MESE, MANGGARAI TIMUR, NUSA TENGGARA TIMUR",1,180,33,213
https://kawalpemilu.org#85270,"WATU MORI, RANA MESE, MANGGARAI TIMUR, NUSA TENGGARA TIMUR",2,208,14,222
https://kawalpemilu.org#85270,"WATU MORI, RANA MESE, MANGGARAI TIMUR, NUSA TENGGARA TIMUR",3,194,15,209
https://kawalpemilu.org#85270,"WATU MORI, RANA MESE, MANGGARAI TIMUR, NUSA TENGGARA TIMUR",4,165,4,169
https://kawalpemilu.org#85270,"WATU MORI, RANA MESE, MANGGARAI TIMUR, NUSA TENGGARA TIMUR",5,207,6,213
https://kawalpemilu.org#85270,"WATU MORI, RANA MESE, MANGGARAI TIMUR, NUSA TENGGARA TIMUR",6,147,6,153
https://kawalpemilu.org#85271,"BANGKA  KEMPO, RANA MESE, MANGGARAI TIMUR, NUSA TENGGARA TIMUR",1,123,14,137
https://kawalpemilu.org#85271,"BANGKA  KEMPO, RANA MESE, MANGGARAI TIMUR, NUSA TENGGARA TIMUR",2,204,10,214
https://kawalpemilu.org#85271,"BANGKA  KEMPO, RANA MESE, MANGGARAI TIMUR, NUSA TENGGARA TIMUR",3,154,6,160
https://kawalpemilu.org#85271,"BANGKA  KEMPO, RANA MESE, MANGGARAI TIMUR, NUSA TENGGARA TIMUR",4,127,9,136
https://kawalpemilu.org#85271,"BANGKA  KEMPO, RANA MESE, MANGGARAI TIMUR, NUSA TENGGARA TIMUR",5,101,0,101
https://kawalpemilu.org#85272,"COMPANG TEBER, RANA MESE, MANGGARAI TIMUR, NUSA TENGGARA TIMUR",1,208,12,220
https://kawalpemilu.org#85272,"COMPANG TEBER, RANA MESE, MANGGARAI TIMUR, NUSA TENGGARA TIMUR",2,220,6,226
https://kawalpemilu.org#85272,"COMPANG TEBER, RANA MESE, MANGGARAI TIMUR, NUSA TENGGARA TIMUR",3,130,8,138
https://kawalpemilu.org#85272,"COMPANG TEBER, RANA MESE, MANGGARAI TIMUR, NUSA TENGGARA TIMUR",4,110,3,113
https://kawalpemilu.org#85273,"BANGKA MASA, RANA MESE, MANGGARAI TIMUR, NUSA TENGGARA TIMUR",1,105,6,111
https://kawalpemilu.org#85273,"BANGKA MASA, RANA MESE, MANGGARAI TIMUR, NUSA TENGGARA TIMUR",2,168,21,189
https://kawalpemilu.org#85273,"BANGKA MASA, RANA MESE, MANGGARAI TIMUR, NUSA TENGGARA TIMUR",3,199,13,212
https://kawalpemilu.org#85273,"BANGKA MASA, RANA MESE, MANGGARAI TIMUR, NUSA TENGGARA TIMUR",4,190,10,200
https://kawalpemilu.org#85274,"COMPANG LONI, RANA MESE, MANGGARAI TIMUR, NUSA TENGGARA TIMUR",1,118,2,120
https://kawalpemilu.org#85274,"COMPANG LONI, RANA MESE, MANGGARAI TIMUR, NUSA TENGGARA TIMUR",2,196,18,214
https://kawalpemilu.org#85275,"COMPANG KEMPO, RANA MESE, MANGGARAI TIMUR, NUSA TENGGARA TIMUR",1,192,15,207
https://kawalpemilu.org#85275,"COMPANG KEMPO, RANA MESE, MANGGARAI TIMUR, NUSA TENGGARA TIMUR",2,168,11,179
https://kawalpemilu.org#85275,"COMPANG KEMPO, RANA MESE, MANGGARAI TIMUR, NUSA TENGGARA TIMUR",3,156,17,173
https://kawalpemilu.org#85275,"COMPANG KEMPO, RANA MESE, MANGGARAI TIMUR, NUSA TENGGARA TIMUR",4,88,2,90
https://kawalpemilu.org#91327,"SATAR LENDA, RANA MESE, MANGGARAI TIMUR, NUSA TENGGARA TIMUR",1,261,13,274
https://kawalpemilu.org#91327,"SATAR LENDA, RANA MESE, MANGGARAI TIMUR, NUSA TENGGARA TIMUR",2,104,6,110
https://kawalpemilu.org#91327,"SATAR LENDA, RANA MESE, MANGGARAI TIMUR, NUSA TENGGARA TIMUR",3,269,9,278
https://kawalpemilu.org#91328,"LIDI, RANA MESE, MANGGARAI TIMUR, NUSA TENGGARA TIMUR",1,152,10,162
https://kawalpemilu.org#91328,"LIDI, RANA MESE, MANGGARAI TIMUR, NUSA TENGGARA TIMUR",2,211,9,220
https://kawalpemilu.org#91328,"LIDI, RANA MESE, MANGGARAI TIMUR, NUSA TENGGARA TIMUR",3,204,8,212
https://kawalpemilu.org#91328,"LIDI, RANA MESE, MANGGARAI TIMUR, NUSA TENGGARA TIMUR",4,156,11,167
https://kawalpemilu.org#91329,"LALANG, RANA MESE, MANGGARAI TIMUR, NUSA TENGGARA TIMUR",1,178,9,187
https://kawalpemilu.org#91329,"LALANG, RANA MESE, MANGGARAI TIMUR, NUSA TENGGARA TIMUR",2,184,18,202
https://kawalpemilu.org#91329,"LALANG, RANA MESE, MANGGARAI TIMUR, NUSA TENGGARA TIMUR",3,171,9,180
https://kawalpemilu.org#58129,"ARUS, POCO RANAKA TIMUR, MANGGARAI TIMUR, NUSA TENGGARA TIMUR",1,176,16,192
https://kawalpemilu.org#58129,"ARUS, POCO RANAKA TIMUR, MANGGARAI TIMUR, NUSA TENGGARA TIMUR",2,187,10,197
https://kawalpemilu.org#58129,"ARUS, POCO RANAKA TIMUR, MANGGARAI TIMUR, NUSA TENGGARA TIMUR",3,185,8,193
https://kawalpemilu.org#58129,"ARUS, POCO RANAKA TIMUR, MANGGARAI TIMUR, NUSA TENGGARA TIMUR",4,209,6,215
https://kawalpemilu.org#58129,"ARUS, POCO RANAKA TIMUR, MANGGARAI TIMUR, NUSA TENGGARA TIMUR",5,174,7,181
https://kawalpemilu.org#58129,"ARUS, POCO RANAKA TIMUR, MANGGARAI TIMUR, NUSA TENGGARA TIMUR",6,136,6,142
https://kawalpemilu.org#58130,"RENGKAM, POCO RANAKA TIMUR, MANGGARAI TIMUR, NUSA TENGGARA TIMUR",1,181,9,190
https://kawalpemilu.org#58130,"RENGKAM, POCO RANAKA TIMUR, MANGGARAI TIMUR, NUSA TENGGARA TIMUR",2,181,13,194
https://kawalpemilu.org#58130,"RENGKAM, POCO RANAKA TIMUR, MANGGARAI TIMUR, NUSA TENGGARA TIMUR",3,197,18,215
https://kawalpemilu.org#58130,"RENGKAM, POCO RANAKA TIMUR, MANGGARAI TIMUR, NUSA TENGGARA TIMUR",4,209,8,217
https://kawalpemilu.org#58130,"RENGKAM, POCO RANAKA TIMUR, MANGGARAI TIMUR, NUSA TENGGARA TIMUR",5,101,9,110
https://kawalpemilu.org#58130,"RENGKAM, POCO RANAKA TIMUR, MANGGARAI TIMUR, NUSA TENGGARA TIMUR",6,167,5,172
https://kawalpemilu.org#58131,"BENTENG RAMPAS, POCO RANAKA TIMUR, MANGGARAI TIMUR, NUSA TENGGARA TIMUR",1,208,34,242
https://kawalpemilu.org#58131,"BENTENG RAMPAS, POCO RANAKA TIMUR, MANGGARAI TIMUR, NUSA TENGGARA TIMUR",2,208,5,213
https://kawalpemilu.org#58131,"BENTENG RAMPAS, POCO RANAKA TIMUR, MANGGARAI TIMUR, NUSA TENGGARA TIMUR",3,201,11,212
https://kawalpemilu.org#58131,"BENTENG RAMPAS, POCO RANAKA TIMUR, MANGGARAI TIMUR, NUSA TENGGARA TIMUR",4,172,14,186
https://kawalpemilu.org#58132,"NGKIONG DORA, POCO RANAKA TIMUR, MANGGARAI TIMUR, NUSA TENGGARA TIMUR",1,145,8,153
https://kawalpemilu.org#58132,"NGKIONG DORA, POCO RANAKA TIMUR, MANGGARAI TIMUR, NUSA TENGGARA TIMUR",2,172,10,182
https://kawalpemilu.org#58132,"NGKIONG DORA, POCO RANAKA TIMUR, MANGGARAI TIMUR, NUSA TENGGARA TIMUR",3,158,10,168
https://kawalpemilu.org#58132,"NGKIONG DORA, POCO RANAKA TIMUR, MANGGARAI TIMUR, NUSA TENGGARA TIMUR",4,203,10,213
https://kawalpemilu.org#58133,"ULU WAE, POCO RANAKA TIMUR, MANGGARAI TIMUR, NUSA TENGGARA TIMUR",1,173,1,174
https://kawalpemilu.org#58133,"ULU WAE, POCO RANAKA TIMUR, MANGGARAI TIMUR, NUSA TENGGARA TIMUR",2,170,5,175
https://kawalpemilu.org#58133,"ULU WAE, POCO RANAKA TIMUR, MANGGARAI TIMUR, NUSA TENGGARA TIMUR",3,185,12,197
https://kawalpemilu.org#58133,"ULU WAE, POCO RANAKA TIMUR, MANGGARAI TIMUR, NUSA TENGGARA TIMUR",4,246,14,260
https://kawalpemilu.org#58144,"WATU ARUS, POCO RANAKA TIMUR, MANGGARAI TIMUR, NUSA TENGGARA TIMUR",1,210,6,216
https://kawalpemilu.org#58144,"WATU ARUS, POCO RANAKA TIMUR, MANGGARAI TIMUR, NUSA TENGGARA TIMUR",2,125,12,137
https://kawalpemilu.org#58144,"WATU ARUS, POCO RANAKA TIMUR, MANGGARAI TIMUR, NUSA TENGGARA TIMUR",3,165,32,197
https://kawalpemilu.org#58145,"TANGO MOLAS, POCO RANAKA TIMUR, MANGGARAI TIMUR, NUSA TENGGARA TIMUR",1,193,22,215
https://kawalpemilu.org#58145,"TANGO MOLAS, POCO RANAKA TIMUR, MANGGARAI TIMUR, NUSA TENGGARA TIMUR",2,191,24,215
https://kawalpemilu.org#58145,"TANGO MOLAS, POCO RANAKA TIMUR, MANGGARAI TIMUR, NUSA TENGGARA TIMUR",3,200,12,212
https://kawalpemilu.org#58145,"TANGO MOLAS, POCO RANAKA TIMUR, MANGGARAI TIMUR, NUSA TENGGARA TIMUR",4,149,35,184
https://kawalpemilu.org#58145,"TANGO MOLAS, POCO RANAKA TIMUR, MANGGARAI TIMUR, NUSA TENGGARA TIMUR",5,173,15,188
https://kawalpemilu.org#58145,"TANGO MOLAS, POCO RANAKA TIMUR, MANGGARAI TIMUR, NUSA TENGGARA TIMUR",6,82,28,110
https://kawalpemilu.org#58146,"GOLO LERO, POCO RANAKA TIMUR, MANGGARAI TIMUR, NUSA TENGGARA TIMUR",1,124,16,140
https://kawalpemilu.org#58146,"GOLO LERO, POCO RANAKA TIMUR, MANGGARAI TIMUR, NUSA TENGGARA TIMUR",2,136,19,155
https://kawalpemilu.org#58146,"GOLO LERO, POCO RANAKA TIMUR, MANGGARAI TIMUR, NUSA TENGGARA TIMUR",3,173,14,187
https://kawalpemilu.org#58146,"GOLO LERO, POCO RANAKA TIMUR, MANGGARAI TIMUR, NUSA TENGGARA TIMUR",4,151,7,158
https://kawalpemilu.org#58146,"GOLO LERO, POCO RANAKA TIMUR, MANGGARAI TIMUR, NUSA TENGGARA TIMUR",5,181,7,188
https://kawalpemilu.org#58147,"COMPANG WUNIS, POCO RANAKA TIMUR, MANGGARAI TIMUR, NUSA TENGGARA TIMUR",1,188,20,208
https://kawalpemilu.org#58147,"COMPANG WUNIS, POCO RANAKA TIMUR, MANGGARAI TIMUR, NUSA TENGGARA TIMUR",2,221,10,231
https://kawalpemilu.org#58147,"COMPANG WUNIS, POCO RANAKA TIMUR, MANGGARAI TIMUR, NUSA TENGGARA TIMUR",3,212,14,226
https://kawalpemilu.org#58148,"WANGKAR WELI, POCO RANAKA TIMUR, MANGGARAI TIMUR, NUSA TENGGARA TIMUR",1,177,33,210
https://kawalpemilu.org#58148,"WANGKAR WELI, POCO RANAKA TIMUR, MANGGARAI TIMUR, NUSA TENGGARA TIMUR",2,129,47,176
https://kawalpemilu.org#58148,"WANGKAR WELI, POCO RANAKA TIMUR, MANGGARAI TIMUR, NUSA TENGGARA TIMUR",3,135,4,139
https://kawalpemilu.org#58148,"WANGKAR WELI, POCO RANAKA TIMUR, MANGGARAI TIMUR, NUSA TENGGARA TIMUR",4,178,27,205
https://kawalpemilu.org#85276,"RENDE NAO, POCO RANAKA TIMUR, MANGGARAI TIMUR, NUSA TENGGARA TIMUR",1,214,11,225
https://kawalpemilu.org#85276,"RENDE NAO, POCO RANAKA TIMUR, MANGGARAI TIMUR, NUSA TENGGARA TIMUR",2,193,11,204
https://kawalpemilu.org#85276,"RENDE NAO, POCO RANAKA TIMUR, MANGGARAI TIMUR, NUSA TENGGARA TIMUR",3,213,11,224
https://kawalpemilu.org#85276,"RENDE NAO, POCO RANAKA TIMUR, MANGGARAI TIMUR, NUSA TENGGARA TIMUR",4,109,7,116
https://kawalpemilu.org#85277,"URUNG DORA, POCO RANAKA TIMUR, MANGGARAI TIMUR, NUSA TENGGARA TIMUR",1,178,12,190
https://kawalpemilu.org#85277,"URUNG DORA, POCO RANAKA TIMUR, MANGGARAI TIMUR, NUSA TENGGARA TIMUR",2,135,8,143
https://kawalpemilu.org#85277,"URUNG DORA, POCO RANAKA TIMUR, MANGGARAI TIMUR, NUSA TENGGARA TIMUR",3,174,21,195
https://kawalpemilu.org#85277,"URUNG DORA, POCO RANAKA TIMUR, MANGGARAI TIMUR, NUSA TENGGARA TIMUR",4,73,10,83
https://kawalpemilu.org#85278,"COMPANG RACI, POCO RANAKA TIMUR, MANGGARAI TIMUR, NUSA TENGGARA TIMUR",1,151,12,163
https://kawalpemilu.org#85278,"COMPANG RACI, POCO RANAKA TIMUR, MANGGARAI TIMUR, NUSA TENGGARA TIMUR",2,113,17,130
https://kawalpemilu.org#85278,"COMPANG RACI, POCO RANAKA TIMUR, MANGGARAI TIMUR, NUSA TENGGARA TIMUR",3,204,16,220
https://kawalpemilu.org#85279,"WEJANG MAWE, POCO RANAKA TIMUR, MANGGARAI TIMUR, NUSA TENGGARA TIMUR",1,198,9,207
https://kawalpemilu.org#85279,"WEJANG MAWE, POCO RANAKA TIMUR, MANGGARAI TIMUR, NUSA TENGGARA TIMUR",2,221,5,226
https://kawalpemilu.org#85279,"WEJANG MAWE, POCO RANAKA TIMUR, MANGGARAI TIMUR, NUSA TENGGARA TIMUR",3,229,3,232
https://kawalpemilu.org#85279,"WEJANG MAWE, POCO RANAKA TIMUR, MANGGARAI TIMUR, NUSA TENGGARA TIMUR",4,171,4,175
https://kawalpemilu.org#85280,"BANGKA ARUS, POCO RANAKA TIMUR, MANGGARAI TIMUR, NUSA TENGGARA TIMUR",1,224,12,236
https://kawalpemilu.org#85280,"BANGKA ARUS, POCO RANAKA TIMUR, MANGGARAI TIMUR, NUSA TENGGARA TIMUR",2,170,6,176
https://kawalpemilu.org#85280,"BANGKA ARUS, POCO RANAKA TIMUR, MANGGARAI TIMUR, NUSA TENGGARA TIMUR",3,162,2,164
https://kawalpemilu.org#85280,"BANGKA ARUS, POCO RANAKA TIMUR, MANGGARAI TIMUR, NUSA TENGGARA TIMUR",4,174,2,176
https://kawalpemilu.org#85280,"BANGKA ARUS, POCO RANAKA TIMUR, MANGGARAI TIMUR, NUSA TENGGARA TIMUR",5,178,13,191
https://kawalpemilu.org#85280,"BANGKA ARUS, POCO RANAKA TIMUR, MANGGARAI TIMUR, NUSA TENGGARA TIMUR",6,162,8,170
https://kawalpemilu.org#85281,"COLOL, POCO RANAKA TIMUR, MANGGARAI TIMUR, NUSA TENGGARA TIMUR",1,144,8,152
https://kawalpemilu.org#85281,"COLOL, POCO RANAKA TIMUR, MANGGARAI TIMUR, NUSA TENGGARA TIMUR",2,169,14,183
https://kawalpemilu.org#85281,"COLOL, POCO RANAKA TIMUR, MANGGARAI TIMUR, NUSA TENGGARA TIMUR",3,212,18,230
https://kawalpemilu.org#85281,"COLOL, POCO RANAKA TIMUR, MANGGARAI TIMUR, NUSA TENGGARA TIMUR",4,207,12,219
https://kawalpemilu.org#85281,"COLOL, POCO RANAKA TIMUR, MANGGARAI TIMUR, NUSA TENGGARA TIMUR",5,161,7,168
https://kawalpemilu.org#85281,"COLOL, POCO RANAKA TIMUR, MANGGARAI TIMUR, NUSA TENGGARA TIMUR",6,206,8,214
https://kawalpemilu.org#85282,"BENTENG WUNIS, POCO RANAKA TIMUR, MANGGARAI TIMUR, NUSA TENGGARA TIMUR",1,208,16,224
https://kawalpemilu.org#85282,"BENTENG WUNIS, POCO RANAKA TIMUR, MANGGARAI TIMUR, NUSA TENGGARA TIMUR",2,200,12,212
https://kawalpemilu.org#85282,"BENTENG WUNIS, POCO RANAKA TIMUR, MANGGARAI TIMUR, NUSA TENGGARA TIMUR",3,75,4,79
https://kawalpemilu.org#85283,"WEJANG MALI, POCO RANAKA TIMUR, MANGGARAI TIMUR, NUSA TENGGARA TIMUR",1,181,17,198
https://kawalpemilu.org#85283,"WEJANG MALI, POCO RANAKA TIMUR, MANGGARAI TIMUR, NUSA TENGGARA TIMUR",2,159,13,172
https://kawalpemilu.org#85283,"WEJANG MALI, POCO RANAKA TIMUR, MANGGARAI TIMUR, NUSA TENGGARA TIMUR",3,149,10,159
https://kawalpemilu.org#85283,"WEJANG MALI, POCO RANAKA TIMUR, MANGGARAI TIMUR, NUSA TENGGARA TIMUR",4,113,5,118
https://kawalpemilu.org#58181,"LEMPANG PAJI, ELAR SELATAN, MANGGARAI TIMUR, NUSA TENGGARA TIMUR",1,234,4,238
https://kawalpemilu.org#58181,"LEMPANG PAJI, ELAR SELATAN, MANGGARAI TIMUR, NUSA TENGGARA TIMUR",2,160,16,176
https://kawalpemilu.org#58181,"LEMPANG PAJI, ELAR SELATAN, MANGGARAI TIMUR, NUSA TENGGARA TIMUR",3,155,7,162
https://kawalpemilu.org#58181,"LEMPANG PAJI, ELAR SELATAN, MANGGARAI TIMUR, NUSA TENGGARA TIMUR",4,187,20,207
https://kawalpemilu.org#58181,"LEMPANG PAJI, ELAR SELATAN, MANGGARAI TIMUR, NUSA TENGGARA TIMUR",5,175,6,181
https://kawalpemilu.org#58181,"LEMPANG PAJI, ELAR SELATAN, MANGGARAI TIMUR, NUSA TENGGARA TIMUR",6,156,11,167
https://kawalpemilu.org#58187,"SANGAN KALO, ELAR SELATAN, MANGGARAI TIMUR, NUSA TENGGARA TIMUR",1,235,6,241
https://kawalpemilu.org#58187,"SANGAN KALO, ELAR SELATAN, MANGGARAI TIMUR, NUSA TENGGARA TIMUR",2,205,7,212
https://kawalpemilu.org#58187,"SANGAN KALO, ELAR SELATAN, MANGGARAI TIMUR, NUSA TENGGARA TIMUR",3,242,13,255
https://kawalpemilu.org#58187,"SANGAN KALO, ELAR SELATAN, MANGGARAI TIMUR, NUSA TENGGARA TIMUR",4,81,5,86
https://kawalpemilu.org#58187,"SANGAN KALO, ELAR SELATAN, MANGGARAI TIMUR, NUSA TENGGARA TIMUR",5,150,8,158
https://kawalpemilu.org#58187,"SANGAN KALO, ELAR SELATAN, MANGGARAI TIMUR, NUSA TENGGARA TIMUR",6,132,6,138
https://kawalpemilu.org#58188,"NANGA MEJE, ELAR SELATAN, MANGGARAI TIMUR, NUSA TENGGARA TIMUR",1,211,5,216
https://kawalpemilu.org#58188,"NANGA MEJE, ELAR SELATAN, MANGGARAI TIMUR, NUSA TENGGARA TIMUR",2,217,9,226
https://kawalpemilu.org#58188,"NANGA MEJE, ELAR SELATAN, MANGGARAI TIMUR, NUSA TENGGARA TIMUR",3,153,4,157
https://kawalpemilu.org#58188,"NANGA MEJE, ELAR SELATAN, MANGGARAI TIMUR, NUSA TENGGARA TIMUR",4,159,12,171
https://kawalpemilu.org#58189,"LANGGA SAI, ELAR SELATAN, MANGGARAI TIMUR, NUSA TENGGARA TIMUR",1,186,1,187
https://kawalpemilu.org#58189,"LANGGA SAI, ELAR SELATAN, MANGGARAI TIMUR, NUSA TENGGARA TIMUR",2,213,10,223
https://kawalpemilu.org#58189,"LANGGA SAI, ELAR SELATAN, MANGGARAI TIMUR, NUSA TENGGARA TIMUR",3,96,18,114
https://kawalpemilu.org#58189,"LANGGA SAI, ELAR SELATAN, MANGGARAI TIMUR, NUSA TENGGARA TIMUR",4,145,7,152
https://kawalpemilu.org#58191,"GOLO LINUS, ELAR SELATAN, MANGGARAI TIMUR, NUSA TENGGARA TIMUR",1,171,8,179
https://kawalpemilu.org#58191,"GOLO LINUS, ELAR SELATAN, MANGGARAI TIMUR, NUSA TENGGARA TIMUR",2,198,2,200
https://kawalpemilu.org#58191,"GOLO LINUS, ELAR SELATAN, MANGGARAI TIMUR, NUSA TENGGARA TIMUR",3,77,6,83
https://kawalpemilu.org#58192,"GISING, ELAR SELATAN, MANGGARAI TIMUR, NUSA TENGGARA TIMUR",1,192,14,206
https://kawalpemilu.org#58192,"GISING, ELAR SELATAN, MANGGARAI TIMUR, NUSA TENGGARA TIMUR",2,195,21,216
https://kawalpemilu.org#58192,"GISING, ELAR SELATAN, MANGGARAI TIMUR, NUSA TENGGARA TIMUR",3,167,22,189
https://kawalpemilu.org#58192,"GISING, ELAR SELATAN, MANGGARAI TIMUR, NUSA TENGGARA TIMUR",4,112,10,122
https://kawalpemilu.org#58192,"GISING, ELAR SELATAN, MANGGARAI TIMUR, NUSA TENGGARA TIMUR",5,136,13,149
https://kawalpemilu.org#58193,"TENO MESE, ELAR SELATAN, MANGGARAI TIMUR, NUSA TENGGARA TIMUR",1,141,10,151
https://kawalpemilu.org#58193,"TENO MESE, ELAR SELATAN, MANGGARAI TIMUR, NUSA TENGGARA TIMUR",2,157,17,174
https://kawalpemilu.org#58193,"TENO MESE, ELAR SELATAN, MANGGARAI TIMUR, NUSA TENGGARA TIMUR",3,177,18,195
https://kawalpemilu.org#58193,"TENO MESE, ELAR SELATAN, MANGGARAI TIMUR, NUSA TENGGARA TIMUR",4,154,10,164
https://kawalpemilu.org#58194,"PAAN WARU, ELAR SELATAN, MANGGARAI TIMUR, NUSA TENGGARA TIMUR",1,206,11,217
https://kawalpemilu.org#58194,"PAAN WARU, ELAR SELATAN, MANGGARAI TIMUR, NUSA TENGGARA TIMUR",2,224,9,233
https://kawalpemilu.org#58194,"PAAN WARU, ELAR SELATAN, MANGGARAI TIMUR, NUSA TENGGARA TIMUR",3,225,14,239
https://kawalpemilu.org#58194,"PAAN WARU, ELAR SELATAN, MANGGARAI TIMUR, NUSA TENGGARA TIMUR",4,149,4,153
https://kawalpemilu.org#58195,"SIPI, ELAR SELATAN, MANGGARAI TIMUR, NUSA TENGGARA TIMUR",1,227,15,242
https://kawalpemilu.org#58195,"SIPI, ELAR SELATAN, MANGGARAI TIMUR, NUSA TENGGARA TIMUR",2,207,17,224
https://kawalpemilu.org#58195,"SIPI, ELAR SELATAN, MANGGARAI TIMUR, NUSA TENGGARA TIMUR",3,116,8,124
https://kawalpemilu.org#58200,"GOLO WUAS, ELAR SELATAN, MANGGARAI TIMUR, NUSA TENGGARA TIMUR",1,189,16,205
https://kawalpemilu.org#58200,"GOLO WUAS, ELAR SELATAN, MANGGARAI TIMUR, NUSA TENGGARA TIMUR",2,229,8,237
https://kawalpemilu.org#58200,"GOLO WUAS, ELAR SELATAN, MANGGARAI TIMUR, NUSA TENGGARA TIMUR",3,300,5,305
https://kawalpemilu.org#58200,"GOLO WUAS, ELAR SELATAN, MANGGARAI TIMUR, NUSA TENGGARA TIMUR",4,284,9,293
https://kawalpemilu.org#85284,"WAE RASAN, ELAR SELATAN, MANGGARAI TIMUR, NUSA TENGGARA TIMUR",1,153,4,157
https://kawalpemilu.org#85284,"WAE RASAN, ELAR SELATAN, MANGGARAI TIMUR, NUSA TENGGARA TIMUR",2,73,4,77
https://kawalpemilu.org#85285,"NANGA PUUN, ELAR SELATAN, MANGGARAI TIMUR, NUSA TENGGARA TIMUR",1,135,12,147
https://kawalpemilu.org#85285,"NANGA PUUN, ELAR SELATAN, MANGGARAI TIMUR, NUSA TENGGARA TIMUR",2,142,5,147
https://kawalpemilu.org#85285,"NANGA PUUN, ELAR SELATAN, MANGGARAI TIMUR, NUSA TENGGARA TIMUR",3,171,6,177
https://kawalpemilu.org#91330,"BENTENG PAU, ELAR SELATAN, MANGGARAI TIMUR, NUSA TENGGARA TIMUR",1,97,9,106
https://kawalpemilu.org#91330,"BENTENG PAU, ELAR SELATAN, MANGGARAI TIMUR, NUSA TENGGARA TIMUR",2,135,12,147
https://kawalpemilu.org#91330,"BENTENG PAU, ELAR SELATAN, MANGGARAI TIMUR, NUSA TENGGARA TIMUR",3,170,10,180
https://kawalpemilu.org#91330,"BENTENG PAU, ELAR SELATAN, MANGGARAI TIMUR, NUSA TENGGARA TIMUR",4,145,30,175
https://kawalpemilu.org#91330,"BENTENG PAU, ELAR SELATAN, MANGGARAI TIMUR, NUSA TENGGARA TIMUR",5,123,3,126
https://kawalpemilu.org#91331,"MOSI NGARAN, ELAR SELATAN, MANGGARAI TIMUR, NUSA TENGGARA TIMUR",1,177,4,181
https://kawalpemilu.org#91331,"MOSI NGARAN, ELAR SELATAN, MANGGARAI TIMUR, NUSA TENGGARA TIMUR",2,190,43,233
https://kawalpemilu.org#91331,"MOSI NGARAN, ELAR SELATAN, MANGGARAI TIMUR, NUSA TENGGARA TIMUR",3,82,0,82
https://kawalpemilu.org#91331,"MOSI NGARAN, ELAR SELATAN, MANGGARAI TIMUR, NUSA TENGGARA TIMUR",4,199,28,227
https://kawalpemilu.org#58221,"MEBBA, SABU BARAT, SABU RAIJUA, NUSA TENGGARA TIMUR",1,163,17,180
https://kawalpemilu.org#58221,"MEBBA, SABU BARAT, SABU RAIJUA, NUSA TENGGARA TIMUR",2,153,52,205
https://kawalpemilu.org#58221,"MEBBA, SABU BARAT, SABU RAIJUA, NUSA TENGGARA TIMUR",3,197,20,217
https://kawalpemilu.org#58221,"MEBBA, SABU BARAT, SABU RAIJUA, NUSA TENGGARA TIMUR",4,62,123,185
https://kawalpemilu.org#58221,"MEBBA, SABU BARAT, SABU RAIJUA, NUSA TENGGARA TIMUR",5,133,6,139
https://kawalpemilu.org#58221,"MEBBA, SABU BARAT, SABU RAIJUA, NUSA TENGGARA TIMUR",6,120,11,131
https://kawalpemilu.org#58221,"MEBBA, SABU BARAT, SABU RAIJUA, NUSA TENGGARA TIMUR",7,206,9,215
https://kawalpemilu.org#58221,"MEBBA, SABU BARAT, SABU RAIJUA, NUSA TENGGARA TIMUR",8,145,1,146
https://kawalpemilu.org#58221,"MEBBA, SABU BARAT, SABU RAIJUA, NUSA TENGGARA TIMUR",9,176,8,184
https://kawalpemilu.org#58222,"MENIA, SABU BARAT, SABU RAIJUA, NUSA TENGGARA TIMUR",1,182,4,186
https://kawalpemilu.org#58222,"MENIA, SABU BARAT, SABU RAIJUA, NUSA TENGGARA TIMUR",2,200,12,212
https://kawalpemilu.org#58222,"MENIA, SABU BARAT, SABU RAIJUA, NUSA TENGGARA TIMUR",3,155,4,159
https://kawalpemilu.org#58222,"MENIA, SABU BARAT, SABU RAIJUA, NUSA TENGGARA TIMUR",4,136,7,143
https://kawalpemilu.org#58222,"MENIA, SABU BARAT, SABU RAIJUA, NUSA TENGGARA TIMUR",5,206,10,216
https://kawalpemilu.org#58222,"MENIA, SABU BARAT, SABU RAIJUA, NUSA TENGGARA TIMUR",6,209,4,213
https://kawalpemilu.org#58222,"MENIA, SABU BARAT, SABU RAIJUA, NUSA TENGGARA TIMUR",7,185,5,190
https://kawalpemilu.org#58222,"MENIA, SABU BARAT, SABU RAIJUA, NUSA TENGGARA TIMUR",8,188,0,188
https://kawalpemilu.org#58223,"RAELORO, SABU BARAT, SABU RAIJUA, NUSA TENGGARA TIMUR",1,217,6,223
https://kawalpemilu.org#58223,"RAELORO, SABU BARAT, SABU RAIJUA, NUSA TENGGARA TIMUR",2,145,4,149
https://kawalpemilu.org#58223,"RAELORO, SABU BARAT, SABU RAIJUA, NUSA TENGGARA TIMUR",3,168,3,171
https://kawalpemilu.org#58223,"RAELORO, SABU BARAT, SABU RAIJUA, NUSA TENGGARA TIMUR",4,249,5,254
https://kawalpemilu.org#58223,"RAELORO, SABU BARAT, SABU RAIJUA, NUSA TENGGARA TIMUR",5,170,1,171
https://kawalpemilu.org#58224,"NADAWAWI, SABU BARAT, SABU RAIJUA, NUSA TENGGARA TIMUR",1,165,5,170
https://kawalpemilu.org#58224,"NADAWAWI, SABU BARAT, SABU RAIJUA, NUSA TENGGARA TIMUR",2,156,7,163
https://kawalpemilu.org#58224,"NADAWAWI, SABU BARAT, SABU RAIJUA, NUSA TENGGARA TIMUR",3,181,2,183
https://kawalpemilu.org#58224,"NADAWAWI, SABU BARAT, SABU RAIJUA, NUSA TENGGARA TIMUR",4,222,9,231
https://kawalpemilu.org#58224,"NADAWAWI, SABU BARAT, SABU RAIJUA, NUSA TENGGARA TIMUR",5,185,6,191
https://kawalpemilu.org#58224,"NADAWAWI, SABU BARAT, SABU RAIJUA, NUSA TENGGARA TIMUR",6,120,1,121
https://kawalpemilu.org#58225,"TERIWU, SABU BARAT, SABU RAIJUA, NUSA TENGGARA TIMUR",1,175,7,182
https://kawalpemilu.org#58225,"TERIWU, SABU BARAT, SABU RAIJUA, NUSA TENGGARA TIMUR",2,161,5,166
https://kawalpemilu.org#58225,"TERIWU, SABU BARAT, SABU RAIJUA, NUSA TENGGARA TIMUR",3,145,6,151
https://kawalpemilu.org#58226,"RAENALULU, SABU BARAT, SABU RAIJUA, NUSA TENGGARA TIMUR",1,198,2,200
https://kawalpemilu.org#58226,"RAENALULU, SABU BARAT, SABU RAIJUA, NUSA TENGGARA TIMUR",2,161,6,167
https://kawalpemilu.org#58226,"RAENALULU, SABU BARAT, SABU RAIJUA, NUSA TENGGARA TIMUR",3,172,3,175
https://kawalpemilu.org#58226,"RAENALULU, SABU BARAT, SABU RAIJUA, NUSA TENGGARA TIMUR",4,202,2,204
https://kawalpemilu.org#58227,"RAEDEWA, SABU BARAT, SABU RAIJUA, NUSA TENGGARA TIMUR",1,161,0,161
https://kawalpemilu.org#58227,"RAEDEWA, SABU BARAT, SABU RAIJUA, NUSA TENGGARA TIMUR",2,146,5,151
https://kawalpemilu.org#58227,"RAEDEWA, SABU BARAT, SABU RAIJUA, NUSA TENGGARA TIMUR",3,152,10,162
https://kawalpemilu.org#58227,"RAEDEWA, SABU BARAT, SABU RAIJUA, NUSA TENGGARA TIMUR",4,213,4,217
https://kawalpemilu.org#58227,"RAEDEWA, SABU BARAT, SABU RAIJUA, NUSA TENGGARA TIMUR",5,159,3,162
https://kawalpemilu.org#58227,"RAEDEWA, SABU BARAT, SABU RAIJUA, NUSA TENGGARA TIMUR",6,169,5,174
https://kawalpemilu.org#58228,"LEDEANA, SABU BARAT, SABU RAIJUA, NUSA TENGGARA TIMUR",1,184,8,192
https://kawalpemilu.org#58228,"LEDEANA, SABU BARAT, SABU RAIJUA, NUSA TENGGARA TIMUR",2,169,6,175
https://kawalpemilu.org#58228,"LEDEANA, SABU BARAT, SABU RAIJUA, NUSA TENGGARA TIMUR",3,173,0,173
https://kawalpemilu.org#58228,"LEDEANA, SABU BARAT, SABU RAIJUA, NUSA TENGGARA TIMUR",4,167,6,173
https://kawalpemilu.org#58228,"LEDEANA, SABU BARAT, SABU RAIJUA, NUSA TENGGARA TIMUR",5,113,2,115
https://kawalpemilu.org#58229,"DEPE, SABU BARAT, SABU RAIJUA, NUSA TENGGARA TIMUR",1,156,20,176
https://kawalpemilu.org#58229,"DEPE, SABU BARAT, SABU RAIJUA, NUSA TENGGARA TIMUR",2,147,5,152
https://kawalpemilu.org#58229,"DEPE, SABU BARAT, SABU RAIJUA, NUSA TENGGARA TIMUR",3,168,3,171
https://kawalpemilu.org#58229,"DEPE, SABU BARAT, SABU RAIJUA, NUSA TENGGARA TIMUR",4,164,5,169
https://kawalpemilu.org#58230,"RAEMUDE, SABU BARAT, SABU RAIJUA, NUSA TENGGARA TIMUR",1,155,6,161
https://kawalpemilu.org#58230,"RAEMUDE, SABU BARAT, SABU RAIJUA, NUSA TENGGARA TIMUR",2,112,7,119
https://kawalpemilu.org#58230,"RAEMUDE, SABU BARAT, SABU RAIJUA, NUSA TENGGARA TIMUR",3,167,4,171
https://kawalpemilu.org#58230,"RAEMUDE, SABU BARAT, SABU RAIJUA, NUSA TENGGARA TIMUR",4,110,2,112
https://kawalpemilu.org#58230,"RAEMUDE, SABU BARAT, SABU RAIJUA, NUSA TENGGARA TIMUR",5,152,3,155
https://kawalpemilu.org#58230,"RAEMUDE, SABU BARAT, SABU RAIJUA, NUSA TENGGARA TIMUR",6,182,3,185
https://kawalpemilu.org#58231,"RAENYALE, SABU BARAT, SABU RAIJUA, NUSA TENGGARA TIMUR",1,208,8,216
https://kawalpemilu.org#58231,"RAENYALE, SABU BARAT, SABU RAIJUA, NUSA TENGGARA TIMUR",2,174,2,176
https://kawalpemilu.org#58231,"RAENYALE, SABU BARAT, SABU RAIJUA, NUSA TENGGARA TIMUR",3,140,3,143
https://kawalpemilu.org#58231,"RAENYALE, SABU BARAT, SABU RAIJUA, NUSA TENGGARA TIMUR",4,155,1,156
https://kawalpemilu.org#58231,"RAENYALE, SABU BARAT, SABU RAIJUA, NUSA TENGGARA TIMUR",5,136,4,140
https://kawalpemilu.org#58231,"RAENYALE, SABU BARAT, SABU RAIJUA, NUSA TENGGARA TIMUR",6,143,0,143
https://kawalpemilu.org#58233,"TITINALEDE, SABU BARAT, SABU RAIJUA, NUSA TENGGARA TIMUR",1,139,7,146
https://kawalpemilu.org#58233,"TITINALEDE, SABU BARAT, SABU RAIJUA, NUSA TENGGARA TIMUR",2,204,4,208
https://kawalpemilu.org#58234,"LEDEKEPAKA, SABU BARAT, SABU RAIJUA, NUSA TENGGARA TIMUR",1,188,6,194
https://kawalpemilu.org#58234,"LEDEKEPAKA, SABU BARAT, SABU RAIJUA, NUSA TENGGARA TIMUR",2,196,6,202
https://kawalpemilu.org#58234,"LEDEKEPAKA, SABU BARAT, SABU RAIJUA, NUSA TENGGARA TIMUR",3,156,6,162
https://kawalpemilu.org#58235,"ROBOABA, SABU BARAT, SABU RAIJUA, NUSA TENGGARA TIMUR",1,201,3,204
https://kawalpemilu.org#58235,"ROBOABA, SABU BARAT, SABU RAIJUA, NUSA TENGGARA TIMUR",2,192,9,201
https://kawalpemilu.org#58235,"ROBOABA, SABU BARAT, SABU RAIJUA, NUSA TENGGARA TIMUR",3,199,7,206
https://kawalpemilu.org#58236,"RAEMADIA, SABU BARAT, SABU RAIJUA, NUSA TENGGARA TIMUR",1,242,7,249
https://kawalpemilu.org#58236,"RAEMADIA, SABU BARAT, SABU RAIJUA, NUSA TENGGARA TIMUR",2,236,7,243
https://kawalpemilu.org#58236,"RAEMADIA, SABU BARAT, SABU RAIJUA, NUSA TENGGARA TIMUR",3,194,8,202
https://kawalpemilu.org#58236,"RAEMADIA, SABU BARAT, SABU RAIJUA, NUSA TENGGARA TIMUR",4,247,11,258
https://kawalpemilu.org#58236,"RAEMADIA, SABU BARAT, SABU RAIJUA, NUSA TENGGARA TIMUR",5,228,5,233
https://kawalpemilu.org#58236,"RAEMADIA, SABU BARAT, SABU RAIJUA, NUSA TENGGARA TIMUR",6,130,2,132
https://kawalpemilu.org#92398,"DELO, SABU BARAT, SABU RAIJUA, NUSA TENGGARA TIMUR",1,187,5,192
https://kawalpemilu.org#92398,"DELO, SABU BARAT, SABU RAIJUA, NUSA TENGGARA TIMUR",2,186,3,189
https://kawalpemilu.org#92398,"DELO, SABU BARAT, SABU RAIJUA, NUSA TENGGARA TIMUR",3,175,3,178
https://kawalpemilu.org#92404,"DJADU, SABU BARAT, SABU RAIJUA, NUSA TENGGARA TIMUR",1,153,3,156
https://kawalpemilu.org#92404,"DJADU, SABU BARAT, SABU RAIJUA, NUSA TENGGARA TIMUR",2,123,2,125
https://kawalpemilu.org#927487,"RAEKORE, SABU BARAT, SABU RAIJUA, NUSA TENGGARA TIMUR",1,184,4,188
https://kawalpemilu.org#927487,"RAEKORE, SABU BARAT, SABU RAIJUA, NUSA TENGGARA TIMUR",2,165,4,169
https://kawalpemilu.org#927487,"RAEKORE, SABU BARAT, SABU RAIJUA, NUSA TENGGARA TIMUR",3,137,6,143
https://kawalpemilu.org#927487,"RAEKORE, SABU BARAT, SABU RAIJUA, NUSA TENGGARA TIMUR",4,150,3,153
https://kawalpemilu.org#927487,"RAEKORE, SABU BARAT, SABU RAIJUA, NUSA TENGGARA TIMUR",5,160,4,164
https://kawalpemilu.org#58238,"BEBAE, SABU TENGAH, SABU RAIJUA, NUSA TENGGARA TIMUR",1,139,3,142
https://kawalpemilu.org#58238,"BEBAE, SABU TENGAH, SABU RAIJUA, NUSA TENGGARA TIMUR",2,138,9,147
https://kawalpemilu.org#58238,"BEBAE, SABU TENGAH, SABU RAIJUA, NUSA TENGGARA TIMUR",3,140,5,145
https://kawalpemilu.org#58239,"TADA, SABU TENGAH, SABU RAIJUA, NUSA TENGGARA TIMUR",1,145,6,151
https://kawalpemilu.org#58239,"TADA, SABU TENGAH, SABU RAIJUA, NUSA TENGGARA TIMUR",2,94,6,100
https://kawalpemilu.org#58239,"TADA, SABU TENGAH, SABU RAIJUA, NUSA TENGGARA TIMUR",3,160,2,162
https://kawalpemilu.org#58240,"MATEI, SABU TENGAH, SABU RAIJUA, NUSA TENGGARA TIMUR",1,175,11,186
https://kawalpemilu.org#58240,"MATEI, SABU TENGAH, SABU RAIJUA, NUSA TENGGARA TIMUR",2,173,5,178
https://kawalpemilu.org#58240,"MATEI, SABU TENGAH, SABU RAIJUA, NUSA TENGGARA TIMUR",3,138,2,140
https://kawalpemilu.org#58241,"LOBOAJU, SABU TENGAH, SABU RAIJUA, NUSA TENGGARA TIMUR",1,194,4,198
https://kawalpemilu.org#58241,"LOBOAJU, SABU TENGAH, SABU RAIJUA, NUSA TENGGARA TIMUR",2,156,4,160
https://kawalpemilu.org#58242,"EIMADAKE, SABU TENGAH, SABU RAIJUA, NUSA TENGGARA TIMUR",1,170,5,175
https://kawalpemilu.org#58242,"EIMADAKE, SABU TENGAH, SABU RAIJUA, NUSA TENGGARA TIMUR",2,135,1,136
https://kawalpemilu.org#58242,"EIMADAKE, SABU TENGAH, SABU RAIJUA, NUSA TENGGARA TIMUR",3,171,6,177
https://kawalpemilu.org#58242,"EIMADAKE, SABU TENGAH, SABU RAIJUA, NUSA TENGGARA TIMUR",4,103,6,109
https://kawalpemilu.org#58243,"EILODE, SABU TENGAH, SABU RAIJUA, NUSA TENGGARA TIMUR",1,150,10,160
https://kawalpemilu.org#58243,"EILODE, SABU TENGAH, SABU RAIJUA, NUSA TENGGARA TIMUR",2,212,6,218
https://kawalpemilu.org#58243,"EILODE, SABU TENGAH, SABU RAIJUA, NUSA TENGGARA TIMUR",3,136,7,143
https://kawalpemilu.org#58243,"EILODE, SABU TENGAH, SABU RAIJUA, NUSA TENGGARA TIMUR",4,107,5,112
https://kawalpemilu.org#58244,"EIMAU, SABU TENGAH, SABU RAIJUA, NUSA TENGGARA TIMUR",1,162,9,171
https://kawalpemilu.org#58244,"EIMAU, SABU TENGAH, SABU RAIJUA, NUSA TENGGARA TIMUR",2,191,13,204
https://kawalpemilu.org#58244,"EIMAU, SABU TENGAH, SABU RAIJUA, NUSA TENGGARA TIMUR",3,140,10,150
https://kawalpemilu.org#58244,"EIMAU, SABU TENGAH, SABU RAIJUA, NUSA TENGGARA TIMUR",4,119,15,134
https://kawalpemilu.org#58255,"JIWUWU, SABU TENGAH, SABU RAIJUA, NUSA TENGGARA TIMUR",1,131,5,136
https://kawalpemilu.org#58255,"JIWUWU, SABU TENGAH, SABU RAIJUA, NUSA TENGGARA TIMUR",2,157,7,164
https://kawalpemilu.org#58255,"JIWUWU, SABU TENGAH, SABU RAIJUA, NUSA TENGGARA TIMUR",3,142,3,145
https://kawalpemilu.org#58246,"BOLOU, SABU TIMUR, SABU RAIJUA, NUSA TENGGARA TIMUR",1,178,1,179
https://kawalpemilu.org#58246,"BOLOU, SABU TIMUR, SABU RAIJUA, NUSA TENGGARA TIMUR",2,173,6,179
https://kawalpemilu.org#58247,"LIMAGGU, SABU TIMUR, SABU RAIJUA, NUSA TENGGARA TIMUR",1,139,5,144
https://kawalpemilu.org#58247,"LIMAGGU, SABU TIMUR, SABU RAIJUA, NUSA TENGGARA TIMUR",2,158,6,164
https://kawalpemilu.org#58247,"LIMAGGU, SABU TIMUR, SABU RAIJUA, NUSA TENGGARA TIMUR",3,118,2,120
https://kawalpemilu.org#58248,"LOBODEI, SABU TIMUR, SABU RAIJUA, NUSA TENGGARA TIMUR",1,196,4,200
https://kawalpemilu.org#58248,"LOBODEI, SABU TIMUR, SABU RAIJUA, NUSA TENGGARA TIMUR",2,174,4,178
https://kawalpemilu.org#58248,"LOBODEI, SABU TIMUR, SABU RAIJUA, NUSA TENGGARA TIMUR",3,173,14,187
https://kawalpemilu.org#58249,"BODAE, SABU TIMUR, SABU RAIJUA, NUSA TENGGARA TIMUR",1,181,8,189
https://kawalpemilu.org#58249,"BODAE, SABU TIMUR, SABU RAIJUA, NUSA TENGGARA TIMUR",2,173,4,177
https://kawalpemilu.org#58249,"BODAE, SABU TIMUR, SABU RAIJUA, NUSA TENGGARA TIMUR",3,137,5,142
https://kawalpemilu.org#58249,"BODAE, SABU TIMUR, SABU RAIJUA, NUSA TENGGARA TIMUR",4,135,4,139
https://kawalpemilu.org#58250,"KEDURU, SABU TIMUR, SABU RAIJUA, NUSA TENGGARA TIMUR",1,145,3,148
https://kawalpemilu.org#58250,"KEDURU, SABU TIMUR, SABU RAIJUA, NUSA TENGGARA TIMUR",2,115,7,122
https://kawalpemilu.org#58250,"KEDURU, SABU TIMUR, SABU RAIJUA, NUSA TENGGARA TIMUR",3,190,3,193
https://kawalpemilu.org#58251,"KUJI RATU, SABU TIMUR, SABU RAIJUA, NUSA TENGGARA TIMUR",1,130,7,137
https://kawalpemilu.org#58251,"KUJI RATU, SABU TIMUR, SABU RAIJUA, NUSA TENGGARA TIMUR",2,137,9,146
https://kawalpemilu.org#58251,"KUJI RATU, SABU TIMUR, SABU RAIJUA, NUSA TENGGARA TIMUR",3,127,2,129
https://kawalpemilu.org#58252,"LOBORAI, SABU TIMUR, SABU RAIJUA, NUSA TENGGARA TIMUR",1,152,2,154
https://kawalpemilu.org#58252,"LOBORAI, SABU TIMUR, SABU RAIJUA, NUSA TENGGARA TIMUR",2,162,6,168
https://kawalpemilu.org#58253,"HUWAGA, SABU TIMUR, SABU RAIJUA, NUSA TENGGARA TIMUR",1,136,18,154
https://kawalpemilu.org#58253,"HUWAGA, SABU TIMUR, SABU RAIJUA, NUSA TENGGARA TIMUR",2,143,10,153
https://kawalpemilu.org#58254,"EIADA, SABU TIMUR, SABU RAIJUA, NUSA TENGGARA TIMUR",1,136,6,142
https://kawalpemilu.org#58254,"EIADA, SABU TIMUR, SABU RAIJUA, NUSA TENGGARA TIMUR",2,129,8,137
https://kawalpemilu.org#58254,"EIADA, SABU TIMUR, SABU RAIJUA, NUSA TENGGARA TIMUR",3,105,7,112
https://kawalpemilu.org#91388,"KELIHA, SABU TIMUR, SABU RAIJUA, NUSA TENGGARA TIMUR",1,140,14,154
https://kawalpemilu.org#91388,"KELIHA, SABU TIMUR, SABU RAIJUA, NUSA TENGGARA TIMUR",2,135,7,142
https://kawalpemilu.org#91388,"KELIHA, SABU TIMUR, SABU RAIJUA, NUSA TENGGARA TIMUR",3,128,5,133
https://kawalpemilu.org#58262,"RAEROBO, SABU LIAE, SABU RAIJUA, NUSA TENGGARA TIMUR",1,149,1,150
https://kawalpemilu.org#58262,"RAEROBO, SABU LIAE, SABU RAIJUA, NUSA TENGGARA TIMUR",2,158,2,160
https://kawalpemilu.org#58262,"RAEROBO, SABU LIAE, SABU RAIJUA, NUSA TENGGARA TIMUR",3,158,4,162
https://kawalpemilu.org#58263,"MEHONA, SABU LIAE, SABU RAIJUA, NUSA TENGGARA TIMUR",1,120,2,122
https://kawalpemilu.org#58263,"MEHONA, SABU LIAE, SABU RAIJUA, NUSA TENGGARA TIMUR",2,107,1,108
https://kawalpemilu.org#58263,"MEHONA, SABU LIAE, SABU RAIJUA, NUSA TENGGARA TIMUR",3,135,2,137
https://kawalpemilu.org#58264,"WADUWALLA, SABU LIAE, SABU RAIJUA, NUSA TENGGARA TIMUR",1,191,7,198
https://kawalpemilu.org#58264,"WADUWALLA, SABU LIAE, SABU RAIJUA, NUSA TENGGARA TIMUR",2,99,2,101
https://kawalpemilu.org#58264,"WADUWALLA, SABU LIAE, SABU RAIJUA, NUSA TENGGARA TIMUR",3,156,3,159
https://kawalpemilu.org#58265,"LEDEKE, SABU LIAE, SABU RAIJUA, NUSA TENGGARA TIMUR",1,161,12,173
https://kawalpemilu.org#58265,"LEDEKE, SABU LIAE, SABU RAIJUA, NUSA TENGGARA TIMUR",2,122,10,132
https://kawalpemilu.org#58265,"LEDEKE, SABU LIAE, SABU RAIJUA, NUSA TENGGARA TIMUR",3,133,6,139
https://kawalpemilu.org#58266,"EILOGO, SABU LIAE, SABU RAIJUA, NUSA TENGGARA TIMUR",1,156,5,161
https://kawalpemilu.org#58266,"EILOGO, SABU LIAE, SABU RAIJUA, NUSA TENGGARA TIMUR",2,138,9,147
https://kawalpemilu.org#58266,"EILOGO, SABU LIAE, SABU RAIJUA, NUSA TENGGARA TIMUR",3,149,5,154
https://kawalpemilu.org#58267,"DEME, SABU LIAE, SABU RAIJUA, NUSA TENGGARA TIMUR",1,115,6,121
https://kawalpemilu.org#58267,"DEME, SABU LIAE, SABU RAIJUA, NUSA TENGGARA TIMUR",2,136,1,137
https://kawalpemilu.org#58267,"DEME, SABU LIAE, SABU RAIJUA, NUSA TENGGARA TIMUR",3,128,5,133
https://kawalpemilu.org#58268,"KOTAHAWU, SABU LIAE, SABU RAIJUA, NUSA TENGGARA TIMUR",1,126,16,142
https://kawalpemilu.org#58268,"KOTAHAWU, SABU LIAE, SABU RAIJUA, NUSA TENGGARA TIMUR",2,145,17,162
https://kawalpemilu.org#58268,"KOTAHAWU, SABU LIAE, SABU RAIJUA, NUSA TENGGARA TIMUR",3,129,22,151
https://kawalpemilu.org#58269,"DAINAO, SABU LIAE, SABU RAIJUA, NUSA TENGGARA TIMUR",1,105,3,108
https://kawalpemilu.org#58269,"DAINAO, SABU LIAE, SABU RAIJUA, NUSA TENGGARA TIMUR",2,128,1,129
https://kawalpemilu.org#58269,"DAINAO, SABU LIAE, SABU RAIJUA, NUSA TENGGARA TIMUR",3,146,1,147
https://kawalpemilu.org#90898,"EIKARE, SABU LIAE, SABU RAIJUA, NUSA TENGGARA TIMUR",1,133,6,139
https://kawalpemilu.org#90898,"EIKARE, SABU LIAE, SABU RAIJUA, NUSA TENGGARA TIMUR",2,131,5,136
https://kawalpemilu.org#90899,"LOBORUI, SABU LIAE, SABU RAIJUA, NUSA TENGGARA TIMUR",1,133,9,142
https://kawalpemilu.org#90899,"LOBORUI, SABU LIAE, SABU RAIJUA, NUSA TENGGARA TIMUR",2,133,11,144
https://kawalpemilu.org#90899,"LOBORUI, SABU LIAE, SABU RAIJUA, NUSA TENGGARA TIMUR",3,105,3,108
https://kawalpemilu.org#90901,"HALLA PAJI, SABU LIAE, SABU RAIJUA, NUSA TENGGARA TIMUR",1,126,11,137
https://kawalpemilu.org#90901,"HALLA PAJI, SABU LIAE, SABU RAIJUA, NUSA TENGGARA TIMUR",2,120,8,128
https://kawalpemilu.org#90901,"HALLA PAJI, SABU LIAE, SABU RAIJUA, NUSA TENGGARA TIMUR",3,100,12,112
https://kawalpemilu.org#92436,"LEDETALO, SABU LIAE, SABU RAIJUA, NUSA TENGGARA TIMUR",1,97,11,108
https://kawalpemilu.org#92436,"LEDETALO, SABU LIAE, SABU RAIJUA, NUSA TENGGARA TIMUR",2,92,7,99
https://kawalpemilu.org#92436,"LEDETALO, SABU LIAE, SABU RAIJUA, NUSA TENGGARA TIMUR",3,160,8,168
https://kawalpemilu.org#58271,"LOBOHEDE, HAWU MEHARA, SABU RAIJUA, NUSA TENGGARA TIMUR",1,153,21,174
https://kawalpemilu.org#58271,"LOBOHEDE, HAWU MEHARA, SABU RAIJUA, NUSA TENGGARA TIMUR",2,159,8,167
https://kawalpemilu.org#58271,"LOBOHEDE, HAWU MEHARA, SABU RAIJUA, NUSA TENGGARA TIMUR",3,152,11,163
https://kawalpemilu.org#58271,"LOBOHEDE, HAWU MEHARA, SABU RAIJUA, NUSA TENGGARA TIMUR",4,165,5,170
https://kawalpemilu.org#58271,"LOBOHEDE, HAWU MEHARA, SABU RAIJUA, NUSA TENGGARA TIMUR",5,166,11,177
https://kawalpemilu.org#58271,"LOBOHEDE, HAWU MEHARA, SABU RAIJUA, NUSA TENGGARA TIMUR",6,171,5,176
https://kawalpemilu.org#58272,"MOLIE, HAWU MEHARA, SABU RAIJUA, NUSA TENGGARA TIMUR",1,171,5,176
https://kawalpemilu.org#58272,"MOLIE, HAWU MEHARA, SABU RAIJUA, NUSA TENGGARA TIMUR",2,152,9,161
https://kawalpemilu.org#58272,"MOLIE, HAWU MEHARA, SABU RAIJUA, NUSA TENGGARA TIMUR",3,129,11,140
https://kawalpemilu.org#58272,"MOLIE, HAWU MEHARA, SABU RAIJUA, NUSA TENGGARA TIMUR",4,182,25,207
https://kawalpemilu.org#58272,"MOLIE, HAWU MEHARA, SABU RAIJUA, NUSA TENGGARA TIMUR",5,166,14,180
https://kawalpemilu.org#58272,"MOLIE, HAWU MEHARA, SABU RAIJUA, NUSA TENGGARA TIMUR",6,191,6,197
https://kawalpemilu.org#58273,"DAIEKO, HAWU MEHARA, SABU RAIJUA, NUSA TENGGARA TIMUR",1,171,12,183
https://kawalpemilu.org#58273,"DAIEKO, HAWU MEHARA, SABU RAIJUA, NUSA TENGGARA TIMUR",2,143,7,150
https://kawalpemilu.org#58273,"DAIEKO, HAWU MEHARA, SABU RAIJUA, NUSA TENGGARA TIMUR",3,119,7,126
https://kawalpemilu.org#58273,"DAIEKO, HAWU MEHARA, SABU RAIJUA, NUSA TENGGARA TIMUR",4,114,8,122
https://kawalpemilu.org#58273,"DAIEKO, HAWU MEHARA, SABU RAIJUA, NUSA TENGGARA TIMUR",5,124,14,138
https://kawalpemilu.org#58273,"DAIEKO, HAWU MEHARA, SABU RAIJUA, NUSA TENGGARA TIMUR",6,135,7,142
https://kawalpemilu.org#58273,"DAIEKO, HAWU MEHARA, SABU RAIJUA, NUSA TENGGARA TIMUR",7,135,5,140
https://kawalpemilu.org#58274,"PEDARRO, HAWU MEHARA, SABU RAIJUA, NUSA TENGGARA TIMUR",1,165,15,180
https://kawalpemilu.org#58274,"PEDARRO, HAWU MEHARA, SABU RAIJUA, NUSA TENGGARA TIMUR",2,153,27,180
https://kawalpemilu.org#58274,"PEDARRO, HAWU MEHARA, SABU RAIJUA, NUSA TENGGARA TIMUR",3,170,14,184
https://kawalpemilu.org#58274,"PEDARRO, HAWU MEHARA, SABU RAIJUA, NUSA TENGGARA TIMUR",4,138,17,155
https://kawalpemilu.org#58274,"PEDARRO, HAWU MEHARA, SABU RAIJUA, NUSA TENGGARA TIMUR",5,164,7,171
https://kawalpemilu.org#58274,"PEDARRO, HAWU MEHARA, SABU RAIJUA, NUSA TENGGARA TIMUR",6,146,5,151
https://kawalpemilu.org#58274,"PEDARRO, HAWU MEHARA, SABU RAIJUA, NUSA TENGGARA TIMUR",7,144,5,149
https://kawalpemilu.org#58274,"PEDARRO, HAWU MEHARA, SABU RAIJUA, NUSA TENGGARA TIMUR",8,139,9,148
https://kawalpemilu.org#58275,"TANAJAWA, HAWU MEHARA, SABU RAIJUA, NUSA TENGGARA TIMUR",1,146,14,160
https://kawalpemilu.org#58275,"TANAJAWA, HAWU MEHARA, SABU RAIJUA, NUSA TENGGARA TIMUR",2,138,14,152
https://kawalpemilu.org#58275,"TANAJAWA, HAWU MEHARA, SABU RAIJUA, NUSA TENGGARA TIMUR",3,147,11,158
https://kawalpemilu.org#58275,"TANAJAWA, HAWU MEHARA, SABU RAIJUA, NUSA TENGGARA TIMUR",4,155,11,166
https://kawalpemilu.org#58275,"TANAJAWA, HAWU MEHARA, SABU RAIJUA, NUSA TENGGARA TIMUR",5,142,7,149
https://kawalpemilu.org#58276,"LEDEAE, HAWU MEHARA, SABU RAIJUA, NUSA TENGGARA TIMUR",1,184,10,194
https://kawalpemilu.org#58276,"LEDEAE, HAWU MEHARA, SABU RAIJUA, NUSA TENGGARA TIMUR",2,195,5,200
https://kawalpemilu.org#58276,"LEDEAE, HAWU MEHARA, SABU RAIJUA, NUSA TENGGARA TIMUR",3,167,8,175
https://kawalpemilu.org#58277,"WADUMADDI, HAWU MEHARA, SABU RAIJUA, NUSA TENGGARA TIMUR",1,137,6,143
https://kawalpemilu.org#58277,"WADUMADDI, HAWU MEHARA, SABU RAIJUA, NUSA TENGGARA TIMUR",2,192,8,200
https://kawalpemilu.org#58277,"WADUMADDI, HAWU MEHARA, SABU RAIJUA, NUSA TENGGARA TIMUR",3,171,8,179
https://kawalpemilu.org#58278,"LEDERAGA, HAWU MEHARA, SABU RAIJUA, NUSA TENGGARA TIMUR",1,185,13,198
https://kawalpemilu.org#58278,"LEDERAGA, HAWU MEHARA, SABU RAIJUA, NUSA TENGGARA TIMUR",2,164,37,201
https://kawalpemilu.org#58278,"LEDERAGA, HAWU MEHARA, SABU RAIJUA, NUSA TENGGARA TIMUR",3,220,9,229
https://kawalpemilu.org#58278,"LEDERAGA, HAWU MEHARA, SABU RAIJUA, NUSA TENGGARA TIMUR",4,187,18,205
https://kawalpemilu.org#90904,"GURIMONEARU, HAWU MEHARA, SABU RAIJUA, NUSA TENGGARA TIMUR",1,137,6,143
https://kawalpemilu.org#90904,"GURIMONEARU, HAWU MEHARA, SABU RAIJUA, NUSA TENGGARA TIMUR",2,128,14,142
https://kawalpemilu.org#90904,"GURIMONEARU, HAWU MEHARA, SABU RAIJUA, NUSA TENGGARA TIMUR",3,134,6,140
https://kawalpemilu.org#90904,"GURIMONEARU, HAWU MEHARA, SABU RAIJUA, NUSA TENGGARA TIMUR",4,122,8,130
https://kawalpemilu.org#90905,"RAMEDUE, HAWU MEHARA, SABU RAIJUA, NUSA TENGGARA TIMUR",1,116,3,119
https://kawalpemilu.org#90905,"RAMEDUE, HAWU MEHARA, SABU RAIJUA, NUSA TENGGARA TIMUR",2,146,8,154
https://kawalpemilu.org#90905,"RAMEDUE, HAWU MEHARA, SABU RAIJUA, NUSA TENGGARA TIMUR",3,162,4,166
https://kawalpemilu.org#90905,"RAMEDUE, HAWU MEHARA, SABU RAIJUA, NUSA TENGGARA TIMUR",4,150,6,156
https://kawalpemilu.org#58280,"LEDEKE, RAIJUA, SABU RAIJUA, NUSA TENGGARA TIMUR",1,166,23,189
https://kawalpemilu.org#58280,"LEDEKE, RAIJUA, SABU RAIJUA, NUSA TENGGARA TIMUR",2,170,14,184
https://kawalpemilu.org#58280,"LEDEKE, RAIJUA, SABU RAIJUA, NUSA TENGGARA TIMUR",3,179,15,194
https://kawalpemilu.org#58281,"LEDEUNU, RAIJUA, SABU RAIJUA, NUSA TENGGARA TIMUR",1,210,11,221
https://kawalpemilu.org#58281,"LEDEUNU, RAIJUA, SABU RAIJUA, NUSA TENGGARA TIMUR",2,218,12,230
https://kawalpemilu.org#58281,"LEDEUNU, RAIJUA, SABU RAIJUA, NUSA TENGGARA TIMUR",3,202,14,216
https://kawalpemilu.org#58281,"LEDEUNU, RAIJUA, SABU RAIJUA, NUSA TENGGARA TIMUR",4,219,17,236
https://kawalpemilu.org#58281,"LEDEUNU, RAIJUA, SABU RAIJUA, NUSA TENGGARA TIMUR",5,199,13,212
https://kawalpemilu.org#58281,"LEDEUNU, RAIJUA, SABU RAIJUA, NUSA TENGGARA TIMUR",6,210,5,215
https://kawalpemilu.org#58282,"BOLUA, RAIJUA, SABU RAIJUA, NUSA TENGGARA TIMUR",1,149,13,162
https://kawalpemilu.org#58282,"BOLUA, RAIJUA, SABU RAIJUA, NUSA TENGGARA TIMUR",2,189,5,194
https://kawalpemilu.org#58282,"BOLUA, RAIJUA, SABU RAIJUA, NUSA TENGGARA TIMUR",3,159,7,166
https://kawalpemilu.org#58282,"BOLUA, RAIJUA, SABU RAIJUA, NUSA TENGGARA TIMUR",4,160,9,169
https://kawalpemilu.org#58282,"BOLUA, RAIJUA, SABU RAIJUA, NUSA TENGGARA TIMUR",5,150,8,158
https://kawalpemilu.org#58283,"KOLORAE, RAIJUA, SABU RAIJUA, NUSA TENGGARA TIMUR",1,148,8,156
https://kawalpemilu.org#58283,"KOLORAE, RAIJUA, SABU RAIJUA, NUSA TENGGARA TIMUR",2,167,16,183
https://kawalpemilu.org#58283,"KOLORAE, RAIJUA, SABU RAIJUA, NUSA TENGGARA TIMUR",3,179,3,182
https://kawalpemilu.org#58283,"KOLORAE, RAIJUA, SABU RAIJUA, NUSA TENGGARA TIMUR",4,215,7,222
https://kawalpemilu.org#58284,"BALLU, RAIJUA, SABU RAIJUA, NUSA TENGGARA TIMUR",1,149,6,155
https://kawalpemilu.org#58284,"BALLU, RAIJUA, SABU RAIJUA, NUSA TENGGARA TIMUR",2,163,5,168
https://kawalpemilu.org#58284,"BALLU, RAIJUA, SABU RAIJUA, NUSA TENGGARA TIMUR",3,171,8,179
https://kawalpemilu.org#58284,"BALLU, RAIJUA, SABU RAIJUA, NUSA TENGGARA TIMUR",4,189,3,192
https://kawalpemilu.org#55867,"RAIULUN, MALAKA TIMUR, MALAKA, NUSA TENGGARA TIMUR",1,99,5,104
https://kawalpemilu.org#55867,"RAIULUN, MALAKA TIMUR, MALAKA, NUSA TENGGARA TIMUR",2,105,12,117
https://kawalpemilu.org#55867,"RAIULUN, MALAKA TIMUR, MALAKA, NUSA TENGGARA TIMUR",3,60,8,68
https://kawalpemilu.org#55867,"RAIULUN, MALAKA TIMUR, MALAKA, NUSA TENGGARA TIMUR",4,134,11,145
https://kawalpemilu.org#55868,"WEMEDA, MALAKA TIMUR, MALAKA, NUSA TENGGARA TIMUR",1,110,7,117
https://kawalpemilu.org#55868,"WEMEDA, MALAKA TIMUR, MALAKA, NUSA TENGGARA TIMUR",2,156,4,160
https://kawalpemilu.org#55868,"WEMEDA, MALAKA TIMUR, MALAKA, NUSA TENGGARA TIMUR",3,128,4,132
https://kawalpemilu.org#55868,"WEMEDA, MALAKA TIMUR, MALAKA, NUSA TENGGARA TIMUR",5,183,9,192
https://kawalpemilu.org#55868,"WEMEDA, MALAKA TIMUR, MALAKA, NUSA TENGGARA TIMUR",6,117,4,121
https://kawalpemilu.org#55869,"KUSA, MALAKA TIMUR, MALAKA, NUSA TENGGARA TIMUR",1,104,13,117
https://kawalpemilu.org#55869,"KUSA, MALAKA TIMUR, MALAKA, NUSA TENGGARA TIMUR",2,139,8,147
https://kawalpemilu.org#55869,"KUSA, MALAKA TIMUR, MALAKA, NUSA TENGGARA TIMUR",3,199,8,207
https://kawalpemilu.org#55869,"KUSA, MALAKA TIMUR, MALAKA, NUSA TENGGARA TIMUR",4,181,21,202
https://kawalpemilu.org#55869,"KUSA, MALAKA TIMUR, MALAKA, NUSA TENGGARA TIMUR",5,167,14,181
https://kawalpemilu.org#55870,"NUMPONI, MALAKA TIMUR, MALAKA, NUSA TENGGARA TIMUR",1,188,8,196
https://kawalpemilu.org#55870,"NUMPONI, MALAKA TIMUR, MALAKA, NUSA TENGGARA TIMUR",2,66,89,155
https://kawalpemilu.org#55870,"NUMPONI, MALAKA TIMUR, MALAKA, NUSA TENGGARA TIMUR",3,107,62,169
https://kawalpemilu.org#55870,"NUMPONI, MALAKA TIMUR, MALAKA, NUSA TENGGARA TIMUR",4,181,18,199
https://kawalpemilu.org#55870,"NUMPONI, MALAKA TIMUR, MALAKA, NUSA TENGGARA TIMUR",5,151,10,161
https://kawalpemilu.org#55870,"NUMPONI, MALAKA TIMUR, MALAKA, NUSA TENGGARA TIMUR",6,50,49,99
https://kawalpemilu.org#55870,"NUMPONI, MALAKA TIMUR, MALAKA, NUSA TENGGARA TIMUR",7,113,32,145
https://kawalpemilu.org#55870,"NUMPONI, MALAKA TIMUR, MALAKA, NUSA TENGGARA TIMUR",8,132,8,140
https://kawalpemilu.org#55871,"DIRMA, MALAKA TIMUR, MALAKA, NUSA TENGGARA TIMUR",1,122,2,124
https://kawalpemilu.org#55871,"DIRMA, MALAKA TIMUR, MALAKA, NUSA TENGGARA TIMUR",2,156,17,173
https://kawalpemilu.org#55871,"DIRMA, MALAKA TIMUR, MALAKA, NUSA TENGGARA TIMUR",3,129,20,149
https://kawalpemilu.org#55871,"DIRMA, MALAKA TIMUR, MALAKA, NUSA TENGGARA TIMUR",4,67,6,73
https://kawalpemilu.org#55871,"DIRMA, MALAKA TIMUR, MALAKA, NUSA TENGGARA TIMUR",5,97,13,110
https://kawalpemilu.org#55872,"SANLEO, MALAKA TIMUR, MALAKA, NUSA TENGGARA TIMUR",1,116,16,132
https://kawalpemilu.org#55872,"SANLEO, MALAKA TIMUR, MALAKA, NUSA TENGGARA TIMUR",2,147,7,154
https://kawalpemilu.org#55872,"SANLEO, MALAKA TIMUR, MALAKA, NUSA TENGGARA TIMUR",3,153,19,172
https://kawalpemilu.org#55872,"SANLEO, MALAKA TIMUR, MALAKA, NUSA TENGGARA TIMUR",4,146,31,177
https://kawalpemilu.org#55872,"SANLEO, MALAKA TIMUR, MALAKA, NUSA TENGGARA TIMUR",5,116,7,123
https://kawalpemilu.org#55872,"SANLEO, MALAKA TIMUR, MALAKA, NUSA TENGGARA TIMUR",6,64,6,70
https://kawalpemilu.org#55872,"SANLEO, MALAKA TIMUR, MALAKA, NUSA TENGGARA TIMUR",7,99,7,106
https://kawalpemilu.org#55874,"BABULU, KOBALIMA, MALAKA, NUSA TENGGARA TIMUR",1,105,19,124
https://kawalpemilu.org#55874,"BABULU, KOBALIMA, MALAKA, NUSA TENGGARA TIMUR",2,144,14,158
https://kawalpemilu.org#55874,"BABULU, KOBALIMA, MALAKA, NUSA TENGGARA TIMUR",3,132,5,137
https://kawalpemilu.org#55874,"BABULU, KOBALIMA, MALAKA, NUSA TENGGARA TIMUR",4,84,22,106
https://kawalpemilu.org#55874,"BABULU, KOBALIMA, MALAKA, NUSA TENGGARA TIMUR",5,65,13,78
https://kawalpemilu.org#55875,"BABULU SELATAN, KOBALIMA, MALAKA, NUSA TENGGARA TIMUR",1,141,6,147
https://kawalpemilu.org#55875,"BABULU SELATAN, KOBALIMA, MALAKA, NUSA TENGGARA TIMUR",2,89,10,99
https://kawalpemilu.org#55875,"BABULU SELATAN, KOBALIMA, MALAKA, NUSA TENGGARA TIMUR",3,97,8,105
https://kawalpemilu.org#55875,"BABULU SELATAN, KOBALIMA, MALAKA, NUSA TENGGARA TIMUR",4,139,21,160
https://kawalpemilu.org#55875,"BABULU SELATAN, KOBALIMA, MALAKA, NUSA TENGGARA TIMUR",5,66,2,68
https://kawalpemilu.org#55876,"SISI, KOBALIMA, MALAKA, NUSA TENGGARA TIMUR",1,147,10,157
https://kawalpemilu.org#55876,"SISI, KOBALIMA, MALAKA, NUSA TENGGARA TIMUR",2,136,1,137
https://kawalpemilu.org#55876,"SISI, KOBALIMA, MALAKA, NUSA TENGGARA TIMUR",3,60,100,160
https://kawalpemilu.org#55876,"SISI, KOBALIMA, MALAKA, NUSA TENGGARA TIMUR",4,142,8,150
https://kawalpemilu.org#55876,"SISI, KOBALIMA, MALAKA, NUSA TENGGARA TIMUR",5,150,15,165
https://kawalpemilu.org#55877,"RAINAWE, KOBALIMA, MALAKA, NUSA TENGGARA TIMUR",1,75,40,115
https://kawalpemilu.org#55877,"RAINAWE, KOBALIMA, MALAKA, NUSA TENGGARA TIMUR",2,97,38,135
https://kawalpemilu.org#55877,"RAINAWE, KOBALIMA, MALAKA, NUSA TENGGARA TIMUR",3,62,19,81
https://kawalpemilu.org#55877,"RAINAWE, KOBALIMA, MALAKA, NUSA TENGGARA TIMUR",4,135,22,157
https://kawalpemilu.org#55877,"RAINAWE, KOBALIMA, MALAKA, NUSA TENGGARA TIMUR",5,61,90,151
https://kawalpemilu.org#55877,"RAINAWE, KOBALIMA, MALAKA, NUSA TENGGARA TIMUR",6,162,34,196
https://kawalpemilu.org#55877,"RAINAWE, KOBALIMA, MALAKA, NUSA TENGGARA TIMUR",7,158,20,178
https://kawalpemilu.org#55877,"RAINAWE, KOBALIMA, MALAKA, NUSA TENGGARA TIMUR",8,172,34,206
https://kawalpemilu.org#55877,"RAINAWE, KOBALIMA, MALAKA, NUSA TENGGARA TIMUR",9,62,68,130
https://kawalpemilu.org#55877,"RAINAWE, KOBALIMA, MALAKA, NUSA TENGGARA TIMUR",10,137,20,157
https://kawalpemilu.org#55878,"LITAMALI, KOBALIMA, MALAKA, NUSA TENGGARA TIMUR",1,87,99,186
https://kawalpemilu.org#55878,"LITAMALI, KOBALIMA, MALAKA, NUSA TENGGARA TIMUR",2,92,66,158
https://kawalpemilu.org#55878,"LITAMALI, KOBALIMA, MALAKA, NUSA TENGGARA TIMUR",3,66,106,172
https://kawalpemilu.org#55878,"LITAMALI, KOBALIMA, MALAKA, NUSA TENGGARA TIMUR",4,53,42,95
https://kawalpemilu.org#55878,"LITAMALI, KOBALIMA, MALAKA, NUSA TENGGARA TIMUR",5,120,12,132
https://kawalpemilu.org#55878,"LITAMALI, KOBALIMA, MALAKA, NUSA TENGGARA TIMUR",6,82,28,110
https://kawalpemilu.org#55878,"LITAMALI, KOBALIMA, MALAKA, NUSA TENGGARA TIMUR",7,118,15,133
https://kawalpemilu.org#55878,"LITAMALI, KOBALIMA, MALAKA, NUSA TENGGARA TIMUR",8,135,11,146
https://kawalpemilu.org#55878,"LITAMALI, KOBALIMA, MALAKA, NUSA TENGGARA TIMUR",9,183,10,193
https://kawalpemilu.org#55878,"LITAMALI, KOBALIMA, MALAKA, NUSA TENGGARA TIMUR",10,140,30,170
https://kawalpemilu.org#55878,"LITAMALI, KOBALIMA, MALAKA, NUSA TENGGARA TIMUR",11,162,11,173
https://kawalpemilu.org#55878,"LITAMALI, KOBALIMA, MALAKA, NUSA TENGGARA TIMUR",12,82,11,93
https://kawalpemilu.org#55879,"LAKEKUN UTARA, KOBALIMA, MALAKA, NUSA TENGGARA TIMUR",1,116,15,131
https://kawalpemilu.org#55879,"LAKEKUN UTARA, KOBALIMA, MALAKA, NUSA TENGGARA TIMUR",2,87,42,129
https://kawalpemilu.org#55879,"LAKEKUN UTARA, KOBALIMA, MALAKA, NUSA TENGGARA TIMUR",3,54,59,113
https://kawalpemilu.org#55879,"LAKEKUN UTARA, KOBALIMA, MALAKA, NUSA TENGGARA TIMUR",4,114,8,122
https://kawalpemilu.org#55879,"LAKEKUN UTARA, KOBALIMA, MALAKA, NUSA TENGGARA TIMUR",5,160,8,168
https://kawalpemilu.org#55879,"LAKEKUN UTARA, KOBALIMA, MALAKA, NUSA TENGGARA TIMUR",6,129,8,137
https://kawalpemilu.org#55879,"LAKEKUN UTARA, KOBALIMA, MALAKA, NUSA TENGGARA TIMUR",7,66,39,105
https://kawalpemilu.org#55880,"LAKEKUN, KOBALIMA, MALAKA, NUSA TENGGARA TIMUR",1,135,9,144
https://kawalpemilu.org#55880,"LAKEKUN, KOBALIMA, MALAKA, NUSA TENGGARA TIMUR",2,184,11,195
https://kawalpemilu.org#55880,"LAKEKUN, KOBALIMA, MALAKA, NUSA TENGGARA TIMUR",3,174,14,188
https://kawalpemilu.org#55880,"LAKEKUN, KOBALIMA, MALAKA, NUSA TENGGARA TIMUR",4,102,39,141
https://kawalpemilu.org#55880,"LAKEKUN, KOBALIMA, MALAKA, NUSA TENGGARA TIMUR",5,82,30,112
https://kawalpemilu.org#55880,"LAKEKUN, KOBALIMA, MALAKA, NUSA TENGGARA TIMUR",6,137,62,199
https://kawalpemilu.org#55880,"LAKEKUN, KOBALIMA, MALAKA, NUSA TENGGARA TIMUR",7,112,24,136
https://kawalpemilu.org#55880,"LAKEKUN, KOBALIMA, MALAKA, NUSA TENGGARA TIMUR",8,88,20,108
https://kawalpemilu.org#55881,"LAKEKUN BARAT, KOBALIMA, MALAKA, NUSA TENGGARA TIMUR",1,84,71,155
https://kawalpemilu.org#55881,"LAKEKUN BARAT, KOBALIMA, MALAKA, NUSA TENGGARA TIMUR",2,182,40,222
https://kawalpemilu.org#55881,"LAKEKUN BARAT, KOBALIMA, MALAKA, NUSA TENGGARA TIMUR",3,108,71,179
https://kawalpemilu.org#55881,"LAKEKUN BARAT, KOBALIMA, MALAKA, NUSA TENGGARA TIMUR",4,137,17,154
https://kawalpemilu.org#55881,"LAKEKUN BARAT, KOBALIMA, MALAKA, NUSA TENGGARA TIMUR",5,140,9,149
https://kawalpemilu.org#55881,"LAKEKUN BARAT, KOBALIMA, MALAKA, NUSA TENGGARA TIMUR",6,196,16,212
https://kawalpemilu.org#55881,"LAKEKUN BARAT, KOBALIMA, MALAKA, NUSA TENGGARA TIMUR",7,92,36,128
https://kawalpemilu.org#55881,"LAKEKUN BARAT, KOBALIMA, MALAKA, NUSA TENGGARA TIMUR",8,92,17,109
https://kawalpemilu.org#55881,"LAKEKUN BARAT, KOBALIMA, MALAKA, NUSA TENGGARA TIMUR",9,104,33,137
https://kawalpemilu.org#55881,"LAKEKUN BARAT, KOBALIMA, MALAKA, NUSA TENGGARA TIMUR",10,128,19,147
https://kawalpemilu.org#55883,"BARENE, MALAKA TENGAH, MALAKA, NUSA TENGGARA TIMUR",1,137,5,142
https://kawalpemilu.org#55883,"BARENE, MALAKA TENGAH, MALAKA, NUSA TENGGARA TIMUR",2,164,31,195
https://kawalpemilu.org#55883,"BARENE, MALAKA TENGAH, MALAKA, NUSA TENGGARA TIMUR",3,95,5,100
https://kawalpemilu.org#55883,"BARENE, MALAKA TENGAH, MALAKA, NUSA TENGGARA TIMUR",4,153,7,160
https://kawalpemilu.org#55883,"BARENE, MALAKA TENGAH, MALAKA, NUSA TENGGARA TIMUR",5,85,13,98
https://kawalpemilu.org#55884,"KAKANIUK, MALAKA TENGAH, MALAKA, NUSA TENGGARA TIMUR",1,163,17,180
https://kawalpemilu.org#55884,"KAKANIUK, MALAKA TENGAH, MALAKA, NUSA TENGGARA TIMUR",2,166,8,174
https://kawalpemilu.org#55884,"KAKANIUK, MALAKA TENGAH, MALAKA, NUSA TENGGARA TIMUR",3,144,14,158
https://kawalpemilu.org#55884,"KAKANIUK, MALAKA TENGAH, MALAKA, NUSA TENGGARA TIMUR",4,116,9,125
https://kawalpemilu.org#55884,"KAKANIUK, MALAKA TENGAH, MALAKA, NUSA TENGGARA TIMUR",5,93,6,99
https://kawalpemilu.org#55884,"KAKANIUK, MALAKA TENGAH, MALAKA, NUSA TENGGARA TIMUR",6,94,9,103
https://kawalpemilu.org#55885,"KATERI, MALAKA TENGAH, MALAKA, NUSA TENGGARA TIMUR",1,170,17,187
https://kawalpemilu.org#55885,"KATERI, MALAKA TENGAH, MALAKA, NUSA TENGGARA TIMUR",2,137,8,145
https://kawalpemilu.org#55885,"KATERI, MALAKA TENGAH, MALAKA, NUSA TENGGARA TIMUR",3,133,4,137
https://kawalpemilu.org#55885,"KATERI, MALAKA TENGAH, MALAKA, NUSA TENGGARA TIMUR",4,126,8,134
https://kawalpemilu.org#55885,"KATERI, MALAKA TENGAH, MALAKA, NUSA TENGGARA TIMUR",5,164,1,165
https://kawalpemilu.org#55886,"BAKIRUK, MALAKA TENGAH, MALAKA, NUSA TENGGARA TIMUR",1,158,9,167
https://kawalpemilu.org#55886,"BAKIRUK, MALAKA TENGAH, MALAKA, NUSA TENGGARA TIMUR",2,150,12,162
https://kawalpemilu.org#55886,"BAKIRUK, MALAKA TENGAH, MALAKA, NUSA TENGGARA TIMUR",3,145,10,155
https://kawalpemilu.org#55886,"BAKIRUK, MALAKA TENGAH, MALAKA, NUSA TENGGARA TIMUR",4,166,9,175
https://kawalpemilu.org#55886,"BAKIRUK, MALAKA TENGAH, MALAKA, NUSA TENGGARA TIMUR",5,169,7,176
https://kawalpemilu.org#55886,"BAKIRUK, MALAKA TENGAH, MALAKA, NUSA TENGGARA TIMUR",6,164,2,166
https://kawalpemilu.org#55886,"BAKIRUK, MALAKA TENGAH, MALAKA, NUSA TENGGARA TIMUR",7,120,9,129
https://kawalpemilu.org#55886,"BAKIRUK, MALAKA TENGAH, MALAKA, NUSA TENGGARA TIMUR",8,129,13,142
https://kawalpemilu.org#55886,"BAKIRUK, MALAKA TENGAH, MALAKA, NUSA TENGGARA TIMUR",9,164,1,165
https://kawalpemilu.org#55887,"KAMANASA, MALAKA TENGAH, MALAKA, NUSA TENGGARA TIMUR",1,161,67,228
https://kawalpemilu.org#55887,"KAMANASA, MALAKA TENGAH, MALAKA, NUSA TENGGARA TIMUR",2,170,42,212
https://kawalpemilu.org#55887,"KAMANASA, MALAKA TENGAH, MALAKA, NUSA TENGGARA TIMUR",3,95,101,196
https://kawalpemilu.org#55887,"KAMANASA, MALAKA TENGAH, MALAKA, NUSA TENGGARA TIMUR",4,218,15,233
https://kawalpemilu.org#55887,"KAMANASA, MALAKA TENGAH, MALAKA, NUSA TENGGARA TIMUR",5,152,10,162
https://kawalpemilu.org#55887,"KAMANASA, MALAKA TENGAH, MALAKA, NUSA TENGGARA TIMUR",6,187,36,223
https://kawalpemilu.org#55887,"KAMANASA, MALAKA TENGAH, MALAKA, NUSA TENGGARA TIMUR",7,94,29,123
https://kawalpemilu.org#55887,"KAMANASA, MALAKA TENGAH, MALAKA, NUSA TENGGARA TIMUR",8,55,129,184
https://kawalpemilu.org#55887,"KAMANASA, MALAKA TENGAH, MALAKA, NUSA TENGGARA TIMUR",9,57,86,143
https://kawalpemilu.org#55887,"KAMANASA, MALAKA TENGAH, MALAKA, NUSA TENGGARA TIMUR",10,34,66,100
https://kawalpemilu.org#55887,"KAMANASA, MALAKA TENGAH, MALAKA, NUSA TENGGARA TIMUR",11,42,65,107
https://kawalpemilu.org#55887,"KAMANASA, MALAKA TENGAH, MALAKA, NUSA TENGGARA TIMUR",12,187,15,202
https://kawalpemilu.org#55887,"KAMANASA, MALAKA TENGAH, MALAKA, NUSA TENGGARA TIMUR",13,125,12,137
https://kawalpemilu.org#55887,"KAMANASA, MALAKA TENGAH, MALAKA, NUSA TENGGARA TIMUR",14,79,24,103
https://kawalpemilu.org#55887,"KAMANASA, MALAKA TENGAH, MALAKA, NUSA TENGGARA TIMUR",15,32,68,100
https://kawalpemilu.org#55887,"KAMANASA, MALAKA TENGAH, MALAKA, NUSA TENGGARA TIMUR",16,41,69,110
https://kawalpemilu.org#55888,"WEHALI, MALAKA TENGAH, MALAKA, NUSA TENGGARA TIMUR",1,194,27,221
https://kawalpemilu.org#55888,"WEHALI, MALAKA TENGAH, MALAKA, NUSA TENGGARA TIMUR",2,202,21,223
https://kawalpemilu.org#55888,"WEHALI, MALAKA TENGAH, MALAKA, NUSA TENGGARA TIMUR",3,125,10,135
https://kawalpemilu.org#55888,"WEHALI, MALAKA TENGAH, MALAKA, NUSA TENGGARA TIMUR",4,106,20,126
https://kawalpemilu.org#55888,"WEHALI, MALAKA TENGAH, MALAKA, NUSA TENGGARA TIMUR",5,151,36,187
https://kawalpemilu.org#55888,"WEHALI, MALAKA TENGAH, MALAKA, NUSA TENGGARA TIMUR",6,110,20,130
https://kawalpemilu.org#55888,"WEHALI, MALAKA TENGAH, MALAKA, NUSA TENGGARA TIMUR",7,114,33,147
https://kawalpemilu.org#55888,"WEHALI, MALAKA TENGAH, MALAKA, NUSA TENGGARA TIMUR",8,98,42,140
https://kawalpemilu.org#55888,"WEHALI, MALAKA TENGAH, MALAKA, NUSA TENGGARA TIMUR",9,115,39,154
https://kawalpemilu.org#55888,"WEHALI, MALAKA TENGAH, MALAKA, NUSA TENGGARA TIMUR",10,83,26,109
https://kawalpemilu.org#55888,"WEHALI, MALAKA TENGAH, MALAKA, NUSA TENGGARA TIMUR",11,142,38,180
https://kawalpemilu.org#55888,"WEHALI, MALAKA TENGAH, MALAKA, NUSA TENGGARA TIMUR",12,100,28,128
https://kawalpemilu.org#55888,"WEHALI, MALAKA TENGAH, MALAKA, NUSA TENGGARA TIMUR",13,109,65,174
https://kawalpemilu.org#55888,"WEHALI, MALAKA TENGAH, MALAKA, NUSA TENGGARA TIMUR",14,91,37,128
https://kawalpemilu.org#55888,"WEHALI, MALAKA TENGAH, MALAKA, NUSA TENGGARA TIMUR",15,116,43,159
https://kawalpemilu.org#55888,"WEHALI, MALAKA TENGAH, MALAKA, NUSA TENGGARA TIMUR",16,75,25,100
https://kawalpemilu.org#55888,"WEHALI, MALAKA TENGAH, MALAKA, NUSA TENGGARA TIMUR",17,54,24,78
https://kawalpemilu.org#55888,"WEHALI, MALAKA TENGAH, MALAKA, NUSA TENGGARA TIMUR",18,132,10,142
https://kawalpemilu.org#55888,"WEHALI, MALAKA TENGAH, MALAKA, NUSA TENGGARA TIMUR",19,82,20,102
https://kawalpemilu.org#55888,"WEHALI, MALAKA TENGAH, MALAKA, NUSA TENGGARA TIMUR",20,59,24,83
https://kawalpemilu.org#55888,"WEHALI, MALAKA TENGAH, MALAKA, NUSA TENGGARA TIMUR",21,83,9,92
https://kawalpemilu.org#55888,"WEHALI, MALAKA TENGAH, MALAKA, NUSA TENGGARA TIMUR",22,80,41,121
https://kawalpemilu.org#55888,"WEHALI, MALAKA TENGAH, MALAKA, NUSA TENGGARA TIMUR",23,69,8,77
https://kawalpemilu.org#55888,"WEHALI, MALAKA TENGAH, MALAKA, NUSA TENGGARA TIMUR",24,46,12,58
https://kawalpemilu.org#55888,"WEHALI, MALAKA TENGAH, MALAKA, NUSA TENGGARA TIMUR",25,49,26,75
https://kawalpemilu.org#55889,"UMAKATAHAN, MALAKA TENGAH, MALAKA, NUSA TENGGARA TIMUR",1,157,32,189
https://kawalpemilu.org#55889,"UMAKATAHAN, MALAKA TENGAH, MALAKA, NUSA TENGGARA TIMUR",2,154,12,166
https://kawalpemilu.org#55889,"UMAKATAHAN, MALAKA TENGAH, MALAKA, NUSA TENGGARA TIMUR",3,179,10,189
https://kawalpemilu.org#55889,"UMAKATAHAN, MALAKA TENGAH, MALAKA, NUSA TENGGARA TIMUR",4,178,13,191
https://kawalpemilu.org#55889,"UMAKATAHAN, MALAKA TENGAH, MALAKA, NUSA TENGGARA TIMUR",5,83,6,89
https://kawalpemilu.org#55889,"UMAKATAHAN, MALAKA TENGAH, MALAKA, NUSA TENGGARA TIMUR",6,170,18,188
https://kawalpemilu.org#55889,"UMAKATAHAN, MALAKA TENGAH, MALAKA, NUSA TENGGARA TIMUR",7,189,17,206
https://kawalpemilu.org#55889,"UMAKATAHAN, MALAKA TENGAH, MALAKA, NUSA TENGGARA TIMUR",8,123,1,124
https://kawalpemilu.org#55890,"UMANEN LAWALU, MALAKA TENGAH, MALAKA, NUSA TENGGARA TIMUR",1,196,8,204
https://kawalpemilu.org#55890,"UMANEN LAWALU, MALAKA TENGAH, MALAKA, NUSA TENGGARA TIMUR",2,162,17,179
https://kawalpemilu.org#55890,"UMANEN LAWALU, MALAKA TENGAH, MALAKA, NUSA TENGGARA TIMUR",3,150,15,165
https://kawalpemilu.org#55890,"UMANEN LAWALU, MALAKA TENGAH, MALAKA, NUSA TENGGARA TIMUR",4,167,10,177
https://kawalpemilu.org#55890,"UMANEN LAWALU, MALAKA TENGAH, MALAKA, NUSA TENGGARA TIMUR",5,158,21,179
https://kawalpemilu.org#55890,"UMANEN LAWALU, MALAKA TENGAH, MALAKA, NUSA TENGGARA TIMUR",6,152,31,183
https://kawalpemilu.org#55890,"UMANEN LAWALU, MALAKA TENGAH, MALAKA, NUSA TENGGARA TIMUR",7,93,6,99
https://kawalpemilu.org#55890,"UMANEN LAWALU, MALAKA TENGAH, MALAKA, NUSA TENGGARA TIMUR",8,108,6,114
https://kawalpemilu.org#55891,"KLETEK, MALAKA TENGAH, MALAKA, NUSA TENGGARA TIMUR",1,104,14,118
https://kawalpemilu.org#55891,"KLETEK, MALAKA TENGAH, MALAKA, NUSA TENGGARA TIMUR",2,127,33,160
https://kawalpemilu.org#55891,"KLETEK, MALAKA TENGAH, MALAKA, NUSA TENGGARA TIMUR",3,165,5,170
https://kawalpemilu.org#55891,"KLETEK, MALAKA TENGAH, MALAKA, NUSA TENGGARA TIMUR",4,151,4,155
https://kawalpemilu.org#55891,"KLETEK, MALAKA TENGAH, MALAKA, NUSA TENGGARA TIMUR",5,178,8,186
https://kawalpemilu.org#55891,"KLETEK, MALAKA TENGAH, MALAKA, NUSA TENGGARA TIMUR",6,143,9,152
https://kawalpemilu.org#55891,"KLETEK, MALAKA TENGAH, MALAKA, NUSA TENGGARA TIMUR",7,147,11,158
https://kawalpemilu.org#55891,"KLETEK, MALAKA TENGAH, MALAKA, NUSA TENGGARA TIMUR",8,75,29,104
https://kawalpemilu.org#55892,"NAIMANA, MALAKA TENGAH, MALAKA, NUSA TENGGARA TIMUR",1,159,10,169
https://kawalpemilu.org#55892,"NAIMANA, MALAKA TENGAH, MALAKA, NUSA TENGGARA TIMUR",2,97,2,99
https://kawalpemilu.org#55892,"NAIMANA, MALAKA TENGAH, MALAKA, NUSA TENGGARA TIMUR",3,155,1,156
https://kawalpemilu.org#55892,"NAIMANA, MALAKA TENGAH, MALAKA, NUSA TENGGARA TIMUR",4,179,4,183
https://kawalpemilu.org#55892,"NAIMANA, MALAKA TENGAH, MALAKA, NUSA TENGGARA TIMUR",5,180,6,186
https://kawalpemilu.org#55892,"NAIMANA, MALAKA TENGAH, MALAKA, NUSA TENGGARA TIMUR",6,155,11,166
https://kawalpemilu.org#55892,"NAIMANA, MALAKA TENGAH, MALAKA, NUSA TENGGARA TIMUR",7,84,39,123
https://kawalpemilu.org#55892,"NAIMANA, MALAKA TENGAH, MALAKA, NUSA TENGGARA TIMUR",8,155,11,166
https://kawalpemilu.org#55893,"FAHILUKA, MALAKA TENGAH, MALAKA, NUSA TENGGARA TIMUR",1,159,0,159
https://kawalpemilu.org#55893,"FAHILUKA, MALAKA TENGAH, MALAKA, NUSA TENGGARA TIMUR",2,124,3,127
https://kawalpemilu.org#55893,"FAHILUKA, MALAKA TENGAH, MALAKA, NUSA TENGGARA TIMUR",3,166,11,177
https://kawalpemilu.org#55893,"FAHILUKA, MALAKA TENGAH, MALAKA, NUSA TENGGARA TIMUR",4,136,9,145
https://kawalpemilu.org#55893,"FAHILUKA, MALAKA TENGAH, MALAKA, NUSA TENGGARA TIMUR",5,130,15,145
https://kawalpemilu.org#55893,"FAHILUKA, MALAKA TENGAH, MALAKA, NUSA TENGGARA TIMUR",6,150,8,158
https://kawalpemilu.org#55893,"FAHILUKA, MALAKA TENGAH, MALAKA, NUSA TENGGARA TIMUR",7,86,3,89
https://kawalpemilu.org#55893,"FAHILUKA, MALAKA TENGAH, MALAKA, NUSA TENGGARA TIMUR",8,146,19,165
https://kawalpemilu.org#55894,"LAWALU, MALAKA TENGAH, MALAKA, NUSA TENGGARA TIMUR",1,158,13,171
https://kawalpemilu.org#55894,"LAWALU, MALAKA TENGAH, MALAKA, NUSA TENGGARA TIMUR",2,151,18,169
https://kawalpemilu.org#55894,"LAWALU, MALAKA TENGAH, MALAKA, NUSA TENGGARA TIMUR",3,126,25,151
https://kawalpemilu.org#55894,"LAWALU, MALAKA TENGAH, MALAKA, NUSA TENGGARA TIMUR",4,159,5,164
https://kawalpemilu.org#55894,"LAWALU, MALAKA TENGAH, MALAKA, NUSA TENGGARA TIMUR",5,149,20,169
https://kawalpemilu.org#55895,"BARADA, MALAKA TENGAH, MALAKA, NUSA TENGGARA TIMUR",1,187,3,190
https://kawalpemilu.org#55895,"BARADA, MALAKA TENGAH, MALAKA, NUSA TENGGARA TIMUR",2,168,7,175
https://kawalpemilu.org#55896,"BERELIKU, MALAKA TENGAH, MALAKA, NUSA TENGGARA TIMUR",1,176,13,189
https://kawalpemilu.org#55896,"BERELIKU, MALAKA TENGAH, MALAKA, NUSA TENGGARA TIMUR",2,84,3,87
https://kawalpemilu.org#55896,"BERELIKU, MALAKA TENGAH, MALAKA, NUSA TENGGARA TIMUR",3,148,9,157
https://kawalpemilu.org#55897,"RAILOR, MALAKA TENGAH, MALAKA, NUSA TENGGARA TIMUR",1,158,14,172
https://kawalpemilu.org#55897,"RAILOR, MALAKA TENGAH, MALAKA, NUSA TENGGARA TIMUR",2,154,13,167
https://kawalpemilu.org#55897,"RAILOR, MALAKA TENGAH, MALAKA, NUSA TENGGARA TIMUR",3,126,13,139
https://kawalpemilu.org#55898,"SUAI, MALAKA TENGAH, MALAKA, NUSA TENGGARA TIMUR",1,174,13,187
https://kawalpemilu.org#55898,"SUAI, MALAKA TENGAH, MALAKA, NUSA TENGGARA TIMUR",2,100,9,109
https://kawalpemilu.org#55898,"SUAI, MALAKA TENGAH, MALAKA, NUSA TENGGARA TIMUR",3,112,13,125
https://kawalpemilu.org#55898,"SUAI, MALAKA TENGAH, MALAKA, NUSA TENGGARA TIMUR",4,106,3,109
https://kawalpemilu.org#55898,"SUAI, MALAKA TENGAH, MALAKA, NUSA TENGGARA TIMUR",5,90,7,97
https://kawalpemilu.org#55899,"HAREKAKAE, MALAKA TENGAH, MALAKA, NUSA TENGGARA TIMUR",1,110,25,135
https://kawalpemilu.org#55899,"HAREKAKAE, MALAKA TENGAH, MALAKA, NUSA TENGGARA TIMUR",2,183,38,221
https://kawalpemilu.org#55899,"HAREKAKAE, MALAKA TENGAH, MALAKA, NUSA TENGGARA TIMUR",3,169,37,206
https://kawalpemilu.org#55899,"HAREKAKAE, MALAKA TENGAH, MALAKA, NUSA TENGGARA TIMUR",4,95,40,135
https://kawalpemilu.org#55899,"HAREKAKAE, MALAKA TENGAH, MALAKA, NUSA TENGGARA TIMUR",5,64,79,143
https://kawalpemilu.org#55899,"HAREKAKAE, MALAKA TENGAH, MALAKA, NUSA TENGGARA TIMUR",6,94,20,114
https://kawalpemilu.org#55901,"AS MANULEA, SASITAMEAN, MALAKA, NUSA TENGGARA TIMUR",1,166,16,182
https://kawalpemilu.org#55901,"AS MANULEA, SASITAMEAN, MALAKA, NUSA TENGGARA TIMUR",2,108,9,117
https://kawalpemilu.org#55901,"AS MANULEA, SASITAMEAN, MALAKA, NUSA TENGGARA TIMUR",3,129,6,135
https://kawalpemilu.org#55902,"MANULEA, SASITAMEAN, MALAKA, NUSA TENGGARA TIMUR",1,164,5,169
https://kawalpemilu.org#55902,"MANULEA, SASITAMEAN, MALAKA, NUSA TENGGARA TIMUR",2,192,13,205
https://kawalpemilu.org#55902,"MANULEA, SASITAMEAN, MALAKA, NUSA TENGGARA TIMUR",3,126,1,127
https://kawalpemilu.org#55902,"MANULEA, SASITAMEAN, MALAKA, NUSA TENGGARA TIMUR",4,194,6,200
https://kawalpemilu.org#55902,"MANULEA, SASITAMEAN, MALAKA, NUSA TENGGARA TIMUR",6,214,9,223
https://kawalpemilu.org#55902,"MANULEA, SASITAMEAN, MALAKA, NUSA TENGGARA TIMUR",7,114,0,114
https://kawalpemilu.org#55903,"NAIBONE, SASITAMEAN, MALAKA, NUSA TENGGARA TIMUR",1,137,2,139
https://kawalpemilu.org#55903,"NAIBONE, SASITAMEAN, MALAKA, NUSA TENGGARA TIMUR",2,156,9,165
https://kawalpemilu.org#55903,"NAIBONE, SASITAMEAN, MALAKA, NUSA TENGGARA TIMUR",3,109,5,114
https://kawalpemilu.org#55904,"FATUARUIN, SASITAMEAN, MALAKA, NUSA TENGGARA TIMUR",1,155,7,162
https://kawalpemilu.org#55904,"FATUARUIN, SASITAMEAN, MALAKA, NUSA TENGGARA TIMUR",2,146,5,151
https://kawalpemilu.org#55904,"FATUARUIN, SASITAMEAN, MALAKA, NUSA TENGGARA TIMUR",3,172,12,184
https://kawalpemilu.org#55905,"BUILARAN, SASITAMEAN, MALAKA, NUSA TENGGARA TIMUR",1,208,6,214
https://kawalpemilu.org#55905,"BUILARAN, SASITAMEAN, MALAKA, NUSA TENGGARA TIMUR",2,167,5,172
https://kawalpemilu.org#55905,"BUILARAN, SASITAMEAN, MALAKA, NUSA TENGGARA TIMUR",3,185,5,190
https://kawalpemilu.org#55906,"MANUMUTIN SILOLE, SASITAMEAN, MALAKA, NUSA TENGGARA TIMUR",1,195,3,198
https://kawalpemilu.org#55907,"UMUTNANA, SASITAMEAN, MALAKA, NUSA TENGGARA TIMUR",1,153,21,174
https://kawalpemilu.org#55907,"UMUTNANA, SASITAMEAN, MALAKA, NUSA TENGGARA TIMUR",2,129,14,143
https://kawalpemilu.org#55908,"BEANENO, SASITAMEAN, MALAKA, NUSA TENGGARA TIMUR",1,183,13,196
https://kawalpemilu.org#55908,"BEANENO, SASITAMEAN, MALAKA, NUSA TENGGARA TIMUR",2,155,22,177
https://kawalpemilu.org#55909,"NAISAU, SASITAMEAN, MALAKA, NUSA TENGGARA TIMUR",1,199,8,207
https://kawalpemilu.org#55911,"MOTAULUN, MALAKA BARAT, MALAKA, NUSA TENGGARA TIMUR",1,105,9,114
https://kawalpemilu.org#55911,"MOTAULUN, MALAKA BARAT, MALAKA, NUSA TENGGARA TIMUR",2,111,14,125
https://kawalpemilu.org#55911,"MOTAULUN, MALAKA BARAT, MALAKA, NUSA TENGGARA TIMUR",3,94,9,103
https://kawalpemilu.org#55911,"MOTAULUN, MALAKA BARAT, MALAKA, NUSA TENGGARA TIMUR",4,134,10,144
https://kawalpemilu.org#55911,"MOTAULUN, MALAKA BARAT, MALAKA, NUSA TENGGARA TIMUR",5,107,5,112
https://kawalpemilu.org#55911,"MOTAULUN, MALAKA BARAT, MALAKA, NUSA TENGGARA TIMUR",6,99,13,112
https://kawalpemilu.org#55911,"MOTAULUN, MALAKA BARAT, MALAKA, NUSA TENGGARA TIMUR",7,87,9,96
https://kawalpemilu.org#55912,"SIKUN, MALAKA BARAT, MALAKA, NUSA TENGGARA TIMUR",1,98,11,109
https://kawalpemilu.org#55912,"SIKUN, MALAKA BARAT, MALAKA, NUSA TENGGARA TIMUR",2,99,9,108
https://kawalpemilu.org#55912,"SIKUN, MALAKA BARAT, MALAKA, NUSA TENGGARA TIMUR",3,111,1,112
https://kawalpemilu.org#55912,"SIKUN, MALAKA BARAT, MALAKA, NUSA TENGGARA TIMUR",4,160,13,173
https://kawalpemilu.org#55912,"SIKUN, MALAKA BARAT, MALAKA, NUSA TENGGARA TIMUR",5,58,9,67
https://kawalpemilu.org#55913,"FAFOE, MALAKA BARAT, MALAKA, NUSA TENGGARA TIMUR",1,160,21,181
https://kawalpemilu.org#55913,"FAFOE, MALAKA BARAT, MALAKA, NUSA TENGGARA TIMUR",2,134,18,152
https://kawalpemilu.org#55913,"FAFOE, MALAKA BARAT, MALAKA, NUSA TENGGARA TIMUR",3,159,18,177
https://kawalpemilu.org#55913,"FAFOE, MALAKA BARAT, MALAKA, NUSA TENGGARA TIMUR",4,147,16,163
https://kawalpemilu.org#55913,"FAFOE, MALAKA BARAT, MALAKA, NUSA TENGGARA TIMUR",5,165,5,170
https://kawalpemilu.org#55913,"FAFOE, MALAKA BARAT, MALAKA, NUSA TENGGARA TIMUR",6,124,8,132
https://kawalpemilu.org#55913,"FAFOE, MALAKA BARAT, MALAKA, NUSA TENGGARA TIMUR",7,142,22,164
https://kawalpemilu.org#55914,"LASAEN, MALAKA BARAT, MALAKA, NUSA TENGGARA TIMUR",1,126,10,136
https://kawalpemilu.org#55914,"LASAEN, MALAKA BARAT, MALAKA, NUSA TENGGARA TIMUR",2,146,5,151
https://kawalpemilu.org#55914,"LASAEN, MALAKA BARAT, MALAKA, NUSA TENGGARA TIMUR",3,96,4,100
https://kawalpemilu.org#55914,"LASAEN, MALAKA BARAT, MALAKA, NUSA TENGGARA TIMUR",4,121,6,127
https://kawalpemilu.org#55914,"LASAEN, MALAKA BARAT, MALAKA, NUSA TENGGARA TIMUR",5,83,9,92
https://kawalpemilu.org#55914,"LASAEN, MALAKA BARAT, MALAKA, NUSA TENGGARA TIMUR",6,142,5,147
https://kawalpemilu.org#55914,"LASAEN, MALAKA BARAT, MALAKA, NUSA TENGGARA TIMUR",7,127,8,135
https://kawalpemilu.org#55915,"UMATOOS, MALAKA BARAT, MALAKA, NUSA TENGGARA TIMUR",1,125,13,138
https://kawalpemilu.org#55915,"UMATOOS, MALAKA BARAT, MALAKA, NUSA TENGGARA TIMUR",2,124,9,133
https://kawalpemilu.org#55915,"UMATOOS, MALAKA BARAT, MALAKA, NUSA TENGGARA TIMUR",3,115,11,126
https://kawalpemilu.org#55915,"UMATOOS, MALAKA BARAT, MALAKA, NUSA TENGGARA TIMUR",4,108,9,117
https://kawalpemilu.org#55915,"UMATOOS, MALAKA BARAT, MALAKA, NUSA TENGGARA TIMUR",5,80,6,86
https://kawalpemilu.org#55915,"UMATOOS, MALAKA BARAT, MALAKA, NUSA TENGGARA TIMUR",6,84,11,95
https://kawalpemilu.org#55915,"UMATOOS, MALAKA BARAT, MALAKA, NUSA TENGGARA TIMUR",7,153,10,163
https://kawalpemilu.org#55915,"UMATOOS, MALAKA BARAT, MALAKA, NUSA TENGGARA TIMUR",8,145,21,166
https://kawalpemilu.org#55915,"UMATOOS, MALAKA BARAT, MALAKA, NUSA TENGGARA TIMUR",9,97,6,103
https://kawalpemilu.org#55915,"UMATOOS, MALAKA BARAT, MALAKA, NUSA TENGGARA TIMUR",10,116,6,122
https://kawalpemilu.org#55915,"UMATOOS, MALAKA BARAT, MALAKA, NUSA TENGGARA TIMUR",11,79,20,99
https://kawalpemilu.org#55915,"UMATOOS, MALAKA BARAT, MALAKA, NUSA TENGGARA TIMUR",12,87,8,95
https://kawalpemilu.org#55916,"RABASAHAIN, MALAKA BARAT, MALAKA, NUSA TENGGARA TIMUR",1,157,20,177
https://kawalpemilu.org#55916,"RABASAHAIN, MALAKA BARAT, MALAKA, NUSA TENGGARA TIMUR",2,153,13,166
https://kawalpemilu.org#55916,"RABASAHAIN, MALAKA BARAT, MALAKA, NUSA TENGGARA TIMUR",3,147,26,173
https://kawalpemilu.org#55917,"UMALOR, MALAKA BARAT, MALAKA, NUSA TENGGARA TIMUR",1,72,10,82
https://kawalpemilu.org#55917,"UMALOR, MALAKA BARAT, MALAKA, NUSA TENGGARA TIMUR",2,161,24,185
https://kawalpemilu.org#55917,"UMALOR, MALAKA BARAT, MALAKA, NUSA TENGGARA TIMUR",3,149,18,167
https://kawalpemilu.org#55917,"UMALOR, MALAKA BARAT, MALAKA, NUSA TENGGARA TIMUR",4,117,21,138
https://kawalpemilu.org#55917,"UMALOR, MALAKA BARAT, MALAKA, NUSA TENGGARA TIMUR",5,137,21,158
https://kawalpemilu.org#55917,"UMALOR, MALAKA BARAT, MALAKA, NUSA TENGGARA TIMUR",6,75,8,83
https://kawalpemilu.org#55918,"BESIKAMA, MALAKA BARAT, MALAKA, NUSA TENGGARA TIMUR",1,170,14,184
https://kawalpemilu.org#55918,"BESIKAMA, MALAKA BARAT, MALAKA, NUSA TENGGARA TIMUR",2,141,9,150
https://kawalpemilu.org#55918,"BESIKAMA, MALAKA BARAT, MALAKA, NUSA TENGGARA TIMUR",3,112,2,114
https://kawalpemilu.org#55918,"BESIKAMA, MALAKA BARAT, MALAKA, NUSA TENGGARA TIMUR",4,173,9,182
https://kawalpemilu.org#55918,"BESIKAMA, MALAKA BARAT, MALAKA, NUSA TENGGARA TIMUR",5,139,2,141
https://kawalpemilu.org#55919,"MAKTIHAN, MALAKA BARAT, MALAKA, NUSA TENGGARA TIMUR",1,131,9,140
https://kawalpemilu.org#55919,"MAKTIHAN, MALAKA BARAT, MALAKA, NUSA TENGGARA TIMUR",2,114,11,125
https://kawalpemilu.org#55919,"MAKTIHAN, MALAKA BARAT, MALAKA, NUSA TENGGARA TIMUR",3,143,7,150
https://kawalpemilu.org#55919,"MAKTIHAN, MALAKA BARAT, MALAKA, NUSA TENGGARA TIMUR",4,134,2,136
https://kawalpemilu.org#55919,"MAKTIHAN, MALAKA BARAT, MALAKA, NUSA TENGGARA TIMUR",5,111,5,116
https://kawalpemilu.org#55919,"MAKTIHAN, MALAKA BARAT, MALAKA, NUSA TENGGARA TIMUR",6,110,7,117
https://kawalpemilu.org#55920,"LOOFOUN, MALAKA BARAT, MALAKA, NUSA TENGGARA TIMUR",1,135,13,148
https://kawalpemilu.org#55920,"LOOFOUN, MALAKA BARAT, MALAKA, NUSA TENGGARA TIMUR",2,122,8,130
https://kawalpemilu.org#55920,"LOOFOUN, MALAKA BARAT, MALAKA, NUSA TENGGARA TIMUR",3,116,9,125
https://kawalpemilu.org#55921,"RABASA, MALAKA BARAT, MALAKA, NUSA TENGGARA TIMUR",1,144,29,173
https://kawalpemilu.org#55921,"RABASA, MALAKA BARAT, MALAKA, NUSA TENGGARA TIMUR",2,141,4,145
https://kawalpemilu.org#55922,"RAIMATAUS, MALAKA BARAT, MALAKA, NUSA TENGGARA TIMUR",1,103,7,110
https://kawalpemilu.org#55922,"RAIMATAUS, MALAKA BARAT, MALAKA, NUSA TENGGARA TIMUR",2,87,8,95
https://kawalpemilu.org#55922,"RAIMATAUS, MALAKA BARAT, MALAKA, NUSA TENGGARA TIMUR",3,113,5,118
https://kawalpemilu.org#55922,"RAIMATAUS, MALAKA BARAT, MALAKA, NUSA TENGGARA TIMUR",4,102,3,105
https://kawalpemilu.org#55923,"MOTAAIN, MALAKA BARAT, MALAKA, NUSA TENGGARA TIMUR",1,134,2,136
https://kawalpemilu.org#55923,"MOTAAIN, MALAKA BARAT, MALAKA, NUSA TENGGARA TIMUR",2,110,5,115
https://kawalpemilu.org#55923,"MOTAAIN, MALAKA BARAT, MALAKA, NUSA TENGGARA TIMUR",3,86,4,90
https://kawalpemilu.org#55926,"RABASA HAERAIN, MALAKA BARAT, MALAKA, NUSA TENGGARA TIMUR",1,150,16,166
https://kawalpemilu.org#55926,"RABASA HAERAIN, MALAKA BARAT, MALAKA, NUSA TENGGARA TIMUR",2,127,31,158
https://kawalpemilu.org#55926,"RABASA HAERAIN, MALAKA BARAT, MALAKA, NUSA TENGGARA TIMUR",3,102,21,123
https://kawalpemilu.org#55926,"RABASA HAERAIN, MALAKA BARAT, MALAKA, NUSA TENGGARA TIMUR",4,101,13,114
https://kawalpemilu.org#92134,"NAAS, MALAKA BARAT, MALAKA, NUSA TENGGARA TIMUR",1,93,4,97
https://kawalpemilu.org#92134,"NAAS, MALAKA BARAT, MALAKA, NUSA TENGGARA TIMUR",2,94,7,101
https://kawalpemilu.org#92134,"NAAS, MALAKA BARAT, MALAKA, NUSA TENGGARA TIMUR",3,84,6,90
https://kawalpemilu.org#92134,"NAAS, MALAKA BARAT, MALAKA, NUSA TENGGARA TIMUR",4,107,9,116
https://kawalpemilu.org#92134,"NAAS, MALAKA BARAT, MALAKA, NUSA TENGGARA TIMUR",5,104,7,111
https://kawalpemilu.org#92135,"OAN MANE, MALAKA BARAT, MALAKA, NUSA TENGGARA TIMUR",1,117,17,134
https://kawalpemilu.org#92135,"OAN MANE, MALAKA BARAT, MALAKA, NUSA TENGGARA TIMUR",2,103,12,115
https://kawalpemilu.org#92135,"OAN MANE, MALAKA BARAT, MALAKA, NUSA TENGGARA TIMUR",3,116,2,118
https://kawalpemilu.org#92135,"OAN MANE, MALAKA BARAT, MALAKA, NUSA TENGGARA TIMUR",4,118,7,125
https://kawalpemilu.org#92135,"OAN MANE, MALAKA BARAT, MALAKA, NUSA TENGGARA TIMUR",5,87,11,98
https://kawalpemilu.org#55928,"SAENAMA, RINHAT, MALAKA, NUSA TENGGARA TIMUR",1,129,9,138
https://kawalpemilu.org#55928,"SAENAMA, RINHAT, MALAKA, NUSA TENGGARA TIMUR",2,107,10,117
https://kawalpemilu.org#55928,"SAENAMA, RINHAT, MALAKA, NUSA TENGGARA TIMUR",3,105,1,106
https://kawalpemilu.org#55928,"SAENAMA, RINHAT, MALAKA, NUSA TENGGARA TIMUR",4,131,2,133
https://kawalpemilu.org#55929,"WEKMIDAR, RINHAT, MALAKA, NUSA TENGGARA TIMUR",1,180,12,192
https://kawalpemilu.org#55929,"WEKMIDAR, RINHAT, MALAKA, NUSA TENGGARA TIMUR",2,170,4,174
https://kawalpemilu.org#55930,"LOTAS, RINHAT, MALAKA, NUSA TENGGARA TIMUR",1,100,7,107
https://kawalpemilu.org#55930,"LOTAS, RINHAT, MALAKA, NUSA TENGGARA TIMUR",2,111,9,120
https://kawalpemilu.org#55931,"NANIN, RINHAT, MALAKA, NUSA TENGGARA TIMUR",1,149,4,153
https://kawalpemilu.org#55931,"NANIN, RINHAT, MALAKA, NUSA TENGGARA TIMUR",2,162,11,173
https://kawalpemilu.org#55932,"ALALA, RINHAT, MALAKA, NUSA TENGGARA TIMUR",1,174,13,187
https://kawalpemilu.org#55932,"ALALA, RINHAT, MALAKA, NUSA TENGGARA TIMUR",2,85,7,92
https://kawalpemilu.org#55933,"OEKMURAK, RINHAT, MALAKA, NUSA TENGGARA TIMUR",1,224,8,232
https://kawalpemilu.org#55933,"OEKMURAK, RINHAT, MALAKA, NUSA TENGGARA TIMUR",2,116,3,119
https://kawalpemilu.org#55934,"WEBETUN, RINHAT, MALAKA, NUSA TENGGARA TIMUR",1,162,10,172
https://kawalpemilu.org#55934,"WEBETUN, RINHAT, MALAKA, NUSA TENGGARA TIMUR",2,110,6,116
https://kawalpemilu.org#55935,"NAET, RINHAT, MALAKA, NUSA TENGGARA TIMUR",1,110,11,121
https://kawalpemilu.org#55935,"NAET, RINHAT, MALAKA, NUSA TENGGARA TIMUR",2,87,9,96
https://kawalpemilu.org#55935,"NAET, RINHAT, MALAKA, NUSA TENGGARA TIMUR",3,155,26,181
https://kawalpemilu.org#55935,"NAET, RINHAT, MALAKA, NUSA TENGGARA TIMUR",4,106,13,119
https://kawalpemilu.org#55935,"NAET, RINHAT, MALAKA, NUSA TENGGARA TIMUR",5,91,13,104
https://kawalpemilu.org#55936,"BIUDUKFOHO, RINHAT, MALAKA, NUSA TENGGARA TIMUR",1,99,42,141
https://kawalpemilu.org#55936,"BIUDUKFOHO, RINHAT, MALAKA, NUSA TENGGARA TIMUR",2,77,12,89
https://kawalpemilu.org#55936,"BIUDUKFOHO, RINHAT, MALAKA, NUSA TENGGARA TIMUR",3,125,16,141
https://kawalpemilu.org#55936,"BIUDUKFOHO, RINHAT, MALAKA, NUSA TENGGARA TIMUR",4,100,5,105
https://kawalpemilu.org#55936,"BIUDUKFOHO, RINHAT, MALAKA, NUSA TENGGARA TIMUR",5,92,5,97
https://kawalpemilu.org#55937,"NITI, RINHAT, MALAKA, NUSA TENGGARA TIMUR",1,127,9,136
https://kawalpemilu.org#55937,"NITI, RINHAT, MALAKA, NUSA TENGGARA TIMUR",2,92,13,105
https://kawalpemilu.org#55937,"NITI, RINHAT, MALAKA, NUSA TENGGARA TIMUR",3,104,18,122
https://kawalpemilu.org#55938,"TAFULI, RINHAT, MALAKA, NUSA TENGGARA TIMUR",1,110,44,154
https://kawalpemilu.org#55938,"TAFULI, RINHAT, MALAKA, NUSA TENGGARA TIMUR",2,104,19,123
https://kawalpemilu.org#55938,"TAFULI, RINHAT, MALAKA, NUSA TENGGARA TIMUR",3,59,4,63
https://kawalpemilu.org#55939,"BOEN, RINHAT, MALAKA, NUSA TENGGARA TIMUR",1,148,56,204
https://kawalpemilu.org#55939,"BOEN, RINHAT, MALAKA, NUSA TENGGARA TIMUR",2,115,11,126
https://kawalpemilu.org#55940,"WEKEKE, RINHAT, MALAKA, NUSA TENGGARA TIMUR",1,174,10,184
https://kawalpemilu.org#55940,"WEKEKE, RINHAT, MALAKA, NUSA TENGGARA TIMUR",2,148,21,169
https://kawalpemilu.org#55941,"RAISAMANE, RINHAT, MALAKA, NUSA TENGGARA TIMUR",1,158,19,177
https://kawalpemilu.org#55941,"RAISAMANE, RINHAT, MALAKA, NUSA TENGGARA TIMUR",2,149,11,160
https://kawalpemilu.org#55942,"WEAIN, RINHAT, MALAKA, NUSA TENGGARA TIMUR",1,209,5,214
https://kawalpemilu.org#55942,"WEAIN, RINHAT, MALAKA, NUSA TENGGARA TIMUR",2,94,5,99
https://kawalpemilu.org#55943,"NANEBOT, RINHAT, MALAKA, NUSA TENGGARA TIMUR",1,77,12,89
https://kawalpemilu.org#55943,"NANEBOT, RINHAT, MALAKA, NUSA TENGGARA TIMUR",2,94,3,97
https://kawalpemilu.org#55944,"NABUTAEK, RINHAT, MALAKA, NUSA TENGGARA TIMUR",1,149,3,152
https://kawalpemilu.org#55944,"NABUTAEK, RINHAT, MALAKA, NUSA TENGGARA TIMUR",2,96,16,112
https://kawalpemilu.org#55945,"NAIUSU, RINHAT, MALAKA, NUSA TENGGARA TIMUR",1,169,6,175
https://kawalpemilu.org#55946,"MUKE, RINHAT, MALAKA, NUSA TENGGARA TIMUR",1,107,11,118
https://kawalpemilu.org#55946,"MUKE, RINHAT, MALAKA, NUSA TENGGARA TIMUR",2,93,4,97
https://kawalpemilu.org#85127,"TAFULI I, RINHAT, MALAKA, NUSA TENGGARA TIMUR",1,118,21,139
https://kawalpemilu.org#85127,"TAFULI I, RINHAT, MALAKA, NUSA TENGGARA TIMUR",2,97,25,122
https://kawalpemilu.org#55963,"MEOTROY, LAEN MANEN, MALAKA, NUSA TENGGARA TIMUR",1,167,6,173
https://kawalpemilu.org#55963,"MEOTROY, LAEN MANEN, MALAKA, NUSA TENGGARA TIMUR",2,150,9,159
https://kawalpemilu.org#55963,"MEOTROY, LAEN MANEN, MALAKA, NUSA TENGGARA TIMUR",3,151,9,160
https://kawalpemilu.org#55963,"MEOTROY, LAEN MANEN, MALAKA, NUSA TENGGARA TIMUR",4,162,11,173
https://kawalpemilu.org#55963,"MEOTROY, LAEN MANEN, MALAKA, NUSA TENGGARA TIMUR",5,166,7,173
https://kawalpemilu.org#55964,"TESA, LAEN MANEN, MALAKA, NUSA TENGGARA TIMUR",1,186,5,191
https://kawalpemilu.org#55964,"TESA, LAEN MANEN, MALAKA, NUSA TENGGARA TIMUR",2,156,15,171
https://kawalpemilu.org#55964,"TESA, LAEN MANEN, MALAKA, NUSA TENGGARA TIMUR",3,119,9,128
https://kawalpemilu.org#55964,"TESA, LAEN MANEN, MALAKA, NUSA TENGGARA TIMUR",4,163,12,175
https://kawalpemilu.org#55964,"TESA, LAEN MANEN, MALAKA, NUSA TENGGARA TIMUR",5,124,12,136
https://kawalpemilu.org#55964,"TESA, LAEN MANEN, MALAKA, NUSA TENGGARA TIMUR",6,125,0,125
https://kawalpemilu.org#55964,"TESA, LAEN MANEN, MALAKA, NUSA TENGGARA TIMUR",7,73,4,77
https://kawalpemilu.org#55965,"KAPITAN MEO, LAEN MANEN, MALAKA, NUSA TENGGARA TIMUR",1,122,3,125
https://kawalpemilu.org#55965,"KAPITAN MEO, LAEN MANEN, MALAKA, NUSA TENGGARA TIMUR",2,122,3,125
https://kawalpemilu.org#55965,"KAPITAN MEO, LAEN MANEN, MALAKA, NUSA TENGGARA TIMUR",3,122,9,131
https://kawalpemilu.org#55965,"KAPITAN MEO, LAEN MANEN, MALAKA, NUSA TENGGARA TIMUR",4,87,4,91
https://kawalpemilu.org#55965,"KAPITAN MEO, LAEN MANEN, MALAKA, NUSA TENGGARA TIMUR",5,103,8,111
https://kawalpemilu.org#55965,"KAPITAN MEO, LAEN MANEN, MALAKA, NUSA TENGGARA TIMUR",6,126,4,130
https://kawalpemilu.org#55965,"KAPITAN MEO, LAEN MANEN, MALAKA, NUSA TENGGARA TIMUR",7,101,0,101
https://kawalpemilu.org#55966,"TNIUMANU, LAEN MANEN, MALAKA, NUSA TENGGARA TIMUR",1,158,6,164
https://kawalpemilu.org#55966,"TNIUMANU, LAEN MANEN, MALAKA, NUSA TENGGARA TIMUR",2,136,6,142
https://kawalpemilu.org#55966,"TNIUMANU, LAEN MANEN, MALAKA, NUSA TENGGARA TIMUR",3,130,7,137
https://kawalpemilu.org#55966,"TNIUMANU, LAEN MANEN, MALAKA, NUSA TENGGARA TIMUR",4,139,11,150
https://kawalpemilu.org#55966,"TNIUMANU, LAEN MANEN, MALAKA, NUSA TENGGARA TIMUR",5,158,7,165
https://kawalpemilu.org#55967,"UABAU, LAEN MANEN, MALAKA, NUSA TENGGARA TIMUR",1,177,8,185
https://kawalpemilu.org#55967,"UABAU, LAEN MANEN, MALAKA, NUSA TENGGARA TIMUR",2,181,5,186
https://kawalpemilu.org#55967,"UABAU, LAEN MANEN, MALAKA, NUSA TENGGARA TIMUR",3,170,7,177
https://kawalpemilu.org#55968,"BONI BAIS, LAEN MANEN, MALAKA, NUSA TENGGARA TIMUR",1,144,8,152
https://kawalpemilu.org#55968,"BONI BAIS, LAEN MANEN, MALAKA, NUSA TENGGARA TIMUR",2,131,8,139
https://kawalpemilu.org#55968,"BONI BAIS, LAEN MANEN, MALAKA, NUSA TENGGARA TIMUR",3,89,11,100
https://kawalpemilu.org#55968,"BONI BAIS, LAEN MANEN, MALAKA, NUSA TENGGARA TIMUR",4,148,11,159
https://kawalpemilu.org#55968,"BONI BAIS, LAEN MANEN, MALAKA, NUSA TENGGARA TIMUR",5,120,4,124
https://kawalpemilu.org#55968,"BONI BAIS, LAEN MANEN, MALAKA, NUSA TENGGARA TIMUR",6,83,6,89
https://kawalpemilu.org#55968,"BONI BAIS, LAEN MANEN, MALAKA, NUSA TENGGARA TIMUR",7,78,3,81
https://kawalpemilu.org#55969,"NAUKE KUSA, LAEN MANEN, MALAKA, NUSA TENGGARA TIMUR",1,96,3,99
https://kawalpemilu.org#55969,"NAUKE KUSA, LAEN MANEN, MALAKA, NUSA TENGGARA TIMUR",2,77,6,83
https://kawalpemilu.org#55969,"NAUKE KUSA, LAEN MANEN, MALAKA, NUSA TENGGARA TIMUR",3,172,14,186
https://kawalpemilu.org#55969,"NAUKE KUSA, LAEN MANEN, MALAKA, NUSA TENGGARA TIMUR",5,169,0,169
https://kawalpemilu.org#55969,"NAUKE KUSA, LAEN MANEN, MALAKA, NUSA TENGGARA TIMUR",6,78,11,89
https://kawalpemilu.org#55969,"NAUKE KUSA, LAEN MANEN, MALAKA, NUSA TENGGARA TIMUR",7,94,15,109
https://kawalpemilu.org#55970,"BISESMUS, LAEN MANEN, MALAKA, NUSA TENGGARA TIMUR",1,81,20,101
https://kawalpemilu.org#55970,"BISESMUS, LAEN MANEN, MALAKA, NUSA TENGGARA TIMUR",2,142,22,164
https://kawalpemilu.org#55970,"BISESMUS, LAEN MANEN, MALAKA, NUSA TENGGARA TIMUR",3,89,24,113
https://kawalpemilu.org#55971,"OENAEK, LAEN MANEN, MALAKA, NUSA TENGGARA TIMUR",1,133,5,138
https://kawalpemilu.org#55971,"OENAEK, LAEN MANEN, MALAKA, NUSA TENGGARA TIMUR",2,134,17,151
https://kawalpemilu.org#55971,"OENAEK, LAEN MANEN, MALAKA, NUSA TENGGARA TIMUR",3,138,4,142
https://kawalpemilu.org#55973,"HALIBASAR, WEWIKU, MALAKA, NUSA TENGGARA TIMUR",1,114,8,122
https://kawalpemilu.org#55973,"HALIBASAR, WEWIKU, MALAKA, NUSA TENGGARA TIMUR",2,180,17,197
https://kawalpemilu.org#55973,"HALIBASAR, WEWIKU, MALAKA, NUSA TENGGARA TIMUR",3,120,10,130
https://kawalpemilu.org#55973,"HALIBASAR, WEWIKU, MALAKA, NUSA TENGGARA TIMUR",4,99,10,109
https://kawalpemilu.org#55974,"WEULUN, WEWIKU, MALAKA, NUSA TENGGARA TIMUR",1,152,24,176
https://kawalpemilu.org#55974,"WEULUN, WEWIKU, MALAKA, NUSA TENGGARA TIMUR",2,132,55,187
https://kawalpemilu.org#55974,"WEULUN, WEWIKU, MALAKA, NUSA TENGGARA TIMUR",3,153,36,189
https://kawalpemilu.org#55975,"WEBRIAMATA, WEWIKU, MALAKA, NUSA TENGGARA TIMUR",1,168,23,191
https://kawalpemilu.org#55975,"WEBRIAMATA, WEWIKU, MALAKA, NUSA TENGGARA TIMUR",2,102,13,115
https://kawalpemilu.org#55975,"WEBRIAMATA, WEWIKU, MALAKA, NUSA TENGGARA TIMUR",3,165,7,172
https://kawalpemilu.org#55975,"WEBRIAMATA, WEWIKU, MALAKA, NUSA TENGGARA TIMUR",4,105,6,111
https://kawalpemilu.org#55976,"BADARAI, WEWIKU, MALAKA, NUSA TENGGARA TIMUR",1,180,12,192
https://kawalpemilu.org#55976,"BADARAI, WEWIKU, MALAKA, NUSA TENGGARA TIMUR",2,124,4,128
https://kawalpemilu.org#55976,"BADARAI, WEWIKU, MALAKA, NUSA TENGGARA TIMUR",3,139,7,146
https://kawalpemilu.org#55976,"BADARAI, WEWIKU, MALAKA, NUSA TENGGARA TIMUR",4,154,8,162
https://kawalpemilu.org#55976,"BADARAI, WEWIKU, MALAKA, NUSA TENGGARA TIMUR",5,122,7,129
https://kawalpemilu.org#55976,"BADARAI, WEWIKU, MALAKA, NUSA TENGGARA TIMUR",6,101,3,104
https://kawalpemilu.org#55977,"WEOE, WEWIKU, MALAKA, NUSA TENGGARA TIMUR",1,168,13,181
https://kawalpemilu.org#55977,"WEOE, WEWIKU, MALAKA, NUSA TENGGARA TIMUR",2,193,7,200
https://kawalpemilu.org#55977,"WEOE, WEWIKU, MALAKA, NUSA TENGGARA TIMUR",3,162,15,177
https://kawalpemilu.org#55977,"WEOE, WEWIKU, MALAKA, NUSA TENGGARA TIMUR",4,117,5,122
https://kawalpemilu.org#55977,"WEOE, WEWIKU, MALAKA, NUSA TENGGARA TIMUR",5,132,8,140
https://kawalpemilu.org#55977,"WEOE, WEWIKU, MALAKA, NUSA TENGGARA TIMUR",6,124,13,137
https://kawalpemilu.org#55977,"WEOE, WEWIKU, MALAKA, NUSA TENGGARA TIMUR",7,125,13,138
https://kawalpemilu.org#55977,"WEOE, WEWIKU, MALAKA, NUSA TENGGARA TIMUR",8,136,3,139
https://kawalpemilu.org#55977,"WEOE, WEWIKU, MALAKA, NUSA TENGGARA TIMUR",9,121,3,124
https://kawalpemilu.org#55977,"WEOE, WEWIKU, MALAKA, NUSA TENGGARA TIMUR",10,178,13,191
https://kawalpemilu.org#55977,"WEOE, WEWIKU, MALAKA, NUSA TENGGARA TIMUR",11,156,8,164
https://kawalpemilu.org#55977,"WEOE, WEWIKU, MALAKA, NUSA TENGGARA TIMUR",12,90,19,109
https://kawalpemilu.org#55977,"WEOE, WEWIKU, MALAKA, NUSA TENGGARA TIMUR",13,149,10,159
https://kawalpemilu.org#55977,"WEOE, WEWIKU, MALAKA, NUSA TENGGARA TIMUR",14,107,6,113
https://kawalpemilu.org#55977,"WEOE, WEWIKU, MALAKA, NUSA TENGGARA TIMUR",15,117,4,121
https://kawalpemilu.org#55977,"WEOE, WEWIKU, MALAKA, NUSA TENGGARA TIMUR",16,99,6,105
https://kawalpemilu.org#55978,"LOROTOLUS, WEWIKU, MALAKA, NUSA TENGGARA TIMUR",1,184,5,189
https://kawalpemilu.org#55978,"LOROTOLUS, WEWIKU, MALAKA, NUSA TENGGARA TIMUR",2,175,7,182
https://kawalpemilu.org#55978,"LOROTOLUS, WEWIKU, MALAKA, NUSA TENGGARA TIMUR",3,117,7,124
https://kawalpemilu.org#55978,"LOROTOLUS, WEWIKU, MALAKA, NUSA TENGGARA TIMUR",4,144,8,152
https://kawalpemilu.org#55978,"LOROTOLUS, WEWIKU, MALAKA, NUSA TENGGARA TIMUR",5,127,7,134
https://kawalpemilu.org#55979,"SESERAI, WEWIKU, MALAKA, NUSA TENGGARA TIMUR",1,92,6,98
https://kawalpemilu.org#55979,"SESERAI, WEWIKU, MALAKA, NUSA TENGGARA TIMUR",2,167,14,181
https://kawalpemilu.org#55979,"SESERAI, WEWIKU, MALAKA, NUSA TENGGARA TIMUR",3,131,24,155
https://kawalpemilu.org#55979,"SESERAI, WEWIKU, MALAKA, NUSA TENGGARA TIMUR",4,90,10,100
https://kawalpemilu.org#55979,"SESERAI, WEWIKU, MALAKA, NUSA TENGGARA TIMUR",5,114,4,118
https://kawalpemilu.org#55980,"ALKANI, WEWIKU, MALAKA, NUSA TENGGARA TIMUR",1,154,14,168
https://kawalpemilu.org#55980,"ALKANI, WEWIKU, MALAKA, NUSA TENGGARA TIMUR",2,167,21,188
https://kawalpemilu.org#55980,"ALKANI, WEWIKU, MALAKA, NUSA TENGGARA TIMUR",3,173,15,188
https://kawalpemilu.org#55980,"ALKANI, WEWIKU, MALAKA, NUSA TENGGARA TIMUR",4,106,10,116
https://kawalpemilu.org#55980,"ALKANI, WEWIKU, MALAKA, NUSA TENGGARA TIMUR",5,97,11,108
https://kawalpemilu.org#55981,"LAMEA, WEWIKU, MALAKA, NUSA TENGGARA TIMUR",1,105,24,129
https://kawalpemilu.org#55981,"LAMEA, WEWIKU, MALAKA, NUSA TENGGARA TIMUR",2,119,14,133
https://kawalpemilu.org#55981,"LAMEA, WEWIKU, MALAKA, NUSA TENGGARA TIMUR",3,147,21,168
https://kawalpemilu.org#55981,"LAMEA, WEWIKU, MALAKA, NUSA TENGGARA TIMUR",4,107,11,118
https://kawalpemilu.org#55982,"BIRIS, WEWIKU, MALAKA, NUSA TENGGARA TIMUR",1,101,12,113
https://kawalpemilu.org#55982,"BIRIS, WEWIKU, MALAKA, NUSA TENGGARA TIMUR",2,125,4,129
https://kawalpemilu.org#55982,"BIRIS, WEWIKU, MALAKA, NUSA TENGGARA TIMUR",3,92,11,103
https://kawalpemilu.org#55983,"RABASA BIRIS, WEWIKU, MALAKA, NUSA TENGGARA TIMUR",1,128,12,140
https://kawalpemilu.org#55983,"RABASA BIRIS, WEWIKU, MALAKA, NUSA TENGGARA TIMUR",2,141,17,158
https://kawalpemilu.org#55983,"RABASA BIRIS, WEWIKU, MALAKA, NUSA TENGGARA TIMUR",3,78,16,94
https://kawalpemilu.org#55984,"WESEBEN, WEWIKU, MALAKA, NUSA TENGGARA TIMUR",1,194,17,211
https://kawalpemilu.org#55984,"WESEBEN, WEWIKU, MALAKA, NUSA TENGGARA TIMUR",2,148,9,157
https://kawalpemilu.org#55986,"WESEY, WELIMAN, MALAKA, NUSA TENGGARA TIMUR",1,204,5,209
https://kawalpemilu.org#55986,"WESEY, WELIMAN, MALAKA, NUSA TENGGARA TIMUR",2,128,15,143
https://kawalpemilu.org#55987,"HAITIMUK, WELIMAN, MALAKA, NUSA TENGGARA TIMUR",1,154,15,169
https://kawalpemilu.org#55987,"HAITIMUK, WELIMAN, MALAKA, NUSA TENGGARA TIMUR",2,137,9,146
https://kawalpemilu.org#55987,"HAITIMUK, WELIMAN, MALAKA, NUSA TENGGARA TIMUR",3,117,9,126
https://kawalpemilu.org#55987,"HAITIMUK, WELIMAN, MALAKA, NUSA TENGGARA TIMUR",4,134,1,135
https://kawalpemilu.org#55987,"HAITIMUK, WELIMAN, MALAKA, NUSA TENGGARA TIMUR",5,108,1,109
https://kawalpemilu.org#55987,"HAITIMUK, WELIMAN, MALAKA, NUSA TENGGARA TIMUR",6,90,7,97
https://kawalpemilu.org#55987,"HAITIMUK, WELIMAN, MALAKA, NUSA TENGGARA TIMUR",8,72,12,84
https://kawalpemilu.org#55987,"HAITIMUK, WELIMAN, MALAKA, NUSA TENGGARA TIMUR",9,151,10,161
https://kawalpemilu.org#55987,"HAITIMUK, WELIMAN, MALAKA, NUSA TENGGARA TIMUR",10,83,7,90
https://kawalpemilu.org#55987,"HAITIMUK, WELIMAN, MALAKA, NUSA TENGGARA TIMUR",11,111,11,122
https://kawalpemilu.org#55987,"HAITIMUK, WELIMAN, MALAKA, NUSA TENGGARA TIMUR",12,132,12,144
https://kawalpemilu.org#55988,"LALETEN, WELIMAN, MALAKA, NUSA TENGGARA TIMUR",1,122,13,135
https://kawalpemilu.org#55988,"LALETEN, WELIMAN, MALAKA, NUSA TENGGARA TIMUR",2,152,6,158
https://kawalpemilu.org#55988,"LALETEN, WELIMAN, MALAKA, NUSA TENGGARA TIMUR",3,143,8,151
https://kawalpemilu.org#55988,"LALETEN, WELIMAN, MALAKA, NUSA TENGGARA TIMUR",4,137,6,143
https://kawalpemilu.org#55988,"LALETEN, WELIMAN, MALAKA, NUSA TENGGARA TIMUR",5,143,11,154
https://kawalpemilu.org#55988,"LALETEN, WELIMAN, MALAKA, NUSA TENGGARA TIMUR",6,122,5,127
https://kawalpemilu.org#55989,"KLESELEON, WELIMAN, MALAKA, NUSA TENGGARA TIMUR",1,145,5,150
https://kawalpemilu.org#55989,"KLESELEON, WELIMAN, MALAKA, NUSA TENGGARA TIMUR",2,79,9,88
https://kawalpemilu.org#55989,"KLESELEON, WELIMAN, MALAKA, NUSA TENGGARA TIMUR",3,146,8,154
https://kawalpemilu.org#55989,"KLESELEON, WELIMAN, MALAKA, NUSA TENGGARA TIMUR",4,110,8,118
https://kawalpemilu.org#55990,"ANGKAES, WELIMAN, MALAKA, NUSA TENGGARA TIMUR",1,161,13,174
https://kawalpemilu.org#55990,"ANGKAES, WELIMAN, MALAKA, NUSA TENGGARA TIMUR",2,117,11,128
https://kawalpemilu.org#55990,"ANGKAES, WELIMAN, MALAKA, NUSA TENGGARA TIMUR",3,181,12,193
https://kawalpemilu.org#55990,"ANGKAES, WELIMAN, MALAKA, NUSA TENGGARA TIMUR",4,155,19,174
https://kawalpemilu.org#55990,"ANGKAES, WELIMAN, MALAKA, NUSA TENGGARA TIMUR",5,158,8,166
https://kawalpemilu.org#55991,"WEDEROK, WELIMAN, MALAKA, NUSA TENGGARA TIMUR",1,163,7,170
https://kawalpemilu.org#55991,"WEDEROK, WELIMAN, MALAKA, NUSA TENGGARA TIMUR",2,156,2,158
https://kawalpemilu.org#55991,"WEDEROK, WELIMAN, MALAKA, NUSA TENGGARA TIMUR",3,158,12,170
https://kawalpemilu.org#55991,"WEDEROK, WELIMAN, MALAKA, NUSA TENGGARA TIMUR",4,165,18,183
https://kawalpemilu.org#55992,"LAMUDUR, WELIMAN, MALAKA, NUSA TENGGARA TIMUR",1,159,12,171
https://kawalpemilu.org#55992,"LAMUDUR, WELIMAN, MALAKA, NUSA TENGGARA TIMUR",2,128,17,145
https://kawalpemilu.org#55992,"LAMUDUR, WELIMAN, MALAKA, NUSA TENGGARA TIMUR",3,140,12,152
https://kawalpemilu.org#55992,"LAMUDUR, WELIMAN, MALAKA, NUSA TENGGARA TIMUR",4,124,7,131
https://kawalpemilu.org#55993,"FOREKMODOK, WELIMAN, MALAKA, NUSA TENGGARA TIMUR",1,135,7,142
https://kawalpemilu.org#55993,"FOREKMODOK, WELIMAN, MALAKA, NUSA TENGGARA TIMUR",2,118,3,121
https://kawalpemilu.org#55993,"FOREKMODOK, WELIMAN, MALAKA, NUSA TENGGARA TIMUR",3,110,5,115
https://kawalpemilu.org#55993,"FOREKMODOK, WELIMAN, MALAKA, NUSA TENGGARA TIMUR",4,116,7,123
https://kawalpemilu.org#55993,"FOREKMODOK, WELIMAN, MALAKA, NUSA TENGGARA TIMUR",5,86,7,93
https://kawalpemilu.org#55994,"UMALAWAIN, WELIMAN, MALAKA, NUSA TENGGARA TIMUR",1,138,2,140
https://kawalpemilu.org#55994,"UMALAWAIN, WELIMAN, MALAKA, NUSA TENGGARA TIMUR",2,136,7,143
https://kawalpemilu.org#55994,"UMALAWAIN, WELIMAN, MALAKA, NUSA TENGGARA TIMUR",3,153,2,155
https://kawalpemilu.org#55994,"UMALAWAIN, WELIMAN, MALAKA, NUSA TENGGARA TIMUR",4,133,1,134
https://kawalpemilu.org#55994,"UMALAWAIN, WELIMAN, MALAKA, NUSA TENGGARA TIMUR",5,135,3,138
https://kawalpemilu.org#55995,"LAKULO, WELIMAN, MALAKA, NUSA TENGGARA TIMUR",1,134,12,146
https://kawalpemilu.org#55995,"LAKULO, WELIMAN, MALAKA, NUSA TENGGARA TIMUR",2,140,8,148
https://kawalpemilu.org#55995,"LAKULO, WELIMAN, MALAKA, NUSA TENGGARA TIMUR",3,120,6,126
https://kawalpemilu.org#55995,"LAKULO, WELIMAN, MALAKA, NUSA TENGGARA TIMUR",4,127,6,133
https://kawalpemilu.org#55995,"LAKULO, WELIMAN, MALAKA, NUSA TENGGARA TIMUR",5,140,13,153
https://kawalpemilu.org#55995,"LAKULO, WELIMAN, MALAKA, NUSA TENGGARA TIMUR",6,170,5,175
https://kawalpemilu.org#55995,"LAKULO, WELIMAN, MALAKA, NUSA TENGGARA TIMUR",7,170,5,175
https://kawalpemilu.org#55996,"LEUNKLOT, WELIMAN, MALAKA, NUSA TENGGARA TIMUR",1,156,10,166
https://kawalpemilu.org#55996,"LEUNKLOT, WELIMAN, MALAKA, NUSA TENGGARA TIMUR",2,191,2,193
https://kawalpemilu.org#55996,"LEUNKLOT, WELIMAN, MALAKA, NUSA TENGGARA TIMUR",3,144,14,158
https://kawalpemilu.org#55997,"BONE TASEA, WELIMAN, MALAKA, NUSA TENGGARA TIMUR",1,182,14,196
https://kawalpemilu.org#55997,"BONE TASEA, WELIMAN, MALAKA, NUSA TENGGARA TIMUR",2,167,14,181
https://kawalpemilu.org#55997,"BONE TASEA, WELIMAN, MALAKA, NUSA TENGGARA TIMUR",3,100,7,107
https://kawalpemilu.org#55998,"HALIKLARAN, WELIMAN, MALAKA, NUSA TENGGARA TIMUR",1,177,10,187
https://kawalpemilu.org#55998,"HALIKLARAN, WELIMAN, MALAKA, NUSA TENGGARA TIMUR",2,174,3,177
https://kawalpemilu.org#55998,"HALIKLARAN, WELIMAN, MALAKA, NUSA TENGGARA TIMUR",3,212,1,213
https://kawalpemilu.org#55998,"HALIKLARAN, WELIMAN, MALAKA, NUSA TENGGARA TIMUR",4,199,3,202
https://kawalpemilu.org#55999,"TAABA, WELIMAN, MALAKA, NUSA TENGGARA TIMUR",1,194,7,201
https://kawalpemilu.org#55999,"TAABA, WELIMAN, MALAKA, NUSA TENGGARA TIMUR",2,154,9,163
https://kawalpemilu.org#56018,"BIAU, IO KUFEU, MALAKA, NUSA TENGGARA TIMUR",1,135,9,144
https://kawalpemilu.org#56018,"BIAU, IO KUFEU, MALAKA, NUSA TENGGARA TIMUR",2,165,1,166
https://kawalpemilu.org#56018,"BIAU, IO KUFEU, MALAKA, NUSA TENGGARA TIMUR",3,122,4,126
https://kawalpemilu.org#56019,"KUFEU, IO KUFEU, MALAKA, NUSA TENGGARA TIMUR",1,137,9,146
https://kawalpemilu.org#56019,"KUFEU, IO KUFEU, MALAKA, NUSA TENGGARA TIMUR",2,122,9,131
https://kawalpemilu.org#56019,"KUFEU, IO KUFEU, MALAKA, NUSA TENGGARA TIMUR",3,104,11,115
https://kawalpemilu.org#56019,"KUFEU, IO KUFEU, MALAKA, NUSA TENGGARA TIMUR",4,108,4,112
https://kawalpemilu.org#56020,"TUNMAT, IO KUFEU, MALAKA, NUSA TENGGARA TIMUR",1,95,5,100
https://kawalpemilu.org#56020,"TUNMAT, IO KUFEU, MALAKA, NUSA TENGGARA TIMUR",2,95,7,102
https://kawalpemilu.org#56020,"TUNMAT, IO KUFEU, MALAKA, NUSA TENGGARA TIMUR",3,106,0,106
https://kawalpemilu.org#56020,"TUNMAT, IO KUFEU, MALAKA, NUSA TENGGARA TIMUR",4,103,2,105
https://kawalpemilu.org#56020,"TUNMAT, IO KUFEU, MALAKA, NUSA TENGGARA TIMUR",5,107,8,115
https://kawalpemilu.org#56020,"TUNMAT, IO KUFEU, MALAKA, NUSA TENGGARA TIMUR",6,107,5,112
https://kawalpemilu.org#56021,"TUNABESI, IO KUFEU, MALAKA, NUSA TENGGARA TIMUR",1,172,5,177
https://kawalpemilu.org#56021,"TUNABESI, IO KUFEU, MALAKA, NUSA TENGGARA TIMUR",2,83,1,84
https://kawalpemilu.org#56021,"TUNABESI, IO KUFEU, MALAKA, NUSA TENGGARA TIMUR",3,92,4,96
https://kawalpemilu.org#56021,"TUNABESI, IO KUFEU, MALAKA, NUSA TENGGARA TIMUR",4,128,14,142
https://kawalpemilu.org#56021,"TUNABESI, IO KUFEU, MALAKA, NUSA TENGGARA TIMUR",5,182,9,191
https://kawalpemilu.org#56021,"TUNABESI, IO KUFEU, MALAKA, NUSA TENGGARA TIMUR",6,153,13,166
https://kawalpemilu.org#56021,"TUNABESI, IO KUFEU, MALAKA, NUSA TENGGARA TIMUR",7,157,7,164
https://kawalpemilu.org#56021,"TUNABESI, IO KUFEU, MALAKA, NUSA TENGGARA TIMUR",8,131,14,145
https://kawalpemilu.org#56022,"BANI-BANI, IO KUFEU, MALAKA, NUSA TENGGARA TIMUR",1,121,7,128
https://kawalpemilu.org#56022,"BANI-BANI, IO KUFEU, MALAKA, NUSA TENGGARA TIMUR",2,164,6,170
https://kawalpemilu.org#56022,"BANI-BANI, IO KUFEU, MALAKA, NUSA TENGGARA TIMUR",3,110,9,119
https://kawalpemilu.org#56023,"FATOIN, IO KUFEU, MALAKA, NUSA TENGGARA TIMUR",1,167,15,182
https://kawalpemilu.org#56023,"FATOIN, IO KUFEU, MALAKA, NUSA TENGGARA TIMUR",2,125,9,134
https://kawalpemilu.org#56024,"IKAN TUANBEIS, IO KUFEU, MALAKA, NUSA TENGGARA TIMUR",1,133,8,141
https://kawalpemilu.org#56024,"IKAN TUANBEIS, IO KUFEU, MALAKA, NUSA TENGGARA TIMUR",2,125,15,140
https://kawalpemilu.org#56024,"IKAN TUANBEIS, IO KUFEU, MALAKA, NUSA TENGGARA TIMUR",3,121,13,134
https://kawalpemilu.org#56024,"IKAN TUANBEIS, IO KUFEU, MALAKA, NUSA TENGGARA TIMUR",4,124,15,139
https://kawalpemilu.org#56026,"BABOTIN, BOTIN LEO BELE, MALAKA, NUSA TENGGARA TIMUR",1,238,8,246
https://kawalpemilu.org#56026,"BABOTIN, BOTIN LEO BELE, MALAKA, NUSA TENGGARA TIMUR",2,218,5,223
https://kawalpemilu.org#56026,"BABOTIN, BOTIN LEO BELE, MALAKA, NUSA TENGGARA TIMUR",3,148,13,161
https://kawalpemilu.org#56027,"KEREANA, BOTIN LEO BELE, MALAKA, NUSA TENGGARA TIMUR",1,195,15,210
https://kawalpemilu.org#56027,"KEREANA, BOTIN LEO BELE, MALAKA, NUSA TENGGARA TIMUR",2,77,24,101
https://kawalpemilu.org#56027,"KEREANA, BOTIN LEO BELE, MALAKA, NUSA TENGGARA TIMUR",3,111,6,117
https://kawalpemilu.org#56027,"KEREANA, BOTIN LEO BELE, MALAKA, NUSA TENGGARA TIMUR",4,153,3,156
https://kawalpemilu.org#56027,"KEREANA, BOTIN LEO BELE, MALAKA, NUSA TENGGARA TIMUR",5,25,83,108
https://kawalpemilu.org#56027,"KEREANA, BOTIN LEO BELE, MALAKA, NUSA TENGGARA TIMUR",6,72,3,75
https://kawalpemilu.org#56027,"KEREANA, BOTIN LEO BELE, MALAKA, NUSA TENGGARA TIMUR",7,76,8,84
https://kawalpemilu.org#56027,"KEREANA, BOTIN LEO BELE, MALAKA, NUSA TENGGARA TIMUR",8,59,41,100
https://kawalpemilu.org#56028,"BABOTIN MAEMINA, BOTIN LEO BELE, MALAKA, NUSA TENGGARA TIMUR",1,132,9,141
https://kawalpemilu.org#56028,"BABOTIN MAEMINA, BOTIN LEO BELE, MALAKA, NUSA TENGGARA TIMUR",2,211,19,230
https://kawalpemilu.org#56029,"BABOTIN SELATAN, BOTIN LEO BELE, MALAKA, NUSA TENGGARA TIMUR",1,198,23,221
https://kawalpemilu.org#56030,"TAKARAI, BOTIN LEO BELE, MALAKA, NUSA TENGGARA TIMUR",1,198,14,212
https://kawalpemilu.org#56030,"TAKARAI, BOTIN LEO BELE, MALAKA, NUSA TENGGARA TIMUR",2,71,3,74
https://kawalpemilu.org#56047,"ALAS UTARA, KOBALIMA TIMUR, MALAKA, NUSA TENGGARA TIMUR",1,99,11,110
https://kawalpemilu.org#56047,"ALAS UTARA, KOBALIMA TIMUR, MALAKA, NUSA TENGGARA TIMUR",2,71,6,77
https://kawalpemilu.org#56047,"ALAS UTARA, KOBALIMA TIMUR, MALAKA, NUSA TENGGARA TIMUR",3,140,12,152
https://kawalpemilu.org#56047,"ALAS UTARA, KOBALIMA TIMUR, MALAKA, NUSA TENGGARA TIMUR",4,68,4,72
https://kawalpemilu.org#56047,"ALAS UTARA, KOBALIMA TIMUR, MALAKA, NUSA TENGGARA TIMUR",5,69,5,74
https://kawalpemilu.org#56048,"KOTA BIRU, KOBALIMA TIMUR, MALAKA, NUSA TENGGARA TIMUR",1,133,36,169
https://kawalpemilu.org#56048,"KOTA BIRU, KOBALIMA TIMUR, MALAKA, NUSA TENGGARA TIMUR",2,107,7,114
https://kawalpemilu.org#56048,"KOTA BIRU, KOBALIMA TIMUR, MALAKA, NUSA TENGGARA TIMUR",3,80,8,88
https://kawalpemilu.org#56048,"KOTA BIRU, KOBALIMA TIMUR, MALAKA, NUSA TENGGARA TIMUR",4,106,8,114
https://kawalpemilu.org#56048,"KOTA BIRU, KOBALIMA TIMUR, MALAKA, NUSA TENGGARA TIMUR",5,95,8,103
https://kawalpemilu.org#56049,"ALAS, KOBALIMA TIMUR, MALAKA, NUSA TENGGARA TIMUR",1,163,6,169
https://kawalpemilu.org#56049,"ALAS, KOBALIMA TIMUR, MALAKA, NUSA TENGGARA TIMUR",2,114,10,124
https://kawalpemilu.org#56049,"ALAS, KOBALIMA TIMUR, MALAKA, NUSA TENGGARA TIMUR",3,115,24,139
https://kawalpemilu.org#56049,"ALAS, KOBALIMA TIMUR, MALAKA, NUSA TENGGARA TIMUR",4,155,9,164
https://kawalpemilu.org#56049,"ALAS, KOBALIMA TIMUR, MALAKA, NUSA TENGGARA TIMUR",5,92,12,104
https://kawalpemilu.org#56049,"ALAS, KOBALIMA TIMUR, MALAKA, NUSA TENGGARA TIMUR",6,84,4,88
https://kawalpemilu.org#56050,"ALAS SELATAN, KOBALIMA TIMUR, MALAKA, NUSA TENGGARA TIMUR",1,81,12,93
https://kawalpemilu.org#56050,"ALAS SELATAN, KOBALIMA TIMUR, MALAKA, NUSA TENGGARA TIMUR",2,91,10,101
https://kawalpemilu.org#56050,"ALAS SELATAN, KOBALIMA TIMUR, MALAKA, NUSA TENGGARA TIMUR",3,86,4,90
https://kawalpemilu.org#56050,"ALAS SELATAN, KOBALIMA TIMUR, MALAKA, NUSA TENGGARA TIMUR",4,97,10,107
https://kawalpemilu.org#56050,"ALAS SELATAN, KOBALIMA TIMUR, MALAKA, NUSA TENGGARA TIMUR",5,154,15,169
https://kawalpemilu.org#56050,"ALAS SELATAN, KOBALIMA TIMUR, MALAKA, NUSA TENGGARA TIMUR",6,94,8,102
https://kawalpemilu.org#56050,"ALAS SELATAN, KOBALIMA TIMUR, MALAKA, NUSA TENGGARA TIMUR",7,105,7,112
https://kawalpemilu.org#56050,"ALAS SELATAN, KOBALIMA TIMUR, MALAKA, NUSA TENGGARA TIMUR",8,101,4,105
https://kawalpemilu.org#56050,"ALAS SELATAN, KOBALIMA TIMUR, MALAKA, NUSA TENGGARA TIMUR",9,113,4,117
https://kawalpemilu.org#56050,"ALAS SELATAN, KOBALIMA TIMUR, MALAKA, NUSA TENGGARA TIMUR",10,132,18,150
https://kawalpemilu.org#56050,"ALAS SELATAN, KOBALIMA TIMUR, MALAKA, NUSA TENGGARA TIMUR",11,78,48,126
https://kawalpemilu.org#56050,"ALAS SELATAN, KOBALIMA TIMUR, MALAKA, NUSA TENGGARA TIMUR",12,127,30,157
