Link KawalPemilu,Nama Kelurahan,Nomor TPS,Suara 01,Suara 02,Suara Sah
https://kawalpemilu.org#67396,"SIDONDO II, SIGI BIROMARU, SIGI, SULAWESI TENGAH",1,61,136,197
https://kawalpemilu.org#67396,"SIDONDO II, SIGI BIROMARU, SIGI, SULAWESI TENGAH",2,63,93,156
https://kawalpemilu.org#67396,"SIDONDO II, SIGI BIROMARU, SIGI, SULAWESI TENGAH",3,46,149,195
https://kawalpemilu.org#67397,"SIDONDO I, SIGI BIROMARU, SIGI, SULAWESI TENGAH",1,83,90,173
https://kawalpemilu.org#67397,"SIDONDO I, SIGI BIROMARU, SIGI, SULAWESI TENGAH",2,65,99,164
https://kawalpemilu.org#67397,"SIDONDO I, SIGI BIROMARU, SIGI, SULAWESI TENGAH",3,105,110,215
https://kawalpemilu.org#67397,"SIDONDO I, SIGI BIROMARU, SIGI, SULAWESI TENGAH",4,121,104,225
https://kawalpemilu.org#67397,"SIDONDO I, SIGI BIROMARU, SIGI, SULAWESI TENGAH",5,48,75,123
https://kawalpemilu.org#67397,"SIDONDO I, SIGI BIROMARU, SIGI, SULAWESI TENGAH",6,52,82,134
https://kawalpemilu.org#67397,"SIDONDO I, SIGI BIROMARU, SIGI, SULAWESI TENGAH",7,88,72,160
https://kawalpemilu.org#67397,"SIDONDO I, SIGI BIROMARU, SIGI, SULAWESI TENGAH",8,35,74,109
https://kawalpemilu.org#67397,"SIDONDO I, SIGI BIROMARU, SIGI, SULAWESI TENGAH",9,54,101,155
https://kawalpemilu.org#67397,"SIDONDO I, SIGI BIROMARU, SIGI, SULAWESI TENGAH",10,68,99,167
https://kawalpemilu.org#67397,"SIDONDO I, SIGI BIROMARU, SIGI, SULAWESI TENGAH",11,75,54,129
https://kawalpemilu.org#67397,"SIDONDO I, SIGI BIROMARU, SIGI, SULAWESI TENGAH",12,74,47,121
https://kawalpemilu.org#67398,"BORA, SIGI BIROMARU, SIGI, SULAWESI TENGAH",1,96,155,251
https://kawalpemilu.org#67398,"BORA, SIGI BIROMARU, SIGI, SULAWESI TENGAH",2,90,136,226
https://kawalpemilu.org#67398,"BORA, SIGI BIROMARU, SIGI, SULAWESI TENGAH",3,26,102,128
https://kawalpemilu.org#67398,"BORA, SIGI BIROMARU, SIGI, SULAWESI TENGAH",4,37,128,165
https://kawalpemilu.org#67398,"BORA, SIGI BIROMARU, SIGI, SULAWESI TENGAH",5,69,161,230
https://kawalpemilu.org#67398,"BORA, SIGI BIROMARU, SIGI, SULAWESI TENGAH",6,70,142,212
https://kawalpemilu.org#67398,"BORA, SIGI BIROMARU, SIGI, SULAWESI TENGAH",7,53,164,217
https://kawalpemilu.org#67399,"WATUNONJU, SIGI BIROMARU, SIGI, SULAWESI TENGAH",1,77,116,193
https://kawalpemilu.org#67399,"WATUNONJU, SIGI BIROMARU, SIGI, SULAWESI TENGAH",2,45,93,138
https://kawalpemilu.org#67399,"WATUNONJU, SIGI BIROMARU, SIGI, SULAWESI TENGAH",3,45,141,186
https://kawalpemilu.org#67399,"WATUNONJU, SIGI BIROMARU, SIGI, SULAWESI TENGAH",4,43,106,149
https://kawalpemilu.org#67399,"WATUNONJU, SIGI BIROMARU, SIGI, SULAWESI TENGAH",5,33,92,125
https://kawalpemilu.org#67399,"WATUNONJU, SIGI BIROMARU, SIGI, SULAWESI TENGAH",6,33,96,129
https://kawalpemilu.org#67400,"OLOBUJU, SIGI BIROMARU, SIGI, SULAWESI TENGAH",1,40,105,145
https://kawalpemilu.org#67400,"OLOBUJU, SIGI BIROMARU, SIGI, SULAWESI TENGAH",2,27,119,146
https://kawalpemilu.org#67400,"OLOBUJU, SIGI BIROMARU, SIGI, SULAWESI TENGAH",3,49,143,192
https://kawalpemilu.org#67400,"OLOBUJU, SIGI BIROMARU, SIGI, SULAWESI TENGAH",4,59,147,206
https://kawalpemilu.org#67400,"OLOBUJU, SIGI BIROMARU, SIGI, SULAWESI TENGAH",5,104,65,169
https://kawalpemilu.org#67400,"OLOBUJU, SIGI BIROMARU, SIGI, SULAWESI TENGAH",6,80,52,132
https://kawalpemilu.org#67401,"SOULOWE, SIGI BIROMARU, SIGI, SULAWESI TENGAH",1,90,82,172
https://kawalpemilu.org#67401,"SOULOWE, SIGI BIROMARU, SIGI, SULAWESI TENGAH",2,79,100,179
https://kawalpemilu.org#67401,"SOULOWE, SIGI BIROMARU, SIGI, SULAWESI TENGAH",3,73,86,159
https://kawalpemilu.org#67401,"SOULOWE, SIGI BIROMARU, SIGI, SULAWESI TENGAH",4,90,73,163
https://kawalpemilu.org#67402,"SIDERA, SIGI BIROMARU, SIGI, SULAWESI TENGAH",1,52,188,240
https://kawalpemilu.org#67402,"SIDERA, SIGI BIROMARU, SIGI, SULAWESI TENGAH",2,27,100,127
https://kawalpemilu.org#67402,"SIDERA, SIGI BIROMARU, SIGI, SULAWESI TENGAH",3,57,117,174
https://kawalpemilu.org#67402,"SIDERA, SIGI BIROMARU, SIGI, SULAWESI TENGAH",4,51,62,113
https://kawalpemilu.org#67402,"SIDERA, SIGI BIROMARU, SIGI, SULAWESI TENGAH",5,46,63,109
https://kawalpemilu.org#67402,"SIDERA, SIGI BIROMARU, SIGI, SULAWESI TENGAH",6,29,72,101
https://kawalpemilu.org#67402,"SIDERA, SIGI BIROMARU, SIGI, SULAWESI TENGAH",7,50,83,133
https://kawalpemilu.org#67402,"SIDERA, SIGI BIROMARU, SIGI, SULAWESI TENGAH",8,72,93,165
https://kawalpemilu.org#67402,"SIDERA, SIGI BIROMARU, SIGI, SULAWESI TENGAH",9,74,96,170
https://kawalpemilu.org#67402,"SIDERA, SIGI BIROMARU, SIGI, SULAWESI TENGAH",10,194,30,224
https://kawalpemilu.org#67403,"JONO OGE, SIGI BIROMARU, SIGI, SULAWESI TENGAH",1,98,76,174
https://kawalpemilu.org#67403,"JONO OGE, SIGI BIROMARU, SIGI, SULAWESI TENGAH",2,112,60,172
https://kawalpemilu.org#67403,"JONO OGE, SIGI BIROMARU, SIGI, SULAWESI TENGAH",3,96,90,186
https://kawalpemilu.org#67403,"JONO OGE, SIGI BIROMARU, SIGI, SULAWESI TENGAH",4,138,77,215
https://kawalpemilu.org#67403,"JONO OGE, SIGI BIROMARU, SIGI, SULAWESI TENGAH",5,171,25,196
https://kawalpemilu.org#67403,"JONO OGE, SIGI BIROMARU, SIGI, SULAWESI TENGAH",6,156,10,166
https://kawalpemilu.org#67403,"JONO OGE, SIGI BIROMARU, SIGI, SULAWESI TENGAH",7,123,8,131
https://kawalpemilu.org#67403,"JONO OGE, SIGI BIROMARU, SIGI, SULAWESI TENGAH",8,156,15,171
https://kawalpemilu.org#67403,"JONO OGE, SIGI BIROMARU, SIGI, SULAWESI TENGAH",9,121,20,141
https://kawalpemilu.org#67403,"JONO OGE, SIGI BIROMARU, SIGI, SULAWESI TENGAH",10,133,27,160
https://kawalpemilu.org#67404,"KALUKUBULA, SIGI BIROMARU, SIGI, SULAWESI TENGAH",1,99,68,167
https://kawalpemilu.org#67404,"KALUKUBULA, SIGI BIROMARU, SIGI, SULAWESI TENGAH",2,101,104,205
https://kawalpemilu.org#67404,"KALUKUBULA, SIGI BIROMARU, SIGI, SULAWESI TENGAH",3,71,32,103
https://kawalpemilu.org#67404,"KALUKUBULA, SIGI BIROMARU, SIGI, SULAWESI TENGAH",4,111,65,176
https://kawalpemilu.org#67404,"KALUKUBULA, SIGI BIROMARU, SIGI, SULAWESI TENGAH",5,75,26,101
https://kawalpemilu.org#67404,"KALUKUBULA, SIGI BIROMARU, SIGI, SULAWESI TENGAH",6,121,57,178
https://kawalpemilu.org#67404,"KALUKUBULA, SIGI BIROMARU, SIGI, SULAWESI TENGAH",7,57,29,86
https://kawalpemilu.org#67404,"KALUKUBULA, SIGI BIROMARU, SIGI, SULAWESI TENGAH",8,44,56,100
https://kawalpemilu.org#67404,"KALUKUBULA, SIGI BIROMARU, SIGI, SULAWESI TENGAH",9,38,62,100
https://kawalpemilu.org#67404,"KALUKUBULA, SIGI BIROMARU, SIGI, SULAWESI TENGAH",10,84,100,184
https://kawalpemilu.org#67404,"KALUKUBULA, SIGI BIROMARU, SIGI, SULAWESI TENGAH",11,43,46,89
https://kawalpemilu.org#67404,"KALUKUBULA, SIGI BIROMARU, SIGI, SULAWESI TENGAH",12,32,56,88
https://kawalpemilu.org#67404,"KALUKUBULA, SIGI BIROMARU, SIGI, SULAWESI TENGAH",13,50,65,115
https://kawalpemilu.org#67404,"KALUKUBULA, SIGI BIROMARU, SIGI, SULAWESI TENGAH",14,39,56,95
https://kawalpemilu.org#67404,"KALUKUBULA, SIGI BIROMARU, SIGI, SULAWESI TENGAH",15,36,70,106
https://kawalpemilu.org#67404,"KALUKUBULA, SIGI BIROMARU, SIGI, SULAWESI TENGAH",16,146,55,201
https://kawalpemilu.org#67404,"KALUKUBULA, SIGI BIROMARU, SIGI, SULAWESI TENGAH",17,25,201,226
https://kawalpemilu.org#67404,"KALUKUBULA, SIGI BIROMARU, SIGI, SULAWESI TENGAH",18,33,121,154
https://kawalpemilu.org#67404,"KALUKUBULA, SIGI BIROMARU, SIGI, SULAWESI TENGAH",19,28,132,160
https://kawalpemilu.org#67404,"KALUKUBULA, SIGI BIROMARU, SIGI, SULAWESI TENGAH",20,82,121,203
https://kawalpemilu.org#67404,"KALUKUBULA, SIGI BIROMARU, SIGI, SULAWESI TENGAH",21,102,77,179
https://kawalpemilu.org#67404,"KALUKUBULA, SIGI BIROMARU, SIGI, SULAWESI TENGAH",22,125,59,184
https://kawalpemilu.org#67404,"KALUKUBULA, SIGI BIROMARU, SIGI, SULAWESI TENGAH",23,33,245,278
https://kawalpemilu.org#67404,"KALUKUBULA, SIGI BIROMARU, SIGI, SULAWESI TENGAH",24,23,96,119
https://kawalpemilu.org#67404,"KALUKUBULA, SIGI BIROMARU, SIGI, SULAWESI TENGAH",25,43,207,250
https://kawalpemilu.org#67404,"KALUKUBULA, SIGI BIROMARU, SIGI, SULAWESI TENGAH",26,54,165,219
https://kawalpemilu.org#67404,"KALUKUBULA, SIGI BIROMARU, SIGI, SULAWESI TENGAH",27,52,55,107
https://kawalpemilu.org#67404,"KALUKUBULA, SIGI BIROMARU, SIGI, SULAWESI TENGAH",28,34,153,187
https://kawalpemilu.org#67404,"KALUKUBULA, SIGI BIROMARU, SIGI, SULAWESI TENGAH",29,64,91,155
https://kawalpemilu.org#67404,"KALUKUBULA, SIGI BIROMARU, SIGI, SULAWESI TENGAH",30,70,130,200
https://kawalpemilu.org#67404,"KALUKUBULA, SIGI BIROMARU, SIGI, SULAWESI TENGAH",31,35,135,170
https://kawalpemilu.org#67404,"KALUKUBULA, SIGI BIROMARU, SIGI, SULAWESI TENGAH",32,59,157,216
https://kawalpemilu.org#67404,"KALUKUBULA, SIGI BIROMARU, SIGI, SULAWESI TENGAH",33,39,95,134
https://kawalpemilu.org#67404,"KALUKUBULA, SIGI BIROMARU, SIGI, SULAWESI TENGAH",34,32,82,114
https://kawalpemilu.org#67404,"KALUKUBULA, SIGI BIROMARU, SIGI, SULAWESI TENGAH",35,77,105,182
https://kawalpemilu.org#67404,"KALUKUBULA, SIGI BIROMARU, SIGI, SULAWESI TENGAH",36,83,117,200
https://kawalpemilu.org#67404,"KALUKUBULA, SIGI BIROMARU, SIGI, SULAWESI TENGAH",37,59,71,130
https://kawalpemilu.org#67404,"KALUKUBULA, SIGI BIROMARU, SIGI, SULAWESI TENGAH",38,41,37,78
https://kawalpemilu.org#67404,"KALUKUBULA, SIGI BIROMARU, SIGI, SULAWESI TENGAH",39,74,53,127
https://kawalpemilu.org#67404,"KALUKUBULA, SIGI BIROMARU, SIGI, SULAWESI TENGAH",40,50,46,96
https://kawalpemilu.org#67404,"KALUKUBULA, SIGI BIROMARU, SIGI, SULAWESI TENGAH",41,64,83,147
https://kawalpemilu.org#67404,"KALUKUBULA, SIGI BIROMARU, SIGI, SULAWESI TENGAH",42,54,172,226
https://kawalpemilu.org#67405,"LOLU, SIGI BIROMARU, SIGI, SULAWESI TENGAH",1,78,119,197
https://kawalpemilu.org#67405,"LOLU, SIGI BIROMARU, SIGI, SULAWESI TENGAH",2,54,105,159
https://kawalpemilu.org#67405,"LOLU, SIGI BIROMARU, SIGI, SULAWESI TENGAH",3,74,143,217
https://kawalpemilu.org#67405,"LOLU, SIGI BIROMARU, SIGI, SULAWESI TENGAH",4,83,134,217
https://kawalpemilu.org#67405,"LOLU, SIGI BIROMARU, SIGI, SULAWESI TENGAH",5,54,71,125
https://kawalpemilu.org#67405,"LOLU, SIGI BIROMARU, SIGI, SULAWESI TENGAH",6,53,114,167
https://kawalpemilu.org#67405,"LOLU, SIGI BIROMARU, SIGI, SULAWESI TENGAH",7,90,63,153
https://kawalpemilu.org#67405,"LOLU, SIGI BIROMARU, SIGI, SULAWESI TENGAH",8,97,79,176
https://kawalpemilu.org#67405,"LOLU, SIGI BIROMARU, SIGI, SULAWESI TENGAH",9,60,115,175
https://kawalpemilu.org#67405,"LOLU, SIGI BIROMARU, SIGI, SULAWESI TENGAH",10,75,108,183
https://kawalpemilu.org#67405,"LOLU, SIGI BIROMARU, SIGI, SULAWESI TENGAH",11,60,123,183
https://kawalpemilu.org#67405,"LOLU, SIGI BIROMARU, SIGI, SULAWESI TENGAH",12,76,91,167
https://kawalpemilu.org#67405,"LOLU, SIGI BIROMARU, SIGI, SULAWESI TENGAH",13,57,90,147
https://kawalpemilu.org#67405,"LOLU, SIGI BIROMARU, SIGI, SULAWESI TENGAH",14,39,74,113
https://kawalpemilu.org#67405,"LOLU, SIGI BIROMARU, SIGI, SULAWESI TENGAH",15,59,51,110
https://kawalpemilu.org#67406,"POMBEWE, SIGI BIROMARU, SIGI, SULAWESI TENGAH",1,45,117,222
https://kawalpemilu.org#67406,"POMBEWE, SIGI BIROMARU, SIGI, SULAWESI TENGAH",2,72,70,142
https://kawalpemilu.org#67406,"POMBEWE, SIGI BIROMARU, SIGI, SULAWESI TENGAH",3,40,78,118
https://kawalpemilu.org#67406,"POMBEWE, SIGI BIROMARU, SIGI, SULAWESI TENGAH",4,106,84,190
https://kawalpemilu.org#67406,"POMBEWE, SIGI BIROMARU, SIGI, SULAWESI TENGAH",5,92,36,128
https://kawalpemilu.org#67406,"POMBEWE, SIGI BIROMARU, SIGI, SULAWESI TENGAH",6,110,71,181
https://kawalpemilu.org#67406,"POMBEWE, SIGI BIROMARU, SIGI, SULAWESI TENGAH",7,70,85,155
https://kawalpemilu.org#67406,"POMBEWE, SIGI BIROMARU, SIGI, SULAWESI TENGAH",8,113,124,237
https://kawalpemilu.org#67406,"POMBEWE, SIGI BIROMARU, SIGI, SULAWESI TENGAH",9,120,17,137
https://kawalpemilu.org#67407,"LORU, SIGI BIROMARU, SIGI, SULAWESI TENGAH",1,58,70,128
https://kawalpemilu.org#67407,"LORU, SIGI BIROMARU, SIGI, SULAWESI TENGAH",4,53,102,155
https://kawalpemilu.org#67407,"LORU, SIGI BIROMARU, SIGI, SULAWESI TENGAH",6,59,115,174
https://kawalpemilu.org#67407,"LORU, SIGI BIROMARU, SIGI, SULAWESI TENGAH",7,74,123,197
https://kawalpemilu.org#67407,"LORU, SIGI BIROMARU, SIGI, SULAWESI TENGAH",8,106,91,197
https://kawalpemilu.org#67407,"LORU, SIGI BIROMARU, SIGI, SULAWESI TENGAH",9,86,24,110
https://kawalpemilu.org#67408,"MPANAU, SIGI BIROMARU, SIGI, SULAWESI TENGAH",1,48,140,188
https://kawalpemilu.org#67408,"MPANAU, SIGI BIROMARU, SIGI, SULAWESI TENGAH",2,48,134,182
https://kawalpemilu.org#67408,"MPANAU, SIGI BIROMARU, SIGI, SULAWESI TENGAH",3,38,106,144
https://kawalpemilu.org#67408,"MPANAU, SIGI BIROMARU, SIGI, SULAWESI TENGAH",4,39,162,201
https://kawalpemilu.org#67408,"MPANAU, SIGI BIROMARU, SIGI, SULAWESI TENGAH",5,46,159,205
https://kawalpemilu.org#67408,"MPANAU, SIGI BIROMARU, SIGI, SULAWESI TENGAH",6,40,138,178
https://kawalpemilu.org#67408,"MPANAU, SIGI BIROMARU, SIGI, SULAWESI TENGAH",7,33,124,157
https://kawalpemilu.org#67408,"MPANAU, SIGI BIROMARU, SIGI, SULAWESI TENGAH",8,31,84,115
https://kawalpemilu.org#67408,"MPANAU, SIGI BIROMARU, SIGI, SULAWESI TENGAH",9,25,88,113
https://kawalpemilu.org#67408,"MPANAU, SIGI BIROMARU, SIGI, SULAWESI TENGAH",10,28,140,168
https://kawalpemilu.org#67408,"MPANAU, SIGI BIROMARU, SIGI, SULAWESI TENGAH",11,37,115,152
https://kawalpemilu.org#67408,"MPANAU, SIGI BIROMARU, SIGI, SULAWESI TENGAH",12,61,124,185
https://kawalpemilu.org#67408,"MPANAU, SIGI BIROMARU, SIGI, SULAWESI TENGAH",13,27,96,123
https://kawalpemilu.org#67408,"MPANAU, SIGI BIROMARU, SIGI, SULAWESI TENGAH",14,58,133,191
https://kawalpemilu.org#67408,"MPANAU, SIGI BIROMARU, SIGI, SULAWESI TENGAH",15,23,84,107
https://kawalpemilu.org#67408,"MPANAU, SIGI BIROMARU, SIGI, SULAWESI TENGAH",16,49,66,115
https://kawalpemilu.org#67408,"MPANAU, SIGI BIROMARU, SIGI, SULAWESI TENGAH",17,40,63,103
https://kawalpemilu.org#67409,"NGATABARU, SIGI BIROMARU, SIGI, SULAWESI TENGAH",1,43,87,130
https://kawalpemilu.org#67409,"NGATABARU, SIGI BIROMARU, SIGI, SULAWESI TENGAH",2,57,82,139
https://kawalpemilu.org#67409,"NGATABARU, SIGI BIROMARU, SIGI, SULAWESI TENGAH",3,66,88,154
https://kawalpemilu.org#67409,"NGATABARU, SIGI BIROMARU, SIGI, SULAWESI TENGAH",4,31,112,143
https://kawalpemilu.org#67409,"NGATABARU, SIGI BIROMARU, SIGI, SULAWESI TENGAH",5,59,39,98
https://kawalpemilu.org#67410,"MARANATHA, SIGI BIROMARU, SIGI, SULAWESI TENGAH",1,141,17,158
https://kawalpemilu.org#67410,"MARANATHA, SIGI BIROMARU, SIGI, SULAWESI TENGAH",2,80,11,91
https://kawalpemilu.org#67410,"MARANATHA, SIGI BIROMARU, SIGI, SULAWESI TENGAH",3,123,19,142
https://kawalpemilu.org#67410,"MARANATHA, SIGI BIROMARU, SIGI, SULAWESI TENGAH",4,115,20,135
https://kawalpemilu.org#67410,"MARANATHA, SIGI BIROMARU, SIGI, SULAWESI TENGAH",6,100,34,134
https://kawalpemilu.org#67410,"MARANATHA, SIGI BIROMARU, SIGI, SULAWESI TENGAH",7,113,30,143
https://kawalpemilu.org#67410,"MARANATHA, SIGI BIROMARU, SIGI, SULAWESI TENGAH",8,126,40,166
https://kawalpemilu.org#67410,"MARANATHA, SIGI BIROMARU, SIGI, SULAWESI TENGAH",9,226,8,234
https://kawalpemilu.org#67410,"MARANATHA, SIGI BIROMARU, SIGI, SULAWESI TENGAH",10,178,4,182
https://kawalpemilu.org#67411,"SIDONDO III, SIGI BIROMARU, SIGI, SULAWESI TENGAH",1,62,110,172
https://kawalpemilu.org#67411,"SIDONDO III, SIGI BIROMARU, SIGI, SULAWESI TENGAH",2,86,63,149
https://kawalpemilu.org#67411,"SIDONDO III, SIGI BIROMARU, SIGI, SULAWESI TENGAH",3,111,30,141
https://kawalpemilu.org#67411,"SIDONDO III, SIGI BIROMARU, SIGI, SULAWESI TENGAH",4,83,49,132
https://kawalpemilu.org#67411,"SIDONDO III, SIGI BIROMARU, SIGI, SULAWESI TENGAH",5,64,109,173
https://kawalpemilu.org#67412,"SIDONDO IV, SIGI BIROMARU, SIGI, SULAWESI TENGAH",1,78,114,192
https://kawalpemilu.org#67412,"SIDONDO IV, SIGI BIROMARU, SIGI, SULAWESI TENGAH",2,82,85,167
https://kawalpemilu.org#67412,"SIDONDO IV, SIGI BIROMARU, SIGI, SULAWESI TENGAH",3,92,40,132
https://kawalpemilu.org#67412,"SIDONDO IV, SIGI BIROMARU, SIGI, SULAWESI TENGAH",4,95,44,139
https://kawalpemilu.org#67414,"BOBO, PALOLO, SIGI, SULAWESI TENGAH",1,50,78,128
https://kawalpemilu.org#67414,"BOBO, PALOLO, SIGI, SULAWESI TENGAH",2,80,106,186
https://kawalpemilu.org#67414,"BOBO, PALOLO, SIGI, SULAWESI TENGAH",3,92,74,166
https://kawalpemilu.org#67414,"BOBO, PALOLO, SIGI, SULAWESI TENGAH",4,134,83,217
https://kawalpemilu.org#67415,"BUNGA, PALOLO, SIGI, SULAWESI TENGAH",1,176,11,187
https://kawalpemilu.org#67415,"BUNGA, PALOLO, SIGI, SULAWESI TENGAH",2,158,15,173
https://kawalpemilu.org#67415,"BUNGA, PALOLO, SIGI, SULAWESI TENGAH",3,141,18,159
https://kawalpemilu.org#67415,"BUNGA, PALOLO, SIGI, SULAWESI TENGAH",4,149,17,166
https://kawalpemilu.org#67416,"KAPIROWE, PALOLO, SIGI, SULAWESI TENGAH",1,131,104,235
https://kawalpemilu.org#67416,"KAPIROWE, PALOLO, SIGI, SULAWESI TENGAH",2,175,76,251
https://kawalpemilu.org#67416,"KAPIROWE, PALOLO, SIGI, SULAWESI TENGAH",3,138,92,230
https://kawalpemilu.org#67417,"MAKMUR, PALOLO, SIGI, SULAWESI TENGAH",1,90,95,185
https://kawalpemilu.org#67417,"MAKMUR, PALOLO, SIGI, SULAWESI TENGAH",2,87,90,177
https://kawalpemilu.org#67417,"MAKMUR, PALOLO, SIGI, SULAWESI TENGAH",3,47,81,128
https://kawalpemilu.org#67417,"MAKMUR, PALOLO, SIGI, SULAWESI TENGAH",4,139,37,176
https://kawalpemilu.org#67417,"MAKMUR, PALOLO, SIGI, SULAWESI TENGAH",5,137,31,168
https://kawalpemilu.org#67417,"MAKMUR, PALOLO, SIGI, SULAWESI TENGAH",6,39,44,83
https://kawalpemilu.org#67417,"MAKMUR, PALOLO, SIGI, SULAWESI TENGAH",7,185,32,217
https://kawalpemilu.org#67418,"BERDIKARI, PALOLO, SIGI, SULAWESI TENGAH",1,116,22,138
https://kawalpemilu.org#67418,"BERDIKARI, PALOLO, SIGI, SULAWESI TENGAH",2,132,18,150
https://kawalpemilu.org#67418,"BERDIKARI, PALOLO, SIGI, SULAWESI TENGAH",3,130,21,151
https://kawalpemilu.org#67418,"BERDIKARI, PALOLO, SIGI, SULAWESI TENGAH",4,113,23,136
https://kawalpemilu.org#67418,"BERDIKARI, PALOLO, SIGI, SULAWESI TENGAH",5,94,36,130
https://kawalpemilu.org#67418,"BERDIKARI, PALOLO, SIGI, SULAWESI TENGAH",6,112,31,143
https://kawalpemilu.org#67419,"PATIMBE, PALOLO, SIGI, SULAWESI TENGAH",1,81,60,141
https://kawalpemilu.org#67419,"PATIMBE, PALOLO, SIGI, SULAWESI TENGAH",2,95,71,166
https://kawalpemilu.org#67419,"PATIMBE, PALOLO, SIGI, SULAWESI TENGAH",3,127,72,199
https://kawalpemilu.org#67420,"AMPERA, PALOLO, SIGI, SULAWESI TENGAH",1,98,78,176
https://kawalpemilu.org#67420,"AMPERA, PALOLO, SIGI, SULAWESI TENGAH",2,114,28,142
https://kawalpemilu.org#67420,"AMPERA, PALOLO, SIGI, SULAWESI TENGAH",3,117,28,145
https://kawalpemilu.org#67420,"AMPERA, PALOLO, SIGI, SULAWESI TENGAH",4,108,61,169
https://kawalpemilu.org#67421,"REJEKI, PALOLO, SIGI, SULAWESI TENGAH",1,154,27,181
https://kawalpemilu.org#67421,"REJEKI, PALOLO, SIGI, SULAWESI TENGAH",2,140,13,153
https://kawalpemilu.org#67421,"REJEKI, PALOLO, SIGI, SULAWESI TENGAH",3,145,46,191
https://kawalpemilu.org#67421,"REJEKI, PALOLO, SIGI, SULAWESI TENGAH",4,43,41,84
https://kawalpemilu.org#67421,"REJEKI, PALOLO, SIGI, SULAWESI TENGAH",5,103,3,106
https://kawalpemilu.org#67422,"SINTUWU, PALOLO, SIGI, SULAWESI TENGAH",1,115,31,146
https://kawalpemilu.org#67422,"SINTUWU, PALOLO, SIGI, SULAWESI TENGAH",2,153,38,191
https://kawalpemilu.org#67422,"SINTUWU, PALOLO, SIGI, SULAWESI TENGAH",3,78,66,144
https://kawalpemilu.org#67422,"SINTUWU, PALOLO, SIGI, SULAWESI TENGAH",4,88,73,161
https://kawalpemilu.org#67422,"SINTUWU, PALOLO, SIGI, SULAWESI TENGAH",5,132,29,161
https://kawalpemilu.org#67422,"SINTUWU, PALOLO, SIGI, SULAWESI TENGAH",6,49,100,149
https://kawalpemilu.org#67423,"SIGIMPU, PALOLO, SIGI, SULAWESI TENGAH",1,83,130,213
https://kawalpemilu.org#67424,"BAKUBAKULU, PALOLO, SIGI, SULAWESI TENGAH",1,86,59,145
https://kawalpemilu.org#67424,"BAKUBAKULU, PALOLO, SIGI, SULAWESI TENGAH",2,80,53,133
https://kawalpemilu.org#67424,"BAKUBAKULU, PALOLO, SIGI, SULAWESI TENGAH",3,79,45,124
https://kawalpemilu.org#67424,"BAKUBAKULU, PALOLO, SIGI, SULAWESI TENGAH",4,75,36,111
https://kawalpemilu.org#67424,"BAKUBAKULU, PALOLO, SIGI, SULAWESI TENGAH",5,114,42,156
https://kawalpemilu.org#67424,"BAKUBAKULU, PALOLO, SIGI, SULAWESI TENGAH",6,121,75,196
https://kawalpemilu.org#67425,"BAHAGIA, PALOLO, SIGI, SULAWESI TENGAH",1,71,82,153
https://kawalpemilu.org#67425,"BAHAGIA, PALOLO, SIGI, SULAWESI TENGAH",2,58,72,130
https://kawalpemilu.org#67425,"BAHAGIA, PALOLO, SIGI, SULAWESI TENGAH",3,109,45,154
https://kawalpemilu.org#67425,"BAHAGIA, PALOLO, SIGI, SULAWESI TENGAH",4,151,45,196
https://kawalpemilu.org#67426,"RAHMAT, PALOLO, SIGI, SULAWESI TENGAH",1,116,20,136
https://kawalpemilu.org#67426,"RAHMAT, PALOLO, SIGI, SULAWESI TENGAH",2,115,14,129
https://kawalpemilu.org#67426,"RAHMAT, PALOLO, SIGI, SULAWESI TENGAH",3,136,40,176
https://kawalpemilu.org#67426,"RAHMAT, PALOLO, SIGI, SULAWESI TENGAH",4,221,33,254
https://kawalpemilu.org#67426,"RAHMAT, PALOLO, SIGI, SULAWESI TENGAH",5,89,120,209
https://kawalpemilu.org#67427,"TANAH HARAPAN, PALOLO, SIGI, SULAWESI TENGAH",1,172,13,185
https://kawalpemilu.org#67427,"TANAH HARAPAN, PALOLO, SIGI, SULAWESI TENGAH",2,170,9,179
https://kawalpemilu.org#67427,"TANAH HARAPAN, PALOLO, SIGI, SULAWESI TENGAH",3,193,4,197
https://kawalpemilu.org#67428,"RANTELEDA, PALOLO, SIGI, SULAWESI TENGAH",1,70,41,111
https://kawalpemilu.org#67428,"RANTELEDA, PALOLO, SIGI, SULAWESI TENGAH",2,65,145,210
https://kawalpemilu.org#67428,"RANTELEDA, PALOLO, SIGI, SULAWESI TENGAH",3,76,117,193
https://kawalpemilu.org#67428,"RANTELEDA, PALOLO, SIGI, SULAWESI TENGAH",4,188,7,195
https://kawalpemilu.org#67429,"TONGOA, PALOLO, SIGI, SULAWESI TENGAH",1,218,7,225
https://kawalpemilu.org#67429,"TONGOA, PALOLO, SIGI, SULAWESI TENGAH",2,115,21,136
https://kawalpemilu.org#67429,"TONGOA, PALOLO, SIGI, SULAWESI TENGAH",3,97,19,116
https://kawalpemilu.org#67429,"TONGOA, PALOLO, SIGI, SULAWESI TENGAH",4,179,12,191
https://kawalpemilu.org#67429,"TONGOA, PALOLO, SIGI, SULAWESI TENGAH",5,78,36,114
https://kawalpemilu.org#67429,"TONGOA, PALOLO, SIGI, SULAWESI TENGAH",6,95,29,124
https://kawalpemilu.org#67429,"TONGOA, PALOLO, SIGI, SULAWESI TENGAH",7,89,23,112
https://kawalpemilu.org#67429,"TONGOA, PALOLO, SIGI, SULAWESI TENGAH",8,96,6,102
https://kawalpemilu.org#67429,"TONGOA, PALOLO, SIGI, SULAWESI TENGAH",9,97,10,107
https://kawalpemilu.org#67429,"TONGOA, PALOLO, SIGI, SULAWESI TENGAH",10,145,10,155
https://kawalpemilu.org#67429,"TONGOA, PALOLO, SIGI, SULAWESI TENGAH",11,118,10,128
https://kawalpemilu.org#67429,"TONGOA, PALOLO, SIGI, SULAWESI TENGAH",12,129,11,140
https://kawalpemilu.org#67429,"TONGOA, PALOLO, SIGI, SULAWESI TENGAH",13,62,10,72
https://kawalpemilu.org#67429,"TONGOA, PALOLO, SIGI, SULAWESI TENGAH",14,90,4,94
https://kawalpemilu.org#67430,"LEMBANTONGOA, PALOLO, SIGI, SULAWESI TENGAH",1,105,21,126
https://kawalpemilu.org#67430,"LEMBANTONGOA, PALOLO, SIGI, SULAWESI TENGAH",2,92,20,112
https://kawalpemilu.org#67430,"LEMBANTONGOA, PALOLO, SIGI, SULAWESI TENGAH",3,112,18,130
https://kawalpemilu.org#67430,"LEMBANTONGOA, PALOLO, SIGI, SULAWESI TENGAH",4,96,19,115
https://kawalpemilu.org#67430,"LEMBANTONGOA, PALOLO, SIGI, SULAWESI TENGAH",5,95,16,111
https://kawalpemilu.org#67430,"LEMBANTONGOA, PALOLO, SIGI, SULAWESI TENGAH",6,84,29,113
https://kawalpemilu.org#67430,"LEMBANTONGOA, PALOLO, SIGI, SULAWESI TENGAH",7,119,19,138
https://kawalpemilu.org#67430,"LEMBANTONGOA, PALOLO, SIGI, SULAWESI TENGAH",8,118,16,134
https://kawalpemilu.org#67430,"LEMBANTONGOA, PALOLO, SIGI, SULAWESI TENGAH",9,111,13,124
https://kawalpemilu.org#67430,"LEMBANTONGOA, PALOLO, SIGI, SULAWESI TENGAH",10,131,10,141
https://kawalpemilu.org#67431,"UWE NUNI, PALOLO, SIGI, SULAWESI TENGAH",1,112,4,116
https://kawalpemilu.org#67431,"UWE NUNI, PALOLO, SIGI, SULAWESI TENGAH",2,110,8,118
https://kawalpemilu.org#67431,"UWE NUNI, PALOLO, SIGI, SULAWESI TENGAH",3,157,12,169
https://kawalpemilu.org#67431,"UWE NUNI, PALOLO, SIGI, SULAWESI TENGAH",4,123,10,133
https://kawalpemilu.org#67431,"UWE NUNI, PALOLO, SIGI, SULAWESI TENGAH",5,135,42,177
https://kawalpemilu.org#67431,"UWE NUNI, PALOLO, SIGI, SULAWESI TENGAH",6,165,11,176
https://kawalpemilu.org#67431,"UWE NUNI, PALOLO, SIGI, SULAWESI TENGAH",7,123,43,166
https://kawalpemilu.org#67431,"UWE NUNI, PALOLO, SIGI, SULAWESI TENGAH",8,54,123,177
https://kawalpemilu.org#67431,"UWE NUNI, PALOLO, SIGI, SULAWESI TENGAH",9,118,74,192
https://kawalpemilu.org#67431,"UWE NUNI, PALOLO, SIGI, SULAWESI TENGAH",10,121,6,127
https://kawalpemilu.org#67431,"UWE NUNI, PALOLO, SIGI, SULAWESI TENGAH",11,97,2,99
https://kawalpemilu.org#67432,"SEJAHTERA, PALOLO, SIGI, SULAWESI TENGAH",1,94,85,179
https://kawalpemilu.org#67432,"SEJAHTERA, PALOLO, SIGI, SULAWESI TENGAH",2,111,10,121
https://kawalpemilu.org#67432,"SEJAHTERA, PALOLO, SIGI, SULAWESI TENGAH",3,0,0,0
https://kawalpemilu.org#67432,"SEJAHTERA, PALOLO, SIGI, SULAWESI TENGAH",4,113,10,123
https://kawalpemilu.org#67432,"SEJAHTERA, PALOLO, SIGI, SULAWESI TENGAH",5,83,24,107
https://kawalpemilu.org#67432,"SEJAHTERA, PALOLO, SIGI, SULAWESI TENGAH",6,93,2,95
https://kawalpemilu.org#928653,"UE RANI, PALOLO, SIGI, SULAWESI TENGAH",1,183,46,229
https://kawalpemilu.org#928653,"UE RANI, PALOLO, SIGI, SULAWESI TENGAH",2,161,12,173
https://kawalpemilu.org#928654,"KARUNIA, PALOLO, SIGI, SULAWESI TENGAH",1,137,35,172
https://kawalpemilu.org#928654,"KARUNIA, PALOLO, SIGI, SULAWESI TENGAH",2,118,28,146
https://kawalpemilu.org#928654,"KARUNIA, PALOLO, SIGI, SULAWESI TENGAH",3,107,57,164
https://kawalpemilu.org#928654,"KARUNIA, PALOLO, SIGI, SULAWESI TENGAH",4,117,44,161
https://kawalpemilu.org#928655,"SARUMANA, PALOLO, SIGI, SULAWESI TENGAH",1,117,45,162
https://kawalpemilu.org#928655,"SARUMANA, PALOLO, SIGI, SULAWESI TENGAH",2,133,34,167
https://kawalpemilu.org#67434,"KAMARORA A, NOKILALAKI, SIGI, SULAWESI TENGAH",1,139,51,190
https://kawalpemilu.org#67434,"KAMARORA A, NOKILALAKI, SIGI, SULAWESI TENGAH",2,88,25,113
https://kawalpemilu.org#67434,"KAMARORA A, NOKILALAKI, SIGI, SULAWESI TENGAH",3,78,11,89
https://kawalpemilu.org#67434,"KAMARORA A, NOKILALAKI, SIGI, SULAWESI TENGAH",4,103,7,110
https://kawalpemilu.org#67434,"KAMARORA A, NOKILALAKI, SIGI, SULAWESI TENGAH",5,104,10,114
https://kawalpemilu.org#67434,"KAMARORA A, NOKILALAKI, SIGI, SULAWESI TENGAH",6,173,3,176
https://kawalpemilu.org#67434,"KAMARORA A, NOKILALAKI, SIGI, SULAWESI TENGAH",7,177,13,190
https://kawalpemilu.org#67435,"KAMARORA B, NOKILALAKI, SIGI, SULAWESI TENGAH",1,178,30,208
https://kawalpemilu.org#67435,"KAMARORA B, NOKILALAKI, SIGI, SULAWESI TENGAH",2,102,35,137
https://kawalpemilu.org#67435,"KAMARORA B, NOKILALAKI, SIGI, SULAWESI TENGAH",3,164,26,190
https://kawalpemilu.org#67435,"KAMARORA B, NOKILALAKI, SIGI, SULAWESI TENGAH",4,114,36,150
https://kawalpemilu.org#67435,"KAMARORA B, NOKILALAKI, SIGI, SULAWESI TENGAH",5,73,17,90
https://kawalpemilu.org#67436,"KADIDIA, NOKILALAKI, SIGI, SULAWESI TENGAH",1,122,12,134
https://kawalpemilu.org#67436,"KADIDIA, NOKILALAKI, SIGI, SULAWESI TENGAH",2,118,9,127
https://kawalpemilu.org#67437,"SOPU, NOKILALAKI, SIGI, SULAWESI TENGAH",1,184,9,193
https://kawalpemilu.org#67437,"SOPU, NOKILALAKI, SIGI, SULAWESI TENGAH",2,165,15,180
https://kawalpemilu.org#67437,"SOPU, NOKILALAKI, SIGI, SULAWESI TENGAH",3,0,0,0
https://kawalpemilu.org#67438,"BULILI, NOKILALAKI, SIGI, SULAWESI TENGAH",1,115,107,222
https://kawalpemilu.org#67438,"BULILI, NOKILALAKI, SIGI, SULAWESI TENGAH",2,76,109,185
https://kawalpemilu.org#67438,"BULILI, NOKILALAKI, SIGI, SULAWESI TENGAH",3,141,43,184
https://kawalpemilu.org#67438,"BULILI, NOKILALAKI, SIGI, SULAWESI TENGAH",4,89,59,148
https://kawalpemilu.org#67440,"PUROO, LINDU, SIGI, SULAWESI TENGAH",1,247,8,255
https://kawalpemilu.org#67440,"PUROO, LINDU, SIGI, SULAWESI TENGAH",2,125,19,144
https://kawalpemilu.org#67440,"PUROO, LINDU, SIGI, SULAWESI TENGAH",3,167,18,185
https://kawalpemilu.org#67441,"LANGKO, LINDU, SIGI, SULAWESI TENGAH",1,175,34,209
https://kawalpemilu.org#67441,"LANGKO, LINDU, SIGI, SULAWESI TENGAH",2,185,13,198
https://kawalpemilu.org#67441,"LANGKO, LINDU, SIGI, SULAWESI TENGAH",3,153,8,161
https://kawalpemilu.org#67442,"TOMADO, LINDU, SIGI, SULAWESI TENGAH",1,153,22,175
https://kawalpemilu.org#67442,"TOMADO, LINDU, SIGI, SULAWESI TENGAH",2,113,16,129
https://kawalpemilu.org#67442,"TOMADO, LINDU, SIGI, SULAWESI TENGAH",3,121,46,167
https://kawalpemilu.org#67442,"TOMADO, LINDU, SIGI, SULAWESI TENGAH",4,49,47,96
https://kawalpemilu.org#67442,"TOMADO, LINDU, SIGI, SULAWESI TENGAH",5,209,29,238
https://kawalpemilu.org#67443,"ANCA, LINDU, SIGI, SULAWESI TENGAH",1,213,23,236
https://kawalpemilu.org#67443,"ANCA, LINDU, SIGI, SULAWESI TENGAH",2,199,32,231
https://kawalpemilu.org#928656,"OLU, LINDU, SIGI, SULAWESI TENGAH",1,126,66,192
https://kawalpemilu.org#928656,"OLU, LINDU, SIGI, SULAWESI TENGAH",2,87,56,143
https://kawalpemilu.org#928656,"OLU, LINDU, SIGI, SULAWESI TENGAH",3,169,9,178
https://kawalpemilu.org#928656,"OLU, LINDU, SIGI, SULAWESI TENGAH",4,205,18,223
https://kawalpemilu.org#928656,"OLU, LINDU, SIGI, SULAWESI TENGAH",5,96,62,158
https://kawalpemilu.org#928656,"OLU, LINDU, SIGI, SULAWESI TENGAH",6,145,3,148
https://kawalpemilu.org#67445,"BANGGAIBA, KULAWI, SIGI, SULAWESI TENGAH",1,189,6,195
https://kawalpemilu.org#67445,"BANGGAIBA, KULAWI, SIGI, SULAWESI TENGAH",2,107,15,122
https://kawalpemilu.org#67446,"TANGKULOWI, KULAWI, SIGI, SULAWESI TENGAH",1,241,14,255
https://kawalpemilu.org#67447,"BOLADANGKO, KULAWI, SIGI, SULAWESI TENGAH",1,188,11,199
https://kawalpemilu.org#67447,"BOLADANGKO, KULAWI, SIGI, SULAWESI TENGAH",2,102,64,166
https://kawalpemilu.org#67448,"LONCA, KULAWI, SIGI, SULAWESI TENGAH",1,148,11,159
https://kawalpemilu.org#67449,"RANTEWULU, KULAWI, SIGI, SULAWESI TENGAH",1,103,71,174
https://kawalpemilu.org#67449,"RANTEWULU, KULAWI, SIGI, SULAWESI TENGAH",2,63,53,116
https://kawalpemilu.org#67449,"RANTEWULU, KULAWI, SIGI, SULAWESI TENGAH",3,154,3,157
https://kawalpemilu.org#67450,"TOWULU, KULAWI, SIGI, SULAWESI TENGAH",1,252,4,256
https://kawalpemilu.org#67450,"TOWULU, KULAWI, SIGI, SULAWESI TENGAH",2,189,8,189
https://kawalpemilu.org#67450,"TOWULU, KULAWI, SIGI, SULAWESI TENGAH",3,162,4,166
https://kawalpemilu.org#67450,"TOWULU, KULAWI, SIGI, SULAWESI TENGAH",4,218,2,220
https://kawalpemilu.org#67451,"WINATU, KULAWI, SIGI, SULAWESI TENGAH",1,198,5,203
https://kawalpemilu.org#67451,"WINATU, KULAWI, SIGI, SULAWESI TENGAH",2,211,5,216
https://kawalpemilu.org#67451,"WINATU, KULAWI, SIGI, SULAWESI TENGAH",3,113,6,119
https://kawalpemilu.org#67452,"BOLAPAPU, KULAWI, SIGI, SULAWESI TENGAH",1,142,26,168
https://kawalpemilu.org#67452,"BOLAPAPU, KULAWI, SIGI, SULAWESI TENGAH",2,94,21,115
https://kawalpemilu.org#67452,"BOLAPAPU, KULAWI, SIGI, SULAWESI TENGAH",3,87,50,137
https://kawalpemilu.org#67452,"BOLAPAPU, KULAWI, SIGI, SULAWESI TENGAH",4,87,29,116
https://kawalpemilu.org#67452,"BOLAPAPU, KULAWI, SIGI, SULAWESI TENGAH",5,159,44,203
https://kawalpemilu.org#67452,"BOLAPAPU, KULAWI, SIGI, SULAWESI TENGAH",6,120,19,139
https://kawalpemilu.org#67452,"BOLAPAPU, KULAWI, SIGI, SULAWESI TENGAH",7,118,21,139
https://kawalpemilu.org#67452,"BOLAPAPU, KULAWI, SIGI, SULAWESI TENGAH",8,181,41,222
https://kawalpemilu.org#67452,"BOLAPAPU, KULAWI, SIGI, SULAWESI TENGAH",9,174,46,220
https://kawalpemilu.org#67453,"MATAUE, KULAWI, SIGI, SULAWESI TENGAH",1,193,34,227
https://kawalpemilu.org#67453,"MATAUE, KULAWI, SIGI, SULAWESI TENGAH",2,109,14,123
https://kawalpemilu.org#67454,"TORO, KULAWI, SIGI, SULAWESI TENGAH",1,97,39,136
https://kawalpemilu.org#67454,"TORO, KULAWI, SIGI, SULAWESI TENGAH",2,117,34,151
https://kawalpemilu.org#67454,"TORO, KULAWI, SIGI, SULAWESI TENGAH",3,172,9,181
https://kawalpemilu.org#67454,"TORO, KULAWI, SIGI, SULAWESI TENGAH",4,170,3,173
https://kawalpemilu.org#67454,"TORO, KULAWI, SIGI, SULAWESI TENGAH",5,195,4,199
https://kawalpemilu.org#67454,"TORO, KULAWI, SIGI, SULAWESI TENGAH",6,224,14,238
https://kawalpemilu.org#67454,"TORO, KULAWI, SIGI, SULAWESI TENGAH",7,149,16,165
https://kawalpemilu.org#67454,"TORO, KULAWI, SIGI, SULAWESI TENGAH",8,160,5,165
https://kawalpemilu.org#67455,"SALUA, KULAWI, SIGI, SULAWESI TENGAH",1,148,27,175
https://kawalpemilu.org#67455,"SALUA, KULAWI, SIGI, SULAWESI TENGAH",2,145,19,164
https://kawalpemilu.org#67455,"SALUA, KULAWI, SIGI, SULAWESI TENGAH",3,166,69,235
https://kawalpemilu.org#67455,"SALUA, KULAWI, SIGI, SULAWESI TENGAH",4,96,123,219
https://kawalpemilu.org#67456,"NAMO, KULAWI, SIGI, SULAWESI TENGAH",1,125,52,177
https://kawalpemilu.org#67456,"NAMO, KULAWI, SIGI, SULAWESI TENGAH",2,148,74,222
https://kawalpemilu.org#67456,"NAMO, KULAWI, SIGI, SULAWESI TENGAH",3,158,105,263
https://kawalpemilu.org#67456,"NAMO, KULAWI, SIGI, SULAWESI TENGAH",4,47,32,79
https://kawalpemilu.org#67456,"NAMO, KULAWI, SIGI, SULAWESI TENGAH",5,83,66,149
https://kawalpemilu.org#85740,"SIWONGI, KULAWI, SIGI, SULAWESI TENGAH",1,113,3,116
https://kawalpemilu.org#85740,"SIWONGI, KULAWI, SIGI, SULAWESI TENGAH",2,206,10,216
https://kawalpemilu.org#85741,"SUNGKU, KULAWI, SIGI, SULAWESI TENGAH",1,0,0,0
https://kawalpemilu.org#85741,"SUNGKU, KULAWI, SIGI, SULAWESI TENGAH",2,222,34,256
https://kawalpemilu.org#85741,"SUNGKU, KULAWI, SIGI, SULAWESI TENGAH",3,178,17,195
https://kawalpemilu.org#85741,"SUNGKU, KULAWI, SIGI, SULAWESI TENGAH",4,170,17,187
https://kawalpemilu.org#928657,"MARENA, KULAWI, SIGI, SULAWESI TENGAH",1,179,18,197
https://kawalpemilu.org#928658,"POLEROA MAKUHI, KULAWI, SIGI, SULAWESI TENGAH",1,184,10,194
https://kawalpemilu.org#928658,"POLEROA MAKUHI, KULAWI, SIGI, SULAWESI TENGAH",2,204,15,219
https://kawalpemilu.org#67458,"LEMPELERO, KULAWI SELATAN, SIGI, SULAWESI TENGAH",1,224,20,244
https://kawalpemilu.org#67458,"LEMPELERO, KULAWI SELATAN, SIGI, SULAWESI TENGAH",2,210,33,243
https://kawalpemilu.org#67458,"LEMPELERO, KULAWI SELATAN, SIGI, SULAWESI TENGAH",3,188,4,192
https://kawalpemilu.org#67458,"LEMPELERO, KULAWI SELATAN, SIGI, SULAWESI TENGAH",4,78,3,81
https://kawalpemilu.org#67459,"GIMPU, KULAWI SELATAN, SIGI, SULAWESI TENGAH",1,216,45,261
https://kawalpemilu.org#67459,"GIMPU, KULAWI SELATAN, SIGI, SULAWESI TENGAH",2,206,43,249
https://kawalpemilu.org#67460,"TOMUA, KULAWI SELATAN, SIGI, SULAWESI TENGAH",1,162,23,185
https://kawalpemilu.org#67460,"TOMUA, KULAWI SELATAN, SIGI, SULAWESI TENGAH",2,194,45,239
https://kawalpemilu.org#67460,"TOMUA, KULAWI SELATAN, SIGI, SULAWESI TENGAH",3,121,2,123
https://kawalpemilu.org#67461,"TOMPI BUGIS, KULAWI SELATAN, SIGI, SULAWESI TENGAH",1,47,108,155
https://kawalpemilu.org#67461,"TOMPI BUGIS, KULAWI SELATAN, SIGI, SULAWESI TENGAH",2,56,97,153
https://kawalpemilu.org#67462,"LAWUA, KULAWI SELATAN, SIGI, SULAWESI TENGAH",1,136,26,162
https://kawalpemilu.org#67462,"LAWUA, KULAWI SELATAN, SIGI, SULAWESI TENGAH",2,165,23,188
https://kawalpemilu.org#67462,"LAWUA, KULAWI SELATAN, SIGI, SULAWESI TENGAH",3,76,73,149
https://kawalpemilu.org#67462,"LAWUA, KULAWI SELATAN, SIGI, SULAWESI TENGAH",4,121,21,142
https://kawalpemilu.org#67462,"LAWUA, KULAWI SELATAN, SIGI, SULAWESI TENGAH",5,145,13,158
https://kawalpemilu.org#67463,"WATUKILO, KULAWI SELATAN, SIGI, SULAWESI TENGAH",1,187,38,225
https://kawalpemilu.org#67463,"WATUKILO, KULAWI SELATAN, SIGI, SULAWESI TENGAH",2,139,77,216
https://kawalpemilu.org#67464,"SALUTOME, KULAWI SELATAN, SIGI, SULAWESI TENGAH",1,193,21,214
https://kawalpemilu.org#67464,"SALUTOME, KULAWI SELATAN, SIGI, SULAWESI TENGAH",2,208,12,220
https://kawalpemilu.org#67465,"O'O PARESE, KULAWI SELATAN, SIGI, SULAWESI TENGAH",1,172,22,194
https://kawalpemilu.org#67465,"O'O PARESE, KULAWI SELATAN, SIGI, SULAWESI TENGAH",2,184,21,205
https://kawalpemilu.org#67465,"O'O PARESE, KULAWI SELATAN, SIGI, SULAWESI TENGAH",3,101,23,124
https://kawalpemilu.org#67466,"PILIMAKUJAWA, KULAWI SELATAN, SIGI, SULAWESI TENGAH",1,201,18,219
https://kawalpemilu.org#67466,"PILIMAKUJAWA, KULAWI SELATAN, SIGI, SULAWESI TENGAH",2,146,10,156
https://kawalpemilu.org#67467,"PALAMAKI, KULAWI SELATAN, SIGI, SULAWESI TENGAH",1,166,8,174
https://kawalpemilu.org#67467,"PALAMAKI, KULAWI SELATAN, SIGI, SULAWESI TENGAH",2,103,15,118
https://kawalpemilu.org#85742,"MOA, KULAWI SELATAN, SIGI, SULAWESI TENGAH",1,128,13,141
https://kawalpemilu.org#85742,"MOA, KULAWI SELATAN, SIGI, SULAWESI TENGAH",2,119,17,136
https://kawalpemilu.org#89678,"WANGKA, KULAWI SELATAN, SIGI, SULAWESI TENGAH",1,142,17,159
https://kawalpemilu.org#89678,"WANGKA, KULAWI SELATAN, SIGI, SULAWESI TENGAH",2,143,9,152
https://kawalpemilu.org#67469,"KOJA, PIPIKORO, SIGI, SULAWESI TENGAH",1,158,6,164
https://kawalpemilu.org#67469,"KOJA, PIPIKORO, SIGI, SULAWESI TENGAH",2,163,12,175
https://kawalpemilu.org#67470,"KALAMANTA, PIPIKORO, SIGI, SULAWESI TENGAH",1,233,10,243
https://kawalpemilu.org#67471,"MAMU, PIPIKORO, SIGI, SULAWESI TENGAH",1,216,10,226
https://kawalpemilu.org#67472,"PEANA, PIPIKORO, SIGI, SULAWESI TENGAH",1,121,15,136
https://kawalpemilu.org#67472,"PEANA, PIPIKORO, SIGI, SULAWESI TENGAH",2,150,16,166
https://kawalpemilu.org#67472,"PEANA, PIPIKORO, SIGI, SULAWESI TENGAH",3,221,16,237
https://kawalpemilu.org#67473,"KANTEWU, PIPIKORO, SIGI, SULAWESI TENGAH",1,186,16,202
https://kawalpemilu.org#67473,"KANTEWU, PIPIKORO, SIGI, SULAWESI TENGAH",2,139,34,173
https://kawalpemilu.org#67474,"ONU, PIPIKORO, SIGI, SULAWESI TENGAH",1,260,2,262
https://kawalpemilu.org#67474,"ONU, PIPIKORO, SIGI, SULAWESI TENGAH",2,265,12,277
https://kawalpemilu.org#67475,"MAPAHI, PIPIKORO, SIGI, SULAWESI TENGAH",1,131,25,156
https://kawalpemilu.org#67475,"MAPAHI, PIPIKORO, SIGI, SULAWESI TENGAH",2,45,4,49
https://kawalpemilu.org#67476,"BANASU, PIPIKORO, SIGI, SULAWESI TENGAH",1,139,21,160
https://kawalpemilu.org#67477,"LONEBASA, PIPIKORO, SIGI, SULAWESI TENGAH",1,211,17,228
https://kawalpemilu.org#67477,"LONEBASA, PIPIKORO, SIGI, SULAWESI TENGAH",2,207,13,220
https://kawalpemilu.org#67477,"LONEBASA, PIPIKORO, SIGI, SULAWESI TENGAH",3,124,6,130
https://kawalpemilu.org#67478,"LAWE, PIPIKORO, SIGI, SULAWESI TENGAH",1,119,22,141
https://kawalpemilu.org#67478,"LAWE, PIPIKORO, SIGI, SULAWESI TENGAH",2,130,6,136
https://kawalpemilu.org#67479,"MORUI, PIPIKORO, SIGI, SULAWESI TENGAH",1,163,5,168
https://kawalpemilu.org#85743,"KANTEWU II, PIPIKORO, SIGI, SULAWESI TENGAH",1,196,15,211
https://kawalpemilu.org#85743,"KANTEWU II, PIPIKORO, SIGI, SULAWESI TENGAH",2,208,13,221
https://kawalpemilu.org#85744,"PORELEA, PIPIKORO, SIGI, SULAWESI TENGAH",1,198,1,199
https://kawalpemilu.org#85744,"PORELEA, PIPIKORO, SIGI, SULAWESI TENGAH",2,183,3,186
https://kawalpemilu.org#928659,"TUWO TANIJAYA, PIPIKORO, SIGI, SULAWESI TENGAH",1,134,13,147
https://kawalpemilu.org#928660,"PELEMPEA, PIPIKORO, SIGI, SULAWESI TENGAH",1,242,19,261
https://kawalpemilu.org#928661,"MORUI II, PIPIKORO, SIGI, SULAWESI TENGAH",1,198,3,201
https://kawalpemilu.org#928662,"POLUROA, PIPIKORO, SIGI, SULAWESI TENGAH",1,214,10,224
https://kawalpemilu.org#928663,"MASEWO, PIPIKORO, SIGI, SULAWESI TENGAH",1,126,1,127
https://kawalpemilu.org#928664,"PORELEA II, PIPIKORO, SIGI, SULAWESI TENGAH",1,148,3,151
https://kawalpemilu.org#928664,"PORELEA II, PIPIKORO, SIGI, SULAWESI TENGAH",2,142,1,143
https://kawalpemilu.org#67481,"TUWA, GUMBASA, SIGI, SULAWESI TENGAH",1,123,47,170
https://kawalpemilu.org#67481,"TUWA, GUMBASA, SIGI, SULAWESI TENGAH",2,124,69,193
https://kawalpemilu.org#67481,"TUWA, GUMBASA, SIGI, SULAWESI TENGAH",3,81,36,117
https://kawalpemilu.org#67481,"TUWA, GUMBASA, SIGI, SULAWESI TENGAH",4,79,31,110
https://kawalpemilu.org#67481,"TUWA, GUMBASA, SIGI, SULAWESI TENGAH",5,91,32,123
https://kawalpemilu.org#67481,"TUWA, GUMBASA, SIGI, SULAWESI TENGAH",6,48,28,76
https://kawalpemilu.org#67481,"TUWA, GUMBASA, SIGI, SULAWESI TENGAH",7,46,48,94
https://kawalpemilu.org#67481,"TUWA, GUMBASA, SIGI, SULAWESI TENGAH",8,127,31,158
https://kawalpemilu.org#67482,"OMU, GUMBASA, SIGI, SULAWESI TENGAH",1,165,28,193
https://kawalpemilu.org#67482,"OMU, GUMBASA, SIGI, SULAWESI TENGAH",2,128,50,178
https://kawalpemilu.org#67482,"OMU, GUMBASA, SIGI, SULAWESI TENGAH",3,103,71,174
https://kawalpemilu.org#67482,"OMU, GUMBASA, SIGI, SULAWESI TENGAH",4,99,102,201
https://kawalpemilu.org#67482,"OMU, GUMBASA, SIGI, SULAWESI TENGAH",5,161,12,173
https://kawalpemilu.org#67482,"OMU, GUMBASA, SIGI, SULAWESI TENGAH",6,83,109,192
https://kawalpemilu.org#67483,"SIMORO, GUMBASA, SIGI, SULAWESI TENGAH",1,96,53,149
https://kawalpemilu.org#67483,"SIMORO, GUMBASA, SIGI, SULAWESI TENGAH",2,65,72,137
https://kawalpemilu.org#67483,"SIMORO, GUMBASA, SIGI, SULAWESI TENGAH",3,71,65,136
https://kawalpemilu.org#67483,"SIMORO, GUMBASA, SIGI, SULAWESI TENGAH",4,80,79,159
https://kawalpemilu.org#67484,"PAKULI, GUMBASA, SIGI, SULAWESI TENGAH",1,72,135,207
https://kawalpemilu.org#67484,"PAKULI, GUMBASA, SIGI, SULAWESI TENGAH",2,53,165,218
https://kawalpemilu.org#67484,"PAKULI, GUMBASA, SIGI, SULAWESI TENGAH",3,69,146,215
https://kawalpemilu.org#67484,"PAKULI, GUMBASA, SIGI, SULAWESI TENGAH",4,41,149,190
https://kawalpemilu.org#67484,"PAKULI, GUMBASA, SIGI, SULAWESI TENGAH",5,75,91,166
https://kawalpemilu.org#67484,"PAKULI, GUMBASA, SIGI, SULAWESI TENGAH",6,94,104,198
https://kawalpemilu.org#67484,"PAKULI, GUMBASA, SIGI, SULAWESI TENGAH",7,103,76,179
https://kawalpemilu.org#67484,"PAKULI, GUMBASA, SIGI, SULAWESI TENGAH",8,117,11,128
https://kawalpemilu.org#67485,"PANDERE, GUMBASA, SIGI, SULAWESI TENGAH",1,87,156,243
https://kawalpemilu.org#67485,"PANDERE, GUMBASA, SIGI, SULAWESI TENGAH",2,40,94,134
https://kawalpemilu.org#67485,"PANDERE, GUMBASA, SIGI, SULAWESI TENGAH",3,52,120,172
https://kawalpemilu.org#67485,"PANDERE, GUMBASA, SIGI, SULAWESI TENGAH",4,63,114,177
https://kawalpemilu.org#67485,"PANDERE, GUMBASA, SIGI, SULAWESI TENGAH",5,71,61,132
https://kawalpemilu.org#67485,"PANDERE, GUMBASA, SIGI, SULAWESI TENGAH",6,52,71,123
https://kawalpemilu.org#67485,"PANDERE, GUMBASA, SIGI, SULAWESI TENGAH",7,161,25,186
https://kawalpemilu.org#67485,"PANDERE, GUMBASA, SIGI, SULAWESI TENGAH",8,108,40,148
https://kawalpemilu.org#67485,"PANDERE, GUMBASA, SIGI, SULAWESI TENGAH",9,154,10,164
https://kawalpemilu.org#67485,"PANDERE, GUMBASA, SIGI, SULAWESI TENGAH",10,78,2,80
https://kawalpemilu.org#67486,"KALAWARA, GUMBASA, SIGI, SULAWESI TENGAH",1,192,29,221
https://kawalpemilu.org#67486,"KALAWARA, GUMBASA, SIGI, SULAWESI TENGAH",2,146,8,154
https://kawalpemilu.org#67486,"KALAWARA, GUMBASA, SIGI, SULAWESI TENGAH",3,138,14,152
https://kawalpemilu.org#67486,"KALAWARA, GUMBASA, SIGI, SULAWESI TENGAH",4,71,20,91
https://kawalpemilu.org#67486,"KALAWARA, GUMBASA, SIGI, SULAWESI TENGAH",5,123,25,148
https://kawalpemilu.org#67486,"KALAWARA, GUMBASA, SIGI, SULAWESI TENGAH",6,93,16,109
https://kawalpemilu.org#67486,"KALAWARA, GUMBASA, SIGI, SULAWESI TENGAH",7,148,9,157
https://kawalpemilu.org#928665,"PAKULI UTARA, GUMBASA, SIGI, SULAWESI TENGAH",1,89,142,231
https://kawalpemilu.org#928665,"PAKULI UTARA, GUMBASA, SIGI, SULAWESI TENGAH",2,79,153,232
https://kawalpemilu.org#928665,"PAKULI UTARA, GUMBASA, SIGI, SULAWESI TENGAH",4,95,140,235
https://kawalpemilu.org#67488,"BANGGA, DOLO SELATAN, SIGI, SULAWESI TENGAH",1,46,152,198
https://kawalpemilu.org#67488,"BANGGA, DOLO SELATAN, SIGI, SULAWESI TENGAH",2,61,156,217
https://kawalpemilu.org#67488,"BANGGA, DOLO SELATAN, SIGI, SULAWESI TENGAH",3,41,83,124
https://kawalpemilu.org#67488,"BANGGA, DOLO SELATAN, SIGI, SULAWESI TENGAH",4,45,102,147
https://kawalpemilu.org#67488,"BANGGA, DOLO SELATAN, SIGI, SULAWESI TENGAH",5,44,142,1
https://kawalpemilu.org#67488,"BANGGA, DOLO SELATAN, SIGI, SULAWESI TENGAH",6,43,85,128
https://kawalpemilu.org#67488,"BANGGA, DOLO SELATAN, SIGI, SULAWESI TENGAH",7,59,123,182
https://kawalpemilu.org#67488,"BANGGA, DOLO SELATAN, SIGI, SULAWESI TENGAH",8,153,8,161
https://kawalpemilu.org#67489,"WALATANA, DOLO SELATAN, SIGI, SULAWESI TENGAH",1,31,152,183
https://kawalpemilu.org#67489,"WALATANA, DOLO SELATAN, SIGI, SULAWESI TENGAH",2,11,156,167
https://kawalpemilu.org#67489,"WALATANA, DOLO SELATAN, SIGI, SULAWESI TENGAH",3,24,78,102
https://kawalpemilu.org#67489,"WALATANA, DOLO SELATAN, SIGI, SULAWESI TENGAH",4,83,81,164
https://kawalpemilu.org#67489,"WALATANA, DOLO SELATAN, SIGI, SULAWESI TENGAH",5,54,95,149
https://kawalpemilu.org#67489,"WALATANA, DOLO SELATAN, SIGI, SULAWESI TENGAH",6,41,68,109
https://kawalpemilu.org#67490,"BULUBETE, DOLO SELATAN, SIGI, SULAWESI TENGAH",1,57,100,157
https://kawalpemilu.org#67490,"BULUBETE, DOLO SELATAN, SIGI, SULAWESI TENGAH",2,56,109,165
https://kawalpemilu.org#67490,"BULUBETE, DOLO SELATAN, SIGI, SULAWESI TENGAH",3,48,115,163
https://kawalpemilu.org#67490,"BULUBETE, DOLO SELATAN, SIGI, SULAWESI TENGAH",4,16,86,102
https://kawalpemilu.org#67490,"BULUBETE, DOLO SELATAN, SIGI, SULAWESI TENGAH",5,68,134,202
https://kawalpemilu.org#67490,"BULUBETE, DOLO SELATAN, SIGI, SULAWESI TENGAH",6,29,85,114
https://kawalpemilu.org#67491,"BALUASE, DOLO SELATAN, SIGI, SULAWESI TENGAH",1,14,142,156
https://kawalpemilu.org#67491,"BALUASE, DOLO SELATAN, SIGI, SULAWESI TENGAH",2,12,114,126
https://kawalpemilu.org#67491,"BALUASE, DOLO SELATAN, SIGI, SULAWESI TENGAH",3,23,136,159
https://kawalpemilu.org#67491,"BALUASE, DOLO SELATAN, SIGI, SULAWESI TENGAH",4,25,108,133
https://kawalpemilu.org#67491,"BALUASE, DOLO SELATAN, SIGI, SULAWESI TENGAH",5,25,108,133
https://kawalpemilu.org#67491,"BALUASE, DOLO SELATAN, SIGI, SULAWESI TENGAH",6,32,195,227
https://kawalpemilu.org#67491,"BALUASE, DOLO SELATAN, SIGI, SULAWESI TENGAH",7,68,43,111
https://kawalpemilu.org#67491,"BALUASE, DOLO SELATAN, SIGI, SULAWESI TENGAH",8,98,101,199
https://kawalpemilu.org#67492,"ROGO, DOLO SELATAN, SIGI, SULAWESI TENGAH",1,48,137,185
https://kawalpemilu.org#67492,"ROGO, DOLO SELATAN, SIGI, SULAWESI TENGAH",2,34,97,131
https://kawalpemilu.org#67492,"ROGO, DOLO SELATAN, SIGI, SULAWESI TENGAH",3,87,125,212
https://kawalpemilu.org#67492,"ROGO, DOLO SELATAN, SIGI, SULAWESI TENGAH",4,65,96,161
https://kawalpemilu.org#67492,"ROGO, DOLO SELATAN, SIGI, SULAWESI TENGAH",5,27,81,108
https://kawalpemilu.org#67492,"ROGO, DOLO SELATAN, SIGI, SULAWESI TENGAH",6,34,128,162
https://kawalpemilu.org#67493,"PULU, DOLO SELATAN, SIGI, SULAWESI TENGAH",1,27,229,256
https://kawalpemilu.org#67493,"PULU, DOLO SELATAN, SIGI, SULAWESI TENGAH",2,27,88,115
https://kawalpemilu.org#67493,"PULU, DOLO SELATAN, SIGI, SULAWESI TENGAH",3,30,158,188
https://kawalpemilu.org#67493,"PULU, DOLO SELATAN, SIGI, SULAWESI TENGAH",4,44,172,216
https://kawalpemilu.org#67494,"BALONGGA, DOLO SELATAN, SIGI, SULAWESI TENGAH",1,76,83,159
https://kawalpemilu.org#67494,"BALONGGA, DOLO SELATAN, SIGI, SULAWESI TENGAH",2,42,95,137
https://kawalpemilu.org#67494,"BALONGGA, DOLO SELATAN, SIGI, SULAWESI TENGAH",3,64,157,221
https://kawalpemilu.org#67495,"SAMBO, DOLO SELATAN, SIGI, SULAWESI TENGAH",1,83,86,169
https://kawalpemilu.org#67495,"SAMBO, DOLO SELATAN, SIGI, SULAWESI TENGAH",2,34,136,170
https://kawalpemilu.org#67495,"SAMBO, DOLO SELATAN, SIGI, SULAWESI TENGAH",3,91,99,190
https://kawalpemilu.org#67495,"SAMBO, DOLO SELATAN, SIGI, SULAWESI TENGAH",4,23,69,92
https://kawalpemilu.org#67496,"WISOLO, DOLO SELATAN, SIGI, SULAWESI TENGAH",1,58,82,140
https://kawalpemilu.org#67496,"WISOLO, DOLO SELATAN, SIGI, SULAWESI TENGAH",2,76,106,182
https://kawalpemilu.org#67496,"WISOLO, DOLO SELATAN, SIGI, SULAWESI TENGAH",3,156,30,186
https://kawalpemilu.org#67496,"WISOLO, DOLO SELATAN, SIGI, SULAWESI TENGAH",4,121,11,132
https://kawalpemilu.org#67497,"JONO, DOLO SELATAN, SIGI, SULAWESI TENGAH",1,189,18,207
https://kawalpemilu.org#67497,"JONO, DOLO SELATAN, SIGI, SULAWESI TENGAH",2,181,24,205
https://kawalpemilu.org#67498,"POI, DOLO SELATAN, SIGI, SULAWESI TENGAH",1,50,152,202
https://kawalpemilu.org#67498,"POI, DOLO SELATAN, SIGI, SULAWESI TENGAH",2,67,127,194
https://kawalpemilu.org#67498,"POI, DOLO SELATAN, SIGI, SULAWESI TENGAH",3,73,37,110
https://kawalpemilu.org#928666,"RAMBA, DOLO SELATAN, SIGI, SULAWESI TENGAH",1,64,75,139
https://kawalpemilu.org#928666,"RAMBA, DOLO SELATAN, SIGI, SULAWESI TENGAH",2,75,91,166
https://kawalpemilu.org#67500,"LAMBARA, TANAMBULAVA, SIGI, SULAWESI TENGAH",1,113,88,201
https://kawalpemilu.org#67500,"LAMBARA, TANAMBULAVA, SIGI, SULAWESI TENGAH",2,104,94,198
https://kawalpemilu.org#67500,"LAMBARA, TANAMBULAVA, SIGI, SULAWESI TENGAH",3,167,73,240
https://kawalpemilu.org#67500,"LAMBARA, TANAMBULAVA, SIGI, SULAWESI TENGAH",4,176,50,226
https://kawalpemilu.org#67501,"SIBALAYA SELATAN, TANAMBULAVA, SIGI, SULAWESI TENGAH",1,71,60,131
https://kawalpemilu.org#67501,"SIBALAYA SELATAN, TANAMBULAVA, SIGI, SULAWESI TENGAH",2,92,44,136
https://kawalpemilu.org#67501,"SIBALAYA SELATAN, TANAMBULAVA, SIGI, SULAWESI TENGAH",3,125,93,218
https://kawalpemilu.org#67502,"SIBALAYA UTARA, TANAMBULAVA, SIGI, SULAWESI TENGAH",1,128,127,255
https://kawalpemilu.org#67502,"SIBALAYA UTARA, TANAMBULAVA, SIGI, SULAWESI TENGAH",2,64,85,171
https://kawalpemilu.org#67502,"SIBALAYA UTARA, TANAMBULAVA, SIGI, SULAWESI TENGAH",3,79,80,159
https://kawalpemilu.org#67502,"SIBALAYA UTARA, TANAMBULAVA, SIGI, SULAWESI TENGAH",4,81,65,146
https://kawalpemilu.org#67502,"SIBALAYA UTARA, TANAMBULAVA, SIGI, SULAWESI TENGAH",5,80,71,151
https://kawalpemilu.org#67502,"SIBALAYA UTARA, TANAMBULAVA, SIGI, SULAWESI TENGAH",6,108,54,162
https://kawalpemilu.org#67502,"SIBALAYA UTARA, TANAMBULAVA, SIGI, SULAWESI TENGAH",7,60,60,120
https://kawalpemilu.org#67503,"SIBOWI, TANAMBULAVA, SIGI, SULAWESI TENGAH",1,143,124,267
https://kawalpemilu.org#67503,"SIBOWI, TANAMBULAVA, SIGI, SULAWESI TENGAH",2,112,126,238
https://kawalpemilu.org#67503,"SIBOWI, TANAMBULAVA, SIGI, SULAWESI TENGAH",3,113,83,196
https://kawalpemilu.org#67503,"SIBOWI, TANAMBULAVA, SIGI, SULAWESI TENGAH",4,52,65,117
https://kawalpemilu.org#67503,"SIBOWI, TANAMBULAVA, SIGI, SULAWESI TENGAH",5,70,50,120
https://kawalpemilu.org#67503,"SIBOWI, TANAMBULAVA, SIGI, SULAWESI TENGAH",6,84,58,142
https://kawalpemilu.org#67503,"SIBOWI, TANAMBULAVA, SIGI, SULAWESI TENGAH",8,74,101,175
https://kawalpemilu.org#67503,"SIBOWI, TANAMBULAVA, SIGI, SULAWESI TENGAH",9,107,52,159
https://kawalpemilu.org#67503,"SIBOWI, TANAMBULAVA, SIGI, SULAWESI TENGAH",10,104,61,165
https://kawalpemilu.org#67503,"SIBOWI, TANAMBULAVA, SIGI, SULAWESI TENGAH",11,86,54,140
https://kawalpemilu.org#67503,"SIBOWI, TANAMBULAVA, SIGI, SULAWESI TENGAH",12,133,52,185
https://kawalpemilu.org#928667,"SIBALAYA BARAT, TANAMBULAVA, SIGI, SULAWESI TENGAH",1,124,39,163
https://kawalpemilu.org#928667,"SIBALAYA BARAT, TANAMBULAVA, SIGI, SULAWESI TENGAH",2,126,49,175
https://kawalpemilu.org#928667,"SIBALAYA BARAT, TANAMBULAVA, SIGI, SULAWESI TENGAH",3,109,84,193
https://kawalpemilu.org#928667,"SIBALAYA BARAT, TANAMBULAVA, SIGI, SULAWESI TENGAH",4,121,30,2
https://kawalpemilu.org#928667,"SIBALAYA BARAT, TANAMBULAVA, SIGI, SULAWESI TENGAH",5,103,26,129
https://kawalpemilu.org#67505,"SIBONU, DOLO BARAT, SIGI, SULAWESI TENGAH",1,45,130,175
https://kawalpemilu.org#67505,"SIBONU, DOLO BARAT, SIGI, SULAWESI TENGAH",2,56,130,186
https://kawalpemilu.org#67506,"KALUKU TINGGU, DOLO BARAT, SIGI, SULAWESI TENGAH",1,76,77,153
https://kawalpemilu.org#67506,"KALUKU TINGGU, DOLO BARAT, SIGI, SULAWESI TENGAH",2,91,54,145
https://kawalpemilu.org#67507,"PEWUNU, DOLO BARAT, SIGI, SULAWESI TENGAH",1,51,173,224
https://kawalpemilu.org#67507,"PEWUNU, DOLO BARAT, SIGI, SULAWESI TENGAH",2,29,110,139
https://kawalpemilu.org#67507,"PEWUNU, DOLO BARAT, SIGI, SULAWESI TENGAH",3,26,118,144
https://kawalpemilu.org#67507,"PEWUNU, DOLO BARAT, SIGI, SULAWESI TENGAH",4,26,113,139
https://kawalpemilu.org#67507,"PEWUNU, DOLO BARAT, SIGI, SULAWESI TENGAH",5,49,112,161
https://kawalpemilu.org#67507,"PEWUNU, DOLO BARAT, SIGI, SULAWESI TENGAH",6,34,136,0
https://kawalpemilu.org#67508,"KALEKE, DOLO BARAT, SIGI, SULAWESI TENGAH",1,18,122,140
https://kawalpemilu.org#67508,"KALEKE, DOLO BARAT, SIGI, SULAWESI TENGAH",2,26,96,122
https://kawalpemilu.org#67508,"KALEKE, DOLO BARAT, SIGI, SULAWESI TENGAH",3,27,105,132
https://kawalpemilu.org#67508,"KALEKE, DOLO BARAT, SIGI, SULAWESI TENGAH",4,16,136,152
https://kawalpemilu.org#67508,"KALEKE, DOLO BARAT, SIGI, SULAWESI TENGAH",5,28,207,235
https://kawalpemilu.org#67508,"KALEKE, DOLO BARAT, SIGI, SULAWESI TENGAH",6,41,198,239
https://kawalpemilu.org#67508,"KALEKE, DOLO BARAT, SIGI, SULAWESI TENGAH",7,31,155,186
https://kawalpemilu.org#67508,"KALEKE, DOLO BARAT, SIGI, SULAWESI TENGAH",8,70,109,179
https://kawalpemilu.org#67508,"KALEKE, DOLO BARAT, SIGI, SULAWESI TENGAH",9,40,139,179
https://kawalpemilu.org#67509,"RARAMPADENDE, DOLO BARAT, SIGI, SULAWESI TENGAH",1,56,90,146
https://kawalpemilu.org#67509,"RARAMPADENDE, DOLO BARAT, SIGI, SULAWESI TENGAH",2,72,119,191
https://kawalpemilu.org#67509,"RARAMPADENDE, DOLO BARAT, SIGI, SULAWESI TENGAH",3,66,96,162
https://kawalpemilu.org#67509,"RARAMPADENDE, DOLO BARAT, SIGI, SULAWESI TENGAH",4,72,75,147
https://kawalpemilu.org#67509,"RARAMPADENDE, DOLO BARAT, SIGI, SULAWESI TENGAH",5,43,100,143
https://kawalpemilu.org#67509,"RARAMPADENDE, DOLO BARAT, SIGI, SULAWESI TENGAH",6,69,120,188
https://kawalpemilu.org#67509,"RARAMPADENDE, DOLO BARAT, SIGI, SULAWESI TENGAH",7,37,64,101
https://kawalpemilu.org#67509,"RARAMPADENDE, DOLO BARAT, SIGI, SULAWESI TENGAH",8,56,72,128
https://kawalpemilu.org#67510,"BALUMPEWA, DOLO BARAT, SIGI, SULAWESI TENGAH",1,200,16,216
https://kawalpemilu.org#67510,"BALUMPEWA, DOLO BARAT, SIGI, SULAWESI TENGAH",2,197,4,201
https://kawalpemilu.org#67511,"BALAMOA, DOLO BARAT, SIGI, SULAWESI TENGAH",1,101,56,157
https://kawalpemilu.org#67511,"BALAMOA, DOLO BARAT, SIGI, SULAWESI TENGAH",2,59,52,111
https://kawalpemilu.org#67511,"BALAMOA, DOLO BARAT, SIGI, SULAWESI TENGAH",3,144,26,170
https://kawalpemilu.org#67511,"BALAMOA, DOLO BARAT, SIGI, SULAWESI TENGAH",4,151,12,163
https://kawalpemilu.org#67512,"PESAKU, DOLO BARAT, SIGI, SULAWESI TENGAH",1,19,136,155
https://kawalpemilu.org#67512,"PESAKU, DOLO BARAT, SIGI, SULAWESI TENGAH",2,24,132,156
https://kawalpemilu.org#67512,"PESAKU, DOLO BARAT, SIGI, SULAWESI TENGAH",3,23,105,128
https://kawalpemilu.org#67512,"PESAKU, DOLO BARAT, SIGI, SULAWESI TENGAH",4,19,87,106
https://kawalpemilu.org#67512,"PESAKU, DOLO BARAT, SIGI, SULAWESI TENGAH",5,22,92,114
https://kawalpemilu.org#67512,"PESAKU, DOLO BARAT, SIGI, SULAWESI TENGAH",6,20,82,102
https://kawalpemilu.org#67512,"PESAKU, DOLO BARAT, SIGI, SULAWESI TENGAH",7,29,98,127
https://kawalpemilu.org#67512,"PESAKU, DOLO BARAT, SIGI, SULAWESI TENGAH",8,30,88,118
https://kawalpemilu.org#67513,"MANTIKOLE, DOLO BARAT, SIGI, SULAWESI TENGAH",2,70,51,121
https://kawalpemilu.org#67513,"MANTIKOLE, DOLO BARAT, SIGI, SULAWESI TENGAH",3,78,49,127
https://kawalpemilu.org#67513,"MANTIKOLE, DOLO BARAT, SIGI, SULAWESI TENGAH",4,83,59,142
https://kawalpemilu.org#67513,"MANTIKOLE, DOLO BARAT, SIGI, SULAWESI TENGAH",5,133,41,174
https://kawalpemilu.org#67513,"MANTIKOLE, DOLO BARAT, SIGI, SULAWESI TENGAH",6,63,2,65
https://kawalpemilu.org#67514,"BOBO, DOLO BARAT, SIGI, SULAWESI TENGAH",1,40,146,186
https://kawalpemilu.org#67514,"BOBO, DOLO BARAT, SIGI, SULAWESI TENGAH",2,62,73,135
https://kawalpemilu.org#67514,"BOBO, DOLO BARAT, SIGI, SULAWESI TENGAH",3,57,100,157
https://kawalpemilu.org#67514,"BOBO, DOLO BARAT, SIGI, SULAWESI TENGAH",4,73,85,158
https://kawalpemilu.org#928668,"BALAROA PEWENU, DOLO BARAT, SIGI, SULAWESI TENGAH",1,88,155,243
https://kawalpemilu.org#928668,"BALAROA PEWENU, DOLO BARAT, SIGI, SULAWESI TENGAH",2,106,163,269
https://kawalpemilu.org#928669,"LUKU, DOLO BARAT, SIGI, SULAWESI TENGAH",1,50,86,136
https://kawalpemilu.org#928669,"LUKU, DOLO BARAT, SIGI, SULAWESI TENGAH",2,37,140,177
https://kawalpemilu.org#67516,"TULO, DOLO, SIGI, SULAWESI TENGAH",1,41,111,152
https://kawalpemilu.org#67516,"TULO, DOLO, SIGI, SULAWESI TENGAH",2,41,98,139
https://kawalpemilu.org#67516,"TULO, DOLO, SIGI, SULAWESI TENGAH",3,71,119,190
https://kawalpemilu.org#67516,"TULO, DOLO, SIGI, SULAWESI TENGAH",4,69,106,175
https://kawalpemilu.org#67516,"TULO, DOLO, SIGI, SULAWESI TENGAH",5,43,79,122
https://kawalpemilu.org#67516,"TULO, DOLO, SIGI, SULAWESI TENGAH",6,92,103,195
https://kawalpemilu.org#67516,"TULO, DOLO, SIGI, SULAWESI TENGAH",7,38,147,185
https://kawalpemilu.org#67516,"TULO, DOLO, SIGI, SULAWESI TENGAH",8,21,57,78
https://kawalpemilu.org#67516,"TULO, DOLO, SIGI, SULAWESI TENGAH",9,87,129,215
https://kawalpemilu.org#67516,"TULO, DOLO, SIGI, SULAWESI TENGAH",10,133,74,207
https://kawalpemilu.org#67516,"TULO, DOLO, SIGI, SULAWESI TENGAH",11,56,88,144
https://kawalpemilu.org#67516,"TULO, DOLO, SIGI, SULAWESI TENGAH",12,62,111,173
https://kawalpemilu.org#67516,"TULO, DOLO, SIGI, SULAWESI TENGAH",13,27,157,184
https://kawalpemilu.org#67517,"LANGALESO, DOLO, SIGI, SULAWESI TENGAH",1,80,122,202
https://kawalpemilu.org#67517,"LANGALESO, DOLO, SIGI, SULAWESI TENGAH",2,43,92,135
https://kawalpemilu.org#67517,"LANGALESO, DOLO, SIGI, SULAWESI TENGAH",3,36,123,159
https://kawalpemilu.org#67517,"LANGALESO, DOLO, SIGI, SULAWESI TENGAH",4,32,119,151
https://kawalpemilu.org#67517,"LANGALESO, DOLO, SIGI, SULAWESI TENGAH",5,23,120,148
https://kawalpemilu.org#67517,"LANGALESO, DOLO, SIGI, SULAWESI TENGAH",6,28,132,160
https://kawalpemilu.org#67517,"LANGALESO, DOLO, SIGI, SULAWESI TENGAH",7,28,156,184
https://kawalpemilu.org#67517,"LANGALESO, DOLO, SIGI, SULAWESI TENGAH",8,51,137,188
https://kawalpemilu.org#67517,"LANGALESO, DOLO, SIGI, SULAWESI TENGAH",9,25,50,75
https://kawalpemilu.org#67517,"LANGALESO, DOLO, SIGI, SULAWESI TENGAH",10,52,104,156
https://kawalpemilu.org#67518,"WATUBULA, DOLO, SIGI, SULAWESI TENGAH",1,184,19,203
https://kawalpemilu.org#67518,"WATUBULA, DOLO, SIGI, SULAWESI TENGAH",2,210,25,235
https://kawalpemilu.org#67518,"WATUBULA, DOLO, SIGI, SULAWESI TENGAH",3,162,28,190
https://kawalpemilu.org#67518,"WATUBULA, DOLO, SIGI, SULAWESI TENGAH",4,168,11,179
https://kawalpemilu.org#67519,"SOULOWE, DOLO, SIGI, SULAWESI TENGAH",1,61,67,128
https://kawalpemilu.org#67519,"SOULOWE, DOLO, SIGI, SULAWESI TENGAH",2,54,90,144
https://kawalpemilu.org#67519,"SOULOWE, DOLO, SIGI, SULAWESI TENGAH",3,104,113,217
https://kawalpemilu.org#67519,"SOULOWE, DOLO, SIGI, SULAWESI TENGAH",4,24,132,156
https://kawalpemilu.org#67519,"SOULOWE, DOLO, SIGI, SULAWESI TENGAH",5,109,134,243
https://kawalpemilu.org#67520,"KARAWANA, DOLO, SIGI, SULAWESI TENGAH",1,33,101,128
https://kawalpemilu.org#67520,"KARAWANA, DOLO, SIGI, SULAWESI TENGAH",2,61,88,149
https://kawalpemilu.org#67520,"KARAWANA, DOLO, SIGI, SULAWESI TENGAH",3,20,91,111
https://kawalpemilu.org#67520,"KARAWANA, DOLO, SIGI, SULAWESI TENGAH",4,61,126,187
https://kawalpemilu.org#67520,"KARAWANA, DOLO, SIGI, SULAWESI TENGAH",5,57,129,186
https://kawalpemilu.org#67520,"KARAWANA, DOLO, SIGI, SULAWESI TENGAH",6,47,142,189
https://kawalpemilu.org#67520,"KARAWANA, DOLO, SIGI, SULAWESI TENGAH",7,73,28,101
https://kawalpemilu.org#67521,"KOTAPULU, DOLO, SIGI, SULAWESI TENGAH",1,28,138,166
https://kawalpemilu.org#67521,"KOTAPULU, DOLO, SIGI, SULAWESI TENGAH",2,24,140,164
https://kawalpemilu.org#67521,"KOTAPULU, DOLO, SIGI, SULAWESI TENGAH",3,48,185,233
https://kawalpemilu.org#67521,"KOTAPULU, DOLO, SIGI, SULAWESI TENGAH",4,50,171,221
https://kawalpemilu.org#67521,"KOTAPULU, DOLO, SIGI, SULAWESI TENGAH",5,47,132,179
https://kawalpemilu.org#67521,"KOTAPULU, DOLO, SIGI, SULAWESI TENGAH",6,46,162,208
https://kawalpemilu.org#67522,"KOTARINDAU, DOLO, SIGI, SULAWESI TENGAH",1,30,212,242
https://kawalpemilu.org#67522,"KOTARINDAU, DOLO, SIGI, SULAWESI TENGAH",2,48,210,258
https://kawalpemilu.org#67522,"KOTARINDAU, DOLO, SIGI, SULAWESI TENGAH",3,38,197,235
https://kawalpemilu.org#67522,"KOTARINDAU, DOLO, SIGI, SULAWESI TENGAH",4,30,135,165
https://kawalpemilu.org#67522,"KOTARINDAU, DOLO, SIGI, SULAWESI TENGAH",5,42,169,211
https://kawalpemilu.org#67522,"KOTARINDAU, DOLO, SIGI, SULAWESI TENGAH",6,45,146,191
https://kawalpemilu.org#67522,"KOTARINDAU, DOLO, SIGI, SULAWESI TENGAH",7,35,208,243
https://kawalpemilu.org#67522,"KOTARINDAU, DOLO, SIGI, SULAWESI TENGAH",8,24,242,266
https://kawalpemilu.org#67522,"KOTARINDAU, DOLO, SIGI, SULAWESI TENGAH",9,37,183,220
https://kawalpemilu.org#67522,"KOTARINDAU, DOLO, SIGI, SULAWESI TENGAH",10,31,173,204
https://kawalpemilu.org#67523,"WATURALELE, DOLO, SIGI, SULAWESI TENGAH",1,188,19,207
https://kawalpemilu.org#67523,"WATURALELE, DOLO, SIGI, SULAWESI TENGAH",2,194,13,207
https://kawalpemilu.org#67523,"WATURALELE, DOLO, SIGI, SULAWESI TENGAH",3,169,9,178
https://kawalpemilu.org#67524,"MAKU, DOLO, SIGI, SULAWESI TENGAH",1,86,95,181
https://kawalpemilu.org#67524,"MAKU, DOLO, SIGI, SULAWESI TENGAH",2,71,72,143
https://kawalpemilu.org#67524,"MAKU, DOLO, SIGI, SULAWESI TENGAH",3,129,122,251
https://kawalpemilu.org#67524,"MAKU, DOLO, SIGI, SULAWESI TENGAH",4,160,65,225
https://kawalpemilu.org#67524,"MAKU, DOLO, SIGI, SULAWESI TENGAH",5,0,0,0
https://kawalpemilu.org#67525,"POTOYA, DOLO, SIGI, SULAWESI TENGAH",1,60,192,252
https://kawalpemilu.org#67525,"POTOYA, DOLO, SIGI, SULAWESI TENGAH",2,95,145,240
https://kawalpemilu.org#67525,"POTOYA, DOLO, SIGI, SULAWESI TENGAH",3,104,111,115
https://kawalpemilu.org#67525,"POTOYA, DOLO, SIGI, SULAWESI TENGAH",4,126,110,236
https://kawalpemilu.org#67526,"KABOBONA, DOLO, SIGI, SULAWESI TENGAH",1,101,148,249
https://kawalpemilu.org#67526,"KABOBONA, DOLO, SIGI, SULAWESI TENGAH",2,52,133,185
https://kawalpemilu.org#67526,"KABOBONA, DOLO, SIGI, SULAWESI TENGAH",3,44,142,186
https://kawalpemilu.org#67526,"KABOBONA, DOLO, SIGI, SULAWESI TENGAH",4,65,118,183
https://kawalpemilu.org#67526,"KABOBONA, DOLO, SIGI, SULAWESI TENGAH",5,88,163,251
https://kawalpemilu.org#67526,"KABOBONA, DOLO, SIGI, SULAWESI TENGAH",6,73,118,191
https://kawalpemilu.org#67528,"PORAME, KINOVARO, SIGI, SULAWESI TENGAH",1,101,111,212
https://kawalpemilu.org#67528,"PORAME, KINOVARO, SIGI, SULAWESI TENGAH",2,25,143,168
https://kawalpemilu.org#67528,"PORAME, KINOVARO, SIGI, SULAWESI TENGAH",3,50,117,167
https://kawalpemilu.org#67528,"PORAME, KINOVARO, SIGI, SULAWESI TENGAH",4,34,157,191
https://kawalpemilu.org#67528,"PORAME, KINOVARO, SIGI, SULAWESI TENGAH",5,49,158,207
https://kawalpemilu.org#67528,"PORAME, KINOVARO, SIGI, SULAWESI TENGAH",6,55,130,185
https://kawalpemilu.org#67529,"BALANE, KINOVARO, SIGI, SULAWESI TENGAH",1,60,125,185
https://kawalpemilu.org#67529,"BALANE, KINOVARO, SIGI, SULAWESI TENGAH",2,35,137,172
https://kawalpemilu.org#67529,"BALANE, KINOVARO, SIGI, SULAWESI TENGAH",3,60,84,144
https://kawalpemilu.org#67529,"BALANE, KINOVARO, SIGI, SULAWESI TENGAH",4,62,88,150
https://kawalpemilu.org#67529,"BALANE, KINOVARO, SIGI, SULAWESI TENGAH",5,60,19,79
https://kawalpemilu.org#67530,"UWEMANJE, KINOVARO, SIGI, SULAWESI TENGAH",1,115,79,194
https://kawalpemilu.org#67530,"UWEMANJE, KINOVARO, SIGI, SULAWESI TENGAH",2,90,52,142
https://kawalpemilu.org#67530,"UWEMANJE, KINOVARO, SIGI, SULAWESI TENGAH",3,152,10,162
https://kawalpemilu.org#67530,"UWEMANJE, KINOVARO, SIGI, SULAWESI TENGAH",4,127,19,146
https://kawalpemilu.org#67530,"UWEMANJE, KINOVARO, SIGI, SULAWESI TENGAH",5,168,7,175
https://kawalpemilu.org#67531,"RONDINGO, KINOVARO, SIGI, SULAWESI TENGAH",1,140,29,169
https://kawalpemilu.org#67531,"RONDINGO, KINOVARO, SIGI, SULAWESI TENGAH",2,143,34,177
https://kawalpemilu.org#67532,"DODA, KINOVARO, SIGI, SULAWESI TENGAH",1,16,105,121
https://kawalpemilu.org#67532,"DODA, KINOVARO, SIGI, SULAWESI TENGAH",2,46,163,209
https://kawalpemilu.org#67532,"DODA, KINOVARO, SIGI, SULAWESI TENGAH",3,104,112,216
https://kawalpemilu.org#67532,"DODA, KINOVARO, SIGI, SULAWESI TENGAH",4,76,61,137
https://kawalpemilu.org#67532,"DODA, KINOVARO, SIGI, SULAWESI TENGAH",5,34,167,201
https://kawalpemilu.org#67533,"KALORA, KINOVARO, SIGI, SULAWESI TENGAH",1,56,106,162
https://kawalpemilu.org#67533,"KALORA, KINOVARO, SIGI, SULAWESI TENGAH",2,37,45,82
https://kawalpemilu.org#67533,"KALORA, KINOVARO, SIGI, SULAWESI TENGAH",3,113,105,218
https://kawalpemilu.org#67533,"KALORA, KINOVARO, SIGI, SULAWESI TENGAH",4,33,91,124
https://kawalpemilu.org#67533,"KALORA, KINOVARO, SIGI, SULAWESI TENGAH",5,6,122,128
https://kawalpemilu.org#67533,"KALORA, KINOVARO, SIGI, SULAWESI TENGAH",6,7,96,103
https://kawalpemilu.org#67534,"KANUNA, KINOVARO, SIGI, SULAWESI TENGAH",1,65,123,188
https://kawalpemilu.org#67534,"KANUNA, KINOVARO, SIGI, SULAWESI TENGAH",2,67,113,180
https://kawalpemilu.org#67534,"KANUNA, KINOVARO, SIGI, SULAWESI TENGAH",3,19,155,174
https://kawalpemilu.org#67534,"KANUNA, KINOVARO, SIGI, SULAWESI TENGAH",4,29,74,103
https://kawalpemilu.org#67535,"DAENGGUNE, KINOVARO, SIGI, SULAWESI TENGAH",1,98,112,210
https://kawalpemilu.org#67535,"DAENGGUNE, KINOVARO, SIGI, SULAWESI TENGAH",2,84,106,190
https://kawalpemilu.org#67535,"DAENGGUNE, KINOVARO, SIGI, SULAWESI TENGAH",3,35,98,133
https://kawalpemilu.org#85745,"BOLOBIA, KINOVARO, SIGI, SULAWESI TENGAH",1,152,19,171
https://kawalpemilu.org#928670,"KAYUMPIA, KINOVARO, SIGI, SULAWESI TENGAH",1,162,7,169
https://kawalpemilu.org#928670,"KAYUMPIA, KINOVARO, SIGI, SULAWESI TENGAH",2,98,21,119
https://kawalpemilu.org#67537,"LEBANU, MARAWOLA, SIGI, SULAWESI TENGAH",1,144,20,164
https://kawalpemilu.org#67537,"LEBANU, MARAWOLA, SIGI, SULAWESI TENGAH",2,124,14,134
https://kawalpemilu.org#67538,"BEKA, MARAWOLA, SIGI, SULAWESI TENGAH",1,54,121,175
https://kawalpemilu.org#67538,"BEKA, MARAWOLA, SIGI, SULAWESI TENGAH",2,61,121,182
https://kawalpemilu.org#67538,"BEKA, MARAWOLA, SIGI, SULAWESI TENGAH",3,43,82,125
https://kawalpemilu.org#67538,"BEKA, MARAWOLA, SIGI, SULAWESI TENGAH",4,46,120,166
https://kawalpemilu.org#67538,"BEKA, MARAWOLA, SIGI, SULAWESI TENGAH",5,34,94,128
https://kawalpemilu.org#67538,"BEKA, MARAWOLA, SIGI, SULAWESI TENGAH",6,59,110,169
https://kawalpemilu.org#67538,"BEKA, MARAWOLA, SIGI, SULAWESI TENGAH",7,49,113,162
https://kawalpemilu.org#67538,"BEKA, MARAWOLA, SIGI, SULAWESI TENGAH",8,67,99,166
https://kawalpemilu.org#67538,"BEKA, MARAWOLA, SIGI, SULAWESI TENGAH",9,64,106,170
https://kawalpemilu.org#67538,"BEKA, MARAWOLA, SIGI, SULAWESI TENGAH",10,62,103,165
https://kawalpemilu.org#67539,"SIBEDI, MARAWOLA, SIGI, SULAWESI TENGAH",1,59,74,133
https://kawalpemilu.org#67539,"SIBEDI, MARAWOLA, SIGI, SULAWESI TENGAH",2,58,65,123
https://kawalpemilu.org#67539,"SIBEDI, MARAWOLA, SIGI, SULAWESI TENGAH",3,49,105,154
https://kawalpemilu.org#67539,"SIBEDI, MARAWOLA, SIGI, SULAWESI TENGAH",4,43,82,125
https://kawalpemilu.org#67539,"SIBEDI, MARAWOLA, SIGI, SULAWESI TENGAH",5,60,46,106
https://kawalpemilu.org#67539,"SIBEDI, MARAWOLA, SIGI, SULAWESI TENGAH",7,101,9,110
https://kawalpemilu.org#67540,"PADENDE, MARAWOLA, SIGI, SULAWESI TENGAH",1,51,122,173
https://kawalpemilu.org#67540,"PADENDE, MARAWOLA, SIGI, SULAWESI TENGAH",2,89,109,198
https://kawalpemilu.org#67540,"PADENDE, MARAWOLA, SIGI, SULAWESI TENGAH",3,45,85,130
https://kawalpemilu.org#67540,"PADENDE, MARAWOLA, SIGI, SULAWESI TENGAH",4,69,148,217
https://kawalpemilu.org#67541,"SUNJU, MARAWOLA, SIGI, SULAWESI TENGAH",1,47,125,172
https://kawalpemilu.org#67541,"SUNJU, MARAWOLA, SIGI, SULAWESI TENGAH",2,31,121,152
https://kawalpemilu.org#67541,"SUNJU, MARAWOLA, SIGI, SULAWESI TENGAH",3,64,165,229
https://kawalpemilu.org#67541,"SUNJU, MARAWOLA, SIGI, SULAWESI TENGAH",4,31,101,132
https://kawalpemilu.org#67541,"SUNJU, MARAWOLA, SIGI, SULAWESI TENGAH",5,77,110,187
https://kawalpemilu.org#67542,"TINGGEDE, MARAWOLA, SIGI, SULAWESI TENGAH",1,67,125,192
https://kawalpemilu.org#67542,"TINGGEDE, MARAWOLA, SIGI, SULAWESI TENGAH",2,71,111,182
https://kawalpemilu.org#67542,"TINGGEDE, MARAWOLA, SIGI, SULAWESI TENGAH",3,35,127,162
https://kawalpemilu.org#67542,"TINGGEDE, MARAWOLA, SIGI, SULAWESI TENGAH",4,47,106,153
https://kawalpemilu.org#67542,"TINGGEDE, MARAWOLA, SIGI, SULAWESI TENGAH",5,51,89,140
https://kawalpemilu.org#67542,"TINGGEDE, MARAWOLA, SIGI, SULAWESI TENGAH",6,39,145,184
https://kawalpemilu.org#67542,"TINGGEDE, MARAWOLA, SIGI, SULAWESI TENGAH",7,36,102,138
https://kawalpemilu.org#67542,"TINGGEDE, MARAWOLA, SIGI, SULAWESI TENGAH",8,32,95,127
https://kawalpemilu.org#67542,"TINGGEDE, MARAWOLA, SIGI, SULAWESI TENGAH",9,44,169,213
https://kawalpemilu.org#67542,"TINGGEDE, MARAWOLA, SIGI, SULAWESI TENGAH",10,66,88,154
https://kawalpemilu.org#67542,"TINGGEDE, MARAWOLA, SIGI, SULAWESI TENGAH",11,71,106,177
https://kawalpemilu.org#67542,"TINGGEDE, MARAWOLA, SIGI, SULAWESI TENGAH",12,63,76,139
https://kawalpemilu.org#67542,"TINGGEDE, MARAWOLA, SIGI, SULAWESI TENGAH",13,41,122,163
https://kawalpemilu.org#67542,"TINGGEDE, MARAWOLA, SIGI, SULAWESI TENGAH",14,41,139,180
https://kawalpemilu.org#67542,"TINGGEDE, MARAWOLA, SIGI, SULAWESI TENGAH",15,69,131,200
https://kawalpemilu.org#67542,"TINGGEDE, MARAWOLA, SIGI, SULAWESI TENGAH",16,47,90,137
https://kawalpemilu.org#67542,"TINGGEDE, MARAWOLA, SIGI, SULAWESI TENGAH",17,69,62,131
https://kawalpemilu.org#67542,"TINGGEDE, MARAWOLA, SIGI, SULAWESI TENGAH",18,68,78,146
https://kawalpemilu.org#67542,"TINGGEDE, MARAWOLA, SIGI, SULAWESI TENGAH",19,117,129,246
https://kawalpemilu.org#67542,"TINGGEDE, MARAWOLA, SIGI, SULAWESI TENGAH",20,95,95,190
https://kawalpemilu.org#67542,"TINGGEDE, MARAWOLA, SIGI, SULAWESI TENGAH",21,59,110,169
https://kawalpemilu.org#67542,"TINGGEDE, MARAWOLA, SIGI, SULAWESI TENGAH",22,76,110,186
https://kawalpemilu.org#67542,"TINGGEDE, MARAWOLA, SIGI, SULAWESI TENGAH",23,49,79,128
https://kawalpemilu.org#67543,"BALIASE, MARAWOLA, SIGI, SULAWESI TENGAH",1,54,178,232
https://kawalpemilu.org#67543,"BALIASE, MARAWOLA, SIGI, SULAWESI TENGAH",2,58,177,235
https://kawalpemilu.org#67543,"BALIASE, MARAWOLA, SIGI, SULAWESI TENGAH",3,65,146,211
https://kawalpemilu.org#67543,"BALIASE, MARAWOLA, SIGI, SULAWESI TENGAH",4,54,158,212
https://kawalpemilu.org#67543,"BALIASE, MARAWOLA, SIGI, SULAWESI TENGAH",5,49,77,126
https://kawalpemilu.org#67543,"BALIASE, MARAWOLA, SIGI, SULAWESI TENGAH",6,57,88,145
https://kawalpemilu.org#67543,"BALIASE, MARAWOLA, SIGI, SULAWESI TENGAH",7,39,115,154
https://kawalpemilu.org#67543,"BALIASE, MARAWOLA, SIGI, SULAWESI TENGAH",8,38,96,134
https://kawalpemilu.org#67543,"BALIASE, MARAWOLA, SIGI, SULAWESI TENGAH",9,30,120,150
https://kawalpemilu.org#67543,"BALIASE, MARAWOLA, SIGI, SULAWESI TENGAH",10,37,111,148
https://kawalpemilu.org#67543,"BALIASE, MARAWOLA, SIGI, SULAWESI TENGAH",11,25,74,99
https://kawalpemilu.org#67543,"BALIASE, MARAWOLA, SIGI, SULAWESI TENGAH",12,51,83,134
https://kawalpemilu.org#67544,"BINANGGA, MARAWOLA, SIGI, SULAWESI TENGAH",1,25,102,127
https://kawalpemilu.org#67544,"BINANGGA, MARAWOLA, SIGI, SULAWESI TENGAH",2,47,153,200
https://kawalpemilu.org#67544,"BINANGGA, MARAWOLA, SIGI, SULAWESI TENGAH",3,23,122,145
https://kawalpemilu.org#67544,"BINANGGA, MARAWOLA, SIGI, SULAWESI TENGAH",4,25,112,137
https://kawalpemilu.org#67544,"BINANGGA, MARAWOLA, SIGI, SULAWESI TENGAH",5,13,102,115
https://kawalpemilu.org#67544,"BINANGGA, MARAWOLA, SIGI, SULAWESI TENGAH",6,39,161,200
https://kawalpemilu.org#67544,"BINANGGA, MARAWOLA, SIGI, SULAWESI TENGAH",7,16,113,129
https://kawalpemilu.org#67544,"BINANGGA, MARAWOLA, SIGI, SULAWESI TENGAH",8,39,165,204
https://kawalpemilu.org#67544,"BINANGGA, MARAWOLA, SIGI, SULAWESI TENGAH",9,40,159,199
https://kawalpemilu.org#67544,"BINANGGA, MARAWOLA, SIGI, SULAWESI TENGAH",10,57,163,220
https://kawalpemilu.org#67545,"BOYABALIASE, MARAWOLA, SIGI, SULAWESI TENGAH",1,48,207,255
https://kawalpemilu.org#67545,"BOYABALIASE, MARAWOLA, SIGI, SULAWESI TENGAH",2,18,126,144
https://kawalpemilu.org#67545,"BOYABALIASE, MARAWOLA, SIGI, SULAWESI TENGAH",3,34,92,126
https://kawalpemilu.org#67546,"TINGGEDE SELATAN, MARAWOLA, SIGI, SULAWESI TENGAH",1,23,110,133
https://kawalpemilu.org#67546,"TINGGEDE SELATAN, MARAWOLA, SIGI, SULAWESI TENGAH",2,44,100,144
https://kawalpemilu.org#67546,"TINGGEDE SELATAN, MARAWOLA, SIGI, SULAWESI TENGAH",3,58,155,213
https://kawalpemilu.org#67546,"TINGGEDE SELATAN, MARAWOLA, SIGI, SULAWESI TENGAH",4,42,147,181
https://kawalpemilu.org#67546,"TINGGEDE SELATAN, MARAWOLA, SIGI, SULAWESI TENGAH",5,59,150,209
https://kawalpemilu.org#67546,"TINGGEDE SELATAN, MARAWOLA, SIGI, SULAWESI TENGAH",6,66,110,176
https://kawalpemilu.org#89679,"BOMBA, MARAWOLA, SIGI, SULAWESI TENGAH",1,88,129,217
https://kawalpemilu.org#89679,"BOMBA, MARAWOLA, SIGI, SULAWESI TENGAH",2,71,131,202
https://kawalpemilu.org#67548,"WAYU, MARAWOLA BARAT, SIGI, SULAWESI TENGAH",1,204,25,229
https://kawalpemilu.org#67549,"TAIPANGGABE, MARAWOLA BARAT, SIGI, SULAWESI TENGAH",1,121,4,125
https://kawalpemilu.org#67550,"MATANTIMALI, MARAWOLA BARAT, SIGI, SULAWESI TENGAH",1,164,11,175
https://kawalpemilu.org#67550,"MATANTIMALI, MARAWOLA BARAT, SIGI, SULAWESI TENGAH",2,114,10,124
https://kawalpemilu.org#67551,"LEWARA, MARAWOLA BARAT, SIGI, SULAWESI TENGAH",1,165,12,177
https://kawalpemilu.org#67551,"LEWARA, MARAWOLA BARAT, SIGI, SULAWESI TENGAH",2,143,38,181
https://kawalpemilu.org#67551,"LEWARA, MARAWOLA BARAT, SIGI, SULAWESI TENGAH",3,134,4,138
https://kawalpemilu.org#67552,"DOMBU, MARAWOLA BARAT, SIGI, SULAWESI TENGAH",1,163,17,180
https://kawalpemilu.org#67552,"DOMBU, MARAWOLA BARAT, SIGI, SULAWESI TENGAH",2,64,10,74
https://kawalpemilu.org#67552,"DOMBU, MARAWOLA BARAT, SIGI, SULAWESI TENGAH",3,60,11,71
https://kawalpemilu.org#67553,"SOI, MARAWOLA BARAT, SIGI, SULAWESI TENGAH",1,110,24,134
https://kawalpemilu.org#67553,"SOI, MARAWOLA BARAT, SIGI, SULAWESI TENGAH",2,153,13,166
https://kawalpemilu.org#67554,"WUGAGA, MARAWOLA BARAT, SIGI, SULAWESI TENGAH",1,120,17,137
https://kawalpemilu.org#67554,"WUGAGA, MARAWOLA BARAT, SIGI, SULAWESI TENGAH",2,156,18,156
https://kawalpemilu.org#67555,"PANASIBAJA, MARAWOLA BARAT, SIGI, SULAWESI TENGAH",1,165,9,174
https://kawalpemilu.org#67555,"PANASIBAJA, MARAWOLA BARAT, SIGI, SULAWESI TENGAH",2,67,12,79
https://kawalpemilu.org#67556,"ONGULERO, MARAWOLA BARAT, SIGI, SULAWESI TENGAH",1,137,12,149
https://kawalpemilu.org#67557,"WIAPORE, MARAWOLA BARAT, SIGI, SULAWESI TENGAH",1,168,16,184
https://kawalpemilu.org#928671,"WAWUJAI, MARAWOLA BARAT, SIGI, SULAWESI TENGAH",1,105,3,108
https://kawalpemilu.org#928671,"WAWUJAI, MARAWOLA BARAT, SIGI, SULAWESI TENGAH",2,113,2,115
https://kawalpemilu.org#928672,"LEMOSIRANINDI, MARAWOLA BARAT, SIGI, SULAWESI TENGAH",1,180,21,201
https://kawalpemilu.org#928672,"LEMOSIRANINDI, MARAWOLA BARAT, SIGI, SULAWESI TENGAH",2,125,2,127
https://kawalpemilu.org#67560,"BUGIS, BATUI, BANGGAI, SULAWESI TENGAH",1,86,129,215
https://kawalpemilu.org#67560,"BUGIS, BATUI, BANGGAI, SULAWESI TENGAH",2,39,50,89
https://kawalpemilu.org#67561,"BALANTANG, BATUI, BANGGAI, SULAWESI TENGAH",2,76,83,159
https://kawalpemilu.org#67561,"BALANTANG, BATUI, BANGGAI, SULAWESI TENGAH",3,110,76,186
https://kawalpemilu.org#67561,"BALANTANG, BATUI, BANGGAI, SULAWESI TENGAH",4,63,100,163
https://kawalpemilu.org#67561,"BALANTANG, BATUI, BANGGAI, SULAWESI TENGAH",5,93,66,159
https://kawalpemilu.org#67562,"BATUI, BATUI, BANGGAI, SULAWESI TENGAH",1,96,114,210
https://kawalpemilu.org#67562,"BATUI, BATUI, BANGGAI, SULAWESI TENGAH",2,86,73,159
https://kawalpemilu.org#67563,"TOLANDO, BATUI, BANGGAI, SULAWESI TENGAH",1,134,108,242
https://kawalpemilu.org#67563,"TOLANDO, BATUI, BANGGAI, SULAWESI TENGAH",2,125,77,202
https://kawalpemilu.org#67563,"TOLANDO, BATUI, BANGGAI, SULAWESI TENGAH",3,115,89,204
https://kawalpemilu.org#67563,"TOLANDO, BATUI, BANGGAI, SULAWESI TENGAH",4,107,73,180
https://kawalpemilu.org#67563,"TOLANDO, BATUI, BANGGAI, SULAWESI TENGAH",5,71,55,126
https://kawalpemilu.org#67563,"TOLANDO, BATUI, BANGGAI, SULAWESI TENGAH",6,140,65,205
https://kawalpemilu.org#67564,"LAMO, BATUI, BANGGAI, SULAWESI TENGAH",2,103,69,172
https://kawalpemilu.org#67564,"LAMO, BATUI, BANGGAI, SULAWESI TENGAH",3,94,111,205
https://kawalpemilu.org#67564,"LAMO, BATUI, BANGGAI, SULAWESI TENGAH",5,96,104,200
https://kawalpemilu.org#67564,"LAMO, BATUI, BANGGAI, SULAWESI TENGAH",6,78,70,148
https://kawalpemilu.org#67565,"SISIPAN, BATUI, BANGGAI, SULAWESI TENGAH",1,125,119,244
https://kawalpemilu.org#67565,"SISIPAN, BATUI, BANGGAI, SULAWESI TENGAH",3,107,114,221
https://kawalpemilu.org#67565,"SISIPAN, BATUI, BANGGAI, SULAWESI TENGAH",4,109,103,212
https://kawalpemilu.org#67565,"SISIPAN, BATUI, BANGGAI, SULAWESI TENGAH",5,87,100,187
https://kawalpemilu.org#67565,"SISIPAN, BATUI, BANGGAI, SULAWESI TENGAH",6,71,83,154
https://kawalpemilu.org#67565,"SISIPAN, BATUI, BANGGAI, SULAWESI TENGAH",7,35,25,60
https://kawalpemilu.org#67566,"BAKUNG, BATUI, BANGGAI, SULAWESI TENGAH",1,135,83,218
https://kawalpemilu.org#67566,"BAKUNG, BATUI, BANGGAI, SULAWESI TENGAH",2,70,101,171
https://kawalpemilu.org#67566,"BAKUNG, BATUI, BANGGAI, SULAWESI TENGAH",3,115,97,212
https://kawalpemilu.org#67566,"BAKUNG, BATUI, BANGGAI, SULAWESI TENGAH",4,88,81,169
https://kawalpemilu.org#67567,"NONONG, BATUI, BANGGAI, SULAWESI TENGAH",1,84,95,179
https://kawalpemilu.org#67567,"NONONG, BATUI, BANGGAI, SULAWESI TENGAH",2,90,59,149
https://kawalpemilu.org#67567,"NONONG, BATUI, BANGGAI, SULAWESI TENGAH",3,95,88,183
https://kawalpemilu.org#67567,"NONONG, BATUI, BANGGAI, SULAWESI TENGAH",4,83,71,154
https://kawalpemilu.org#67567,"NONONG, BATUI, BANGGAI, SULAWESI TENGAH",5,53,60,113
https://kawalpemilu.org#67567,"NONONG, BATUI, BANGGAI, SULAWESI TENGAH",6,117,60,177
https://kawalpemilu.org#67567,"NONONG, BATUI, BANGGAI, SULAWESI TENGAH",7,77,59,136
https://kawalpemilu.org#67568,"KAYOWA, BATUI, BANGGAI, SULAWESI TENGAH",1,86,53,139
https://kawalpemilu.org#67568,"KAYOWA, BATUI, BANGGAI, SULAWESI TENGAH",2,150,54,204
https://kawalpemilu.org#67568,"KAYOWA, BATUI, BANGGAI, SULAWESI TENGAH",3,93,36,129
https://kawalpemilu.org#67569,"ONDO-ONDOLU, BATUI, BANGGAI, SULAWESI TENGAH",1,146,49,195
https://kawalpemilu.org#67569,"ONDO-ONDOLU, BATUI, BANGGAI, SULAWESI TENGAH",2,139,62,201
https://kawalpemilu.org#67569,"ONDO-ONDOLU, BATUI, BANGGAI, SULAWESI TENGAH",3,101,28,129
https://kawalpemilu.org#67569,"ONDO-ONDOLU, BATUI, BANGGAI, SULAWESI TENGAH",4,103,14,117
https://kawalpemilu.org#67570,"HONBOLA, BATUI, BANGGAI, SULAWESI TENGAH",1,175,19,194
https://kawalpemilu.org#67570,"HONBOLA, BATUI, BANGGAI, SULAWESI TENGAH",2,152,29,181
https://kawalpemilu.org#67570,"HONBOLA, BATUI, BANGGAI, SULAWESI TENGAH",3,123,22,145
https://kawalpemilu.org#67571,"USO, BATUI, BANGGAI, SULAWESI TENGAH",1,87,80,167
https://kawalpemilu.org#67571,"USO, BATUI, BANGGAI, SULAWESI TENGAH",2,98,76,174
https://kawalpemilu.org#67571,"USO, BATUI, BANGGAI, SULAWESI TENGAH",3,124,91,214
https://kawalpemilu.org#67571,"USO, BATUI, BANGGAI, SULAWESI TENGAH",4,140,41,181
https://kawalpemilu.org#67572,"ONDO-ONDOLU I, BATUI, BANGGAI, SULAWESI TENGAH",1,75,31,106
https://kawalpemilu.org#67572,"ONDO-ONDOLU I, BATUI, BANGGAI, SULAWESI TENGAH",2,86,84,170
https://kawalpemilu.org#67572,"ONDO-ONDOLU I, BATUI, BANGGAI, SULAWESI TENGAH",3,178,36,214
https://kawalpemilu.org#67574,"BUNTA I, BUNTA, BANGGAI, SULAWESI TENGAH",1,174,52,226
https://kawalpemilu.org#67574,"BUNTA I, BUNTA, BANGGAI, SULAWESI TENGAH",2,145,55,200
https://kawalpemilu.org#67574,"BUNTA I, BUNTA, BANGGAI, SULAWESI TENGAH",3,77,68,145
https://kawalpemilu.org#67574,"BUNTA I, BUNTA, BANGGAI, SULAWESI TENGAH",4,149,68,217
https://kawalpemilu.org#67574,"BUNTA I, BUNTA, BANGGAI, SULAWESI TENGAH",5,59,110,169
https://kawalpemilu.org#67574,"BUNTA I, BUNTA, BANGGAI, SULAWESI TENGAH",6,86,77,163
https://kawalpemilu.org#67574,"BUNTA I, BUNTA, BANGGAI, SULAWESI TENGAH",7,42,47,89
https://kawalpemilu.org#67574,"BUNTA I, BUNTA, BANGGAI, SULAWESI TENGAH",8,43,56,99
https://kawalpemilu.org#67574,"BUNTA I, BUNTA, BANGGAI, SULAWESI TENGAH",9,102,33,135
https://kawalpemilu.org#67574,"BUNTA I, BUNTA, BANGGAI, SULAWESI TENGAH",10,42,67,109
https://kawalpemilu.org#67574,"BUNTA I, BUNTA, BANGGAI, SULAWESI TENGAH",11,122,32,154
https://kawalpemilu.org#67575,"BUNTA II, BUNTA, BANGGAI, SULAWESI TENGAH",1,110,82,192
https://kawalpemilu.org#67575,"BUNTA II, BUNTA, BANGGAI, SULAWESI TENGAH",2,108,89,197
https://kawalpemilu.org#67575,"BUNTA II, BUNTA, BANGGAI, SULAWESI TENGAH",3,86,109,195
https://kawalpemilu.org#67575,"BUNTA II, BUNTA, BANGGAI, SULAWESI TENGAH",4,112,91,203
https://kawalpemilu.org#67575,"BUNTA II, BUNTA, BANGGAI, SULAWESI TENGAH",5,55,60,115
https://kawalpemilu.org#67576,"SALABENDA, BUNTA, BANGGAI, SULAWESI TENGAH",1,86,82,168
https://kawalpemilu.org#67576,"SALABENDA, BUNTA, BANGGAI, SULAWESI TENGAH",2,47,78,125
https://kawalpemilu.org#67576,"SALABENDA, BUNTA, BANGGAI, SULAWESI TENGAH",3,92,52,144
https://kawalpemilu.org#67576,"SALABENDA, BUNTA, BANGGAI, SULAWESI TENGAH",5,120,66,186
https://kawalpemilu.org#67576,"SALABENDA, BUNTA, BANGGAI, SULAWESI TENGAH",6,102,19,121
https://kawalpemilu.org#67577,"BOHOTOKONG, BUNTA, BANGGAI, SULAWESI TENGAH",1,128,56,184
https://kawalpemilu.org#67577,"BOHOTOKONG, BUNTA, BANGGAI, SULAWESI TENGAH",2,120,34,154
https://kawalpemilu.org#67577,"BOHOTOKONG, BUNTA, BANGGAI, SULAWESI TENGAH",3,60,66,126
https://kawalpemilu.org#67577,"BOHOTOKONG, BUNTA, BANGGAI, SULAWESI TENGAH",4,134,49,183
https://kawalpemilu.org#67578,"DONDO SIMOLI, BUNTA, BANGGAI, SULAWESI TENGAH",1,153,63,216
https://kawalpemilu.org#67578,"DONDO SIMOLI, BUNTA, BANGGAI, SULAWESI TENGAH",2,102,43,145
https://kawalpemilu.org#67579,"LAONGGO, BUNTA, BANGGAI, SULAWESI TENGAH",1,166,25,191
https://kawalpemilu.org#67579,"LAONGGO, BUNTA, BANGGAI, SULAWESI TENGAH",2,180,21,201
https://kawalpemilu.org#67579,"LAONGGO, BUNTA, BANGGAI, SULAWESI TENGAH",3,164,20,184
https://kawalpemilu.org#67581,"TOMBONGAN ULOS, BUNTA, BANGGAI, SULAWESI TENGAH",1,169,20,189
https://kawalpemilu.org#67582,"PONGIAN, BUNTA, BANGGAI, SULAWESI TENGAH",1,91,97,188
https://kawalpemilu.org#67582,"PONGIAN, BUNTA, BANGGAI, SULAWESI TENGAH",2,116,84,200
https://kawalpemilu.org#67582,"PONGIAN, BUNTA, BANGGAI, SULAWESI TENGAH",4,137,73,210
https://kawalpemilu.org#67583,"TUNTUNG, BUNTA, BANGGAI, SULAWESI TENGAH",1,125,57,182
https://kawalpemilu.org#67583,"TUNTUNG, BUNTA, BANGGAI, SULAWESI TENGAH",2,108,109,217
https://kawalpemilu.org#67584,"NANGA-NANGAON, BUNTA, BANGGAI, SULAWESI TENGAH",1,168,29,197
https://kawalpemilu.org#67585,"TOIMA, BUNTA, BANGGAI, SULAWESI TENGAH",1,82,105,187
https://kawalpemilu.org#67585,"TOIMA, BUNTA, BANGGAI, SULAWESI TENGAH",2,66,116,182
https://kawalpemilu.org#67585,"TOIMA, BUNTA, BANGGAI, SULAWESI TENGAH",3,61,103,164
https://kawalpemilu.org#67585,"TOIMA, BUNTA, BANGGAI, SULAWESI TENGAH",4,62,86,148
https://kawalpemilu.org#67587,"HUHAK, BUNTA, BANGGAI, SULAWESI TENGAH",1,74,51,125
https://kawalpemilu.org#67587,"HUHAK, BUNTA, BANGGAI, SULAWESI TENGAH",2,87,62,149
https://kawalpemilu.org#67588,"LONTIO, BUNTA, BANGGAI, SULAWESI TENGAH",2,125,65,190
https://kawalpemilu.org#67590,"LONGGOLIAN, BUNTA, BANGGAI, SULAWESI TENGAH",1,64,68,132
https://kawalpemilu.org#67590,"LONGGOLIAN, BUNTA, BANGGAI, SULAWESI TENGAH",2,64,71,135
https://kawalpemilu.org#67591,"KALUMBANGAN, BUNTA, BANGGAI, SULAWESI TENGAH",1,69,72,141
https://kawalpemilu.org#67591,"KALUMBANGAN, BUNTA, BANGGAI, SULAWESI TENGAH",2,87,42,129
https://kawalpemilu.org#67592,"POLO, BUNTA, BANGGAI, SULAWESI TENGAH",1,121,52,173
https://kawalpemilu.org#67592,"POLO, BUNTA, BANGGAI, SULAWESI TENGAH",2,100,79,179
https://kawalpemilu.org#85624,"KALAKA, BUNTA, BANGGAI, SULAWESI TENGAH",1,101,77,178
https://kawalpemilu.org#85624,"KALAKA, BUNTA, BANGGAI, SULAWESI TENGAH",2,81,122,203
https://kawalpemilu.org#85624,"KALAKA, BUNTA, BANGGAI, SULAWESI TENGAH",3,99,76,175
https://kawalpemilu.org#85624,"KALAKA, BUNTA, BANGGAI, SULAWESI TENGAH",4,46,44,90
https://kawalpemilu.org#85624,"KALAKA, BUNTA, BANGGAI, SULAWESI TENGAH",5,58,23,81
https://kawalpemilu.org#85625,"BALANGA, BUNTA, BANGGAI, SULAWESI TENGAH",1,57,68,125
https://kawalpemilu.org#85625,"BALANGA, BUNTA, BANGGAI, SULAWESI TENGAH",2,47,50,97
https://kawalpemilu.org#85626,"KOILI, BUNTA, BANGGAI, SULAWESI TENGAH",1,85,6,91
https://kawalpemilu.org#85626,"KOILI, BUNTA, BANGGAI, SULAWESI TENGAH",2,136,32,168
https://kawalpemilu.org#67594,"MENDONO, KINTOM, BANGGAI, SULAWESI TENGAH",1,126,82,208
https://kawalpemilu.org#67594,"MENDONO, KINTOM, BANGGAI, SULAWESI TENGAH",2,118,107,225
https://kawalpemilu.org#67594,"MENDONO, KINTOM, BANGGAI, SULAWESI TENGAH",3,119,89,208
https://kawalpemilu.org#67594,"MENDONO, KINTOM, BANGGAI, SULAWESI TENGAH",4,98,68,166
https://kawalpemilu.org#67594,"MENDONO, KINTOM, BANGGAI, SULAWESI TENGAH",5,86,109,195
https://kawalpemilu.org#67596,"KALOLOS, KINTOM, BANGGAI, SULAWESI TENGAH",1,151,82,233
https://kawalpemilu.org#67596,"KALOLOS, KINTOM, BANGGAI, SULAWESI TENGAH",2,43,45,88
https://kawalpemilu.org#67597,"TANGKIANG, KINTOM, BANGGAI, SULAWESI TENGAH",1,126,112,238
https://kawalpemilu.org#67597,"TANGKIANG, KINTOM, BANGGAI, SULAWESI TENGAH",2,95,133,228
https://kawalpemilu.org#67597,"TANGKIANG, KINTOM, BANGGAI, SULAWESI TENGAH",3,44,56,100
https://kawalpemilu.org#67598,"PADANG, KINTOM, BANGGAI, SULAWESI TENGAH",1,64,109,173
https://kawalpemilu.org#67598,"PADANG, KINTOM, BANGGAI, SULAWESI TENGAH",2,61,102,163
https://kawalpemilu.org#67598,"PADANG, KINTOM, BANGGAI, SULAWESI TENGAH",3,57,84,141
https://kawalpemilu.org#67599,"MANYULA, KINTOM, BANGGAI, SULAWESI TENGAH",1,66,92,158
https://kawalpemilu.org#67599,"MANYULA, KINTOM, BANGGAI, SULAWESI TENGAH",2,85,90,175
https://kawalpemilu.org#67600,"ULING, KINTOM, BANGGAI, SULAWESI TENGAH",1,108,127,235
https://kawalpemilu.org#67600,"ULING, KINTOM, BANGGAI, SULAWESI TENGAH",2,107,99,206
https://kawalpemilu.org#67601,"KINTOM, KINTOM, BANGGAI, SULAWESI TENGAH",1,89,137,226
https://kawalpemilu.org#67601,"KINTOM, KINTOM, BANGGAI, SULAWESI TENGAH",2,79,122,201
https://kawalpemilu.org#67601,"KINTOM, KINTOM, BANGGAI, SULAWESI TENGAH",3,48,68,116
https://kawalpemilu.org#67602,"SAMADOYA, KINTOM, BANGGAI, SULAWESI TENGAH",1,48,119,167
https://kawalpemilu.org#67602,"SAMADOYA, KINTOM, BANGGAI, SULAWESI TENGAH",2,69,109,178
https://kawalpemilu.org#67602,"SAMADOYA, KINTOM, BANGGAI, SULAWESI TENGAH",3,43,100,143
https://kawalpemilu.org#67603,"DIMPALON, KINTOM, BANGGAI, SULAWESI TENGAH",1,78,140,218
https://kawalpemilu.org#67603,"DIMPALON, KINTOM, BANGGAI, SULAWESI TENGAH",2,87,128,225
https://kawalpemilu.org#67604,"SOLAN, KINTOM, BANGGAI, SULAWESI TENGAH",1,128,24,152
https://kawalpemilu.org#67604,"SOLAN, KINTOM, BANGGAI, SULAWESI TENGAH",2,136,24,160
https://kawalpemilu.org#67604,"SOLAN, KINTOM, BANGGAI, SULAWESI TENGAH",3,131,6,137
https://kawalpemilu.org#67606,"BABANBUYANGGE, KINTOM, BANGGAI, SULAWESI TENGAH",1,124,26,150
https://kawalpemilu.org#67606,"BABANBUYANGGE, KINTOM, BANGGAI, SULAWESI TENGAH",2,118,25,143
https://kawalpemilu.org#85627,"MONDONUN, KINTOM, BANGGAI, SULAWESI TENGAH",3,53,80,133
https://kawalpemilu.org#85628,"SOLAN BARU, KINTOM, BANGGAI, SULAWESI TENGAH",1,174,12,186
https://kawalpemilu.org#85628,"SOLAN BARU, KINTOM, BANGGAI, SULAWESI TENGAH",2,129,17,146
https://kawalpemilu.org#85629,"DIMPALON BARU, KINTOM, BANGGAI, SULAWESI TENGAH",1,84,99,183
https://kawalpemilu.org#85629,"DIMPALON BARU, KINTOM, BANGGAI, SULAWESI TENGAH",2,74,135,209
https://kawalpemilu.org#67614,"LUWUK, LUWUK, BANGGAI, SULAWESI TENGAH",1,131,62,193
https://kawalpemilu.org#67614,"LUWUK, LUWUK, BANGGAI, SULAWESI TENGAH",2,80,86,166
https://kawalpemilu.org#67614,"LUWUK, LUWUK, BANGGAI, SULAWESI TENGAH",3,118,105,0
https://kawalpemilu.org#67614,"LUWUK, LUWUK, BANGGAI, SULAWESI TENGAH",4,98,92,190
https://kawalpemilu.org#67614,"LUWUK, LUWUK, BANGGAI, SULAWESI TENGAH",5,66,103,169
https://kawalpemilu.org#67614,"LUWUK, LUWUK, BANGGAI, SULAWESI TENGAH",6,73,119,192
https://kawalpemilu.org#67614,"LUWUK, LUWUK, BANGGAI, SULAWESI TENGAH",7,48,73,121
https://kawalpemilu.org#67614,"LUWUK, LUWUK, BANGGAI, SULAWESI TENGAH",8,52,68,120
https://kawalpemilu.org#67614,"LUWUK, LUWUK, BANGGAI, SULAWESI TENGAH",9,66,92,158
https://kawalpemilu.org#67614,"LUWUK, LUWUK, BANGGAI, SULAWESI TENGAH",10,43,91,134
https://kawalpemilu.org#67614,"LUWUK, LUWUK, BANGGAI, SULAWESI TENGAH",11,0,0,0
https://kawalpemilu.org#67614,"LUWUK, LUWUK, BANGGAI, SULAWESI TENGAH",12,58,83,141
https://kawalpemilu.org#67614,"LUWUK, LUWUK, BANGGAI, SULAWESI TENGAH",13,49,123,172
https://kawalpemilu.org#67614,"LUWUK, LUWUK, BANGGAI, SULAWESI TENGAH",16,46,54,100
https://kawalpemilu.org#67614,"LUWUK, LUWUK, BANGGAI, SULAWESI TENGAH",18,55,54,109
https://kawalpemilu.org#67614,"LUWUK, LUWUK, BANGGAI, SULAWESI TENGAH",20,59,71,130
https://kawalpemilu.org#67614,"LUWUK, LUWUK, BANGGAI, SULAWESI TENGAH",21,51,56,107
https://kawalpemilu.org#67614,"LUWUK, LUWUK, BANGGAI, SULAWESI TENGAH",23,40,98,138
https://kawalpemilu.org#67614,"LUWUK, LUWUK, BANGGAI, SULAWESI TENGAH",25,46,79,125
https://kawalpemilu.org#67614,"LUWUK, LUWUK, BANGGAI, SULAWESI TENGAH",26,40,65,105
https://kawalpemilu.org#67615,"BARU, LUWUK, BANGGAI, SULAWESI TENGAH",1,85,118,203
https://kawalpemilu.org#67615,"BARU, LUWUK, BANGGAI, SULAWESI TENGAH",2,66,157,223
https://kawalpemilu.org#67615,"BARU, LUWUK, BANGGAI, SULAWESI TENGAH",3,81,64,145
https://kawalpemilu.org#67615,"BARU, LUWUK, BANGGAI, SULAWESI TENGAH",4,95,103,198
https://kawalpemilu.org#67615,"BARU, LUWUK, BANGGAI, SULAWESI TENGAH",5,69,100,169
https://kawalpemilu.org#67615,"BARU, LUWUK, BANGGAI, SULAWESI TENGAH",6,76,107,183
https://kawalpemilu.org#67615,"BARU, LUWUK, BANGGAI, SULAWESI TENGAH",7,101,58,159
https://kawalpemilu.org#67615,"BARU, LUWUK, BANGGAI, SULAWESI TENGAH",8,80,89,169
https://kawalpemilu.org#67616,"SOHO, LUWUK, BANGGAI, SULAWESI TENGAH",1,61,106,167
https://kawalpemilu.org#67616,"SOHO, LUWUK, BANGGAI, SULAWESI TENGAH",2,89,64,153
https://kawalpemilu.org#67616,"SOHO, LUWUK, BANGGAI, SULAWESI TENGAH",3,68,60,128
https://kawalpemilu.org#67616,"SOHO, LUWUK, BANGGAI, SULAWESI TENGAH",4,73,80,153
https://kawalpemilu.org#67616,"SOHO, LUWUK, BANGGAI, SULAWESI TENGAH",5,59,86,145
https://kawalpemilu.org#67616,"SOHO, LUWUK, BANGGAI, SULAWESI TENGAH",6,99,26,125
https://kawalpemilu.org#67616,"SOHO, LUWUK, BANGGAI, SULAWESI TENGAH",7,60,56,116
https://kawalpemilu.org#67616,"SOHO, LUWUK, BANGGAI, SULAWESI TENGAH",8,55,90,145
https://kawalpemilu.org#67616,"SOHO, LUWUK, BANGGAI, SULAWESI TENGAH",9,65,55,120
https://kawalpemilu.org#67617,"BUNGIN, LUWUK, BANGGAI, SULAWESI TENGAH",1,75,24,99
https://kawalpemilu.org#67617,"BUNGIN, LUWUK, BANGGAI, SULAWESI TENGAH",3,52,76,128
https://kawalpemilu.org#67617,"BUNGIN, LUWUK, BANGGAI, SULAWESI TENGAH",6,67,75,142
https://kawalpemilu.org#67617,"BUNGIN, LUWUK, BANGGAI, SULAWESI TENGAH",7,94,55,149
https://kawalpemilu.org#67617,"BUNGIN, LUWUK, BANGGAI, SULAWESI TENGAH",8,66,38,104
https://kawalpemilu.org#67617,"BUNGIN, LUWUK, BANGGAI, SULAWESI TENGAH",9,45,38,83
https://kawalpemilu.org#67617,"BUNGIN, LUWUK, BANGGAI, SULAWESI TENGAH",11,77,92,169
https://kawalpemilu.org#67617,"BUNGIN, LUWUK, BANGGAI, SULAWESI TENGAH",14,91,83,174
https://kawalpemilu.org#67617,"BUNGIN, LUWUK, BANGGAI, SULAWESI TENGAH",15,93,120,213
https://kawalpemilu.org#67621,"TONTOUAN, LUWUK, BANGGAI, SULAWESI TENGAH",1,119,72,191
https://kawalpemilu.org#67621,"TONTOUAN, LUWUK, BANGGAI, SULAWESI TENGAH",2,193,81,274
https://kawalpemilu.org#67621,"TONTOUAN, LUWUK, BANGGAI, SULAWESI TENGAH",3,133,94,227
https://kawalpemilu.org#67621,"TONTOUAN, LUWUK, BANGGAI, SULAWESI TENGAH",4,102,79,181
https://kawalpemilu.org#67621,"TONTOUAN, LUWUK, BANGGAI, SULAWESI TENGAH",5,75,60,135
https://kawalpemilu.org#67622,"LUMPOKNYO, LUWUK, BANGGAI, SULAWESI TENGAH",1,99,99,198
https://kawalpemilu.org#67622,"LUMPOKNYO, LUWUK, BANGGAI, SULAWESI TENGAH",2,88,140,228
https://kawalpemilu.org#67622,"LUMPOKNYO, LUWUK, BANGGAI, SULAWESI TENGAH",3,67,109,176
https://kawalpemilu.org#67622,"LUMPOKNYO, LUWUK, BANGGAI, SULAWESI TENGAH",4,83,107,190
https://kawalpemilu.org#85630,"KELEKE, LUWUK, BANGGAI, SULAWESI TENGAH",1,132,10,142
https://kawalpemilu.org#85630,"KELEKE, LUWUK, BANGGAI, SULAWESI TENGAH",2,84,42,126
https://kawalpemilu.org#85630,"KELEKE, LUWUK, BANGGAI, SULAWESI TENGAH",3,100,94,194
https://kawalpemilu.org#85630,"KELEKE, LUWUK, BANGGAI, SULAWESI TENGAH",4,87,148,235
https://kawalpemilu.org#85630,"KELEKE, LUWUK, BANGGAI, SULAWESI TENGAH",5,89,66,155
https://kawalpemilu.org#85630,"KELEKE, LUWUK, BANGGAI, SULAWESI TENGAH",6,124,69,193
https://kawalpemilu.org#85631,"BUNGIN TIMUR, LUWUK, BANGGAI, SULAWESI TENGAH",1,120,66,186
https://kawalpemilu.org#85631,"BUNGIN TIMUR, LUWUK, BANGGAI, SULAWESI TENGAH",3,80,88,168
https://kawalpemilu.org#85631,"BUNGIN TIMUR, LUWUK, BANGGAI, SULAWESI TENGAH",4,117,71,188
https://kawalpemilu.org#85631,"BUNGIN TIMUR, LUWUK, BANGGAI, SULAWESI TENGAH",5,98,67,165
https://kawalpemilu.org#85631,"BUNGIN TIMUR, LUWUK, BANGGAI, SULAWESI TENGAH",7,83,73,156
https://kawalpemilu.org#85631,"BUNGIN TIMUR, LUWUK, BANGGAI, SULAWESI TENGAH",8,94,106,200
https://kawalpemilu.org#85631,"BUNGIN TIMUR, LUWUK, BANGGAI, SULAWESI TENGAH",9,82,66,148
https://kawalpemilu.org#85631,"BUNGIN TIMUR, LUWUK, BANGGAI, SULAWESI TENGAH",10,92,90,182
https://kawalpemilu.org#85631,"BUNGIN TIMUR, LUWUK, BANGGAI, SULAWESI TENGAH",12,48,62,110
https://kawalpemilu.org#85631,"BUNGIN TIMUR, LUWUK, BANGGAI, SULAWESI TENGAH",13,45,51,96
https://kawalpemilu.org#85632,"MANGKIO BARU, LUWUK, BANGGAI, SULAWESI TENGAH",1,39,116,155
https://kawalpemilu.org#85632,"MANGKIO BARU, LUWUK, BANGGAI, SULAWESI TENGAH",2,63,140,281
https://kawalpemilu.org#85632,"MANGKIO BARU, LUWUK, BANGGAI, SULAWESI TENGAH",3,53,82,135
https://kawalpemilu.org#85632,"MANGKIO BARU, LUWUK, BANGGAI, SULAWESI TENGAH",4,40,105,145
https://kawalpemilu.org#85632,"MANGKIO BARU, LUWUK, BANGGAI, SULAWESI TENGAH",5,77,88,2
https://kawalpemilu.org#85632,"MANGKIO BARU, LUWUK, BANGGAI, SULAWESI TENGAH",6,71,86,157
https://kawalpemilu.org#85632,"MANGKIO BARU, LUWUK, BANGGAI, SULAWESI TENGAH",7,62,120,182
https://kawalpemilu.org#85632,"MANGKIO BARU, LUWUK, BANGGAI, SULAWESI TENGAH",8,43,89,132
https://kawalpemilu.org#85632,"MANGKIO BARU, LUWUK, BANGGAI, SULAWESI TENGAH",9,63,61,124
https://kawalpemilu.org#85632,"MANGKIO BARU, LUWUK, BANGGAI, SULAWESI TENGAH",10,101,86,187
https://kawalpemilu.org#85632,"MANGKIO BARU, LUWUK, BANGGAI, SULAWESI TENGAH",11,60,92,152
https://kawalpemilu.org#85632,"MANGKIO BARU, LUWUK, BANGGAI, SULAWESI TENGAH",12,59,55,114
https://kawalpemilu.org#85632,"MANGKIO BARU, LUWUK, BANGGAI, SULAWESI TENGAH",13,38,50,88
https://kawalpemilu.org#85632,"MANGKIO BARU, LUWUK, BANGGAI, SULAWESI TENGAH",14,49,49,98
https://kawalpemilu.org#87821,"KERATON, LUWUK, BANGGAI, SULAWESI TENGAH",1,103,49,152
https://kawalpemilu.org#87821,"KERATON, LUWUK, BANGGAI, SULAWESI TENGAH",2,98,50,148
https://kawalpemilu.org#87821,"KERATON, LUWUK, BANGGAI, SULAWESI TENGAH",3,39,59,98
https://kawalpemilu.org#87821,"KERATON, LUWUK, BANGGAI, SULAWESI TENGAH",4,69,71,140
https://kawalpemilu.org#87821,"KERATON, LUWUK, BANGGAI, SULAWESI TENGAH",5,35,40,75
https://kawalpemilu.org#87821,"KERATON, LUWUK, BANGGAI, SULAWESI TENGAH",6,50,57,107
https://kawalpemilu.org#87821,"KERATON, LUWUK, BANGGAI, SULAWESI TENGAH",7,55,98,153
https://kawalpemilu.org#87821,"KERATON, LUWUK, BANGGAI, SULAWESI TENGAH",8,57,54,111
https://kawalpemilu.org#87821,"KERATON, LUWUK, BANGGAI, SULAWESI TENGAH",9,26,61,87
https://kawalpemilu.org#87821,"KERATON, LUWUK, BANGGAI, SULAWESI TENGAH",10,19,98,117
https://kawalpemilu.org#87821,"KERATON, LUWUK, BANGGAI, SULAWESI TENGAH",11,49,94,143
https://kawalpemilu.org#87821,"KERATON, LUWUK, BANGGAI, SULAWESI TENGAH",12,124,64,188
https://kawalpemilu.org#87821,"KERATON, LUWUK, BANGGAI, SULAWESI TENGAH",13,50,77,127
https://kawalpemilu.org#87821,"KERATON, LUWUK, BANGGAI, SULAWESI TENGAH",14,69,72,141
https://kawalpemilu.org#87821,"KERATON, LUWUK, BANGGAI, SULAWESI TENGAH",15,75,37,112
https://kawalpemilu.org#67639,"NIPA, LAMALA, BANGGAI, SULAWESI TENGAH",1,204,8,212
https://kawalpemilu.org#67639,"NIPA, LAMALA, BANGGAI, SULAWESI TENGAH",2,184,10,194
https://kawalpemilu.org#67639,"NIPA, LAMALA, BANGGAI, SULAWESI TENGAH",3,124,7,131
https://kawalpemilu.org#67639,"NIPA, LAMALA, BANGGAI, SULAWESI TENGAH",4,122,1,123
https://kawalpemilu.org#67640,"KAGITAKAN, LAMALA, BANGGAI, SULAWESI TENGAH",1,63,31,94
https://kawalpemilu.org#67640,"KAGITAKAN, LAMALA, BANGGAI, SULAWESI TENGAH",2,126,18,144
https://kawalpemilu.org#67641,"SIRONG, LAMALA, BANGGAI, SULAWESI TENGAH",1,144,10,154
https://kawalpemilu.org#67641,"SIRONG, LAMALA, BANGGAI, SULAWESI TENGAH",2,142,17,2
https://kawalpemilu.org#67641,"SIRONG, LAMALA, BANGGAI, SULAWESI TENGAH",3,134,29,163
https://kawalpemilu.org#67642,"POROAN, LAMALA, BANGGAI, SULAWESI TENGAH",1,97,133,230
https://kawalpemilu.org#67642,"POROAN, LAMALA, BANGGAI, SULAWESI TENGAH",2,97,116,213
https://kawalpemilu.org#67643,"LOMBA, LAMALA, BANGGAI, SULAWESI TENGAH",1,84,75,159
https://kawalpemilu.org#67643,"LOMBA, LAMALA, BANGGAI, SULAWESI TENGAH",2,62,94,156
https://kawalpemilu.org#67643,"LOMBA, LAMALA, BANGGAI, SULAWESI TENGAH",3,40,106,146
https://kawalpemilu.org#67644,"BONEBOBAKAL, LAMALA, BANGGAI, SULAWESI TENGAH",1,33,118,151
https://kawalpemilu.org#67644,"BONEBOBAKAL, LAMALA, BANGGAI, SULAWESI TENGAH",2,50,104,154
https://kawalpemilu.org#67645,"BARUGA, LAMALA, BANGGAI, SULAWESI TENGAH",1,94,29,123
https://kawalpemilu.org#67645,"BARUGA, LAMALA, BANGGAI, SULAWESI TENGAH",2,51,56,107
https://kawalpemilu.org#67646,"KOTABARU, LAMALA, BANGGAI, SULAWESI TENGAH",1,123,41,164
https://kawalpemilu.org#67646,"KOTABARU, LAMALA, BANGGAI, SULAWESI TENGAH",2,142,2,144
https://kawalpemilu.org#67647,"LABOTAN, LAMALA, BANGGAI, SULAWESI TENGAH",1,161,16,177
https://kawalpemilu.org#67647,"LABOTAN, LAMALA, BANGGAI, SULAWESI TENGAH",2,146,37,183
https://kawalpemilu.org#67648,"TINONDA, LAMALA, BANGGAI, SULAWESI TENGAH",1,151,23,174
https://kawalpemilu.org#67648,"TINONDA, LAMALA, BANGGAI, SULAWESI TENGAH",2,120,22,142
https://kawalpemilu.org#85633,"BAHARI MAKMUR, LAMALA, BANGGAI, SULAWESI TENGAH",1,81,51,132
https://kawalpemilu.org#87822,"KOTA RAYA, LAMALA, BANGGAI, SULAWESI TENGAH",1,98,50,148
https://kawalpemilu.org#67651,"BALANTAK, BALANTAK, BANGGAI, SULAWESI TENGAH",1,57,96,153
https://kawalpemilu.org#67651,"BALANTAK, BALANTAK, BANGGAI, SULAWESI TENGAH",2,75,100,175
https://kawalpemilu.org#67651,"BALANTAK, BALANTAK, BANGGAI, SULAWESI TENGAH",3,74,82,156
https://kawalpemilu.org#67652,"DALE-DALE, BALANTAK, BANGGAI, SULAWESI TENGAH",1,77,158,235
https://kawalpemilu.org#67652,"DALE-DALE, BALANTAK, BANGGAI, SULAWESI TENGAH",2,72,149,221
https://kawalpemilu.org#67653,"TALIMA A, BALANTAK, BANGGAI, SULAWESI TENGAH",1,116,1,117
https://kawalpemilu.org#67653,"TALIMA A, BALANTAK, BANGGAI, SULAWESI TENGAH",2,110,4,114
https://kawalpemilu.org#67654,"TALIMA B, BALANTAK, BANGGAI, SULAWESI TENGAH",1,198,15,213
https://kawalpemilu.org#67654,"TALIMA B, BALANTAK, BANGGAI, SULAWESI TENGAH",2,129,5,134
https://kawalpemilu.org#67655,"DOLOM, BALANTAK, BANGGAI, SULAWESI TENGAH",1,155,7,162
https://kawalpemilu.org#67656,"KILOMA, BALANTAK, BANGGAI, SULAWESI TENGAH",1,87,66,153
https://kawalpemilu.org#67657,"RA'U, BALANTAK, BANGGAI, SULAWESI TENGAH",1,71,36,107
https://kawalpemilu.org#67658,"TANOTU, BALANTAK, BANGGAI, SULAWESI TENGAH",1,61,72,133
https://kawalpemilu.org#67658,"TANOTU, BALANTAK, BANGGAI, SULAWESI TENGAH",2,45,122,167
https://kawalpemilu.org#67659,"PADANG, BALANTAK, BANGGAI, SULAWESI TENGAH",1,57,73,130
https://kawalpemilu.org#67660,"MAMPING, BALANTAK, BANGGAI, SULAWESI TENGAH",1,44,106,150
https://kawalpemilu.org#67660,"MAMPING, BALANTAK, BANGGAI, SULAWESI TENGAH",2,95,73,168
https://kawalpemilu.org#67661,"LUOK, BALANTAK, BANGGAI, SULAWESI TENGAH",1,54,58,112
https://kawalpemilu.org#67667,"BOLOAK, BALANTAK, BANGGAI, SULAWESI TENGAH",1,141,13,154
https://kawalpemilu.org#67667,"BOLOAK, BALANTAK, BANGGAI, SULAWESI TENGAH",2,126,21,147
https://kawalpemilu.org#87823,"TALANG BATU, BALANTAK, BANGGAI, SULAWESI TENGAH",1,115,124,239
https://kawalpemilu.org#87823,"TALANG BATU, BALANTAK, BANGGAI, SULAWESI TENGAH",2,112,107,219
https://kawalpemilu.org#67670,"PAKOWA, PAGIMANA, BANGGAI, SULAWESI TENGAH",1,100,122,222
https://kawalpemilu.org#67670,"PAKOWA, PAGIMANA, BANGGAI, SULAWESI TENGAH",2,59,94,153
https://kawalpemilu.org#67670,"PAKOWA, PAGIMANA, BANGGAI, SULAWESI TENGAH",3,62,55,117
https://kawalpemilu.org#67671,"PAGIMANA, PAGIMANA, BANGGAI, SULAWESI TENGAH",1,80,87,167
https://kawalpemilu.org#67671,"PAGIMANA, PAGIMANA, BANGGAI, SULAWESI TENGAH",2,110,99,209
https://kawalpemilu.org#67671,"PAGIMANA, PAGIMANA, BANGGAI, SULAWESI TENGAH",3,88,89,177
https://kawalpemilu.org#67671,"PAGIMANA, PAGIMANA, BANGGAI, SULAWESI TENGAH",4,79,99,178
https://kawalpemilu.org#67671,"PAGIMANA, PAGIMANA, BANGGAI, SULAWESI TENGAH",5,92,112,204
https://kawalpemilu.org#67671,"PAGIMANA, PAGIMANA, BANGGAI, SULAWESI TENGAH",6,78,101,179
https://kawalpemilu.org#67671,"PAGIMANA, PAGIMANA, BANGGAI, SULAWESI TENGAH",7,54,58,112
https://kawalpemilu.org#67671,"PAGIMANA, PAGIMANA, BANGGAI, SULAWESI TENGAH",8,29,74,103
https://kawalpemilu.org#67672,"BASABUNGAN, PAGIMANA, BANGGAI, SULAWESI TENGAH",1,103,95,198
https://kawalpemilu.org#67672,"BASABUNGAN, PAGIMANA, BANGGAI, SULAWESI TENGAH",2,119,46,165
https://kawalpemilu.org#67672,"BASABUNGAN, PAGIMANA, BANGGAI, SULAWESI TENGAH",3,94,121,215
https://kawalpemilu.org#67672,"BASABUNGAN, PAGIMANA, BANGGAI, SULAWESI TENGAH",4,86,51,137
https://kawalpemilu.org#67673,"BALOA DODA, PAGIMANA, BANGGAI, SULAWESI TENGAH",1,113,13,126
https://kawalpemilu.org#67673,"BALOA DODA, PAGIMANA, BANGGAI, SULAWESI TENGAH",2,61,2,63
https://kawalpemilu.org#67675,"ASAAN, PAGIMANA, BANGGAI, SULAWESI TENGAH",1,145,28,173
https://kawalpemilu.org#67675,"ASAAN, PAGIMANA, BANGGAI, SULAWESI TENGAH",2,91,14,105
https://kawalpemilu.org#67676,"BALAI GONDI, PAGIMANA, BANGGAI, SULAWESI TENGAH",1,106,86,192
https://kawalpemilu.org#67678,"GOMUO, PAGIMANA, BANGGAI, SULAWESI TENGAH",1,16,30,46
https://kawalpemilu.org#67679,"NAIN, PAGIMANA, BANGGAI, SULAWESI TENGAH",1,93,5,98
https://kawalpemilu.org#67680,"LAMO, PAGIMANA, BANGGAI, SULAWESI TENGAH",1,104,67,171
https://kawalpemilu.org#67680,"LAMO, PAGIMANA, BANGGAI, SULAWESI TENGAH",2,43,46,89
https://kawalpemilu.org#67681,"TONGKONUNUK, PAGIMANA, BANGGAI, SULAWESI TENGAH",1,103,111,214
https://kawalpemilu.org#67681,"TONGKONUNUK, PAGIMANA, BANGGAI, SULAWESI TENGAH",2,138,79,217
https://kawalpemilu.org#67682,"HOHUDONGAN, PAGIMANA, BANGGAI, SULAWESI TENGAH",1,109,19,128
https://kawalpemilu.org#67683,"SINAMPANGNYO, PAGIMANA, BANGGAI, SULAWESI TENGAH",1,130,15,145
https://kawalpemilu.org#67683,"SINAMPANGNYO, PAGIMANA, BANGGAI, SULAWESI TENGAH",2,101,49,150
https://kawalpemilu.org#67684,"JAYA BAKTI, PAGIMANA, BANGGAI, SULAWESI TENGAH",1,61,122,183
https://kawalpemilu.org#67684,"JAYA BAKTI, PAGIMANA, BANGGAI, SULAWESI TENGAH",2,83,132,215
https://kawalpemilu.org#67684,"JAYA BAKTI, PAGIMANA, BANGGAI, SULAWESI TENGAH",3,105,91,196
https://kawalpemilu.org#67684,"JAYA BAKTI, PAGIMANA, BANGGAI, SULAWESI TENGAH",4,124,46,170
https://kawalpemilu.org#67684,"JAYA BAKTI, PAGIMANA, BANGGAI, SULAWESI TENGAH",5,121,56,177
https://kawalpemilu.org#67684,"JAYA BAKTI, PAGIMANA, BANGGAI, SULAWESI TENGAH",6,118,49,167
https://kawalpemilu.org#67684,"JAYA BAKTI, PAGIMANA, BANGGAI, SULAWESI TENGAH",7,133,75,208
https://kawalpemilu.org#67684,"JAYA BAKTI, PAGIMANA, BANGGAI, SULAWESI TENGAH",8,65,99,164
https://kawalpemilu.org#67684,"JAYA BAKTI, PAGIMANA, BANGGAI, SULAWESI TENGAH",9,97,97,194
https://kawalpemilu.org#67684,"JAYA BAKTI, PAGIMANA, BANGGAI, SULAWESI TENGAH",10,103,70,173
https://kawalpemilu.org#67684,"JAYA BAKTI, PAGIMANA, BANGGAI, SULAWESI TENGAH",11,170,57,227
https://kawalpemilu.org#67684,"JAYA BAKTI, PAGIMANA, BANGGAI, SULAWESI TENGAH",12,113,54,167
https://kawalpemilu.org#67684,"JAYA BAKTI, PAGIMANA, BANGGAI, SULAWESI TENGAH",13,109,103,212
https://kawalpemilu.org#67686,"LAMBANGAN, PAGIMANA, BANGGAI, SULAWESI TENGAH",1,132,83,215
https://kawalpemilu.org#67686,"LAMBANGAN, PAGIMANA, BANGGAI, SULAWESI TENGAH",2,114,73,187
https://kawalpemilu.org#67687,"TOIPAN, PAGIMANA, BANGGAI, SULAWESI TENGAH",1,173,81,254
https://kawalpemilu.org#67688,"SIUNA, PAGIMANA, BANGGAI, SULAWESI TENGAH",1,161,92,253
https://kawalpemilu.org#67688,"SIUNA, PAGIMANA, BANGGAI, SULAWESI TENGAH",2,140,105,245
https://kawalpemilu.org#67688,"SIUNA, PAGIMANA, BANGGAI, SULAWESI TENGAH",3,138,28,166
https://kawalpemilu.org#67689,"PINAPUAN, PAGIMANA, BANGGAI, SULAWESI TENGAH",1,83,41,124
https://kawalpemilu.org#67689,"PINAPUAN, PAGIMANA, BANGGAI, SULAWESI TENGAH",2,111,14,125
https://kawalpemilu.org#67690,"SEPA, PAGIMANA, BANGGAI, SULAWESI TENGAH",1,162,50,212
https://kawalpemilu.org#67690,"SEPA, PAGIMANA, BANGGAI, SULAWESI TENGAH",2,140,33,173
https://kawalpemilu.org#67691,"TALOYON, PAGIMANA, BANGGAI, SULAWESI TENGAH",1,11,63,74
https://kawalpemilu.org#67691,"TALOYON, PAGIMANA, BANGGAI, SULAWESI TENGAH",2,73,83,156
https://kawalpemilu.org#67692,"UWEDAKA, PAGIMANA, BANGGAI, SULAWESI TENGAH",1,80,78,158
https://kawalpemilu.org#67692,"UWEDAKA, PAGIMANA, BANGGAI, SULAWESI TENGAH",2,82,75,157
https://kawalpemilu.org#67693,"TINTINGAN, PAGIMANA, BANGGAI, SULAWESI TENGAH",1,97,59,156
https://kawalpemilu.org#67693,"TINTINGAN, PAGIMANA, BANGGAI, SULAWESI TENGAH",2,96,66,162
https://kawalpemilu.org#67693,"TINTINGAN, PAGIMANA, BANGGAI, SULAWESI TENGAH",3,76,67,143
https://kawalpemilu.org#67694,"BUNGAWON, PAGIMANA, BANGGAI, SULAWESI TENGAH",1,60,63,123
https://kawalpemilu.org#67694,"BUNGAWON, PAGIMANA, BANGGAI, SULAWESI TENGAH",2,74,62,136
https://kawalpemilu.org#67695,"HUHAK, PAGIMANA, BANGGAI, SULAWESI TENGAH",1,131,116,247
https://kawalpemilu.org#67696,"POH, PAGIMANA, BANGGAI, SULAWESI TENGAH",2,99,91,190
https://kawalpemilu.org#67698,"BONDAT, PAGIMANA, BANGGAI, SULAWESI TENGAH",1,109,29,138
https://kawalpemilu.org#67698,"BONDAT, PAGIMANA, BANGGAI, SULAWESI TENGAH",2,79,52,131
https://kawalpemilu.org#67699,"SAMMAJATEM, PAGIMANA, BANGGAI, SULAWESI TENGAH",1,62,99,161
https://kawalpemilu.org#67699,"SAMMAJATEM, PAGIMANA, BANGGAI, SULAWESI TENGAH",2,91,20,111
https://kawalpemilu.org#67699,"SAMMAJATEM, PAGIMANA, BANGGAI, SULAWESI TENGAH",3,76,63,138
https://kawalpemilu.org#67699,"SAMMAJATEM, PAGIMANA, BANGGAI, SULAWESI TENGAH",4,96,34,130
https://kawalpemilu.org#67699,"SAMMAJATEM, PAGIMANA, BANGGAI, SULAWESI TENGAH",5,78,64,142
https://kawalpemilu.org#67700,"BULU, PAGIMANA, BANGGAI, SULAWESI TENGAH",1,132,5,137
https://kawalpemilu.org#67700,"BULU, PAGIMANA, BANGGAI, SULAWESI TENGAH",2,95,3,98
https://kawalpemilu.org#67701,"TOMBANG, PAGIMANA, BANGGAI, SULAWESI TENGAH",1,137,65,202
https://kawalpemilu.org#87824,"AMPERA, PAGIMANA, BANGGAI, SULAWESI TENGAH",1,151,63,214
https://kawalpemilu.org#87825,"DONGKALAN, PAGIMANA, BANGGAI, SULAWESI TENGAH",1,183,7,190
https://kawalpemilu.org#67703,"BUALEMO A, BUALEMO, BANGGAI, SULAWESI TENGAH",1,90,114,204
https://kawalpemilu.org#67703,"BUALEMO A, BUALEMO, BANGGAI, SULAWESI TENGAH",2,58,47,105
https://kawalpemilu.org#67703,"BUALEMO A, BUALEMO, BANGGAI, SULAWESI TENGAH",3,67,81,148
https://kawalpemilu.org#67703,"BUALEMO A, BUALEMO, BANGGAI, SULAWESI TENGAH",4,74,80,154
https://kawalpemilu.org#67703,"BUALEMO A, BUALEMO, BANGGAI, SULAWESI TENGAH",5,70,81,151
https://kawalpemilu.org#67704,"TIKUPAN, BUALEMO, BANGGAI, SULAWESI TENGAH",1,111,106,217
https://kawalpemilu.org#67704,"TIKUPAN, BUALEMO, BANGGAI, SULAWESI TENGAH",2,120,94,214
https://kawalpemilu.org#67704,"TIKUPAN, BUALEMO, BANGGAI, SULAWESI TENGAH",3,76,53,129
https://kawalpemilu.org#67704,"TIKUPAN, BUALEMO, BANGGAI, SULAWESI TENGAH",4,76,33,109
https://kawalpemilu.org#67705,"TRANS MAYAYAP, BUALEMO, BANGGAI, SULAWESI TENGAH",1,170,67,237
https://kawalpemilu.org#67705,"TRANS MAYAYAP, BUALEMO, BANGGAI, SULAWESI TENGAH",2,148,82,230
https://kawalpemilu.org#67705,"TRANS MAYAYAP, BUALEMO, BANGGAI, SULAWESI TENGAH",3,80,34,114
https://kawalpemilu.org#67706,"TOIBA, BUALEMO, BANGGAI, SULAWESI TENGAH",1,114,106,220
https://kawalpemilu.org#67706,"TOIBA, BUALEMO, BANGGAI, SULAWESI TENGAH",2,85,119,204
https://kawalpemilu.org#67706,"TOIBA, BUALEMO, BANGGAI, SULAWESI TENGAH",3,37,31,68
https://kawalpemilu.org#67706,"TOIBA, BUALEMO, BANGGAI, SULAWESI TENGAH",4,57,49,106
https://kawalpemilu.org#67707,"LONGKOGA BARAT, BUALEMO, BANGGAI, SULAWESI TENGAH",1,77,98,175
https://kawalpemilu.org#67707,"LONGKOGA BARAT, BUALEMO, BANGGAI, SULAWESI TENGAH",2,87,116,203
https://kawalpemilu.org#67707,"LONGKOGA BARAT, BUALEMO, BANGGAI, SULAWESI TENGAH",3,89,89,178
https://kawalpemilu.org#67707,"LONGKOGA BARAT, BUALEMO, BANGGAI, SULAWESI TENGAH",4,92,91,183
https://kawalpemilu.org#67707,"LONGKOGA BARAT, BUALEMO, BANGGAI, SULAWESI TENGAH",5,66,119,185
https://kawalpemilu.org#67708,"LONGKOGA TIMUR, BUALEMO, BANGGAI, SULAWESI TENGAH",1,111,98,209
https://kawalpemilu.org#67708,"LONGKOGA TIMUR, BUALEMO, BANGGAI, SULAWESI TENGAH",2,72,122,194
https://kawalpemilu.org#67708,"LONGKOGA TIMUR, BUALEMO, BANGGAI, SULAWESI TENGAH",3,58,82,140
https://kawalpemilu.org#67708,"LONGKOGA TIMUR, BUALEMO, BANGGAI, SULAWESI TENGAH",4,90,64,154
https://kawalpemilu.org#67709,"BUALEMO B, BUALEMO, BANGGAI, SULAWESI TENGAH",1,48,135,183
https://kawalpemilu.org#67709,"BUALEMO B, BUALEMO, BANGGAI, SULAWESI TENGAH",2,50,150,200
https://kawalpemilu.org#67709,"BUALEMO B, BUALEMO, BANGGAI, SULAWESI TENGAH",3,47,121,168
https://kawalpemilu.org#67709,"BUALEMO B, BUALEMO, BANGGAI, SULAWESI TENGAH",4,72,117,189
https://kawalpemilu.org#67710,"TAIMA, BUALEMO, BANGGAI, SULAWESI TENGAH",1,38,91,129
https://kawalpemilu.org#67710,"TAIMA, BUALEMO, BANGGAI, SULAWESI TENGAH",2,47,38,85
https://kawalpemilu.org#67710,"TAIMA, BUALEMO, BANGGAI, SULAWESI TENGAH",3,64,110,174
https://kawalpemilu.org#67711,"SAMPAKA, BUALEMO, BANGGAI, SULAWESI TENGAH",1,48,97,145
https://kawalpemilu.org#67711,"SAMPAKA, BUALEMO, BANGGAI, SULAWESI TENGAH",2,55,93,148
https://kawalpemilu.org#67711,"SAMPAKA, BUALEMO, BANGGAI, SULAWESI TENGAH",3,113,17,130
https://kawalpemilu.org#67711,"SAMPAKA, BUALEMO, BANGGAI, SULAWESI TENGAH",4,66,75,141
https://kawalpemilu.org#67712,"MALIK, BUALEMO, BANGGAI, SULAWESI TENGAH",1,81,100,181
https://kawalpemilu.org#67712,"MALIK, BUALEMO, BANGGAI, SULAWESI TENGAH",2,90,111,201
https://kawalpemilu.org#67713,"BINSIL, BUALEMO, BANGGAI, SULAWESI TENGAH",1,115,48,163
https://kawalpemilu.org#67713,"BINSIL, BUALEMO, BANGGAI, SULAWESI TENGAH",2,82,66,148
https://kawalpemilu.org#67714,"BINSIL PADANG, BUALEMO, BANGGAI, SULAWESI TENGAH",1,84,135,219
https://kawalpemilu.org#67714,"BINSIL PADANG, BUALEMO, BANGGAI, SULAWESI TENGAH",2,70,135,205
https://kawalpemilu.org#67714,"BINSIL PADANG, BUALEMO, BANGGAI, SULAWESI TENGAH",3,81,109,190
https://kawalpemilu.org#67715,"LEMBAH TOMPOTIKA, BUALEMO, BANGGAI, SULAWESI TENGAH",1,67,75,142
https://kawalpemilu.org#67715,"LEMBAH TOMPOTIKA, BUALEMO, BANGGAI, SULAWESI TENGAH",2,92,53,145
https://kawalpemilu.org#67715,"LEMBAH TOMPOTIKA, BUALEMO, BANGGAI, SULAWESI TENGAH",3,86,111,197
https://kawalpemilu.org#67715,"LEMBAH TOMPOTIKA, BUALEMO, BANGGAI, SULAWESI TENGAH",4,70,102,172
https://kawalpemilu.org#67715,"LEMBAH TOMPOTIKA, BUALEMO, BANGGAI, SULAWESI TENGAH",5,83,105,188
https://kawalpemilu.org#67716,"MAYAYAP, BUALEMO, BANGGAI, SULAWESI TENGAH",1,56,109,165
https://kawalpemilu.org#67716,"MAYAYAP, BUALEMO, BANGGAI, SULAWESI TENGAH",2,98,127,225
https://kawalpemilu.org#67716,"MAYAYAP, BUALEMO, BANGGAI, SULAWESI TENGAH",3,160,77,237
https://kawalpemilu.org#67717,"BIMA KARYA, BUALEMO, BANGGAI, SULAWESI TENGAH",1,136,48,184
https://kawalpemilu.org#67717,"BIMA KARYA, BUALEMO, BANGGAI, SULAWESI TENGAH",2,167,36,203
https://kawalpemilu.org#67717,"BIMA KARYA, BUALEMO, BANGGAI, SULAWESI TENGAH",3,169,39,208
https://kawalpemilu.org#67718,"NIPA KALEMOAN, BUALEMO, BANGGAI, SULAWESI TENGAH",1,102,82,184
https://kawalpemilu.org#67718,"NIPA KALEMOAN, BUALEMO, BANGGAI, SULAWESI TENGAH",2,143,14,157
https://kawalpemilu.org#67718,"NIPA KALEMOAN, BUALEMO, BANGGAI, SULAWESI TENGAH",3,133,18,151
https://kawalpemilu.org#85634,"MALIK MAKMUR, BUALEMO, BANGGAI, SULAWESI TENGAH",2,193,35,228
https://kawalpemilu.org#85634,"MALIK MAKMUR, BUALEMO, BANGGAI, SULAWESI TENGAH",3,176,25,201
https://kawalpemilu.org#85635,"LEMBAH MAKMUR, BUALEMO, BANGGAI, SULAWESI TENGAH",1,76,61,137
https://kawalpemilu.org#85636,"DWI KARYA, BUALEMO, BANGGAI, SULAWESI TENGAH",1,184,12,196
https://kawalpemilu.org#927583,"SALIPI, BUALEMO, BANGGAI, SULAWESI TENGAH",1,144,27,171
https://kawalpemilu.org#927583,"SALIPI, BUALEMO, BANGGAI, SULAWESI TENGAH",2,86,36,122
https://kawalpemilu.org#927583,"SALIPI, BUALEMO, BANGGAI, SULAWESI TENGAH",3,103,25,128
https://kawalpemilu.org#67720,"CENDANA, TOILI, BANGGAI, SULAWESI TENGAH",1,64,95,159
https://kawalpemilu.org#67720,"CENDANA, TOILI, BANGGAI, SULAWESI TENGAH",2,64,48,112
https://kawalpemilu.org#67720,"CENDANA, TOILI, BANGGAI, SULAWESI TENGAH",3,115,38,153
https://kawalpemilu.org#67720,"CENDANA, TOILI, BANGGAI, SULAWESI TENGAH",4,105,78,183
https://kawalpemilu.org#67720,"CENDANA, TOILI, BANGGAI, SULAWESI TENGAH",5,140,55,195
https://kawalpemilu.org#67720,"CENDANA, TOILI, BANGGAI, SULAWESI TENGAH",6,102,59,161
https://kawalpemilu.org#67720,"CENDANA, TOILI, BANGGAI, SULAWESI TENGAH",7,122,74,196
https://kawalpemilu.org#67721,"CENDANA PURA, TOILI, BANGGAI, SULAWESI TENGAH",2,110,107,217
https://kawalpemilu.org#67721,"CENDANA PURA, TOILI, BANGGAI, SULAWESI TENGAH",3,62,91,153
https://kawalpemilu.org#67721,"CENDANA PURA, TOILI, BANGGAI, SULAWESI TENGAH",5,155,49,204
https://kawalpemilu.org#67722,"SENTRAL SARI, TOILI, BANGGAI, SULAWESI TENGAH",1,119,90,209
https://kawalpemilu.org#67722,"SENTRAL SARI, TOILI, BANGGAI, SULAWESI TENGAH",2,187,15,202
https://kawalpemilu.org#67722,"SENTRAL SARI, TOILI, BANGGAI, SULAWESI TENGAH",3,133,44,177
https://kawalpemilu.org#67722,"SENTRAL SARI, TOILI, BANGGAI, SULAWESI TENGAH",4,138,50,188
https://kawalpemilu.org#67722,"SENTRAL SARI, TOILI, BANGGAI, SULAWESI TENGAH",5,94,55,149
https://kawalpemilu.org#67723,"TOHITI SARI, TOILI, BANGGAI, SULAWESI TENGAH",1,137,25,162
https://kawalpemilu.org#67723,"TOHITI SARI, TOILI, BANGGAI, SULAWESI TENGAH",2,127,26,153
https://kawalpemilu.org#67723,"TOHITI SARI, TOILI, BANGGAI, SULAWESI TENGAH",3,180,30,210
https://kawalpemilu.org#67723,"TOHITI SARI, TOILI, BANGGAI, SULAWESI TENGAH",4,161,24,185
https://kawalpemilu.org#67723,"TOHITI SARI, TOILI, BANGGAI, SULAWESI TENGAH",5,161,15,176
https://kawalpemilu.org#67723,"TOHITI SARI, TOILI, BANGGAI, SULAWESI TENGAH",6,152,42,194
https://kawalpemilu.org#67724,"TIRTA KENCANA, TOILI, BANGGAI, SULAWESI TENGAH",1,131,76,207
https://kawalpemilu.org#67724,"TIRTA KENCANA, TOILI, BANGGAI, SULAWESI TENGAH",2,124,52,176
https://kawalpemilu.org#67724,"TIRTA KENCANA, TOILI, BANGGAI, SULAWESI TENGAH",3,112,89,201
https://kawalpemilu.org#67724,"TIRTA KENCANA, TOILI, BANGGAI, SULAWESI TENGAH",4,73,57,130
https://kawalpemilu.org#67724,"TIRTA KENCANA, TOILI, BANGGAI, SULAWESI TENGAH",5,99,47,146
https://kawalpemilu.org#67725,"SINGKOYO, TOILI, BANGGAI, SULAWESI TENGAH",1,153,86,239
https://kawalpemilu.org#67725,"SINGKOYO, TOILI, BANGGAI, SULAWESI TENGAH",2,144,81,225
https://kawalpemilu.org#67725,"SINGKOYO, TOILI, BANGGAI, SULAWESI TENGAH",3,59,61,120
https://kawalpemilu.org#67725,"SINGKOYO, TOILI, BANGGAI, SULAWESI TENGAH",4,100,22,122
https://kawalpemilu.org#67725,"SINGKOYO, TOILI, BANGGAI, SULAWESI TENGAH",5,91,28,119
https://kawalpemilu.org#67725,"SINGKOYO, TOILI, BANGGAI, SULAWESI TENGAH",6,130,30,160
https://kawalpemilu.org#67726,"TOLISU, TOILI, BANGGAI, SULAWESI TENGAH",1,153,41,194
https://kawalpemilu.org#67726,"TOLISU, TOILI, BANGGAI, SULAWESI TENGAH",2,161,49,210
https://kawalpemilu.org#67726,"TOLISU, TOILI, BANGGAI, SULAWESI TENGAH",3,150,45,195
https://kawalpemilu.org#67726,"TOLISU, TOILI, BANGGAI, SULAWESI TENGAH",4,131,70,201
https://kawalpemilu.org#67726,"TOLISU, TOILI, BANGGAI, SULAWESI TENGAH",5,156,43,199
https://kawalpemilu.org#67726,"TOLISU, TOILI, BANGGAI, SULAWESI TENGAH",6,130,50,180
https://kawalpemilu.org#67726,"TOLISU, TOILI, BANGGAI, SULAWESI TENGAH",7,159,43,202
https://kawalpemilu.org#67727,"PIONDO, TOILI, BANGGAI, SULAWESI TENGAH",1,147,61,208
https://kawalpemilu.org#67727,"PIONDO, TOILI, BANGGAI, SULAWESI TENGAH",2,148,26,174
https://kawalpemilu.org#67727,"PIONDO, TOILI, BANGGAI, SULAWESI TENGAH",3,176,24,200
https://kawalpemilu.org#67727,"PIONDO, TOILI, BANGGAI, SULAWESI TENGAH",4,146,31,177
https://kawalpemilu.org#67728,"TIRTA SARI, TOILI, BANGGAI, SULAWESI TENGAH",1,94,36,130
https://kawalpemilu.org#67728,"TIRTA SARI, TOILI, BANGGAI, SULAWESI TENGAH",2,79,60,139
https://kawalpemilu.org#67728,"TIRTA SARI, TOILI, BANGGAI, SULAWESI TENGAH",3,129,44,173
https://kawalpemilu.org#67728,"TIRTA SARI, TOILI, BANGGAI, SULAWESI TENGAH",4,104,35,139
https://kawalpemilu.org#67728,"TIRTA SARI, TOILI, BANGGAI, SULAWESI TENGAH",5,123,40,163
https://kawalpemilu.org#67728,"TIRTA SARI, TOILI, BANGGAI, SULAWESI TENGAH",6,99,36,135
https://kawalpemilu.org#67729,"RUSA KENCANA, TOILI, BANGGAI, SULAWESI TENGAH",1,81,108,189
https://kawalpemilu.org#67729,"RUSA KENCANA, TOILI, BANGGAI, SULAWESI TENGAH",2,75,84,159
https://kawalpemilu.org#67729,"RUSA KENCANA, TOILI, BANGGAI, SULAWESI TENGAH",3,155,45,200
https://kawalpemilu.org#67729,"RUSA KENCANA, TOILI, BANGGAI, SULAWESI TENGAH",4,144,54,198
https://kawalpemilu.org#67729,"RUSA KENCANA, TOILI, BANGGAI, SULAWESI TENGAH",5,124,48,172
https://kawalpemilu.org#67729,"RUSA KENCANA, TOILI, BANGGAI, SULAWESI TENGAH",6,112,45,157
https://kawalpemilu.org#67729,"RUSA KENCANA, TOILI, BANGGAI, SULAWESI TENGAH",7,181,63,244
https://kawalpemilu.org#67729,"RUSA KENCANA, TOILI, BANGGAI, SULAWESI TENGAH",8,147,60,207
https://kawalpemilu.org#67730,"BUKIT JAYA, TOILI, BANGGAI, SULAWESI TENGAH",1,143,31,174
https://kawalpemilu.org#67730,"BUKIT JAYA, TOILI, BANGGAI, SULAWESI TENGAH",2,144,43,187
https://kawalpemilu.org#67730,"BUKIT JAYA, TOILI, BANGGAI, SULAWESI TENGAH",3,147,53,200
https://kawalpemilu.org#67730,"BUKIT JAYA, TOILI, BANGGAI, SULAWESI TENGAH",4,153,68,221
https://kawalpemilu.org#67730,"BUKIT JAYA, TOILI, BANGGAI, SULAWESI TENGAH",5,189,32,221
https://kawalpemilu.org#67731,"SAMALORE, TOILI, BANGGAI, SULAWESI TENGAH",1,93,35,128
https://kawalpemilu.org#67731,"SAMALORE, TOILI, BANGGAI, SULAWESI TENGAH",2,119,30,149
https://kawalpemilu.org#67731,"SAMALORE, TOILI, BANGGAI, SULAWESI TENGAH",3,75,33,108
https://kawalpemilu.org#67731,"SAMALORE, TOILI, BANGGAI, SULAWESI TENGAH",4,163,37,200
https://kawalpemilu.org#67732,"UE MEA, TOILI, BANGGAI, SULAWESI TENGAH",1,110,15,125
https://kawalpemilu.org#67732,"UE MEA, TOILI, BANGGAI, SULAWESI TENGAH",2,96,24,120
https://kawalpemilu.org#67733,"BENTENG, TOILI, BANGGAI, SULAWESI TENGAH",1,116,35,151
https://kawalpemilu.org#67733,"BENTENG, TOILI, BANGGAI, SULAWESI TENGAH",2,144,23,167
https://kawalpemilu.org#67734,"MANSAHANG, TOILI, BANGGAI, SULAWESI TENGAH",1,135,78,213
https://kawalpemilu.org#67734,"MANSAHANG, TOILI, BANGGAI, SULAWESI TENGAH",2,63,35,98
https://kawalpemilu.org#67734,"MANSAHANG, TOILI, BANGGAI, SULAWESI TENGAH",3,76,24,100
https://kawalpemilu.org#67735,"SINDANG BARU, TOILI, BANGGAI, SULAWESI TENGAH",1,150,35,185
https://kawalpemilu.org#67735,"SINDANG BARU, TOILI, BANGGAI, SULAWESI TENGAH",2,169,25,194
https://kawalpemilu.org#67735,"SINDANG BARU, TOILI, BANGGAI, SULAWESI TENGAH",3,179,11,190
https://kawalpemilu.org#67735,"SINDANG BARU, TOILI, BANGGAI, SULAWESI TENGAH",4,163,9,172
https://kawalpemilu.org#67736,"TANAH ABANG, TOILI, BANGGAI, SULAWESI TENGAH",1,126,123,249
https://kawalpemilu.org#67736,"TANAH ABANG, TOILI, BANGGAI, SULAWESI TENGAH",2,100,138,238
https://kawalpemilu.org#67736,"TANAH ABANG, TOILI, BANGGAI, SULAWESI TENGAH",3,131,96,227
https://kawalpemilu.org#67737,"JAYA KENCANA, TOILI, BANGGAI, SULAWESI TENGAH",1,124,48,172
https://kawalpemilu.org#67737,"JAYA KENCANA, TOILI, BANGGAI, SULAWESI TENGAH",2,102,67,169
https://kawalpemilu.org#67737,"JAYA KENCANA, TOILI, BANGGAI, SULAWESI TENGAH",3,147,36,183
https://kawalpemilu.org#67738,"MEKAR KENCANA, TOILI, BANGGAI, SULAWESI TENGAH",1,88,14,102
https://kawalpemilu.org#67738,"MEKAR KENCANA, TOILI, BANGGAI, SULAWESI TENGAH",2,145,3,148
https://kawalpemilu.org#67738,"MEKAR KENCANA, TOILI, BANGGAI, SULAWESI TENGAH",3,196,3,199
https://kawalpemilu.org#67738,"MEKAR KENCANA, TOILI, BANGGAI, SULAWESI TENGAH",4,143,24,167
https://kawalpemilu.org#67739,"MARGA KENCANA, TOILI, BANGGAI, SULAWESI TENGAH",1,158,72,230
https://kawalpemilu.org#67739,"MARGA KENCANA, TOILI, BANGGAI, SULAWESI TENGAH",2,153,84,237
https://kawalpemilu.org#67739,"MARGA KENCANA, TOILI, BANGGAI, SULAWESI TENGAH",3,191,31,222
https://kawalpemilu.org#67739,"MARGA KENCANA, TOILI, BANGGAI, SULAWESI TENGAH",4,112,62,174
https://kawalpemilu.org#67740,"SARI BUANA, TOILI, BANGGAI, SULAWESI TENGAH",1,179,9,188
https://kawalpemilu.org#67740,"SARI BUANA, TOILI, BANGGAI, SULAWESI TENGAH",2,195,4,199
https://kawalpemilu.org#67740,"SARI BUANA, TOILI, BANGGAI, SULAWESI TENGAH",3,204,6,210
https://kawalpemilu.org#67740,"SARI BUANA, TOILI, BANGGAI, SULAWESI TENGAH",4,164,2,166
https://kawalpemilu.org#67740,"SARI BUANA, TOILI, BANGGAI, SULAWESI TENGAH",5,142,6,148
https://kawalpemilu.org#67741,"SENTRAL TIMUR, TOILI, BANGGAI, SULAWESI TENGAH",1,145,56,201
https://kawalpemilu.org#67741,"SENTRAL TIMUR, TOILI, BANGGAI, SULAWESI TENGAH",2,112,62,174
https://kawalpemilu.org#67741,"SENTRAL TIMUR, TOILI, BANGGAI, SULAWESI TENGAH",3,77,59,136
https://kawalpemilu.org#67741,"SENTRAL TIMUR, TOILI, BANGGAI, SULAWESI TENGAH",4,138,84,222
https://kawalpemilu.org#67741,"SENTRAL TIMUR, TOILI, BANGGAI, SULAWESI TENGAH",5,112,66,178
https://kawalpemilu.org#67741,"SENTRAL TIMUR, TOILI, BANGGAI, SULAWESI TENGAH",6,156,38,194
https://kawalpemilu.org#87826,"MULYA SARI, TOILI, BANGGAI, SULAWESI TENGAH",1,197,18,215
https://kawalpemilu.org#87826,"MULYA SARI, TOILI, BANGGAI, SULAWESI TENGAH",2,153,35,188
https://kawalpemilu.org#87826,"MULYA SARI, TOILI, BANGGAI, SULAWESI TENGAH",3,223,9,232
https://kawalpemilu.org#87827,"TIRTA JAYA, TOILI, BANGGAI, SULAWESI TENGAH",1,173,80,253
https://kawalpemilu.org#87827,"TIRTA JAYA, TOILI, BANGGAI, SULAWESI TENGAH",2,68,161,229
https://kawalpemilu.org#87827,"TIRTA JAYA, TOILI, BANGGAI, SULAWESI TENGAH",3,58,174,232
https://kawalpemilu.org#87827,"TIRTA JAYA, TOILI, BANGGAI, SULAWESI TENGAH",4,129,127,256
https://kawalpemilu.org#927584,"SIDOMUKTI, TOILI, BANGGAI, SULAWESI TENGAH",1,140,80,220
https://kawalpemilu.org#67743,"TANGEBAN, MASAMA, BANGGAI, SULAWESI TENGAH",1,67,124,191
https://kawalpemilu.org#67743,"TANGEBAN, MASAMA, BANGGAI, SULAWESI TENGAH",2,76,137,213
https://kawalpemilu.org#67743,"TANGEBAN, MASAMA, BANGGAI, SULAWESI TENGAH",3,87,132,219
https://kawalpemilu.org#67743,"TANGEBAN, MASAMA, BANGGAI, SULAWESI TENGAH",4,50,80,130
https://kawalpemilu.org#67744,"TAUGI, MASAMA, BANGGAI, SULAWESI TENGAH",1,103,114,217
https://kawalpemilu.org#67744,"TAUGI, MASAMA, BANGGAI, SULAWESI TENGAH",2,110,124,234
https://kawalpemilu.org#67745,"ETENG, MASAMA, BANGGAI, SULAWESI TENGAH",1,156,11,167
https://kawalpemilu.org#67745,"ETENG, MASAMA, BANGGAI, SULAWESI TENGAH",2,102,11,113
https://kawalpemilu.org#67745,"ETENG, MASAMA, BANGGAI, SULAWESI TENGAH",3,87,71,158
https://kawalpemilu.org#67746,"MINANG ANDALA, MASAMA, BANGGAI, SULAWESI TENGAH",1,90,96,186
https://kawalpemilu.org#67746,"MINANG ANDALA, MASAMA, BANGGAI, SULAWESI TENGAH",2,84,94,178
https://kawalpemilu.org#67746,"MINANG ANDALA, MASAMA, BANGGAI, SULAWESI TENGAH",4,127,73,200
https://kawalpemilu.org#67747,"POSPA DUATAKARYA, MASAMA, BANGGAI, SULAWESI TENGAH",1,223,21,244
https://kawalpemilu.org#67747,"POSPA DUATAKARYA, MASAMA, BANGGAI, SULAWESI TENGAH",2,209,4,213
https://kawalpemilu.org#67747,"POSPA DUATAKARYA, MASAMA, BANGGAI, SULAWESI TENGAH",3,202,17,219
https://kawalpemilu.org#67747,"POSPA DUATAKARYA, MASAMA, BANGGAI, SULAWESI TENGAH",4,143,7,150
https://kawalpemilu.org#67748,"PURWO AGUNG, MASAMA, BANGGAI, SULAWESI TENGAH",1,140,23,163
https://kawalpemilu.org#67748,"PURWO AGUNG, MASAMA, BANGGAI, SULAWESI TENGAH",2,158,35,193
https://kawalpemilu.org#67748,"PURWO AGUNG, MASAMA, BANGGAI, SULAWESI TENGAH",3,179,17,196
https://kawalpemilu.org#67749,"KEMBANG  MERTA, MASAMA, BANGGAI, SULAWESI TENGAH",1,166,11,177
https://kawalpemilu.org#67749,"KEMBANG  MERTA, MASAMA, BANGGAI, SULAWESI TENGAH",2,161,10,171
https://kawalpemilu.org#67749,"KEMBANG  MERTA, MASAMA, BANGGAI, SULAWESI TENGAH",3,164,13,177
https://kawalpemilu.org#67750,"SIMPANGAN, MASAMA, BANGGAI, SULAWESI TENGAH",1,119,41,160
https://kawalpemilu.org#67750,"SIMPANGAN, MASAMA, BANGGAI, SULAWESI TENGAH",2,141,25,166
https://kawalpemilu.org#67751,"TOMPOTIKA MAKMUR, MASAMA, BANGGAI, SULAWESI TENGAH",1,124,39,163
https://kawalpemilu.org#67751,"TOMPOTIKA MAKMUR, MASAMA, BANGGAI, SULAWESI TENGAH",2,129,38,167
https://kawalpemilu.org#67752,"DUATA KARYA, MASAMA, BANGGAI, SULAWESI TENGAH",1,193,8,201
https://kawalpemilu.org#67752,"DUATA KARYA, MASAMA, BANGGAI, SULAWESI TENGAH",2,162,13,175
https://kawalpemilu.org#67752,"DUATA KARYA, MASAMA, BANGGAI, SULAWESI TENGAH",3,181,8,189
https://kawalpemilu.org#67753,"SERESE, MASAMA, BANGGAI, SULAWESI TENGAH",1,104,91,195
https://kawalpemilu.org#67753,"SERESE, MASAMA, BANGGAI, SULAWESI TENGAH",2,109,119,228
https://kawalpemilu.org#67753,"SERESE, MASAMA, BANGGAI, SULAWESI TENGAH",3,78,54,132
https://kawalpemilu.org#85637,"CEMERLANG, MASAMA, BANGGAI, SULAWESI TENGAH",1,55,156,211
https://kawalpemilu.org#85637,"CEMERLANG, MASAMA, BANGGAI, SULAWESI TENGAH",2,67,154,221
https://kawalpemilu.org#85637,"CEMERLANG, MASAMA, BANGGAI, SULAWESI TENGAH",3,26,78,104
https://kawalpemilu.org#85638,"RANGGA-RANGGA, MASAMA, BANGGAI, SULAWESI TENGAH",1,117,38,155
https://kawalpemilu.org#85638,"RANGGA-RANGGA, MASAMA, BANGGAI, SULAWESI TENGAH",2,91,22,113
https://kawalpemilu.org#87829,"PADANGAN, MASAMA, BANGGAI, SULAWESI TENGAH",1,57,140,197
https://kawalpemilu.org#87829,"PADANGAN, MASAMA, BANGGAI, SULAWESI TENGAH",2,68,110,178
https://kawalpemilu.org#67755,"KAYUTANYO, LUWUK TIMUR, BANGGAI, SULAWESI TENGAH",1,115,57,172
https://kawalpemilu.org#67755,"KAYUTANYO, LUWUK TIMUR, BANGGAI, SULAWESI TENGAH",2,102,113,215
https://kawalpemilu.org#67755,"KAYUTANYO, LUWUK TIMUR, BANGGAI, SULAWESI TENGAH",3,72,51,123
https://kawalpemilu.org#67756,"POHI, LUWUK TIMUR, BANGGAI, SULAWESI TENGAH",2,88,47,135
https://kawalpemilu.org#67756,"POHI, LUWUK TIMUR, BANGGAI, SULAWESI TENGAH",4,77,43,120
https://kawalpemilu.org#67757,"HUNDUHON, LUWUK TIMUR, BANGGAI, SULAWESI TENGAH",1,95,145,240
https://kawalpemilu.org#67757,"HUNDUHON, LUWUK TIMUR, BANGGAI, SULAWESI TENGAH",2,102,136,238
https://kawalpemilu.org#67757,"HUNDUHON, LUWUK TIMUR, BANGGAI, SULAWESI TENGAH",3,193,30,223
https://kawalpemilu.org#67757,"HUNDUHON, LUWUK TIMUR, BANGGAI, SULAWESI TENGAH",4,113,109,222
https://kawalpemilu.org#67758,"BAYA, LUWUK TIMUR, BANGGAI, SULAWESI TENGAH",1,106,44,150
https://kawalpemilu.org#67758,"BAYA, LUWUK TIMUR, BANGGAI, SULAWESI TENGAH",2,105,24,129
https://kawalpemilu.org#67758,"BAYA, LUWUK TIMUR, BANGGAI, SULAWESI TENGAH",3,129,33,162
https://kawalpemilu.org#67758,"BAYA, LUWUK TIMUR, BANGGAI, SULAWESI TENGAH",4,131,56,187
https://kawalpemilu.org#67759,"UWEDIKAN, LUWUK TIMUR, BANGGAI, SULAWESI TENGAH",1,108,77,185
https://kawalpemilu.org#67759,"UWEDIKAN, LUWUK TIMUR, BANGGAI, SULAWESI TENGAH",2,107,108,215
https://kawalpemilu.org#67759,"UWEDIKAN, LUWUK TIMUR, BANGGAI, SULAWESI TENGAH",3,78,137,215
https://kawalpemilu.org#67760,"BANTAYAN, LUWUK TIMUR, BANGGAI, SULAWESI TENGAH",3,69,75,144
https://kawalpemilu.org#67760,"BANTAYAN, LUWUK TIMUR, BANGGAI, SULAWESI TENGAH",4,70,82,152
https://kawalpemilu.org#67760,"BANTAYAN, LUWUK TIMUR, BANGGAI, SULAWESI TENGAH",5,112,105,217
https://kawalpemilu.org#67761,"LAUWON, LUWUK TIMUR, BANGGAI, SULAWESI TENGAH",1,71,157,228
https://kawalpemilu.org#67761,"LAUWON, LUWUK TIMUR, BANGGAI, SULAWESI TENGAH",2,88,153,241
https://kawalpemilu.org#67761,"LAUWON, LUWUK TIMUR, BANGGAI, SULAWESI TENGAH",3,38,47,85
https://kawalpemilu.org#67762,"BOITAN, LUWUK TIMUR, BANGGAI, SULAWESI TENGAH",1,117,27,144
https://kawalpemilu.org#67762,"BOITAN, LUWUK TIMUR, BANGGAI, SULAWESI TENGAH",2,97,34,131
https://kawalpemilu.org#67763,"MALINO, LUWUK TIMUR, BANGGAI, SULAWESI TENGAH",1,188,7,195
https://kawalpemilu.org#67763,"MALINO, LUWUK TIMUR, BANGGAI, SULAWESI TENGAH",2,182,50,232
https://kawalpemilu.org#67763,"MALINO, LUWUK TIMUR, BANGGAI, SULAWESI TENGAH",3,95,20,115
https://kawalpemilu.org#67764,"LOUK, LUWUK TIMUR, BANGGAI, SULAWESI TENGAH",1,100,119,219
https://kawalpemilu.org#67764,"LOUK, LUWUK TIMUR, BANGGAI, SULAWESI TENGAH",2,139,75,214
https://kawalpemilu.org#67764,"LOUK, LUWUK TIMUR, BANGGAI, SULAWESI TENGAH",3,42,16,58
https://kawalpemilu.org#67765,"LONTOS, LUWUK TIMUR, BANGGAI, SULAWESI TENGAH",1,132,35,167
https://kawalpemilu.org#67766,"INDANG SARI, LUWUK TIMUR, BANGGAI, SULAWESI TENGAH",1,144,58,202
https://kawalpemilu.org#67766,"INDANG SARI, LUWUK TIMUR, BANGGAI, SULAWESI TENGAH",2,177,33,210
https://kawalpemilu.org#87830,"BUKIT MULYA, LUWUK TIMUR, BANGGAI, SULAWESI TENGAH",1,84,26,110
https://kawalpemilu.org#87830,"BUKIT MULYA, LUWUK TIMUR, BANGGAI, SULAWESI TENGAH",2,71,34,105
https://kawalpemilu.org#67768,"DONGIN, TOILI BARAT, BANGGAI, SULAWESI TENGAH",1,152,44,196
https://kawalpemilu.org#67768,"DONGIN, TOILI BARAT, BANGGAI, SULAWESI TENGAH",2,128,31,159
https://kawalpemilu.org#67769,"PANDAN WANGI, TOILI BARAT, BANGGAI, SULAWESI TENGAH",1,149,36,185
https://kawalpemilu.org#67769,"PANDAN WANGI, TOILI BARAT, BANGGAI, SULAWESI TENGAH",2,143,59,202
https://kawalpemilu.org#67770,"KAMI WANGI, TOILI BARAT, BANGGAI, SULAWESI TENGAH",1,225,9,234
https://kawalpemilu.org#67770,"KAMI WANGI, TOILI BARAT, BANGGAI, SULAWESI TENGAH",2,146,67,213
https://kawalpemilu.org#67770,"KAMI WANGI, TOILI BARAT, BANGGAI, SULAWESI TENGAH",3,234,16,250
https://kawalpemilu.org#67770,"KAMI WANGI, TOILI BARAT, BANGGAI, SULAWESI TENGAH",4,189,37,226
https://kawalpemilu.org#67770,"KAMI WANGI, TOILI BARAT, BANGGAI, SULAWESI TENGAH",5,183,14,197
https://kawalpemilu.org#67770,"KAMI WANGI, TOILI BARAT, BANGGAI, SULAWESI TENGAH",6,164,50,214
https://kawalpemilu.org#67770,"KAMI WANGI, TOILI BARAT, BANGGAI, SULAWESI TENGAH",7,179,6,185
https://kawalpemilu.org#67770,"KAMI WANGI, TOILI BARAT, BANGGAI, SULAWESI TENGAH",8,175,14,189
https://kawalpemilu.org#67771,"SINDANG SARI, TOILI BARAT, BANGGAI, SULAWESI TENGAH",1,104,101,205
https://kawalpemilu.org#67771,"SINDANG SARI, TOILI BARAT, BANGGAI, SULAWESI TENGAH",2,230,11,241
https://kawalpemilu.org#67771,"SINDANG SARI, TOILI BARAT, BANGGAI, SULAWESI TENGAH",3,130,81,211
https://kawalpemilu.org#67771,"SINDANG SARI, TOILI BARAT, BANGGAI, SULAWESI TENGAH",4,227,10,237
https://kawalpemilu.org#67771,"SINDANG SARI, TOILI BARAT, BANGGAI, SULAWESI TENGAH",5,226,14,240
https://kawalpemilu.org#67771,"SINDANG SARI, TOILI BARAT, BANGGAI, SULAWESI TENGAH",6,205,8,213
https://kawalpemilu.org#67772,"MAKAPA, TOILI BARAT, BANGGAI, SULAWESI TENGAH",1,187,17,204
https://kawalpemilu.org#67772,"MAKAPA, TOILI BARAT, BANGGAI, SULAWESI TENGAH",2,192,19,211
https://kawalpemilu.org#67772,"MAKAPA, TOILI BARAT, BANGGAI, SULAWESI TENGAH",3,76,161,237
https://kawalpemilu.org#67772,"MAKAPA, TOILI BARAT, BANGGAI, SULAWESI TENGAH",4,226,7,233
https://kawalpemilu.org#67772,"MAKAPA, TOILI BARAT, BANGGAI, SULAWESI TENGAH",5,189,7,196
https://kawalpemilu.org#67773,"KARYA MAKMUR, TOILI BARAT, BANGGAI, SULAWESI TENGAH",1,86,171,257
https://kawalpemilu.org#67773,"KARYA MAKMUR, TOILI BARAT, BANGGAI, SULAWESI TENGAH",2,151,24,175
https://kawalpemilu.org#67773,"KARYA MAKMUR, TOILI BARAT, BANGGAI, SULAWESI TENGAH",3,143,16,159
https://kawalpemilu.org#67773,"KARYA MAKMUR, TOILI BARAT, BANGGAI, SULAWESI TENGAH",4,201,9,210
https://kawalpemilu.org#67773,"KARYA MAKMUR, TOILI BARAT, BANGGAI, SULAWESI TENGAH",5,188,15,203
https://kawalpemilu.org#67773,"KARYA MAKMUR, TOILI BARAT, BANGGAI, SULAWESI TENGAH",6,49,154,203
https://kawalpemilu.org#67774,"MANTAWA, TOILI BARAT, BANGGAI, SULAWESI TENGAH",1,225,13,238
https://kawalpemilu.org#67774,"MANTAWA, TOILI BARAT, BANGGAI, SULAWESI TENGAH",2,251,4,255
https://kawalpemilu.org#67774,"MANTAWA, TOILI BARAT, BANGGAI, SULAWESI TENGAH",3,152,80,232
https://kawalpemilu.org#67774,"MANTAWA, TOILI BARAT, BANGGAI, SULAWESI TENGAH",4,189,24,213
https://kawalpemilu.org#67775,"PASIR LAMBA, TOILI BARAT, BANGGAI, SULAWESI TENGAH",1,119,113,232
https://kawalpemilu.org#67775,"PASIR LAMBA, TOILI BARAT, BANGGAI, SULAWESI TENGAH",2,208,25,233
https://kawalpemilu.org#67775,"PASIR LAMBA, TOILI BARAT, BANGGAI, SULAWESI TENGAH",4,146,97,243
https://kawalpemilu.org#67775,"PASIR LAMBA, TOILI BARAT, BANGGAI, SULAWESI TENGAH",5,211,7,218
https://kawalpemilu.org#67776,"MANTAWA BONEBAE, TOILI BARAT, BANGGAI, SULAWESI TENGAH",1,75,108,183
https://kawalpemilu.org#67777,"GUNUNG KRAMAT, TOILI BARAT, BANGGAI, SULAWESI TENGAH",1,163,30,193
https://kawalpemilu.org#67777,"GUNUNG KRAMAT, TOILI BARAT, BANGGAI, SULAWESI TENGAH",2,190,37,227
https://kawalpemilu.org#67777,"GUNUNG KRAMAT, TOILI BARAT, BANGGAI, SULAWESI TENGAH",3,114,38,152
https://kawalpemilu.org#67777,"GUNUNG KRAMAT, TOILI BARAT, BANGGAI, SULAWESI TENGAH",4,134,22,156
https://kawalpemilu.org#67778,"LEMBAH KRAMAT, TOILI BARAT, BANGGAI, SULAWESI TENGAH",1,178,42,220
https://kawalpemilu.org#67778,"LEMBAH KRAMAT, TOILI BARAT, BANGGAI, SULAWESI TENGAH",2,165,67,232
https://kawalpemilu.org#67778,"LEMBAH KRAMAT, TOILI BARAT, BANGGAI, SULAWESI TENGAH",3,124,42,166
https://kawalpemilu.org#67778,"LEMBAH KRAMAT, TOILI BARAT, BANGGAI, SULAWESI TENGAH",4,162,27,189
https://kawalpemilu.org#67779,"RATA, TOILI BARAT, BANGGAI, SULAWESI TENGAH",1,129,91,220
https://kawalpemilu.org#67779,"RATA, TOILI BARAT, BANGGAI, SULAWESI TENGAH",2,131,98,229
https://kawalpemilu.org#67779,"RATA, TOILI BARAT, BANGGAI, SULAWESI TENGAH",3,86,39,125
https://kawalpemilu.org#67780,"BUKIT MAKARTI, TOILI BARAT, BANGGAI, SULAWESI TENGAH",1,169,75,244
https://kawalpemilu.org#67780,"BUKIT MAKARTI, TOILI BARAT, BANGGAI, SULAWESI TENGAH",2,169,13,182
https://kawalpemilu.org#67780,"BUKIT MAKARTI, TOILI BARAT, BANGGAI, SULAWESI TENGAH",3,122,54,176
https://kawalpemilu.org#67781,"UWE LULO, TOILI BARAT, BANGGAI, SULAWESI TENGAH",1,123,9,132
https://kawalpemilu.org#67781,"UWE LULO, TOILI BARAT, BANGGAI, SULAWESI TENGAH",2,177,47,224
https://kawalpemilu.org#67781,"UWE LULO, TOILI BARAT, BANGGAI, SULAWESI TENGAH",3,244,10,254
https://kawalpemilu.org#67781,"UWE LULO, TOILI BARAT, BANGGAI, SULAWESI TENGAH",4,182,63,245
https://kawalpemilu.org#67781,"UWE LULO, TOILI BARAT, BANGGAI, SULAWESI TENGAH",5,120,21,141
https://kawalpemilu.org#67782,"BUMI HARAPAN, TOILI BARAT, BANGGAI, SULAWESI TENGAH",1,136,28,164
https://kawalpemilu.org#67782,"BUMI HARAPAN, TOILI BARAT, BANGGAI, SULAWESI TENGAH",2,133,16,149
https://kawalpemilu.org#67783,"MEKAR SARI, TOILI BARAT, BANGGAI, SULAWESI TENGAH",1,204,29,233
https://kawalpemilu.org#67783,"MEKAR SARI, TOILI BARAT, BANGGAI, SULAWESI TENGAH",2,165,12,177
https://kawalpemilu.org#67783,"MEKAR SARI, TOILI BARAT, BANGGAI, SULAWESI TENGAH",3,142,20,162
https://kawalpemilu.org#87831,"MEKAR JAYA, TOILI BARAT, BANGGAI, SULAWESI TENGAH",1,36,89,125
https://kawalpemilu.org#87831,"MEKAR JAYA, TOILI BARAT, BANGGAI, SULAWESI TENGAH",2,38,182,220
https://kawalpemilu.org#87831,"MEKAR JAYA, TOILI BARAT, BANGGAI, SULAWESI TENGAH",3,38,187,225
https://kawalpemilu.org#67785,"BANGKETA, NUHON, BANGGAI, SULAWESI TENGAH",1,149,71,220
https://kawalpemilu.org#67785,"BANGKETA, NUHON, BANGGAI, SULAWESI TENGAH",2,157,57,214
https://kawalpemilu.org#67785,"BANGKETA, NUHON, BANGGAI, SULAWESI TENGAH",3,107,53,160
https://kawalpemilu.org#67785,"BANGKETA, NUHON, BANGGAI, SULAWESI TENGAH",4,120,71,191
https://kawalpemilu.org#67786,"TOBELOMBANG, NUHON, BANGGAI, SULAWESI TENGAH",1,79,10,89
https://kawalpemilu.org#67786,"TOBELOMBANG, NUHON, BANGGAI, SULAWESI TENGAH",2,114,18,132
https://kawalpemilu.org#67786,"TOBELOMBANG, NUHON, BANGGAI, SULAWESI TENGAH",3,69,13,82
https://kawalpemilu.org#67787,"BALAAN, NUHON, BANGGAI, SULAWESI TENGAH",1,122,51,173
https://kawalpemilu.org#67787,"BALAAN, NUHON, BANGGAI, SULAWESI TENGAH",2,142,63,205
https://kawalpemilu.org#67787,"BALAAN, NUHON, BANGGAI, SULAWESI TENGAH",3,139,39,178
https://kawalpemilu.org#67787,"BALAAN, NUHON, BANGGAI, SULAWESI TENGAH",4,135,55,190
https://kawalpemilu.org#67788,"MANTAN B, NUHON, BANGGAI, SULAWESI TENGAH",1,130,42,172
https://kawalpemilu.org#67788,"MANTAN B, NUHON, BANGGAI, SULAWESI TENGAH",2,138,49,187
https://kawalpemilu.org#67789,"TOMEANG, NUHON, BANGGAI, SULAWESI TENGAH",1,128,95,223
https://kawalpemilu.org#67789,"TOMEANG, NUHON, BANGGAI, SULAWESI TENGAH",2,123,56,179
https://kawalpemilu.org#67789,"TOMEANG, NUHON, BANGGAI, SULAWESI TENGAH",3,101,82,183
https://kawalpemilu.org#67789,"TOMEANG, NUHON, BANGGAI, SULAWESI TENGAH",4,84,74,158
https://kawalpemilu.org#67789,"TOMEANG, NUHON, BANGGAI, SULAWESI TENGAH",5,59,67,126
https://kawalpemilu.org#67789,"TOMEANG, NUHON, BANGGAI, SULAWESI TENGAH",6,113,46,159
https://kawalpemilu.org#67790,"PAKOWA BUNTA, NUHON, BANGGAI, SULAWESI TENGAH",1,97,95,192
https://kawalpemilu.org#67790,"PAKOWA BUNTA, NUHON, BANGGAI, SULAWESI TENGAH",2,47,86,133
https://kawalpemilu.org#67791,"TIBOMBO, NUHON, BANGGAI, SULAWESI TENGAH",1,206,19,225
https://kawalpemilu.org#67791,"TIBOMBO, NUHON, BANGGAI, SULAWESI TENGAH",2,72,13,85
https://kawalpemilu.org#67792,"BOLOBUNGKANG, NUHON, BANGGAI, SULAWESI TENGAH",1,79,71,150
https://kawalpemilu.org#67792,"BOLOBUNGKANG, NUHON, BANGGAI, SULAWESI TENGAH",2,105,70,175
https://kawalpemilu.org#67792,"BOLOBUNGKANG, NUHON, BANGGAI, SULAWESI TENGAH",3,166,64,230
https://kawalpemilu.org#67793,"PETAK, NUHON, BANGGAI, SULAWESI TENGAH",1,139,85,224
https://kawalpemilu.org#67793,"PETAK, NUHON, BANGGAI, SULAWESI TENGAH",2,120,59,179
https://kawalpemilu.org#67794,"BELLA, NUHON, BANGGAI, SULAWESI TENGAH",1,79,111,190
https://kawalpemilu.org#67794,"BELLA, NUHON, BANGGAI, SULAWESI TENGAH",2,92,108,200
https://kawalpemilu.org#67794,"BELLA, NUHON, BANGGAI, SULAWESI TENGAH",3,63,74,137
https://kawalpemilu.org#67795,"BINOHU, NUHON, BANGGAI, SULAWESI TENGAH",1,117,52,169
https://kawalpemilu.org#67795,"BINOHU, NUHON, BANGGAI, SULAWESI TENGAH",2,104,53,157
https://kawalpemilu.org#67795,"BINOHU, NUHON, BANGGAI, SULAWESI TENGAH",3,57,38,95
https://kawalpemilu.org#67796,"DAMAI MAKMUR, NUHON, BANGGAI, SULAWESI TENGAH",1,183,24,207
https://kawalpemilu.org#67796,"DAMAI MAKMUR, NUHON, BANGGAI, SULAWESI TENGAH",2,157,24,181
https://kawalpemilu.org#67796,"DAMAI MAKMUR, NUHON, BANGGAI, SULAWESI TENGAH",3,181,8,189
https://kawalpemilu.org#67796,"DAMAI MAKMUR, NUHON, BANGGAI, SULAWESI TENGAH",4,147,15,162
https://kawalpemilu.org#67797,"JAYA MAKMUR, NUHON, BANGGAI, SULAWESI TENGAH",1,184,43,227
https://kawalpemilu.org#67797,"JAYA MAKMUR, NUHON, BANGGAI, SULAWESI TENGAH",2,152,48,200
https://kawalpemilu.org#67797,"JAYA MAKMUR, NUHON, BANGGAI, SULAWESI TENGAH",3,182,26,208
https://kawalpemilu.org#67797,"JAYA MAKMUR, NUHON, BANGGAI, SULAWESI TENGAH",4,199,47,246
https://kawalpemilu.org#67797,"JAYA MAKMUR, NUHON, BANGGAI, SULAWESI TENGAH",5,176,54,230
https://kawalpemilu.org#67798,"SAITI, NUHON, BANGGAI, SULAWESI TENGAH",1,176,29,205
https://kawalpemilu.org#67798,"SAITI, NUHON, BANGGAI, SULAWESI TENGAH",2,148,29,177
https://kawalpemilu.org#67798,"SAITI, NUHON, BANGGAI, SULAWESI TENGAH",3,152,26,178
https://kawalpemilu.org#67798,"SAITI, NUHON, BANGGAI, SULAWESI TENGAH",4,152,23,175
https://kawalpemilu.org#67798,"SAITI, NUHON, BANGGAI, SULAWESI TENGAH",5,135,24,159
https://kawalpemilu.org#67798,"SAITI, NUHON, BANGGAI, SULAWESI TENGAH",6,141,35,176
https://kawalpemilu.org#67799,"SUMBER AGUNG, NUHON, BANGGAI, SULAWESI TENGAH",1,136,52,188
https://kawalpemilu.org#67799,"SUMBER AGUNG, NUHON, BANGGAI, SULAWESI TENGAH",2,132,71,203
https://kawalpemilu.org#67799,"SUMBER AGUNG, NUHON, BANGGAI, SULAWESI TENGAH",3,112,54,166
https://kawalpemilu.org#67799,"SUMBER AGUNG, NUHON, BANGGAI, SULAWESI TENGAH",4,176,43,219
https://kawalpemilu.org#67800,"BATU HITAM, NUHON, BANGGAI, SULAWESI TENGAH",1,98,65,163
https://kawalpemilu.org#67800,"BATU HITAM, NUHON, BANGGAI, SULAWESI TENGAH",2,98,53,151
https://kawalpemilu.org#67801,"KABUA BUA, NUHON, BANGGAI, SULAWESI TENGAH",1,189,19,208
https://kawalpemilu.org#67801,"KABUA BUA, NUHON, BANGGAI, SULAWESI TENGAH",2,49,3,52
https://kawalpemilu.org#67802,"PULO DALAGAN, NUHON, BANGGAI, SULAWESI TENGAH",1,127,52,179
https://kawalpemilu.org#67802,"PULO DALAGAN, NUHON, BANGGAI, SULAWESI TENGAH",2,117,21,138
https://kawalpemilu.org#85639,"OBOK BALINGARA, NUHON, BANGGAI, SULAWESI TENGAH",1,48,46,94
https://kawalpemilu.org#85639,"OBOK BALINGARA, NUHON, BANGGAI, SULAWESI TENGAH",2,153,36,189
https://kawalpemilu.org#85640,"TETESULU, NUHON, BANGGAI, SULAWESI TENGAH",1,147,90,237
https://kawalpemilu.org#67804,"SALUAN, MOILONG, BANGGAI, SULAWESI TENGAH",1,91,106,197
https://kawalpemilu.org#67804,"SALUAN, MOILONG, BANGGAI, SULAWESI TENGAH",2,35,35,70
https://kawalpemilu.org#67805,"TOILI, MOILONG, BANGGAI, SULAWESI TENGAH",1,120,57,177
https://kawalpemilu.org#67805,"TOILI, MOILONG, BANGGAI, SULAWESI TENGAH",2,96,62,158
https://kawalpemilu.org#67805,"TOILI, MOILONG, BANGGAI, SULAWESI TENGAH",3,136,80,216
https://kawalpemilu.org#67805,"TOILI, MOILONG, BANGGAI, SULAWESI TENGAH",4,49,42,91
https://kawalpemilu.org#67805,"TOILI, MOILONG, BANGGAI, SULAWESI TENGAH",5,103,16,119
https://kawalpemilu.org#67805,"TOILI, MOILONG, BANGGAI, SULAWESI TENGAH",6,113,57,170
https://kawalpemilu.org#67806,"SELAMET RAHARJO, MOILONG, BANGGAI, SULAWESI TENGAH",1,140,60,200
https://kawalpemilu.org#67806,"SELAMET RAHARJO, MOILONG, BANGGAI, SULAWESI TENGAH",2,156,26,182
https://kawalpemilu.org#67806,"SELAMET RAHARJO, MOILONG, BANGGAI, SULAWESI TENGAH",3,154,38,192
https://kawalpemilu.org#67806,"SELAMET RAHARJO, MOILONG, BANGGAI, SULAWESI TENGAH",4,130,50,180
https://kawalpemilu.org#67807,"MULIO HARJO, MOILONG, BANGGAI, SULAWESI TENGAH",1,157,44,201
https://kawalpemilu.org#67807,"MULIO HARJO, MOILONG, BANGGAI, SULAWESI TENGAH",2,140,48,188
https://kawalpemilu.org#67807,"MULIO HARJO, MOILONG, BANGGAI, SULAWESI TENGAH",3,136,44,180
https://kawalpemilu.org#67807,"MULIO HARJO, MOILONG, BANGGAI, SULAWESI TENGAH",5,101,73,174
https://kawalpemilu.org#67807,"MULIO HARJO, MOILONG, BANGGAI, SULAWESI TENGAH",6,104,60,164
https://kawalpemilu.org#67808,"SIDOHARJO, MOILONG, BANGGAI, SULAWESI TENGAH",1,114,74,188
https://kawalpemilu.org#67808,"SIDOHARJO, MOILONG, BANGGAI, SULAWESI TENGAH",2,130,54,184
https://kawalpemilu.org#67809,"BUMI HARJO, MOILONG, BANGGAI, SULAWESI TENGAH",1,120,111,231
https://kawalpemilu.org#67809,"BUMI HARJO, MOILONG, BANGGAI, SULAWESI TENGAH",2,119,109,228
https://kawalpemilu.org#67809,"BUMI HARJO, MOILONG, BANGGAI, SULAWESI TENGAH",3,71,79,150
https://kawalpemilu.org#67810,"MINAKARYA, MOILONG, BANGGAI, SULAWESI TENGAH",1,100,117,217
https://kawalpemilu.org#67810,"MINAKARYA, MOILONG, BANGGAI, SULAWESI TENGAH",2,144,71,215
https://kawalpemilu.org#67810,"MINAKARYA, MOILONG, BANGGAI, SULAWESI TENGAH",3,120,58,178
https://kawalpemilu.org#67810,"MINAKARYA, MOILONG, BANGGAI, SULAWESI TENGAH",4,107,83,190
https://kawalpemilu.org#67810,"MINAKARYA, MOILONG, BANGGAI, SULAWESI TENGAH",5,112,72,184
https://kawalpemilu.org#67811,"MINAHAKI, MOILONG, BANGGAI, SULAWESI TENGAH",1,134,66,200
https://kawalpemilu.org#67811,"MINAHAKI, MOILONG, BANGGAI, SULAWESI TENGAH",2,121,47,168
https://kawalpemilu.org#67812,"ARGA KENCANA, MOILONG, BANGGAI, SULAWESI TENGAH",1,193,38,231
https://kawalpemilu.org#67812,"ARGA KENCANA, MOILONG, BANGGAI, SULAWESI TENGAH",2,181,39,220
https://kawalpemilu.org#67812,"ARGA KENCANA, MOILONG, BANGGAI, SULAWESI TENGAH",3,173,43,216
https://kawalpemilu.org#67812,"ARGA KENCANA, MOILONG, BANGGAI, SULAWESI TENGAH",4,159,43,202
https://kawalpemilu.org#67812,"ARGA KENCANA, MOILONG, BANGGAI, SULAWESI TENGAH",5,171,21,192
https://kawalpemilu.org#67813,"MOILONG, MOILONG, BANGGAI, SULAWESI TENGAH",1,103,119,222
https://kawalpemilu.org#67813,"MOILONG, MOILONG, BANGGAI, SULAWESI TENGAH",2,60,100,160
https://kawalpemilu.org#67813,"MOILONG, MOILONG, BANGGAI, SULAWESI TENGAH",3,102,77,179
https://kawalpemilu.org#67813,"MOILONG, MOILONG, BANGGAI, SULAWESI TENGAH",4,64,73,137
https://kawalpemilu.org#67813,"MOILONG, MOILONG, BANGGAI, SULAWESI TENGAH",5,82,85,167
https://kawalpemilu.org#67813,"MOILONG, MOILONG, BANGGAI, SULAWESI TENGAH",6,87,67,154
https://kawalpemilu.org#67814,"KARANG ANYAR, MOILONG, BANGGAI, SULAWESI TENGAH",1,122,47,169
https://kawalpemilu.org#67814,"KARANG ANYAR, MOILONG, BANGGAI, SULAWESI TENGAH",2,131,26,157
https://kawalpemilu.org#67814,"KARANG ANYAR, MOILONG, BANGGAI, SULAWESI TENGAH",3,124,40,164
https://kawalpemilu.org#67815,"SUMBER HARJO, MOILONG, BANGGAI, SULAWESI TENGAH",1,131,86,217
https://kawalpemilu.org#67815,"SUMBER HARJO, MOILONG, BANGGAI, SULAWESI TENGAH",2,115,99,214
https://kawalpemilu.org#67815,"SUMBER HARJO, MOILONG, BANGGAI, SULAWESI TENGAH",4,68,40,108
https://kawalpemilu.org#67816,"KARYA JAYA, MOILONG, BANGGAI, SULAWESI TENGAH",1,118,94,212
https://kawalpemilu.org#67816,"KARYA JAYA, MOILONG, BANGGAI, SULAWESI TENGAH",2,88,114,202
https://kawalpemilu.org#67816,"KARYA JAYA, MOILONG, BANGGAI, SULAWESI TENGAH",3,70,37,107
https://kawalpemilu.org#67817,"TOU, MOILONG, BANGGAI, SULAWESI TENGAH",1,118,66,184
https://kawalpemilu.org#67817,"TOU, MOILONG, BANGGAI, SULAWESI TENGAH",2,86,61,147
https://kawalpemilu.org#67818,"ARGO MULYO, MOILONG, BANGGAI, SULAWESI TENGAH",1,146,27,173
https://kawalpemilu.org#67818,"ARGO MULYO, MOILONG, BANGGAI, SULAWESI TENGAH",2,130,57,187
https://kawalpemilu.org#67818,"ARGO MULYO, MOILONG, BANGGAI, SULAWESI TENGAH",3,114,34,148
https://kawalpemilu.org#67819,"SIDO MAKMUR, MOILONG, BANGGAI, SULAWESI TENGAH",1,116,98,214
https://kawalpemilu.org#67819,"SIDO MAKMUR, MOILONG, BANGGAI, SULAWESI TENGAH",2,130,47,177
https://kawalpemilu.org#67819,"SIDO MAKMUR, MOILONG, BANGGAI, SULAWESI TENGAH",3,109,58,167
https://kawalpemilu.org#67819,"SIDO MAKMUR, MOILONG, BANGGAI, SULAWESI TENGAH",4,125,48,173
https://kawalpemilu.org#67821,"MAASING, BATUI SELATAN, BANGGAI, SULAWESI TENGAH",1,117,75,192
https://kawalpemilu.org#67821,"MAASING, BATUI SELATAN, BANGGAI, SULAWESI TENGAH",2,161,72,233
https://kawalpemilu.org#67821,"MAASING, BATUI SELATAN, BANGGAI, SULAWESI TENGAH",3,178,46,224
https://kawalpemilu.org#67821,"MAASING, BATUI SELATAN, BANGGAI, SULAWESI TENGAH",4,139,78,217
https://kawalpemilu.org#67821,"MAASING, BATUI SELATAN, BANGGAI, SULAWESI TENGAH",5,179,40,219
https://kawalpemilu.org#67822,"GORI-GORI, BATUI SELATAN, BANGGAI, SULAWESI TENGAH",1,113,42,156
https://kawalpemilu.org#67822,"GORI-GORI, BATUI SELATAN, BANGGAI, SULAWESI TENGAH",2,100,25,125
https://kawalpemilu.org#67822,"GORI-GORI, BATUI SELATAN, BANGGAI, SULAWESI TENGAH",3,125,49,174
https://kawalpemilu.org#67822,"GORI-GORI, BATUI SELATAN, BANGGAI, SULAWESI TENGAH",4,167,47,214
https://kawalpemilu.org#67822,"GORI-GORI, BATUI SELATAN, BANGGAI, SULAWESI TENGAH",5,123,35,158
https://kawalpemilu.org#67823,"SINORANG, BATUI SELATAN, BANGGAI, SULAWESI TENGAH",1,116,65,181
https://kawalpemilu.org#67823,"SINORANG, BATUI SELATAN, BANGGAI, SULAWESI TENGAH",2,123,87,210
https://kawalpemilu.org#67823,"SINORANG, BATUI SELATAN, BANGGAI, SULAWESI TENGAH",3,142,37,179
https://kawalpemilu.org#67823,"SINORANG, BATUI SELATAN, BANGGAI, SULAWESI TENGAH",4,122,29,151
https://kawalpemilu.org#67823,"SINORANG, BATUI SELATAN, BANGGAI, SULAWESI TENGAH",5,113,25,138
https://kawalpemilu.org#67823,"SINORANG, BATUI SELATAN, BANGGAI, SULAWESI TENGAH",6,146,113,259
https://kawalpemilu.org#67823,"SINORANG, BATUI SELATAN, BANGGAI, SULAWESI TENGAH",7,59,68,127
https://kawalpemilu.org#67823,"SINORANG, BATUI SELATAN, BANGGAI, SULAWESI TENGAH",8,84,71,155
https://kawalpemilu.org#67824,"SUKAMAJU, BATUI SELATAN, BANGGAI, SULAWESI TENGAH",1,174,37,211
https://kawalpemilu.org#67824,"SUKAMAJU, BATUI SELATAN, BANGGAI, SULAWESI TENGAH",2,131,43,174
https://kawalpemilu.org#67824,"SUKAMAJU, BATUI SELATAN, BANGGAI, SULAWESI TENGAH",3,200,29,229
https://kawalpemilu.org#67825,"SUKAMAJU SATU, BATUI SELATAN, BANGGAI, SULAWESI TENGAH",1,162,92,254
https://kawalpemilu.org#67825,"SUKAMAJU SATU, BATUI SELATAN, BANGGAI, SULAWESI TENGAH",2,232,8,240
https://kawalpemilu.org#67825,"SUKAMAJU SATU, BATUI SELATAN, BANGGAI, SULAWESI TENGAH",3,187,38,225
https://kawalpemilu.org#67826,"PAISU BULOLI, BATUI SELATAN, BANGGAI, SULAWESI TENGAH",1,194,32,226
https://kawalpemilu.org#67826,"PAISU BULOLI, BATUI SELATAN, BANGGAI, SULAWESI TENGAH",2,223,26,249
https://kawalpemilu.org#67827,"OMBOLU, BATUI SELATAN, BANGGAI, SULAWESI TENGAH",1,111,52,162
https://kawalpemilu.org#67827,"OMBOLU, BATUI SELATAN, BANGGAI, SULAWESI TENGAH",2,143,41,184
https://kawalpemilu.org#67827,"OMBOLU, BATUI SELATAN, BANGGAI, SULAWESI TENGAH",3,142,34,176
https://kawalpemilu.org#67827,"OMBOLU, BATUI SELATAN, BANGGAI, SULAWESI TENGAH",4,126,16,142
https://kawalpemilu.org#67827,"OMBOLU, BATUI SELATAN, BANGGAI, SULAWESI TENGAH",5,162,54,216
https://kawalpemilu.org#67828,"BONEBALANTAK, BATUI SELATAN, BANGGAI, SULAWESI TENGAH",1,113,40,153
https://kawalpemilu.org#67828,"BONEBALANTAK, BATUI SELATAN, BANGGAI, SULAWESI TENGAH",2,150,56,206
https://kawalpemilu.org#67828,"BONEBALANTAK, BATUI SELATAN, BANGGAI, SULAWESI TENGAH",3,123,65,188
https://kawalpemilu.org#67828,"BONEBALANTAK, BATUI SELATAN, BANGGAI, SULAWESI TENGAH",4,146,52,198
https://kawalpemilu.org#67828,"BONEBALANTAK, BATUI SELATAN, BANGGAI, SULAWESI TENGAH",5,125,52,177
https://kawalpemilu.org#67828,"BONEBALANTAK, BATUI SELATAN, BANGGAI, SULAWESI TENGAH",6,146,30,176
https://kawalpemilu.org#67829,"MASUNGKANG, BATUI SELATAN, BANGGAI, SULAWESI TENGAH",1,138,38,176
https://kawalpemilu.org#67829,"MASUNGKANG, BATUI SELATAN, BANGGAI, SULAWESI TENGAH",2,160,35,195
https://kawalpemilu.org#67830,"MALEO JAYA, BATUI SELATAN, BANGGAI, SULAWESI TENGAH",1,139,21,160
https://kawalpemilu.org#67830,"MALEO JAYA, BATUI SELATAN, BANGGAI, SULAWESI TENGAH",2,126,17,143
https://kawalpemilu.org#67830,"MALEO JAYA, BATUI SELATAN, BANGGAI, SULAWESI TENGAH",3,128,22,150
https://kawalpemilu.org#67830,"MALEO JAYA, BATUI SELATAN, BANGGAI, SULAWESI TENGAH",4,91,18,109
https://kawalpemilu.org#67832,"LOBU, LOBU, BANGGAI, SULAWESI TENGAH",1,43,122,165
https://kawalpemilu.org#67832,"LOBU, LOBU, BANGGAI, SULAWESI TENGAH",2,50,129,179
https://kawalpemilu.org#67833,"BOLOBUNGKANG, LOBU, BANGGAI, SULAWESI TENGAH",1,87,77,164
https://kawalpemilu.org#67833,"BOLOBUNGKANG, LOBU, BANGGAI, SULAWESI TENGAH",2,60,129,189
https://kawalpemilu.org#67833,"BOLOBUNGKANG, LOBU, BANGGAI, SULAWESI TENGAH",3,101,78,179
https://kawalpemilu.org#67834,"NIUBULAN, LOBU, BANGGAI, SULAWESI TENGAH",1,84,81,165
https://kawalpemilu.org#67835,"KADODI, LOBU, BANGGAI, SULAWESI TENGAH",1,68,70,138
https://kawalpemilu.org#67836,"UHA UHANGON, LOBU, BANGGAI, SULAWESI TENGAH",1,98,34,132
https://kawalpemilu.org#67836,"UHA UHANGON, LOBU, BANGGAI, SULAWESI TENGAH",2,131,27,158
https://kawalpemilu.org#67837,"BAHINGIN, LOBU, BANGGAI, SULAWESI TENGAH",1,83,50,133
https://kawalpemilu.org#67838,"UWE DAKA-DAKA, LOBU, BANGGAI, SULAWESI TENGAH",1,148,66,214
https://kawalpemilu.org#67839,"BALEAN, LOBU, BANGGAI, SULAWESI TENGAH",1,125,35,160
https://kawalpemilu.org#67839,"BALEAN, LOBU, BANGGAI, SULAWESI TENGAH",2,68,86,154
https://kawalpemilu.org#67840,"LAMBULI, LOBU, BANGGAI, SULAWESI TENGAH",1,102,31,133
https://kawalpemilu.org#87990,"DOLOM, LOBU, BANGGAI, SULAWESI TENGAH",1,138,7,145
https://kawalpemilu.org#67842,"BERINGIN JAYA, SIMPANG RAYA, BANGGAI, SULAWESI TENGAH",1,139,46,185
https://kawalpemilu.org#67842,"BERINGIN JAYA, SIMPANG RAYA, BANGGAI, SULAWESI TENGAH",3,159,31,190
https://kawalpemilu.org#67842,"BERINGIN JAYA, SIMPANG RAYA, BANGGAI, SULAWESI TENGAH",4,111,72,183
https://kawalpemilu.org#67842,"BERINGIN JAYA, SIMPANG RAYA, BANGGAI, SULAWESI TENGAH",5,80,43,123
https://kawalpemilu.org#67842,"BERINGIN JAYA, SIMPANG RAYA, BANGGAI, SULAWESI TENGAH",6,82,33,115
https://kawalpemilu.org#67842,"BERINGIN JAYA, SIMPANG RAYA, BANGGAI, SULAWESI TENGAH",7,115,59,174
https://kawalpemilu.org#67843,"RANTAU JAYA, SIMPANG RAYA, BANGGAI, SULAWESI TENGAH",1,190,18,208
https://kawalpemilu.org#67843,"RANTAU JAYA, SIMPANG RAYA, BANGGAI, SULAWESI TENGAH",2,148,38,186
https://kawalpemilu.org#67843,"RANTAU JAYA, SIMPANG RAYA, BANGGAI, SULAWESI TENGAH",3,146,12,158
https://kawalpemilu.org#67843,"RANTAU JAYA, SIMPANG RAYA, BANGGAI, SULAWESI TENGAH",4,192,19,211
https://kawalpemilu.org#67843,"RANTAU JAYA, SIMPANG RAYA, BANGGAI, SULAWESI TENGAH",5,186,30,216
https://kawalpemilu.org#67843,"RANTAU JAYA, SIMPANG RAYA, BANGGAI, SULAWESI TENGAH",6,157,45,202
https://kawalpemilu.org#67844,"KONINIS, SIMPANG RAYA, BANGGAI, SULAWESI TENGAH",1,118,84,202
https://kawalpemilu.org#67844,"KONINIS, SIMPANG RAYA, BANGGAI, SULAWESI TENGAH",2,89,37,126
https://kawalpemilu.org#67844,"KONINIS, SIMPANG RAYA, BANGGAI, SULAWESI TENGAH",3,99,111,210
https://kawalpemilu.org#67845,"GONOHOP, SIMPANG RAYA, BANGGAI, SULAWESI TENGAH",1,175,45,220
https://kawalpemilu.org#67845,"GONOHOP, SIMPANG RAYA, BANGGAI, SULAWESI TENGAH",2,143,69,212
https://kawalpemilu.org#67845,"GONOHOP, SIMPANG RAYA, BANGGAI, SULAWESI TENGAH",3,151,49,200
https://kawalpemilu.org#67845,"GONOHOP, SIMPANG RAYA, BANGGAI, SULAWESI TENGAH",4,123,34,157
https://kawalpemilu.org#67845,"GONOHOP, SIMPANG RAYA, BANGGAI, SULAWESI TENGAH",5,77,36,113
https://kawalpemilu.org#67846,"SUMBER MULIA, SIMPANG RAYA, BANGGAI, SULAWESI TENGAH",1,219,26,245
https://kawalpemilu.org#67846,"SUMBER MULIA, SIMPANG RAYA, BANGGAI, SULAWESI TENGAH",2,147,30,177
https://kawalpemilu.org#67846,"SUMBER MULIA, SIMPANG RAYA, BANGGAI, SULAWESI TENGAH",3,110,51,161
https://kawalpemilu.org#67846,"SUMBER MULIA, SIMPANG RAYA, BANGGAI, SULAWESI TENGAH",4,160,38,198
https://kawalpemilu.org#67846,"SUMBER MULIA, SIMPANG RAYA, BANGGAI, SULAWESI TENGAH",5,166,51,217
https://kawalpemilu.org#67846,"SUMBER MULIA, SIMPANG RAYA, BANGGAI, SULAWESI TENGAH",6,130,28,158
https://kawalpemilu.org#67846,"SUMBER MULIA, SIMPANG RAYA, BANGGAI, SULAWESI TENGAH",7,159,48,207
https://kawalpemilu.org#67846,"SUMBER MULIA, SIMPANG RAYA, BANGGAI, SULAWESI TENGAH",8,133,58,191
https://kawalpemilu.org#67846,"SUMBER MULIA, SIMPANG RAYA, BANGGAI, SULAWESI TENGAH",9,92,30,122
https://kawalpemilu.org#67846,"SUMBER MULIA, SIMPANG RAYA, BANGGAI, SULAWESI TENGAH",10,71,24,95
https://kawalpemilu.org#67846,"SUMBER MULIA, SIMPANG RAYA, BANGGAI, SULAWESI TENGAH",11,52,26,78
https://kawalpemilu.org#67847,"DODA BUNTA, SIMPANG RAYA, BANGGAI, SULAWESI TENGAH",2,110,23,133
https://kawalpemilu.org#67849,"SIMPANG DUA, SIMPANG RAYA, BANGGAI, SULAWESI TENGAH",1,142,42,184
https://kawalpemilu.org#67849,"SIMPANG DUA, SIMPANG RAYA, BANGGAI, SULAWESI TENGAH",2,106,26,132
https://kawalpemilu.org#67849,"SIMPANG DUA, SIMPANG RAYA, BANGGAI, SULAWESI TENGAH",3,108,35,143
https://kawalpemilu.org#67849,"SIMPANG DUA, SIMPANG RAYA, BANGGAI, SULAWESI TENGAH",4,65,1,66
https://kawalpemilu.org#67850,"DOWIWI, SIMPANG RAYA, BANGGAI, SULAWESI TENGAH",1,163,31,194
https://kawalpemilu.org#67852,"DWIPA KARYA, SIMPANG RAYA, BANGGAI, SULAWESI TENGAH",1,180,37,217
https://kawalpemilu.org#67852,"DWIPA KARYA, SIMPANG RAYA, BANGGAI, SULAWESI TENGAH",2,176,44,220
https://kawalpemilu.org#67852,"DWIPA KARYA, SIMPANG RAYA, BANGGAI, SULAWESI TENGAH",3,151,46,197
https://kawalpemilu.org#67852,"DWIPA KARYA, SIMPANG RAYA, BANGGAI, SULAWESI TENGAH",4,117,29,146
https://kawalpemilu.org#67852,"DWIPA KARYA, SIMPANG RAYA, BANGGAI, SULAWESI TENGAH",5,121,27,148
https://kawalpemilu.org#67852,"DWIPA KARYA, SIMPANG RAYA, BANGGAI, SULAWESI TENGAH",6,90,22,112
https://kawalpemilu.org#67853,"LOKAIT, SIMPANG RAYA, BANGGAI, SULAWESI TENGAH",1,176,40,216
https://kawalpemilu.org#67855,"TOMBOS, BALANTAK SELATAN, BANGGAI, SULAWESI TENGAH",1,92,120,212
https://kawalpemilu.org#67855,"TOMBOS, BALANTAK SELATAN, BANGGAI, SULAWESI TENGAH",2,54,139,193
https://kawalpemilu.org#67855,"TOMBOS, BALANTAK SELATAN, BANGGAI, SULAWESI TENGAH",3,76,124,200
https://kawalpemilu.org#67856,"DONDO, BALANTAK SELATAN, BANGGAI, SULAWESI TENGAH",1,96,54,150
https://kawalpemilu.org#67856,"DONDO, BALANTAK SELATAN, BANGGAI, SULAWESI TENGAH",2,66,15,81
https://kawalpemilu.org#67857,"SEPE, BALANTAK SELATAN, BANGGAI, SULAWESI TENGAH",1,32,55,87
https://kawalpemilu.org#67857,"SEPE, BALANTAK SELATAN, BANGGAI, SULAWESI TENGAH",2,55,88,143
https://kawalpemilu.org#67858,"BOOY, BALANTAK SELATAN, BANGGAI, SULAWESI TENGAH",1,131,51,182
https://kawalpemilu.org#67859,"TINTINGAN, BALANTAK SELATAN, BANGGAI, SULAWESI TENGAH",1,119,76,195
https://kawalpemilu.org#67860,"RESARNA, BALANTAK SELATAN, BANGGAI, SULAWESI TENGAH",1,127,25,152
https://kawalpemilu.org#67861,"GIWANG, BALANTAK SELATAN, BANGGAI, SULAWESI TENGAH",1,148,54,202
https://kawalpemilu.org#67861,"GIWANG, BALANTAK SELATAN, BANGGAI, SULAWESI TENGAH",2,163,33,196
https://kawalpemilu.org#67862,"TONGKE, BALANTAK SELATAN, BANGGAI, SULAWESI TENGAH",1,167,11,178
https://kawalpemilu.org#67862,"TONGKE, BALANTAK SELATAN, BANGGAI, SULAWESI TENGAH",2,150,21,171
https://kawalpemilu.org#67862,"TONGKE, BALANTAK SELATAN, BANGGAI, SULAWESI TENGAH",3,79,14,93
https://kawalpemilu.org#67863,"GORONTALO, BALANTAK SELATAN, BANGGAI, SULAWESI TENGAH",1,122,78,200
https://kawalpemilu.org#67864,"POYANG, BALANTAK SELATAN, BANGGAI, SULAWESI TENGAH",1,137,20,157
https://kawalpemilu.org#67864,"POYANG, BALANTAK SELATAN, BANGGAI, SULAWESI TENGAH",2,98,8,106
https://kawalpemilu.org#67865,"TANGGAWAS, BALANTAK SELATAN, BANGGAI, SULAWESI TENGAH",1,164,52,216
https://kawalpemilu.org#67662,"KAMPANGAR, BALANTAK UTARA, BANGGAI, SULAWESI TENGAH",1,93,136,229
https://kawalpemilu.org#67663,"TEKU, BALANTAK UTARA, BANGGAI, SULAWESI TENGAH",1,73,83,156
https://kawalpemilu.org#67663,"TEKU, BALANTAK UTARA, BANGGAI, SULAWESI TENGAH",2,83,72,155
https://kawalpemilu.org#67665,"BATU SIMPANG, BALANTAK UTARA, BANGGAI, SULAWESI TENGAH",1,86,107,193
https://kawalpemilu.org#67666,"PANGKALASEANG, BALANTAK UTARA, BANGGAI, SULAWESI TENGAH",1,126,81,207
https://kawalpemilu.org#67666,"PANGKALASEANG, BALANTAK UTARA, BANGGAI, SULAWESI TENGAH",2,72,105,177
https://kawalpemilu.org#67666,"PANGKALASEANG, BALANTAK UTARA, BANGGAI, SULAWESI TENGAH",3,96,80,176
https://kawalpemilu.org#67668,"KUNTANG, BALANTAK UTARA, BANGGAI, SULAWESI TENGAH",1,93,55,148
https://kawalpemilu.org#67668,"KUNTANG, BALANTAK UTARA, BANGGAI, SULAWESI TENGAH",2,55,59,114
https://kawalpemilu.org#85641,"ONDOLIANG, BALANTAK UTARA, BANGGAI, SULAWESI TENGAH",1,51,84,135
https://kawalpemilu.org#85641,"ONDOLIANG, BALANTAK UTARA, BANGGAI, SULAWESI TENGAH",2,51,60,111
https://kawalpemilu.org#85642,"BATU MANDI, BALANTAK UTARA, BANGGAI, SULAWESI TENGAH",1,156,46,202
https://kawalpemilu.org#85643,"PANGKALASEANG BARU, BALANTAK UTARA, BANGGAI, SULAWESI TENGAH",1,65,46,111
https://kawalpemilu.org#85643,"PANGKALASEANG BARU, BALANTAK UTARA, BANGGAI, SULAWESI TENGAH",2,93,42,135
https://kawalpemilu.org#85644,"TOWEER, BALANTAK UTARA, BANGGAI, SULAWESI TENGAH",1,63,94,157
https://kawalpemilu.org#85644,"TOWEER, BALANTAK UTARA, BANGGAI, SULAWESI TENGAH",2,57,91,148
https://kawalpemilu.org#87991,"PULAU DUA, BALANTAK UTARA, BANGGAI, SULAWESI TENGAH",1,91,156,247
https://kawalpemilu.org#67611,"MAAHAS, LUWUK SELATAN, BANGGAI, SULAWESI TENGAH",1,59,126,185
https://kawalpemilu.org#67611,"MAAHAS, LUWUK SELATAN, BANGGAI, SULAWESI TENGAH",2,78,168,246
https://kawalpemilu.org#67611,"MAAHAS, LUWUK SELATAN, BANGGAI, SULAWESI TENGAH",3,65,122,187
https://kawalpemilu.org#67611,"MAAHAS, LUWUK SELATAN, BANGGAI, SULAWESI TENGAH",5,49,127,173
https://kawalpemilu.org#67611,"MAAHAS, LUWUK SELATAN, BANGGAI, SULAWESI TENGAH",6,62,122,184
https://kawalpemilu.org#67611,"MAAHAS, LUWUK SELATAN, BANGGAI, SULAWESI TENGAH",7,95,159,254
https://kawalpemilu.org#67611,"MAAHAS, LUWUK SELATAN, BANGGAI, SULAWESI TENGAH",8,56,181,237
https://kawalpemilu.org#67611,"MAAHAS, LUWUK SELATAN, BANGGAI, SULAWESI TENGAH",9,77,122,199
https://kawalpemilu.org#67611,"MAAHAS, LUWUK SELATAN, BANGGAI, SULAWESI TENGAH",10,38,52,90
https://kawalpemilu.org#67612,"SIMPONG, LUWUK SELATAN, BANGGAI, SULAWESI TENGAH",1,73,141,214
https://kawalpemilu.org#67612,"SIMPONG, LUWUK SELATAN, BANGGAI, SULAWESI TENGAH",2,106,82,188
https://kawalpemilu.org#67612,"SIMPONG, LUWUK SELATAN, BANGGAI, SULAWESI TENGAH",3,51,121,172
https://kawalpemilu.org#67612,"SIMPONG, LUWUK SELATAN, BANGGAI, SULAWESI TENGAH",4,31,49,80
https://kawalpemilu.org#67612,"SIMPONG, LUWUK SELATAN, BANGGAI, SULAWESI TENGAH",5,68,92,160
https://kawalpemilu.org#67612,"SIMPONG, LUWUK SELATAN, BANGGAI, SULAWESI TENGAH",6,38,87,125
https://kawalpemilu.org#67612,"SIMPONG, LUWUK SELATAN, BANGGAI, SULAWESI TENGAH",7,54,96,150
https://kawalpemilu.org#67612,"SIMPONG, LUWUK SELATAN, BANGGAI, SULAWESI TENGAH",8,95,104,199
https://kawalpemilu.org#67612,"SIMPONG, LUWUK SELATAN, BANGGAI, SULAWESI TENGAH",9,52,99,151
https://kawalpemilu.org#67612,"SIMPONG, LUWUK SELATAN, BANGGAI, SULAWESI TENGAH",10,81,83,164
https://kawalpemilu.org#67612,"SIMPONG, LUWUK SELATAN, BANGGAI, SULAWESI TENGAH",11,56,129,185
https://kawalpemilu.org#67612,"SIMPONG, LUWUK SELATAN, BANGGAI, SULAWESI TENGAH",12,52,172,224
https://kawalpemilu.org#67613,"HANGA HANGA, LUWUK SELATAN, BANGGAI, SULAWESI TENGAH",3,86,108,194
https://kawalpemilu.org#67613,"HANGA HANGA, LUWUK SELATAN, BANGGAI, SULAWESI TENGAH",4,102,129,231
https://kawalpemilu.org#67613,"HANGA HANGA, LUWUK SELATAN, BANGGAI, SULAWESI TENGAH",5,50,153,203
https://kawalpemilu.org#67613,"HANGA HANGA, LUWUK SELATAN, BANGGAI, SULAWESI TENGAH",6,99,119,218
https://kawalpemilu.org#67613,"HANGA HANGA, LUWUK SELATAN, BANGGAI, SULAWESI TENGAH",7,91,98,189
https://kawalpemilu.org#67620,"BUBUNG, LUWUK SELATAN, BANGGAI, SULAWESI TENGAH",1,111,117,228
https://kawalpemilu.org#67620,"BUBUNG, LUWUK SELATAN, BANGGAI, SULAWESI TENGAH",2,111,119,230
https://kawalpemilu.org#67620,"BUBUNG, LUWUK SELATAN, BANGGAI, SULAWESI TENGAH",3,109,95,204
https://kawalpemilu.org#85645,"JOLE, LUWUK SELATAN, BANGGAI, SULAWESI TENGAH",1,100,149,249
https://kawalpemilu.org#85645,"JOLE, LUWUK SELATAN, BANGGAI, SULAWESI TENGAH",2,78,140,218
https://kawalpemilu.org#85645,"JOLE, LUWUK SELATAN, BANGGAI, SULAWESI TENGAH",3,83,99,182
https://kawalpemilu.org#85645,"JOLE, LUWUK SELATAN, BANGGAI, SULAWESI TENGAH",4,62,68,130
https://kawalpemilu.org#85645,"JOLE, LUWUK SELATAN, BANGGAI, SULAWESI TENGAH",5,39,31,70
https://kawalpemilu.org#85646,"HANGA-HANGA PERMAI, LUWUK SELATAN, BANGGAI, SULAWESI TENGAH",1,77,107,184
https://kawalpemilu.org#85646,"HANGA-HANGA PERMAI, LUWUK SELATAN, BANGGAI, SULAWESI TENGAH",2,75,156,231
https://kawalpemilu.org#85646,"HANGA-HANGA PERMAI, LUWUK SELATAN, BANGGAI, SULAWESI TENGAH",3,84,119,203
https://kawalpemilu.org#85646,"HANGA-HANGA PERMAI, LUWUK SELATAN, BANGGAI, SULAWESI TENGAH",4,58,94,152
https://kawalpemilu.org#85646,"HANGA-HANGA PERMAI, LUWUK SELATAN, BANGGAI, SULAWESI TENGAH",5,44,74,118
https://kawalpemilu.org#85647,"KOMPO, LUWUK SELATAN, BANGGAI, SULAWESI TENGAH",1,83,155,238
https://kawalpemilu.org#85647,"KOMPO, LUWUK SELATAN, BANGGAI, SULAWESI TENGAH",2,89,143,232
https://kawalpemilu.org#85647,"KOMPO, LUWUK SELATAN, BANGGAI, SULAWESI TENGAH",3,76,129,205
https://kawalpemilu.org#85647,"KOMPO, LUWUK SELATAN, BANGGAI, SULAWESI TENGAH",4,69,142,211
https://kawalpemilu.org#85647,"KOMPO, LUWUK SELATAN, BANGGAI, SULAWESI TENGAH",5,45,74,119
https://kawalpemilu.org#85647,"KOMPO, LUWUK SELATAN, BANGGAI, SULAWESI TENGAH",6,36,79,115
https://kawalpemilu.org#85647,"KOMPO, LUWUK SELATAN, BANGGAI, SULAWESI TENGAH",7,62,81,143
https://kawalpemilu.org#85647,"KOMPO, LUWUK SELATAN, BANGGAI, SULAWESI TENGAH",8,40,58,98
https://kawalpemilu.org#85648,"BUKIT MEMBUAL, LUWUK SELATAN, BANGGAI, SULAWESI TENGAH",1,87,99,186
https://kawalpemilu.org#85648,"BUKIT MEMBUAL, LUWUK SELATAN, BANGGAI, SULAWESI TENGAH",2,74,128,202
https://kawalpemilu.org#85648,"BUKIT MEMBUAL, LUWUK SELATAN, BANGGAI, SULAWESI TENGAH",3,93,96,189
https://kawalpemilu.org#85648,"BUKIT MEMBUAL, LUWUK SELATAN, BANGGAI, SULAWESI TENGAH",4,69,92,161
https://kawalpemilu.org#85649,"TOMBANG PERMAI, LUWUK SELATAN, BANGGAI, SULAWESI TENGAH",1,85,92,177
https://kawalpemilu.org#85649,"TOMBANG PERMAI, LUWUK SELATAN, BANGGAI, SULAWESI TENGAH",2,67,95,162
https://kawalpemilu.org#85649,"TOMBANG PERMAI, LUWUK SELATAN, BANGGAI, SULAWESI TENGAH",3,35,72,107
https://kawalpemilu.org#85649,"TOMBANG PERMAI, LUWUK SELATAN, BANGGAI, SULAWESI TENGAH",4,38,26,64
https://kawalpemilu.org#85649,"TOMBANG PERMAI, LUWUK SELATAN, BANGGAI, SULAWESI TENGAH",5,28,33,61
https://kawalpemilu.org#85650,"TANJUNG TUWIS, LUWUK SELATAN, BANGGAI, SULAWESI TENGAH",1,95,114,209
https://kawalpemilu.org#85650,"TANJUNG TUWIS, LUWUK SELATAN, BANGGAI, SULAWESI TENGAH",2,78,163,241
https://kawalpemilu.org#85650,"TANJUNG TUWIS, LUWUK SELATAN, BANGGAI, SULAWESI TENGAH",3,56,164,220
https://kawalpemilu.org#85650,"TANJUNG TUWIS, LUWUK SELATAN, BANGGAI, SULAWESI TENGAH",4,62,176,238
https://kawalpemilu.org#85650,"TANJUNG TUWIS, LUWUK SELATAN, BANGGAI, SULAWESI TENGAH",5,52,185,237
https://kawalpemilu.org#67618,"KILONGAN, LUWUK UTARA, BANGGAI, SULAWESI TENGAH",1,96,98,194
https://kawalpemilu.org#67618,"KILONGAN, LUWUK UTARA, BANGGAI, SULAWESI TENGAH",2,92,157,249
https://kawalpemilu.org#67618,"KILONGAN, LUWUK UTARA, BANGGAI, SULAWESI TENGAH",3,45,62,107
https://kawalpemilu.org#67618,"KILONGAN, LUWUK UTARA, BANGGAI, SULAWESI TENGAH",4,107,102,209
https://kawalpemilu.org#67618,"KILONGAN, LUWUK UTARA, BANGGAI, SULAWESI TENGAH",5,149,95,244
https://kawalpemilu.org#67618,"KILONGAN, LUWUK UTARA, BANGGAI, SULAWESI TENGAH",6,71,39,110
https://kawalpemilu.org#67618,"KILONGAN, LUWUK UTARA, BANGGAI, SULAWESI TENGAH",9,97,84,181
https://kawalpemilu.org#67623,"BUMI BERINGIN, LUWUK UTARA, BANGGAI, SULAWESI TENGAH",1,104,94,198
https://kawalpemilu.org#67623,"BUMI BERINGIN, LUWUK UTARA, BANGGAI, SULAWESI TENGAH",2,65,43,108
https://kawalpemilu.org#67623,"BUMI BERINGIN, LUWUK UTARA, BANGGAI, SULAWESI TENGAH",3,44,44,88
https://kawalpemilu.org#67624,"BOYOU, LUWUK UTARA, BANGGAI, SULAWESI TENGAH",1,132,90,222
https://kawalpemilu.org#67624,"BOYOU, LUWUK UTARA, BANGGAI, SULAWESI TENGAH",2,110,105,215
https://kawalpemilu.org#67624,"BOYOU, LUWUK UTARA, BANGGAI, SULAWESI TENGAH",3,106,101,207
https://kawalpemilu.org#67625,"BIAK, LUWUK UTARA, BANGGAI, SULAWESI TENGAH",1,131,123,254
https://kawalpemilu.org#67625,"BIAK, LUWUK UTARA, BANGGAI, SULAWESI TENGAH",2,111,103,214
https://kawalpemilu.org#67625,"BIAK, LUWUK UTARA, BANGGAI, SULAWESI TENGAH",3,131,113,244
https://kawalpemilu.org#67625,"BIAK, LUWUK UTARA, BANGGAI, SULAWESI TENGAH",4,148,92,240
https://kawalpemilu.org#67625,"BIAK, LUWUK UTARA, BANGGAI, SULAWESI TENGAH",5,68,56,124
https://kawalpemilu.org#67625,"BIAK, LUWUK UTARA, BANGGAI, SULAWESI TENGAH",6,107,69,176
https://kawalpemilu.org#67625,"BIAK, LUWUK UTARA, BANGGAI, SULAWESI TENGAH",7,63,28,91
https://kawalpemilu.org#67626,"BUNGA, LUWUK UTARA, BANGGAI, SULAWESI TENGAH",1,127,82,209
https://kawalpemilu.org#67626,"BUNGA, LUWUK UTARA, BANGGAI, SULAWESI TENGAH",2,62,49,111
https://kawalpemilu.org#67626,"BUNGA, LUWUK UTARA, BANGGAI, SULAWESI TENGAH",3,165,49,214
https://kawalpemilu.org#67626,"BUNGA, LUWUK UTARA, BANGGAI, SULAWESI TENGAH",4,101,42,143
https://kawalpemilu.org#67626,"BUNGA, LUWUK UTARA, BANGGAI, SULAWESI TENGAH",5,86,43,129
https://kawalpemilu.org#67626,"BUNGA, LUWUK UTARA, BANGGAI, SULAWESI TENGAH",6,118,62,180
https://kawalpemilu.org#67627,"KAMUMU, LUWUK UTARA, BANGGAI, SULAWESI TENGAH",1,215,7,222
https://kawalpemilu.org#67627,"KAMUMU, LUWUK UTARA, BANGGAI, SULAWESI TENGAH",2,148,3,151
https://kawalpemilu.org#67627,"KAMUMU, LUWUK UTARA, BANGGAI, SULAWESI TENGAH",3,95,5,100
https://kawalpemilu.org#67628,"SALODIK, LUWUK UTARA, BANGGAI, SULAWESI TENGAH",1,102,90,192
https://kawalpemilu.org#67628,"SALODIK, LUWUK UTARA, BANGGAI, SULAWESI TENGAH",2,86,7,93
https://kawalpemilu.org#67628,"SALODIK, LUWUK UTARA, BANGGAI, SULAWESI TENGAH",3,87,44,131
https://kawalpemilu.org#67628,"SALODIK, LUWUK UTARA, BANGGAI, SULAWESI TENGAH",4,88,65,153
https://kawalpemilu.org#67629,"AWU, LUWUK UTARA, BANGGAI, SULAWESI TENGAH",1,70,140,210
https://kawalpemilu.org#67629,"AWU, LUWUK UTARA, BANGGAI, SULAWESI TENGAH",2,89,89,178
https://kawalpemilu.org#67629,"AWU, LUWUK UTARA, BANGGAI, SULAWESI TENGAH",3,70,129,199
https://kawalpemilu.org#85651,"KILONGAN PERMAI, LUWUK UTARA, BANGGAI, SULAWESI TENGAH",1,87,76,163
https://kawalpemilu.org#85651,"KILONGAN PERMAI, LUWUK UTARA, BANGGAI, SULAWESI TENGAH",2,47,79,126
https://kawalpemilu.org#85651,"KILONGAN PERMAI, LUWUK UTARA, BANGGAI, SULAWESI TENGAH",3,125,98,223
https://kawalpemilu.org#85651,"KILONGAN PERMAI, LUWUK UTARA, BANGGAI, SULAWESI TENGAH",4,86,130,216
https://kawalpemilu.org#85651,"KILONGAN PERMAI, LUWUK UTARA, BANGGAI, SULAWESI TENGAH",5,90,108,198
https://kawalpemilu.org#85651,"KILONGAN PERMAI, LUWUK UTARA, BANGGAI, SULAWESI TENGAH",6,84,121,205
https://kawalpemilu.org#85651,"KILONGAN PERMAI, LUWUK UTARA, BANGGAI, SULAWESI TENGAH",7,72,116,188
https://kawalpemilu.org#85651,"KILONGAN PERMAI, LUWUK UTARA, BANGGAI, SULAWESI TENGAH",8,62,81,143
https://kawalpemilu.org#85651,"KILONGAN PERMAI, LUWUK UTARA, BANGGAI, SULAWESI TENGAH",9,86,95,181
https://kawalpemilu.org#85652,"LENYEK, LUWUK UTARA, BANGGAI, SULAWESI TENGAH",1,152,13,165
https://kawalpemilu.org#85652,"LENYEK, LUWUK UTARA, BANGGAI, SULAWESI TENGAH",2,117,33,150
https://kawalpemilu.org#85653,"BUON MANDIRI, LUWUK UTARA, BANGGAI, SULAWESI TENGAH",1,150,94,244
https://kawalpemilu.org#85653,"BUON MANDIRI, LUWUK UTARA, BANGGAI, SULAWESI TENGAH",2,171,49,220
https://kawalpemilu.org#67631,"LONAS, MANTOH, BANGGAI, SULAWESI TENGAH",1,152,42,194
https://kawalpemilu.org#67631,"LONAS, MANTOH, BANGGAI, SULAWESI TENGAH",2,98,35,133
https://kawalpemilu.org#67632,"BORAS, MANTOH, BANGGAI, SULAWESI TENGAH",1,131,10,141
https://kawalpemilu.org#67632,"BORAS, MANTOH, BANGGAI, SULAWESI TENGAH",2,112,5,117
https://kawalpemilu.org#67633,"SULUBOMBONG, MANTOH, BANGGAI, SULAWESI TENGAH",1,186,17,203
https://kawalpemilu.org#67633,"SULUBOMBONG, MANTOH, BANGGAI, SULAWESI TENGAH",2,173,15,188
https://kawalpemilu.org#67633,"SULUBOMBONG, MANTOH, BANGGAI, SULAWESI TENGAH",3,170,1,181
https://kawalpemilu.org#67633,"SULUBOMBONG, MANTOH, BANGGAI, SULAWESI TENGAH",4,144,8,152
https://kawalpemilu.org#67636,"BINOTIK, MANTOH, BANGGAI, SULAWESI TENGAH",1,121,36,157
https://kawalpemilu.org#67636,"BINOTIK, MANTOH, BANGGAI, SULAWESI TENGAH",2,122,21,143
https://kawalpemilu.org#67637,"SOBOL, MANTOH, BANGGAI, SULAWESI TENGAH",1,157,17,174
https://kawalpemilu.org#67637,"SOBOL, MANTOH, BANGGAI, SULAWESI TENGAH",2,204,28,232
https://kawalpemilu.org#67649,"GARUGA, MANTOH, BANGGAI, SULAWESI TENGAH",1,99,58,157
https://kawalpemilu.org#85654,"SOBOL BARU, MANTOH, BANGGAI, SULAWESI TENGAH",1,145,34,179
https://kawalpemilu.org#85654,"SOBOL BARU, MANTOH, BANGGAI, SULAWESI TENGAH",2,103,30,133
https://kawalpemilu.org#85655,"BOLLA, MANTOH, BANGGAI, SULAWESI TENGAH",2,109,20,129
https://kawalpemilu.org#87992,"PONDANG, MANTOH, BANGGAI, SULAWESI TENGAH",1,159,33,192
https://kawalpemilu.org#87992,"PONDANG, MANTOH, BANGGAI, SULAWESI TENGAH",2,144,42,186
https://kawalpemilu.org#87992,"PONDANG, MANTOH, BANGGAI, SULAWESI TENGAH",3,177,31,208
https://kawalpemilu.org#87992,"PONDANG, MANTOH, BANGGAI, SULAWESI TENGAH",4,175,25,200
https://kawalpemilu.org#87992,"PONDANG, MANTOH, BANGGAI, SULAWESI TENGAH",5,163,33,196
https://kawalpemilu.org#87993,"BOMBONGAN, MANTOH, BANGGAI, SULAWESI TENGAH",1,167,11,178
https://kawalpemilu.org#87993,"BOMBONGAN, MANTOH, BANGGAI, SULAWESI TENGAH",2,198,18,216
https://kawalpemilu.org#87993,"BOMBONGAN, MANTOH, BANGGAI, SULAWESI TENGAH",3,110,7,117
https://kawalpemilu.org#67595,"LONTIO, NAMBO, BANGGAI, SULAWESI TENGAH",1,108,70,178
https://kawalpemilu.org#67595,"LONTIO, NAMBO, BANGGAI, SULAWESI TENGAH",2,99,93,192
https://kawalpemilu.org#67595,"LONTIO, NAMBO, BANGGAI, SULAWESI TENGAH",3,92,86,178
https://kawalpemilu.org#67605,"PADUNGNYO, NAMBO, BANGGAI, SULAWESI TENGAH",1,74,106,180
https://kawalpemilu.org#67605,"PADUNGNYO, NAMBO, BANGGAI, SULAWESI TENGAH",2,75,69,144
https://kawalpemilu.org#67605,"PADUNGNYO, NAMBO, BANGGAI, SULAWESI TENGAH",3,90,75,165
https://kawalpemilu.org#67605,"PADUNGNYO, NAMBO, BANGGAI, SULAWESI TENGAH",4,98,95,193
https://kawalpemilu.org#67609,"NAMBO PADANG, NAMBO, BANGGAI, SULAWESI TENGAH",1,71,83,154
https://kawalpemilu.org#67609,"NAMBO PADANG, NAMBO, BANGGAI, SULAWESI TENGAH",2,91,67,158
https://kawalpemilu.org#67609,"NAMBO PADANG, NAMBO, BANGGAI, SULAWESI TENGAH",3,83,88,171
https://kawalpemilu.org#67610,"NAMBO LEMPEK, NAMBO, BANGGAI, SULAWESI TENGAH",1,73,119,192
https://kawalpemilu.org#67610,"NAMBO LEMPEK, NAMBO, BANGGAI, SULAWESI TENGAH",2,78,122,200
https://kawalpemilu.org#67610,"NAMBO LEMPEK, NAMBO, BANGGAI, SULAWESI TENGAH",3,70,126,196
https://kawalpemilu.org#67619,"KOYOAN, NAMBO, BANGGAI, SULAWESI TENGAH",1,56,165,221
https://kawalpemilu.org#67619,"KOYOAN, NAMBO, BANGGAI, SULAWESI TENGAH",2,88,117,205
https://kawalpemilu.org#85656,"NAMBO BOSAA, NAMBO, BANGGAI, SULAWESI TENGAH",1,86,148,234
https://kawalpemilu.org#85656,"NAMBO BOSAA, NAMBO, BANGGAI, SULAWESI TENGAH",2,59,64,123
https://kawalpemilu.org#85656,"NAMBO BOSAA, NAMBO, BANGGAI, SULAWESI TENGAH",3,54,64,118
https://kawalpemilu.org#85657,"NAMBO LEMPEK BARU, NAMBO, BANGGAI, SULAWESI TENGAH",1,69,111,180
https://kawalpemilu.org#85657,"NAMBO LEMPEK BARU, NAMBO, BANGGAI, SULAWESI TENGAH",2,88,103,191
https://kawalpemilu.org#85657,"NAMBO LEMPEK BARU, NAMBO, BANGGAI, SULAWESI TENGAH",3,90,106,196
https://kawalpemilu.org#85658,"LONTIO BARU, NAMBO, BANGGAI, SULAWESI TENGAH",1,111,88,199
https://kawalpemilu.org#85658,"LONTIO BARU, NAMBO, BANGGAI, SULAWESI TENGAH",2,84,112,196
https://kawalpemilu.org#85659,"KOYOAN PERMAI, NAMBO, BANGGAI, SULAWESI TENGAH",1,71,111,182
https://kawalpemilu.org#85659,"KOYOAN PERMAI, NAMBO, BANGGAI, SULAWESI TENGAH",2,75,107,182
https://kawalpemilu.org#85660,"SAYANGBONGIN, NAMBO, BANGGAI, SULAWESI TENGAH",1,75,63,138
https://kawalpemilu.org#85660,"SAYANGBONGIN, NAMBO, BANGGAI, SULAWESI TENGAH",2,91,82,173
https://kawalpemilu.org#85660,"SAYANGBONGIN, NAMBO, BANGGAI, SULAWESI TENGAH",3,96,75,171
https://kawalpemilu.org#85661,"LUMBE, NAMBO, BANGGAI, SULAWESI TENGAH",1,109,109,218
https://kawalpemilu.org#85661,"LUMBE, NAMBO, BANGGAI, SULAWESI TENGAH",2,81,111,192
https://kawalpemilu.org#67868,"MOENGKO LAMA, POSO KOTA, POSO, SULAWESI TENGAH",1,30,107,137
https://kawalpemilu.org#67868,"MOENGKO LAMA, POSO KOTA, POSO, SULAWESI TENGAH",2,36,142,178
https://kawalpemilu.org#67868,"MOENGKO LAMA, POSO KOTA, POSO, SULAWESI TENGAH",3,67,100,167
https://kawalpemilu.org#67868,"MOENGKO LAMA, POSO KOTA, POSO, SULAWESI TENGAH",4,49,118,167
https://kawalpemilu.org#67868,"MOENGKO LAMA, POSO KOTA, POSO, SULAWESI TENGAH",5,46,135,181
https://kawalpemilu.org#67868,"MOENGKO LAMA, POSO KOTA, POSO, SULAWESI TENGAH",6,81,109,190
https://kawalpemilu.org#67868,"MOENGKO LAMA, POSO KOTA, POSO, SULAWESI TENGAH",7,57,135,192
https://kawalpemilu.org#67868,"MOENGKO LAMA, POSO KOTA, POSO, SULAWESI TENGAH",8,34,158,192
https://kawalpemilu.org#67869,"MOENGKO BARU, POSO KOTA, POSO, SULAWESI TENGAH",1,35,161,196
https://kawalpemilu.org#67869,"MOENGKO BARU, POSO KOTA, POSO, SULAWESI TENGAH",2,44,149,193
https://kawalpemilu.org#67869,"MOENGKO BARU, POSO KOTA, POSO, SULAWESI TENGAH",3,48,133,181
https://kawalpemilu.org#67869,"MOENGKO BARU, POSO KOTA, POSO, SULAWESI TENGAH",4,22,113,135
https://kawalpemilu.org#67869,"MOENGKO BARU, POSO KOTA, POSO, SULAWESI TENGAH",5,37,127,164
https://kawalpemilu.org#67870,"KAYAMANYA, POSO KOTA, POSO, SULAWESI TENGAH",1,29,114,143
https://kawalpemilu.org#67870,"KAYAMANYA, POSO KOTA, POSO, SULAWESI TENGAH",2,38,124,162
https://kawalpemilu.org#67870,"KAYAMANYA, POSO KOTA, POSO, SULAWESI TENGAH",3,62,153,217
https://kawalpemilu.org#67870,"KAYAMANYA, POSO KOTA, POSO, SULAWESI TENGAH",4,42,118,160
https://kawalpemilu.org#67870,"KAYAMANYA, POSO KOTA, POSO, SULAWESI TENGAH",5,36,141,177
https://kawalpemilu.org#67870,"KAYAMANYA, POSO KOTA, POSO, SULAWESI TENGAH",6,94,146,240
https://kawalpemilu.org#67870,"KAYAMANYA, POSO KOTA, POSO, SULAWESI TENGAH",7,31,119,150
https://kawalpemilu.org#67870,"KAYAMANYA, POSO KOTA, POSO, SULAWESI TENGAH",8,27,107,134
https://kawalpemilu.org#67870,"KAYAMANYA, POSO KOTA, POSO, SULAWESI TENGAH",9,32,97,129
https://kawalpemilu.org#67870,"KAYAMANYA, POSO KOTA, POSO, SULAWESI TENGAH",10,32,92,124
https://kawalpemilu.org#67870,"KAYAMANYA, POSO KOTA, POSO, SULAWESI TENGAH",11,55,163,218
https://kawalpemilu.org#67870,"KAYAMANYA, POSO KOTA, POSO, SULAWESI TENGAH",12,22,81,103
https://kawalpemilu.org#67871,"GEBANGREJO, POSO KOTA, POSO, SULAWESI TENGAH",1,31,152,183
https://kawalpemilu.org#67871,"GEBANGREJO, POSO KOTA, POSO, SULAWESI TENGAH",2,32,91,123
https://kawalpemilu.org#67871,"GEBANGREJO, POSO KOTA, POSO, SULAWESI TENGAH",3,47,88,135
https://kawalpemilu.org#67871,"GEBANGREJO, POSO KOTA, POSO, SULAWESI TENGAH",4,47,132,179
https://kawalpemilu.org#67871,"GEBANGREJO, POSO KOTA, POSO, SULAWESI TENGAH",5,27,134,161
https://kawalpemilu.org#67871,"GEBANGREJO, POSO KOTA, POSO, SULAWESI TENGAH",6,68,180,248
https://kawalpemilu.org#67871,"GEBANGREJO, POSO KOTA, POSO, SULAWESI TENGAH",7,55,118,173
https://kawalpemilu.org#67871,"GEBANGREJO, POSO KOTA, POSO, SULAWESI TENGAH",8,45,155,200
https://kawalpemilu.org#67871,"GEBANGREJO, POSO KOTA, POSO, SULAWESI TENGAH",9,42,144,186
https://kawalpemilu.org#67871,"GEBANGREJO, POSO KOTA, POSO, SULAWESI TENGAH",10,14,18,32
https://kawalpemilu.org#67871,"GEBANGREJO, POSO KOTA, POSO, SULAWESI TENGAH",11,24,50,74
https://kawalpemilu.org#67871,"GEBANGREJO, POSO KOTA, POSO, SULAWESI TENGAH",12,31,140,171
https://kawalpemilu.org#67871,"GEBANGREJO, POSO KOTA, POSO, SULAWESI TENGAH",13,29,69,98
https://kawalpemilu.org#67871,"GEBANGREJO, POSO KOTA, POSO, SULAWESI TENGAH",14,18,37,55
https://kawalpemilu.org#67871,"GEBANGREJO, POSO KOTA, POSO, SULAWESI TENGAH",15,17,59,76
https://kawalpemilu.org#67871,"GEBANGREJO, POSO KOTA, POSO, SULAWESI TENGAH",16,34,82,116
https://kawalpemilu.org#929208,"GEBANGREJO TIMUR, POSO KOTA, POSO, SULAWESI TENGAH",1,60,99,159
https://kawalpemilu.org#929208,"GEBANGREJO TIMUR, POSO KOTA, POSO, SULAWESI TENGAH",2,54,111,165
https://kawalpemilu.org#929208,"GEBANGREJO TIMUR, POSO KOTA, POSO, SULAWESI TENGAH",3,58,116,174
https://kawalpemilu.org#929208,"GEBANGREJO TIMUR, POSO KOTA, POSO, SULAWESI TENGAH",4,37,82,119
https://kawalpemilu.org#929208,"GEBANGREJO TIMUR, POSO KOTA, POSO, SULAWESI TENGAH",5,42,96,138
https://kawalpemilu.org#929208,"GEBANGREJO TIMUR, POSO KOTA, POSO, SULAWESI TENGAH",6,75,99,174
https://kawalpemilu.org#929208,"GEBANGREJO TIMUR, POSO KOTA, POSO, SULAWESI TENGAH",7,32,69,101
https://kawalpemilu.org#929208,"GEBANGREJO TIMUR, POSO KOTA, POSO, SULAWESI TENGAH",8,42,133,175
https://kawalpemilu.org#929208,"GEBANGREJO TIMUR, POSO KOTA, POSO, SULAWESI TENGAH",9,60,100,160
https://kawalpemilu.org#929209,"GEBANGREJO BARAT, POSO KOTA, POSO, SULAWESI TENGAH",1,40,65,105
https://kawalpemilu.org#929209,"GEBANGREJO BARAT, POSO KOTA, POSO, SULAWESI TENGAH",2,57,124,181
https://kawalpemilu.org#929209,"GEBANGREJO BARAT, POSO KOTA, POSO, SULAWESI TENGAH",3,51,109,160
https://kawalpemilu.org#929209,"GEBANGREJO BARAT, POSO KOTA, POSO, SULAWESI TENGAH",4,78,94,172
https://kawalpemilu.org#929209,"GEBANGREJO BARAT, POSO KOTA, POSO, SULAWESI TENGAH",5,46,125,171
https://kawalpemilu.org#929209,"GEBANGREJO BARAT, POSO KOTA, POSO, SULAWESI TENGAH",6,56,142,198
https://kawalpemilu.org#929209,"GEBANGREJO BARAT, POSO KOTA, POSO, SULAWESI TENGAH",7,37,42,79
https://kawalpemilu.org#929209,"GEBANGREJO BARAT, POSO KOTA, POSO, SULAWESI TENGAH",8,35,64,99
https://kawalpemilu.org#929210,"KAYAMANYA SENTRAL, POSO KOTA, POSO, SULAWESI TENGAH",1,47,145,192
https://kawalpemilu.org#929210,"KAYAMANYA SENTRAL, POSO KOTA, POSO, SULAWESI TENGAH",2,33,74,107
https://kawalpemilu.org#929210,"KAYAMANYA SENTRAL, POSO KOTA, POSO, SULAWESI TENGAH",3,38,90,128
https://kawalpemilu.org#929210,"KAYAMANYA SENTRAL, POSO KOTA, POSO, SULAWESI TENGAH",4,30,95,125
https://kawalpemilu.org#929210,"KAYAMANYA SENTRAL, POSO KOTA, POSO, SULAWESI TENGAH",5,30,65,95
https://kawalpemilu.org#929210,"KAYAMANYA SENTRAL, POSO KOTA, POSO, SULAWESI TENGAH",6,39,145,184
https://kawalpemilu.org#929210,"KAYAMANYA SENTRAL, POSO KOTA, POSO, SULAWESI TENGAH",7,50,89,139
https://kawalpemilu.org#929210,"KAYAMANYA SENTRAL, POSO KOTA, POSO, SULAWESI TENGAH",8,33,109,142
https://kawalpemilu.org#929210,"KAYAMANYA SENTRAL, POSO KOTA, POSO, SULAWESI TENGAH",9,37,98,135
https://kawalpemilu.org#929210,"KAYAMANYA SENTRAL, POSO KOTA, POSO, SULAWESI TENGAH",10,18,45,63
https://kawalpemilu.org#929210,"KAYAMANYA SENTRAL, POSO KOTA, POSO, SULAWESI TENGAH",11,39,72,111
https://kawalpemilu.org#67873,"KASINGUNCU, POSO PESISIR, POSO, SULAWESI TENGAH",1,43,146,189
https://kawalpemilu.org#67873,"KASINGUNCU, POSO PESISIR, POSO, SULAWESI TENGAH",2,127,24,151
https://kawalpemilu.org#67873,"KASINGUNCU, POSO PESISIR, POSO, SULAWESI TENGAH",3,151,28,179
https://kawalpemilu.org#67873,"KASINGUNCU, POSO PESISIR, POSO, SULAWESI TENGAH",4,48,140,188
https://kawalpemilu.org#67873,"KASINGUNCU, POSO PESISIR, POSO, SULAWESI TENGAH",5,57,76,133
https://kawalpemilu.org#67873,"KASINGUNCU, POSO PESISIR, POSO, SULAWESI TENGAH",6,62,57,119
https://kawalpemilu.org#67873,"KASINGUNCU, POSO PESISIR, POSO, SULAWESI TENGAH",7,185,31,216
https://kawalpemilu.org#67873,"KASINGUNCU, POSO PESISIR, POSO, SULAWESI TENGAH",8,81,93,174
https://kawalpemilu.org#67873,"KASINGUNCU, POSO PESISIR, POSO, SULAWESI TENGAH",9,41,81,122
https://kawalpemilu.org#67874,"MAPANE, POSO PESISIR, POSO, SULAWESI TENGAH",1,56,143,199
https://kawalpemilu.org#67874,"MAPANE, POSO PESISIR, POSO, SULAWESI TENGAH",2,88,117,205
https://kawalpemilu.org#67874,"MAPANE, POSO PESISIR, POSO, SULAWESI TENGAH",3,70,142,212
https://kawalpemilu.org#67874,"MAPANE, POSO PESISIR, POSO, SULAWESI TENGAH",4,74,110,184
https://kawalpemilu.org#67874,"MAPANE, POSO PESISIR, POSO, SULAWESI TENGAH",5,57,132,189
https://kawalpemilu.org#67874,"MAPANE, POSO PESISIR, POSO, SULAWESI TENGAH",6,65,115,180
https://kawalpemilu.org#67875,"BETANIA, POSO PESISIR, POSO, SULAWESI TENGAH",1,154,27,181
https://kawalpemilu.org#67875,"BETANIA, POSO PESISIR, POSO, SULAWESI TENGAH",2,143,36,179
https://kawalpemilu.org#67875,"BETANIA, POSO PESISIR, POSO, SULAWESI TENGAH",3,140,39,179
https://kawalpemilu.org#67876,"TOINI, POSO PESISIR, POSO, SULAWESI TENGAH",1,54,61,115
https://kawalpemilu.org#67876,"TOINI, POSO PESISIR, POSO, SULAWESI TENGAH",2,53,97,150
https://kawalpemilu.org#67876,"TOINI, POSO PESISIR, POSO, SULAWESI TENGAH",3,55,116,171
https://kawalpemilu.org#67876,"TOINI, POSO PESISIR, POSO, SULAWESI TENGAH",4,53,98,151
https://kawalpemilu.org#67876,"TOINI, POSO PESISIR, POSO, SULAWESI TENGAH",5,128,38,166
https://kawalpemilu.org#67876,"TOINI, POSO PESISIR, POSO, SULAWESI TENGAH",6,58,81,139
https://kawalpemilu.org#67877,"BEGA, POSO PESISIR, POSO, SULAWESI TENGAH",1,18,144,162
https://kawalpemilu.org#67877,"BEGA, POSO PESISIR, POSO, SULAWESI TENGAH",2,25,153,178
https://kawalpemilu.org#67877,"BEGA, POSO PESISIR, POSO, SULAWESI TENGAH",3,9,142,151
https://kawalpemilu.org#67878,"MASAMBA, POSO PESISIR, POSO, SULAWESI TENGAH",1,66,92,158
https://kawalpemilu.org#67878,"MASAMBA, POSO PESISIR, POSO, SULAWESI TENGAH",2,41,82,123
https://kawalpemilu.org#67878,"MASAMBA, POSO PESISIR, POSO, SULAWESI TENGAH",3,70,64,134
https://kawalpemilu.org#67879,"SAATU, POSO PESISIR, POSO, SULAWESI TENGAH",1,143,25,168
https://kawalpemilu.org#67879,"SAATU, POSO PESISIR, POSO, SULAWESI TENGAH",2,173,24,197
https://kawalpemilu.org#67880,"PINEDAPA, POSO PESISIR, POSO, SULAWESI TENGAH",1,117,17,134
https://kawalpemilu.org#67880,"PINEDAPA, POSO PESISIR, POSO, SULAWESI TENGAH",2,159,15,174
https://kawalpemilu.org#67880,"PINEDAPA, POSO PESISIR, POSO, SULAWESI TENGAH",3,103,49,152
https://kawalpemilu.org#67880,"PINEDAPA, POSO PESISIR, POSO, SULAWESI TENGAH",4,95,55,150
https://kawalpemilu.org#67880,"PINEDAPA, POSO PESISIR, POSO, SULAWESI TENGAH",5,118,33,151
https://kawalpemilu.org#67881,"MASANI, POSO PESISIR, POSO, SULAWESI TENGAH",1,190,12,202
https://kawalpemilu.org#67881,"MASANI, POSO PESISIR, POSO, SULAWESI TENGAH",2,41,111,152
https://kawalpemilu.org#67882,"TOKORONDO, POSO PESISIR, POSO, SULAWESI TENGAH",1,87,119,206
https://kawalpemilu.org#67882,"TOKORONDO, POSO PESISIR, POSO, SULAWESI TENGAH",2,58,108,166
https://kawalpemilu.org#67882,"TOKORONDO, POSO PESISIR, POSO, SULAWESI TENGAH",3,51,102,153
https://kawalpemilu.org#67882,"TOKORONDO, POSO PESISIR, POSO, SULAWESI TENGAH",4,62,110,172
https://kawalpemilu.org#67882,"TOKORONDO, POSO PESISIR, POSO, SULAWESI TENGAH",5,53,104,157
https://kawalpemilu.org#67882,"TOKORONDO, POSO PESISIR, POSO, SULAWESI TENGAH",6,55,78,133
https://kawalpemilu.org#67882,"TOKORONDO, POSO PESISIR, POSO, SULAWESI TENGAH",7,42,35,77
https://kawalpemilu.org#67882,"TOKORONDO, POSO PESISIR, POSO, SULAWESI TENGAH",8,98,107,205
https://kawalpemilu.org#67882,"TOKORONDO, POSO PESISIR, POSO, SULAWESI TENGAH",9,75,84,159
https://kawalpemilu.org#67883,"TIWAA, POSO PESISIR, POSO, SULAWESI TENGAH",1,74,107,181
https://kawalpemilu.org#67883,"TIWAA, POSO PESISIR, POSO, SULAWESI TENGAH",2,88,91,179
https://kawalpemilu.org#67883,"TIWAA, POSO PESISIR, POSO, SULAWESI TENGAH",3,116,122,238
https://kawalpemilu.org#67884,"LANTO JAYA, POSO PESISIR, POSO, SULAWESI TENGAH",2,40,126,166
https://kawalpemilu.org#67884,"LANTO JAYA, POSO PESISIR, POSO, SULAWESI TENGAH",4,154,46,200
https://kawalpemilu.org#67885,"LAPE, POSO PESISIR, POSO, SULAWESI TENGAH",1,57,128,185
https://kawalpemilu.org#67885,"LAPE, POSO PESISIR, POSO, SULAWESI TENGAH",2,57,152,209
https://kawalpemilu.org#67885,"LAPE, POSO PESISIR, POSO, SULAWESI TENGAH",3,43,65,108
https://kawalpemilu.org#67885,"LAPE, POSO PESISIR, POSO, SULAWESI TENGAH",4,67,109,176
https://kawalpemilu.org#67886,"TOWU, POSO PESISIR, POSO, SULAWESI TENGAH",1,57,107,164
https://kawalpemilu.org#67886,"TOWU, POSO PESISIR, POSO, SULAWESI TENGAH",2,40,106,146
https://kawalpemilu.org#67886,"TOWU, POSO PESISIR, POSO, SULAWESI TENGAH",3,15,37,52
https://kawalpemilu.org#67886,"TOWU, POSO PESISIR, POSO, SULAWESI TENGAH",4,71,76,147
https://kawalpemilu.org#67886,"TOWU, POSO PESISIR, POSO, SULAWESI TENGAH",5,27,46,73
https://kawalpemilu.org#928602,"UERALULU, POSO PESISIR, POSO, SULAWESI TENGAH",1,91,67,158
https://kawalpemilu.org#928602,"UERALULU, POSO PESISIR, POSO, SULAWESI TENGAH",2,102,63,165
https://kawalpemilu.org#929212,"TABALU, POSO PESISIR, POSO, SULAWESI TENGAH",1,60,155,215
https://kawalpemilu.org#929212,"TABALU, POSO PESISIR, POSO, SULAWESI TENGAH",2,26,170,196
https://kawalpemilu.org#929212,"TABALU, POSO PESISIR, POSO, SULAWESI TENGAH",3,34,157,191
https://kawalpemilu.org#67888,"TAMPEMADORA, LAGE, POSO, SULAWESI TENGAH",1,171,12,183
https://kawalpemilu.org#67888,"TAMPEMADORA, LAGE, POSO, SULAWESI TENGAH",2,200,8,208
https://kawalpemilu.org#67888,"TAMPEMADORA, LAGE, POSO, SULAWESI TENGAH",3,168,16,184
https://kawalpemilu.org#67889,"PANDIRI, LAGE, POSO, SULAWESI TENGAH",1,179,11,190
https://kawalpemilu.org#67889,"PANDIRI, LAGE, POSO, SULAWESI TENGAH",2,143,39,182
https://kawalpemilu.org#67889,"PANDIRI, LAGE, POSO, SULAWESI TENGAH",3,125,18,143
https://kawalpemilu.org#67889,"PANDIRI, LAGE, POSO, SULAWESI TENGAH",4,153,17,170
https://kawalpemilu.org#67889,"PANDIRI, LAGE, POSO, SULAWESI TENGAH",5,162,17,179
https://kawalpemilu.org#67889,"PANDIRI, LAGE, POSO, SULAWESI TENGAH",6,154,16,170
https://kawalpemilu.org#67890,"WATUAWU, LAGE, POSO, SULAWESI TENGAH",1,143,20,163
https://kawalpemilu.org#67890,"WATUAWU, LAGE, POSO, SULAWESI TENGAH",2,142,8,150
https://kawalpemilu.org#67890,"WATUAWU, LAGE, POSO, SULAWESI TENGAH",3,167,23,190
https://kawalpemilu.org#67890,"WATUAWU, LAGE, POSO, SULAWESI TENGAH",4,143,14,157
https://kawalpemilu.org#67890,"WATUAWU, LAGE, POSO, SULAWESI TENGAH",5,183,17,200
https://kawalpemilu.org#67890,"WATUAWU, LAGE, POSO, SULAWESI TENGAH",6,182,13,195
https://kawalpemilu.org#67890,"WATUAWU, LAGE, POSO, SULAWESI TENGAH",7,156,10,166
https://kawalpemilu.org#67890,"WATUAWU, LAGE, POSO, SULAWESI TENGAH",8,186,7,193
https://kawalpemilu.org#67891,"TAMBARO, LAGE, POSO, SULAWESI TENGAH",1,134,12,146
https://kawalpemilu.org#67891,"TAMBARO, LAGE, POSO, SULAWESI TENGAH",2,146,8,154
https://kawalpemilu.org#67891,"TAMBARO, LAGE, POSO, SULAWESI TENGAH",3,143,13,156
https://kawalpemilu.org#67892,"TAGOLU, LAGE, POSO, SULAWESI TENGAH",1,137,14,151
https://kawalpemilu.org#67892,"TAGOLU, LAGE, POSO, SULAWESI TENGAH",2,177,6,183
https://kawalpemilu.org#67892,"TAGOLU, LAGE, POSO, SULAWESI TENGAH",3,175,8,183
https://kawalpemilu.org#67892,"TAGOLU, LAGE, POSO, SULAWESI TENGAH",4,152,14,166
https://kawalpemilu.org#67893,"MALIWUKO, LAGE, POSO, SULAWESI TENGAH",1,165,13,178
https://kawalpemilu.org#67893,"MALIWUKO, LAGE, POSO, SULAWESI TENGAH",2,151,28,179
https://kawalpemilu.org#67893,"MALIWUKO, LAGE, POSO, SULAWESI TENGAH",3,161,14,175
https://kawalpemilu.org#67893,"MALIWUKO, LAGE, POSO, SULAWESI TENGAH",4,140,32,172
https://kawalpemilu.org#67894,"SILANCA, LAGE, POSO, SULAWESI TENGAH",1,155,18,173
https://kawalpemilu.org#67894,"SILANCA, LAGE, POSO, SULAWESI TENGAH",2,189,15,204
https://kawalpemilu.org#67894,"SILANCA, LAGE, POSO, SULAWESI TENGAH",3,178,13,191
https://kawalpemilu.org#67894,"SILANCA, LAGE, POSO, SULAWESI TENGAH",4,171,7,178
https://kawalpemilu.org#67894,"SILANCA, LAGE, POSO, SULAWESI TENGAH",5,163,14,177
https://kawalpemilu.org#67894,"SILANCA, LAGE, POSO, SULAWESI TENGAH",6,172,10,182
https://kawalpemilu.org#67895,"SEPE, LAGE, POSO, SULAWESI TENGAH",1,118,23,141
https://kawalpemilu.org#67895,"SEPE, LAGE, POSO, SULAWESI TENGAH",2,115,22,137
https://kawalpemilu.org#67895,"SEPE, LAGE, POSO, SULAWESI TENGAH",3,61,53,114
https://kawalpemilu.org#67895,"SEPE, LAGE, POSO, SULAWESI TENGAH",4,184,25,209
https://kawalpemilu.org#67895,"SEPE, LAGE, POSO, SULAWESI TENGAH",5,187,39,226
https://kawalpemilu.org#67896,"BATEGENCU, LAGE, POSO, SULAWESI TENGAH",1,169,22,191
https://kawalpemilu.org#67896,"BATEGENCU, LAGE, POSO, SULAWESI TENGAH",2,114,10,124
https://kawalpemilu.org#67897,"TOYADO, LAGE, POSO, SULAWESI TENGAH",1,112,166,278
https://kawalpemilu.org#67897,"TOYADO, LAGE, POSO, SULAWESI TENGAH",2,105,8,113
https://kawalpemilu.org#67897,"TOYADO, LAGE, POSO, SULAWESI TENGAH",3,127,98,225
https://kawalpemilu.org#67897,"TOYADO, LAGE, POSO, SULAWESI TENGAH",4,48,64,112
https://kawalpemilu.org#67898,"TONGKO, LAGE, POSO, SULAWESI TENGAH",1,73,85,158
https://kawalpemilu.org#67898,"TONGKO, LAGE, POSO, SULAWESI TENGAH",2,87,69,156
https://kawalpemilu.org#67898,"TONGKO, LAGE, POSO, SULAWESI TENGAH",3,76,93,169
https://kawalpemilu.org#67898,"TONGKO, LAGE, POSO, SULAWESI TENGAH",4,83,90,173
https://kawalpemilu.org#67898,"TONGKO, LAGE, POSO, SULAWESI TENGAH",5,154,40,194
https://kawalpemilu.org#67899,"MALEI, LAGE, POSO, SULAWESI TENGAH",1,118,75,193
https://kawalpemilu.org#67899,"MALEI, LAGE, POSO, SULAWESI TENGAH",2,91,95,186
https://kawalpemilu.org#67899,"MALEI, LAGE, POSO, SULAWESI TENGAH",3,92,87,179
https://kawalpemilu.org#67899,"MALEI, LAGE, POSO, SULAWESI TENGAH",4,133,18,151
https://kawalpemilu.org#67899,"MALEI, LAGE, POSO, SULAWESI TENGAH",5,163,3,166
https://kawalpemilu.org#67899,"MALEI, LAGE, POSO, SULAWESI TENGAH",6,142,15,157
https://kawalpemilu.org#67900,"SINTUWULEMBA, LAGE, POSO, SULAWESI TENGAH",1,97,61,158
https://kawalpemilu.org#67900,"SINTUWULEMBA, LAGE, POSO, SULAWESI TENGAH",2,106,55,161
https://kawalpemilu.org#67901,"LABUAN, LAGE, POSO, SULAWESI TENGAH",1,104,89,193
https://kawalpemilu.org#67901,"LABUAN, LAGE, POSO, SULAWESI TENGAH",2,100,86,186
https://kawalpemilu.org#67901,"LABUAN, LAGE, POSO, SULAWESI TENGAH",3,100,122,222
https://kawalpemilu.org#928603,"LABUADAGO, LAGE, POSO, SULAWESI TENGAH",1,170,14,184
https://kawalpemilu.org#928603,"LABUADAGO, LAGE, POSO, SULAWESI TENGAH",2,127,5,132
https://kawalpemilu.org#928603,"LABUADAGO, LAGE, POSO, SULAWESI TENGAH",3,162,10,172
https://kawalpemilu.org#928603,"LABUADAGO, LAGE, POSO, SULAWESI TENGAH",4,121,11,132
https://kawalpemilu.org#928604,"RATO'OMBU, LAGE, POSO, SULAWESI TENGAH",1,250,8,258
https://kawalpemilu.org#928604,"RATO'OMBU, LAGE, POSO, SULAWESI TENGAH",2,228,8,236
https://kawalpemilu.org#928604,"RATO'OMBU, LAGE, POSO, SULAWESI TENGAH",3,94,56,150
https://kawalpemilu.org#67907,"SAWIDAGO, PAMONA UTARA, POSO, SULAWESI TENGAH",2,206,11,217
https://kawalpemilu.org#67907,"SAWIDAGO, PAMONA UTARA, POSO, SULAWESI TENGAH",3,228,6,234
https://kawalpemilu.org#67907,"SAWIDAGO, PAMONA UTARA, POSO, SULAWESI TENGAH",4,167,6,173
https://kawalpemilu.org#67907,"SAWIDAGO, PAMONA UTARA, POSO, SULAWESI TENGAH",5,117,6,123
https://kawalpemilu.org#67907,"SAWIDAGO, PAMONA UTARA, POSO, SULAWESI TENGAH",6,171,4,175
https://kawalpemilu.org#67907,"SAWIDAGO, PAMONA UTARA, POSO, SULAWESI TENGAH",8,148,7,155
https://kawalpemilu.org#67907,"SAWIDAGO, PAMONA UTARA, POSO, SULAWESI TENGAH",9,151,2,153
https://kawalpemilu.org#67907,"SAWIDAGO, PAMONA UTARA, POSO, SULAWESI TENGAH",10,0,0,0
https://kawalpemilu.org#67908,"TENDEADONGI, PAMONA UTARA, POSO, SULAWESI TENGAH",1,189,12,201
https://kawalpemilu.org#67908,"TENDEADONGI, PAMONA UTARA, POSO, SULAWESI TENGAH",2,201,11,212
https://kawalpemilu.org#67908,"TENDEADONGI, PAMONA UTARA, POSO, SULAWESI TENGAH",3,163,6,169
https://kawalpemilu.org#67908,"TENDEADONGI, PAMONA UTARA, POSO, SULAWESI TENGAH",4,172,4,176
https://kawalpemilu.org#67908,"TENDEADONGI, PAMONA UTARA, POSO, SULAWESI TENGAH",5,209,10,219
https://kawalpemilu.org#67914,"SAOJO, PAMONA UTARA, POSO, SULAWESI TENGAH",1,179,7,186
https://kawalpemilu.org#67914,"SAOJO, PAMONA UTARA, POSO, SULAWESI TENGAH",2,161,11,172
https://kawalpemilu.org#67914,"SAOJO, PAMONA UTARA, POSO, SULAWESI TENGAH",3,195,2,197
https://kawalpemilu.org#67914,"SAOJO, PAMONA UTARA, POSO, SULAWESI TENGAH",4,181,8,189
https://kawalpemilu.org#67914,"SAOJO, PAMONA UTARA, POSO, SULAWESI TENGAH",5,175,15,190
https://kawalpemilu.org#67918,"PANJOKA, PAMONA UTARA, POSO, SULAWESI TENGAH",2,143,2,145
https://kawalpemilu.org#67921,"L E N A, PAMONA UTARA, POSO, SULAWESI TENGAH",1,222,8,230
https://kawalpemilu.org#67921,"L E N A, PAMONA UTARA, POSO, SULAWESI TENGAH",2,218,9,227
https://kawalpemilu.org#93013,"PETIRODONGI, PAMONA UTARA, POSO, SULAWESI TENGAH",1,152,11,163
https://kawalpemilu.org#93013,"PETIRODONGI, PAMONA UTARA, POSO, SULAWESI TENGAH",2,162,2,164
https://kawalpemilu.org#93013,"PETIRODONGI, PAMONA UTARA, POSO, SULAWESI TENGAH",3,203,2,205
https://kawalpemilu.org#93013,"PETIRODONGI, PAMONA UTARA, POSO, SULAWESI TENGAH",4,198,13,211
https://kawalpemilu.org#93013,"PETIRODONGI, PAMONA UTARA, POSO, SULAWESI TENGAH",5,202,7,209
https://kawalpemilu.org#93013,"PETIRODONGI, PAMONA UTARA, POSO, SULAWESI TENGAH",6,175,5,180
https://kawalpemilu.org#93013,"PETIRODONGI, PAMONA UTARA, POSO, SULAWESI TENGAH",7,172,2,174
https://kawalpemilu.org#93014,"SULEWANA, PAMONA UTARA, POSO, SULAWESI TENGAH",1,173,9,182
https://kawalpemilu.org#93014,"SULEWANA, PAMONA UTARA, POSO, SULAWESI TENGAH",2,152,6,158
https://kawalpemilu.org#93014,"SULEWANA, PAMONA UTARA, POSO, SULAWESI TENGAH",3,178,15,193
https://kawalpemilu.org#93014,"SULEWANA, PAMONA UTARA, POSO, SULAWESI TENGAH",4,167,24,191
https://kawalpemilu.org#93014,"SULEWANA, PAMONA UTARA, POSO, SULAWESI TENGAH",5,156,12,168
https://kawalpemilu.org#93014,"SULEWANA, PAMONA UTARA, POSO, SULAWESI TENGAH",6,182,16,198
https://kawalpemilu.org#93014,"SULEWANA, PAMONA UTARA, POSO, SULAWESI TENGAH",7,257,7,264
https://kawalpemilu.org#93015,"SANGIRA, PAMONA UTARA, POSO, SULAWESI TENGAH",1,181,15,196
https://kawalpemilu.org#93015,"SANGIRA, PAMONA UTARA, POSO, SULAWESI TENGAH",2,165,5,170
https://kawalpemilu.org#93015,"SANGIRA, PAMONA UTARA, POSO, SULAWESI TENGAH",3,0,0,0
https://kawalpemilu.org#93016,"KUKU, PAMONA UTARA, POSO, SULAWESI TENGAH",1,236,17,253
https://kawalpemilu.org#93016,"KUKU, PAMONA UTARA, POSO, SULAWESI TENGAH",2,214,15,229
https://kawalpemilu.org#93017,"UELINCU, PAMONA UTARA, POSO, SULAWESI TENGAH",1,133,0,133
https://kawalpemilu.org#93017,"UELINCU, PAMONA UTARA, POSO, SULAWESI TENGAH",2,131,0,131
https://kawalpemilu.org#67924,"TARIPA, PAMONA TIMUR, POSO, SULAWESI TENGAH",1,195,5,200
https://kawalpemilu.org#67924,"TARIPA, PAMONA TIMUR, POSO, SULAWESI TENGAH",2,190,13,203
https://kawalpemilu.org#67924,"TARIPA, PAMONA TIMUR, POSO, SULAWESI TENGAH",3,196,5,201
https://kawalpemilu.org#67925,"TIU, PAMONA TIMUR, POSO, SULAWESI TENGAH",1,191,10,201
https://kawalpemilu.org#67925,"TIU, PAMONA TIMUR, POSO, SULAWESI TENGAH",2,161,3,164
https://kawalpemilu.org#67925,"TIU, PAMONA TIMUR, POSO, SULAWESI TENGAH",3,175,6,181
https://kawalpemilu.org#67926,"PETIRO, PAMONA TIMUR, POSO, SULAWESI TENGAH",1,206,10,216
https://kawalpemilu.org#67926,"PETIRO, PAMONA TIMUR, POSO, SULAWESI TENGAH",2,165,12,177
https://kawalpemilu.org#67927,"PANCASILA, PAMONA TIMUR, POSO, SULAWESI TENGAH",1,176,20,196
https://kawalpemilu.org#67928,"OLUMOKUNDE, PAMONA TIMUR, POSO, SULAWESI TENGAH",1,168,10,178
https://kawalpemilu.org#67928,"OLUMOKUNDE, PAMONA TIMUR, POSO, SULAWESI TENGAH",2,164,6,170
https://kawalpemilu.org#67928,"OLUMOKUNDE, PAMONA TIMUR, POSO, SULAWESI TENGAH",3,153,13,166
https://kawalpemilu.org#67928,"OLUMOKUNDE, PAMONA TIMUR, POSO, SULAWESI TENGAH",4,156,14,170
https://kawalpemilu.org#67929,"KAMBA, PAMONA TIMUR, POSO, SULAWESI TENGAH",1,174,2,176
https://kawalpemilu.org#67929,"KAMBA, PAMONA TIMUR, POSO, SULAWESI TENGAH",2,132,3,135
https://kawalpemilu.org#67929,"KAMBA, PAMONA TIMUR, POSO, SULAWESI TENGAH",3,119,0,119
https://kawalpemilu.org#67929,"KAMBA, PAMONA TIMUR, POSO, SULAWESI TENGAH",4,120,0,120
https://kawalpemilu.org#67929,"KAMBA, PAMONA TIMUR, POSO, SULAWESI TENGAH",5,126,2,128
https://kawalpemilu.org#67930,"DIDIRI, PAMONA TIMUR, POSO, SULAWESI TENGAH",1,215,6,221
https://kawalpemilu.org#67930,"DIDIRI, PAMONA TIMUR, POSO, SULAWESI TENGAH",2,217,10,227
https://kawalpemilu.org#67931,"KELEI, PAMONA TIMUR, POSO, SULAWESI TENGAH",1,168,13,181
https://kawalpemilu.org#67931,"KELEI, PAMONA TIMUR, POSO, SULAWESI TENGAH",2,165,6,171
https://kawalpemilu.org#67931,"KELEI, PAMONA TIMUR, POSO, SULAWESI TENGAH",3,180,2,182
https://kawalpemilu.org#67931,"KELEI, PAMONA TIMUR, POSO, SULAWESI TENGAH",4,188,9,197
https://kawalpemilu.org#67931,"KELEI, PAMONA TIMUR, POSO, SULAWESI TENGAH",5,193,3,196
https://kawalpemilu.org#67931,"KELEI, PAMONA TIMUR, POSO, SULAWESI TENGAH",6,202,3,205
https://kawalpemilu.org#67932,"POLEGANYARA, PAMONA TIMUR, POSO, SULAWESI TENGAH",2,186,15,201
https://kawalpemilu.org#67932,"POLEGANYARA, PAMONA TIMUR, POSO, SULAWESI TENGAH",3,142,6,148
https://kawalpemilu.org#67932,"POLEGANYARA, PAMONA TIMUR, POSO, SULAWESI TENGAH",4,159,11,170
https://kawalpemilu.org#67932,"POLEGANYARA, PAMONA TIMUR, POSO, SULAWESI TENGAH",5,195,8,203
https://kawalpemilu.org#67933,"MASEWE, PAMONA TIMUR, POSO, SULAWESI TENGAH",1,188,2,190
https://kawalpemilu.org#67933,"MASEWE, PAMONA TIMUR, POSO, SULAWESI TENGAH",2,164,9,173
https://kawalpemilu.org#67934,"MATIALEMBA, PAMONA TIMUR, POSO, SULAWESI TENGAH",1,176,10,186
https://kawalpemilu.org#67934,"MATIALEMBA, PAMONA TIMUR, POSO, SULAWESI TENGAH",2,142,10,152
https://kawalpemilu.org#67935,"KANCU'U, PAMONA TIMUR, POSO, SULAWESI TENGAH",1,179,9,188
https://kawalpemilu.org#67935,"KANCU'U, PAMONA TIMUR, POSO, SULAWESI TENGAH",2,209,15,224
https://kawalpemilu.org#928606,"MAGAPU, PAMONA TIMUR, POSO, SULAWESI TENGAH",1,109,88,197
https://kawalpemilu.org#928606,"MAGAPU, PAMONA TIMUR, POSO, SULAWESI TENGAH",2,130,28,158
https://kawalpemilu.org#67937,"BANCEA, PAMONA SELATAN, POSO, SULAWESI TENGAH",1,198,5,203
https://kawalpemilu.org#67937,"BANCEA, PAMONA SELATAN, POSO, SULAWESI TENGAH",2,137,12,149
https://kawalpemilu.org#67937,"BANCEA, PAMONA SELATAN, POSO, SULAWESI TENGAH",3,214,10,224
https://kawalpemilu.org#67937,"BANCEA, PAMONA SELATAN, POSO, SULAWESI TENGAH",4,186,7,193
https://kawalpemilu.org#67937,"BANCEA, PAMONA SELATAN, POSO, SULAWESI TENGAH",5,130,13,143
https://kawalpemilu.org#67937,"BANCEA, PAMONA SELATAN, POSO, SULAWESI TENGAH",6,147,6,153
https://kawalpemilu.org#67938,"BOE, PAMONA SELATAN, POSO, SULAWESI TENGAH",1,167,20,187
https://kawalpemilu.org#67938,"BOE, PAMONA SELATAN, POSO, SULAWESI TENGAH",2,155,13,168
https://kawalpemilu.org#67938,"BOE, PAMONA SELATAN, POSO, SULAWESI TENGAH",3,179,15,194
https://kawalpemilu.org#67938,"BOE, PAMONA SELATAN, POSO, SULAWESI TENGAH",4,203,9,212
https://kawalpemilu.org#67938,"BOE, PAMONA SELATAN, POSO, SULAWESI TENGAH",5,175,17,192
https://kawalpemilu.org#67939,"PENDOLO, PAMONA SELATAN, POSO, SULAWESI TENGAH",1,126,31,157
https://kawalpemilu.org#67939,"PENDOLO, PAMONA SELATAN, POSO, SULAWESI TENGAH",2,166,18,184
https://kawalpemilu.org#67939,"PENDOLO, PAMONA SELATAN, POSO, SULAWESI TENGAH",3,139,10,149
https://kawalpemilu.org#67939,"PENDOLO, PAMONA SELATAN, POSO, SULAWESI TENGAH",4,149,9,158
https://kawalpemilu.org#67939,"PENDOLO, PAMONA SELATAN, POSO, SULAWESI TENGAH",5,149,20,169
https://kawalpemilu.org#67939,"PENDOLO, PAMONA SELATAN, POSO, SULAWESI TENGAH",6,173,14,187
https://kawalpemilu.org#67939,"PENDOLO, PAMONA SELATAN, POSO, SULAWESI TENGAH",7,172,23,195
https://kawalpemilu.org#67940,"PANDAYORA, PAMONA SELATAN, POSO, SULAWESI TENGAH",1,152,29,181
https://kawalpemilu.org#67940,"PANDAYORA, PAMONA SELATAN, POSO, SULAWESI TENGAH",2,152,29,181
https://kawalpemilu.org#67940,"PANDAYORA, PAMONA SELATAN, POSO, SULAWESI TENGAH",3,150,32,182
https://kawalpemilu.org#67940,"PANDAYORA, PAMONA SELATAN, POSO, SULAWESI TENGAH",4,148,69,217
https://kawalpemilu.org#67940,"PANDAYORA, PAMONA SELATAN, POSO, SULAWESI TENGAH",5,102,26,128
https://kawalpemilu.org#67940,"PANDAYORA, PAMONA SELATAN, POSO, SULAWESI TENGAH",6,198,26,224
https://kawalpemilu.org#67940,"PANDAYORA, PAMONA SELATAN, POSO, SULAWESI TENGAH",7,146,19,165
https://kawalpemilu.org#67941,"MAYOA, PAMONA SELATAN, POSO, SULAWESI TENGAH",1,116,47,163
https://kawalpemilu.org#67941,"MAYOA, PAMONA SELATAN, POSO, SULAWESI TENGAH",2,127,29,156
https://kawalpemilu.org#67941,"MAYOA, PAMONA SELATAN, POSO, SULAWESI TENGAH",3,169,34,203
https://kawalpemilu.org#67941,"MAYOA, PAMONA SELATAN, POSO, SULAWESI TENGAH",4,160,46,206
https://kawalpemilu.org#67941,"MAYOA, PAMONA SELATAN, POSO, SULAWESI TENGAH",5,149,20,169
https://kawalpemilu.org#67941,"MAYOA, PAMONA SELATAN, POSO, SULAWESI TENGAH",6,57,83,140
https://kawalpemilu.org#67941,"MAYOA, PAMONA SELATAN, POSO, SULAWESI TENGAH",7,58,47,105
https://kawalpemilu.org#67941,"MAYOA, PAMONA SELATAN, POSO, SULAWESI TENGAH",8,97,83,180
https://kawalpemilu.org#67942,"UELENE, PAMONA SELATAN, POSO, SULAWESI TENGAH",1,162,22,184
https://kawalpemilu.org#67942,"UELENE, PAMONA SELATAN, POSO, SULAWESI TENGAH",2,191,14,205
https://kawalpemilu.org#67943,"MAYASARI, PAMONA SELATAN, POSO, SULAWESI TENGAH",1,65,109,174
https://kawalpemilu.org#67943,"MAYASARI, PAMONA SELATAN, POSO, SULAWESI TENGAH",2,116,41,157
https://kawalpemilu.org#67943,"MAYASARI, PAMONA SELATAN, POSO, SULAWESI TENGAH",3,44,101,145
https://kawalpemilu.org#67943,"MAYASARI, PAMONA SELATAN, POSO, SULAWESI TENGAH",4,63,112,175
https://kawalpemilu.org#67943,"MAYASARI, PAMONA SELATAN, POSO, SULAWESI TENGAH",5,107,69,176
https://kawalpemilu.org#67943,"MAYASARI, PAMONA SELATAN, POSO, SULAWESI TENGAH",6,99,58,157
https://kawalpemilu.org#67943,"MAYASARI, PAMONA SELATAN, POSO, SULAWESI TENGAH",7,92,61,153
https://kawalpemilu.org#67944,"PANDA JAYA, PAMONA SELATAN, POSO, SULAWESI TENGAH",1,44,120,164
https://kawalpemilu.org#67944,"PANDA JAYA, PAMONA SELATAN, POSO, SULAWESI TENGAH",2,43,134,177
https://kawalpemilu.org#67944,"PANDA JAYA, PAMONA SELATAN, POSO, SULAWESI TENGAH",3,28,132,160
https://kawalpemilu.org#67944,"PANDA JAYA, PAMONA SELATAN, POSO, SULAWESI TENGAH",4,13,99,112
https://kawalpemilu.org#67944,"PANDA JAYA, PAMONA SELATAN, POSO, SULAWESI TENGAH",5,51,74,125
https://kawalpemilu.org#67944,"PANDA JAYA, PAMONA SELATAN, POSO, SULAWESI TENGAH",6,60,72,132
https://kawalpemilu.org#67944,"PANDA JAYA, PAMONA SELATAN, POSO, SULAWESI TENGAH",7,38,95,133
https://kawalpemilu.org#67944,"PANDA JAYA, PAMONA SELATAN, POSO, SULAWESI TENGAH",8,27,124,151
https://kawalpemilu.org#67944,"PANDA JAYA, PAMONA SELATAN, POSO, SULAWESI TENGAH",9,33,148,181
https://kawalpemilu.org#67944,"PANDA JAYA, PAMONA SELATAN, POSO, SULAWESI TENGAH",10,68,96,164
https://kawalpemilu.org#67945,"MAYA JAYA, PAMONA SELATAN, POSO, SULAWESI TENGAH",1,64,115,179
https://kawalpemilu.org#67945,"MAYA JAYA, PAMONA SELATAN, POSO, SULAWESI TENGAH",2,143,71,214
https://kawalpemilu.org#67945,"MAYA JAYA, PAMONA SELATAN, POSO, SULAWESI TENGAH",3,10,97,107
https://kawalpemilu.org#67946,"BANGUN JAYA, PAMONA SELATAN, POSO, SULAWESI TENGAH",1,137,37,174
https://kawalpemilu.org#67946,"BANGUN JAYA, PAMONA SELATAN, POSO, SULAWESI TENGAH",2,55,75,130
https://kawalpemilu.org#67947,"PANJO, PAMONA SELATAN, POSO, SULAWESI TENGAH",1,148,23,171
https://kawalpemilu.org#67947,"PANJO, PAMONA SELATAN, POSO, SULAWESI TENGAH",2,158,15,173
https://kawalpemilu.org#67947,"PANJO, PAMONA SELATAN, POSO, SULAWESI TENGAH",3,145,5,150
https://kawalpemilu.org#67947,"PANJO, PAMONA SELATAN, POSO, SULAWESI TENGAH",4,101,7,108
https://kawalpemilu.org#67947,"PANJO, PAMONA SELATAN, POSO, SULAWESI TENGAH",5,155,2,157
https://kawalpemilu.org#67948,"PASIR PUTIH, PAMONA SELATAN, POSO, SULAWESI TENGAH",1,202,28,230
https://kawalpemilu.org#67948,"PASIR PUTIH, PAMONA SELATAN, POSO, SULAWESI TENGAH",2,112,52,164
https://kawalpemilu.org#67948,"PASIR PUTIH, PAMONA SELATAN, POSO, SULAWESI TENGAH",3,33,60,93
https://kawalpemilu.org#67948,"PASIR PUTIH, PAMONA SELATAN, POSO, SULAWESI TENGAH",4,18,75,93
https://kawalpemilu.org#67950,"DODOLO, LORE UTARA, POSO, SULAWESI TENGAH",1,197,42,239
https://kawalpemilu.org#67951,"KADUWAA, LORE UTARA, POSO, SULAWESI TENGAH",1,173,39,212
https://kawalpemilu.org#67951,"KADUWAA, LORE UTARA, POSO, SULAWESI TENGAH",2,173,29,202
https://kawalpemilu.org#67951,"KADUWAA, LORE UTARA, POSO, SULAWESI TENGAH",3,107,22,129
https://kawalpemilu.org#67952,"WATUMAETA, LORE UTARA, POSO, SULAWESI TENGAH",2,202,22,224
https://kawalpemilu.org#67952,"WATUMAETA, LORE UTARA, POSO, SULAWESI TENGAH",9,43,114,157
https://kawalpemilu.org#67952,"WATUMAETA, LORE UTARA, POSO, SULAWESI TENGAH",10,77,27,104
https://kawalpemilu.org#67953,"SEDOA, LORE UTARA, POSO, SULAWESI TENGAH",4,69,14,83
https://kawalpemilu.org#67954,"ALITUPU, LORE UTARA, POSO, SULAWESI TENGAH",3,98,99,197
https://kawalpemilu.org#67954,"ALITUPU, LORE UTARA, POSO, SULAWESI TENGAH",4,114,64,178
https://kawalpemilu.org#67954,"ALITUPU, LORE UTARA, POSO, SULAWESI TENGAH",5,123,102,225
https://kawalpemilu.org#67954,"ALITUPU, LORE UTARA, POSO, SULAWESI TENGAH",6,102,22,124
https://kawalpemilu.org#67954,"ALITUPU, LORE UTARA, POSO, SULAWESI TENGAH",8,105,48,153
https://kawalpemilu.org#67954,"ALITUPU, LORE UTARA, POSO, SULAWESI TENGAH",10,48,36,84
https://kawalpemilu.org#67954,"ALITUPU, LORE UTARA, POSO, SULAWESI TENGAH",11,68,21,89
https://kawalpemilu.org#67955,"WUASA, LORE UTARA, POSO, SULAWESI TENGAH",1,116,38,154
https://kawalpemilu.org#67955,"WUASA, LORE UTARA, POSO, SULAWESI TENGAH",2,142,35,177
https://kawalpemilu.org#67955,"WUASA, LORE UTARA, POSO, SULAWESI TENGAH",3,159,31,190
https://kawalpemilu.org#67955,"WUASA, LORE UTARA, POSO, SULAWESI TENGAH",4,166,21,187
https://kawalpemilu.org#67955,"WUASA, LORE UTARA, POSO, SULAWESI TENGAH",5,174,31,205
https://kawalpemilu.org#67955,"WUASA, LORE UTARA, POSO, SULAWESI TENGAH",6,157,49,206
https://kawalpemilu.org#67955,"WUASA, LORE UTARA, POSO, SULAWESI TENGAH",7,154,21,175
https://kawalpemilu.org#67955,"WUASA, LORE UTARA, POSO, SULAWESI TENGAH",8,151,26,177
https://kawalpemilu.org#67955,"WUASA, LORE UTARA, POSO, SULAWESI TENGAH",9,189,13,202
https://kawalpemilu.org#67955,"WUASA, LORE UTARA, POSO, SULAWESI TENGAH",10,131,38,169
https://kawalpemilu.org#67956,"BUMI BANYUSARI, LORE UTARA, POSO, SULAWESI TENGAH",1,143,37,180
https://kawalpemilu.org#67956,"BUMI BANYUSARI, LORE UTARA, POSO, SULAWESI TENGAH",2,185,46,231
https://kawalpemilu.org#67967,"GINTU, LORE SELATAN, POSO, SULAWESI TENGAH",1,221,34,255
https://kawalpemilu.org#67967,"GINTU, LORE SELATAN, POSO, SULAWESI TENGAH",2,209,20,229
https://kawalpemilu.org#67967,"GINTU, LORE SELATAN, POSO, SULAWESI TENGAH",3,139,19,158
https://kawalpemilu.org#67967,"GINTU, LORE SELATAN, POSO, SULAWESI TENGAH",4,134,13,147
https://kawalpemilu.org#67967,"GINTU, LORE SELATAN, POSO, SULAWESI TENGAH",5,94,16,110
https://kawalpemilu.org#67971,"BULILI, LORE SELATAN, POSO, SULAWESI TENGAH",1,221,7,228
https://kawalpemilu.org#67971,"BULILI, LORE SELATAN, POSO, SULAWESI TENGAH",2,225,6,231
https://kawalpemilu.org#67976,"KILO, POSO PESISIR UTARA, POSO, SULAWESI TENGAH",1,70,74,144
https://kawalpemilu.org#67976,"KILO, POSO PESISIR UTARA, POSO, SULAWESI TENGAH",2,192,18,210
https://kawalpemilu.org#67976,"KILO, POSO PESISIR UTARA, POSO, SULAWESI TENGAH",3,84,101,185
https://kawalpemilu.org#67976,"KILO, POSO PESISIR UTARA, POSO, SULAWESI TENGAH",4,45,85,130
https://kawalpemilu.org#67976,"KILO, POSO PESISIR UTARA, POSO, SULAWESI TENGAH",5,68,131,199
https://kawalpemilu.org#67976,"KILO, POSO PESISIR UTARA, POSO, SULAWESI TENGAH",6,76,45,121
https://kawalpemilu.org#67977,"KAWENDE, POSO PESISIR UTARA, POSO, SULAWESI TENGAH",1,154,22,176
https://kawalpemilu.org#67977,"KAWENDE, POSO PESISIR UTARA, POSO, SULAWESI TENGAH",2,88,14,102
https://kawalpemilu.org#67977,"KAWENDE, POSO PESISIR UTARA, POSO, SULAWESI TENGAH",3,181,15,196
https://kawalpemilu.org#67978,"KALORA, POSO PESISIR UTARA, POSO, SULAWESI TENGAH",1,76,29,105
https://kawalpemilu.org#67978,"KALORA, POSO PESISIR UTARA, POSO, SULAWESI TENGAH",2,26,108,134
https://kawalpemilu.org#67978,"KALORA, POSO PESISIR UTARA, POSO, SULAWESI TENGAH",3,38,108,146
https://kawalpemilu.org#67978,"KALORA, POSO PESISIR UTARA, POSO, SULAWESI TENGAH",4,101,51,152
https://kawalpemilu.org#67978,"KALORA, POSO PESISIR UTARA, POSO, SULAWESI TENGAH",5,22,112,134
https://kawalpemilu.org#67978,"KALORA, POSO PESISIR UTARA, POSO, SULAWESI TENGAH",6,35,108,143
https://kawalpemilu.org#67979,"TAMBARANA, POSO PESISIR UTARA, POSO, SULAWESI TENGAH",1,180,21,201
https://kawalpemilu.org#67979,"TAMBARANA, POSO PESISIR UTARA, POSO, SULAWESI TENGAH",2,157,44,201
https://kawalpemilu.org#67979,"TAMBARANA, POSO PESISIR UTARA, POSO, SULAWESI TENGAH",3,130,53,183
https://kawalpemilu.org#67979,"TAMBARANA, POSO PESISIR UTARA, POSO, SULAWESI TENGAH",4,63,51,114
https://kawalpemilu.org#67979,"TAMBARANA, POSO PESISIR UTARA, POSO, SULAWESI TENGAH",5,79,63,142
https://kawalpemilu.org#67979,"TAMBARANA, POSO PESISIR UTARA, POSO, SULAWESI TENGAH",6,96,54,150
https://kawalpemilu.org#67979,"TAMBARANA, POSO PESISIR UTARA, POSO, SULAWESI TENGAH",8,116,43,159
https://kawalpemilu.org#67979,"TAMBARANA, POSO PESISIR UTARA, POSO, SULAWESI TENGAH",9,129,73,202
https://kawalpemilu.org#67979,"TAMBARANA, POSO PESISIR UTARA, POSO, SULAWESI TENGAH",10,139,60,199
https://kawalpemilu.org#67979,"TAMBARANA, POSO PESISIR UTARA, POSO, SULAWESI TENGAH",11,61,30,91
https://kawalpemilu.org#67979,"TAMBARANA, POSO PESISIR UTARA, POSO, SULAWESI TENGAH",12,84,24,108
https://kawalpemilu.org#67979,"TAMBARANA, POSO PESISIR UTARA, POSO, SULAWESI TENGAH",13,119,74,193
https://kawalpemilu.org#67979,"TAMBARANA, POSO PESISIR UTARA, POSO, SULAWESI TENGAH",14,66,44,110
https://kawalpemilu.org#67980,"TUMORA, POSO PESISIR UTARA, POSO, SULAWESI TENGAH",1,101,90,191
https://kawalpemilu.org#67980,"TUMORA, POSO PESISIR UTARA, POSO, SULAWESI TENGAH",2,72,106,178
https://kawalpemilu.org#67980,"TUMORA, POSO PESISIR UTARA, POSO, SULAWESI TENGAH",3,125,51,176
https://kawalpemilu.org#67981,"TRI MULYA, POSO PESISIR UTARA, POSO, SULAWESI TENGAH",1,162,4,166
https://kawalpemilu.org#67981,"TRI MULYA, POSO PESISIR UTARA, POSO, SULAWESI TENGAH",2,158,9,167
https://kawalpemilu.org#67981,"TRI MULYA, POSO PESISIR UTARA, POSO, SULAWESI TENGAH",3,92,27,119
https://kawalpemilu.org#67981,"TRI MULYA, POSO PESISIR UTARA, POSO, SULAWESI TENGAH",4,190,4,194
https://kawalpemilu.org#67981,"TRI MULYA, POSO PESISIR UTARA, POSO, SULAWESI TENGAH",5,121,58,179
https://kawalpemilu.org#67981,"TRI MULYA, POSO PESISIR UTARA, POSO, SULAWESI TENGAH",6,98,92,190
https://kawalpemilu.org#67982,"BAKTI AGUNG, POSO PESISIR UTARA, POSO, SULAWESI TENGAH",1,104,37,141
https://kawalpemilu.org#67982,"BAKTI AGUNG, POSO PESISIR UTARA, POSO, SULAWESI TENGAH",2,105,46,151
https://kawalpemilu.org#67982,"BAKTI AGUNG, POSO PESISIR UTARA, POSO, SULAWESI TENGAH",3,125,34,159
https://kawalpemilu.org#67982,"BAKTI AGUNG, POSO PESISIR UTARA, POSO, SULAWESI TENGAH",4,140,28,168
https://kawalpemilu.org#67982,"BAKTI AGUNG, POSO PESISIR UTARA, POSO, SULAWESI TENGAH",5,101,59,160
https://kawalpemilu.org#67982,"BAKTI AGUNG, POSO PESISIR UTARA, POSO, SULAWESI TENGAH",6,103,59,162
https://kawalpemilu.org#67982,"BAKTI AGUNG, POSO PESISIR UTARA, POSO, SULAWESI TENGAH",7,169,10,179
https://kawalpemilu.org#67983,"TOBE, POSO PESISIR UTARA, POSO, SULAWESI TENGAH",1,169,21,190
https://kawalpemilu.org#67983,"TOBE, POSO PESISIR UTARA, POSO, SULAWESI TENGAH",2,178,23,201
https://kawalpemilu.org#67984,"MAMBUKE, POSO PESISIR UTARA, POSO, SULAWESI TENGAH",1,121,66,187
https://kawalpemilu.org#67984,"MAMBUKE, POSO PESISIR UTARA, POSO, SULAWESI TENGAH",2,126,52,178
https://kawalpemilu.org#928608,"MARANDA, POSO PESISIR UTARA, POSO, SULAWESI TENGAH",1,182,23,205
https://kawalpemilu.org#928608,"MARANDA, POSO PESISIR UTARA, POSO, SULAWESI TENGAH",2,112,34,146
https://kawalpemilu.org#928608,"MARANDA, POSO PESISIR UTARA, POSO, SULAWESI TENGAH",3,97,46,143
https://kawalpemilu.org#928608,"MARANDA, POSO PESISIR UTARA, POSO, SULAWESI TENGAH",4,75,82,157
https://kawalpemilu.org#928608,"MARANDA, POSO PESISIR UTARA, POSO, SULAWESI TENGAH",5,98,50,148
https://kawalpemilu.org#67986,"DEWUA, POSO PESISIR SELATAN, POSO, SULAWESI TENGAH",1,228,17,245
https://kawalpemilu.org#67986,"DEWUA, POSO PESISIR SELATAN, POSO, SULAWESI TENGAH",2,223,18,241
https://kawalpemilu.org#67987,"SANGGINORA, POSO PESISIR SELATAN, POSO, SULAWESI TENGAH",1,193,15,208
https://kawalpemilu.org#67987,"SANGGINORA, POSO PESISIR SELATAN, POSO, SULAWESI TENGAH",2,194,8,202
https://kawalpemilu.org#67987,"SANGGINORA, POSO PESISIR SELATAN, POSO, SULAWESI TENGAH",3,195,13,208
https://kawalpemilu.org#67988,"TANGKURA, POSO PESISIR SELATAN, POSO, SULAWESI TENGAH",1,204,21,225
https://kawalpemilu.org#67988,"TANGKURA, POSO PESISIR SELATAN, POSO, SULAWESI TENGAH",2,187,22,209
https://kawalpemilu.org#67988,"TANGKURA, POSO PESISIR SELATAN, POSO, SULAWESI TENGAH",3,179,40,219
https://kawalpemilu.org#67988,"TANGKURA, POSO PESISIR SELATAN, POSO, SULAWESI TENGAH",4,208,24,232
https://kawalpemilu.org#67988,"TANGKURA, POSO PESISIR SELATAN, POSO, SULAWESI TENGAH",5,177,47,224
https://kawalpemilu.org#67988,"TANGKURA, POSO PESISIR SELATAN, POSO, SULAWESI TENGAH",7,132,20,152
https://kawalpemilu.org#67989,"MALITU, POSO PESISIR SELATAN, POSO, SULAWESI TENGAH",1,124,22,146
https://kawalpemilu.org#67989,"MALITU, POSO PESISIR SELATAN, POSO, SULAWESI TENGAH",2,141,20,161
https://kawalpemilu.org#67989,"MALITU, POSO PESISIR SELATAN, POSO, SULAWESI TENGAH",3,148,23,171
https://kawalpemilu.org#67991,"BETALEMBA, POSO PESISIR SELATAN, POSO, SULAWESI TENGAH",2,126,32,158
https://kawalpemilu.org#67991,"BETALEMBA, POSO PESISIR SELATAN, POSO, SULAWESI TENGAH",4,81,73,154
https://kawalpemilu.org#67992,"PANTANGOLEMBA, POSO PESISIR SELATAN, POSO, SULAWESI TENGAH",1,127,32,159
https://kawalpemilu.org#67993,"PADALEMBARA, POSO PESISIR SELATAN, POSO, SULAWESI TENGAH",1,158,61,219
https://kawalpemilu.org#67993,"PADALEMBARA, POSO PESISIR SELATAN, POSO, SULAWESI TENGAH",2,173,14,187
https://kawalpemilu.org#67993,"PADALEMBARA, POSO PESISIR SELATAN, POSO, SULAWESI TENGAH",3,199,10,209
https://kawalpemilu.org#67995,"TAIPA, PAMONA BARAT, POSO, SULAWESI TENGAH",1,135,8,143
https://kawalpemilu.org#67995,"TAIPA, PAMONA BARAT, POSO, SULAWESI TENGAH",2,139,15,154
https://kawalpemilu.org#67996,"MEKO, PAMONA BARAT, POSO, SULAWESI TENGAH",1,157,8,165
https://kawalpemilu.org#67996,"MEKO, PAMONA BARAT, POSO, SULAWESI TENGAH",2,125,5,130
https://kawalpemilu.org#67996,"MEKO, PAMONA BARAT, POSO, SULAWESI TENGAH",3,138,10,148
https://kawalpemilu.org#67996,"MEKO, PAMONA BARAT, POSO, SULAWESI TENGAH",4,181,3,184
https://kawalpemilu.org#67996,"MEKO, PAMONA BARAT, POSO, SULAWESI TENGAH",5,130,5,135
https://kawalpemilu.org#67996,"MEKO, PAMONA BARAT, POSO, SULAWESI TENGAH",6,126,4,130
https://kawalpemilu.org#67996,"MEKO, PAMONA BARAT, POSO, SULAWESI TENGAH",7,173,5,178
https://kawalpemilu.org#67996,"MEKO, PAMONA BARAT, POSO, SULAWESI TENGAH",8,181,0,181
https://kawalpemilu.org#67996,"MEKO, PAMONA BARAT, POSO, SULAWESI TENGAH",9,140,6,146
https://kawalpemilu.org#67996,"MEKO, PAMONA BARAT, POSO, SULAWESI TENGAH",10,91,2,93
https://kawalpemilu.org#67996,"MEKO, PAMONA BARAT, POSO, SULAWESI TENGAH",11,162,4,166
https://kawalpemilu.org#67997,"TOINASA, PAMONA BARAT, POSO, SULAWESI TENGAH",1,160,4,164
https://kawalpemilu.org#67997,"TOINASA, PAMONA BARAT, POSO, SULAWESI TENGAH",2,96,9,105
https://kawalpemilu.org#67997,"TOINASA, PAMONA BARAT, POSO, SULAWESI TENGAH",3,137,6,143
https://kawalpemilu.org#67997,"TOINASA, PAMONA BARAT, POSO, SULAWESI TENGAH",4,153,8,161
https://kawalpemilu.org#67997,"TOINASA, PAMONA BARAT, POSO, SULAWESI TENGAH",5,175,8,183
https://kawalpemilu.org#67997,"TOINASA, PAMONA BARAT, POSO, SULAWESI TENGAH",6,135,3,138
https://kawalpemilu.org#67997,"TOINASA, PAMONA BARAT, POSO, SULAWESI TENGAH",7,137,10,147
https://kawalpemilu.org#67997,"TOINASA, PAMONA BARAT, POSO, SULAWESI TENGAH",8,128,8,136
https://kawalpemilu.org#67997,"TOINASA, PAMONA BARAT, POSO, SULAWESI TENGAH",9,165,5,170
https://kawalpemilu.org#67998,"SALUKAIA, PAMONA BARAT, POSO, SULAWESI TENGAH",1,161,19,180
https://kawalpemilu.org#67998,"SALUKAIA, PAMONA BARAT, POSO, SULAWESI TENGAH",2,159,11,170
https://kawalpemilu.org#67998,"SALUKAIA, PAMONA BARAT, POSO, SULAWESI TENGAH",3,167,10,177
https://kawalpemilu.org#67998,"SALUKAIA, PAMONA BARAT, POSO, SULAWESI TENGAH",4,167,7,174
https://kawalpemilu.org#67998,"SALUKAIA, PAMONA BARAT, POSO, SULAWESI TENGAH",5,110,9,119
https://kawalpemilu.org#67998,"SALUKAIA, PAMONA BARAT, POSO, SULAWESI TENGAH",6,169,11,170
https://kawalpemilu.org#67998,"SALUKAIA, PAMONA BARAT, POSO, SULAWESI TENGAH",7,130,7,137
https://kawalpemilu.org#67998,"SALUKAIA, PAMONA BARAT, POSO, SULAWESI TENGAH",8,154,11,165
https://kawalpemilu.org#67999,"URANOSARI, PAMONA BARAT, POSO, SULAWESI TENGAH",1,149,17,166
https://kawalpemilu.org#67999,"URANOSARI, PAMONA BARAT, POSO, SULAWESI TENGAH",2,182,14,196
https://kawalpemilu.org#928610,"OWINI, PAMONA BARAT, POSO, SULAWESI TENGAH",1,176,9,185
https://kawalpemilu.org#928610,"OWINI, PAMONA BARAT, POSO, SULAWESI TENGAH",2,182,12,194
https://kawalpemilu.org#68001,"SAYO, POSO KOTA SELATAN, POSO, SULAWESI TENGAH",1,41,137,178
https://kawalpemilu.org#68001,"SAYO, POSO KOTA SELATAN, POSO, SULAWESI TENGAH",2,26,75,101
https://kawalpemilu.org#68001,"SAYO, POSO KOTA SELATAN, POSO, SULAWESI TENGAH",3,102,21,123
https://kawalpemilu.org#68001,"SAYO, POSO KOTA SELATAN, POSO, SULAWESI TENGAH",4,38,138,176
https://kawalpemilu.org#68001,"SAYO, POSO KOTA SELATAN, POSO, SULAWESI TENGAH",5,33,91,124
https://kawalpemilu.org#68001,"SAYO, POSO KOTA SELATAN, POSO, SULAWESI TENGAH",6,22,87,109
https://kawalpemilu.org#68001,"SAYO, POSO KOTA SELATAN, POSO, SULAWESI TENGAH",7,34,108,142
https://kawalpemilu.org#68001,"SAYO, POSO KOTA SELATAN, POSO, SULAWESI TENGAH",8,90,9,99
https://kawalpemilu.org#68001,"SAYO, POSO KOTA SELATAN, POSO, SULAWESI TENGAH",9,32,101,133
https://kawalpemilu.org#68002,"BUKIT BAMBU, POSO KOTA SELATAN, POSO, SULAWESI TENGAH",1,154,22,176
https://kawalpemilu.org#68003,"KAWUA, POSO KOTA SELATAN, POSO, SULAWESI TENGAH",1,117,25,142
https://kawalpemilu.org#68003,"KAWUA, POSO KOTA SELATAN, POSO, SULAWESI TENGAH",2,103,25,128
https://kawalpemilu.org#68003,"KAWUA, POSO KOTA SELATAN, POSO, SULAWESI TENGAH",3,118,14,132
https://kawalpemilu.org#68003,"KAWUA, POSO KOTA SELATAN, POSO, SULAWESI TENGAH",4,98,12,110
https://kawalpemilu.org#68003,"KAWUA, POSO KOTA SELATAN, POSO, SULAWESI TENGAH",5,211,17,228
https://kawalpemilu.org#68003,"KAWUA, POSO KOTA SELATAN, POSO, SULAWESI TENGAH",6,167,30,197
https://kawalpemilu.org#68003,"KAWUA, POSO KOTA SELATAN, POSO, SULAWESI TENGAH",7,153,34,187
https://kawalpemilu.org#68003,"KAWUA, POSO KOTA SELATAN, POSO, SULAWESI TENGAH",8,94,32,126
https://kawalpemilu.org#68003,"KAWUA, POSO KOTA SELATAN, POSO, SULAWESI TENGAH",9,165,28,193
https://kawalpemilu.org#68003,"KAWUA, POSO KOTA SELATAN, POSO, SULAWESI TENGAH",10,106,35,141
https://kawalpemilu.org#68004,"RONONONCU, POSO KOTA SELATAN, POSO, SULAWESI TENGAH",1,78,42,120
https://kawalpemilu.org#68004,"RONONONCU, POSO KOTA SELATAN, POSO, SULAWESI TENGAH",2,90,25,115
https://kawalpemilu.org#68004,"RONONONCU, POSO KOTA SELATAN, POSO, SULAWESI TENGAH",3,157,20,177
https://kawalpemilu.org#68004,"RONONONCU, POSO KOTA SELATAN, POSO, SULAWESI TENGAH",4,132,15,147
https://kawalpemilu.org#68004,"RONONONCU, POSO KOTA SELATAN, POSO, SULAWESI TENGAH",5,108,12,120
https://kawalpemilu.org#68004,"RONONONCU, POSO KOTA SELATAN, POSO, SULAWESI TENGAH",6,123,19,142
https://kawalpemilu.org#68004,"RONONONCU, POSO KOTA SELATAN, POSO, SULAWESI TENGAH",7,113,12,125
https://kawalpemilu.org#68004,"RONONONCU, POSO KOTA SELATAN, POSO, SULAWESI TENGAH",8,111,14,125
https://kawalpemilu.org#68004,"RONONONCU, POSO KOTA SELATAN, POSO, SULAWESI TENGAH",9,123,12,135
https://kawalpemilu.org#68004,"RONONONCU, POSO KOTA SELATAN, POSO, SULAWESI TENGAH",10,122,17,139
https://kawalpemilu.org#68005,"LEMBOMAWO, POSO KOTA SELATAN, POSO, SULAWESI TENGAH",1,166,14,180
https://kawalpemilu.org#68005,"LEMBOMAWO, POSO KOTA SELATAN, POSO, SULAWESI TENGAH",2,144,21,165
https://kawalpemilu.org#68005,"LEMBOMAWO, POSO KOTA SELATAN, POSO, SULAWESI TENGAH",3,161,22,183
https://kawalpemilu.org#68005,"LEMBOMAWO, POSO KOTA SELATAN, POSO, SULAWESI TENGAH",4,73,73,146
https://kawalpemilu.org#68005,"LEMBOMAWO, POSO KOTA SELATAN, POSO, SULAWESI TENGAH",5,142,33,175
https://kawalpemilu.org#68007,"BONESOMPE, POSO KOTA UTARA, POSO, SULAWESI TENGAH",1,66,109,175
https://kawalpemilu.org#68007,"BONESOMPE, POSO KOTA UTARA, POSO, SULAWESI TENGAH",2,51,121,172
https://kawalpemilu.org#68007,"BONESOMPE, POSO KOTA UTARA, POSO, SULAWESI TENGAH",3,45,99,144
https://kawalpemilu.org#68007,"BONESOMPE, POSO KOTA UTARA, POSO, SULAWESI TENGAH",4,65,160,225
https://kawalpemilu.org#68007,"BONESOMPE, POSO KOTA UTARA, POSO, SULAWESI TENGAH",5,52,151,203
https://kawalpemilu.org#68007,"BONESOMPE, POSO KOTA UTARA, POSO, SULAWESI TENGAH",6,65,143,208
https://kawalpemilu.org#68007,"BONESOMPE, POSO KOTA UTARA, POSO, SULAWESI TENGAH",7,34,145,179
https://kawalpemilu.org#68007,"BONESOMPE, POSO KOTA UTARA, POSO, SULAWESI TENGAH",8,37,154,191
https://kawalpemilu.org#68007,"BONESOMPE, POSO KOTA UTARA, POSO, SULAWESI TENGAH",9,55,130,185
https://kawalpemilu.org#68008,"KASINTUWU, POSO KOTA UTARA, POSO, SULAWESI TENGAH",1,119,15,134
https://kawalpemilu.org#68008,"KASINTUWU, POSO KOTA UTARA, POSO, SULAWESI TENGAH",3,58,55,113
https://kawalpemilu.org#68008,"KASINTUWU, POSO KOTA UTARA, POSO, SULAWESI TENGAH",4,124,71,195
https://kawalpemilu.org#68008,"KASINTUWU, POSO KOTA UTARA, POSO, SULAWESI TENGAH",5,26,38,64
https://kawalpemilu.org#68009,"LOMBOGIA, POSO KOTA UTARA, POSO, SULAWESI TENGAH",1,68,109,177
https://kawalpemilu.org#68009,"LOMBOGIA, POSO KOTA UTARA, POSO, SULAWESI TENGAH",2,129,21,150
https://kawalpemilu.org#68010,"LAWANGA, POSO KOTA UTARA, POSO, SULAWESI TENGAH",1,34,131,165
https://kawalpemilu.org#68010,"LAWANGA, POSO KOTA UTARA, POSO, SULAWESI TENGAH",2,29,105,134
https://kawalpemilu.org#68010,"LAWANGA, POSO KOTA UTARA, POSO, SULAWESI TENGAH",3,24,131,155
https://kawalpemilu.org#68010,"LAWANGA, POSO KOTA UTARA, POSO, SULAWESI TENGAH",4,34,129,163
https://kawalpemilu.org#68010,"LAWANGA, POSO KOTA UTARA, POSO, SULAWESI TENGAH",5,49,153,202
https://kawalpemilu.org#68010,"LAWANGA, POSO KOTA UTARA, POSO, SULAWESI TENGAH",6,49,98,147
https://kawalpemilu.org#68010,"LAWANGA, POSO KOTA UTARA, POSO, SULAWESI TENGAH",7,40,122,162
https://kawalpemilu.org#68011,"TEGALREJO, POSO KOTA UTARA, POSO, SULAWESI TENGAH",1,58,152,210
https://kawalpemilu.org#68011,"TEGALREJO, POSO KOTA UTARA, POSO, SULAWESI TENGAH",2,49,121,170
https://kawalpemilu.org#68011,"TEGALREJO, POSO KOTA UTARA, POSO, SULAWESI TENGAH",3,40,137,177
https://kawalpemilu.org#68011,"TEGALREJO, POSO KOTA UTARA, POSO, SULAWESI TENGAH",4,40,137,177
https://kawalpemilu.org#68011,"TEGALREJO, POSO KOTA UTARA, POSO, SULAWESI TENGAH",5,65,101,166
https://kawalpemilu.org#68011,"TEGALREJO, POSO KOTA UTARA, POSO, SULAWESI TENGAH",6,54,127,181
https://kawalpemilu.org#68012,"MADALE, POSO KOTA UTARA, POSO, SULAWESI TENGAH",1,131,18,149
https://kawalpemilu.org#68012,"MADALE, POSO KOTA UTARA, POSO, SULAWESI TENGAH",2,62,104,166
https://kawalpemilu.org#68012,"MADALE, POSO KOTA UTARA, POSO, SULAWESI TENGAH",3,118,44,162
https://kawalpemilu.org#68012,"MADALE, POSO KOTA UTARA, POSO, SULAWESI TENGAH",4,80,82,162
https://kawalpemilu.org#929211,"LAWANGA TAWONGAN, POSO KOTA UTARA, POSO, SULAWESI TENGAH",1,41,103,144
https://kawalpemilu.org#929211,"LAWANGA TAWONGAN, POSO KOTA UTARA, POSO, SULAWESI TENGAH",2,39,122,161
https://kawalpemilu.org#929211,"LAWANGA TAWONGAN, POSO KOTA UTARA, POSO, SULAWESI TENGAH",3,45,125,170
https://kawalpemilu.org#929211,"LAWANGA TAWONGAN, POSO KOTA UTARA, POSO, SULAWESI TENGAH",4,43,119,162
https://kawalpemilu.org#929211,"LAWANGA TAWONGAN, POSO KOTA UTARA, POSO, SULAWESI TENGAH",5,54,145,199
https://kawalpemilu.org#929211,"LAWANGA TAWONGAN, POSO KOTA UTARA, POSO, SULAWESI TENGAH",6,54,115,169
https://kawalpemilu.org#68014,"TUARE, LORE BARAT, POSO, SULAWESI TENGAH",1,151,2,151
https://kawalpemilu.org#68014,"TUARE, LORE BARAT, POSO, SULAWESI TENGAH",2,150,10,160
https://kawalpemilu.org#68015,"KAGEROA, LORE BARAT, POSO, SULAWESI TENGAH",1,222,12,234
https://kawalpemilu.org#68017,"LENGKEKA, LORE BARAT, POSO, SULAWESI TENGAH",1,183,9,192
https://kawalpemilu.org#68017,"LENGKEKA, LORE BARAT, POSO, SULAWESI TENGAH",2,169,13,182
https://kawalpemilu.org#68017,"LENGKEKA, LORE BARAT, POSO, SULAWESI TENGAH",3,126,4,130
https://kawalpemilu.org#68019,"LELIO, LORE BARAT, POSO, SULAWESI TENGAH",1,238,11,249
https://kawalpemilu.org#68021,"WINOWANGA, LORE TIMUR, POSO, SULAWESI TENGAH",4,159,11,170
https://kawalpemilu.org#68022,"MAHOLO, LORE TIMUR, POSO, SULAWESI TENGAH",4,169,24,193
https://kawalpemilu.org#68032,"KOROBONO, PAMONA TENGGARA, POSO, SULAWESI TENGAH",1,181,24,205
https://kawalpemilu.org#68032,"KOROBONO, PAMONA TENGGARA, POSO, SULAWESI TENGAH",2,163,11,174
https://kawalpemilu.org#68032,"KOROBONO, PAMONA TENGGARA, POSO, SULAWESI TENGAH",3,156,15,171
https://kawalpemilu.org#68033,"AMPORIWO, PAMONA TENGGARA, POSO, SULAWESI TENGAH",1,232,16,248
https://kawalpemilu.org#68034,"WAYURA, PAMONA TENGGARA, POSO, SULAWESI TENGAH",1,208,16,224
https://kawalpemilu.org#68034,"WAYURA, PAMONA TENGGARA, POSO, SULAWESI TENGAH",2,187,7,194
https://kawalpemilu.org#68034,"WAYURA, PAMONA TENGGARA, POSO, SULAWESI TENGAH",3,112,5,117
https://kawalpemilu.org#68035,"TOKILO, PAMONA TENGGARA, POSO, SULAWESI TENGAH",1,158,17,175
https://kawalpemilu.org#68035,"TOKILO, PAMONA TENGGARA, POSO, SULAWESI TENGAH",2,172,14,186
https://kawalpemilu.org#68036,"TINDOLI, PAMONA TENGGARA, POSO, SULAWESI TENGAH",1,185,30,215
https://kawalpemilu.org#68036,"TINDOLI, PAMONA TENGGARA, POSO, SULAWESI TENGAH",2,210,17,227
https://kawalpemilu.org#68036,"TINDOLI, PAMONA TENGGARA, POSO, SULAWESI TENGAH",3,156,9,165
https://kawalpemilu.org#68037,"TOLAMBO, PAMONA TENGGARA, POSO, SULAWESI TENGAH",1,168,2,170
https://kawalpemilu.org#68037,"TOLAMBO, PAMONA TENGGARA, POSO, SULAWESI TENGAH",2,161,1,162
https://kawalpemilu.org#68038,"SINGKONA, PAMONA TENGGARA, POSO, SULAWESI TENGAH",1,204,11,215
https://kawalpemilu.org#68038,"SINGKONA, PAMONA TENGGARA, POSO, SULAWESI TENGAH",2,183,18,201
https://kawalpemilu.org#68039,"SALINDU, PAMONA TENGGARA, POSO, SULAWESI TENGAH",1,210,28,238
https://kawalpemilu.org#68039,"SALINDU, PAMONA TENGGARA, POSO, SULAWESI TENGAH",2,154,11,165
https://kawalpemilu.org#68040,"BARATI, PAMONA TENGGARA, POSO, SULAWESI TENGAH",1,70,5,75
https://kawalpemilu.org#68040,"BARATI, PAMONA TENGGARA, POSO, SULAWESI TENGAH",2,138,14,152
https://kawalpemilu.org#68040,"BARATI, PAMONA TENGGARA, POSO, SULAWESI TENGAH",3,145,5,150
https://kawalpemilu.org#68040,"BARATI, PAMONA TENGGARA, POSO, SULAWESI TENGAH",4,124,14,138
https://kawalpemilu.org#68040,"BARATI, PAMONA TENGGARA, POSO, SULAWESI TENGAH",5,98,8,106
https://kawalpemilu.org#68040,"BARATI, PAMONA TENGGARA, POSO, SULAWESI TENGAH",6,128,6,134
https://kawalpemilu.org#68040,"BARATI, PAMONA TENGGARA, POSO, SULAWESI TENGAH",7,111,6,117
https://kawalpemilu.org#68040,"BARATI, PAMONA TENGGARA, POSO, SULAWESI TENGAH",8,81,1,82
https://kawalpemilu.org#927509,"BUYUMPONDOLI, PAMONA PUSELEMBA, POSO, SULAWESI TENGAH",1,188,13,201
https://kawalpemilu.org#927509,"BUYUMPONDOLI, PAMONA PUSELEMBA, POSO, SULAWESI TENGAH",2,169,6,175
https://kawalpemilu.org#927509,"BUYUMPONDOLI, PAMONA PUSELEMBA, POSO, SULAWESI TENGAH",3,149,7,156
https://kawalpemilu.org#927509,"BUYUMPONDOLI, PAMONA PUSELEMBA, POSO, SULAWESI TENGAH",4,129,8,137
https://kawalpemilu.org#927509,"BUYUMPONDOLI, PAMONA PUSELEMBA, POSO, SULAWESI TENGAH",5,208,17,225
https://kawalpemilu.org#927509,"BUYUMPONDOLI, PAMONA PUSELEMBA, POSO, SULAWESI TENGAH",7,171,16,187
https://kawalpemilu.org#927510,"TENTENA, PAMONA PUSELEMBA, POSO, SULAWESI TENGAH",1,175,7,182
https://kawalpemilu.org#927510,"TENTENA, PAMONA PUSELEMBA, POSO, SULAWESI TENGAH",2,112,7,119
https://kawalpemilu.org#927510,"TENTENA, PAMONA PUSELEMBA, POSO, SULAWESI TENGAH",4,90,2,92
https://kawalpemilu.org#927510,"TENTENA, PAMONA PUSELEMBA, POSO, SULAWESI TENGAH",5,144,4,148
https://kawalpemilu.org#927510,"TENTENA, PAMONA PUSELEMBA, POSO, SULAWESI TENGAH",6,103,3,106
https://kawalpemilu.org#927510,"TENTENA, PAMONA PUSELEMBA, POSO, SULAWESI TENGAH",7,167,7,174
https://kawalpemilu.org#927510,"TENTENA, PAMONA PUSELEMBA, POSO, SULAWESI TENGAH",8,160,3,163
https://kawalpemilu.org#927511,"PAMONA, PAMONA PUSELEMBA, POSO, SULAWESI TENGAH",1,168,7,175
https://kawalpemilu.org#927511,"PAMONA, PAMONA PUSELEMBA, POSO, SULAWESI TENGAH",2,173,10,183
https://kawalpemilu.org#927511,"PAMONA, PAMONA PUSELEMBA, POSO, SULAWESI TENGAH",3,188,6,194
https://kawalpemilu.org#927511,"PAMONA, PAMONA PUSELEMBA, POSO, SULAWESI TENGAH",4,207,6,213
https://kawalpemilu.org#927511,"PAMONA, PAMONA PUSELEMBA, POSO, SULAWESI TENGAH",5,180,11,191
https://kawalpemilu.org#927511,"PAMONA, PAMONA PUSELEMBA, POSO, SULAWESI TENGAH",6,179,5,184
https://kawalpemilu.org#927511,"PAMONA, PAMONA PUSELEMBA, POSO, SULAWESI TENGAH",7,177,18,195
https://kawalpemilu.org#927511,"PAMONA, PAMONA PUSELEMBA, POSO, SULAWESI TENGAH",8,166,10,176
https://kawalpemilu.org#927511,"PAMONA, PAMONA PUSELEMBA, POSO, SULAWESI TENGAH",9,151,11,162
https://kawalpemilu.org#927511,"PAMONA, PAMONA PUSELEMBA, POSO, SULAWESI TENGAH",10,242,4,246
https://kawalpemilu.org#927511,"PAMONA, PAMONA PUSELEMBA, POSO, SULAWESI TENGAH",11,213,8,221
https://kawalpemilu.org#927511,"PAMONA, PAMONA PUSELEMBA, POSO, SULAWESI TENGAH",12,214,1,215
https://kawalpemilu.org#927511,"PAMONA, PAMONA PUSELEMBA, POSO, SULAWESI TENGAH",13,191,7,198
https://kawalpemilu.org#927511,"PAMONA, PAMONA PUSELEMBA, POSO, SULAWESI TENGAH",14,129,3,132
https://kawalpemilu.org#927511,"PAMONA, PAMONA PUSELEMBA, POSO, SULAWESI TENGAH",15,128,17,145
https://kawalpemilu.org#927511,"PAMONA, PAMONA PUSELEMBA, POSO, SULAWESI TENGAH",16,178,11,189
https://kawalpemilu.org#927512,"SANGELE, PAMONA PUSELEMBA, POSO, SULAWESI TENGAH",1,144,8,152
https://kawalpemilu.org#927512,"SANGELE, PAMONA PUSELEMBA, POSO, SULAWESI TENGAH",2,146,26,170
https://kawalpemilu.org#927512,"SANGELE, PAMONA PUSELEMBA, POSO, SULAWESI TENGAH",3,125,5,130
https://kawalpemilu.org#927512,"SANGELE, PAMONA PUSELEMBA, POSO, SULAWESI TENGAH",4,151,6,157
https://kawalpemilu.org#927512,"SANGELE, PAMONA PUSELEMBA, POSO, SULAWESI TENGAH",5,177,3,200
https://kawalpemilu.org#927512,"SANGELE, PAMONA PUSELEMBA, POSO, SULAWESI TENGAH",6,211,22,233
https://kawalpemilu.org#927512,"SANGELE, PAMONA PUSELEMBA, POSO, SULAWESI TENGAH",7,219,17,236
https://kawalpemilu.org#927512,"SANGELE, PAMONA PUSELEMBA, POSO, SULAWESI TENGAH",8,175,15,190
https://kawalpemilu.org#927512,"SANGELE, PAMONA PUSELEMBA, POSO, SULAWESI TENGAH",9,120,10,130
https://kawalpemilu.org#927513,"TONUSU, PAMONA PUSELEMBA, POSO, SULAWESI TENGAH",1,156,7,163
https://kawalpemilu.org#927513,"TONUSU, PAMONA PUSELEMBA, POSO, SULAWESI TENGAH",2,156,6,162
https://kawalpemilu.org#927513,"TONUSU, PAMONA PUSELEMBA, POSO, SULAWESI TENGAH",3,187,6,193
https://kawalpemilu.org#927513,"TONUSU, PAMONA PUSELEMBA, POSO, SULAWESI TENGAH",4,165,5,170
https://kawalpemilu.org#927513,"TONUSU, PAMONA PUSELEMBA, POSO, SULAWESI TENGAH",5,185,2,187
https://kawalpemilu.org#927513,"TONUSU, PAMONA PUSELEMBA, POSO, SULAWESI TENGAH",6,172,2,174
https://kawalpemilu.org#927514,"MAYAKELI, PAMONA PUSELEMBA, POSO, SULAWESI TENGAH",1,136,8,144
https://kawalpemilu.org#927514,"MAYAKELI, PAMONA PUSELEMBA, POSO, SULAWESI TENGAH",2,154,6,160
https://kawalpemilu.org#927514,"MAYAKELI, PAMONA PUSELEMBA, POSO, SULAWESI TENGAH",3,145,4,149
https://kawalpemilu.org#927515,"PEURA, PAMONA PUSELEMBA, POSO, SULAWESI TENGAH",1,213,10,223
https://kawalpemilu.org#927515,"PEURA, PAMONA PUSELEMBA, POSO, SULAWESI TENGAH",2,178,3,181
https://kawalpemilu.org#927515,"PEURA, PAMONA PUSELEMBA, POSO, SULAWESI TENGAH",3,176,2,178
https://kawalpemilu.org#927515,"PEURA, PAMONA PUSELEMBA, POSO, SULAWESI TENGAH",4,182,12,194
https://kawalpemilu.org#927516,"DULUMAI, PAMONA PUSELEMBA, POSO, SULAWESI TENGAH",1,175,11,186
https://kawalpemilu.org#927516,"DULUMAI, PAMONA PUSELEMBA, POSO, SULAWESI TENGAH",2,166,12,178
https://kawalpemilu.org#927517,"SOE, PAMONA PUSELEMBA, POSO, SULAWESI TENGAH",1,186,2,188
https://kawalpemilu.org#927517,"SOE, PAMONA PUSELEMBA, POSO, SULAWESI TENGAH",2,228,5,233
https://kawalpemilu.org#927517,"SOE, PAMONA PUSELEMBA, POSO, SULAWESI TENGAH",3,173,11,184
https://kawalpemilu.org#927517,"SOE, PAMONA PUSELEMBA, POSO, SULAWESI TENGAH",4,189,4,193
https://kawalpemilu.org#927518,"LEBONI, PAMONA PUSELEMBA, POSO, SULAWESI TENGAH",1,176,4,180
https://kawalpemilu.org#927518,"LEBONI, PAMONA PUSELEMBA, POSO, SULAWESI TENGAH",2,138,5,143
https://kawalpemilu.org#927518,"LEBONI, PAMONA PUSELEMBA, POSO, SULAWESI TENGAH",4,156,8,164
https://kawalpemilu.org#928605,"WERA, PAMONA PUSELEMBA, POSO, SULAWESI TENGAH",1,179,4,183
https://kawalpemilu.org#928605,"WERA, PAMONA PUSELEMBA, POSO, SULAWESI TENGAH",2,166,4,170
https://kawalpemilu.org#68043,"PANTOLOBETE, RIO PAKAVA, DONGGALA, SULAWESI TENGAH",1,133,18,151
https://kawalpemilu.org#68043,"PANTOLOBETE, RIO PAKAVA, DONGGALA, SULAWESI TENGAH",2,142,22,164
https://kawalpemilu.org#68043,"PANTOLOBETE, RIO PAKAVA, DONGGALA, SULAWESI TENGAH",3,114,31,145
https://kawalpemilu.org#68044,"BONEMARAWA, RIO PAKAVA, DONGGALA, SULAWESI TENGAH",1,164,22,186
https://kawalpemilu.org#68044,"BONEMARAWA, RIO PAKAVA, DONGGALA, SULAWESI TENGAH",2,190,32,222
https://kawalpemilu.org#68044,"BONEMARAWA, RIO PAKAVA, DONGGALA, SULAWESI TENGAH",3,210,16,226
https://kawalpemilu.org#68044,"BONEMARAWA, RIO PAKAVA, DONGGALA, SULAWESI TENGAH",4,176,9,185
https://kawalpemilu.org#68044,"BONEMARAWA, RIO PAKAVA, DONGGALA, SULAWESI TENGAH",5,60,5,65
https://kawalpemilu.org#68044,"BONEMARAWA, RIO PAKAVA, DONGGALA, SULAWESI TENGAH",6,153,16,169
https://kawalpemilu.org#68045,"TINAUKA, RIO PAKAVA, DONGGALA, SULAWESI TENGAH",1,126,19,145
https://kawalpemilu.org#68045,"TINAUKA, RIO PAKAVA, DONGGALA, SULAWESI TENGAH",2,126,21,147
https://kawalpemilu.org#68045,"TINAUKA, RIO PAKAVA, DONGGALA, SULAWESI TENGAH",3,166,21,187
https://kawalpemilu.org#68045,"TINAUKA, RIO PAKAVA, DONGGALA, SULAWESI TENGAH",4,80,35,115
https://kawalpemilu.org#68045,"TINAUKA, RIO PAKAVA, DONGGALA, SULAWESI TENGAH",5,100,38,138
https://kawalpemilu.org#68046,"LALUNDU, RIO PAKAVA, DONGGALA, SULAWESI TENGAH",1,148,45,193
https://kawalpemilu.org#68046,"LALUNDU, RIO PAKAVA, DONGGALA, SULAWESI TENGAH",2,141,54,195
https://kawalpemilu.org#68046,"LALUNDU, RIO PAKAVA, DONGGALA, SULAWESI TENGAH",3,181,6,187
https://kawalpemilu.org#68046,"LALUNDU, RIO PAKAVA, DONGGALA, SULAWESI TENGAH",4,227,15,242
https://kawalpemilu.org#68046,"LALUNDU, RIO PAKAVA, DONGGALA, SULAWESI TENGAH",5,193,27,222
https://kawalpemilu.org#68046,"LALUNDU, RIO PAKAVA, DONGGALA, SULAWESI TENGAH",6,92,34,126
https://kawalpemilu.org#68046,"LALUNDU, RIO PAKAVA, DONGGALA, SULAWESI TENGAH",7,83,18,101
https://kawalpemilu.org#68047,"TOVIORA, RIO PAKAVA, DONGGALA, SULAWESI TENGAH",1,102,25,127
https://kawalpemilu.org#68047,"TOVIORA, RIO PAKAVA, DONGGALA, SULAWESI TENGAH",2,177,48,225
https://kawalpemilu.org#68047,"TOVIORA, RIO PAKAVA, DONGGALA, SULAWESI TENGAH",3,146,36,182
https://kawalpemilu.org#68047,"TOVIORA, RIO PAKAVA, DONGGALA, SULAWESI TENGAH",4,152,38,190
https://kawalpemilu.org#68047,"TOVIORA, RIO PAKAVA, DONGGALA, SULAWESI TENGAH",5,103,41,144
https://kawalpemilu.org#68047,"TOVIORA, RIO PAKAVA, DONGGALA, SULAWESI TENGAH",6,146,33,179
https://kawalpemilu.org#68048,"MINTI MAKMUR, RIO PAKAVA, DONGGALA, SULAWESI TENGAH",1,180,28,208
https://kawalpemilu.org#68048,"MINTI MAKMUR, RIO PAKAVA, DONGGALA, SULAWESI TENGAH",2,199,7,206
https://kawalpemilu.org#68048,"MINTI MAKMUR, RIO PAKAVA, DONGGALA, SULAWESI TENGAH",3,226,9,235
https://kawalpemilu.org#68048,"MINTI MAKMUR, RIO PAKAVA, DONGGALA, SULAWESI TENGAH",4,200,22,222
https://kawalpemilu.org#68048,"MINTI MAKMUR, RIO PAKAVA, DONGGALA, SULAWESI TENGAH",5,161,49,210
https://kawalpemilu.org#68048,"MINTI MAKMUR, RIO PAKAVA, DONGGALA, SULAWESI TENGAH",6,174,42,216
https://kawalpemilu.org#68048,"MINTI MAKMUR, RIO PAKAVA, DONGGALA, SULAWESI TENGAH",7,154,26,180
https://kawalpemilu.org#68048,"MINTI MAKMUR, RIO PAKAVA, DONGGALA, SULAWESI TENGAH",8,169,35,204
https://kawalpemilu.org#68049,"POLANTO JAYA, RIO PAKAVA, DONGGALA, SULAWESI TENGAH",1,177,63,240
https://kawalpemilu.org#68049,"POLANTO JAYA, RIO PAKAVA, DONGGALA, SULAWESI TENGAH",2,185,51,236
https://kawalpemilu.org#68049,"POLANTO JAYA, RIO PAKAVA, DONGGALA, SULAWESI TENGAH",3,158,38,196
https://kawalpemilu.org#68049,"POLANTO JAYA, RIO PAKAVA, DONGGALA, SULAWESI TENGAH",4,195,16,211
https://kawalpemilu.org#68049,"POLANTO JAYA, RIO PAKAVA, DONGGALA, SULAWESI TENGAH",5,174,22,196
https://kawalpemilu.org#68049,"POLANTO JAYA, RIO PAKAVA, DONGGALA, SULAWESI TENGAH",6,141,47,188
https://kawalpemilu.org#68049,"POLANTO JAYA, RIO PAKAVA, DONGGALA, SULAWESI TENGAH",7,241,15,256
https://kawalpemilu.org#68050,"POLANDO JAYA, RIO PAKAVA, DONGGALA, SULAWESI TENGAH",1,178,24,202
https://kawalpemilu.org#68050,"POLANDO JAYA, RIO PAKAVA, DONGGALA, SULAWESI TENGAH",2,182,10,192
https://kawalpemilu.org#68050,"POLANDO JAYA, RIO PAKAVA, DONGGALA, SULAWESI TENGAH",3,125,36,161
https://kawalpemilu.org#68051,"RIO MUKTI, RIO PAKAVA, DONGGALA, SULAWESI TENGAH",1,212,9,221
https://kawalpemilu.org#68051,"RIO MUKTI, RIO PAKAVA, DONGGALA, SULAWESI TENGAH",2,193,14,207
https://kawalpemilu.org#68051,"RIO MUKTI, RIO PAKAVA, DONGGALA, SULAWESI TENGAH",3,198,9,207
https://kawalpemilu.org#68051,"RIO MUKTI, RIO PAKAVA, DONGGALA, SULAWESI TENGAH",4,139,9,148
https://kawalpemilu.org#68051,"RIO MUKTI, RIO PAKAVA, DONGGALA, SULAWESI TENGAH",5,116,10,126
https://kawalpemilu.org#68052,"PANCA MUKTI, RIO PAKAVA, DONGGALA, SULAWESI TENGAH",1,213,25,238
https://kawalpemilu.org#68052,"PANCA MUKTI, RIO PAKAVA, DONGGALA, SULAWESI TENGAH",2,201,37,238
https://kawalpemilu.org#68053,"PAKAVA, RIO PAKAVA, DONGGALA, SULAWESI TENGAH",1,131,46,177
https://kawalpemilu.org#68053,"PAKAVA, RIO PAKAVA, DONGGALA, SULAWESI TENGAH",2,189,14,203
https://kawalpemilu.org#68053,"PAKAVA, RIO PAKAVA, DONGGALA, SULAWESI TENGAH",3,108,11,119
https://kawalpemilu.org#68053,"PAKAVA, RIO PAKAVA, DONGGALA, SULAWESI TENGAH",4,108,11,119
https://kawalpemilu.org#68054,"NGOVI VAKAVA, RIO PAKAVA, DONGGALA, SULAWESI TENGAH",1,146,26,172
https://kawalpemilu.org#68054,"NGOVI VAKAVA, RIO PAKAVA, DONGGALA, SULAWESI TENGAH",2,132,17,149
https://kawalpemilu.org#68054,"NGOVI VAKAVA, RIO PAKAVA, DONGGALA, SULAWESI TENGAH",3,130,18,148
https://kawalpemilu.org#68054,"NGOVI VAKAVA, RIO PAKAVA, DONGGALA, SULAWESI TENGAH",4,126,8,134
https://kawalpemilu.org#68054,"NGOVI VAKAVA, RIO PAKAVA, DONGGALA, SULAWESI TENGAH",5,122,5,127
https://kawalpemilu.org#68055,"BUKIT INDAH, RIO PAKAVA, DONGGALA, SULAWESI TENGAH",1,152,54,206
https://kawalpemilu.org#68055,"BUKIT INDAH, RIO PAKAVA, DONGGALA, SULAWESI TENGAH",2,170,70,240
https://kawalpemilu.org#68056,"MBULAWA, RIO PAKAVA, DONGGALA, SULAWESI TENGAH",1,186,30,216
https://kawalpemilu.org#68056,"MBULAWA, RIO PAKAVA, DONGGALA, SULAWESI TENGAH",2,72,3,75
https://kawalpemilu.org#68056,"MBULAWA, RIO PAKAVA, DONGGALA, SULAWESI TENGAH",3,83,21,104
https://kawalpemilu.org#68058,"KAMBAYANG, DAMPELAS, DONGGALA, SULAWESI TENGAH",1,54,56,110
https://kawalpemilu.org#68058,"KAMBAYANG, DAMPELAS, DONGGALA, SULAWESI TENGAH",2,77,104,181
https://kawalpemilu.org#68058,"KAMBAYANG, DAMPELAS, DONGGALA, SULAWESI TENGAH",3,134,61,195
https://kawalpemilu.org#68058,"KAMBAYANG, DAMPELAS, DONGGALA, SULAWESI TENGAH",4,60,17,77
https://kawalpemilu.org#68059,"TALAGA, DAMPELAS, DONGGALA, SULAWESI TENGAH",1,114,108,222
https://kawalpemilu.org#68059,"TALAGA, DAMPELAS, DONGGALA, SULAWESI TENGAH",2,95,88,183
https://kawalpemilu.org#68059,"TALAGA, DAMPELAS, DONGGALA, SULAWESI TENGAH",3,124,104,228
https://kawalpemilu.org#68059,"TALAGA, DAMPELAS, DONGGALA, SULAWESI TENGAH",4,54,104,158
https://kawalpemilu.org#68059,"TALAGA, DAMPELAS, DONGGALA, SULAWESI TENGAH",5,65,110,175
https://kawalpemilu.org#68059,"TALAGA, DAMPELAS, DONGGALA, SULAWESI TENGAH",6,84,155,239
https://kawalpemilu.org#68059,"TALAGA, DAMPELAS, DONGGALA, SULAWESI TENGAH",7,82,141,223
https://kawalpemilu.org#68059,"TALAGA, DAMPELAS, DONGGALA, SULAWESI TENGAH",8,74,42,116
https://kawalpemilu.org#68060,"SABANG, DAMPELAS, DONGGALA, SULAWESI TENGAH",1,78,58,136
https://kawalpemilu.org#68060,"SABANG, DAMPELAS, DONGGALA, SULAWESI TENGAH",2,54,143,197
https://kawalpemilu.org#68060,"SABANG, DAMPELAS, DONGGALA, SULAWESI TENGAH",3,90,122,212
https://kawalpemilu.org#68060,"SABANG, DAMPELAS, DONGGALA, SULAWESI TENGAH",5,93,43,136
https://kawalpemilu.org#68061,"SIOYONG, DAMPELAS, DONGGALA, SULAWESI TENGAH",1,161,66,227
https://kawalpemilu.org#68061,"SIOYONG, DAMPELAS, DONGGALA, SULAWESI TENGAH",2,102,119,221
https://kawalpemilu.org#68061,"SIOYONG, DAMPELAS, DONGGALA, SULAWESI TENGAH",3,134,69,203
https://kawalpemilu.org#68061,"SIOYONG, DAMPELAS, DONGGALA, SULAWESI TENGAH",4,147,48,195
https://kawalpemilu.org#68061,"SIOYONG, DAMPELAS, DONGGALA, SULAWESI TENGAH",5,138,65,203
https://kawalpemilu.org#68061,"SIOYONG, DAMPELAS, DONGGALA, SULAWESI TENGAH",6,178,32,210
https://kawalpemilu.org#68061,"SIOYONG, DAMPELAS, DONGGALA, SULAWESI TENGAH",7,122,77,199
https://kawalpemilu.org#68061,"SIOYONG, DAMPELAS, DONGGALA, SULAWESI TENGAH",8,168,65,233
https://kawalpemilu.org#68061,"SIOYONG, DAMPELAS, DONGGALA, SULAWESI TENGAH",9,154,65,219
https://kawalpemilu.org#68062,"PANII, DAMPELAS, DONGGALA, SULAWESI TENGAH",1,144,65,209
https://kawalpemilu.org#68062,"PANII, DAMPELAS, DONGGALA, SULAWESI TENGAH",2,143,39,182
https://kawalpemilu.org#68062,"PANII, DAMPELAS, DONGGALA, SULAWESI TENGAH",3,194,19,213
https://kawalpemilu.org#68062,"PANII, DAMPELAS, DONGGALA, SULAWESI TENGAH",4,164,12,176
https://kawalpemilu.org#68062,"PANII, DAMPELAS, DONGGALA, SULAWESI TENGAH",5,134,27,161
https://kawalpemilu.org#68062,"PANII, DAMPELAS, DONGGALA, SULAWESI TENGAH",6,160,57,217
https://kawalpemilu.org#68063,"PONGGERANG, DAMPELAS, DONGGALA, SULAWESI TENGAH",1,104,55,159
https://kawalpemilu.org#68063,"PONGGERANG, DAMPELAS, DONGGALA, SULAWESI TENGAH",2,103,80,183
https://kawalpemilu.org#68063,"PONGGERANG, DAMPELAS, DONGGALA, SULAWESI TENGAH",3,107,60,167
https://kawalpemilu.org#68063,"PONGGERANG, DAMPELAS, DONGGALA, SULAWESI TENGAH",4,113,62,175
https://kawalpemilu.org#68063,"PONGGERANG, DAMPELAS, DONGGALA, SULAWESI TENGAH",5,115,81,196
https://kawalpemilu.org#68063,"PONGGERANG, DAMPELAS, DONGGALA, SULAWESI TENGAH",6,180,48,228
https://kawalpemilu.org#68063,"PONGGERANG, DAMPELAS, DONGGALA, SULAWESI TENGAH",7,78,64,142
https://kawalpemilu.org#68063,"PONGGERANG, DAMPELAS, DONGGALA, SULAWESI TENGAH",9,61,52,113
https://kawalpemilu.org#68064,"RERANG, DAMPELAS, DONGGALA, SULAWESI TENGAH",1,71,44,115
https://kawalpemilu.org#68064,"RERANG, DAMPELAS, DONGGALA, SULAWESI TENGAH",2,103,86,189
https://kawalpemilu.org#68064,"RERANG, DAMPELAS, DONGGALA, SULAWESI TENGAH",3,122,74,196
https://kawalpemilu.org#68064,"RERANG, DAMPELAS, DONGGALA, SULAWESI TENGAH",4,99,83,182
https://kawalpemilu.org#68064,"RERANG, DAMPELAS, DONGGALA, SULAWESI TENGAH",6,99,92,191
https://kawalpemilu.org#68064,"RERANG, DAMPELAS, DONGGALA, SULAWESI TENGAH",7,89,110,199
https://kawalpemilu.org#68064,"RERANG, DAMPELAS, DONGGALA, SULAWESI TENGAH",8,93,27,120
https://kawalpemilu.org#68064,"RERANG, DAMPELAS, DONGGALA, SULAWESI TENGAH",9,42,14,56
https://kawalpemilu.org#68064,"RERANG, DAMPELAS, DONGGALA, SULAWESI TENGAH",10,63,56,119
https://kawalpemilu.org#68064,"RERANG, DAMPELAS, DONGGALA, SULAWESI TENGAH",11,71,33,104
https://kawalpemilu.org#68065,"BUDI MUKTI, DAMPELAS, DONGGALA, SULAWESI TENGAH",1,198,24,222
https://kawalpemilu.org#68065,"BUDI MUKTI, DAMPELAS, DONGGALA, SULAWESI TENGAH",2,168,37,205
https://kawalpemilu.org#68065,"BUDI MUKTI, DAMPELAS, DONGGALA, SULAWESI TENGAH",3,153,68,221
https://kawalpemilu.org#68065,"BUDI MUKTI, DAMPELAS, DONGGALA, SULAWESI TENGAH",4,132,50,182
https://kawalpemilu.org#68065,"BUDI MUKTI, DAMPELAS, DONGGALA, SULAWESI TENGAH",5,146,54,200
https://kawalpemilu.org#68065,"BUDI MUKTI, DAMPELAS, DONGGALA, SULAWESI TENGAH",6,211,14,225
https://kawalpemilu.org#68066,"LEMBAH MUKTI, DAMPELAS, DONGGALA, SULAWESI TENGAH",1,41,116,157
https://kawalpemilu.org#68066,"LEMBAH MUKTI, DAMPELAS, DONGGALA, SULAWESI TENGAH",2,52,104,156
https://kawalpemilu.org#68066,"LEMBAH MUKTI, DAMPELAS, DONGGALA, SULAWESI TENGAH",3,138,72,210
https://kawalpemilu.org#68066,"LEMBAH MUKTI, DAMPELAS, DONGGALA, SULAWESI TENGAH",4,167,46,213
https://kawalpemilu.org#68066,"LEMBAH MUKTI, DAMPELAS, DONGGALA, SULAWESI TENGAH",5,190,31,221
https://kawalpemilu.org#68066,"LEMBAH MUKTI, DAMPELAS, DONGGALA, SULAWESI TENGAH",6,146,11,157
https://kawalpemilu.org#68066,"LEMBAH MUKTI, DAMPELAS, DONGGALA, SULAWESI TENGAH",7,138,7,145
https://kawalpemilu.org#68067,"MALONAS, DAMPELAS, DONGGALA, SULAWESI TENGAH",1,148,77,225
https://kawalpemilu.org#68067,"MALONAS, DAMPELAS, DONGGALA, SULAWESI TENGAH",2,145,96,241
https://kawalpemilu.org#68067,"MALONAS, DAMPELAS, DONGGALA, SULAWESI TENGAH",3,130,73,203
https://kawalpemilu.org#68067,"MALONAS, DAMPELAS, DONGGALA, SULAWESI TENGAH",4,163,86,249
https://kawalpemilu.org#68067,"MALONAS, DAMPELAS, DONGGALA, SULAWESI TENGAH",6,174,73,247
https://kawalpemilu.org#68067,"MALONAS, DAMPELAS, DONGGALA, SULAWESI TENGAH",7,221,25,246
https://kawalpemilu.org#68068,"PARISAN AGUNG, DAMPELAS, DONGGALA, SULAWESI TENGAH",1,135,80,215
https://kawalpemilu.org#68068,"PARISAN AGUNG, DAMPELAS, DONGGALA, SULAWESI TENGAH",2,127,39,166
https://kawalpemilu.org#68068,"PARISAN AGUNG, DAMPELAS, DONGGALA, SULAWESI TENGAH",3,102,14,116
https://kawalpemilu.org#68068,"PARISAN AGUNG, DAMPELAS, DONGGALA, SULAWESI TENGAH",4,160,34,194
https://kawalpemilu.org#68068,"PARISAN AGUNG, DAMPELAS, DONGGALA, SULAWESI TENGAH",5,159,31,190
https://kawalpemilu.org#68069,"KARYA MUKTI, DAMPELAS, DONGGALA, SULAWESI TENGAH",1,151,16,167
https://kawalpemilu.org#68069,"KARYA MUKTI, DAMPELAS, DONGGALA, SULAWESI TENGAH",2,159,17,176
https://kawalpemilu.org#68069,"KARYA MUKTI, DAMPELAS, DONGGALA, SULAWESI TENGAH",3,140,14,154
https://kawalpemilu.org#68069,"KARYA MUKTI, DAMPELAS, DONGGALA, SULAWESI TENGAH",4,44,160,204
https://kawalpemilu.org#68069,"KARYA MUKTI, DAMPELAS, DONGGALA, SULAWESI TENGAH",5,54,136,190
https://kawalpemilu.org#68069,"KARYA MUKTI, DAMPELAS, DONGGALA, SULAWESI TENGAH",6,42,150,192
https://kawalpemilu.org#68069,"KARYA MUKTI, DAMPELAS, DONGGALA, SULAWESI TENGAH",7,139,91,230
https://kawalpemilu.org#68069,"KARYA MUKTI, DAMPELAS, DONGGALA, SULAWESI TENGAH",8,94,64,158
https://kawalpemilu.org#68069,"KARYA MUKTI, DAMPELAS, DONGGALA, SULAWESI TENGAH",9,130,71,201
https://kawalpemilu.org#68069,"KARYA MUKTI, DAMPELAS, DONGGALA, SULAWESI TENGAH",10,129,89,218
https://kawalpemilu.org#68069,"KARYA MUKTI, DAMPELAS, DONGGALA, SULAWESI TENGAH",11,146,62,208
https://kawalpemilu.org#68069,"KARYA MUKTI, DAMPELAS, DONGGALA, SULAWESI TENGAH",12,150,53,203
https://kawalpemilu.org#87570,"LONG, DAMPELAS, DONGGALA, SULAWESI TENGAH",1,144,72,216
https://kawalpemilu.org#87570,"LONG, DAMPELAS, DONGGALA, SULAWESI TENGAH",2,154,54,211
https://kawalpemilu.org#87570,"LONG, DAMPELAS, DONGGALA, SULAWESI TENGAH",3,58,30,88
https://kawalpemilu.org#68071,"KABONGA BESAR, BANAWA, DONGGALA, SULAWESI TENGAH",1,194,47,241
https://kawalpemilu.org#68071,"KABONGA BESAR, BANAWA, DONGGALA, SULAWESI TENGAH",2,175,62,237
https://kawalpemilu.org#68071,"KABONGA BESAR, BANAWA, DONGGALA, SULAWESI TENGAH",3,126,106,232
https://kawalpemilu.org#68071,"KABONGA BESAR, BANAWA, DONGGALA, SULAWESI TENGAH",4,100,134,234
https://kawalpemilu.org#68071,"KABONGA BESAR, BANAWA, DONGGALA, SULAWESI TENGAH",5,153,107,260
https://kawalpemilu.org#68071,"KABONGA BESAR, BANAWA, DONGGALA, SULAWESI TENGAH",6,89,114,203
https://kawalpemilu.org#68071,"KABONGA BESAR, BANAWA, DONGGALA, SULAWESI TENGAH",7,129,97,226
https://kawalpemilu.org#68072,"GANTI, BANAWA, DONGGALA, SULAWESI TENGAH",1,145,102,247
https://kawalpemilu.org#68072,"GANTI, BANAWA, DONGGALA, SULAWESI TENGAH",2,110,121,231
https://kawalpemilu.org#68072,"GANTI, BANAWA, DONGGALA, SULAWESI TENGAH",3,148,84,232
https://kawalpemilu.org#68072,"GANTI, BANAWA, DONGGALA, SULAWESI TENGAH",4,97,99,196
https://kawalpemilu.org#68072,"GANTI, BANAWA, DONGGALA, SULAWESI TENGAH",5,107,104,211
https://kawalpemilu.org#68072,"GANTI, BANAWA, DONGGALA, SULAWESI TENGAH",6,146,106,252
https://kawalpemilu.org#68072,"GANTI, BANAWA, DONGGALA, SULAWESI TENGAH",7,129,42,171
https://kawalpemilu.org#68072,"GANTI, BANAWA, DONGGALA, SULAWESI TENGAH",8,123,33,156
https://kawalpemilu.org#68072,"GANTI, BANAWA, DONGGALA, SULAWESI TENGAH",9,242,23,265
https://kawalpemilu.org#68072,"GANTI, BANAWA, DONGGALA, SULAWESI TENGAH",10,7,33,40
https://kawalpemilu.org#68072,"GANTI, BANAWA, DONGGALA, SULAWESI TENGAH",11,125,36,161
https://kawalpemilu.org#68072,"GANTI, BANAWA, DONGGALA, SULAWESI TENGAH",12,170,24,194
https://kawalpemilu.org#68073,"KABONGA KECIL, BANAWA, DONGGALA, SULAWESI TENGAH",1,134,105,139
https://kawalpemilu.org#68073,"KABONGA KECIL, BANAWA, DONGGALA, SULAWESI TENGAH",2,116,95,211
https://kawalpemilu.org#68073,"KABONGA KECIL, BANAWA, DONGGALA, SULAWESI TENGAH",3,133,99,232
https://kawalpemilu.org#68073,"KABONGA KECIL, BANAWA, DONGGALA, SULAWESI TENGAH",4,127,109,236
https://kawalpemilu.org#68073,"KABONGA KECIL, BANAWA, DONGGALA, SULAWESI TENGAH",5,99,138,237
https://kawalpemilu.org#68073,"KABONGA KECIL, BANAWA, DONGGALA, SULAWESI TENGAH",6,74,140,214
https://kawalpemilu.org#68073,"KABONGA KECIL, BANAWA, DONGGALA, SULAWESI TENGAH",7,127,53,180
https://kawalpemilu.org#68073,"KABONGA KECIL, BANAWA, DONGGALA, SULAWESI TENGAH",8,164,39,203
https://kawalpemilu.org#68074,"GUNUNG BALE, BANAWA, DONGGALA, SULAWESI TENGAH",1,144,103,247
https://kawalpemilu.org#68074,"GUNUNG BALE, BANAWA, DONGGALA, SULAWESI TENGAH",2,116,137,253
https://kawalpemilu.org#68074,"GUNUNG BALE, BANAWA, DONGGALA, SULAWESI TENGAH",3,188,75,263
https://kawalpemilu.org#68074,"GUNUNG BALE, BANAWA, DONGGALA, SULAWESI TENGAH",4,117,103,220
https://kawalpemilu.org#68074,"GUNUNG BALE, BANAWA, DONGGALA, SULAWESI TENGAH",5,175,81,256
https://kawalpemilu.org#68074,"GUNUNG BALE, BANAWA, DONGGALA, SULAWESI TENGAH",6,165,104,269
https://kawalpemilu.org#68075,"MALENI, BANAWA, DONGGALA, SULAWESI TENGAH",1,92,140,232
https://kawalpemilu.org#68075,"MALENI, BANAWA, DONGGALA, SULAWESI TENGAH",2,101,115,216
https://kawalpemilu.org#68075,"MALENI, BANAWA, DONGGALA, SULAWESI TENGAH",3,99,128,227
https://kawalpemilu.org#68075,"MALENI, BANAWA, DONGGALA, SULAWESI TENGAH",4,109,79,3
https://kawalpemilu.org#68075,"MALENI, BANAWA, DONGGALA, SULAWESI TENGAH",5,85,103,188
https://kawalpemilu.org#68075,"MALENI, BANAWA, DONGGALA, SULAWESI TENGAH",6,107,103,210
https://kawalpemilu.org#68075,"MALENI, BANAWA, DONGGALA, SULAWESI TENGAH",7,139,76,215
https://kawalpemilu.org#68076,"TANJUNG BATU, BANAWA, DONGGALA, SULAWESI TENGAH",1,118,92,210
https://kawalpemilu.org#68076,"TANJUNG BATU, BANAWA, DONGGALA, SULAWESI TENGAH",2,99,153,252
https://kawalpemilu.org#68076,"TANJUNG BATU, BANAWA, DONGGALA, SULAWESI TENGAH",3,91,103,194
https://kawalpemilu.org#68076,"TANJUNG BATU, BANAWA, DONGGALA, SULAWESI TENGAH",4,99,96,195
https://kawalpemilu.org#68076,"TANJUNG BATU, BANAWA, DONGGALA, SULAWESI TENGAH",5,96,80,176
https://kawalpemilu.org#68076,"TANJUNG BATU, BANAWA, DONGGALA, SULAWESI TENGAH",6,106,84,190
https://kawalpemilu.org#68076,"TANJUNG BATU, BANAWA, DONGGALA, SULAWESI TENGAH",7,132,67,199
https://kawalpemilu.org#68077,"BOYA, BANAWA, DONGGALA, SULAWESI TENGAH",1,94,121,215
https://kawalpemilu.org#68077,"BOYA, BANAWA, DONGGALA, SULAWESI TENGAH",2,127,79,206
https://kawalpemilu.org#68077,"BOYA, BANAWA, DONGGALA, SULAWESI TENGAH",3,130,85,215
https://kawalpemilu.org#68077,"BOYA, BANAWA, DONGGALA, SULAWESI TENGAH",4,90,113,203
https://kawalpemilu.org#68077,"BOYA, BANAWA, DONGGALA, SULAWESI TENGAH",5,136,67,203
https://kawalpemilu.org#68077,"BOYA, BANAWA, DONGGALA, SULAWESI TENGAH",6,116,85,201
https://kawalpemilu.org#68077,"BOYA, BANAWA, DONGGALA, SULAWESI TENGAH",7,126,91,217
https://kawalpemilu.org#68077,"BOYA, BANAWA, DONGGALA, SULAWESI TENGAH",8,68,64,132
https://kawalpemilu.org#68078,"LABUAN BAJO, BANAWA, DONGGALA, SULAWESI TENGAH",1,139,66,205
https://kawalpemilu.org#68078,"LABUAN BAJO, BANAWA, DONGGALA, SULAWESI TENGAH",2,139,107,246
https://kawalpemilu.org#68078,"LABUAN BAJO, BANAWA, DONGGALA, SULAWESI TENGAH",3,133,94,227
https://kawalpemilu.org#68078,"LABUAN BAJO, BANAWA, DONGGALA, SULAWESI TENGAH",4,155,77,232
https://kawalpemilu.org#68078,"LABUAN BAJO, BANAWA, DONGGALA, SULAWESI TENGAH",5,130,40,170
https://kawalpemilu.org#68078,"LABUAN BAJO, BANAWA, DONGGALA, SULAWESI TENGAH",6,124,79,1
https://kawalpemilu.org#68078,"LABUAN BAJO, BANAWA, DONGGALA, SULAWESI TENGAH",7,124,72,196
https://kawalpemilu.org#68079,"BONEOGE, BANAWA, DONGGALA, SULAWESI TENGAH",1,172,15,187
https://kawalpemilu.org#68079,"BONEOGE, BANAWA, DONGGALA, SULAWESI TENGAH",2,204,17,221
https://kawalpemilu.org#68079,"BONEOGE, BANAWA, DONGGALA, SULAWESI TENGAH",3,192,30,222
https://kawalpemilu.org#68079,"BONEOGE, BANAWA, DONGGALA, SULAWESI TENGAH",4,153,53,206
https://kawalpemilu.org#68079,"BONEOGE, BANAWA, DONGGALA, SULAWESI TENGAH",5,159,56,215
https://kawalpemilu.org#68079,"BONEOGE, BANAWA, DONGGALA, SULAWESI TENGAH",6,125,75,201
https://kawalpemilu.org#68079,"BONEOGE, BANAWA, DONGGALA, SULAWESI TENGAH",7,119,90,208
https://kawalpemilu.org#68079,"BONEOGE, BANAWA, DONGGALA, SULAWESI TENGAH",9,142,73,215
https://kawalpemilu.org#68080,"LOLI OGE, BANAWA, DONGGALA, SULAWESI TENGAH",1,86,119,205
https://kawalpemilu.org#68080,"LOLI OGE, BANAWA, DONGGALA, SULAWESI TENGAH",2,85,132,217
https://kawalpemilu.org#68080,"LOLI OGE, BANAWA, DONGGALA, SULAWESI TENGAH",3,81,131,212
https://kawalpemilu.org#68080,"LOLI OGE, BANAWA, DONGGALA, SULAWESI TENGAH",4,67,115,182
https://kawalpemilu.org#68080,"LOLI OGE, BANAWA, DONGGALA, SULAWESI TENGAH",5,72,144,216
https://kawalpemilu.org#68081,"LOLI TASIBURI, BANAWA, DONGGALA, SULAWESI TENGAH",1,56,138,194
https://kawalpemilu.org#68081,"LOLI TASIBURI, BANAWA, DONGGALA, SULAWESI TENGAH",2,84,118,202
https://kawalpemilu.org#68081,"LOLI TASIBURI, BANAWA, DONGGALA, SULAWESI TENGAH",3,97,99,196
https://kawalpemilu.org#68081,"LOLI TASIBURI, BANAWA, DONGGALA, SULAWESI TENGAH",4,88,110,198
https://kawalpemilu.org#68081,"LOLI TASIBURI, BANAWA, DONGGALA, SULAWESI TENGAH",5,107,84,191
https://kawalpemilu.org#68081,"LOLI TASIBURI, BANAWA, DONGGALA, SULAWESI TENGAH",6,98,75,173
https://kawalpemilu.org#68082,"LOLI PESUA, BANAWA, DONGGALA, SULAWESI TENGAH",1,139,115,254
https://kawalpemilu.org#68082,"LOLI PESUA, BANAWA, DONGGALA, SULAWESI TENGAH",2,138,102,240
https://kawalpemilu.org#68082,"LOLI PESUA, BANAWA, DONGGALA, SULAWESI TENGAH",3,137,104,241
https://kawalpemilu.org#68082,"LOLI PESUA, BANAWA, DONGGALA, SULAWESI TENGAH",4,110,75,185
https://kawalpemilu.org#68083,"LOLI DONDO, BANAWA, DONGGALA, SULAWESI TENGAH",1,100,103,203
https://kawalpemilu.org#68083,"LOLI DONDO, BANAWA, DONGGALA, SULAWESI TENGAH",2,134,108,0
https://kawalpemilu.org#68083,"LOLI DONDO, BANAWA, DONGGALA, SULAWESI TENGAH",3,145,77,222
https://kawalpemilu.org#68083,"LOLI DONDO, BANAWA, DONGGALA, SULAWESI TENGAH",4,96,99,195
https://kawalpemilu.org#68084,"LOLI SALURAN, BANAWA, DONGGALA, SULAWESI TENGAH",1,0,0,0
https://kawalpemilu.org#68084,"LOLI SALURAN, BANAWA, DONGGALA, SULAWESI TENGAH",2,61,149,210
https://kawalpemilu.org#68084,"LOLI SALURAN, BANAWA, DONGGALA, SULAWESI TENGAH",3,95,99,194
https://kawalpemilu.org#68086,"LABUAN, LABUAN, DONGGALA, SULAWESI TENGAH",1,74,101,175
https://kawalpemilu.org#68086,"LABUAN, LABUAN, DONGGALA, SULAWESI TENGAH",2,71,145,216
https://kawalpemilu.org#68086,"LABUAN, LABUAN, DONGGALA, SULAWESI TENGAH",3,43,124,167
https://kawalpemilu.org#68086,"LABUAN, LABUAN, DONGGALA, SULAWESI TENGAH",4,117,83,200
https://kawalpemilu.org#68086,"LABUAN, LABUAN, DONGGALA, SULAWESI TENGAH",5,90,99,189
https://kawalpemilu.org#68086,"LABUAN, LABUAN, DONGGALA, SULAWESI TENGAH",6,97,78,175
https://kawalpemilu.org#68086,"LABUAN, LABUAN, DONGGALA, SULAWESI TENGAH",7,124,104,228
https://kawalpemilu.org#68086,"LABUAN, LABUAN, DONGGALA, SULAWESI TENGAH",8,54,86,140
https://kawalpemilu.org#68087,"LABUAN SALUMBONE, LABUAN, DONGGALA, SULAWESI TENGAH",1,65,107,172
https://kawalpemilu.org#68087,"LABUAN SALUMBONE, LABUAN, DONGGALA, SULAWESI TENGAH",2,60,120,180
https://kawalpemilu.org#68087,"LABUAN SALUMBONE, LABUAN, DONGGALA, SULAWESI TENGAH",3,32,130,162
https://kawalpemilu.org#68087,"LABUAN SALUMBONE, LABUAN, DONGGALA, SULAWESI TENGAH",4,53,118,171
https://kawalpemilu.org#68087,"LABUAN SALUMBONE, LABUAN, DONGGALA, SULAWESI TENGAH",5,61,167,178
https://kawalpemilu.org#68087,"LABUAN SALUMBONE, LABUAN, DONGGALA, SULAWESI TENGAH",6,79,96,175
https://kawalpemilu.org#68088,"LABUAN PANIMBA, LABUAN, DONGGALA, SULAWESI TENGAH",1,100,114,214
https://kawalpemilu.org#68088,"LABUAN PANIMBA, LABUAN, DONGGALA, SULAWESI TENGAH",2,140,101,241
https://kawalpemilu.org#68088,"LABUAN PANIMBA, LABUAN, DONGGALA, SULAWESI TENGAH",3,93,117,210
https://kawalpemilu.org#68088,"LABUAN PANIMBA, LABUAN, DONGGALA, SULAWESI TENGAH",4,131,90,221
https://kawalpemilu.org#68088,"LABUAN PANIMBA, LABUAN, DONGGALA, SULAWESI TENGAH",5,153,80,233
https://kawalpemilu.org#68088,"LABUAN PANIMBA, LABUAN, DONGGALA, SULAWESI TENGAH",6,161,71,232
https://kawalpemilu.org#68088,"LABUAN PANIMBA, LABUAN, DONGGALA, SULAWESI TENGAH",7,192,62,254
https://kawalpemilu.org#68089,"LABUAN LELEA, LABUAN, DONGGALA, SULAWESI TENGAH",1,61,127,188
https://kawalpemilu.org#68089,"LABUAN LELEA, LABUAN, DONGGALA, SULAWESI TENGAH",2,63,130,193
https://kawalpemilu.org#68089,"LABUAN LELEA, LABUAN, DONGGALA, SULAWESI TENGAH",3,84,121,205
https://kawalpemilu.org#68089,"LABUAN LELEA, LABUAN, DONGGALA, SULAWESI TENGAH",4,69,128,197
https://kawalpemilu.org#68089,"LABUAN LELEA, LABUAN, DONGGALA, SULAWESI TENGAH",5,62,161,223
https://kawalpemilu.org#68089,"LABUAN LELEA, LABUAN, DONGGALA, SULAWESI TENGAH",6,140,96,236
https://kawalpemilu.org#68090,"LABUAN KUNGGUMA, LABUAN, DONGGALA, SULAWESI TENGAH",1,96,99,195
https://kawalpemilu.org#68090,"LABUAN KUNGGUMA, LABUAN, DONGGALA, SULAWESI TENGAH",2,69,100,169
https://kawalpemilu.org#68090,"LABUAN KUNGGUMA, LABUAN, DONGGALA, SULAWESI TENGAH",3,84,84,168
https://kawalpemilu.org#68090,"LABUAN KUNGGUMA, LABUAN, DONGGALA, SULAWESI TENGAH",4,96,66,162
https://kawalpemilu.org#68091,"LABUAN TOPOSO, LABUAN, DONGGALA, SULAWESI TENGAH",1,162,27,189
https://kawalpemilu.org#68091,"LABUAN TOPOSO, LABUAN, DONGGALA, SULAWESI TENGAH",2,163,38,201
https://kawalpemilu.org#68091,"LABUAN TOPOSO, LABUAN, DONGGALA, SULAWESI TENGAH",3,115,98,213
https://kawalpemilu.org#68091,"LABUAN TOPOSO, LABUAN, DONGGALA, SULAWESI TENGAH",4,118,101,219
https://kawalpemilu.org#68091,"LABUAN TOPOSO, LABUAN, DONGGALA, SULAWESI TENGAH",5,136,59,195
https://kawalpemilu.org#68091,"LABUAN TOPOSO, LABUAN, DONGGALA, SULAWESI TENGAH",6,110,43,153
https://kawalpemilu.org#68091,"LABUAN TOPOSO, LABUAN, DONGGALA, SULAWESI TENGAH",7,63,69,132
https://kawalpemilu.org#68091,"LABUAN TOPOSO, LABUAN, DONGGALA, SULAWESI TENGAH",8,138,8,146
https://kawalpemilu.org#68091,"LABUAN TOPOSO, LABUAN, DONGGALA, SULAWESI TENGAH",9,112,27,139
https://kawalpemilu.org#87571,"LABUAN LUMBUBAKA, LABUAN, DONGGALA, SULAWESI TENGAH",1,66,149,215
https://kawalpemilu.org#87571,"LABUAN LUMBUBAKA, LABUAN, DONGGALA, SULAWESI TENGAH",2,100,104,204
https://kawalpemilu.org#68093,"DALAKA, SINDUE, DONGGALA, SULAWESI TENGAH",1,69,141,210
https://kawalpemilu.org#68093,"DALAKA, SINDUE, DONGGALA, SULAWESI TENGAH",2,48,156,204
https://kawalpemilu.org#68093,"DALAKA, SINDUE, DONGGALA, SULAWESI TENGAH",3,73,124,197
https://kawalpemilu.org#68093,"DALAKA, SINDUE, DONGGALA, SULAWESI TENGAH",4,98,104,202
https://kawalpemilu.org#68093,"DALAKA, SINDUE, DONGGALA, SULAWESI TENGAH",5,104,105,209
https://kawalpemilu.org#68093,"DALAKA, SINDUE, DONGGALA, SULAWESI TENGAH",6,41,163,204
https://kawalpemilu.org#68093,"DALAKA, SINDUE, DONGGALA, SULAWESI TENGAH",7,59,154,213
https://kawalpemilu.org#68093,"DALAKA, SINDUE, DONGGALA, SULAWESI TENGAH",8,48,65,113
https://kawalpemilu.org#68093,"DALAKA, SINDUE, DONGGALA, SULAWESI TENGAH",9,45,41,86
https://kawalpemilu.org#68094,"LERO, SINDUE, DONGGALA, SULAWESI TENGAH",1,57,196,253
https://kawalpemilu.org#68094,"LERO, SINDUE, DONGGALA, SULAWESI TENGAH",2,45,179,224
https://kawalpemilu.org#68094,"LERO, SINDUE, DONGGALA, SULAWESI TENGAH",3,90,155,245
https://kawalpemilu.org#68094,"LERO, SINDUE, DONGGALA, SULAWESI TENGAH",4,72,132,204
https://kawalpemilu.org#68094,"LERO, SINDUE, DONGGALA, SULAWESI TENGAH",5,50,185,235
https://kawalpemilu.org#68094,"LERO, SINDUE, DONGGALA, SULAWESI TENGAH",6,68,121,189
https://kawalpemilu.org#68095,"TARIPA, SINDUE, DONGGALA, SULAWESI TENGAH",1,93,85,178
https://kawalpemilu.org#68095,"TARIPA, SINDUE, DONGGALA, SULAWESI TENGAH",2,100,50,150
https://kawalpemilu.org#68096,"SUMARI, SINDUE, DONGGALA, SULAWESI TENGAH",1,126,57,183
https://kawalpemilu.org#68096,"SUMARI, SINDUE, DONGGALA, SULAWESI TENGAH",2,113,108,221
https://kawalpemilu.org#68096,"SUMARI, SINDUE, DONGGALA, SULAWESI TENGAH",3,88,91,179
https://kawalpemilu.org#68097,"TOAYA, SINDUE, DONGGALA, SULAWESI TENGAH",1,105,139,244
https://kawalpemilu.org#68097,"TOAYA, SINDUE, DONGGALA, SULAWESI TENGAH",2,98,106,204
https://kawalpemilu.org#68097,"TOAYA, SINDUE, DONGGALA, SULAWESI TENGAH",3,72,107,179
https://kawalpemilu.org#68097,"TOAYA, SINDUE, DONGGALA, SULAWESI TENGAH",4,48,206,254
https://kawalpemilu.org#68097,"TOAYA, SINDUE, DONGGALA, SULAWESI TENGAH",5,85,162,251
https://kawalpemilu.org#68097,"TOAYA, SINDUE, DONGGALA, SULAWESI TENGAH",6,61,183,244
https://kawalpemilu.org#68097,"TOAYA, SINDUE, DONGGALA, SULAWESI TENGAH",7,62,193,255
https://kawalpemilu.org#68097,"TOAYA, SINDUE, DONGGALA, SULAWESI TENGAH",8,101,132,233
https://kawalpemilu.org#68097,"TOAYA, SINDUE, DONGGALA, SULAWESI TENGAH",9,85,109,194
https://kawalpemilu.org#68098,"MASAINGI, SINDUE, DONGGALA, SULAWESI TENGAH",1,63,132,195
https://kawalpemilu.org#68098,"MASAINGI, SINDUE, DONGGALA, SULAWESI TENGAH",2,78,142,220
https://kawalpemilu.org#68098,"MASAINGI, SINDUE, DONGGALA, SULAWESI TENGAH",3,90,146,236
https://kawalpemilu.org#68099,"MARANA, SINDUE, DONGGALA, SULAWESI TENGAH",1,63,155,218
https://kawalpemilu.org#68099,"MARANA, SINDUE, DONGGALA, SULAWESI TENGAH",2,57,142,199
https://kawalpemilu.org#68099,"MARANA, SINDUE, DONGGALA, SULAWESI TENGAH",3,81,124,205
https://kawalpemilu.org#68100,"ENU, SINDUE, DONGGALA, SULAWESI TENGAH",1,45,168,213
https://kawalpemilu.org#68100,"ENU, SINDUE, DONGGALA, SULAWESI TENGAH",2,73,147,220
https://kawalpemilu.org#68100,"ENU, SINDUE, DONGGALA, SULAWESI TENGAH",3,82,127,209
https://kawalpemilu.org#68100,"ENU, SINDUE, DONGGALA, SULAWESI TENGAH",4,110,67,177
https://kawalpemilu.org#68100,"ENU, SINDUE, DONGGALA, SULAWESI TENGAH",5,60,104,164
https://kawalpemilu.org#68101,"LERO TATARI, SINDUE, DONGGALA, SULAWESI TENGAH",1,63,171,234
https://kawalpemilu.org#68101,"LERO TATARI, SINDUE, DONGGALA, SULAWESI TENGAH",2,86,161,247
https://kawalpemilu.org#68101,"LERO TATARI, SINDUE, DONGGALA, SULAWESI TENGAH",3,52,157,209
https://kawalpemilu.org#68101,"LERO TATARI, SINDUE, DONGGALA, SULAWESI TENGAH",4,118,127,245
https://kawalpemilu.org#68101,"LERO TATARI, SINDUE, DONGGALA, SULAWESI TENGAH",5,61,5,66
https://kawalpemilu.org#68102,"TOAYA VUNTA, SINDUE, DONGGALA, SULAWESI TENGAH",1,121,109,230
https://kawalpemilu.org#68102,"TOAYA VUNTA, SINDUE, DONGGALA, SULAWESI TENGAH",2,120,104,224
https://kawalpemilu.org#68102,"TOAYA VUNTA, SINDUE, DONGGALA, SULAWESI TENGAH",3,124,110,234
https://kawalpemilu.org#68102,"TOAYA VUNTA, SINDUE, DONGGALA, SULAWESI TENGAH",4,119,100,219
https://kawalpemilu.org#68102,"TOAYA VUNTA, SINDUE, DONGGALA, SULAWESI TENGAH",5,104,127,231
https://kawalpemilu.org#68103,"GUMBASA, SINDUE, DONGGALA, SULAWESI TENGAH",1,210,18,228
https://kawalpemilu.org#68103,"GUMBASA, SINDUE, DONGGALA, SULAWESI TENGAH",2,185,61,246
https://kawalpemilu.org#68104,"APE MALIKO, SINDUE, DONGGALA, SULAWESI TENGAH",1,81,52,133
https://kawalpemilu.org#68104,"APE MALIKO, SINDUE, DONGGALA, SULAWESI TENGAH",2,102,37,139
https://kawalpemilu.org#68104,"APE MALIKO, SINDUE, DONGGALA, SULAWESI TENGAH",3,177,40,217
https://kawalpemilu.org#68105,"KAVAYA, SINDUE, DONGGALA, SULAWESI TENGAH",1,67,154,221
https://kawalpemilu.org#68105,"KAVAYA, SINDUE, DONGGALA, SULAWESI TENGAH",2,102,106,208
https://kawalpemilu.org#68105,"KAVAYA, SINDUE, DONGGALA, SULAWESI TENGAH",3,124,97,221
https://kawalpemilu.org#68107,"OMBO, SIRENJA, DONGGALA, SULAWESI TENGAH",1,75,41,116
https://kawalpemilu.org#68107,"OMBO, SIRENJA, DONGGALA, SULAWESI TENGAH",2,90,39,129
https://kawalpemilu.org#68107,"OMBO, SIRENJA, DONGGALA, SULAWESI TENGAH",3,129,71,200
https://kawalpemilu.org#68107,"OMBO, SIRENJA, DONGGALA, SULAWESI TENGAH",4,117,62,179
https://kawalpemilu.org#68107,"OMBO, SIRENJA, DONGGALA, SULAWESI TENGAH",5,76,53,129
https://kawalpemilu.org#68108,"TONDO, SIRENJA, DONGGALA, SULAWESI TENGAH",1,137,65,202
https://kawalpemilu.org#68108,"TONDO, SIRENJA, DONGGALA, SULAWESI TENGAH",2,110,98,208
https://kawalpemilu.org#68108,"TONDO, SIRENJA, DONGGALA, SULAWESI TENGAH",3,120,80,200
https://kawalpemilu.org#68108,"TONDO, SIRENJA, DONGGALA, SULAWESI TENGAH",4,110,86,196
https://kawalpemilu.org#68108,"TONDO, SIRENJA, DONGGALA, SULAWESI TENGAH",5,141,62,203
https://kawalpemilu.org#68109,"JONOOGE, SIRENJA, DONGGALA, SULAWESI TENGAH",1,124,107,231
https://kawalpemilu.org#68109,"JONOOGE, SIRENJA, DONGGALA, SULAWESI TENGAH",2,100,51,151
https://kawalpemilu.org#68109,"JONOOGE, SIRENJA, DONGGALA, SULAWESI TENGAH",3,83,67,150
https://kawalpemilu.org#68110,"DAMPAL, SIRENJA, DONGGALA, SULAWESI TENGAH",1,135,49,184
https://kawalpemilu.org#68110,"DAMPAL, SIRENJA, DONGGALA, SULAWESI TENGAH",2,48,92,140
https://kawalpemilu.org#68110,"DAMPAL, SIRENJA, DONGGALA, SULAWESI TENGAH",3,79,74,153
https://kawalpemilu.org#68111,"SIPI, SIRENJA, DONGGALA, SULAWESI TENGAH",1,66,137,203
https://kawalpemilu.org#68111,"SIPI, SIRENJA, DONGGALA, SULAWESI TENGAH",2,70,118,118
https://kawalpemilu.org#68111,"SIPI, SIRENJA, DONGGALA, SULAWESI TENGAH",3,89,81,170
https://kawalpemilu.org#68111,"SIPI, SIRENJA, DONGGALA, SULAWESI TENGAH",4,88,92,180
https://kawalpemilu.org#68111,"SIPI, SIRENJA, DONGGALA, SULAWESI TENGAH",5,83,86,169
https://kawalpemilu.org#68111,"SIPI, SIRENJA, DONGGALA, SULAWESI TENGAH",6,109,78,187
https://kawalpemilu.org#68111,"SIPI, SIRENJA, DONGGALA, SULAWESI TENGAH",7,52,116,168
https://kawalpemilu.org#68112,"TANJUNG PADANG, SIRENJA, DONGGALA, SULAWESI TENGAH",2,90,77,167
https://kawalpemilu.org#68112,"TANJUNG PADANG, SIRENJA, DONGGALA, SULAWESI TENGAH",3,103,60,163
https://kawalpemilu.org#68112,"TANJUNG PADANG, SIRENJA, DONGGALA, SULAWESI TENGAH",4,79,79,158
https://kawalpemilu.org#68112,"TANJUNG PADANG, SIRENJA, DONGGALA, SULAWESI TENGAH",5,93,65,158
https://kawalpemilu.org#68112,"TANJUNG PADANG, SIRENJA, DONGGALA, SULAWESI TENGAH",6,64,84,148
https://kawalpemilu.org#68112,"TANJUNG PADANG, SIRENJA, DONGGALA, SULAWESI TENGAH",7,80,96,176
https://kawalpemilu.org#68113,"BALINTUMA, SIRENJA, DONGGALA, SULAWESI TENGAH",1,72,82,154
https://kawalpemilu.org#68113,"BALINTUMA, SIRENJA, DONGGALA, SULAWESI TENGAH",2,77,75,152
https://kawalpemilu.org#68113,"BALINTUMA, SIRENJA, DONGGALA, SULAWESI TENGAH",3,64,98,162
https://kawalpemilu.org#68113,"BALINTUMA, SIRENJA, DONGGALA, SULAWESI TENGAH",4,99,35,134
https://kawalpemilu.org#68113,"BALINTUMA, SIRENJA, DONGGALA, SULAWESI TENGAH",5,108,26,134
https://kawalpemilu.org#68114,"SIBADO, SIRENJA, DONGGALA, SULAWESI TENGAH",1,121,49,170
https://kawalpemilu.org#68114,"SIBADO, SIRENJA, DONGGALA, SULAWESI TENGAH",2,101,55,156
https://kawalpemilu.org#68114,"SIBADO, SIRENJA, DONGGALA, SULAWESI TENGAH",3,109,42,151
https://kawalpemilu.org#68114,"SIBADO, SIRENJA, DONGGALA, SULAWESI TENGAH",4,99,44,143
https://kawalpemilu.org#68114,"SIBADO, SIRENJA, DONGGALA, SULAWESI TENGAH",5,62,34,96
https://kawalpemilu.org#68114,"SIBADO, SIRENJA, DONGGALA, SULAWESI TENGAH",7,105,44,149
https://kawalpemilu.org#68114,"SIBADO, SIRENJA, DONGGALA, SULAWESI TENGAH",8,124,41,165
https://kawalpemilu.org#68114,"SIBADO, SIRENJA, DONGGALA, SULAWESI TENGAH",9,72,14,86
https://kawalpemilu.org#68115,"TOMPE, SIRENJA, DONGGALA, SULAWESI TENGAH",1,111,64,175
https://kawalpemilu.org#68115,"TOMPE, SIRENJA, DONGGALA, SULAWESI TENGAH",2,100,95,195
https://kawalpemilu.org#68115,"TOMPE, SIRENJA, DONGGALA, SULAWESI TENGAH",3,100,103,203
https://kawalpemilu.org#68115,"TOMPE, SIRENJA, DONGGALA, SULAWESI TENGAH",4,77,98,175
https://kawalpemilu.org#68115,"TOMPE, SIRENJA, DONGGALA, SULAWESI TENGAH",5,97,60,157
https://kawalpemilu.org#68116,"LOMPIO, SIRENJA, DONGGALA, SULAWESI TENGAH",1,94,96,190
https://kawalpemilu.org#68116,"LOMPIO, SIRENJA, DONGGALA, SULAWESI TENGAH",2,58,156,214
https://kawalpemilu.org#68116,"LOMPIO, SIRENJA, DONGGALA, SULAWESI TENGAH",3,136,79,215
https://kawalpemilu.org#68117,"LENDE, SIRENJA, DONGGALA, SULAWESI TENGAH",1,93,77,170
https://kawalpemilu.org#68117,"LENDE, SIRENJA, DONGGALA, SULAWESI TENGAH",2,65,120,185
https://kawalpemilu.org#68117,"LENDE, SIRENJA, DONGGALA, SULAWESI TENGAH",3,50,118,168
https://kawalpemilu.org#68117,"LENDE, SIRENJA, DONGGALA, SULAWESI TENGAH",4,66,104,170
https://kawalpemilu.org#68117,"LENDE, SIRENJA, DONGGALA, SULAWESI TENGAH",5,102,70,172
https://kawalpemilu.org#68118,"LENDE TOVEA, SIRENJA, DONGGALA, SULAWESI TENGAH",1,80,96,176
https://kawalpemilu.org#68118,"LENDE TOVEA, SIRENJA, DONGGALA, SULAWESI TENGAH",2,61,53,114
https://kawalpemilu.org#68118,"LENDE TOVEA, SIRENJA, DONGGALA, SULAWESI TENGAH",3,102,48,150
https://kawalpemilu.org#68118,"LENDE TOVEA, SIRENJA, DONGGALA, SULAWESI TENGAH",5,69,33,102
https://kawalpemilu.org#68118,"LENDE TOVEA, SIRENJA, DONGGALA, SULAWESI TENGAH",6,88,22,110
https://kawalpemilu.org#93020,"UJUMBOU, SIRENJA, DONGGALA, SULAWESI TENGAH",1,125,90,215
https://kawalpemilu.org#93020,"UJUMBOU, SIRENJA, DONGGALA, SULAWESI TENGAH",2,113,51,164
https://kawalpemilu.org#93020,"UJUMBOU, SIRENJA, DONGGALA, SULAWESI TENGAH",3,146,54,200
https://kawalpemilu.org#93020,"UJUMBOU, SIRENJA, DONGGALA, SULAWESI TENGAH",4,141,40,181
https://kawalpemilu.org#93020,"UJUMBOU, SIRENJA, DONGGALA, SULAWESI TENGAH",5,161,38,199
https://kawalpemilu.org#93020,"UJUMBOU, SIRENJA, DONGGALA, SULAWESI TENGAH",6,109,56,165
https://kawalpemilu.org#68120,"LABEAN, BALAESANG, DONGGALA, SULAWESI TENGAH",1,144,60,204
https://kawalpemilu.org#68120,"LABEAN, BALAESANG, DONGGALA, SULAWESI TENGAH",2,135,68,203
https://kawalpemilu.org#68120,"LABEAN, BALAESANG, DONGGALA, SULAWESI TENGAH",3,161,88,249
https://kawalpemilu.org#68120,"LABEAN, BALAESANG, DONGGALA, SULAWESI TENGAH",4,122,95,217
https://kawalpemilu.org#68120,"LABEAN, BALAESANG, DONGGALA, SULAWESI TENGAH",5,84,107,191
https://kawalpemilu.org#68120,"LABEAN, BALAESANG, DONGGALA, SULAWESI TENGAH",6,116,87,203
https://kawalpemilu.org#68120,"LABEAN, BALAESANG, DONGGALA, SULAWESI TENGAH",7,164,69,233
https://kawalpemilu.org#68120,"LABEAN, BALAESANG, DONGGALA, SULAWESI TENGAH",8,122,67,189
https://kawalpemilu.org#68120,"LABEAN, BALAESANG, DONGGALA, SULAWESI TENGAH",9,125,87,212
https://kawalpemilu.org#68121,"LOMBONGA, BALAESANG, DONGGALA, SULAWESI TENGAH",1,154,61,215
https://kawalpemilu.org#68121,"LOMBONGA, BALAESANG, DONGGALA, SULAWESI TENGAH",2,115,62,177
https://kawalpemilu.org#68121,"LOMBONGA, BALAESANG, DONGGALA, SULAWESI TENGAH",3,117,85,202
https://kawalpemilu.org#68121,"LOMBONGA, BALAESANG, DONGGALA, SULAWESI TENGAH",4,134,68,202
https://kawalpemilu.org#68121,"LOMBONGA, BALAESANG, DONGGALA, SULAWESI TENGAH",5,109,81,190
https://kawalpemilu.org#68121,"LOMBONGA, BALAESANG, DONGGALA, SULAWESI TENGAH",6,102,68,170
https://kawalpemilu.org#68122,"MELI, BALAESANG, DONGGALA, SULAWESI TENGAH",1,124,76,200
https://kawalpemilu.org#68122,"MELI, BALAESANG, DONGGALA, SULAWESI TENGAH",2,96,129,225
https://kawalpemilu.org#68122,"MELI, BALAESANG, DONGGALA, SULAWESI TENGAH",3,114,73,187
https://kawalpemilu.org#68122,"MELI, BALAESANG, DONGGALA, SULAWESI TENGAH",4,118,69,187
https://kawalpemilu.org#68122,"MELI, BALAESANG, DONGGALA, SULAWESI TENGAH",5,133,72,205
https://kawalpemilu.org#68123,"TAMBU, BALAESANG, DONGGALA, SULAWESI TENGAH",1,103,127,230
https://kawalpemilu.org#68123,"TAMBU, BALAESANG, DONGGALA, SULAWESI TENGAH",2,94,133,227
https://kawalpemilu.org#68123,"TAMBU, BALAESANG, DONGGALA, SULAWESI TENGAH",3,90,143,233
https://kawalpemilu.org#68123,"TAMBU, BALAESANG, DONGGALA, SULAWESI TENGAH",4,74,103,177
https://kawalpemilu.org#68123,"TAMBU, BALAESANG, DONGGALA, SULAWESI TENGAH",5,80,84,164
https://kawalpemilu.org#68123,"TAMBU, BALAESANG, DONGGALA, SULAWESI TENGAH",6,81,69,150
https://kawalpemilu.org#68124,"SIWELI, BALAESANG, DONGGALA, SULAWESI TENGAH",1,84,143,227
https://kawalpemilu.org#68124,"SIWELI, BALAESANG, DONGGALA, SULAWESI TENGAH",2,100,106,206
https://kawalpemilu.org#68124,"SIWELI, BALAESANG, DONGGALA, SULAWESI TENGAH",3,96,106,202
https://kawalpemilu.org#68124,"SIWELI, BALAESANG, DONGGALA, SULAWESI TENGAH",4,98,106,204
https://kawalpemilu.org#68124,"SIWELI, BALAESANG, DONGGALA, SULAWESI TENGAH",5,55,100,155
https://kawalpemilu.org#68124,"SIWELI, BALAESANG, DONGGALA, SULAWESI TENGAH",6,110,60,170
https://kawalpemilu.org#68124,"SIWELI, BALAESANG, DONGGALA, SULAWESI TENGAH",7,122,38,160
https://kawalpemilu.org#68124,"SIWELI, BALAESANG, DONGGALA, SULAWESI TENGAH",8,156,16,172
https://kawalpemilu.org#68124,"SIWELI, BALAESANG, DONGGALA, SULAWESI TENGAH",9,111,53,164
https://kawalpemilu.org#68125,"SIBUALONG, BALAESANG, DONGGALA, SULAWESI TENGAH",1,123,94,217
https://kawalpemilu.org#68125,"SIBUALONG, BALAESANG, DONGGALA, SULAWESI TENGAH",2,140,83,223
https://kawalpemilu.org#68125,"SIBUALONG, BALAESANG, DONGGALA, SULAWESI TENGAH",3,118,112,230
https://kawalpemilu.org#68126,"SIBAYU, BALAESANG, DONGGALA, SULAWESI TENGAH",1,113,109,222
https://kawalpemilu.org#68126,"SIBAYU, BALAESANG, DONGGALA, SULAWESI TENGAH",2,95,49,144
https://kawalpemilu.org#68126,"SIBAYU, BALAESANG, DONGGALA, SULAWESI TENGAH",3,197,15,212
https://kawalpemilu.org#68126,"SIBAYU, BALAESANG, DONGGALA, SULAWESI TENGAH",4,132,67,199
https://kawalpemilu.org#68126,"SIBAYU, BALAESANG, DONGGALA, SULAWESI TENGAH",5,129,24,153
https://kawalpemilu.org#68127,"MALINO, BALAESANG, DONGGALA, SULAWESI TENGAH",1,113,56,169
https://kawalpemilu.org#68127,"MALINO, BALAESANG, DONGGALA, SULAWESI TENGAH",2,137,38,175
https://kawalpemilu.org#68127,"MALINO, BALAESANG, DONGGALA, SULAWESI TENGAH",3,127,49,176
https://kawalpemilu.org#68127,"MALINO, BALAESANG, DONGGALA, SULAWESI TENGAH",4,132,42,174
https://kawalpemilu.org#68128,"MAPANE TAMBU, BALAESANG, DONGGALA, SULAWESI TENGAH",1,100,144,244
https://kawalpemilu.org#68128,"MAPANE TAMBU, BALAESANG, DONGGALA, SULAWESI TENGAH",2,74,107,181
https://kawalpemilu.org#68128,"MAPANE TAMBU, BALAESANG, DONGGALA, SULAWESI TENGAH",3,108,66,174
https://kawalpemilu.org#68128,"MAPANE TAMBU, BALAESANG, DONGGALA, SULAWESI TENGAH",4,66,82,148
https://kawalpemilu.org#68129,"TOVIA TAMBU, BALAESANG, DONGGALA, SULAWESI TENGAH",1,134,82,216
https://kawalpemilu.org#68129,"TOVIA TAMBU, BALAESANG, DONGGALA, SULAWESI TENGAH",2,161,71,232
https://kawalpemilu.org#68129,"TOVIA TAMBU, BALAESANG, DONGGALA, SULAWESI TENGAH",3,141,39,180
https://kawalpemilu.org#68129,"TOVIA TAMBU, BALAESANG, DONGGALA, SULAWESI TENGAH",4,212,52,264
https://kawalpemilu.org#68129,"TOVIA TAMBU, BALAESANG, DONGGALA, SULAWESI TENGAH",5,132,81,213
https://kawalpemilu.org#68129,"TOVIA TAMBU, BALAESANG, DONGGALA, SULAWESI TENGAH",6,136,47,183
https://kawalpemilu.org#87572,"SIPURE, BALAESANG, DONGGALA, SULAWESI TENGAH",1,96,117,213
https://kawalpemilu.org#87572,"SIPURE, BALAESANG, DONGGALA, SULAWESI TENGAH",2,103,115,218
https://kawalpemilu.org#87573,"KAMPUNG BARU SIBAYU, BALAESANG, DONGGALA, SULAWESI TENGAH",1,64,98,162
https://kawalpemilu.org#87573,"KAMPUNG BARU SIBAYU, BALAESANG, DONGGALA, SULAWESI TENGAH",2,109,66,175
https://kawalpemilu.org#87573,"KAMPUNG BARU SIBAYU, BALAESANG, DONGGALA, SULAWESI TENGAH",3,81,74,155
https://kawalpemilu.org#87573,"KAMPUNG BARU SIBAYU, BALAESANG, DONGGALA, SULAWESI TENGAH",4,106,51,157
https://kawalpemilu.org#87574,"SIMAGAYA, BALAESANG, DONGGALA, SULAWESI TENGAH",1,88,122,210
https://kawalpemilu.org#87574,"SIMAGAYA, BALAESANG, DONGGALA, SULAWESI TENGAH",2,74,108,182
https://kawalpemilu.org#87574,"SIMAGAYA, BALAESANG, DONGGALA, SULAWESI TENGAH",3,74,103,177
https://kawalpemilu.org#87574,"SIMAGAYA, BALAESANG, DONGGALA, SULAWESI TENGAH",4,116,63,179
https://kawalpemilu.org#68131,"BALUKANG, SOJOL, DONGGALA, SULAWESI TENGAH",1,161,102,263
https://kawalpemilu.org#68131,"BALUKANG, SOJOL, DONGGALA, SULAWESI TENGAH",2,85,175,260
https://kawalpemilu.org#68131,"BALUKANG, SOJOL, DONGGALA, SULAWESI TENGAH",3,127,61,188
https://kawalpemilu.org#68131,"BALUKANG, SOJOL, DONGGALA, SULAWESI TENGAH",4,77,121,198
https://kawalpemilu.org#68131,"BALUKANG, SOJOL, DONGGALA, SULAWESI TENGAH",5,94,135,229
https://kawalpemilu.org#68131,"BALUKANG, SOJOL, DONGGALA, SULAWESI TENGAH",6,169,73,242
https://kawalpemilu.org#68131,"BALUKANG, SOJOL, DONGGALA, SULAWESI TENGAH",7,63,74,137
https://kawalpemilu.org#68132,"SIWALEMPU, SOJOL, DONGGALA, SULAWESI TENGAH",2,122,74,196
https://kawalpemilu.org#68132,"SIWALEMPU, SOJOL, DONGGALA, SULAWESI TENGAH",3,132,59,191
https://kawalpemilu.org#68132,"SIWALEMPU, SOJOL, DONGGALA, SULAWESI TENGAH",4,98,121,219
https://kawalpemilu.org#68132,"SIWALEMPU, SOJOL, DONGGALA, SULAWESI TENGAH",5,110,102,212
https://kawalpemilu.org#68132,"SIWALEMPU, SOJOL, DONGGALA, SULAWESI TENGAH",6,106,89,195
https://kawalpemilu.org#68132,"SIWALEMPU, SOJOL, DONGGALA, SULAWESI TENGAH",7,151,100,251
https://kawalpemilu.org#68132,"SIWALEMPU, SOJOL, DONGGALA, SULAWESI TENGAH",8,69,119,188
https://kawalpemilu.org#68132,"SIWALEMPU, SOJOL, DONGGALA, SULAWESI TENGAH",9,104,101,205
https://kawalpemilu.org#68133,"SIBOANG, SOJOL, DONGGALA, SULAWESI TENGAH",1,153,96,249
https://kawalpemilu.org#68133,"SIBOANG, SOJOL, DONGGALA, SULAWESI TENGAH",2,133,95,228
https://kawalpemilu.org#68133,"SIBOANG, SOJOL, DONGGALA, SULAWESI TENGAH",3,82,96,178
https://kawalpemilu.org#68133,"SIBOANG, SOJOL, DONGGALA, SULAWESI TENGAH",4,108,71,179
https://kawalpemilu.org#68133,"SIBOANG, SOJOL, DONGGALA, SULAWESI TENGAH",5,84,49,133
https://kawalpemilu.org#68133,"SIBOANG, SOJOL, DONGGALA, SULAWESI TENGAH",6,161,74,235
https://kawalpemilu.org#68133,"SIBOANG, SOJOL, DONGGALA, SULAWESI TENGAH",7,116,54,170
https://kawalpemilu.org#68133,"SIBOANG, SOJOL, DONGGALA, SULAWESI TENGAH",8,113,40,153
https://kawalpemilu.org#68133,"SIBOANG, SOJOL, DONGGALA, SULAWESI TENGAH",9,131,74,205
https://kawalpemilu.org#68133,"SIBOANG, SOJOL, DONGGALA, SULAWESI TENGAH",10,106,46,152
https://kawalpemilu.org#68133,"SIBOANG, SOJOL, DONGGALA, SULAWESI TENGAH",11,112,72,184
https://kawalpemilu.org#68134,"TONGGOLOBIBI, SOJOL, DONGGALA, SULAWESI TENGAH",1,161,105,266
https://kawalpemilu.org#68134,"TONGGOLOBIBI, SOJOL, DONGGALA, SULAWESI TENGAH",2,164,85,249
https://kawalpemilu.org#68134,"TONGGOLOBIBI, SOJOL, DONGGALA, SULAWESI TENGAH",3,139,78,217
https://kawalpemilu.org#68134,"TONGGOLOBIBI, SOJOL, DONGGALA, SULAWESI TENGAH",4,134,58,192
https://kawalpemilu.org#68134,"TONGGOLOBIBI, SOJOL, DONGGALA, SULAWESI TENGAH",5,201,28,229
https://kawalpemilu.org#68134,"TONGGOLOBIBI, SOJOL, DONGGALA, SULAWESI TENGAH",6,126,18,144
https://kawalpemilu.org#68134,"TONGGOLOBIBI, SOJOL, DONGGALA, SULAWESI TENGAH",7,116,27,143
https://kawalpemilu.org#68134,"TONGGOLOBIBI, SOJOL, DONGGALA, SULAWESI TENGAH",8,97,43,140
https://kawalpemilu.org#68134,"TONGGOLOBIBI, SOJOL, DONGGALA, SULAWESI TENGAH",9,152,25,177
https://kawalpemilu.org#68134,"TONGGOLOBIBI, SOJOL, DONGGALA, SULAWESI TENGAH",10,132,79,211
https://kawalpemilu.org#68134,"TONGGOLOBIBI, SOJOL, DONGGALA, SULAWESI TENGAH",11,118,70,188
https://kawalpemilu.org#68134,"TONGGOLOBIBI, SOJOL, DONGGALA, SULAWESI TENGAH",12,104,70,174
https://kawalpemilu.org#68135,"BOU, SOJOL, DONGGALA, SULAWESI TENGAH",1,75,100,175
https://kawalpemilu.org#68135,"BOU, SOJOL, DONGGALA, SULAWESI TENGAH",2,97,85,182
https://kawalpemilu.org#68135,"BOU, SOJOL, DONGGALA, SULAWESI TENGAH",3,104,114,214
https://kawalpemilu.org#68135,"BOU, SOJOL, DONGGALA, SULAWESI TENGAH",4,88,134,222
https://kawalpemilu.org#68135,"BOU, SOJOL, DONGGALA, SULAWESI TENGAH",5,73,124,197
https://kawalpemilu.org#68135,"BOU, SOJOL, DONGGALA, SULAWESI TENGAH",6,67,168,235
https://kawalpemilu.org#68135,"BOU, SOJOL, DONGGALA, SULAWESI TENGAH",7,73,93,166
https://kawalpemilu.org#68135,"BOU, SOJOL, DONGGALA, SULAWESI TENGAH",8,89,80,169
https://kawalpemilu.org#68136,"SAMALILI, SOJOL, DONGGALA, SULAWESI TENGAH",1,186,66,252
https://kawalpemilu.org#68136,"SAMALILI, SOJOL, DONGGALA, SULAWESI TENGAH",2,135,41,176
https://kawalpemilu.org#68136,"SAMALILI, SOJOL, DONGGALA, SULAWESI TENGAH",3,137,73,210
https://kawalpemilu.org#68136,"SAMALILI, SOJOL, DONGGALA, SULAWESI TENGAH",4,183,48,231
https://kawalpemilu.org#68136,"SAMALILI, SOJOL, DONGGALA, SULAWESI TENGAH",5,193,36,229
https://kawalpemilu.org#68137,"BUKIT HARAPAN, SOJOL, DONGGALA, SULAWESI TENGAH",1,173,66,239
https://kawalpemilu.org#68137,"BUKIT HARAPAN, SOJOL, DONGGALA, SULAWESI TENGAH",2,96,53,149
https://kawalpemilu.org#68138,"PANGALASIANG, SOJOL, DONGGALA, SULAWESI TENGAH",1,114,80,194
https://kawalpemilu.org#68138,"PANGALASIANG, SOJOL, DONGGALA, SULAWESI TENGAH",2,140,45,185
https://kawalpemilu.org#68138,"PANGALASIANG, SOJOL, DONGGALA, SULAWESI TENGAH",3,142,71,213
https://kawalpemilu.org#68138,"PANGALASIANG, SOJOL, DONGGALA, SULAWESI TENGAH",4,57,155,212
https://kawalpemilu.org#68138,"PANGALASIANG, SOJOL, DONGGALA, SULAWESI TENGAH",5,54,101,155
https://kawalpemilu.org#68138,"PANGALASIANG, SOJOL, DONGGALA, SULAWESI TENGAH",6,108,46,154
https://kawalpemilu.org#68138,"PANGALASIANG, SOJOL, DONGGALA, SULAWESI TENGAH",7,103,37,140
https://kawalpemilu.org#68138,"PANGALASIANG, SOJOL, DONGGALA, SULAWESI TENGAH",8,74,44,118
https://kawalpemilu.org#68138,"PANGALASIANG, SOJOL, DONGGALA, SULAWESI TENGAH",9,32,122,154
https://kawalpemilu.org#68138,"PANGALASIANG, SOJOL, DONGGALA, SULAWESI TENGAH",10,60,126,186
https://kawalpemilu.org#68138,"PANGALASIANG, SOJOL, DONGGALA, SULAWESI TENGAH",11,66,75,141
https://kawalpemilu.org#68139,"BALUKANG II, SOJOL, DONGGALA, SULAWESI TENGAH",1,188,74,262
https://kawalpemilu.org#68139,"BALUKANG II, SOJOL, DONGGALA, SULAWESI TENGAH",2,100,79,179
https://kawalpemilu.org#68139,"BALUKANG II, SOJOL, DONGGALA, SULAWESI TENGAH",3,114,59,173
https://kawalpemilu.org#68139,"BALUKANG II, SOJOL, DONGGALA, SULAWESI TENGAH",4,132,91,223
https://kawalpemilu.org#68139,"BALUKANG II, SOJOL, DONGGALA, SULAWESI TENGAH",5,168,68,236
https://kawalpemilu.org#68139,"BALUKANG II, SOJOL, DONGGALA, SULAWESI TENGAH",6,126,92,218
https://kawalpemilu.org#68141,"MBUWU, BANAWA SELATAN, DONGGALA, SULAWESI TENGAH",1,146,40,186
https://kawalpemilu.org#68141,"MBUWU, BANAWA SELATAN, DONGGALA, SULAWESI TENGAH",2,116,53,169
https://kawalpemilu.org#68141,"MBUWU, BANAWA SELATAN, DONGGALA, SULAWESI TENGAH",3,147,26,173
https://kawalpemilu.org#68141,"MBUWU, BANAWA SELATAN, DONGGALA, SULAWESI TENGAH",4,113,14,127
https://kawalpemilu.org#68141,"MBUWU, BANAWA SELATAN, DONGGALA, SULAWESI TENGAH",5,143,10,153
https://kawalpemilu.org#68142,"SALUMPAKU, BANAWA SELATAN, DONGGALA, SULAWESI TENGAH",1,114,124,238
https://kawalpemilu.org#68142,"SALUMPAKU, BANAWA SELATAN, DONGGALA, SULAWESI TENGAH",2,47,50,97
https://kawalpemilu.org#68142,"SALUMPAKU, BANAWA SELATAN, DONGGALA, SULAWESI TENGAH",3,143,73,216
https://kawalpemilu.org#68143,"WATATU, BANAWA SELATAN, DONGGALA, SULAWESI TENGAH",1,138,100,238
https://kawalpemilu.org#68143,"WATATU, BANAWA SELATAN, DONGGALA, SULAWESI TENGAH",2,110,121,231
https://kawalpemilu.org#68143,"WATATU, BANAWA SELATAN, DONGGALA, SULAWESI TENGAH",3,199,31,230
https://kawalpemilu.org#68143,"WATATU, BANAWA SELATAN, DONGGALA, SULAWESI TENGAH",4,110,86,196
https://kawalpemilu.org#68143,"WATATU, BANAWA SELATAN, DONGGALA, SULAWESI TENGAH",5,50,37,87
https://kawalpemilu.org#68143,"WATATU, BANAWA SELATAN, DONGGALA, SULAWESI TENGAH",6,160,11,171
https://kawalpemilu.org#68143,"WATATU, BANAWA SELATAN, DONGGALA, SULAWESI TENGAH",7,118,52,170
https://kawalpemilu.org#68143,"WATATU, BANAWA SELATAN, DONGGALA, SULAWESI TENGAH",8,138,74,212
https://kawalpemilu.org#68144,"SURUMANA, BANAWA SELATAN, DONGGALA, SULAWESI TENGAH",1,155,90,245
https://kawalpemilu.org#68144,"SURUMANA, BANAWA SELATAN, DONGGALA, SULAWESI TENGAH",2,104,109,213
https://kawalpemilu.org#68144,"SURUMANA, BANAWA SELATAN, DONGGALA, SULAWESI TENGAH",3,67,88,155
https://kawalpemilu.org#68144,"SURUMANA, BANAWA SELATAN, DONGGALA, SULAWESI TENGAH",4,124,83,207
https://kawalpemilu.org#68144,"SURUMANA, BANAWA SELATAN, DONGGALA, SULAWESI TENGAH",5,55,58,113
https://kawalpemilu.org#68145,"LALOMBI, BANAWA SELATAN, DONGGALA, SULAWESI TENGAH",1,107,89,196
https://kawalpemilu.org#68145,"LALOMBI, BANAWA SELATAN, DONGGALA, SULAWESI TENGAH",2,111,69,180
https://kawalpemilu.org#68145,"LALOMBI, BANAWA SELATAN, DONGGALA, SULAWESI TENGAH",3,121,85,206
https://kawalpemilu.org#68145,"LALOMBI, BANAWA SELATAN, DONGGALA, SULAWESI TENGAH",4,155,53,208
https://kawalpemilu.org#68145,"LALOMBI, BANAWA SELATAN, DONGGALA, SULAWESI TENGAH",5,151,80,231
https://kawalpemilu.org#68146,"TANAMEA, BANAWA SELATAN, DONGGALA, SULAWESI TENGAH",1,114,86,200
https://kawalpemilu.org#68146,"TANAMEA, BANAWA SELATAN, DONGGALA, SULAWESI TENGAH",2,131,102,233
https://kawalpemilu.org#68146,"TANAMEA, BANAWA SELATAN, DONGGALA, SULAWESI TENGAH",3,163,69,232
https://kawalpemilu.org#68146,"TANAMEA, BANAWA SELATAN, DONGGALA, SULAWESI TENGAH",4,107,124,231
https://kawalpemilu.org#68147,"BAMBARIMI, BANAWA SELATAN, DONGGALA, SULAWESI TENGAH",1,78,116,193
https://kawalpemilu.org#68147,"BAMBARIMI, BANAWA SELATAN, DONGGALA, SULAWESI TENGAH",2,100,151,251
https://kawalpemilu.org#68147,"BAMBARIMI, BANAWA SELATAN, DONGGALA, SULAWESI TENGAH",3,87,19,106
https://kawalpemilu.org#68148,"SALUNGKAENU, BANAWA SELATAN, DONGGALA, SULAWESI TENGAH",1,108,135,243
https://kawalpemilu.org#68148,"SALUNGKAENU, BANAWA SELATAN, DONGGALA, SULAWESI TENGAH",2,113,52,165
https://kawalpemilu.org#68148,"SALUNGKAENU, BANAWA SELATAN, DONGGALA, SULAWESI TENGAH",3,102,48,150
https://kawalpemilu.org#68149,"LUMBUMAMARA, BANAWA SELATAN, DONGGALA, SULAWESI TENGAH",1,105,142,247
https://kawalpemilu.org#68149,"LUMBUMAMARA, BANAWA SELATAN, DONGGALA, SULAWESI TENGAH",2,78,171,249
https://kawalpemilu.org#68149,"LUMBUMAMARA, BANAWA SELATAN, DONGGALA, SULAWESI TENGAH",3,126,97,223
https://kawalpemilu.org#68149,"LUMBUMAMARA, BANAWA SELATAN, DONGGALA, SULAWESI TENGAH",4,73,117,190
https://kawalpemilu.org#68150,"TOLONGANO, BANAWA SELATAN, DONGGALA, SULAWESI TENGAH",1,63,131,194
https://kawalpemilu.org#68150,"TOLONGANO, BANAWA SELATAN, DONGGALA, SULAWESI TENGAH",2,88,129,217
https://kawalpemilu.org#68150,"TOLONGANO, BANAWA SELATAN, DONGGALA, SULAWESI TENGAH",3,119,84,203
https://kawalpemilu.org#68150,"TOLONGANO, BANAWA SELATAN, DONGGALA, SULAWESI TENGAH",4,43,127,170
https://kawalpemilu.org#68151,"TOSALE, BANAWA SELATAN, DONGGALA, SULAWESI TENGAH",1,177,47,224
https://kawalpemilu.org#68151,"TOSALE, BANAWA SELATAN, DONGGALA, SULAWESI TENGAH",2,77,142,219
https://kawalpemilu.org#68151,"TOSALE, BANAWA SELATAN, DONGGALA, SULAWESI TENGAH",3,90,93,183
https://kawalpemilu.org#68151,"TOSALE, BANAWA SELATAN, DONGGALA, SULAWESI TENGAH",4,88,142,230
https://kawalpemilu.org#68151,"TOSALE, BANAWA SELATAN, DONGGALA, SULAWESI TENGAH",5,103,123,226
https://kawalpemilu.org#68151,"TOSALE, BANAWA SELATAN, DONGGALA, SULAWESI TENGAH",6,123,92,215
https://kawalpemilu.org#68152,"LUMBU TAROMBO, BANAWA SELATAN, DONGGALA, SULAWESI TENGAH",1,84,128,212
https://kawalpemilu.org#68152,"LUMBU TAROMBO, BANAWA SELATAN, DONGGALA, SULAWESI TENGAH",2,107,111,218
https://kawalpemilu.org#68152,"LUMBU TAROMBO, BANAWA SELATAN, DONGGALA, SULAWESI TENGAH",3,99,98,197
https://kawalpemilu.org#68152,"LUMBU TAROMBO, BANAWA SELATAN, DONGGALA, SULAWESI TENGAH",4,115,91,206
https://kawalpemilu.org#68153,"LUMBULAMA, BANAWA SELATAN, DONGGALA, SULAWESI TENGAH",1,147,4,151
https://kawalpemilu.org#68153,"LUMBULAMA, BANAWA SELATAN, DONGGALA, SULAWESI TENGAH",2,172,28,200
https://kawalpemilu.org#68153,"LUMBULAMA, BANAWA SELATAN, DONGGALA, SULAWESI TENGAH",3,208,17,225
https://kawalpemilu.org#68154,"ONGULARA, BANAWA SELATAN, DONGGALA, SULAWESI TENGAH",1,116,4,120
https://kawalpemilu.org#68154,"ONGULARA, BANAWA SELATAN, DONGGALA, SULAWESI TENGAH",3,87,8,95
https://kawalpemilu.org#68155,"MALINO, BANAWA SELATAN, DONGGALA, SULAWESI TENGAH",1,147,7,154
https://kawalpemilu.org#68155,"MALINO, BANAWA SELATAN, DONGGALA, SULAWESI TENGAH",2,143,28,171
https://kawalpemilu.org#68155,"MALINO, BANAWA SELATAN, DONGGALA, SULAWESI TENGAH",3,176,13,189
https://kawalpemilu.org#87575,"LEMBASADA, BANAWA SELATAN, DONGGALA, SULAWESI TENGAH",1,98,79,177
https://kawalpemilu.org#87575,"LEMBASADA, BANAWA SELATAN, DONGGALA, SULAWESI TENGAH",2,75,106,181
https://kawalpemilu.org#87575,"LEMBASADA, BANAWA SELATAN, DONGGALA, SULAWESI TENGAH",3,110,98,208
https://kawalpemilu.org#87575,"LEMBASADA, BANAWA SELATAN, DONGGALA, SULAWESI TENGAH",4,105,76,181
https://kawalpemilu.org#87576,"SAROMBAYA, BANAWA SELATAN, DONGGALA, SULAWESI TENGAH",1,91,122,213
https://kawalpemilu.org#87576,"SAROMBAYA, BANAWA SELATAN, DONGGALA, SULAWESI TENGAH",2,94,49,143
https://kawalpemilu.org#87576,"SAROMBAYA, BANAWA SELATAN, DONGGALA, SULAWESI TENGAH",3,106,50,156
https://kawalpemilu.org#87577,"SALUSUMPU, BANAWA SELATAN, DONGGALA, SULAWESI TENGAH",1,163,79,242
https://kawalpemilu.org#87577,"SALUSUMPU, BANAWA SELATAN, DONGGALA, SULAWESI TENGAH",2,103,95,198
https://kawalpemilu.org#87578,"TANAMPULU, BANAWA SELATAN, DONGGALA, SULAWESI TENGAH",1,112,97,209
https://kawalpemilu.org#87578,"TANAMPULU, BANAWA SELATAN, DONGGALA, SULAWESI TENGAH",2,122,72,194
https://kawalpemilu.org#68157,"WANI I, TANANTOVEA, DONGGALA, SULAWESI TENGAH",1,81,134,215
https://kawalpemilu.org#68157,"WANI I, TANANTOVEA, DONGGALA, SULAWESI TENGAH",2,73,126,199
https://kawalpemilu.org#68157,"WANI I, TANANTOVEA, DONGGALA, SULAWESI TENGAH",3,110,108,218
https://kawalpemilu.org#68157,"WANI I, TANANTOVEA, DONGGALA, SULAWESI TENGAH",4,149,74,223
https://kawalpemilu.org#68157,"WANI I, TANANTOVEA, DONGGALA, SULAWESI TENGAH",5,116,105,221
https://kawalpemilu.org#68158,"WANI II, TANANTOVEA, DONGGALA, SULAWESI TENGAH",1,62,130,192
https://kawalpemilu.org#68158,"WANI II, TANANTOVEA, DONGGALA, SULAWESI TENGAH",2,105,108,213
https://kawalpemilu.org#68158,"WANI II, TANANTOVEA, DONGGALA, SULAWESI TENGAH",3,96,131,227
https://kawalpemilu.org#68158,"WANI II, TANANTOVEA, DONGGALA, SULAWESI TENGAH",4,48,142,190
https://kawalpemilu.org#68158,"WANI II, TANANTOVEA, DONGGALA, SULAWESI TENGAH",5,76,136,212
https://kawalpemilu.org#68158,"WANI II, TANANTOVEA, DONGGALA, SULAWESI TENGAH",6,84,106,190
https://kawalpemilu.org#68158,"WANI II, TANANTOVEA, DONGGALA, SULAWESI TENGAH",7,120,80,200
https://kawalpemilu.org#68159,"NUPABOMBA, TANANTOVEA, DONGGALA, SULAWESI TENGAH",1,45,202,247
https://kawalpemilu.org#68159,"NUPABOMBA, TANANTOVEA, DONGGALA, SULAWESI TENGAH",2,46,147,193
https://kawalpemilu.org#68159,"NUPABOMBA, TANANTOVEA, DONGGALA, SULAWESI TENGAH",3,78,166,244
https://kawalpemilu.org#68159,"NUPABOMBA, TANANTOVEA, DONGGALA, SULAWESI TENGAH",4,94,34,128
https://kawalpemilu.org#68159,"NUPABOMBA, TANANTOVEA, DONGGALA, SULAWESI TENGAH",5,139,75,214
https://kawalpemilu.org#68159,"NUPABOMBA, TANANTOVEA, DONGGALA, SULAWESI TENGAH",6,108,38,146
https://kawalpemilu.org#68159,"NUPABOMBA, TANANTOVEA, DONGGALA, SULAWESI TENGAH",7,93,52,145
https://kawalpemilu.org#68159,"NUPABOMBA, TANANTOVEA, DONGGALA, SULAWESI TENGAH",8,167,70,237
https://kawalpemilu.org#68159,"NUPABOMBA, TANANTOVEA, DONGGALA, SULAWESI TENGAH",9,143,50,193
https://kawalpemilu.org#68159,"NUPABOMBA, TANANTOVEA, DONGGALA, SULAWESI TENGAH",10,109,25,134
https://kawalpemilu.org#68160,"WOMBO, TANANTOVEA, DONGGALA, SULAWESI TENGAH",1,110,111,221
https://kawalpemilu.org#68160,"WOMBO, TANANTOVEA, DONGGALA, SULAWESI TENGAH",2,78,101,179
https://kawalpemilu.org#68160,"WOMBO, TANANTOVEA, DONGGALA, SULAWESI TENGAH",3,88,87,175
https://kawalpemilu.org#68160,"WOMBO, TANANTOVEA, DONGGALA, SULAWESI TENGAH",4,88,115,203
https://kawalpemilu.org#68161,"GUNTARANO, TANANTOVEA, DONGGALA, SULAWESI TENGAH",1,192,30,222
https://kawalpemilu.org#68161,"GUNTARANO, TANANTOVEA, DONGGALA, SULAWESI TENGAH",2,125,82,207
https://kawalpemilu.org#68161,"GUNTARANO, TANANTOVEA, DONGGALA, SULAWESI TENGAH",3,110,93,203
https://kawalpemilu.org#68161,"GUNTARANO, TANANTOVEA, DONGGALA, SULAWESI TENGAH",4,93,114,207
https://kawalpemilu.org#68161,"GUNTARANO, TANANTOVEA, DONGGALA, SULAWESI TENGAH",5,136,111,247
https://kawalpemilu.org#68162,"BALE, TANANTOVEA, DONGGALA, SULAWESI TENGAH",1,135,122,257
https://kawalpemilu.org#68162,"BALE, TANANTOVEA, DONGGALA, SULAWESI TENGAH",2,103,45,148
https://kawalpemilu.org#68162,"BALE, TANANTOVEA, DONGGALA, SULAWESI TENGAH",3,94,105,199
https://kawalpemilu.org#68162,"BALE, TANANTOVEA, DONGGALA, SULAWESI TENGAH",5,119,69,188
https://kawalpemilu.org#68163,"WOMBO MPANAU, TANANTOVEA, DONGGALA, SULAWESI TENGAH",1,133,105,238
https://kawalpemilu.org#68163,"WOMBO MPANAU, TANANTOVEA, DONGGALA, SULAWESI TENGAH",2,119,153,272
https://kawalpemilu.org#68163,"WOMBO MPANAU, TANANTOVEA, DONGGALA, SULAWESI TENGAH",3,138,108,247
https://kawalpemilu.org#68164,"WOMBO KALONGGO, TANANTOVEA, DONGGALA, SULAWESI TENGAH",1,117,128,245
https://kawalpemilu.org#68164,"WOMBO KALONGGO, TANANTOVEA, DONGGALA, SULAWESI TENGAH",2,123,139,262
https://kawalpemilu.org#87579,"WANI TIGA, TANANTOVEA, DONGGALA, SULAWESI TENGAH",1,95,100,195
https://kawalpemilu.org#87580,"WANI LUMBUMPETIGO, TANANTOVEA, DONGGALA, SULAWESI TENGAH",1,153,62,215
https://kawalpemilu.org#87580,"WANI LUMBUMPETIGO, TANANTOVEA, DONGGALA, SULAWESI TENGAH",2,118,93,211
https://kawalpemilu.org#87580,"WANI LUMBUMPETIGO, TANANTOVEA, DONGGALA, SULAWESI TENGAH",3,136,63,199
https://kawalpemilu.org#68166,"PALINTUMA, PANEMBANI, DONGGALA, SULAWESI TENGAH",1,179,11,190
https://kawalpemilu.org#68166,"PALINTUMA, PANEMBANI, DONGGALA, SULAWESI TENGAH",2,135,8,143
https://kawalpemilu.org#68166,"PALINTUMA, PANEMBANI, DONGGALA, SULAWESI TENGAH",3,72,8,80
https://kawalpemilu.org#68166,"PALINTUMA, PANEMBANI, DONGGALA, SULAWESI TENGAH",4,110,12,122
https://kawalpemilu.org#68166,"PALINTUMA, PANEMBANI, DONGGALA, SULAWESI TENGAH",5,43,0,43
https://kawalpemilu.org#68166,"PALINTUMA, PANEMBANI, DONGGALA, SULAWESI TENGAH",6,76,4,80
https://kawalpemilu.org#68166,"PALINTUMA, PANEMBANI, DONGGALA, SULAWESI TENGAH",7,95,9,104
https://kawalpemilu.org#68167,"GIMPUBIA, PANEMBANI, DONGGALA, SULAWESI TENGAH",1,202,12,214
https://kawalpemilu.org#68167,"GIMPUBIA, PANEMBANI, DONGGALA, SULAWESI TENGAH",2,150,11,161
https://kawalpemilu.org#68168,"DANGARA'A, PANEMBANI, DONGGALA, SULAWESI TENGAH",1,134,9,143
https://kawalpemilu.org#68169,"BAMBAKANINI, PANEMBANI, DONGGALA, SULAWESI TENGAH",1,136,10,146
https://kawalpemilu.org#68169,"BAMBAKANINI, PANEMBANI, DONGGALA, SULAWESI TENGAH",2,124,5,129
https://kawalpemilu.org#68169,"BAMBAKANINI, PANEMBANI, DONGGALA, SULAWESI TENGAH",3,104,2,106
https://kawalpemilu.org#68170,"BAMBAKAENU, PANEMBANI, DONGGALA, SULAWESI TENGAH",1,139,12,151
https://kawalpemilu.org#68170,"BAMBAKAENU, PANEMBANI, DONGGALA, SULAWESI TENGAH",2,105,19,124
https://kawalpemilu.org#68171,"TOMODO, PANEMBANI, DONGGALA, SULAWESI TENGAH",1,141,9,150
https://kawalpemilu.org#68171,"TOMODO, PANEMBANI, DONGGALA, SULAWESI TENGAH",2,145,6,151
https://kawalpemilu.org#87581,"KANAGALONGGA, PANEMBANI, DONGGALA, SULAWESI TENGAH",1,191,7,198
https://kawalpemilu.org#87581,"KANAGALONGGA, PANEMBANI, DONGGALA, SULAWESI TENGAH",2,126,9,135
https://kawalpemilu.org#87582,"KARAVIA, PANEMBANI, DONGGALA, SULAWESI TENGAH",1,217,4,221
https://kawalpemilu.org#87582,"KARAVIA, PANEMBANI, DONGGALA, SULAWESI TENGAH",2,56,1,57
https://kawalpemilu.org#87583,"TAVANGGELI, PANEMBANI, DONGGALA, SULAWESI TENGAH",1,119,3,122
https://kawalpemilu.org#87583,"TAVANGGELI, PANEMBANI, DONGGALA, SULAWESI TENGAH",2,60,3,63
https://kawalpemilu.org#68173,"TIBO, SINDUE TOMBUSABORA, DONGGALA, SULAWESI TENGAH",1,89,131,220
https://kawalpemilu.org#68173,"TIBO, SINDUE TOMBUSABORA, DONGGALA, SULAWESI TENGAH",2,109,93,202
https://kawalpemilu.org#68173,"TIBO, SINDUE TOMBUSABORA, DONGGALA, SULAWESI TENGAH",3,75,116,191
https://kawalpemilu.org#68173,"TIBO, SINDUE TOMBUSABORA, DONGGALA, SULAWESI TENGAH",4,130,71,201
https://kawalpemilu.org#68173,"TIBO, SINDUE TOMBUSABORA, DONGGALA, SULAWESI TENGAH",5,108,102,210
https://kawalpemilu.org#68173,"TIBO, SINDUE TOMBUSABORA, DONGGALA, SULAWESI TENGAH",6,120,95,215
https://kawalpemilu.org#68173,"TIBO, SINDUE TOMBUSABORA, DONGGALA, SULAWESI TENGAH",7,155,48,203
https://kawalpemilu.org#68173,"TIBO, SINDUE TOMBUSABORA, DONGGALA, SULAWESI TENGAH",8,121,84,205
https://kawalpemilu.org#68173,"TIBO, SINDUE TOMBUSABORA, DONGGALA, SULAWESI TENGAH",9,142,8,150
https://kawalpemilu.org#68174,"KALIBURU, SINDUE TOMBUSABORA, DONGGALA, SULAWESI TENGAH",1,131,96,227
https://kawalpemilu.org#68174,"KALIBURU, SINDUE TOMBUSABORA, DONGGALA, SULAWESI TENGAH",2,135,99,234
https://kawalpemilu.org#68174,"KALIBURU, SINDUE TOMBUSABORA, DONGGALA, SULAWESI TENGAH",3,151,78,229
https://kawalpemilu.org#68174,"KALIBURU, SINDUE TOMBUSABORA, DONGGALA, SULAWESI TENGAH",4,81,79,160
https://kawalpemilu.org#68174,"KALIBURU, SINDUE TOMBUSABORA, DONGGALA, SULAWESI TENGAH",5,37,7,44
https://kawalpemilu.org#68175,"BATUSUYA, SINDUE TOMBUSABORA, DONGGALA, SULAWESI TENGAH",1,152,35,187
https://kawalpemilu.org#68175,"BATUSUYA, SINDUE TOMBUSABORA, DONGGALA, SULAWESI TENGAH",2,185,32,217
https://kawalpemilu.org#68175,"BATUSUYA, SINDUE TOMBUSABORA, DONGGALA, SULAWESI TENGAH",3,128,57,185
https://kawalpemilu.org#68175,"BATUSUYA, SINDUE TOMBUSABORA, DONGGALA, SULAWESI TENGAH",4,133,70,203
https://kawalpemilu.org#68175,"BATUSUYA, SINDUE TOMBUSABORA, DONGGALA, SULAWESI TENGAH",5,93,95,191
https://kawalpemilu.org#68175,"BATUSUYA, SINDUE TOMBUSABORA, DONGGALA, SULAWESI TENGAH",6,112,42,154
https://kawalpemilu.org#68175,"BATUSUYA, SINDUE TOMBUSABORA, DONGGALA, SULAWESI TENGAH",7,100,13,113
https://kawalpemilu.org#68176,"SALOYA, SINDUE TOMBUSABORA, DONGGALA, SULAWESI TENGAH",1,181,43,224
https://kawalpemilu.org#68176,"SALOYA, SINDUE TOMBUSABORA, DONGGALA, SULAWESI TENGAH",2,138,99,237
https://kawalpemilu.org#68176,"SALOYA, SINDUE TOMBUSABORA, DONGGALA, SULAWESI TENGAH",3,149,85,234
https://kawalpemilu.org#68176,"SALOYA, SINDUE TOMBUSABORA, DONGGALA, SULAWESI TENGAH",4,161,72,233
https://kawalpemilu.org#68176,"SALOYA, SINDUE TOMBUSABORA, DONGGALA, SULAWESI TENGAH",5,149,76,225
https://kawalpemilu.org#68177,"BATUSUYA GO'O, SINDUE TOMBUSABORA, DONGGALA, SULAWESI TENGAH",1,79,95,174
https://kawalpemilu.org#68177,"BATUSUYA GO'O, SINDUE TOMBUSABORA, DONGGALA, SULAWESI TENGAH",2,104,95,199
https://kawalpemilu.org#68177,"BATUSUYA GO'O, SINDUE TOMBUSABORA, DONGGALA, SULAWESI TENGAH",3,99,47,146
https://kawalpemilu.org#68177,"BATUSUYA GO'O, SINDUE TOMBUSABORA, DONGGALA, SULAWESI TENGAH",4,104,49,153
https://kawalpemilu.org#68177,"BATUSUYA GO'O, SINDUE TOMBUSABORA, DONGGALA, SULAWESI TENGAH",5,137,24,161
https://kawalpemilu.org#68177,"BATUSUYA GO'O, SINDUE TOMBUSABORA, DONGGALA, SULAWESI TENGAH",6,88,8,96
https://kawalpemilu.org#87584,"KALIBURU KATA, SINDUE TOMBUSABORA, DONGGALA, SULAWESI TENGAH",1,122,68,190
https://kawalpemilu.org#87584,"KALIBURU KATA, SINDUE TOMBUSABORA, DONGGALA, SULAWESI TENGAH",2,127,66,193
https://kawalpemilu.org#87584,"KALIBURU KATA, SINDUE TOMBUSABORA, DONGGALA, SULAWESI TENGAH",3,57,31,88
https://kawalpemilu.org#68179,"SIKARA TOBATA, SINDUE TOBATA, DONGGALA, SULAWESI TENGAH",1,126,41,167
https://kawalpemilu.org#68179,"SIKARA TOBATA, SINDUE TOBATA, DONGGALA, SULAWESI TENGAH",2,105,51,156
https://kawalpemilu.org#68179,"SIKARA TOBATA, SINDUE TOBATA, DONGGALA, SULAWESI TENGAH",3,143,45,188
https://kawalpemilu.org#68179,"SIKARA TOBATA, SINDUE TOBATA, DONGGALA, SULAWESI TENGAH",4,115,68,183
https://kawalpemilu.org#68179,"SIKARA TOBATA, SINDUE TOBATA, DONGGALA, SULAWESI TENGAH",5,111,23,134
https://kawalpemilu.org#68179,"SIKARA TOBATA, SINDUE TOBATA, DONGGALA, SULAWESI TENGAH",6,119,21,140
https://kawalpemilu.org#68180,"ALINDAU, SINDUE TOBATA, DONGGALA, SULAWESI TENGAH",1,107,50,157
https://kawalpemilu.org#68180,"ALINDAU, SINDUE TOBATA, DONGGALA, SULAWESI TENGAH",2,93,65,158
https://kawalpemilu.org#68180,"ALINDAU, SINDUE TOBATA, DONGGALA, SULAWESI TENGAH",3,68,61,129
https://kawalpemilu.org#68180,"ALINDAU, SINDUE TOBATA, DONGGALA, SULAWESI TENGAH",4,73,47,120
https://kawalpemilu.org#68180,"ALINDAU, SINDUE TOBATA, DONGGALA, SULAWESI TENGAH",5,105,48,153
https://kawalpemilu.org#68180,"ALINDAU, SINDUE TOBATA, DONGGALA, SULAWESI TENGAH",6,115,40,155
https://kawalpemilu.org#68180,"ALINDAU, SINDUE TOBATA, DONGGALA, SULAWESI TENGAH",7,157,60,217
https://kawalpemilu.org#68180,"ALINDAU, SINDUE TOBATA, DONGGALA, SULAWESI TENGAH",8,129,60,189
https://kawalpemilu.org#68180,"ALINDAU, SINDUE TOBATA, DONGGALA, SULAWESI TENGAH",9,118,37,155
https://kawalpemilu.org#68181,"OTI, SINDUE TOBATA, DONGGALA, SULAWESI TENGAH",1,142,42,184
https://kawalpemilu.org#68181,"OTI, SINDUE TOBATA, DONGGALA, SULAWESI TENGAH",2,144,37,181
https://kawalpemilu.org#68181,"OTI, SINDUE TOBATA, DONGGALA, SULAWESI TENGAH",3,76,66,142
https://kawalpemilu.org#68181,"OTI, SINDUE TOBATA, DONGGALA, SULAWESI TENGAH",4,114,63,177
https://kawalpemilu.org#68181,"OTI, SINDUE TOBATA, DONGGALA, SULAWESI TENGAH",5,104,48,152
https://kawalpemilu.org#68181,"OTI, SINDUE TOBATA, DONGGALA, SULAWESI TENGAH",6,110,103,213
https://kawalpemilu.org#68181,"OTI, SINDUE TOBATA, DONGGALA, SULAWESI TENGAH",7,118,61,179
https://kawalpemilu.org#68181,"OTI, SINDUE TOBATA, DONGGALA, SULAWESI TENGAH",8,135,34,169
https://kawalpemilu.org#68182,"TAMARENJA, SINDUE TOBATA, DONGGALA, SULAWESI TENGAH",1,117,86,203
https://kawalpemilu.org#68182,"TAMARENJA, SINDUE TOBATA, DONGGALA, SULAWESI TENGAH",2,70,90,160
https://kawalpemilu.org#68182,"TAMARENJA, SINDUE TOBATA, DONGGALA, SULAWESI TENGAH",3,78,127,205
https://kawalpemilu.org#68182,"TAMARENJA, SINDUE TOBATA, DONGGALA, SULAWESI TENGAH",4,74,88,162
https://kawalpemilu.org#68183,"SIPESO, SINDUE TOBATA, DONGGALA, SULAWESI TENGAH",1,128,25,153
https://kawalpemilu.org#68183,"SIPESO, SINDUE TOBATA, DONGGALA, SULAWESI TENGAH",2,152,20,172
https://kawalpemilu.org#87585,"SINDOSA, SINDUE TOBATA, DONGGALA, SULAWESI TENGAH",1,43,95,138
https://kawalpemilu.org#87585,"SINDOSA, SINDUE TOBATA, DONGGALA, SULAWESI TENGAH",2,66,60,126
https://kawalpemilu.org#87585,"SINDOSA, SINDUE TOBATA, DONGGALA, SULAWESI TENGAH",3,85,44,129
https://kawalpemilu.org#68185,"POWELUA, BANAWA TENGAH, DONGGALA, SULAWESI TENGAH",1,114,36,150
https://kawalpemilu.org#68185,"POWELUA, BANAWA TENGAH, DONGGALA, SULAWESI TENGAH",2,117,41,158
https://kawalpemilu.org#68185,"POWELUA, BANAWA TENGAH, DONGGALA, SULAWESI TENGAH",3,114,48,162
https://kawalpemilu.org#68185,"POWELUA, BANAWA TENGAH, DONGGALA, SULAWESI TENGAH",4,60,84,144
https://kawalpemilu.org#68185,"POWELUA, BANAWA TENGAH, DONGGALA, SULAWESI TENGAH",5,63,75,138
https://kawalpemilu.org#68185,"POWELUA, BANAWA TENGAH, DONGGALA, SULAWESI TENGAH",6,59,118,177
https://kawalpemilu.org#68186,"LUMBUDOLO, BANAWA TENGAH, DONGGALA, SULAWESI TENGAH",1,45,193,238
https://kawalpemilu.org#68186,"LUMBUDOLO, BANAWA TENGAH, DONGGALA, SULAWESI TENGAH",2,30,161,191
https://kawalpemilu.org#68186,"LUMBUDOLO, BANAWA TENGAH, DONGGALA, SULAWESI TENGAH",3,36,158,194
https://kawalpemilu.org#68187,"KOLA-KOLA, BANAWA TENGAH, DONGGALA, SULAWESI TENGAH",1,32,63,95
https://kawalpemilu.org#68187,"KOLA-KOLA, BANAWA TENGAH, DONGGALA, SULAWESI TENGAH",2,93,110,203
https://kawalpemilu.org#68187,"KOLA-KOLA, BANAWA TENGAH, DONGGALA, SULAWESI TENGAH",3,90,114,204
https://kawalpemilu.org#68187,"KOLA-KOLA, BANAWA TENGAH, DONGGALA, SULAWESI TENGAH",4,68,133,201
https://kawalpemilu.org#68187,"KOLA-KOLA, BANAWA TENGAH, DONGGALA, SULAWESI TENGAH",5,102,97,199
https://kawalpemilu.org#68188,"LIMBORO, BANAWA TENGAH, DONGGALA, SULAWESI TENGAH",1,91,79,170
https://kawalpemilu.org#68188,"LIMBORO, BANAWA TENGAH, DONGGALA, SULAWESI TENGAH",2,90,79,169
https://kawalpemilu.org#68188,"LIMBORO, BANAWA TENGAH, DONGGALA, SULAWESI TENGAH",3,152,121,273
https://kawalpemilu.org#68188,"LIMBORO, BANAWA TENGAH, DONGGALA, SULAWESI TENGAH",4,70,107,177
https://kawalpemilu.org#68188,"LIMBORO, BANAWA TENGAH, DONGGALA, SULAWESI TENGAH",5,91,106,197
https://kawalpemilu.org#68188,"LIMBORO, BANAWA TENGAH, DONGGALA, SULAWESI TENGAH",6,199,33,232
https://kawalpemilu.org#68189,"TOWALE, BANAWA TENGAH, DONGGALA, SULAWESI TENGAH",1,96,113,209
https://kawalpemilu.org#68189,"TOWALE, BANAWA TENGAH, DONGGALA, SULAWESI TENGAH",2,108,94,202
https://kawalpemilu.org#68189,"TOWALE, BANAWA TENGAH, DONGGALA, SULAWESI TENGAH",3,83,103,186
https://kawalpemilu.org#68189,"TOWALE, BANAWA TENGAH, DONGGALA, SULAWESI TENGAH",4,83,99,182
https://kawalpemilu.org#68189,"TOWALE, BANAWA TENGAH, DONGGALA, SULAWESI TENGAH",5,144,75,219
https://kawalpemilu.org#68189,"TOWALE, BANAWA TENGAH, DONGGALA, SULAWESI TENGAH",6,135,91,226
https://kawalpemilu.org#68190,"SALUBOMBA, BANAWA TENGAH, DONGGALA, SULAWESI TENGAH",1,64,184,248
https://kawalpemilu.org#68190,"SALUBOMBA, BANAWA TENGAH, DONGGALA, SULAWESI TENGAH",2,51,194,245
https://kawalpemilu.org#68190,"SALUBOMBA, BANAWA TENGAH, DONGGALA, SULAWESI TENGAH",3,68,179,247
https://kawalpemilu.org#68190,"SALUBOMBA, BANAWA TENGAH, DONGGALA, SULAWESI TENGAH",4,79,97,176
https://kawalpemilu.org#68191,"MEKAR BARU, BANAWA TENGAH, DONGGALA, SULAWESI TENGAH",1,94,81,175
https://kawalpemilu.org#68191,"MEKAR BARU, BANAWA TENGAH, DONGGALA, SULAWESI TENGAH",2,46,107,153
https://kawalpemilu.org#68191,"MEKAR BARU, BANAWA TENGAH, DONGGALA, SULAWESI TENGAH",3,96,85,181
https://kawalpemilu.org#87586,"LAMPO, BANAWA TENGAH, DONGGALA, SULAWESI TENGAH",1,146,89,235
https://kawalpemilu.org#87586,"LAMPO, BANAWA TENGAH, DONGGALA, SULAWESI TENGAH",2,149,64,213
https://kawalpemilu.org#68193,"OGOAMAS I, SOJOL UTARA, DONGGALA, SULAWESI TENGAH",1,130,47,177
https://kawalpemilu.org#68193,"OGOAMAS I, SOJOL UTARA, DONGGALA, SULAWESI TENGAH",2,113,48,0
https://kawalpemilu.org#68193,"OGOAMAS I, SOJOL UTARA, DONGGALA, SULAWESI TENGAH",3,116,47,163
https://kawalpemilu.org#68193,"OGOAMAS I, SOJOL UTARA, DONGGALA, SULAWESI TENGAH",4,140,34,174
https://kawalpemilu.org#68193,"OGOAMAS I, SOJOL UTARA, DONGGALA, SULAWESI TENGAH",5,131,34,165
https://kawalpemilu.org#68193,"OGOAMAS I, SOJOL UTARA, DONGGALA, SULAWESI TENGAH",6,114,53,167
https://kawalpemilu.org#68193,"OGOAMAS I, SOJOL UTARA, DONGGALA, SULAWESI TENGAH",7,129,42,171
https://kawalpemilu.org#68193,"OGOAMAS I, SOJOL UTARA, DONGGALA, SULAWESI TENGAH",8,121,44,165
https://kawalpemilu.org#68193,"OGOAMAS I, SOJOL UTARA, DONGGALA, SULAWESI TENGAH",9,0,0,0
https://kawalpemilu.org#68193,"OGOAMAS I, SOJOL UTARA, DONGGALA, SULAWESI TENGAH",10,108,69,177
https://kawalpemilu.org#68193,"OGOAMAS I, SOJOL UTARA, DONGGALA, SULAWESI TENGAH",11,117,45,162
https://kawalpemilu.org#68193,"OGOAMAS I, SOJOL UTARA, DONGGALA, SULAWESI TENGAH",12,121,60,181
https://kawalpemilu.org#68194,"OGOAMAS II, SOJOL UTARA, DONGGALA, SULAWESI TENGAH",1,112,45,167
https://kawalpemilu.org#68194,"OGOAMAS II, SOJOL UTARA, DONGGALA, SULAWESI TENGAH",2,122,41,163
https://kawalpemilu.org#68194,"OGOAMAS II, SOJOL UTARA, DONGGALA, SULAWESI TENGAH",3,105,47,152
https://kawalpemilu.org#68194,"OGOAMAS II, SOJOL UTARA, DONGGALA, SULAWESI TENGAH",4,111,49,160
https://kawalpemilu.org#68194,"OGOAMAS II, SOJOL UTARA, DONGGALA, SULAWESI TENGAH",5,111,51,162
https://kawalpemilu.org#68194,"OGOAMAS II, SOJOL UTARA, DONGGALA, SULAWESI TENGAH",6,103,42,145
https://kawalpemilu.org#68194,"OGOAMAS II, SOJOL UTARA, DONGGALA, SULAWESI TENGAH",7,99,31,130
https://kawalpemilu.org#68194,"OGOAMAS II, SOJOL UTARA, DONGGALA, SULAWESI TENGAH",8,97,45,139
https://kawalpemilu.org#68194,"OGOAMAS II, SOJOL UTARA, DONGGALA, SULAWESI TENGAH",9,135,59,194
https://kawalpemilu.org#68194,"OGOAMAS II, SOJOL UTARA, DONGGALA, SULAWESI TENGAH",10,134,41,175
https://kawalpemilu.org#68195,"LENJU, SOJOL UTARA, DONGGALA, SULAWESI TENGAH",1,106,66,172
https://kawalpemilu.org#68195,"LENJU, SOJOL UTARA, DONGGALA, SULAWESI TENGAH",2,114,62,176
https://kawalpemilu.org#68195,"LENJU, SOJOL UTARA, DONGGALA, SULAWESI TENGAH",3,119,55,174
https://kawalpemilu.org#68195,"LENJU, SOJOL UTARA, DONGGALA, SULAWESI TENGAH",4,105,33,138
https://kawalpemilu.org#68196,"PESIK, SOJOL UTARA, DONGGALA, SULAWESI TENGAH",1,120,30,150
https://kawalpemilu.org#68196,"PESIK, SOJOL UTARA, DONGGALA, SULAWESI TENGAH",2,102,28,130
https://kawalpemilu.org#68196,"PESIK, SOJOL UTARA, DONGGALA, SULAWESI TENGAH",3,142,12,154
https://kawalpemilu.org#87587,"BENGKOLI, SOJOL UTARA, DONGGALA, SULAWESI TENGAH",1,68,60,128
https://kawalpemilu.org#87587,"BENGKOLI, SOJOL UTARA, DONGGALA, SULAWESI TENGAH",2,106,27,133
https://kawalpemilu.org#87587,"BENGKOLI, SOJOL UTARA, DONGGALA, SULAWESI TENGAH",3,89,27,116
https://kawalpemilu.org#87587,"BENGKOLI, SOJOL UTARA, DONGGALA, SULAWESI TENGAH",4,138,21,159
https://kawalpemilu.org#68198,"KETONG, BALAESANG TANJUNG, DONGGALA, SULAWESI TENGAH",1,136,67,203
https://kawalpemilu.org#68198,"KETONG, BALAESANG TANJUNG, DONGGALA, SULAWESI TENGAH",2,89,103,192
https://kawalpemilu.org#68198,"KETONG, BALAESANG TANJUNG, DONGGALA, SULAWESI TENGAH",3,153,31,184
https://kawalpemilu.org#68198,"KETONG, BALAESANG TANJUNG, DONGGALA, SULAWESI TENGAH",4,128,85,213
https://kawalpemilu.org#68198,"KETONG, BALAESANG TANJUNG, DONGGALA, SULAWESI TENGAH",5,122,34,156
https://kawalpemilu.org#68198,"KETONG, BALAESANG TANJUNG, DONGGALA, SULAWESI TENGAH",6,119,55,174
https://kawalpemilu.org#68199,"RANO, BALAESANG TANJUNG, DONGGALA, SULAWESI TENGAH",1,213,35,248
https://kawalpemilu.org#68199,"RANO, BALAESANG TANJUNG, DONGGALA, SULAWESI TENGAH",2,237,31,268
https://kawalpemilu.org#68199,"RANO, BALAESANG TANJUNG, DONGGALA, SULAWESI TENGAH",3,235,28,263
https://kawalpemilu.org#68199,"RANO, BALAESANG TANJUNG, DONGGALA, SULAWESI TENGAH",4,98,20,118
https://kawalpemilu.org#68200,"KAMONJI, BALAESANG TANJUNG, DONGGALA, SULAWESI TENGAH",1,140,82,222
https://kawalpemilu.org#68200,"KAMONJI, BALAESANG TANJUNG, DONGGALA, SULAWESI TENGAH",2,178,49,227
https://kawalpemilu.org#68200,"KAMONJI, BALAESANG TANJUNG, DONGGALA, SULAWESI TENGAH",3,188,42,230
https://kawalpemilu.org#68201,"MALEI, BALAESANG TANJUNG, DONGGALA, SULAWESI TENGAH",1,148,58,206
https://kawalpemilu.org#68201,"MALEI, BALAESANG TANJUNG, DONGGALA, SULAWESI TENGAH",2,93,123,217
https://kawalpemilu.org#68201,"MALEI, BALAESANG TANJUNG, DONGGALA, SULAWESI TENGAH",3,128,95,223
https://kawalpemilu.org#68201,"MALEI, BALAESANG TANJUNG, DONGGALA, SULAWESI TENGAH",4,116,108,224
https://kawalpemilu.org#68201,"MALEI, BALAESANG TANJUNG, DONGGALA, SULAWESI TENGAH",5,106,105,211
https://kawalpemilu.org#68202,"WALANDANO, BALAESANG TANJUNG, DONGGALA, SULAWESI TENGAH",1,205,43,248
https://kawalpemilu.org#68202,"WALANDANO, BALAESANG TANJUNG, DONGGALA, SULAWESI TENGAH",2,193,12,205
https://kawalpemilu.org#68202,"WALANDANO, BALAESANG TANJUNG, DONGGALA, SULAWESI TENGAH",3,195,36,231
https://kawalpemilu.org#68204,"PALAU, BALAESANG TANJUNG, DONGGALA, SULAWESI TENGAH",1,160,63,223
https://kawalpemilu.org#68204,"PALAU, BALAESANG TANJUNG, DONGGALA, SULAWESI TENGAH",2,154,20,174
https://kawalpemilu.org#68204,"PALAU, BALAESANG TANJUNG, DONGGALA, SULAWESI TENGAH",3,97,30,127
https://kawalpemilu.org#87588,"POMOLULU, BALAESANG TANJUNG, DONGGALA, SULAWESI TENGAH",1,78,84,162
https://kawalpemilu.org#87588,"POMOLULU, BALAESANG TANJUNG, DONGGALA, SULAWESI TENGAH",2,86,89,175
https://kawalpemilu.org#87588,"POMOLULU, BALAESANG TANJUNG, DONGGALA, SULAWESI TENGAH",3,148,13,160
https://kawalpemilu.org#87588,"POMOLULU, BALAESANG TANJUNG, DONGGALA, SULAWESI TENGAH",4,130,65,195
https://kawalpemilu.org#87588,"POMOLULU, BALAESANG TANJUNG, DONGGALA, SULAWESI TENGAH",5,103,89,192
https://kawalpemilu.org#93023,"MANIMBAYA, BALAESANG TANJUNG, DONGGALA, SULAWESI TENGAH",1,128,35,163
https://kawalpemilu.org#93023,"MANIMBAYA, BALAESANG TANJUNG, DONGGALA, SULAWESI TENGAH",2,159,42,201
https://kawalpemilu.org#93023,"MANIMBAYA, BALAESANG TANJUNG, DONGGALA, SULAWESI TENGAH",3,219,28,247
https://kawalpemilu.org#68208,"KOMBO, DAMPAL SELATAN, TOLITOLI, SULAWESI TENGAH",1,154,67,221
https://kawalpemilu.org#68208,"KOMBO, DAMPAL SELATAN, TOLITOLI, SULAWESI TENGAH",2,110,90,200
https://kawalpemilu.org#68208,"KOMBO, DAMPAL SELATAN, TOLITOLI, SULAWESI TENGAH",3,135,78,213
https://kawalpemilu.org#68208,"KOMBO, DAMPAL SELATAN, TOLITOLI, SULAWESI TENGAH",4,85,144,229
https://kawalpemilu.org#68208,"KOMBO, DAMPAL SELATAN, TOLITOLI, SULAWESI TENGAH",5,125,124,249
https://kawalpemilu.org#68208,"KOMBO, DAMPAL SELATAN, TOLITOLI, SULAWESI TENGAH",6,103,143,246
https://kawalpemilu.org#68209,"TAMPIALA, DAMPAL SELATAN, TOLITOLI, SULAWESI TENGAH",1,125,100,225
https://kawalpemilu.org#68209,"TAMPIALA, DAMPAL SELATAN, TOLITOLI, SULAWESI TENGAH",2,138,111,249
https://kawalpemilu.org#68209,"TAMPIALA, DAMPAL SELATAN, TOLITOLI, SULAWESI TENGAH",3,134,90,224
https://kawalpemilu.org#68209,"TAMPIALA, DAMPAL SELATAN, TOLITOLI, SULAWESI TENGAH",4,115,66,181
https://kawalpemilu.org#68209,"TAMPIALA, DAMPAL SELATAN, TOLITOLI, SULAWESI TENGAH",5,94,81,175
https://kawalpemilu.org#68210,"SONI, DAMPAL SELATAN, TOLITOLI, SULAWESI TENGAH",1,115,79,194
https://kawalpemilu.org#68210,"SONI, DAMPAL SELATAN, TOLITOLI, SULAWESI TENGAH",2,72,108,180
https://kawalpemilu.org#68210,"SONI, DAMPAL SELATAN, TOLITOLI, SULAWESI TENGAH",3,123,69,192
https://kawalpemilu.org#68210,"SONI, DAMPAL SELATAN, TOLITOLI, SULAWESI TENGAH",4,101,89,190
https://kawalpemilu.org#68210,"SONI, DAMPAL SELATAN, TOLITOLI, SULAWESI TENGAH",5,138,108,246
https://kawalpemilu.org#68210,"SONI, DAMPAL SELATAN, TOLITOLI, SULAWESI TENGAH",6,111,141,252
https://kawalpemilu.org#68210,"SONI, DAMPAL SELATAN, TOLITOLI, SULAWESI TENGAH",7,126,123,249
https://kawalpemilu.org#68210,"SONI, DAMPAL SELATAN, TOLITOLI, SULAWESI TENGAH",8,152,85,237
https://kawalpemilu.org#68210,"SONI, DAMPAL SELATAN, TOLITOLI, SULAWESI TENGAH",9,121,137,258
https://kawalpemilu.org#68211,"BANGKIR, DAMPAL SELATAN, TOLITOLI, SULAWESI TENGAH",1,151,81,233
https://kawalpemilu.org#68211,"BANGKIR, DAMPAL SELATAN, TOLITOLI, SULAWESI TENGAH",2,100,68,168
https://kawalpemilu.org#68211,"BANGKIR, DAMPAL SELATAN, TOLITOLI, SULAWESI TENGAH",3,78,79,157
https://kawalpemilu.org#68211,"BANGKIR, DAMPAL SELATAN, TOLITOLI, SULAWESI TENGAH",4,121,93,214
https://kawalpemilu.org#68211,"BANGKIR, DAMPAL SELATAN, TOLITOLI, SULAWESI TENGAH",5,143,64,207
https://kawalpemilu.org#68211,"BANGKIR, DAMPAL SELATAN, TOLITOLI, SULAWESI TENGAH",6,108,80,188
https://kawalpemilu.org#68211,"BANGKIR, DAMPAL SELATAN, TOLITOLI, SULAWESI TENGAH",7,143,101,244
https://kawalpemilu.org#68211,"BANGKIR, DAMPAL SELATAN, TOLITOLI, SULAWESI TENGAH",9,118,67,185
https://kawalpemilu.org#68211,"BANGKIR, DAMPAL SELATAN, TOLITOLI, SULAWESI TENGAH",10,52,48,100
https://kawalpemilu.org#68212,"DONGKO, DAMPAL SELATAN, TOLITOLI, SULAWESI TENGAH",1,153,77,230
https://kawalpemilu.org#68212,"DONGKO, DAMPAL SELATAN, TOLITOLI, SULAWESI TENGAH",2,155,71,226
https://kawalpemilu.org#68212,"DONGKO, DAMPAL SELATAN, TOLITOLI, SULAWESI TENGAH",3,80,50,130
https://kawalpemilu.org#68212,"DONGKO, DAMPAL SELATAN, TOLITOLI, SULAWESI TENGAH",4,148,73,221
https://kawalpemilu.org#68212,"DONGKO, DAMPAL SELATAN, TOLITOLI, SULAWESI TENGAH",5,114,37,151
https://kawalpemilu.org#68213,"MIMBALA, DAMPAL SELATAN, TOLITOLI, SULAWESI TENGAH",1,106,110,216
https://kawalpemilu.org#68213,"MIMBALA, DAMPAL SELATAN, TOLITOLI, SULAWESI TENGAH",2,96,105,201
https://kawalpemilu.org#68213,"MIMBALA, DAMPAL SELATAN, TOLITOLI, SULAWESI TENGAH",3,117,97,214
https://kawalpemilu.org#68214,"LEMPE, DAMPAL SELATAN, TOLITOLI, SULAWESI TENGAH",1,70,90,160
https://kawalpemilu.org#68214,"LEMPE, DAMPAL SELATAN, TOLITOLI, SULAWESI TENGAH",2,127,57,184
https://kawalpemilu.org#68214,"LEMPE, DAMPAL SELATAN, TOLITOLI, SULAWESI TENGAH",3,125,31,156
https://kawalpemilu.org#68214,"LEMPE, DAMPAL SELATAN, TOLITOLI, SULAWESI TENGAH",4,79,80,159
https://kawalpemilu.org#68214,"LEMPE, DAMPAL SELATAN, TOLITOLI, SULAWESI TENGAH",5,181,39,220
https://kawalpemilu.org#68214,"LEMPE, DAMPAL SELATAN, TOLITOLI, SULAWESI TENGAH",6,113,93,206
https://kawalpemilu.org#68214,"LEMPE, DAMPAL SELATAN, TOLITOLI, SULAWESI TENGAH",7,78,58,136
https://kawalpemilu.org#68215,"PADDUMPU, DAMPAL SELATAN, TOLITOLI, SULAWESI TENGAH",1,78,56,134
https://kawalpemilu.org#68215,"PADDUMPU, DAMPAL SELATAN, TOLITOLI, SULAWESI TENGAH",2,88,118,206
https://kawalpemilu.org#68215,"PADDUMPU, DAMPAL SELATAN, TOLITOLI, SULAWESI TENGAH",3,137,97,234
https://kawalpemilu.org#68215,"PADDUMPU, DAMPAL SELATAN, TOLITOLI, SULAWESI TENGAH",4,90,114,204
https://kawalpemilu.org#68215,"PADDUMPU, DAMPAL SELATAN, TOLITOLI, SULAWESI TENGAH",5,112,66,178
https://kawalpemilu.org#68215,"PADDUMPU, DAMPAL SELATAN, TOLITOLI, SULAWESI TENGAH",6,85,95,180
https://kawalpemilu.org#68216,"ABBAJARENG, DAMPAL SELATAN, TOLITOLI, SULAWESI TENGAH",1,125,77,202
https://kawalpemilu.org#68216,"ABBAJARENG, DAMPAL SELATAN, TOLITOLI, SULAWESI TENGAH",2,142,63,205
https://kawalpemilu.org#68216,"ABBAJARENG, DAMPAL SELATAN, TOLITOLI, SULAWESI TENGAH",3,91,41,132
https://kawalpemilu.org#928612,"PUSE, DAMPAL SELATAN, TOLITOLI, SULAWESI TENGAH",1,94,78,172
https://kawalpemilu.org#928612,"PUSE, DAMPAL SELATAN, TOLITOLI, SULAWESI TENGAH",2,118,83,201
https://kawalpemilu.org#928612,"PUSE, DAMPAL SELATAN, TOLITOLI, SULAWESI TENGAH",3,92,93,185
https://kawalpemilu.org#928612,"PUSE, DAMPAL SELATAN, TOLITOLI, SULAWESI TENGAH",4,88,62,150
https://kawalpemilu.org#928613,"PALLAKAWE, DAMPAL SELATAN, TOLITOLI, SULAWESI TENGAH",1,73,93,166
https://kawalpemilu.org#928613,"PALLAKAWE, DAMPAL SELATAN, TOLITOLI, SULAWESI TENGAH",2,122,101,223
https://kawalpemilu.org#928613,"PALLAKAWE, DAMPAL SELATAN, TOLITOLI, SULAWESI TENGAH",3,32,81,113
https://kawalpemilu.org#928614,"SIMUNTU, DAMPAL SELATAN, TOLITOLI, SULAWESI TENGAH",1,52,44,96
https://kawalpemilu.org#928614,"SIMUNTU, DAMPAL SELATAN, TOLITOLI, SULAWESI TENGAH",2,55,91,146
https://kawalpemilu.org#931037,"LEMBA HARAPAN, DAMPAL SELATAN, TOLITOLI, SULAWESI TENGAH",1,119,45,164
https://kawalpemilu.org#931037,"LEMBA HARAPAN, DAMPAL SELATAN, TOLITOLI, SULAWESI TENGAH",2,119,71,190
https://kawalpemilu.org#68218,"BANAGAN, DAMPAL UTARA, TOLITOLI, SULAWESI TENGAH",1,64,89,153
https://kawalpemilu.org#68218,"BANAGAN, DAMPAL UTARA, TOLITOLI, SULAWESI TENGAH",2,108,52,160
https://kawalpemilu.org#68218,"BANAGAN, DAMPAL UTARA, TOLITOLI, SULAWESI TENGAH",3,104,110,214
https://kawalpemilu.org#68218,"BANAGAN, DAMPAL UTARA, TOLITOLI, SULAWESI TENGAH",4,81,17,98
https://kawalpemilu.org#68219,"KABINUANG, DAMPAL UTARA, TOLITOLI, SULAWESI TENGAH",1,105,68,173
https://kawalpemilu.org#68219,"KABINUANG, DAMPAL UTARA, TOLITOLI, SULAWESI TENGAH",2,99,46,145
https://kawalpemilu.org#68219,"KABINUANG, DAMPAL UTARA, TOLITOLI, SULAWESI TENGAH",3,108,67,175
https://kawalpemilu.org#68219,"KABINUANG, DAMPAL UTARA, TOLITOLI, SULAWESI TENGAH",4,81,71,152
https://kawalpemilu.org#68220,"OGOTUA, DAMPAL UTARA, TOLITOLI, SULAWESI TENGAH",1,54,84,138
https://kawalpemilu.org#68220,"OGOTUA, DAMPAL UTARA, TOLITOLI, SULAWESI TENGAH",2,85,67,152
https://kawalpemilu.org#68220,"OGOTUA, DAMPAL UTARA, TOLITOLI, SULAWESI TENGAH",3,73,44,117
https://kawalpemilu.org#68220,"OGOTUA, DAMPAL UTARA, TOLITOLI, SULAWESI TENGAH",4,76,76,152
https://kawalpemilu.org#68220,"OGOTUA, DAMPAL UTARA, TOLITOLI, SULAWESI TENGAH",5,62,95,157
https://kawalpemilu.org#68220,"OGOTUA, DAMPAL UTARA, TOLITOLI, SULAWESI TENGAH",6,63,103,166
https://kawalpemilu.org#68220,"OGOTUA, DAMPAL UTARA, TOLITOLI, SULAWESI TENGAH",7,98,101,199
https://kawalpemilu.org#68220,"OGOTUA, DAMPAL UTARA, TOLITOLI, SULAWESI TENGAH",8,105,85,190
https://kawalpemilu.org#68220,"OGOTUA, DAMPAL UTARA, TOLITOLI, SULAWESI TENGAH",9,123,97,220
https://kawalpemilu.org#68220,"OGOTUA, DAMPAL UTARA, TOLITOLI, SULAWESI TENGAH",10,88,123,211
https://kawalpemilu.org#68220,"OGOTUA, DAMPAL UTARA, TOLITOLI, SULAWESI TENGAH",11,98,93,191
https://kawalpemilu.org#68220,"OGOTUA, DAMPAL UTARA, TOLITOLI, SULAWESI TENGAH",12,112,28,140
https://kawalpemilu.org#68221,"TOMPOH, DAMPAL UTARA, TOLITOLI, SULAWESI TENGAH",1,106,68,174
https://kawalpemilu.org#68221,"TOMPOH, DAMPAL UTARA, TOLITOLI, SULAWESI TENGAH",2,149,62,211
https://kawalpemilu.org#68221,"TOMPOH, DAMPAL UTARA, TOLITOLI, SULAWESI TENGAH",3,79,129,208
https://kawalpemilu.org#68222,"BAMBAPULA, DAMPAL UTARA, TOLITOLI, SULAWESI TENGAH",1,120,79,199
https://kawalpemilu.org#68222,"BAMBAPULA, DAMPAL UTARA, TOLITOLI, SULAWESI TENGAH",2,112,95,207
https://kawalpemilu.org#68222,"BAMBAPULA, DAMPAL UTARA, TOLITOLI, SULAWESI TENGAH",3,65,94,159
https://kawalpemilu.org#68222,"BAMBAPULA, DAMPAL UTARA, TOLITOLI, SULAWESI TENGAH",4,36,61,97
https://kawalpemilu.org#68222,"BAMBAPULA, DAMPAL UTARA, TOLITOLI, SULAWESI TENGAH",5,76,36,112
https://kawalpemilu.org#68222,"BAMBAPULA, DAMPAL UTARA, TOLITOLI, SULAWESI TENGAH",6,105,65,170
https://kawalpemilu.org#68222,"BAMBAPULA, DAMPAL UTARA, TOLITOLI, SULAWESI TENGAH",7,45,66,111
https://kawalpemilu.org#68223,"MALAMBIGU, DAMPAL UTARA, TOLITOLI, SULAWESI TENGAH",1,56,83,139
https://kawalpemilu.org#68223,"MALAMBIGU, DAMPAL UTARA, TOLITOLI, SULAWESI TENGAH",2,30,24,54
https://kawalpemilu.org#68224,"SIMATANG TANJUNG, DAMPAL UTARA, TOLITOLI, SULAWESI TENGAH",1,100,95,195
https://kawalpemilu.org#68224,"SIMATANG TANJUNG, DAMPAL UTARA, TOLITOLI, SULAWESI TENGAH",2,87,67,154
https://kawalpemilu.org#68224,"SIMATANG TANJUNG, DAMPAL UTARA, TOLITOLI, SULAWESI TENGAH",3,100,59,159
https://kawalpemilu.org#68225,"SIMATANG UTARA, DAMPAL UTARA, TOLITOLI, SULAWESI TENGAH",1,23,22,45
https://kawalpemilu.org#68225,"SIMATANG UTARA, DAMPAL UTARA, TOLITOLI, SULAWESI TENGAH",2,49,53,102
https://kawalpemilu.org#68225,"SIMATANG UTARA, DAMPAL UTARA, TOLITOLI, SULAWESI TENGAH",3,52,141,193
https://kawalpemilu.org#85662,"SESE, DAMPAL UTARA, TOLITOLI, SULAWESI TENGAH",1,90,122,212
https://kawalpemilu.org#85662,"SESE, DAMPAL UTARA, TOLITOLI, SULAWESI TENGAH",2,43,122,165
https://kawalpemilu.org#85662,"SESE, DAMPAL UTARA, TOLITOLI, SULAWESI TENGAH",3,35,125,160
https://kawalpemilu.org#928615,"OGOLALI, DAMPAL UTARA, TOLITOLI, SULAWESI TENGAH",1,76,44,120
https://kawalpemilu.org#928615,"OGOLALI, DAMPAL UTARA, TOLITOLI, SULAWESI TENGAH",2,101,40,141
https://kawalpemilu.org#928615,"OGOLALI, DAMPAL UTARA, TOLITOLI, SULAWESI TENGAH",3,55,20,75
https://kawalpemilu.org#928616,"BALAROA, DAMPAL UTARA, TOLITOLI, SULAWESI TENGAH",1,46,73,119
https://kawalpemilu.org#928616,"BALAROA, DAMPAL UTARA, TOLITOLI, SULAWESI TENGAH",2,71,60,131
https://kawalpemilu.org#928616,"BALAROA, DAMPAL UTARA, TOLITOLI, SULAWESI TENGAH",3,86,93,178
https://kawalpemilu.org#931038,"STADONG, DAMPAL UTARA, TOLITOLI, SULAWESI TENGAH",1,58,73,131
https://kawalpemilu.org#931038,"STADONG, DAMPAL UTARA, TOLITOLI, SULAWESI TENGAH",2,87,95,182
https://kawalpemilu.org#931038,"STADONG, DAMPAL UTARA, TOLITOLI, SULAWESI TENGAH",3,110,41,151
https://kawalpemilu.org#68227,"LUOK MANIPI, DONDO, TOLITOLI, SULAWESI TENGAH",1,98,109,207
https://kawalpemilu.org#68227,"LUOK MANIPI, DONDO, TOLITOLI, SULAWESI TENGAH",2,48,50,98
https://kawalpemilu.org#68227,"LUOK MANIPI, DONDO, TOLITOLI, SULAWESI TENGAH",3,53,51,104
https://kawalpemilu.org#68228,"SALUMBIA, DONDO, TOLITOLI, SULAWESI TENGAH",1,86,47,133
https://kawalpemilu.org#68228,"SALUMBIA, DONDO, TOLITOLI, SULAWESI TENGAH",2,76,11,87
https://kawalpemilu.org#68228,"SALUMBIA, DONDO, TOLITOLI, SULAWESI TENGAH",3,180,19,199
https://kawalpemilu.org#68228,"SALUMBIA, DONDO, TOLITOLI, SULAWESI TENGAH",4,102,65,167
https://kawalpemilu.org#68228,"SALUMBIA, DONDO, TOLITOLI, SULAWESI TENGAH",5,119,48,167
https://kawalpemilu.org#68228,"SALUMBIA, DONDO, TOLITOLI, SULAWESI TENGAH",6,89,64,153
https://kawalpemilu.org#68228,"SALUMBIA, DONDO, TOLITOLI, SULAWESI TENGAH",7,111,55,166
https://kawalpemilu.org#68229,"BAMBAPUN, DONDO, TOLITOLI, SULAWESI TENGAH",1,53,126,179
https://kawalpemilu.org#68229,"BAMBAPUN, DONDO, TOLITOLI, SULAWESI TENGAH",2,86,77,163
https://kawalpemilu.org#68229,"BAMBAPUN, DONDO, TOLITOLI, SULAWESI TENGAH",3,49,45,94
https://kawalpemilu.org#68229,"BAMBAPUN, DONDO, TOLITOLI, SULAWESI TENGAH",4,56,44,100
https://kawalpemilu.org#68229,"BAMBAPUN, DONDO, TOLITOLI, SULAWESI TENGAH",5,110,54,164
https://kawalpemilu.org#68230,"OGOWELE, DONDO, TOLITOLI, SULAWESI TENGAH",1,89,28,117
https://kawalpemilu.org#68230,"OGOWELE, DONDO, TOLITOLI, SULAWESI TENGAH",2,97,79,176
https://kawalpemilu.org#68230,"OGOWELE, DONDO, TOLITOLI, SULAWESI TENGAH",3,86,66,152
https://kawalpemilu.org#68231,"LAIS, DONDO, TOLITOLI, SULAWESI TENGAH",1,48,52,100
https://kawalpemilu.org#68231,"LAIS, DONDO, TOLITOLI, SULAWESI TENGAH",2,89,57,146
https://kawalpemilu.org#68231,"LAIS, DONDO, TOLITOLI, SULAWESI TENGAH",3,85,40,125
https://kawalpemilu.org#68231,"LAIS, DONDO, TOLITOLI, SULAWESI TENGAH",4,40,70,110
https://kawalpemilu.org#68231,"LAIS, DONDO, TOLITOLI, SULAWESI TENGAH",5,101,60,161
https://kawalpemilu.org#68232,"OGOGASANG, DONDO, TOLITOLI, SULAWESI TENGAH",1,99,54,153
https://kawalpemilu.org#68232,"OGOGASANG, DONDO, TOLITOLI, SULAWESI TENGAH",2,110,75,185
https://kawalpemilu.org#68233,"MALOMBA, DONDO, TOLITOLI, SULAWESI TENGAH",1,60,74,134
https://kawalpemilu.org#68233,"MALOMBA, DONDO, TOLITOLI, SULAWESI TENGAH",2,37,68,105
https://kawalpemilu.org#68233,"MALOMBA, DONDO, TOLITOLI, SULAWESI TENGAH",3,109,81,190
https://kawalpemilu.org#68233,"MALOMBA, DONDO, TOLITOLI, SULAWESI TENGAH",4,76,20,96
https://kawalpemilu.org#68233,"MALOMBA, DONDO, TOLITOLI, SULAWESI TENGAH",5,133,91,224
https://kawalpemilu.org#68233,"MALOMBA, DONDO, TOLITOLI, SULAWESI TENGAH",6,110,47,157
https://kawalpemilu.org#68233,"MALOMBA, DONDO, TOLITOLI, SULAWESI TENGAH",7,72,81,153
https://kawalpemilu.org#68233,"MALOMBA, DONDO, TOLITOLI, SULAWESI TENGAH",8,93,63,156
https://kawalpemilu.org#68233,"MALOMBA, DONDO, TOLITOLI, SULAWESI TENGAH",9,85,15,100
https://kawalpemilu.org#68233,"MALOMBA, DONDO, TOLITOLI, SULAWESI TENGAH",10,76,61,137
https://kawalpemilu.org#68234,"OGOGILI, DONDO, TOLITOLI, SULAWESI TENGAH",1,85,124,209
https://kawalpemilu.org#68234,"OGOGILI, DONDO, TOLITOLI, SULAWESI TENGAH",2,91,91,182
https://kawalpemilu.org#68234,"OGOGILI, DONDO, TOLITOLI, SULAWESI TENGAH",3,111,98,111
https://kawalpemilu.org#68235,"TINABOGAN, DONDO, TOLITOLI, SULAWESI TENGAH",1,122,98,220
https://kawalpemilu.org#68235,"TINABOGAN, DONDO, TOLITOLI, SULAWESI TENGAH",2,88,120,208
https://kawalpemilu.org#68235,"TINABOGAN, DONDO, TOLITOLI, SULAWESI TENGAH",3,59,47,106
https://kawalpemilu.org#68235,"TINABOGAN, DONDO, TOLITOLI, SULAWESI TENGAH",4,88,85,173
https://kawalpemilu.org#68235,"TINABOGAN, DONDO, TOLITOLI, SULAWESI TENGAH",5,53,84,137
https://kawalpemilu.org#68235,"TINABOGAN, DONDO, TOLITOLI, SULAWESI TENGAH",6,35,50,85
https://kawalpemilu.org#68235,"TINABOGAN, DONDO, TOLITOLI, SULAWESI TENGAH",7,80,85,165
https://kawalpemilu.org#68235,"TINABOGAN, DONDO, TOLITOLI, SULAWESI TENGAH",8,88,50,138
https://kawalpemilu.org#68235,"TINABOGAN, DONDO, TOLITOLI, SULAWESI TENGAH",9,112,84,196
https://kawalpemilu.org#68236,"MALULU, DONDO, TOLITOLI, SULAWESI TENGAH",1,109,76,185
https://kawalpemilu.org#68236,"MALULU, DONDO, TOLITOLI, SULAWESI TENGAH",2,57,148,3
https://kawalpemilu.org#68236,"MALULU, DONDO, TOLITOLI, SULAWESI TENGAH",3,82,143,225
https://kawalpemilu.org#68236,"MALULU, DONDO, TOLITOLI, SULAWESI TENGAH",4,65,144,209
https://kawalpemilu.org#68237,"MALALA, DONDO, TOLITOLI, SULAWESI TENGAH",1,143,51,194
https://kawalpemilu.org#68237,"MALALA, DONDO, TOLITOLI, SULAWESI TENGAH",2,87,49,136
https://kawalpemilu.org#68237,"MALALA, DONDO, TOLITOLI, SULAWESI TENGAH",3,169,51,220
https://kawalpemilu.org#68237,"MALALA, DONDO, TOLITOLI, SULAWESI TENGAH",4,92,69,161
https://kawalpemilu.org#68237,"MALALA, DONDO, TOLITOLI, SULAWESI TENGAH",5,54,5,59
https://kawalpemilu.org#68237,"MALALA, DONDO, TOLITOLI, SULAWESI TENGAH",6,110,47,157
https://kawalpemilu.org#68237,"MALALA, DONDO, TOLITOLI, SULAWESI TENGAH",7,118,65,183
https://kawalpemilu.org#68237,"MALALA, DONDO, TOLITOLI, SULAWESI TENGAH",8,83,73,156
https://kawalpemilu.org#68237,"MALALA, DONDO, TOLITOLI, SULAWESI TENGAH",9,79,68,147
https://kawalpemilu.org#68237,"MALALA, DONDO, TOLITOLI, SULAWESI TENGAH",10,75,78,153
https://kawalpemilu.org#68237,"MALALA, DONDO, TOLITOLI, SULAWESI TENGAH",11,92,31,123
https://kawalpemilu.org#68238,"ANGGASAN, DONDO, TOLITOLI, SULAWESI TENGAH",1,128,50,178
https://kawalpemilu.org#68238,"ANGGASAN, DONDO, TOLITOLI, SULAWESI TENGAH",2,88,49,137
https://kawalpemilu.org#68238,"ANGGASAN, DONDO, TOLITOLI, SULAWESI TENGAH",3,146,25,171
https://kawalpemilu.org#68238,"ANGGASAN, DONDO, TOLITOLI, SULAWESI TENGAH",4,91,31,122
https://kawalpemilu.org#68238,"ANGGASAN, DONDO, TOLITOLI, SULAWESI TENGAH",5,114,34,148
https://kawalpemilu.org#928617,"BETENGON, DONDO, TOLITOLI, SULAWESI TENGAH",1,110,81,191
https://kawalpemilu.org#928617,"BETENGON, DONDO, TOLITOLI, SULAWESI TENGAH",2,177,42,219
https://kawalpemilu.org#928618,"PANGKUNG, DONDO, TOLITOLI, SULAWESI TENGAH",1,92,105,197
https://kawalpemilu.org#928618,"PANGKUNG, DONDO, TOLITOLI, SULAWESI TENGAH",2,82,99,181
https://kawalpemilu.org#928618,"PANGKUNG, DONDO, TOLITOLI, SULAWESI TENGAH",3,152,73,225
https://kawalpemilu.org#931039,"OGOWELE BUGA, DONDO, TOLITOLI, SULAWESI TENGAH",1,63,75,138
https://kawalpemilu.org#931039,"OGOWELE BUGA, DONDO, TOLITOLI, SULAWESI TENGAH",2,50,136,186
https://kawalpemilu.org#931039,"OGOWELE BUGA, DONDO, TOLITOLI, SULAWESI TENGAH",3,76,77,153
https://kawalpemilu.org#931039,"OGOWELE BUGA, DONDO, TOLITOLI, SULAWESI TENGAH",4,156,10,166
https://kawalpemilu.org#931040,"LOBUO, DONDO, TOLITOLI, SULAWESI TENGAH",1,62,51,113
https://kawalpemilu.org#931040,"LOBUO, DONDO, TOLITOLI, SULAWESI TENGAH",2,103,95,198
https://kawalpemilu.org#931040,"LOBUO, DONDO, TOLITOLI, SULAWESI TENGAH",3,76,28,104
https://kawalpemilu.org#68240,"SIBALUTON, BASIDONDO, TOLITOLI, SULAWESI TENGAH",1,64,95,159
https://kawalpemilu.org#68240,"SIBALUTON, BASIDONDO, TOLITOLI, SULAWESI TENGAH",2,120,34,154
https://kawalpemilu.org#68240,"SIBALUTON, BASIDONDO, TOLITOLI, SULAWESI TENGAH",3,117,42,159
https://kawalpemilu.org#68240,"SIBALUTON, BASIDONDO, TOLITOLI, SULAWESI TENGAH",4,97,48,145
https://kawalpemilu.org#68240,"SIBALUTON, BASIDONDO, TOLITOLI, SULAWESI TENGAH",5,85,75,160
https://kawalpemilu.org#68240,"SIBALUTON, BASIDONDO, TOLITOLI, SULAWESI TENGAH",6,77,44,121
https://kawalpemilu.org#68240,"SIBALUTON, BASIDONDO, TOLITOLI, SULAWESI TENGAH",7,78,28,106
https://kawalpemilu.org#68240,"SIBALUTON, BASIDONDO, TOLITOLI, SULAWESI TENGAH",8,61,42,103
https://kawalpemilu.org#68240,"SIBALUTON, BASIDONDO, TOLITOLI, SULAWESI TENGAH",9,69,36,105
https://kawalpemilu.org#68241,"KAYU LOMPA, BASIDONDO, TOLITOLI, SULAWESI TENGAH",1,70,15,85
https://kawalpemilu.org#68241,"KAYU LOMPA, BASIDONDO, TOLITOLI, SULAWESI TENGAH",2,99,56,155
https://kawalpemilu.org#68241,"KAYU LOMPA, BASIDONDO, TOLITOLI, SULAWESI TENGAH",3,133,51,184
https://kawalpemilu.org#68241,"KAYU LOMPA, BASIDONDO, TOLITOLI, SULAWESI TENGAH",4,124,69,193
https://kawalpemilu.org#68241,"KAYU LOMPA, BASIDONDO, TOLITOLI, SULAWESI TENGAH",5,51,58,109
https://kawalpemilu.org#68241,"KAYU LOMPA, BASIDONDO, TOLITOLI, SULAWESI TENGAH",6,72,18,90
https://kawalpemilu.org#68241,"KAYU LOMPA, BASIDONDO, TOLITOLI, SULAWESI TENGAH",7,146,27,173
https://kawalpemilu.org#68241,"KAYU LOMPA, BASIDONDO, TOLITOLI, SULAWESI TENGAH",8,146,61,207
https://kawalpemilu.org#68241,"KAYU LOMPA, BASIDONDO, TOLITOLI, SULAWESI TENGAH",9,114,42,156
https://kawalpemilu.org#68241,"KAYU LOMPA, BASIDONDO, TOLITOLI, SULAWESI TENGAH",10,63,24,87
https://kawalpemilu.org#68242,"LABONU, BASIDONDO, TOLITOLI, SULAWESI TENGAH",2,128,44,172
https://kawalpemilu.org#68242,"LABONU, BASIDONDO, TOLITOLI, SULAWESI TENGAH",3,131,25,156
https://kawalpemilu.org#68242,"LABONU, BASIDONDO, TOLITOLI, SULAWESI TENGAH",4,112,48,160
https://kawalpemilu.org#68243,"SILONDOU, BASIDONDO, TOLITOLI, SULAWESI TENGAH",1,72,18,90
https://kawalpemilu.org#68243,"SILONDOU, BASIDONDO, TOLITOLI, SULAWESI TENGAH",2,159,25,184
https://kawalpemilu.org#68243,"SILONDOU, BASIDONDO, TOLITOLI, SULAWESI TENGAH",3,138,45,183
https://kawalpemilu.org#68243,"SILONDOU, BASIDONDO, TOLITOLI, SULAWESI TENGAH",4,98,40,138
https://kawalpemilu.org#68243,"SILONDOU, BASIDONDO, TOLITOLI, SULAWESI TENGAH",5,63,27,90
https://kawalpemilu.org#68243,"SILONDOU, BASIDONDO, TOLITOLI, SULAWESI TENGAH",6,132,15,147
https://kawalpemilu.org#68244,"KINAPASAN, BASIDONDO, TOLITOLI, SULAWESI TENGAH",1,53,35,88
https://kawalpemilu.org#68244,"KINAPASAN, BASIDONDO, TOLITOLI, SULAWESI TENGAH",2,63,36,99
https://kawalpemilu.org#68245,"KONGKOMOS, BASIDONDO, TOLITOLI, SULAWESI TENGAH",1,61,95,156
https://kawalpemilu.org#68245,"KONGKOMOS, BASIDONDO, TOLITOLI, SULAWESI TENGAH",2,88,67,155
https://kawalpemilu.org#68245,"KONGKOMOS, BASIDONDO, TOLITOLI, SULAWESI TENGAH",3,161,46,207
https://kawalpemilu.org#68245,"KONGKOMOS, BASIDONDO, TOLITOLI, SULAWESI TENGAH",4,96,64,160
https://kawalpemilu.org#68245,"KONGKOMOS, BASIDONDO, TOLITOLI, SULAWESI TENGAH",5,83,65,148
https://kawalpemilu.org#68246,"OGOSIPAT, BASIDONDO, TOLITOLI, SULAWESI TENGAH",1,96,27,123
https://kawalpemilu.org#68246,"OGOSIPAT, BASIDONDO, TOLITOLI, SULAWESI TENGAH",2,96,22,118
https://kawalpemilu.org#68246,"OGOSIPAT, BASIDONDO, TOLITOLI, SULAWESI TENGAH",3,96,20,116
https://kawalpemilu.org#85663,"GALANDAU, BASIDONDO, TOLITOLI, SULAWESI TENGAH",1,140,28,168
https://kawalpemilu.org#928619,"MARISA, BASIDONDO, TOLITOLI, SULAWESI TENGAH",1,79,64,143
https://kawalpemilu.org#931041,"BASI, BASIDONDO, TOLITOLI, SULAWESI TENGAH",1,112,69,181
https://kawalpemilu.org#931041,"BASI, BASIDONDO, TOLITOLI, SULAWESI TENGAH",2,92,82,174
https://kawalpemilu.org#68248,"BUGA, OGODEIDE, TOLITOLI, SULAWESI TENGAH",1,117,44,161
https://kawalpemilu.org#68248,"BUGA, OGODEIDE, TOLITOLI, SULAWESI TENGAH",2,129,29,158
https://kawalpemilu.org#68248,"BUGA, OGODEIDE, TOLITOLI, SULAWESI TENGAH",3,139,43,182
https://kawalpemilu.org#68248,"BUGA, OGODEIDE, TOLITOLI, SULAWESI TENGAH",4,121,45,166
https://kawalpemilu.org#68248,"BUGA, OGODEIDE, TOLITOLI, SULAWESI TENGAH",5,86,12,98
https://kawalpemilu.org#68248,"BUGA, OGODEIDE, TOLITOLI, SULAWESI TENGAH",6,43,48,91
https://kawalpemilu.org#68249,"BATUILO, OGODEIDE, TOLITOLI, SULAWESI TENGAH",1,170,40,210
https://kawalpemilu.org#68249,"BATUILO, OGODEIDE, TOLITOLI, SULAWESI TENGAH",2,42,7,49
https://kawalpemilu.org#68249,"BATUILO, OGODEIDE, TOLITOLI, SULAWESI TENGAH",3,138,18,156
https://kawalpemilu.org#68250,"KAMALU, OGODEIDE, TOLITOLI, SULAWESI TENGAH",1,129,30,159
https://kawalpemilu.org#68250,"KAMALU, OGODEIDE, TOLITOLI, SULAWESI TENGAH",2,145,50,195
https://kawalpemilu.org#68250,"KAMALU, OGODEIDE, TOLITOLI, SULAWESI TENGAH",3,117,34,151
https://kawalpemilu.org#68250,"KAMALU, OGODEIDE, TOLITOLI, SULAWESI TENGAH",4,107,70,177
https://kawalpemilu.org#68251,"MUARA BESAR, OGODEIDE, TOLITOLI, SULAWESI TENGAH",1,150,35,185
https://kawalpemilu.org#68251,"MUARA BESAR, OGODEIDE, TOLITOLI, SULAWESI TENGAH",2,164,44,208
https://kawalpemilu.org#68251,"MUARA BESAR, OGODEIDE, TOLITOLI, SULAWESI TENGAH",3,66,25,91
https://kawalpemilu.org#68252,"BILO, OGODEIDE, TOLITOLI, SULAWESI TENGAH",1,113,79,192
https://kawalpemilu.org#68252,"BILO, OGODEIDE, TOLITOLI, SULAWESI TENGAH",2,75,74,149
https://kawalpemilu.org#68252,"BILO, OGODEIDE, TOLITOLI, SULAWESI TENGAH",3,58,147,205
https://kawalpemilu.org#68252,"BILO, OGODEIDE, TOLITOLI, SULAWESI TENGAH",4,80,110,190
https://kawalpemilu.org#68252,"BILO, OGODEIDE, TOLITOLI, SULAWESI TENGAH",5,69,93,162
https://kawalpemilu.org#68252,"BILO, OGODEIDE, TOLITOLI, SULAWESI TENGAH",6,59,61,120
https://kawalpemilu.org#68252,"BILO, OGODEIDE, TOLITOLI, SULAWESI TENGAH",7,43,41,84
https://kawalpemilu.org#68253,"LABUAN LOBO, OGODEIDE, TOLITOLI, SULAWESI TENGAH",1,117,46,163
https://kawalpemilu.org#68253,"LABUAN LOBO, OGODEIDE, TOLITOLI, SULAWESI TENGAH",2,126,29,155
https://kawalpemilu.org#68253,"LABUAN LOBO, OGODEIDE, TOLITOLI, SULAWESI TENGAH",3,53,61,114
https://kawalpemilu.org#68253,"LABUAN LOBO, OGODEIDE, TOLITOLI, SULAWESI TENGAH",4,56,52,108
https://kawalpemilu.org#68253,"LABUAN LOBO, OGODEIDE, TOLITOLI, SULAWESI TENGAH",5,33,92,125
https://kawalpemilu.org#68253,"LABUAN LOBO, OGODEIDE, TOLITOLI, SULAWESI TENGAH",6,67,52,119
https://kawalpemilu.org#68254,"SAMBUJAN, OGODEIDE, TOLITOLI, SULAWESI TENGAH",1,85,102,187
https://kawalpemilu.org#68254,"SAMBUJAN, OGODEIDE, TOLITOLI, SULAWESI TENGAH",2,115,70,185
https://kawalpemilu.org#68254,"SAMBUJAN, OGODEIDE, TOLITOLI, SULAWESI TENGAH",3,81,61,142
https://kawalpemilu.org#68255,"PULIAS, OGODEIDE, TOLITOLI, SULAWESI TENGAH",1,155,60,215
https://kawalpemilu.org#68255,"PULIAS, OGODEIDE, TOLITOLI, SULAWESI TENGAH",2,78,41,119
https://kawalpemilu.org#68255,"PULIAS, OGODEIDE, TOLITOLI, SULAWESI TENGAH",3,88,121,209
https://kawalpemilu.org#68255,"PULIAS, OGODEIDE, TOLITOLI, SULAWESI TENGAH",4,39,72,111
https://kawalpemilu.org#68255,"PULIAS, OGODEIDE, TOLITOLI, SULAWESI TENGAH",5,58,38,96
https://kawalpemilu.org#68255,"PULIAS, OGODEIDE, TOLITOLI, SULAWESI TENGAH",6,21,63,84
https://kawalpemilu.org#68255,"PULIAS, OGODEIDE, TOLITOLI, SULAWESI TENGAH",7,92,85,177
https://kawalpemilu.org#68256,"KABETAN, OGODEIDE, TOLITOLI, SULAWESI TENGAH",1,146,93,239
https://kawalpemilu.org#68256,"KABETAN, OGODEIDE, TOLITOLI, SULAWESI TENGAH",2,83,127,210
https://kawalpemilu.org#68256,"KABETAN, OGODEIDE, TOLITOLI, SULAWESI TENGAH",3,67,63,130
https://kawalpemilu.org#68257,"PAGAITAN, OGODEIDE, TOLITOLI, SULAWESI TENGAH",1,120,31,151
https://kawalpemilu.org#68257,"PAGAITAN, OGODEIDE, TOLITOLI, SULAWESI TENGAH",2,96,48,144
https://kawalpemilu.org#68257,"PAGAITAN, OGODEIDE, TOLITOLI, SULAWESI TENGAH",3,132,5,137
https://kawalpemilu.org#68258,"BAMBALAGA, OGODEIDE, TOLITOLI, SULAWESI TENGAH",1,143,48,191
https://kawalpemilu.org#68258,"BAMBALAGA, OGODEIDE, TOLITOLI, SULAWESI TENGAH",2,85,11,96
https://kawalpemilu.org#68260,"JANJA, LAMPASIO, TOLITOLI, SULAWESI TENGAH",1,109,26,135
https://kawalpemilu.org#68260,"JANJA, LAMPASIO, TOLITOLI, SULAWESI TENGAH",2,118,26,144
https://kawalpemilu.org#68260,"JANJA, LAMPASIO, TOLITOLI, SULAWESI TENGAH",3,161,18,179
https://kawalpemilu.org#68260,"JANJA, LAMPASIO, TOLITOLI, SULAWESI TENGAH",4,89,14,103
https://kawalpemilu.org#68260,"JANJA, LAMPASIO, TOLITOLI, SULAWESI TENGAH",5,177,45,222
https://kawalpemilu.org#68261,"OYOM, LAMPASIO, TOLITOLI, SULAWESI TENGAH",1,85,61,146
https://kawalpemilu.org#68261,"OYOM, LAMPASIO, TOLITOLI, SULAWESI TENGAH",2,166,27,193
https://kawalpemilu.org#68261,"OYOM, LAMPASIO, TOLITOLI, SULAWESI TENGAH",3,110,60,170
https://kawalpemilu.org#68261,"OYOM, LAMPASIO, TOLITOLI, SULAWESI TENGAH",4,96,8,104
https://kawalpemilu.org#68261,"OYOM, LAMPASIO, TOLITOLI, SULAWESI TENGAH",5,100,46,146
https://kawalpemilu.org#68261,"OYOM, LAMPASIO, TOLITOLI, SULAWESI TENGAH",6,125,55,180
https://kawalpemilu.org#68261,"OYOM, LAMPASIO, TOLITOLI, SULAWESI TENGAH",7,58,14,72
https://kawalpemilu.org#68261,"OYOM, LAMPASIO, TOLITOLI, SULAWESI TENGAH",8,130,8,138
https://kawalpemilu.org#68261,"OYOM, LAMPASIO, TOLITOLI, SULAWESI TENGAH",9,51,5,56
https://kawalpemilu.org#68262,"SALUGAN, LAMPASIO, TOLITOLI, SULAWESI TENGAH",1,93,50,143
https://kawalpemilu.org#68262,"SALUGAN, LAMPASIO, TOLITOLI, SULAWESI TENGAH",2,88,67,155
https://kawalpemilu.org#68262,"SALUGAN, LAMPASIO, TOLITOLI, SULAWESI TENGAH",3,115,64,179
https://kawalpemilu.org#68263,"LAMPASIO, LAMPASIO, TOLITOLI, SULAWESI TENGAH",1,103,76,179
https://kawalpemilu.org#68263,"LAMPASIO, LAMPASIO, TOLITOLI, SULAWESI TENGAH",2,107,56,163
https://kawalpemilu.org#68263,"LAMPASIO, LAMPASIO, TOLITOLI, SULAWESI TENGAH",3,57,30,87
https://kawalpemilu.org#68263,"LAMPASIO, LAMPASIO, TOLITOLI, SULAWESI TENGAH",4,156,59,215
https://kawalpemilu.org#68263,"LAMPASIO, LAMPASIO, TOLITOLI, SULAWESI TENGAH",5,88,46,134
https://kawalpemilu.org#68263,"LAMPASIO, LAMPASIO, TOLITOLI, SULAWESI TENGAH",6,19,28,47
https://kawalpemilu.org#68263,"LAMPASIO, LAMPASIO, TOLITOLI, SULAWESI TENGAH",7,79,31,110
https://kawalpemilu.org#68263,"LAMPASIO, LAMPASIO, TOLITOLI, SULAWESI TENGAH",8,79,110,189
https://kawalpemilu.org#68263,"LAMPASIO, LAMPASIO, TOLITOLI, SULAWESI TENGAH",9,82,23,105
https://kawalpemilu.org#68263,"LAMPASIO, LAMPASIO, TOLITOLI, SULAWESI TENGAH",10,93,11,104
https://kawalpemilu.org#68264,"TINADING, LAMPASIO, TOLITOLI, SULAWESI TENGAH",1,211,25,236
https://kawalpemilu.org#68264,"TINADING, LAMPASIO, TOLITOLI, SULAWESI TENGAH",2,190,28,218
https://kawalpemilu.org#68264,"TINADING, LAMPASIO, TOLITOLI, SULAWESI TENGAH",3,177,31,208
https://kawalpemilu.org#68264,"TINADING, LAMPASIO, TOLITOLI, SULAWESI TENGAH",4,85,18,103
https://kawalpemilu.org#68264,"TINADING, LAMPASIO, TOLITOLI, SULAWESI TENGAH",5,104,35,139
https://kawalpemilu.org#68264,"TINADING, LAMPASIO, TOLITOLI, SULAWESI TENGAH",6,41,30,71
https://kawalpemilu.org#68264,"TINADING, LAMPASIO, TOLITOLI, SULAWESI TENGAH",7,129,96,225
https://kawalpemilu.org#68264,"TINADING, LAMPASIO, TOLITOLI, SULAWESI TENGAH",8,113,39,152
https://kawalpemilu.org#68264,"TINADING, LAMPASIO, TOLITOLI, SULAWESI TENGAH",9,48,11,59
https://kawalpemilu.org#68265,"SIBEA, LAMPASIO, TOLITOLI, SULAWESI TENGAH",1,135,33,168
https://kawalpemilu.org#68265,"SIBEA, LAMPASIO, TOLITOLI, SULAWESI TENGAH",2,124,65,189
https://kawalpemilu.org#68265,"SIBEA, LAMPASIO, TOLITOLI, SULAWESI TENGAH",3,143,32,175
https://kawalpemilu.org#68265,"SIBEA, LAMPASIO, TOLITOLI, SULAWESI TENGAH",4,159,33,192
https://kawalpemilu.org#68265,"SIBEA, LAMPASIO, TOLITOLI, SULAWESI TENGAH",5,151,34,185
https://kawalpemilu.org#68265,"SIBEA, LAMPASIO, TOLITOLI, SULAWESI TENGAH",6,150,30,180
https://kawalpemilu.org#68266,"MAIBUA, LAMPASIO, TOLITOLI, SULAWESI TENGAH",1,77,48,125
https://kawalpemilu.org#68266,"MAIBUA, LAMPASIO, TOLITOLI, SULAWESI TENGAH",2,77,13,90
https://kawalpemilu.org#68266,"MAIBUA, LAMPASIO, TOLITOLI, SULAWESI TENGAH",3,70,6,76
https://kawalpemilu.org#68267,"MULYA SARI, LAMPASIO, TOLITOLI, SULAWESI TENGAH",1,76,13,89
https://kawalpemilu.org#68267,"MULYA SARI, LAMPASIO, TOLITOLI, SULAWESI TENGAH",2,67,30,97
https://kawalpemilu.org#85664,"OGOMATANANG, LAMPASIO, TOLITOLI, SULAWESI TENGAH",1,77,24,101
https://kawalpemilu.org#85664,"OGOMATANANG, LAMPASIO, TOLITOLI, SULAWESI TENGAH",2,105,29,134
https://kawalpemilu.org#85664,"OGOMATANANG, LAMPASIO, TOLITOLI, SULAWESI TENGAH",3,67,40,107
https://kawalpemilu.org#85664,"OGOMATANANG, LAMPASIO, TOLITOLI, SULAWESI TENGAH",4,84,67,151
https://kawalpemilu.org#85664,"OGOMATANANG, LAMPASIO, TOLITOLI, SULAWESI TENGAH",5,77,46,123
https://kawalpemilu.org#85664,"OGOMATANANG, LAMPASIO, TOLITOLI, SULAWESI TENGAH",6,67,31,98
https://kawalpemilu.org#68271,"TUWELEY, BAOLAN, TOLITOLI, SULAWESI TENGAH",1,41,93,134
https://kawalpemilu.org#68271,"TUWELEY, BAOLAN, TOLITOLI, SULAWESI TENGAH",2,101,118,219
https://kawalpemilu.org#68271,"TUWELEY, BAOLAN, TOLITOLI, SULAWESI TENGAH",3,41,83,124
https://kawalpemilu.org#68271,"TUWELEY, BAOLAN, TOLITOLI, SULAWESI TENGAH",4,34,148,182
https://kawalpemilu.org#68271,"TUWELEY, BAOLAN, TOLITOLI, SULAWESI TENGAH",5,79,143,222
https://kawalpemilu.org#68271,"TUWELEY, BAOLAN, TOLITOLI, SULAWESI TENGAH",6,63,82,145
https://kawalpemilu.org#68271,"TUWELEY, BAOLAN, TOLITOLI, SULAWESI TENGAH",7,75,74,149
https://kawalpemilu.org#68271,"TUWELEY, BAOLAN, TOLITOLI, SULAWESI TENGAH",8,66,87,153
https://kawalpemilu.org#68271,"TUWELEY, BAOLAN, TOLITOLI, SULAWESI TENGAH",9,48,113,161
https://kawalpemilu.org#68271,"TUWELEY, BAOLAN, TOLITOLI, SULAWESI TENGAH",10,113,123,236
https://kawalpemilu.org#68271,"TUWELEY, BAOLAN, TOLITOLI, SULAWESI TENGAH",11,76,64,140
https://kawalpemilu.org#68271,"TUWELEY, BAOLAN, TOLITOLI, SULAWESI TENGAH",12,68,99,167
https://kawalpemilu.org#68271,"TUWELEY, BAOLAN, TOLITOLI, SULAWESI TENGAH",13,87,146,233
https://kawalpemilu.org#68271,"TUWELEY, BAOLAN, TOLITOLI, SULAWESI TENGAH",14,76,64,140
https://kawalpemilu.org#68271,"TUWELEY, BAOLAN, TOLITOLI, SULAWESI TENGAH",15,40,75,115
https://kawalpemilu.org#68271,"TUWELEY, BAOLAN, TOLITOLI, SULAWESI TENGAH",16,60,88,148
https://kawalpemilu.org#68271,"TUWELEY, BAOLAN, TOLITOLI, SULAWESI TENGAH",17,90,116,206
https://kawalpemilu.org#68271,"TUWELEY, BAOLAN, TOLITOLI, SULAWESI TENGAH",18,94,93,187
https://kawalpemilu.org#68271,"TUWELEY, BAOLAN, TOLITOLI, SULAWESI TENGAH",19,137,45,182
https://kawalpemilu.org#68271,"TUWELEY, BAOLAN, TOLITOLI, SULAWESI TENGAH",20,118,84,202
https://kawalpemilu.org#68271,"TUWELEY, BAOLAN, TOLITOLI, SULAWESI TENGAH",21,82,84,166
https://kawalpemilu.org#68271,"TUWELEY, BAOLAN, TOLITOLI, SULAWESI TENGAH",22,39,100,139
https://kawalpemilu.org#68271,"TUWELEY, BAOLAN, TOLITOLI, SULAWESI TENGAH",23,35,68,103
https://kawalpemilu.org#68271,"TUWELEY, BAOLAN, TOLITOLI, SULAWESI TENGAH",24,59,102,161
https://kawalpemilu.org#68271,"TUWELEY, BAOLAN, TOLITOLI, SULAWESI TENGAH",25,111,142,253
https://kawalpemilu.org#68271,"TUWELEY, BAOLAN, TOLITOLI, SULAWESI TENGAH",26,103,159,262
https://kawalpemilu.org#68271,"TUWELEY, BAOLAN, TOLITOLI, SULAWESI TENGAH",27,69,149,217
https://kawalpemilu.org#68271,"TUWELEY, BAOLAN, TOLITOLI, SULAWESI TENGAH",28,74,159,233
https://kawalpemilu.org#68271,"TUWELEY, BAOLAN, TOLITOLI, SULAWESI TENGAH",29,89,132,221
https://kawalpemilu.org#68271,"TUWELEY, BAOLAN, TOLITOLI, SULAWESI TENGAH",30,100,110,210
https://kawalpemilu.org#68271,"TUWELEY, BAOLAN, TOLITOLI, SULAWESI TENGAH",31,32,61,93
https://kawalpemilu.org#68271,"TUWELEY, BAOLAN, TOLITOLI, SULAWESI TENGAH",32,76,75,151
https://kawalpemilu.org#68272,"NALU, BAOLAN, TOLITOLI, SULAWESI TENGAH",1,66,66,132
https://kawalpemilu.org#68272,"NALU, BAOLAN, TOLITOLI, SULAWESI TENGAH",2,47,71,118
https://kawalpemilu.org#68272,"NALU, BAOLAN, TOLITOLI, SULAWESI TENGAH",3,78,72,150
https://kawalpemilu.org#68272,"NALU, BAOLAN, TOLITOLI, SULAWESI TENGAH",4,55,123,178
https://kawalpemilu.org#68272,"NALU, BAOLAN, TOLITOLI, SULAWESI TENGAH",5,80,114,194
https://kawalpemilu.org#68272,"NALU, BAOLAN, TOLITOLI, SULAWESI TENGAH",6,51,106,157
https://kawalpemilu.org#68272,"NALU, BAOLAN, TOLITOLI, SULAWESI TENGAH",7,51,134,185
https://kawalpemilu.org#68272,"NALU, BAOLAN, TOLITOLI, SULAWESI TENGAH",8,76,139,215
https://kawalpemilu.org#68272,"NALU, BAOLAN, TOLITOLI, SULAWESI TENGAH",9,83,126,209
https://kawalpemilu.org#68272,"NALU, BAOLAN, TOLITOLI, SULAWESI TENGAH",10,79,178,257
https://kawalpemilu.org#68272,"NALU, BAOLAN, TOLITOLI, SULAWESI TENGAH",11,49,138,187
https://kawalpemilu.org#68272,"NALU, BAOLAN, TOLITOLI, SULAWESI TENGAH",12,29,78,107
https://kawalpemilu.org#68272,"NALU, BAOLAN, TOLITOLI, SULAWESI TENGAH",13,88,90,178
https://kawalpemilu.org#68272,"NALU, BAOLAN, TOLITOLI, SULAWESI TENGAH",14,81,122,203
https://kawalpemilu.org#68272,"NALU, BAOLAN, TOLITOLI, SULAWESI TENGAH",15,50,100,150
https://kawalpemilu.org#68272,"NALU, BAOLAN, TOLITOLI, SULAWESI TENGAH",16,60,100,160
https://kawalpemilu.org#68272,"NALU, BAOLAN, TOLITOLI, SULAWESI TENGAH",17,56,71,127
https://kawalpemilu.org#68272,"NALU, BAOLAN, TOLITOLI, SULAWESI TENGAH",18,49,82,131
https://kawalpemilu.org#68272,"NALU, BAOLAN, TOLITOLI, SULAWESI TENGAH",19,110,142,252
https://kawalpemilu.org#68272,"NALU, BAOLAN, TOLITOLI, SULAWESI TENGAH",20,94,74,168
https://kawalpemilu.org#68272,"NALU, BAOLAN, TOLITOLI, SULAWESI TENGAH",21,38,71,109
https://kawalpemilu.org#68272,"NALU, BAOLAN, TOLITOLI, SULAWESI TENGAH",22,34,65,99
https://kawalpemilu.org#68272,"NALU, BAOLAN, TOLITOLI, SULAWESI TENGAH",23,99,100,199
https://kawalpemilu.org#68272,"NALU, BAOLAN, TOLITOLI, SULAWESI TENGAH",24,71,107,178
https://kawalpemilu.org#68272,"NALU, BAOLAN, TOLITOLI, SULAWESI TENGAH",25,50,65,115
https://kawalpemilu.org#68272,"NALU, BAOLAN, TOLITOLI, SULAWESI TENGAH",26,110,106,216
https://kawalpemilu.org#68272,"NALU, BAOLAN, TOLITOLI, SULAWESI TENGAH",27,35,121,156
https://kawalpemilu.org#68272,"NALU, BAOLAN, TOLITOLI, SULAWESI TENGAH",28,40,154,194
https://kawalpemilu.org#68272,"NALU, BAOLAN, TOLITOLI, SULAWESI TENGAH",29,124,100,224
https://kawalpemilu.org#68272,"NALU, BAOLAN, TOLITOLI, SULAWESI TENGAH",30,123,47,170
https://kawalpemilu.org#68272,"NALU, BAOLAN, TOLITOLI, SULAWESI TENGAH",31,91,40,131
https://kawalpemilu.org#68273,"BARU, BAOLAN, TOLITOLI, SULAWESI TENGAH",1,67,62,129
https://kawalpemilu.org#68273,"BARU, BAOLAN, TOLITOLI, SULAWESI TENGAH",2,86,120,206
https://kawalpemilu.org#68273,"BARU, BAOLAN, TOLITOLI, SULAWESI TENGAH",3,85,141,226
https://kawalpemilu.org#68273,"BARU, BAOLAN, TOLITOLI, SULAWESI TENGAH",4,73,156,231
https://kawalpemilu.org#68273,"BARU, BAOLAN, TOLITOLI, SULAWESI TENGAH",5,74,107,181
https://kawalpemilu.org#68273,"BARU, BAOLAN, TOLITOLI, SULAWESI TENGAH",6,46,125,171
https://kawalpemilu.org#68273,"BARU, BAOLAN, TOLITOLI, SULAWESI TENGAH",7,58,109,167
https://kawalpemilu.org#68273,"BARU, BAOLAN, TOLITOLI, SULAWESI TENGAH",8,79,86,165
https://kawalpemilu.org#68273,"BARU, BAOLAN, TOLITOLI, SULAWESI TENGAH",9,60,88,148
https://kawalpemilu.org#68273,"BARU, BAOLAN, TOLITOLI, SULAWESI TENGAH",10,70,157,227
https://kawalpemilu.org#68273,"BARU, BAOLAN, TOLITOLI, SULAWESI TENGAH",11,55,61,116
https://kawalpemilu.org#68273,"BARU, BAOLAN, TOLITOLI, SULAWESI TENGAH",12,74,78,152
https://kawalpemilu.org#68273,"BARU, BAOLAN, TOLITOLI, SULAWESI TENGAH",13,72,119,191
https://kawalpemilu.org#68273,"BARU, BAOLAN, TOLITOLI, SULAWESI TENGAH",14,55,52,107
https://kawalpemilu.org#68273,"BARU, BAOLAN, TOLITOLI, SULAWESI TENGAH",15,66,37,103
https://kawalpemilu.org#68273,"BARU, BAOLAN, TOLITOLI, SULAWESI TENGAH",16,72,103,175
https://kawalpemilu.org#68273,"BARU, BAOLAN, TOLITOLI, SULAWESI TENGAH",17,59,92,151
https://kawalpemilu.org#68273,"BARU, BAOLAN, TOLITOLI, SULAWESI TENGAH",18,114,125,239
https://kawalpemilu.org#68273,"BARU, BAOLAN, TOLITOLI, SULAWESI TENGAH",19,117,32,149
https://kawalpemilu.org#68273,"BARU, BAOLAN, TOLITOLI, SULAWESI TENGAH",20,105,67,172
https://kawalpemilu.org#68273,"BARU, BAOLAN, TOLITOLI, SULAWESI TENGAH",21,57,65,122
https://kawalpemilu.org#68273,"BARU, BAOLAN, TOLITOLI, SULAWESI TENGAH",22,66,145,211
https://kawalpemilu.org#68273,"BARU, BAOLAN, TOLITOLI, SULAWESI TENGAH",23,34,67,101
https://kawalpemilu.org#68273,"BARU, BAOLAN, TOLITOLI, SULAWESI TENGAH",24,34,87,121
https://kawalpemilu.org#68273,"BARU, BAOLAN, TOLITOLI, SULAWESI TENGAH",25,39,65,104
https://kawalpemilu.org#68273,"BARU, BAOLAN, TOLITOLI, SULAWESI TENGAH",26,80,109,189
https://kawalpemilu.org#68273,"BARU, BAOLAN, TOLITOLI, SULAWESI TENGAH",27,37,122,159
https://kawalpemilu.org#68273,"BARU, BAOLAN, TOLITOLI, SULAWESI TENGAH",28,72,84,156
https://kawalpemilu.org#68273,"BARU, BAOLAN, TOLITOLI, SULAWESI TENGAH",29,72,91,163
https://kawalpemilu.org#68273,"BARU, BAOLAN, TOLITOLI, SULAWESI TENGAH",30,46,70,116
https://kawalpemilu.org#68273,"BARU, BAOLAN, TOLITOLI, SULAWESI TENGAH",31,71,143,215
https://kawalpemilu.org#68273,"BARU, BAOLAN, TOLITOLI, SULAWESI TENGAH",32,63,86,149
https://kawalpemilu.org#68273,"BARU, BAOLAN, TOLITOLI, SULAWESI TENGAH",33,92,69,161
https://kawalpemilu.org#68273,"BARU, BAOLAN, TOLITOLI, SULAWESI TENGAH",34,83,21,104
https://kawalpemilu.org#68273,"BARU, BAOLAN, TOLITOLI, SULAWESI TENGAH",35,69,116,185
https://kawalpemilu.org#68273,"BARU, BAOLAN, TOLITOLI, SULAWESI TENGAH",36,68,36,104
https://kawalpemilu.org#68273,"BARU, BAOLAN, TOLITOLI, SULAWESI TENGAH",37,71,97,168
https://kawalpemilu.org#68273,"BARU, BAOLAN, TOLITOLI, SULAWESI TENGAH",38,107,35,142
https://kawalpemilu.org#68273,"BARU, BAOLAN, TOLITOLI, SULAWESI TENGAH",39,71,112,183
https://kawalpemilu.org#68273,"BARU, BAOLAN, TOLITOLI, SULAWESI TENGAH",40,85,112,197
https://kawalpemilu.org#68273,"BARU, BAOLAN, TOLITOLI, SULAWESI TENGAH",41,35,84,119
https://kawalpemilu.org#68273,"BARU, BAOLAN, TOLITOLI, SULAWESI TENGAH",42,80,137,217
https://kawalpemilu.org#68273,"BARU, BAOLAN, TOLITOLI, SULAWESI TENGAH",43,72,93,165
https://kawalpemilu.org#68273,"BARU, BAOLAN, TOLITOLI, SULAWESI TENGAH",44,67,109,176
https://kawalpemilu.org#68273,"BARU, BAOLAN, TOLITOLI, SULAWESI TENGAH",45,54,64,118
https://kawalpemilu.org#68273,"BARU, BAOLAN, TOLITOLI, SULAWESI TENGAH",46,70,98,168
https://kawalpemilu.org#68273,"BARU, BAOLAN, TOLITOLI, SULAWESI TENGAH",47,65,80,145
https://kawalpemilu.org#68273,"BARU, BAOLAN, TOLITOLI, SULAWESI TENGAH",48,77,76,153
https://kawalpemilu.org#68273,"BARU, BAOLAN, TOLITOLI, SULAWESI TENGAH",49,106,117,223
https://kawalpemilu.org#68273,"BARU, BAOLAN, TOLITOLI, SULAWESI TENGAH",50,77,142,219
https://kawalpemilu.org#68273,"BARU, BAOLAN, TOLITOLI, SULAWESI TENGAH",51,66,109,175
https://kawalpemilu.org#68273,"BARU, BAOLAN, TOLITOLI, SULAWESI TENGAH",52,76,64,140
https://kawalpemilu.org#68273,"BARU, BAOLAN, TOLITOLI, SULAWESI TENGAH",53,50,57,107
https://kawalpemilu.org#68273,"BARU, BAOLAN, TOLITOLI, SULAWESI TENGAH",54,66,59,125
https://kawalpemilu.org#68273,"BARU, BAOLAN, TOLITOLI, SULAWESI TENGAH",55,86,126,212
https://kawalpemilu.org#68273,"BARU, BAOLAN, TOLITOLI, SULAWESI TENGAH",56,76,105,181
https://kawalpemilu.org#68273,"BARU, BAOLAN, TOLITOLI, SULAWESI TENGAH",57,76,78,154
https://kawalpemilu.org#68273,"BARU, BAOLAN, TOLITOLI, SULAWESI TENGAH",58,53,85,138
https://kawalpemilu.org#68273,"BARU, BAOLAN, TOLITOLI, SULAWESI TENGAH",59,46,69,115
https://kawalpemilu.org#68273,"BARU, BAOLAN, TOLITOLI, SULAWESI TENGAH",60,83,98,181
https://kawalpemilu.org#68273,"BARU, BAOLAN, TOLITOLI, SULAWESI TENGAH",61,62,108,170
https://kawalpemilu.org#68273,"BARU, BAOLAN, TOLITOLI, SULAWESI TENGAH",62,38,53,91
https://kawalpemilu.org#68273,"BARU, BAOLAN, TOLITOLI, SULAWESI TENGAH",63,24,55,79
https://kawalpemilu.org#68273,"BARU, BAOLAN, TOLITOLI, SULAWESI TENGAH",64,54,84,138
https://kawalpemilu.org#68273,"BARU, BAOLAN, TOLITOLI, SULAWESI TENGAH",65,70,91,161
https://kawalpemilu.org#68274,"PANASAKAN, BAOLAN, TOLITOLI, SULAWESI TENGAH",1,57,113,170
https://kawalpemilu.org#68274,"PANASAKAN, BAOLAN, TOLITOLI, SULAWESI TENGAH",2,63,134,197
https://kawalpemilu.org#68274,"PANASAKAN, BAOLAN, TOLITOLI, SULAWESI TENGAH",3,64,82,146
https://kawalpemilu.org#68274,"PANASAKAN, BAOLAN, TOLITOLI, SULAWESI TENGAH",4,69,80,149
https://kawalpemilu.org#68274,"PANASAKAN, BAOLAN, TOLITOLI, SULAWESI TENGAH",5,47,99,146
https://kawalpemilu.org#68274,"PANASAKAN, BAOLAN, TOLITOLI, SULAWESI TENGAH",6,76,118,194
https://kawalpemilu.org#68274,"PANASAKAN, BAOLAN, TOLITOLI, SULAWESI TENGAH",7,45,63,108
https://kawalpemilu.org#68274,"PANASAKAN, BAOLAN, TOLITOLI, SULAWESI TENGAH",8,61,136,197
https://kawalpemilu.org#68274,"PANASAKAN, BAOLAN, TOLITOLI, SULAWESI TENGAH",9,51,87,138
https://kawalpemilu.org#68274,"PANASAKAN, BAOLAN, TOLITOLI, SULAWESI TENGAH",10,46,103,149
https://kawalpemilu.org#68274,"PANASAKAN, BAOLAN, TOLITOLI, SULAWESI TENGAH",11,26,43,69
https://kawalpemilu.org#68274,"PANASAKAN, BAOLAN, TOLITOLI, SULAWESI TENGAH",13,78,61,139
https://kawalpemilu.org#68274,"PANASAKAN, BAOLAN, TOLITOLI, SULAWESI TENGAH",14,61,100,161
https://kawalpemilu.org#68274,"PANASAKAN, BAOLAN, TOLITOLI, SULAWESI TENGAH",15,75,34,109
https://kawalpemilu.org#68274,"PANASAKAN, BAOLAN, TOLITOLI, SULAWESI TENGAH",16,79,39,118
https://kawalpemilu.org#68274,"PANASAKAN, BAOLAN, TOLITOLI, SULAWESI TENGAH",17,97,38,135
https://kawalpemilu.org#68274,"PANASAKAN, BAOLAN, TOLITOLI, SULAWESI TENGAH",18,25,55,80
https://kawalpemilu.org#68274,"PANASAKAN, BAOLAN, TOLITOLI, SULAWESI TENGAH",19,92,74,166
https://kawalpemilu.org#68274,"PANASAKAN, BAOLAN, TOLITOLI, SULAWESI TENGAH",20,84,96,180
https://kawalpemilu.org#68274,"PANASAKAN, BAOLAN, TOLITOLI, SULAWESI TENGAH",21,82,102,184
https://kawalpemilu.org#68274,"PANASAKAN, BAOLAN, TOLITOLI, SULAWESI TENGAH",22,55,63,118
https://kawalpemilu.org#68274,"PANASAKAN, BAOLAN, TOLITOLI, SULAWESI TENGAH",23,46,72,118
https://kawalpemilu.org#68274,"PANASAKAN, BAOLAN, TOLITOLI, SULAWESI TENGAH",24,60,73,133
https://kawalpemilu.org#68274,"PANASAKAN, BAOLAN, TOLITOLI, SULAWESI TENGAH",25,40,93,133
https://kawalpemilu.org#68274,"PANASAKAN, BAOLAN, TOLITOLI, SULAWESI TENGAH",26,86,146,234
https://kawalpemilu.org#68274,"PANASAKAN, BAOLAN, TOLITOLI, SULAWESI TENGAH",27,51,56,107
https://kawalpemilu.org#68274,"PANASAKAN, BAOLAN, TOLITOLI, SULAWESI TENGAH",28,72,76,148
https://kawalpemilu.org#68274,"PANASAKAN, BAOLAN, TOLITOLI, SULAWESI TENGAH",29,80,17,97
https://kawalpemilu.org#68274,"PANASAKAN, BAOLAN, TOLITOLI, SULAWESI TENGAH",31,44,61,105
https://kawalpemilu.org#68274,"PANASAKAN, BAOLAN, TOLITOLI, SULAWESI TENGAH",32,56,88,144
https://kawalpemilu.org#68275,"SIDOARJO, BAOLAN, TOLITOLI, SULAWESI TENGAH",1,41,103,144
https://kawalpemilu.org#68275,"SIDOARJO, BAOLAN, TOLITOLI, SULAWESI TENGAH",2,44,128,172
https://kawalpemilu.org#68275,"SIDOARJO, BAOLAN, TOLITOLI, SULAWESI TENGAH",3,75,45,120
https://kawalpemilu.org#68275,"SIDOARJO, BAOLAN, TOLITOLI, SULAWESI TENGAH",4,106,22,128
https://kawalpemilu.org#68275,"SIDOARJO, BAOLAN, TOLITOLI, SULAWESI TENGAH",5,115,68,183
https://kawalpemilu.org#68275,"SIDOARJO, BAOLAN, TOLITOLI, SULAWESI TENGAH",6,92,34,126
https://kawalpemilu.org#68275,"SIDOARJO, BAOLAN, TOLITOLI, SULAWESI TENGAH",7,66,101,167
https://kawalpemilu.org#68275,"SIDOARJO, BAOLAN, TOLITOLI, SULAWESI TENGAH",8,71,82,153
https://kawalpemilu.org#68275,"SIDOARJO, BAOLAN, TOLITOLI, SULAWESI TENGAH",9,104,78,182
https://kawalpemilu.org#68275,"SIDOARJO, BAOLAN, TOLITOLI, SULAWESI TENGAH",10,127,63,190
https://kawalpemilu.org#68275,"SIDOARJO, BAOLAN, TOLITOLI, SULAWESI TENGAH",11,71,117,188
https://kawalpemilu.org#68275,"SIDOARJO, BAOLAN, TOLITOLI, SULAWESI TENGAH",12,62,112,174
https://kawalpemilu.org#68275,"SIDOARJO, BAOLAN, TOLITOLI, SULAWESI TENGAH",13,100,165,265
https://kawalpemilu.org#68275,"SIDOARJO, BAOLAN, TOLITOLI, SULAWESI TENGAH",15,67,91,158
https://kawalpemilu.org#68275,"SIDOARJO, BAOLAN, TOLITOLI, SULAWESI TENGAH",16,127,58,185
https://kawalpemilu.org#68276,"TAMBUN, BAOLAN, TOLITOLI, SULAWESI TENGAH",1,70,180,250
https://kawalpemilu.org#68276,"TAMBUN, BAOLAN, TOLITOLI, SULAWESI TENGAH",2,52,130,182
https://kawalpemilu.org#68276,"TAMBUN, BAOLAN, TOLITOLI, SULAWESI TENGAH",3,72,105,177
https://kawalpemilu.org#68276,"TAMBUN, BAOLAN, TOLITOLI, SULAWESI TENGAH",4,123,125,248
https://kawalpemilu.org#68276,"TAMBUN, BAOLAN, TOLITOLI, SULAWESI TENGAH",5,93,100,193
https://kawalpemilu.org#68276,"TAMBUN, BAOLAN, TOLITOLI, SULAWESI TENGAH",6,84,141,225
https://kawalpemilu.org#68276,"TAMBUN, BAOLAN, TOLITOLI, SULAWESI TENGAH",7,62,108,170
https://kawalpemilu.org#68276,"TAMBUN, BAOLAN, TOLITOLI, SULAWESI TENGAH",8,55,92,0
https://kawalpemilu.org#68276,"TAMBUN, BAOLAN, TOLITOLI, SULAWESI TENGAH",9,81,86,167
https://kawalpemilu.org#68276,"TAMBUN, BAOLAN, TOLITOLI, SULAWESI TENGAH",10,40,196,236
https://kawalpemilu.org#68277,"DADAKITAN, BAOLAN, TOLITOLI, SULAWESI TENGAH",1,82,88,170
https://kawalpemilu.org#68277,"DADAKITAN, BAOLAN, TOLITOLI, SULAWESI TENGAH",2,85,68,153
https://kawalpemilu.org#68277,"DADAKITAN, BAOLAN, TOLITOLI, SULAWESI TENGAH",3,72,70,142
https://kawalpemilu.org#68277,"DADAKITAN, BAOLAN, TOLITOLI, SULAWESI TENGAH",4,93,120,213
https://kawalpemilu.org#68277,"DADAKITAN, BAOLAN, TOLITOLI, SULAWESI TENGAH",5,96,94,190
https://kawalpemilu.org#68277,"DADAKITAN, BAOLAN, TOLITOLI, SULAWESI TENGAH",6,68,71,139
https://kawalpemilu.org#68277,"DADAKITAN, BAOLAN, TOLITOLI, SULAWESI TENGAH",7,78,102,180
https://kawalpemilu.org#68277,"DADAKITAN, BAOLAN, TOLITOLI, SULAWESI TENGAH",8,120,50,170
https://kawalpemilu.org#68277,"DADAKITAN, BAOLAN, TOLITOLI, SULAWESI TENGAH",9,139,64,203
https://kawalpemilu.org#68277,"DADAKITAN, BAOLAN, TOLITOLI, SULAWESI TENGAH",10,104,71,175
https://kawalpemilu.org#68280,"BUNTUNA, BAOLAN, TOLITOLI, SULAWESI TENGAH",1,99,141,240
https://kawalpemilu.org#68280,"BUNTUNA, BAOLAN, TOLITOLI, SULAWESI TENGAH",2,59,110,169
https://kawalpemilu.org#68280,"BUNTUNA, BAOLAN, TOLITOLI, SULAWESI TENGAH",3,73,114,187
https://kawalpemilu.org#68280,"BUNTUNA, BAOLAN, TOLITOLI, SULAWESI TENGAH",4,50,90,140
https://kawalpemilu.org#68280,"BUNTUNA, BAOLAN, TOLITOLI, SULAWESI TENGAH",5,81,98,179
https://kawalpemilu.org#68280,"BUNTUNA, BAOLAN, TOLITOLI, SULAWESI TENGAH",6,77,89,166
https://kawalpemilu.org#68280,"BUNTUNA, BAOLAN, TOLITOLI, SULAWESI TENGAH",7,82,106,188
https://kawalpemilu.org#68280,"BUNTUNA, BAOLAN, TOLITOLI, SULAWESI TENGAH",8,56,62,118
https://kawalpemilu.org#68280,"BUNTUNA, BAOLAN, TOLITOLI, SULAWESI TENGAH",9,83,97,180
https://kawalpemilu.org#68281,"LELEAN NONO, BAOLAN, TOLITOLI, SULAWESI TENGAH",1,38,106,144
https://kawalpemilu.org#68281,"LELEAN NONO, BAOLAN, TOLITOLI, SULAWESI TENGAH",2,32,94,126
https://kawalpemilu.org#68281,"LELEAN NONO, BAOLAN, TOLITOLI, SULAWESI TENGAH",3,99,123,222
https://kawalpemilu.org#68281,"LELEAN NONO, BAOLAN, TOLITOLI, SULAWESI TENGAH",4,64,126,190
https://kawalpemilu.org#68281,"LELEAN NONO, BAOLAN, TOLITOLI, SULAWESI TENGAH",5,67,63,130
https://kawalpemilu.org#68281,"LELEAN NONO, BAOLAN, TOLITOLI, SULAWESI TENGAH",6,101,121,222
https://kawalpemilu.org#68281,"LELEAN NONO, BAOLAN, TOLITOLI, SULAWESI TENGAH",7,93,81,174
https://kawalpemilu.org#928620,"PANGI, BAOLAN, TOLITOLI, SULAWESI TENGAH",1,39,108,147
https://kawalpemilu.org#928620,"PANGI, BAOLAN, TOLITOLI, SULAWESI TENGAH",2,48,97,145
https://kawalpemilu.org#928620,"PANGI, BAOLAN, TOLITOLI, SULAWESI TENGAH",3,36,94,130
https://kawalpemilu.org#928620,"PANGI, BAOLAN, TOLITOLI, SULAWESI TENGAH",4,66,74,140
https://kawalpemilu.org#68283,"OGOMOLI, GALANG, TOLITOLI, SULAWESI TENGAH",1,166,65,231
https://kawalpemilu.org#68283,"OGOMOLI, GALANG, TOLITOLI, SULAWESI TENGAH",2,131,88,219
https://kawalpemilu.org#68283,"OGOMOLI, GALANG, TOLITOLI, SULAWESI TENGAH",3,79,94,173
https://kawalpemilu.org#68283,"OGOMOLI, GALANG, TOLITOLI, SULAWESI TENGAH",4,142,86,228
https://kawalpemilu.org#68283,"OGOMOLI, GALANG, TOLITOLI, SULAWESI TENGAH",5,75,80,155
https://kawalpemilu.org#68283,"OGOMOLI, GALANG, TOLITOLI, SULAWESI TENGAH",6,110,99,209
https://kawalpemilu.org#68283,"OGOMOLI, GALANG, TOLITOLI, SULAWESI TENGAH",7,76,135,211
https://kawalpemilu.org#68283,"OGOMOLI, GALANG, TOLITOLI, SULAWESI TENGAH",8,52,116,168
https://kawalpemilu.org#68283,"OGOMOLI, GALANG, TOLITOLI, SULAWESI TENGAH",9,107,78,185
https://kawalpemilu.org#68284,"SANDANA, GALANG, TOLITOLI, SULAWESI TENGAH",1,64,84,148
https://kawalpemilu.org#68284,"SANDANA, GALANG, TOLITOLI, SULAWESI TENGAH",2,96,103,199
https://kawalpemilu.org#68284,"SANDANA, GALANG, TOLITOLI, SULAWESI TENGAH",3,80,57,137
https://kawalpemilu.org#68284,"SANDANA, GALANG, TOLITOLI, SULAWESI TENGAH",4,130,69,199
https://kawalpemilu.org#68284,"SANDANA, GALANG, TOLITOLI, SULAWESI TENGAH",5,121,95,216
https://kawalpemilu.org#68284,"SANDANA, GALANG, TOLITOLI, SULAWESI TENGAH",6,80,109,189
https://kawalpemilu.org#68284,"SANDANA, GALANG, TOLITOLI, SULAWESI TENGAH",7,74,69,143
https://kawalpemilu.org#68285,"KALANGKANGAN, GALANG, TOLITOLI, SULAWESI TENGAH",1,110,76,186
https://kawalpemilu.org#68285,"KALANGKANGAN, GALANG, TOLITOLI, SULAWESI TENGAH",2,83,149,232
https://kawalpemilu.org#68285,"KALANGKANGAN, GALANG, TOLITOLI, SULAWESI TENGAH",3,110,112,222
https://kawalpemilu.org#68285,"KALANGKANGAN, GALANG, TOLITOLI, SULAWESI TENGAH",4,102,143,245
https://kawalpemilu.org#68285,"KALANGKANGAN, GALANG, TOLITOLI, SULAWESI TENGAH",5,58,150,208
https://kawalpemilu.org#68285,"KALANGKANGAN, GALANG, TOLITOLI, SULAWESI TENGAH",7,82,144,226
https://kawalpemilu.org#68285,"KALANGKANGAN, GALANG, TOLITOLI, SULAWESI TENGAH",8,133,112,245
https://kawalpemilu.org#68285,"KALANGKANGAN, GALANG, TOLITOLI, SULAWESI TENGAH",9,105,64,169
https://kawalpemilu.org#68285,"KALANGKANGAN, GALANG, TOLITOLI, SULAWESI TENGAH",10,149,101,250
https://kawalpemilu.org#68285,"KALANGKANGAN, GALANG, TOLITOLI, SULAWESI TENGAH",11,100,97,197
https://kawalpemilu.org#68285,"KALANGKANGAN, GALANG, TOLITOLI, SULAWESI TENGAH",12,97,123,220
https://kawalpemilu.org#68286,"LANTAPAN, GALANG, TOLITOLI, SULAWESI TENGAH",2,107,119,226
https://kawalpemilu.org#68286,"LANTAPAN, GALANG, TOLITOLI, SULAWESI TENGAH",3,169,43,212
https://kawalpemilu.org#68287,"LAKATAN, GALANG, TOLITOLI, SULAWESI TENGAH",1,91,111,202
https://kawalpemilu.org#68287,"LAKATAN, GALANG, TOLITOLI, SULAWESI TENGAH",2,118,124,242
https://kawalpemilu.org#68287,"LAKATAN, GALANG, TOLITOLI, SULAWESI TENGAH",3,77,99,176
https://kawalpemilu.org#68287,"LAKATAN, GALANG, TOLITOLI, SULAWESI TENGAH",4,78,117,195
https://kawalpemilu.org#68287,"LAKATAN, GALANG, TOLITOLI, SULAWESI TENGAH",5,57,119,176
https://kawalpemilu.org#68287,"LAKATAN, GALANG, TOLITOLI, SULAWESI TENGAH",6,124,101,225
https://kawalpemilu.org#68287,"LAKATAN, GALANG, TOLITOLI, SULAWESI TENGAH",7,79,131,210
https://kawalpemilu.org#68287,"LAKATAN, GALANG, TOLITOLI, SULAWESI TENGAH",8,161,51,212
https://kawalpemilu.org#68287,"LAKATAN, GALANG, TOLITOLI, SULAWESI TENGAH",9,114,135,249
https://kawalpemilu.org#68288,"TINIGI, GALANG, TOLITOLI, SULAWESI TENGAH",1,110,126,236
https://kawalpemilu.org#68288,"TINIGI, GALANG, TOLITOLI, SULAWESI TENGAH",2,82,102,184
https://kawalpemilu.org#68288,"TINIGI, GALANG, TOLITOLI, SULAWESI TENGAH",3,80,160,240
https://kawalpemilu.org#68288,"TINIGI, GALANG, TOLITOLI, SULAWESI TENGAH",4,58,161,219
https://kawalpemilu.org#68288,"TINIGI, GALANG, TOLITOLI, SULAWESI TENGAH",5,72,136,208
https://kawalpemilu.org#68288,"TINIGI, GALANG, TOLITOLI, SULAWESI TENGAH",6,108,104,212
https://kawalpemilu.org#68288,"TINIGI, GALANG, TOLITOLI, SULAWESI TENGAH",7,88,109,197
https://kawalpemilu.org#68288,"TINIGI, GALANG, TOLITOLI, SULAWESI TENGAH",8,111,97,208
https://kawalpemilu.org#68288,"TINIGI, GALANG, TOLITOLI, SULAWESI TENGAH",9,82,115,197
https://kawalpemilu.org#68288,"TINIGI, GALANG, TOLITOLI, SULAWESI TENGAH",10,71,141,212
https://kawalpemilu.org#68288,"TINIGI, GALANG, TOLITOLI, SULAWESI TENGAH",11,73,94,167
https://kawalpemilu.org#68288,"TINIGI, GALANG, TOLITOLI, SULAWESI TENGAH",12,21,172,193
https://kawalpemilu.org#68288,"TINIGI, GALANG, TOLITOLI, SULAWESI TENGAH",13,39,102,141
https://kawalpemilu.org#68288,"TINIGI, GALANG, TOLITOLI, SULAWESI TENGAH",14,98,159,257
https://kawalpemilu.org#68289,"GINUNGGUNG, GALANG, TOLITOLI, SULAWESI TENGAH",1,79,63,142
https://kawalpemilu.org#68289,"GINUNGGUNG, GALANG, TOLITOLI, SULAWESI TENGAH",2,157,64,221
https://kawalpemilu.org#68289,"GINUNGGUNG, GALANG, TOLITOLI, SULAWESI TENGAH",3,49,98,147
https://kawalpemilu.org#68289,"GINUNGGUNG, GALANG, TOLITOLI, SULAWESI TENGAH",4,86,140,226
https://kawalpemilu.org#68289,"GINUNGGUNG, GALANG, TOLITOLI, SULAWESI TENGAH",5,143,124,267
https://kawalpemilu.org#68289,"GINUNGGUNG, GALANG, TOLITOLI, SULAWESI TENGAH",6,89,149,238
https://kawalpemilu.org#68290,"LALOS, GALANG, TOLITOLI, SULAWESI TENGAH",1,99,161,260
https://kawalpemilu.org#68290,"LALOS, GALANG, TOLITOLI, SULAWESI TENGAH",2,89,144,233
https://kawalpemilu.org#68290,"LALOS, GALANG, TOLITOLI, SULAWESI TENGAH",3,79,132,211
https://kawalpemilu.org#68290,"LALOS, GALANG, TOLITOLI, SULAWESI TENGAH",4,78,152,230
https://kawalpemilu.org#68290,"LALOS, GALANG, TOLITOLI, SULAWESI TENGAH",5,81,133,214
https://kawalpemilu.org#68290,"LALOS, GALANG, TOLITOLI, SULAWESI TENGAH",6,98,67,165
https://kawalpemilu.org#68290,"LALOS, GALANG, TOLITOLI, SULAWESI TENGAH",7,135,92,227
https://kawalpemilu.org#68290,"LALOS, GALANG, TOLITOLI, SULAWESI TENGAH",8,108,75,183
https://kawalpemilu.org#68291,"TENDE, GALANG, TOLITOLI, SULAWESI TENGAH",1,106,97,203
https://kawalpemilu.org#68291,"TENDE, GALANG, TOLITOLI, SULAWESI TENGAH",2,152,86,238
https://kawalpemilu.org#68291,"TENDE, GALANG, TOLITOLI, SULAWESI TENGAH",3,101,118,219
https://kawalpemilu.org#68291,"TENDE, GALANG, TOLITOLI, SULAWESI TENGAH",4,80,125,205
https://kawalpemilu.org#68291,"TENDE, GALANG, TOLITOLI, SULAWESI TENGAH",5,94,85,179
https://kawalpemilu.org#68292,"SABANG, GALANG, TOLITOLI, SULAWESI TENGAH",1,108,64,172
https://kawalpemilu.org#68292,"SABANG, GALANG, TOLITOLI, SULAWESI TENGAH",2,27,62,89
https://kawalpemilu.org#68292,"SABANG, GALANG, TOLITOLI, SULAWESI TENGAH",3,71,114,185
https://kawalpemilu.org#68292,"SABANG, GALANG, TOLITOLI, SULAWESI TENGAH",4,63,70,133
https://kawalpemilu.org#68292,"SABANG, GALANG, TOLITOLI, SULAWESI TENGAH",5,145,73,218
https://kawalpemilu.org#68293,"BAJUGAN, GALANG, TOLITOLI, SULAWESI TENGAH",1,99,124,223
https://kawalpemilu.org#68293,"BAJUGAN, GALANG, TOLITOLI, SULAWESI TENGAH",2,57,71,128
https://kawalpemilu.org#68293,"BAJUGAN, GALANG, TOLITOLI, SULAWESI TENGAH",3,102,75,177
https://kawalpemilu.org#68293,"BAJUGAN, GALANG, TOLITOLI, SULAWESI TENGAH",4,87,107,194
https://kawalpemilu.org#68293,"BAJUGAN, GALANG, TOLITOLI, SULAWESI TENGAH",5,103,105,208
https://kawalpemilu.org#68293,"BAJUGAN, GALANG, TOLITOLI, SULAWESI TENGAH",6,124,97,221
https://kawalpemilu.org#68293,"BAJUGAN, GALANG, TOLITOLI, SULAWESI TENGAH",7,105,6,111
https://kawalpemilu.org#68293,"BAJUGAN, GALANG, TOLITOLI, SULAWESI TENGAH",8,126,18,144
https://kawalpemilu.org#68293,"BAJUGAN, GALANG, TOLITOLI, SULAWESI TENGAH",9,75,144,219
https://kawalpemilu.org#928621,"AUNG, GALANG, TOLITOLI, SULAWESI TENGAH",1,71,102,173
https://kawalpemilu.org#928621,"AUNG, GALANG, TOLITOLI, SULAWESI TENGAH",2,62,109,171
https://kawalpemilu.org#928621,"AUNG, GALANG, TOLITOLI, SULAWESI TENGAH",3,101,98,199
https://kawalpemilu.org#928621,"AUNG, GALANG, TOLITOLI, SULAWESI TENGAH",4,99,92,191
https://kawalpemilu.org#928621,"AUNG, GALANG, TOLITOLI, SULAWESI TENGAH",5,77,103,180
https://kawalpemilu.org#928621,"AUNG, GALANG, TOLITOLI, SULAWESI TENGAH",6,82,73,155
https://kawalpemilu.org#928622,"MALANGGA, GALANG, TOLITOLI, SULAWESI TENGAH",1,98,140,238
https://kawalpemilu.org#928622,"MALANGGA, GALANG, TOLITOLI, SULAWESI TENGAH",2,30,166,196
https://kawalpemilu.org#928622,"MALANGGA, GALANG, TOLITOLI, SULAWESI TENGAH",3,121,109,230
https://kawalpemilu.org#928622,"MALANGGA, GALANG, TOLITOLI, SULAWESI TENGAH",4,52,166,218
https://kawalpemilu.org#928623,"KINOPASAN, GALANG, TOLITOLI, SULAWESI TENGAH",1,68,149,217
https://kawalpemilu.org#928623,"KINOPASAN, GALANG, TOLITOLI, SULAWESI TENGAH",2,102,118,220
https://kawalpemilu.org#928623,"KINOPASAN, GALANG, TOLITOLI, SULAWESI TENGAH",3,39,94,133
https://kawalpemilu.org#928623,"KINOPASAN, GALANG, TOLITOLI, SULAWESI TENGAH",4,134,89,223
https://kawalpemilu.org#928623,"KINOPASAN, GALANG, TOLITOLI, SULAWESI TENGAH",5,61,114,175
https://kawalpemilu.org#68295,"TIMBOLO, TOLI-TOLI UTARA, TOLITOLI, SULAWESI TENGAH",1,128,75,203
https://kawalpemilu.org#68295,"TIMBOLO, TOLI-TOLI UTARA, TOLITOLI, SULAWESI TENGAH",2,138,59,197
https://kawalpemilu.org#68296,"TELUK JAYA, TOLI-TOLI UTARA, TOLITOLI, SULAWESI TENGAH",1,159,15,174
https://kawalpemilu.org#68296,"TELUK JAYA, TOLI-TOLI UTARA, TOLITOLI, SULAWESI TENGAH",2,132,32,164
https://kawalpemilu.org#68296,"TELUK JAYA, TOLI-TOLI UTARA, TOLITOLI, SULAWESI TENGAH",3,113,70,183
https://kawalpemilu.org#68296,"TELUK JAYA, TOLI-TOLI UTARA, TOLITOLI, SULAWESI TENGAH",4,132,11,143
https://kawalpemilu.org#68297,"SANTIGI, TOLI-TOLI UTARA, TOLITOLI, SULAWESI TENGAH",1,104,55,159
https://kawalpemilu.org#68297,"SANTIGI, TOLI-TOLI UTARA, TOLITOLI, SULAWESI TENGAH",2,87,65,152
https://kawalpemilu.org#68297,"SANTIGI, TOLI-TOLI UTARA, TOLITOLI, SULAWESI TENGAH",3,81,68,149
https://kawalpemilu.org#68298,"LAULALANG, TOLI-TOLI UTARA, TOLITOLI, SULAWESI TENGAH",1,82,95,177
https://kawalpemilu.org#68298,"LAULALANG, TOLI-TOLI UTARA, TOLITOLI, SULAWESI TENGAH",2,116,98,214
https://kawalpemilu.org#68298,"LAULALANG, TOLI-TOLI UTARA, TOLITOLI, SULAWESI TENGAH",3,78,108,186
https://kawalpemilu.org#68298,"LAULALANG, TOLI-TOLI UTARA, TOLITOLI, SULAWESI TENGAH",4,113,92,205
https://kawalpemilu.org#68298,"LAULALANG, TOLI-TOLI UTARA, TOLITOLI, SULAWESI TENGAH",5,125,72,197
https://kawalpemilu.org#68298,"LAULALANG, TOLI-TOLI UTARA, TOLITOLI, SULAWESI TENGAH",6,102,141,243
https://kawalpemilu.org#68298,"LAULALANG, TOLI-TOLI UTARA, TOLITOLI, SULAWESI TENGAH",7,56,66,122
https://kawalpemilu.org#68298,"LAULALANG, TOLI-TOLI UTARA, TOLITOLI, SULAWESI TENGAH",8,70,57,127
https://kawalpemilu.org#68298,"LAULALANG, TOLI-TOLI UTARA, TOLITOLI, SULAWESI TENGAH",9,142,24,166
https://kawalpemilu.org#68298,"LAULALANG, TOLI-TOLI UTARA, TOLITOLI, SULAWESI TENGAH",10,136,32,168
https://kawalpemilu.org#68298,"LAULALANG, TOLI-TOLI UTARA, TOLITOLI, SULAWESI TENGAH",11,148,11,159
https://kawalpemilu.org#68299,"SALUMPAGA, TOLI-TOLI UTARA, TOLITOLI, SULAWESI TENGAH",1,110,139,248
https://kawalpemilu.org#68299,"SALUMPAGA, TOLI-TOLI UTARA, TOLITOLI, SULAWESI TENGAH",2,79,155,234
https://kawalpemilu.org#68299,"SALUMPAGA, TOLI-TOLI UTARA, TOLITOLI, SULAWESI TENGAH",3,77,138,215
https://kawalpemilu.org#68299,"SALUMPAGA, TOLI-TOLI UTARA, TOLITOLI, SULAWESI TENGAH",4,44,103,147
https://kawalpemilu.org#68299,"SALUMPAGA, TOLI-TOLI UTARA, TOLITOLI, SULAWESI TENGAH",5,62,84,146
https://kawalpemilu.org#68299,"SALUMPAGA, TOLI-TOLI UTARA, TOLITOLI, SULAWESI TENGAH",6,81,112,193
https://kawalpemilu.org#68299,"SALUMPAGA, TOLI-TOLI UTARA, TOLITOLI, SULAWESI TENGAH",7,136,100,236
https://kawalpemilu.org#68299,"SALUMPAGA, TOLI-TOLI UTARA, TOLITOLI, SULAWESI TENGAH",8,89,89,178
https://kawalpemilu.org#68299,"SALUMPAGA, TOLI-TOLI UTARA, TOLITOLI, SULAWESI TENGAH",9,93,85,178
https://kawalpemilu.org#68299,"SALUMPAGA, TOLI-TOLI UTARA, TOLITOLI, SULAWESI TENGAH",10,111,98,209
https://kawalpemilu.org#68299,"SALUMPAGA, TOLI-TOLI UTARA, TOLITOLI, SULAWESI TENGAH",11,126,88,214
https://kawalpemilu.org#68299,"SALUMPAGA, TOLI-TOLI UTARA, TOLITOLI, SULAWESI TENGAH",12,144,61,205
https://kawalpemilu.org#68299,"SALUMPAGA, TOLI-TOLI UTARA, TOLITOLI, SULAWESI TENGAH",13,76,48,124
https://kawalpemilu.org#68299,"SALUMPAGA, TOLI-TOLI UTARA, TOLITOLI, SULAWESI TENGAH",14,73,45,118
https://kawalpemilu.org#68300,"DIULE, TOLI-TOLI UTARA, TOLITOLI, SULAWESI TENGAH",1,64,49,113
https://kawalpemilu.org#68300,"DIULE, TOLI-TOLI UTARA, TOLITOLI, SULAWESI TENGAH",2,102,111,213
https://kawalpemilu.org#68300,"DIULE, TOLI-TOLI UTARA, TOLITOLI, SULAWESI TENGAH",3,71,88,159
https://kawalpemilu.org#68300,"DIULE, TOLI-TOLI UTARA, TOLITOLI, SULAWESI TENGAH",4,113,127,240
https://kawalpemilu.org#68300,"DIULE, TOLI-TOLI UTARA, TOLITOLI, SULAWESI TENGAH",5,100,38,138
https://kawalpemilu.org#68301,"PINJAN, TOLI-TOLI UTARA, TOLITOLI, SULAWESI TENGAH",1,89,124,213
https://kawalpemilu.org#68301,"PINJAN, TOLI-TOLI UTARA, TOLITOLI, SULAWESI TENGAH",2,68,106,174
https://kawalpemilu.org#68301,"PINJAN, TOLI-TOLI UTARA, TOLITOLI, SULAWESI TENGAH",3,77,130,207
https://kawalpemilu.org#68301,"PINJAN, TOLI-TOLI UTARA, TOLITOLI, SULAWESI TENGAH",4,64,59,123
https://kawalpemilu.org#68301,"PINJAN, TOLI-TOLI UTARA, TOLITOLI, SULAWESI TENGAH",5,61,64,125
https://kawalpemilu.org#68301,"PINJAN, TOLI-TOLI UTARA, TOLITOLI, SULAWESI TENGAH",6,83,98,181
https://kawalpemilu.org#68302,"BINONTOAN, TOLI-TOLI UTARA, TOLITOLI, SULAWESI TENGAH",1,96,51,147
https://kawalpemilu.org#68302,"BINONTOAN, TOLI-TOLI UTARA, TOLITOLI, SULAWESI TENGAH",2,121,68,189
https://kawalpemilu.org#68302,"BINONTOAN, TOLI-TOLI UTARA, TOLITOLI, SULAWESI TENGAH",3,128,32,160
https://kawalpemilu.org#68302,"BINONTOAN, TOLI-TOLI UTARA, TOLITOLI, SULAWESI TENGAH",4,130,45,175
https://kawalpemilu.org#68302,"BINONTOAN, TOLI-TOLI UTARA, TOLITOLI, SULAWESI TENGAH",5,92,74,166
https://kawalpemilu.org#68302,"BINONTOAN, TOLI-TOLI UTARA, TOLITOLI, SULAWESI TENGAH",6,133,41,174
https://kawalpemilu.org#68302,"BINONTOAN, TOLI-TOLI UTARA, TOLITOLI, SULAWESI TENGAH",7,78,45,123
https://kawalpemilu.org#68303,"LAKUAN TOLI-TOLI, TOLI-TOLI UTARA, TOLITOLI, SULAWESI TENGAH",1,141,72,213
https://kawalpemilu.org#68303,"LAKUAN TOLI-TOLI, TOLI-TOLI UTARA, TOLITOLI, SULAWESI TENGAH",2,119,63,182
https://kawalpemilu.org#68303,"LAKUAN TOLI-TOLI, TOLI-TOLI UTARA, TOLITOLI, SULAWESI TENGAH",3,79,92,171
https://kawalpemilu.org#68303,"LAKUAN TOLI-TOLI, TOLI-TOLI UTARA, TOLITOLI, SULAWESI TENGAH",4,69,75,144
https://kawalpemilu.org#68303,"LAKUAN TOLI-TOLI, TOLI-TOLI UTARA, TOLITOLI, SULAWESI TENGAH",5,100,74,174
https://kawalpemilu.org#68303,"LAKUAN TOLI-TOLI, TOLI-TOLI UTARA, TOLITOLI, SULAWESI TENGAH",6,100,69,169
https://kawalpemilu.org#928624,"GIO, TOLI-TOLI UTARA, TOLITOLI, SULAWESI TENGAH",1,143,52,195
https://kawalpemilu.org#928624,"GIO, TOLI-TOLI UTARA, TOLITOLI, SULAWESI TENGAH",2,167,77,244
https://kawalpemilu.org#68305,"GALUMPANG, DAKO PEMEAN, TOLITOLI, SULAWESI TENGAH",1,95,105,200
https://kawalpemilu.org#68305,"GALUMPANG, DAKO PEMEAN, TOLITOLI, SULAWESI TENGAH",2,89,108,197
https://kawalpemilu.org#68305,"GALUMPANG, DAKO PEMEAN, TOLITOLI, SULAWESI TENGAH",3,95,77,172
https://kawalpemilu.org#68305,"GALUMPANG, DAKO PEMEAN, TOLITOLI, SULAWESI TENGAH",4,89,71,160
https://kawalpemilu.org#68305,"GALUMPANG, DAKO PEMEAN, TOLITOLI, SULAWESI TENGAH",5,81,89,170
https://kawalpemilu.org#68305,"GALUMPANG, DAKO PEMEAN, TOLITOLI, SULAWESI TENGAH",6,95,134,229
https://kawalpemilu.org#68305,"GALUMPANG, DAKO PEMEAN, TOLITOLI, SULAWESI TENGAH",7,90,66,156
https://kawalpemilu.org#68305,"GALUMPANG, DAKO PEMEAN, TOLITOLI, SULAWESI TENGAH",8,107,71,178
https://kawalpemilu.org#68305,"GALUMPANG, DAKO PEMEAN, TOLITOLI, SULAWESI TENGAH",9,113,58,171
https://kawalpemilu.org#68306,"DUNGINGIS, DAKO PEMEAN, TOLITOLI, SULAWESI TENGAH",1,136,124,260
https://kawalpemilu.org#68306,"DUNGINGIS, DAKO PEMEAN, TOLITOLI, SULAWESI TENGAH",2,149,110,259
https://kawalpemilu.org#68306,"DUNGINGIS, DAKO PEMEAN, TOLITOLI, SULAWESI TENGAH",3,87,104,191
https://kawalpemilu.org#68306,"DUNGINGIS, DAKO PEMEAN, TOLITOLI, SULAWESI TENGAH",4,63,121,184
https://kawalpemilu.org#68306,"DUNGINGIS, DAKO PEMEAN, TOLITOLI, SULAWESI TENGAH",5,115,144,259
https://kawalpemilu.org#68306,"DUNGINGIS, DAKO PEMEAN, TOLITOLI, SULAWESI TENGAH",6,14,127,141
https://kawalpemilu.org#68306,"DUNGINGIS, DAKO PEMEAN, TOLITOLI, SULAWESI TENGAH",7,64,88,152
https://kawalpemilu.org#68307,"KAPAS, DAKO PEMEAN, TOLITOLI, SULAWESI TENGAH",1,53,125,178
https://kawalpemilu.org#68307,"KAPAS, DAKO PEMEAN, TOLITOLI, SULAWESI TENGAH",2,104,91,195
https://kawalpemilu.org#68307,"KAPAS, DAKO PEMEAN, TOLITOLI, SULAWESI TENGAH",3,81,79,160
https://kawalpemilu.org#68307,"KAPAS, DAKO PEMEAN, TOLITOLI, SULAWESI TENGAH",4,97,85,182
https://kawalpemilu.org#68307,"KAPAS, DAKO PEMEAN, TOLITOLI, SULAWESI TENGAH",5,82,78,160
https://kawalpemilu.org#68308,"LINGADAN, DAKO PEMEAN, TOLITOLI, SULAWESI TENGAH",1,104,111,215
https://kawalpemilu.org#68308,"LINGADAN, DAKO PEMEAN, TOLITOLI, SULAWESI TENGAH",2,79,100,179
https://kawalpemilu.org#68308,"LINGADAN, DAKO PEMEAN, TOLITOLI, SULAWESI TENGAH",3,64,84,148
https://kawalpemilu.org#68308,"LINGADAN, DAKO PEMEAN, TOLITOLI, SULAWESI TENGAH",4,52,69,121
https://kawalpemilu.org#68308,"LINGADAN, DAKO PEMEAN, TOLITOLI, SULAWESI TENGAH",5,89,52,141
https://kawalpemilu.org#68308,"LINGADAN, DAKO PEMEAN, TOLITOLI, SULAWESI TENGAH",6,135,75,210
https://kawalpemilu.org#68308,"LINGADAN, DAKO PEMEAN, TOLITOLI, SULAWESI TENGAH",7,45,64,109
https://kawalpemilu.org#68308,"LINGADAN, DAKO PEMEAN, TOLITOLI, SULAWESI TENGAH",8,70,61,131
https://kawalpemilu.org#68308,"LINGADAN, DAKO PEMEAN, TOLITOLI, SULAWESI TENGAH",9,64,25,89
https://kawalpemilu.org#68308,"LINGADAN, DAKO PEMEAN, TOLITOLI, SULAWESI TENGAH",10,125,65,190
https://kawalpemilu.org#68311,"MOMUNU, MOMUNU, BUOL, SULAWESI TENGAH",1,172,48,220
https://kawalpemilu.org#68311,"MOMUNU, MOMUNU, BUOL, SULAWESI TENGAH",2,170,56,226
https://kawalpemilu.org#68312,"PINAMULA, MOMUNU, BUOL, SULAWESI TENGAH",1,95,72,167
https://kawalpemilu.org#68312,"PINAMULA, MOMUNU, BUOL, SULAWESI TENGAH",2,108,102,210
https://kawalpemilu.org#68312,"PINAMULA, MOMUNU, BUOL, SULAWESI TENGAH",3,88,85,173
https://kawalpemilu.org#68313,"PUJIMULYO, MOMUNU, BUOL, SULAWESI TENGAH",1,121,110,231
https://kawalpemilu.org#68313,"PUJIMULYO, MOMUNU, BUOL, SULAWESI TENGAH",2,151,83,234
https://kawalpemilu.org#68314,"TALUAN, MOMUNU, BUOL, SULAWESI TENGAH",1,144,33,177
https://kawalpemilu.org#68314,"TALUAN, MOMUNU, BUOL, SULAWESI TENGAH",2,132,37,169
https://kawalpemilu.org#68314,"TALUAN, MOMUNU, BUOL, SULAWESI TENGAH",3,137,41,178
https://kawalpemilu.org#68315,"POTUGU, MOMUNU, BUOL, SULAWESI TENGAH",1,114,76,190
https://kawalpemilu.org#68315,"POTUGU, MOMUNU, BUOL, SULAWESI TENGAH",2,99,97,196
https://kawalpemilu.org#68315,"POTUGU, MOMUNU, BUOL, SULAWESI TENGAH",3,119,71,190
https://kawalpemilu.org#68316,"PANIMBUL, MOMUNU, BUOL, SULAWESI TENGAH",1,110,88,198
https://kawalpemilu.org#68316,"PANIMBUL, MOMUNU, BUOL, SULAWESI TENGAH",2,105,55,160
https://kawalpemilu.org#68316,"PANIMBUL, MOMUNU, BUOL, SULAWESI TENGAH",3,126,32,158
https://kawalpemilu.org#68317,"TONGON, MOMUNU, BUOL, SULAWESI TENGAH",1,64,130,194
https://kawalpemilu.org#68317,"TONGON, MOMUNU, BUOL, SULAWESI TENGAH",2,114,86,200
https://kawalpemilu.org#68317,"TONGON, MOMUNU, BUOL, SULAWESI TENGAH",3,53,149,202
https://kawalpemilu.org#68317,"TONGON, MOMUNU, BUOL, SULAWESI TENGAH",4,91,100,191
https://kawalpemilu.org#68318,"LAMADONG II, MOMUNU, BUOL, SULAWESI TENGAH",1,104,80,184
https://kawalpemilu.org#68318,"LAMADONG II, MOMUNU, BUOL, SULAWESI TENGAH",2,90,103,193
https://kawalpemilu.org#68318,"LAMADONG II, MOMUNU, BUOL, SULAWESI TENGAH",3,107,88,195
https://kawalpemilu.org#68318,"LAMADONG II, MOMUNU, BUOL, SULAWESI TENGAH",4,106,101,207
https://kawalpemilu.org#68319,"POMAYAGON, MOMUNU, BUOL, SULAWESI TENGAH",1,137,58,195
https://kawalpemilu.org#68319,"POMAYAGON, MOMUNU, BUOL, SULAWESI TENGAH",2,128,58,186
https://kawalpemilu.org#68319,"POMAYAGON, MOMUNU, BUOL, SULAWESI TENGAH",3,101,87,188
https://kawalpemilu.org#68320,"GUAMONIAL, MOMUNU, BUOL, SULAWESI TENGAH",1,84,87,171
https://kawalpemilu.org#68320,"GUAMONIAL, MOMUNU, BUOL, SULAWESI TENGAH",2,96,62,158
https://kawalpemilu.org#68321,"LAMADONG I, MOMUNU, BUOL, SULAWESI TENGAH",1,80,154,234
https://kawalpemilu.org#68321,"LAMADONG I, MOMUNU, BUOL, SULAWESI TENGAH",2,58,143,201
https://kawalpemilu.org#68321,"LAMADONG I, MOMUNU, BUOL, SULAWESI TENGAH",3,54,155,209
https://kawalpemilu.org#68321,"LAMADONG I, MOMUNU, BUOL, SULAWESI TENGAH",4,54,147,201
https://kawalpemilu.org#68321,"LAMADONG I, MOMUNU, BUOL, SULAWESI TENGAH",5,58,120,178
https://kawalpemilu.org#68321,"LAMADONG I, MOMUNU, BUOL, SULAWESI TENGAH",6,72,97,169
https://kawalpemilu.org#68322,"PAJEKO, MOMUNU, BUOL, SULAWESI TENGAH",1,58,172,230
https://kawalpemilu.org#68322,"PAJEKO, MOMUNU, BUOL, SULAWESI TENGAH",2,41,164,205
https://kawalpemilu.org#68322,"PAJEKO, MOMUNU, BUOL, SULAWESI TENGAH",3,90,117,207
https://kawalpemilu.org#68322,"PAJEKO, MOMUNU, BUOL, SULAWESI TENGAH",4,66,158,224
https://kawalpemilu.org#68322,"PAJEKO, MOMUNU, BUOL, SULAWESI TENGAH",5,90,116,206
https://kawalpemilu.org#68322,"PAJEKO, MOMUNU, BUOL, SULAWESI TENGAH",6,76,107,183
https://kawalpemilu.org#68323,"WAKAT, MOMUNU, BUOL, SULAWESI TENGAH",1,129,82,211
https://kawalpemilu.org#68324,"SORAYA, MOMUNU, BUOL, SULAWESI TENGAH",1,190,49,239
https://kawalpemilu.org#68325,"MANGUBI, MOMUNU, BUOL, SULAWESI TENGAH",1,90,100,190
https://kawalpemilu.org#68325,"MANGUBI, MOMUNU, BUOL, SULAWESI TENGAH",2,72,123,195
https://kawalpemilu.org#89681,"PERMATA PUTIH, MOMUNU, BUOL, SULAWESI TENGAH",1,172,36,208
https://kawalpemilu.org#68327,"TAYADUN, BOKAT, BUOL, SULAWESI TENGAH",1,89,133,222
https://kawalpemilu.org#68327,"TAYADUN, BOKAT, BUOL, SULAWESI TENGAH",2,77,147,251
https://kawalpemilu.org#68327,"TAYADUN, BOKAT, BUOL, SULAWESI TENGAH",3,69,102,171
https://kawalpemilu.org#68328,"POONGAN, BOKAT, BUOL, SULAWESI TENGAH",1,133,43,176
https://kawalpemilu.org#68328,"POONGAN, BOKAT, BUOL, SULAWESI TENGAH",2,100,42,142
https://kawalpemilu.org#68328,"POONGAN, BOKAT, BUOL, SULAWESI TENGAH",3,65,9,74
https://kawalpemilu.org#68328,"POONGAN, BOKAT, BUOL, SULAWESI TENGAH",4,133,60,193
https://kawalpemilu.org#68328,"POONGAN, BOKAT, BUOL, SULAWESI TENGAH",5,51,19,70
https://kawalpemilu.org#68329,"BONGO, BOKAT, BUOL, SULAWESI TENGAH",1,71,122,193
https://kawalpemilu.org#68329,"BONGO, BOKAT, BUOL, SULAWESI TENGAH",2,65,110,175
https://kawalpemilu.org#68329,"BONGO, BOKAT, BUOL, SULAWESI TENGAH",3,83,102,185
https://kawalpemilu.org#68329,"BONGO, BOKAT, BUOL, SULAWESI TENGAH",4,88,103,191
https://kawalpemilu.org#68329,"BONGO, BOKAT, BUOL, SULAWESI TENGAH",5,118,115,233
https://kawalpemilu.org#68330,"DOULAN, BOKAT, BUOL, SULAWESI TENGAH",1,50,152,202
https://kawalpemilu.org#68330,"DOULAN, BOKAT, BUOL, SULAWESI TENGAH",2,50,169,219
https://kawalpemilu.org#68330,"DOULAN, BOKAT, BUOL, SULAWESI TENGAH",3,81,153,234
https://kawalpemilu.org#68331,"KANTANAN, BOKAT, BUOL, SULAWESI TENGAH",1,83,103,186
https://kawalpemilu.org#68331,"KANTANAN, BOKAT, BUOL, SULAWESI TENGAH",2,104,115,219
https://kawalpemilu.org#68331,"KANTANAN, BOKAT, BUOL, SULAWESI TENGAH",3,100,105,205
https://kawalpemilu.org#68332,"KODOLAGON, BOKAT, BUOL, SULAWESI TENGAH",1,117,85,202
https://kawalpemilu.org#68332,"KODOLAGON, BOKAT, BUOL, SULAWESI TENGAH",2,117,80,197
https://kawalpemilu.org#68332,"KODOLAGON, BOKAT, BUOL, SULAWESI TENGAH",3,95,117,212
https://kawalpemilu.org#68332,"KODOLAGON, BOKAT, BUOL, SULAWESI TENGAH",4,145,69,214
https://kawalpemilu.org#68333,"NEGERI LAMA, BOKAT, BUOL, SULAWESI TENGAH",1,90,124,214
https://kawalpemilu.org#68333,"NEGERI LAMA, BOKAT, BUOL, SULAWESI TENGAH",2,93,123,216
https://kawalpemilu.org#68333,"NEGERI LAMA, BOKAT, BUOL, SULAWESI TENGAH",3,93,110,203
https://kawalpemilu.org#68333,"NEGERI LAMA, BOKAT, BUOL, SULAWESI TENGAH",4,79,133,212
https://kawalpemilu.org#68334,"BOKAT IV, BOKAT, BUOL, SULAWESI TENGAH",1,112,85,197
https://kawalpemilu.org#68335,"BUTUKAN, BOKAT, BUOL, SULAWESI TENGAH",1,124,51,175
https://kawalpemilu.org#68335,"BUTUKAN, BOKAT, BUOL, SULAWESI TENGAH",2,96,56,152
https://kawalpemilu.org#68336,"BOKAT, BOKAT, BUOL, SULAWESI TENGAH",1,113,96,209
https://kawalpemilu.org#68336,"BOKAT, BOKAT, BUOL, SULAWESI TENGAH",2,80,157,237
https://kawalpemilu.org#68336,"BOKAT, BOKAT, BUOL, SULAWESI TENGAH",3,57,159,216
https://kawalpemilu.org#68336,"BOKAT, BOKAT, BUOL, SULAWESI TENGAH",4,74,154,228
https://kawalpemilu.org#68336,"BOKAT, BOKAT, BUOL, SULAWESI TENGAH",5,66,160,226
https://kawalpemilu.org#68337,"TIKOPO, BOKAT, BUOL, SULAWESI TENGAH",1,131,48,179
https://kawalpemilu.org#68338,"BUKAMOG, BOKAT, BUOL, SULAWESI TENGAH",1,51,179,230
https://kawalpemilu.org#68338,"BUKAMOG, BOKAT, BUOL, SULAWESI TENGAH",2,58,165,223
https://kawalpemilu.org#68338,"BUKAMOG, BOKAT, BUOL, SULAWESI TENGAH",3,119,125,244
https://kawalpemilu.org#68339,"TANG, BOKAT, BUOL, SULAWESI TENGAH",1,80,135,215
https://kawalpemilu.org#68339,"TANG, BOKAT, BUOL, SULAWESI TENGAH",2,115,122,237
https://kawalpemilu.org#68340,"DUAMAYO, BOKAT, BUOL, SULAWESI TENGAH",1,133,8,141
https://kawalpemilu.org#68340,"DUAMAYO, BOKAT, BUOL, SULAWESI TENGAH",2,94,8,102
https://kawalpemilu.org#68341,"LANGUDON, BOKAT, BUOL, SULAWESI TENGAH",1,128,41,169
https://kawalpemilu.org#68343,"LONU, BUNOBOGU, BUOL, SULAWESI TENGAH",1,63,115,178
https://kawalpemilu.org#68343,"LONU, BUNOBOGU, BUOL, SULAWESI TENGAH",2,47,133,180
https://kawalpemilu.org#68343,"LONU, BUNOBOGU, BUOL, SULAWESI TENGAH",3,52,137,189
https://kawalpemilu.org#68343,"LONU, BUNOBOGU, BUOL, SULAWESI TENGAH",4,39,140,179
https://kawalpemilu.org#68344,"TAMIT, BUNOBOGU, BUOL, SULAWESI TENGAH",1,127,90,217
https://kawalpemilu.org#68344,"TAMIT, BUNOBOGU, BUOL, SULAWESI TENGAH",2,149,84,233
https://kawalpemilu.org#68345,"BOTUGOLU, BUNOBOGU, BUOL, SULAWESI TENGAH",1,94,118,212
https://kawalpemilu.org#68345,"BOTUGOLU, BUNOBOGU, BUOL, SULAWESI TENGAH",2,85,139,224
https://kawalpemilu.org#68345,"BOTUGOLU, BUNOBOGU, BUOL, SULAWESI TENGAH",3,89,100,189
https://kawalpemilu.org#68346,"BUNOBOGU, BUNOBOGU, BUOL, SULAWESI TENGAH",1,88,86,174
https://kawalpemilu.org#68346,"BUNOBOGU, BUNOBOGU, BUOL, SULAWESI TENGAH",2,47,137,184
https://kawalpemilu.org#68346,"BUNOBOGU, BUNOBOGU, BUOL, SULAWESI TENGAH",3,73,113,186
https://kawalpemilu.org#68346,"BUNOBOGU, BUNOBOGU, BUOL, SULAWESI TENGAH",4,74,104,178
https://kawalpemilu.org#68346,"BUNOBOGU, BUNOBOGU, BUOL, SULAWESI TENGAH",5,102,112,214
https://kawalpemilu.org#68347,"KONAMUKAN, BUNOBOGU, BUOL, SULAWESI TENGAH",1,79,121,200
https://kawalpemilu.org#68347,"KONAMUKAN, BUNOBOGU, BUOL, SULAWESI TENGAH",2,85,112,197
https://kawalpemilu.org#68348,"PONIPINGAN, BUNOBOGU, BUOL, SULAWESI TENGAH",1,72,82,154
https://kawalpemilu.org#68348,"PONIPINGAN, BUNOBOGU, BUOL, SULAWESI TENGAH",2,72,92,164
https://kawalpemilu.org#68348,"PONIPINGAN, BUNOBOGU, BUOL, SULAWESI TENGAH",3,141,60,201
https://kawalpemilu.org#68349,"INALATAN, BUNOBOGU, BUOL, SULAWESI TENGAH",1,65,108,173
https://kawalpemilu.org#68349,"INALATAN, BUNOBOGU, BUOL, SULAWESI TENGAH",2,45,121,166
https://kawalpemilu.org#68349,"INALATAN, BUNOBOGU, BUOL, SULAWESI TENGAH",3,87,90,177
https://kawalpemilu.org#68350,"DOMAG MEKAR, BUNOBOGU, BUOL, SULAWESI TENGAH",1,79,103,182
https://kawalpemilu.org#68350,"DOMAG MEKAR, BUNOBOGU, BUOL, SULAWESI TENGAH",2,52,119,171
https://kawalpemilu.org#68350,"DOMAG MEKAR, BUNOBOGU, BUOL, SULAWESI TENGAH",3,62,106,168
https://kawalpemilu.org#68350,"DOMAG MEKAR, BUNOBOGU, BUOL, SULAWESI TENGAH",4,97,62,159
https://kawalpemilu.org#89683,"BUNOBOGU SELATAN, BUNOBOGU, BUOL, SULAWESI TENGAH",1,45,143,188
https://kawalpemilu.org#89683,"BUNOBOGU SELATAN, BUNOBOGU, BUOL, SULAWESI TENGAH",2,76,119,195
https://kawalpemilu.org#89683,"BUNOBOGU SELATAN, BUNOBOGU, BUOL, SULAWESI TENGAH",3,59,131,190
https://kawalpemilu.org#89684,"POKOBO, BUNOBOGU, BUOL, SULAWESI TENGAH",1,109,88,197
https://kawalpemilu.org#89684,"POKOBO, BUNOBOGU, BUOL, SULAWESI TENGAH",2,82,88,170
https://kawalpemilu.org#68352,"UMU, PALELEH, BUOL, SULAWESI TENGAH",1,168,72,240
https://kawalpemilu.org#68353,"MULANGATO, PALELEH, BUOL, SULAWESI TENGAH",1,112,79,191
https://kawalpemilu.org#68353,"MULANGATO, PALELEH, BUOL, SULAWESI TENGAH",2,132,70,202
https://kawalpemilu.org#68353,"MULANGATO, PALELEH, BUOL, SULAWESI TENGAH",3,115,59,174
https://kawalpemilu.org#68354,"LILITO, PALELEH, BUOL, SULAWESI TENGAH",1,132,95,227
https://kawalpemilu.org#68354,"LILITO, PALELEH, BUOL, SULAWESI TENGAH",2,122,76,199
https://kawalpemilu.org#68355,"TALAKI, PALELEH, BUOL, SULAWESI TENGAH",1,133,109,242
https://kawalpemilu.org#68355,"TALAKI, PALELEH, BUOL, SULAWESI TENGAH",2,168,81,249
https://kawalpemilu.org#68355,"TALAKI, PALELEH, BUOL, SULAWESI TENGAH",3,110,115,225
https://kawalpemilu.org#68356,"BATURATA, PALELEH, BUOL, SULAWESI TENGAH",1,62,98,160
https://kawalpemilu.org#68356,"BATURATA, PALELEH, BUOL, SULAWESI TENGAH",2,72,144,216
https://kawalpemilu.org#68356,"BATURATA, PALELEH, BUOL, SULAWESI TENGAH",3,35,115,150
https://kawalpemilu.org#68357,"KWALABESAR, PALELEH, BUOL, SULAWESI TENGAH",1,51,183,234
https://kawalpemilu.org#68357,"KWALABESAR, PALELEH, BUOL, SULAWESI TENGAH",2,42,86,128
https://kawalpemilu.org#68357,"KWALABESAR, PALELEH, BUOL, SULAWESI TENGAH",3,67,177,244
https://kawalpemilu.org#68357,"KWALABESAR, PALELEH, BUOL, SULAWESI TENGAH",4,34,200,234
https://kawalpemilu.org#68357,"KWALABESAR, PALELEH, BUOL, SULAWESI TENGAH",5,40,197,237
https://kawalpemilu.org#68357,"KWALABESAR, PALELEH, BUOL, SULAWESI TENGAH",6,64,191,255
https://kawalpemilu.org#68358,"TOLAU, PALELEH, BUOL, SULAWESI TENGAH",1,118,74,192
https://kawalpemilu.org#68358,"TOLAU, PALELEH, BUOL, SULAWESI TENGAH",2,136,71,207
https://kawalpemilu.org#68358,"TOLAU, PALELEH, BUOL, SULAWESI TENGAH",3,168,36,204
https://kawalpemilu.org#68358,"TOLAU, PALELEH, BUOL, SULAWESI TENGAH",4,148,47,195
https://kawalpemilu.org#68359,"PALELEH, PALELEH, BUOL, SULAWESI TENGAH",1,51,154,205
https://kawalpemilu.org#68359,"PALELEH, PALELEH, BUOL, SULAWESI TENGAH",2,81,119,200
https://kawalpemilu.org#68359,"PALELEH, PALELEH, BUOL, SULAWESI TENGAH",3,83,129,212
https://kawalpemilu.org#68359,"PALELEH, PALELEH, BUOL, SULAWESI TENGAH",4,62,126,188
https://kawalpemilu.org#68359,"PALELEH, PALELEH, BUOL, SULAWESI TENGAH",5,75,93,168
https://kawalpemilu.org#68360,"LINTIDU, PALELEH, BUOL, SULAWESI TENGAH",1,127,102,229
https://kawalpemilu.org#68360,"LINTIDU, PALELEH, BUOL, SULAWESI TENGAH",2,152,70,222
https://kawalpemilu.org#68361,"PIONOTO, PALELEH, BUOL, SULAWESI TENGAH",1,111,49,160
https://kawalpemilu.org#68361,"PIONOTO, PALELEH, BUOL, SULAWESI TENGAH",2,141,13,154
https://kawalpemilu.org#68362,"DOPALAK, PALELEH, BUOL, SULAWESI TENGAH",1,49,169,218
https://kawalpemilu.org#68362,"DOPALAK, PALELEH, BUOL, SULAWESI TENGAH",2,68,141,209
https://kawalpemilu.org#68362,"DOPALAK, PALELEH, BUOL, SULAWESI TENGAH",3,57,169,226
https://kawalpemilu.org#68363,"DOTUNO, PALELEH, BUOL, SULAWESI TENGAH",1,89,118,207
https://kawalpemilu.org#68363,"DOTUNO, PALELEH, BUOL, SULAWESI TENGAH",2,124,63,187
https://kawalpemilu.org#68363,"DOTUNO, PALELEH, BUOL, SULAWESI TENGAH",3,111,74,185
https://kawalpemilu.org#68365,"BOILAN, TILOAN, BUOL, SULAWESI TENGAH",1,122,34,156
https://kawalpemilu.org#68365,"BOILAN, TILOAN, BUOL, SULAWESI TENGAH",2,152,44,196
https://kawalpemilu.org#68365,"BOILAN, TILOAN, BUOL, SULAWESI TENGAH",3,149,89,238
https://kawalpemilu.org#68366,"KOKOBUKA, TILOAN, BUOL, SULAWESI TENGAH",1,55,130,185
https://kawalpemilu.org#68366,"KOKOBUKA, TILOAN, BUOL, SULAWESI TENGAH",2,135,80,215
https://kawalpemilu.org#68366,"KOKOBUKA, TILOAN, BUOL, SULAWESI TENGAH",3,97,102,199
https://kawalpemilu.org#68366,"KOKOBUKA, TILOAN, BUOL, SULAWESI TENGAH",4,77,21,98
https://kawalpemilu.org#68366,"KOKOBUKA, TILOAN, BUOL, SULAWESI TENGAH",5,61,35,96
https://kawalpemilu.org#68366,"KOKOBUKA, TILOAN, BUOL, SULAWESI TENGAH",6,84,115,199
https://kawalpemilu.org#68366,"KOKOBUKA, TILOAN, BUOL, SULAWESI TENGAH",7,94,38,132
https://kawalpemilu.org#68367,"AIR TERANG, TILOAN, BUOL, SULAWESI TENGAH",1,104,71,175
https://kawalpemilu.org#68367,"AIR TERANG, TILOAN, BUOL, SULAWESI TENGAH",2,119,107,226
https://kawalpemilu.org#68367,"AIR TERANG, TILOAN, BUOL, SULAWESI TENGAH",3,66,81,147
https://kawalpemilu.org#68367,"AIR TERANG, TILOAN, BUOL, SULAWESI TENGAH",4,87,113,200
https://kawalpemilu.org#68368,"PANILAN JAYA, TILOAN, BUOL, SULAWESI TENGAH",1,142,31,173
https://kawalpemilu.org#68368,"PANILAN JAYA, TILOAN, BUOL, SULAWESI TENGAH",2,135,33,168
https://kawalpemilu.org#68368,"PANILAN JAYA, TILOAN, BUOL, SULAWESI TENGAH",3,58,48,106
https://kawalpemilu.org#68368,"PANILAN JAYA, TILOAN, BUOL, SULAWESI TENGAH",4,144,29,173
https://kawalpemilu.org#68369,"JATIMULYA, TILOAN, BUOL, SULAWESI TENGAH",1,196,19,215
https://kawalpemilu.org#68369,"JATIMULYA, TILOAN, BUOL, SULAWESI TENGAH",2,125,61,186
https://kawalpemilu.org#68369,"JATIMULYA, TILOAN, BUOL, SULAWESI TENGAH",3,58,78,136
https://kawalpemilu.org#68369,"JATIMULYA, TILOAN, BUOL, SULAWESI TENGAH",4,176,24,200
https://kawalpemilu.org#68370,"LOMULI, TILOAN, BUOL, SULAWESI TENGAH",1,124,26,150
https://kawalpemilu.org#68370,"LOMULI, TILOAN, BUOL, SULAWESI TENGAH",2,97,25,122
https://kawalpemilu.org#68370,"LOMULI, TILOAN, BUOL, SULAWESI TENGAH",3,116,45,161
https://kawalpemilu.org#68371,"BALAU, TILOAN, BUOL, SULAWESI TENGAH",1,147,36,183
https://kawalpemilu.org#68371,"BALAU, TILOAN, BUOL, SULAWESI TENGAH",2,133,48,181
https://kawalpemilu.org#68372,"MANIALA, TILOAN, BUOL, SULAWESI TENGAH",1,200,59,259
https://kawalpemilu.org#68372,"MANIALA, TILOAN, BUOL, SULAWESI TENGAH",2,142,56,198
https://kawalpemilu.org#68372,"MANIALA, TILOAN, BUOL, SULAWESI TENGAH",3,107,63,170
https://kawalpemilu.org#68373,"MONGGONIT, TILOAN, BUOL, SULAWESI TENGAH",1,63,81,144
https://kawalpemilu.org#68373,"MONGGONIT, TILOAN, BUOL, SULAWESI TENGAH",2,23,40,63
https://kawalpemilu.org#68375,"BIAU, BUKAL, BUOL, SULAWESI TENGAH",1,140,74,214
https://kawalpemilu.org#68375,"BIAU, BUKAL, BUOL, SULAWESI TENGAH",2,141,76,217
https://kawalpemilu.org#68375,"BIAU, BUKAL, BUOL, SULAWESI TENGAH",3,114,71,185
https://kawalpemilu.org#68376,"BUNGKUDU, BUKAL, BUOL, SULAWESI TENGAH",1,98,80,178
https://kawalpemilu.org#68376,"BUNGKUDU, BUKAL, BUOL, SULAWESI TENGAH",2,133,58,191
https://kawalpemilu.org#68376,"BUNGKUDU, BUKAL, BUOL, SULAWESI TENGAH",3,72,160,232
https://kawalpemilu.org#68377,"RANTEMARANU, BUKAL, BUOL, SULAWESI TENGAH",1,152,22,174
https://kawalpemilu.org#68377,"RANTEMARANU, BUKAL, BUOL, SULAWESI TENGAH",2,135,37,172
https://kawalpemilu.org#68377,"RANTEMARANU, BUKAL, BUOL, SULAWESI TENGAH",3,174,17,191
https://kawalpemilu.org#68377,"RANTEMARANU, BUKAL, BUOL, SULAWESI TENGAH",4,135,48,183
https://kawalpemilu.org#68378,"WINANGUN, BUKAL, BUOL, SULAWESI TENGAH",1,175,10,185
https://kawalpemilu.org#68378,"WINANGUN, BUKAL, BUOL, SULAWESI TENGAH",2,161,67,228
https://kawalpemilu.org#68378,"WINANGUN, BUKAL, BUOL, SULAWESI TENGAH",3,43,50,93
https://kawalpemilu.org#68378,"WINANGUN, BUKAL, BUOL, SULAWESI TENGAH",4,40,32,72
https://kawalpemilu.org#68378,"WINANGUN, BUKAL, BUOL, SULAWESI TENGAH",5,109,51,160
https://kawalpemilu.org#68378,"WINANGUN, BUKAL, BUOL, SULAWESI TENGAH",6,49,45,94
https://kawalpemilu.org#68378,"WINANGUN, BUKAL, BUOL, SULAWESI TENGAH",7,122,40,162
https://kawalpemilu.org#68379,"MODO, BUKAL, BUOL, SULAWESI TENGAH",1,158,62,220
https://kawalpemilu.org#68379,"MODO, BUKAL, BUOL, SULAWESI TENGAH",2,185,41,226
https://kawalpemilu.org#68379,"MODO, BUKAL, BUOL, SULAWESI TENGAH",3,193,44,237
https://kawalpemilu.org#68379,"MODO, BUKAL, BUOL, SULAWESI TENGAH",4,121,110,231
https://kawalpemilu.org#68380,"UNONE, BUKAL, BUOL, SULAWESI TENGAH",1,120,103,223
https://kawalpemilu.org#68380,"UNONE, BUKAL, BUOL, SULAWESI TENGAH",2,121,110,231
https://kawalpemilu.org#68380,"UNONE, BUKAL, BUOL, SULAWESI TENGAH",3,123,119,242
https://kawalpemilu.org#68381,"MOPU, BUKAL, BUOL, SULAWESI TENGAH",1,111,64,175
https://kawalpemilu.org#68381,"MOPU, BUKAL, BUOL, SULAWESI TENGAH",2,111,89,200
https://kawalpemilu.org#68381,"MOPU, BUKAL, BUOL, SULAWESI TENGAH",3,67,59,126
https://kawalpemilu.org#68382,"DIAT, BUKAL, BUOL, SULAWESI TENGAH",1,134,129,263
https://kawalpemilu.org#68382,"DIAT, BUKAL, BUOL, SULAWESI TENGAH",2,142,106,248
https://kawalpemilu.org#68383,"POTANGOAN, BUKAL, BUOL, SULAWESI TENGAH",1,135,70,205
https://kawalpemilu.org#68383,"POTANGOAN, BUKAL, BUOL, SULAWESI TENGAH",2,110,59,169
https://kawalpemilu.org#68383,"POTANGOAN, BUKAL, BUOL, SULAWESI TENGAH",3,109,64,173
https://kawalpemilu.org#68383,"POTANGOAN, BUKAL, BUOL, SULAWESI TENGAH",4,147,96,243
https://kawalpemilu.org#68384,"BINUANG, BUKAL, BUOL, SULAWESI TENGAH",1,81,51,132
https://kawalpemilu.org#68385,"YUGUT, BUKAL, BUOL, SULAWESI TENGAH",1,120,64,184
https://kawalpemilu.org#68385,"YUGUT, BUKAL, BUOL, SULAWESI TENGAH",2,57,41,98
https://kawalpemilu.org#68385,"YUGUT, BUKAL, BUOL, SULAWESI TENGAH",3,56,27,83
https://kawalpemilu.org#68385,"YUGUT, BUKAL, BUOL, SULAWESI TENGAH",4,108,74,182
https://kawalpemilu.org#68386,"MOOYONG, BUKAL, BUOL, SULAWESI TENGAH",1,139,65,204
https://kawalpemilu.org#68386,"MOOYONG, BUKAL, BUOL, SULAWESI TENGAH",2,173,12,185
https://kawalpemilu.org#68386,"MOOYONG, BUKAL, BUOL, SULAWESI TENGAH",3,19,16,35
https://kawalpemilu.org#68386,"MOOYONG, BUKAL, BUOL, SULAWESI TENGAH",4,182,44,226
https://kawalpemilu.org#89685,"MULAT, BUKAL, BUOL, SULAWESI TENGAH",1,94,50,144
https://kawalpemilu.org#89685,"MULAT, BUKAL, BUOL, SULAWESI TENGAH",2,87,60,147
https://kawalpemilu.org#89686,"BUKAL, BUKAL, BUOL, SULAWESI TENGAH",1,57,56,113
https://kawalpemilu.org#89686,"BUKAL, BUKAL, BUOL, SULAWESI TENGAH",2,51,7,58
https://kawalpemilu.org#89686,"BUKAL, BUKAL, BUOL, SULAWESI TENGAH",3,49,7,56
https://kawalpemilu.org#89686,"BUKAL, BUKAL, BUOL, SULAWESI TENGAH",4,52,31,83
https://kawalpemilu.org#68388,"LOKODIDI, GADUNG, BUOL, SULAWESI TENGAH",1,79,152,231
https://kawalpemilu.org#68388,"LOKODIDI, GADUNG, BUOL, SULAWESI TENGAH",2,59,102,161
https://kawalpemilu.org#68388,"LOKODIDI, GADUNG, BUOL, SULAWESI TENGAH",3,86,92,178
https://kawalpemilu.org#68388,"LOKODIDI, GADUNG, BUOL, SULAWESI TENGAH",4,60,85,145
https://kawalpemilu.org#68388,"LOKODIDI, GADUNG, BUOL, SULAWESI TENGAH",5,42,83,125
https://kawalpemilu.org#68388,"LOKODIDI, GADUNG, BUOL, SULAWESI TENGAH",6,48,94,142
https://kawalpemilu.org#68389,"MATINAN, GADUNG, BUOL, SULAWESI TENGAH",1,91,140,231
https://kawalpemilu.org#68389,"MATINAN, GADUNG, BUOL, SULAWESI TENGAH",2,65,131,196
https://kawalpemilu.org#68389,"MATINAN, GADUNG, BUOL, SULAWESI TENGAH",3,77,109,186
https://kawalpemilu.org#68389,"MATINAN, GADUNG, BUOL, SULAWESI TENGAH",4,65,132,197
https://kawalpemilu.org#68390,"TAAT, GADUNG, BUOL, SULAWESI TENGAH",1,98,39,137
https://kawalpemilu.org#68390,"TAAT, GADUNG, BUOL, SULAWESI TENGAH",2,82,119,201
https://kawalpemilu.org#68390,"TAAT, GADUNG, BUOL, SULAWESI TENGAH",3,85,119,204
https://kawalpemilu.org#68391,"LOKODOKA, GADUNG, BUOL, SULAWESI TENGAH",1,156,101,257
https://kawalpemilu.org#68391,"LOKODOKA, GADUNG, BUOL, SULAWESI TENGAH",2,139,101,240
https://kawalpemilu.org#68391,"LOKODOKA, GADUNG, BUOL, SULAWESI TENGAH",3,144,73,217
https://kawalpemilu.org#68392,"LABUTON, GADUNG, BUOL, SULAWESI TENGAH",1,94,69,163
https://kawalpemilu.org#68392,"LABUTON, GADUNG, BUOL, SULAWESI TENGAH",2,67,87,154
https://kawalpemilu.org#68392,"LABUTON, GADUNG, BUOL, SULAWESI TENGAH",3,108,103,211
https://kawalpemilu.org#68392,"LABUTON, GADUNG, BUOL, SULAWESI TENGAH",4,83,75,158
https://kawalpemilu.org#68392,"LABUTON, GADUNG, BUOL, SULAWESI TENGAH",5,94,65,159
https://kawalpemilu.org#68393,"BULAGIDUN, GADUNG, BUOL, SULAWESI TENGAH",1,123,99,222
https://kawalpemilu.org#68393,"BULAGIDUN, GADUNG, BUOL, SULAWESI TENGAH",2,69,79,148
https://kawalpemilu.org#68393,"BULAGIDUN, GADUNG, BUOL, SULAWESI TENGAH",3,68,132,200
https://kawalpemilu.org#68393,"BULAGIDUN, GADUNG, BUOL, SULAWESI TENGAH",4,82,118,200
https://kawalpemilu.org#68394,"DIAPATI, GADUNG, BUOL, SULAWESI TENGAH",1,71,86,157
https://kawalpemilu.org#68394,"DIAPATI, GADUNG, BUOL, SULAWESI TENGAH",2,78,95,173
https://kawalpemilu.org#68394,"DIAPATI, GADUNG, BUOL, SULAWESI TENGAH",3,39,130,169
https://kawalpemilu.org#68394,"DIAPATI, GADUNG, BUOL, SULAWESI TENGAH",4,37,112,149
https://kawalpemilu.org#68394,"DIAPATI, GADUNG, BUOL, SULAWESI TENGAH",5,76,128,204
https://kawalpemilu.org#68395,"NANDU, GADUNG, BUOL, SULAWESI TENGAH",1,98,53,151
https://kawalpemilu.org#68395,"NANDU, GADUNG, BUOL, SULAWESI TENGAH",2,108,54,162
https://kawalpemilu.org#68396,"LIPUBOGU, GADUNG, BUOL, SULAWESI TENGAH",1,140,107,247
https://kawalpemilu.org#68396,"LIPUBOGU, GADUNG, BUOL, SULAWESI TENGAH",2,110,85,195
https://kawalpemilu.org#68396,"LIPUBOGU, GADUNG, BUOL, SULAWESI TENGAH",3,133,192,225
https://kawalpemilu.org#68397,"BULOGIDON TANJUNG, GADUNG, BUOL, SULAWESI TENGAH",1,88,90,178
https://kawalpemilu.org#68397,"BULOGIDON TANJUNG, GADUNG, BUOL, SULAWESI TENGAH",2,123,119,242
https://kawalpemilu.org#89687,"PANDANGAN, GADUNG, BUOL, SULAWESI TENGAH",1,129,56,185
https://kawalpemilu.org#68399,"MOKUPO, KARAMAT, BUOL, SULAWESI TENGAH",1,85,127,212
https://kawalpemilu.org#68399,"MOKUPO, KARAMAT, BUOL, SULAWESI TENGAH",2,86,120,206
https://kawalpemilu.org#68399,"MOKUPO, KARAMAT, BUOL, SULAWESI TENGAH",3,107,110,217
https://kawalpemilu.org#68399,"MOKUPO, KARAMAT, BUOL, SULAWESI TENGAH",4,118,93,211
https://kawalpemilu.org#68400,"MENDAAN, KARAMAT, BUOL, SULAWESI TENGAH",1,144,62,206
https://kawalpemilu.org#68400,"MENDAAN, KARAMAT, BUOL, SULAWESI TENGAH",2,64,26,90
https://kawalpemilu.org#68400,"MENDAAN, KARAMAT, BUOL, SULAWESI TENGAH",3,115,64,179
https://kawalpemilu.org#68401,"BARUGA, KARAMAT, BUOL, SULAWESI TENGAH",1,110,77,187
https://kawalpemilu.org#68401,"BARUGA, KARAMAT, BUOL, SULAWESI TENGAH",2,93,97,190
https://kawalpemilu.org#68401,"BARUGA, KARAMAT, BUOL, SULAWESI TENGAH",3,69,121,190
https://kawalpemilu.org#68402,"MONANO, KARAMAT, BUOL, SULAWESI TENGAH",1,85,171,256
https://kawalpemilu.org#68402,"MONANO, KARAMAT, BUOL, SULAWESI TENGAH",2,79,172,251
https://kawalpemilu.org#68403,"BUSAK I, KARAMAT, BUOL, SULAWESI TENGAH",1,130,123,253
https://kawalpemilu.org#68403,"BUSAK I, KARAMAT, BUOL, SULAWESI TENGAH",2,86,111,197
https://kawalpemilu.org#68403,"BUSAK I, KARAMAT, BUOL, SULAWESI TENGAH",3,100,96,196
https://kawalpemilu.org#68403,"BUSAK I, KARAMAT, BUOL, SULAWESI TENGAH",4,87,98,185
https://kawalpemilu.org#68403,"BUSAK I, KARAMAT, BUOL, SULAWESI TENGAH",5,78,93,171
https://kawalpemilu.org#68403,"BUSAK I, KARAMAT, BUOL, SULAWESI TENGAH",6,73,79,152
https://kawalpemilu.org#68403,"BUSAK I, KARAMAT, BUOL, SULAWESI TENGAH",7,121,79,200
https://kawalpemilu.org#68403,"BUSAK I, KARAMAT, BUOL, SULAWESI TENGAH",8,115,54,169
https://kawalpemilu.org#68403,"BUSAK I, KARAMAT, BUOL, SULAWESI TENGAH",9,131,60,191
https://kawalpemilu.org#68404,"BUSAK II, KARAMAT, BUOL, SULAWESI TENGAH",1,97,112,209
https://kawalpemilu.org#68404,"BUSAK II, KARAMAT, BUOL, SULAWESI TENGAH",2,110,112,222
https://kawalpemilu.org#68404,"BUSAK II, KARAMAT, BUOL, SULAWESI TENGAH",3,158,99,257
https://kawalpemilu.org#68405,"LAMAKAN, KARAMAT, BUOL, SULAWESI TENGAH",1,67,149,216
https://kawalpemilu.org#68405,"LAMAKAN, KARAMAT, BUOL, SULAWESI TENGAH",2,119,121,240
https://kawalpemilu.org#68407,"BODI, PALELEH BARAT, BUOL, SULAWESI TENGAH",1,141,63,204
https://kawalpemilu.org#68407,"BODI, PALELEH BARAT, BUOL, SULAWESI TENGAH",2,114,114,228
https://kawalpemilu.org#68408,"TAYOKAN, PALELEH BARAT, BUOL, SULAWESI TENGAH",1,116,28,144
https://kawalpemilu.org#68408,"TAYOKAN, PALELEH BARAT, BUOL, SULAWESI TENGAH",2,123,29,152
https://kawalpemilu.org#68409,"HARMONI, PALELEH BARAT, BUOL, SULAWESI TENGAH",1,95,140,235
https://kawalpemilu.org#68409,"HARMONI, PALELEH BARAT, BUOL, SULAWESI TENGAH",2,170,38,208
https://kawalpemilu.org#68409,"HARMONI, PALELEH BARAT, BUOL, SULAWESI TENGAH",3,119,41,160
https://kawalpemilu.org#68409,"HARMONI, PALELEH BARAT, BUOL, SULAWESI TENGAH",4,83,54,137
https://kawalpemilu.org#68410,"LUNGUTO, PALELEH BARAT, BUOL, SULAWESI TENGAH",1,119,79,194
https://kawalpemilu.org#68410,"LUNGUTO, PALELEH BARAT, BUOL, SULAWESI TENGAH",2,109,93,202
https://kawalpemilu.org#68411,"TIMBULON, PALELEH BARAT, BUOL, SULAWESI TENGAH",1,80,143,223
https://kawalpemilu.org#68411,"TIMBULON, PALELEH BARAT, BUOL, SULAWESI TENGAH",2,83,137,220
https://kawalpemilu.org#68411,"TIMBULON, PALELEH BARAT, BUOL, SULAWESI TENGAH",3,80,113,193
https://kawalpemilu.org#68411,"TIMBULON, PALELEH BARAT, BUOL, SULAWESI TENGAH",4,83,127,210
https://kawalpemilu.org#68411,"TIMBULON, PALELEH BARAT, BUOL, SULAWESI TENGAH",5,136,21,157
https://kawalpemilu.org#68412,"OYAK, PALELEH BARAT, BUOL, SULAWESI TENGAH",1,164,77,241
https://kawalpemilu.org#68412,"OYAK, PALELEH BARAT, BUOL, SULAWESI TENGAH",2,80,60,140
https://kawalpemilu.org#68413,"HULUBALANG, PALELEH BARAT, BUOL, SULAWESI TENGAH",1,85,130,215
https://kawalpemilu.org#68413,"HULUBALANG, PALELEH BARAT, BUOL, SULAWESI TENGAH",2,71,111,185
https://kawalpemilu.org#68415,"BUOL, BIAU, BUOL, SULAWESI TENGAH",1,100,136,236
https://kawalpemilu.org#68415,"BUOL, BIAU, BUOL, SULAWESI TENGAH",2,78,155,233
https://kawalpemilu.org#68415,"BUOL, BIAU, BUOL, SULAWESI TENGAH",3,90,146,236
https://kawalpemilu.org#68415,"BUOL, BIAU, BUOL, SULAWESI TENGAH",4,84,116,200
https://kawalpemilu.org#68415,"BUOL, BIAU, BUOL, SULAWESI TENGAH",5,112,133,245
https://kawalpemilu.org#68415,"BUOL, BIAU, BUOL, SULAWESI TENGAH",6,116,119,235
https://kawalpemilu.org#68415,"BUOL, BIAU, BUOL, SULAWESI TENGAH",7,87,158,245
https://kawalpemilu.org#68415,"BUOL, BIAU, BUOL, SULAWESI TENGAH",8,77,157,234
https://kawalpemilu.org#68415,"BUOL, BIAU, BUOL, SULAWESI TENGAH",9,89,135,224
https://kawalpemilu.org#68415,"BUOL, BIAU, BUOL, SULAWESI TENGAH",10,71,102,173
https://kawalpemilu.org#68415,"BUOL, BIAU, BUOL, SULAWESI TENGAH",11,85,123,208
https://kawalpemilu.org#68415,"BUOL, BIAU, BUOL, SULAWESI TENGAH",12,112,115,227
https://kawalpemilu.org#68415,"BUOL, BIAU, BUOL, SULAWESI TENGAH",13,109,91,200
https://kawalpemilu.org#68415,"BUOL, BIAU, BUOL, SULAWESI TENGAH",14,96,122,218
https://kawalpemilu.org#68415,"BUOL, BIAU, BUOL, SULAWESI TENGAH",15,62,164,226
https://kawalpemilu.org#68415,"BUOL, BIAU, BUOL, SULAWESI TENGAH",16,57,106,163
https://kawalpemilu.org#68415,"BUOL, BIAU, BUOL, SULAWESI TENGAH",17,79,153,232
https://kawalpemilu.org#68416,"KALI, BIAU, BUOL, SULAWESI TENGAH",1,38,116,154
https://kawalpemilu.org#68416,"KALI, BIAU, BUOL, SULAWESI TENGAH",2,42,116,158
https://kawalpemilu.org#68416,"KALI, BIAU, BUOL, SULAWESI TENGAH",3,45,123,168
https://kawalpemilu.org#68416,"KALI, BIAU, BUOL, SULAWESI TENGAH",4,37,140,177
https://kawalpemilu.org#68416,"KALI, BIAU, BUOL, SULAWESI TENGAH",5,50,169,219
https://kawalpemilu.org#68416,"KALI, BIAU, BUOL, SULAWESI TENGAH",6,47,125,172
https://kawalpemilu.org#68416,"KALI, BIAU, BUOL, SULAWESI TENGAH",7,31,145,176
https://kawalpemilu.org#68416,"KALI, BIAU, BUOL, SULAWESI TENGAH",8,25,101,126
https://kawalpemilu.org#68416,"KALI, BIAU, BUOL, SULAWESI TENGAH",9,43,147,190
https://kawalpemilu.org#68416,"KALI, BIAU, BUOL, SULAWESI TENGAH",10,30,138,168
https://kawalpemilu.org#68416,"KALI, BIAU, BUOL, SULAWESI TENGAH",11,47,186,233
https://kawalpemilu.org#68416,"KALI, BIAU, BUOL, SULAWESI TENGAH",12,38,142,180
https://kawalpemilu.org#68416,"KALI, BIAU, BUOL, SULAWESI TENGAH",13,59,147,206
https://kawalpemilu.org#68416,"KALI, BIAU, BUOL, SULAWESI TENGAH",14,36,158,186
https://kawalpemilu.org#68416,"KALI, BIAU, BUOL, SULAWESI TENGAH",15,34,99,133
https://kawalpemilu.org#68417,"LEOK II, BIAU, BUOL, SULAWESI TENGAH",1,62,151,213
https://kawalpemilu.org#68417,"LEOK II, BIAU, BUOL, SULAWESI TENGAH",2,84,140,224
https://kawalpemilu.org#68417,"LEOK II, BIAU, BUOL, SULAWESI TENGAH",3,49,154,203
https://kawalpemilu.org#68417,"LEOK II, BIAU, BUOL, SULAWESI TENGAH",4,58,135,193
https://kawalpemilu.org#68417,"LEOK II, BIAU, BUOL, SULAWESI TENGAH",5,56,148,204
https://kawalpemilu.org#68417,"LEOK II, BIAU, BUOL, SULAWESI TENGAH",6,53,142,195
https://kawalpemilu.org#68417,"LEOK II, BIAU, BUOL, SULAWESI TENGAH",7,88,151,239
https://kawalpemilu.org#68417,"LEOK II, BIAU, BUOL, SULAWESI TENGAH",8,55,135,190
https://kawalpemilu.org#68417,"LEOK II, BIAU, BUOL, SULAWESI TENGAH",9,64,115,179
https://kawalpemilu.org#68417,"LEOK II, BIAU, BUOL, SULAWESI TENGAH",10,25,66,91
https://kawalpemilu.org#68417,"LEOK II, BIAU, BUOL, SULAWESI TENGAH",11,91,130,221
https://kawalpemilu.org#68417,"LEOK II, BIAU, BUOL, SULAWESI TENGAH",12,52,122,174
https://kawalpemilu.org#68417,"LEOK II, BIAU, BUOL, SULAWESI TENGAH",13,56,108,164
https://kawalpemilu.org#68417,"LEOK II, BIAU, BUOL, SULAWESI TENGAH",14,76,106,182
https://kawalpemilu.org#68417,"LEOK II, BIAU, BUOL, SULAWESI TENGAH",15,34,99,133
https://kawalpemilu.org#68418,"LEOK I, BIAU, BUOL, SULAWESI TENGAH",1,66,169,235
https://kawalpemilu.org#68418,"LEOK I, BIAU, BUOL, SULAWESI TENGAH",2,74,153,227
https://kawalpemilu.org#68418,"LEOK I, BIAU, BUOL, SULAWESI TENGAH",3,84,153,237
https://kawalpemilu.org#68418,"LEOK I, BIAU, BUOL, SULAWESI TENGAH",4,91,155,246
https://kawalpemilu.org#68418,"LEOK I, BIAU, BUOL, SULAWESI TENGAH",5,84,144,228
https://kawalpemilu.org#68418,"LEOK I, BIAU, BUOL, SULAWESI TENGAH",6,89,137,226
https://kawalpemilu.org#68418,"LEOK I, BIAU, BUOL, SULAWESI TENGAH",7,91,121,212
https://kawalpemilu.org#68418,"LEOK I, BIAU, BUOL, SULAWESI TENGAH",8,112,59,171
https://kawalpemilu.org#68418,"LEOK I, BIAU, BUOL, SULAWESI TENGAH",9,160,62,222
https://kawalpemilu.org#68418,"LEOK I, BIAU, BUOL, SULAWESI TENGAH",10,109,114,223
https://kawalpemilu.org#68418,"LEOK I, BIAU, BUOL, SULAWESI TENGAH",11,100,86,186
https://kawalpemilu.org#68418,"LEOK I, BIAU, BUOL, SULAWESI TENGAH",12,102,77,179
https://kawalpemilu.org#68418,"LEOK I, BIAU, BUOL, SULAWESI TENGAH",13,72,69,141
https://kawalpemilu.org#68418,"LEOK I, BIAU, BUOL, SULAWESI TENGAH",14,94,72,166
https://kawalpemilu.org#68419,"KUMALIGON, BIAU, BUOL, SULAWESI TENGAH",1,119,123,242
https://kawalpemilu.org#68419,"KUMALIGON, BIAU, BUOL, SULAWESI TENGAH",2,137,71,208
https://kawalpemilu.org#68419,"KUMALIGON, BIAU, BUOL, SULAWESI TENGAH",3,116,85,201
https://kawalpemilu.org#68419,"KUMALIGON, BIAU, BUOL, SULAWESI TENGAH",4,93,91,184
https://kawalpemilu.org#68419,"KUMALIGON, BIAU, BUOL, SULAWESI TENGAH",5,53,76,129
https://kawalpemilu.org#68420,"KULANGO, BIAU, BUOL, SULAWESI TENGAH",1,60,151,211
https://kawalpemilu.org#68420,"KULANGO, BIAU, BUOL, SULAWESI TENGAH",2,63,142,205
https://kawalpemilu.org#68420,"KULANGO, BIAU, BUOL, SULAWESI TENGAH",3,59,127,186
https://kawalpemilu.org#68420,"KULANGO, BIAU, BUOL, SULAWESI TENGAH",5,53,155,208
https://kawalpemilu.org#68420,"KULANGO, BIAU, BUOL, SULAWESI TENGAH",6,61,160,221
https://kawalpemilu.org#68420,"KULANGO, BIAU, BUOL, SULAWESI TENGAH",7,46,133,179
https://kawalpemilu.org#68421,"BUGIS, BIAU, BUOL, SULAWESI TENGAH",1,65,125,190
https://kawalpemilu.org#68421,"BUGIS, BIAU, BUOL, SULAWESI TENGAH",2,68,160,228
https://kawalpemilu.org#68421,"BUGIS, BIAU, BUOL, SULAWESI TENGAH",3,93,99,192
https://kawalpemilu.org#68421,"BUGIS, BIAU, BUOL, SULAWESI TENGAH",4,88,105,193
https://kawalpemilu.org#68421,"BUGIS, BIAU, BUOL, SULAWESI TENGAH",5,120,114,234
https://kawalpemilu.org#68423,"TUINAN, LAKEA, BUOL, SULAWESI TENGAH",1,97,104,201
https://kawalpemilu.org#68423,"TUINAN, LAKEA, BUOL, SULAWESI TENGAH",2,106,69,175
https://kawalpemilu.org#68423,"TUINAN, LAKEA, BUOL, SULAWESI TENGAH",3,126,72,198
https://kawalpemilu.org#68423,"TUINAN, LAKEA, BUOL, SULAWESI TENGAH",4,135,60,195
https://kawalpemilu.org#68424,"LAKEA II, LAKEA, BUOL, SULAWESI TENGAH",1,73,178,251
https://kawalpemilu.org#68424,"LAKEA II, LAKEA, BUOL, SULAWESI TENGAH",2,68,176,176
https://kawalpemilu.org#68424,"LAKEA II, LAKEA, BUOL, SULAWESI TENGAH",3,86,167,253
https://kawalpemilu.org#68424,"LAKEA II, LAKEA, BUOL, SULAWESI TENGAH",4,80,143,223
https://kawalpemilu.org#68424,"LAKEA II, LAKEA, BUOL, SULAWESI TENGAH",5,81,149,230
https://kawalpemilu.org#68424,"LAKEA II, LAKEA, BUOL, SULAWESI TENGAH",6,64,131,195
https://kawalpemilu.org#68424,"LAKEA II, LAKEA, BUOL, SULAWESI TENGAH",7,90,152,242
https://kawalpemilu.org#68424,"LAKEA II, LAKEA, BUOL, SULAWESI TENGAH",8,79,135,214
https://kawalpemilu.org#68425,"LAKEA I, LAKEA, BUOL, SULAWESI TENGAH",1,76,98,174
https://kawalpemilu.org#68425,"LAKEA I, LAKEA, BUOL, SULAWESI TENGAH",2,59,138,197
https://kawalpemilu.org#68425,"LAKEA I, LAKEA, BUOL, SULAWESI TENGAH",3,42,146,188
https://kawalpemilu.org#68425,"LAKEA I, LAKEA, BUOL, SULAWESI TENGAH",4,80,131,211
https://kawalpemilu.org#68425,"LAKEA I, LAKEA, BUOL, SULAWESI TENGAH",5,108,108,216
https://kawalpemilu.org#68425,"LAKEA I, LAKEA, BUOL, SULAWESI TENGAH",6,55,124,179
https://kawalpemilu.org#68425,"LAKEA I, LAKEA, BUOL, SULAWESI TENGAH",7,84,111,195
https://kawalpemilu.org#68426,"LAKUAN BUOL, LAKEA, BUOL, SULAWESI TENGAH",1,98,109,207
https://kawalpemilu.org#68426,"LAKUAN BUOL, LAKEA, BUOL, SULAWESI TENGAH",2,126,100,226
https://kawalpemilu.org#68426,"LAKUAN BUOL, LAKEA, BUOL, SULAWESI TENGAH",3,133,83,216
https://kawalpemilu.org#68426,"LAKUAN BUOL, LAKEA, BUOL, SULAWESI TENGAH",4,100,88,188
https://kawalpemilu.org#68427,"BUKAAN, LAKEA, BUOL, SULAWESI TENGAH",1,111,41,152
https://kawalpemilu.org#68427,"BUKAAN, LAKEA, BUOL, SULAWESI TENGAH",2,129,47,176
https://kawalpemilu.org#68427,"BUKAAN, LAKEA, BUOL, SULAWESI TENGAH",3,172,35,207
https://kawalpemilu.org#87568,"NGUNE, LAKEA, BUOL, SULAWESI TENGAH",1,82,95,177
https://kawalpemilu.org#87568,"NGUNE, LAKEA, BUOL, SULAWESI TENGAH",2,79,89,168
https://kawalpemilu.org#87569,"ILAMBE, LAKEA, BUOL, SULAWESI TENGAH",1,139,73,212
https://kawalpemilu.org#87569,"ILAMBE, LAKEA, BUOL, SULAWESI TENGAH",2,131,67,198
https://kawalpemilu.org#87569,"ILAMBE, LAKEA, BUOL, SULAWESI TENGAH",3,48,31,79
https://kawalpemilu.org#68526,"MENLUI, BUNGKU TENGAH, MOROWALI, SULAWESI TENGAH",1,32,136,168
https://kawalpemilu.org#68526,"MENLUI, BUNGKU TENGAH, MOROWALI, SULAWESI TENGAH",2,29,129,158
https://kawalpemilu.org#68527,"LAMBEREA, BUNGKU TENGAH, MOROWALI, SULAWESI TENGAH",1,77,173,250
https://kawalpemilu.org#68527,"LAMBEREA, BUNGKU TENGAH, MOROWALI, SULAWESI TENGAH",2,71,159,230
https://kawalpemilu.org#68527,"LAMBEREA, BUNGKU TENGAH, MOROWALI, SULAWESI TENGAH",3,41,109,150
https://kawalpemilu.org#68527,"LAMBEREA, BUNGKU TENGAH, MOROWALI, SULAWESI TENGAH",4,55,132,187
https://kawalpemilu.org#68528,"TOFOISO, BUNGKU TENGAH, MOROWALI, SULAWESI TENGAH",1,58,164,222
https://kawalpemilu.org#68528,"TOFOISO, BUNGKU TENGAH, MOROWALI, SULAWESI TENGAH",2,49,123,172
https://kawalpemilu.org#68529,"MARSAOLEH, BUNGKU TENGAH, MOROWALI, SULAWESI TENGAH",1,44,138,182
https://kawalpemilu.org#68529,"MARSAOLEH, BUNGKU TENGAH, MOROWALI, SULAWESI TENGAH",2,46,141,187
https://kawalpemilu.org#68529,"MARSAOLEH, BUNGKU TENGAH, MOROWALI, SULAWESI TENGAH",3,63,163,226
https://kawalpemilu.org#68529,"MARSAOLEH, BUNGKU TENGAH, MOROWALI, SULAWESI TENGAH",4,50,165,215
https://kawalpemilu.org#68530,"MATANO, BUNGKU TENGAH, MOROWALI, SULAWESI TENGAH",1,113,137,250
https://kawalpemilu.org#68530,"MATANO, BUNGKU TENGAH, MOROWALI, SULAWESI TENGAH",2,76,166,242
https://kawalpemilu.org#68530,"MATANO, BUNGKU TENGAH, MOROWALI, SULAWESI TENGAH",3,50,108,158
https://kawalpemilu.org#68530,"MATANO, BUNGKU TENGAH, MOROWALI, SULAWESI TENGAH",4,47,147,194
https://kawalpemilu.org#68531,"OBUNGI, BUNGKU TENGAH, MOROWALI, SULAWESI TENGAH",1,39,127,166
https://kawalpemilu.org#68531,"OBUNGI, BUNGKU TENGAH, MOROWALI, SULAWESI TENGAH",2,65,130,195
https://kawalpemilu.org#68531,"OBUNGI, BUNGKU TENGAH, MOROWALI, SULAWESI TENGAH",3,54,111,165
https://kawalpemilu.org#68541,"PUUNGKOILU, BUNGKU TENGAH, MOROWALI, SULAWESI TENGAH",1,34,164,198
https://kawalpemilu.org#68541,"PUUNGKOILU, BUNGKU TENGAH, MOROWALI, SULAWESI TENGAH",2,32,174,206
https://kawalpemilu.org#68541,"PUUNGKOILU, BUNGKU TENGAH, MOROWALI, SULAWESI TENGAH",3,28,176,204
https://kawalpemilu.org#68542,"BAHONTOBUNGKU, BUNGKU TENGAH, MOROWALI, SULAWESI TENGAH",1,56,143,199
https://kawalpemilu.org#68542,"BAHONTOBUNGKU, BUNGKU TENGAH, MOROWALI, SULAWESI TENGAH",2,46,108,154
https://kawalpemilu.org#68542,"BAHONTOBUNGKU, BUNGKU TENGAH, MOROWALI, SULAWESI TENGAH",3,68,115,183
https://kawalpemilu.org#68543,"TOFUTI, BUNGKU TENGAH, MOROWALI, SULAWESI TENGAH",1,65,188,253
https://kawalpemilu.org#68543,"TOFUTI, BUNGKU TENGAH, MOROWALI, SULAWESI TENGAH",2,61,188,249
https://kawalpemilu.org#68544,"SAKITA, BUNGKU TENGAH, MOROWALI, SULAWESI TENGAH",1,80,144,224
https://kawalpemilu.org#68544,"SAKITA, BUNGKU TENGAH, MOROWALI, SULAWESI TENGAH",2,55,155,210
https://kawalpemilu.org#68544,"SAKITA, BUNGKU TENGAH, MOROWALI, SULAWESI TENGAH",3,66,159,225
https://kawalpemilu.org#68544,"SAKITA, BUNGKU TENGAH, MOROWALI, SULAWESI TENGAH",4,31,208,239
https://kawalpemilu.org#68544,"SAKITA, BUNGKU TENGAH, MOROWALI, SULAWESI TENGAH",5,55,174,229
https://kawalpemilu.org#68545,"MATANSALA, BUNGKU TENGAH, MOROWALI, SULAWESI TENGAH",1,58,172,230
https://kawalpemilu.org#68545,"MATANSALA, BUNGKU TENGAH, MOROWALI, SULAWESI TENGAH",2,84,154,238
https://kawalpemilu.org#68545,"MATANSALA, BUNGKU TENGAH, MOROWALI, SULAWESI TENGAH",3,54,109,163
https://kawalpemilu.org#68545,"MATANSALA, BUNGKU TENGAH, MOROWALI, SULAWESI TENGAH",4,49,116,165
https://kawalpemilu.org#68546,"BAHORURU, BUNGKU TENGAH, MOROWALI, SULAWESI TENGAH",1,64,207,271
https://kawalpemilu.org#68546,"BAHORURU, BUNGKU TENGAH, MOROWALI, SULAWESI TENGAH",2,42,221,263
https://kawalpemilu.org#68546,"BAHORURU, BUNGKU TENGAH, MOROWALI, SULAWESI TENGAH",3,38,119,257
https://kawalpemilu.org#68546,"BAHORURU, BUNGKU TENGAH, MOROWALI, SULAWESI TENGAH",4,38,213,251
https://kawalpemilu.org#68547,"BENTE, BUNGKU TENGAH, MOROWALI, SULAWESI TENGAH",1,113,144,257
https://kawalpemilu.org#68547,"BENTE, BUNGKU TENGAH, MOROWALI, SULAWESI TENGAH",2,87,162,249
https://kawalpemilu.org#68547,"BENTE, BUNGKU TENGAH, MOROWALI, SULAWESI TENGAH",3,70,141,211
https://kawalpemilu.org#68547,"BENTE, BUNGKU TENGAH, MOROWALI, SULAWESI TENGAH",4,109,116,225
https://kawalpemilu.org#68547,"BENTE, BUNGKU TENGAH, MOROWALI, SULAWESI TENGAH",5,58,67,125
https://kawalpemilu.org#68547,"BENTE, BUNGKU TENGAH, MOROWALI, SULAWESI TENGAH",6,87,135,222
https://kawalpemilu.org#68547,"BENTE, BUNGKU TENGAH, MOROWALI, SULAWESI TENGAH",7,42,119,161
https://kawalpemilu.org#68548,"IPI, BUNGKU TENGAH, MOROWALI, SULAWESI TENGAH",1,70,159,229
https://kawalpemilu.org#68548,"IPI, BUNGKU TENGAH, MOROWALI, SULAWESI TENGAH",2,53,152,205
https://kawalpemilu.org#68548,"IPI, BUNGKU TENGAH, MOROWALI, SULAWESI TENGAH",3,31,127,158
https://kawalpemilu.org#68549,"BAHOMOHONI, BUNGKU TENGAH, MOROWALI, SULAWESI TENGAH",1,57,144,201
https://kawalpemilu.org#68549,"BAHOMOHONI, BUNGKU TENGAH, MOROWALI, SULAWESI TENGAH",2,62,162,224
https://kawalpemilu.org#68549,"BAHOMOHONI, BUNGKU TENGAH, MOROWALI, SULAWESI TENGAH",3,61,177,242
https://kawalpemilu.org#68549,"BAHOMOHONI, BUNGKU TENGAH, MOROWALI, SULAWESI TENGAH",4,45,187,232
https://kawalpemilu.org#68549,"BAHOMOHONI, BUNGKU TENGAH, MOROWALI, SULAWESI TENGAH",5,41,157,198
https://kawalpemilu.org#68549,"BAHOMOHONI, BUNGKU TENGAH, MOROWALI, SULAWESI TENGAH",6,40,163,203
https://kawalpemilu.org#68550,"BAHOMOLEO, BUNGKU TENGAH, MOROWALI, SULAWESI TENGAH",1,57,171,228
https://kawalpemilu.org#68550,"BAHOMOLEO, BUNGKU TENGAH, MOROWALI, SULAWESI TENGAH",2,67,155,222
https://kawalpemilu.org#68550,"BAHOMOLEO, BUNGKU TENGAH, MOROWALI, SULAWESI TENGAH",3,82,133,215
https://kawalpemilu.org#68550,"BAHOMOLEO, BUNGKU TENGAH, MOROWALI, SULAWESI TENGAH",4,84,187,271
https://kawalpemilu.org#68551,"BAHOMANTE, BUNGKU TENGAH, MOROWALI, SULAWESI TENGAH",1,71,140,211
https://kawalpemilu.org#68551,"BAHOMANTE, BUNGKU TENGAH, MOROWALI, SULAWESI TENGAH",2,67,188,255
https://kawalpemilu.org#68551,"BAHOMANTE, BUNGKU TENGAH, MOROWALI, SULAWESI TENGAH",3,87,133,220
https://kawalpemilu.org#68551,"BAHOMANTE, BUNGKU TENGAH, MOROWALI, SULAWESI TENGAH",4,81,164,245
https://kawalpemilu.org#68552,"LANONA, BUNGKU TENGAH, MOROWALI, SULAWESI TENGAH",1,82,167,249
https://kawalpemilu.org#68552,"LANONA, BUNGKU TENGAH, MOROWALI, SULAWESI TENGAH",2,90,88,178
https://kawalpemilu.org#68552,"LANONA, BUNGKU TENGAH, MOROWALI, SULAWESI TENGAH",3,85,103,188
https://kawalpemilu.org#68552,"LANONA, BUNGKU TENGAH, MOROWALI, SULAWESI TENGAH",4,97,107,204
https://kawalpemilu.org#68554,"TUDUA, BUNGKU TENGAH, MOROWALI, SULAWESI TENGAH",1,32,124,156
https://kawalpemilu.org#68554,"TUDUA, BUNGKU TENGAH, MOROWALI, SULAWESI TENGAH",2,54,102,156
https://kawalpemilu.org#68556,"SAINOA, BUNGKU SELATAN, MOROWALI, SULAWESI TENGAH",1,48,163,211
https://kawalpemilu.org#68556,"SAINOA, BUNGKU SELATAN, MOROWALI, SULAWESI TENGAH",2,74,137,211
https://kawalpemilu.org#68556,"SAINOA, BUNGKU SELATAN, MOROWALI, SULAWESI TENGAH",3,45,130,175
https://kawalpemilu.org#68557,"POLEWALI, BUNGKU SELATAN, MOROWALI, SULAWESI TENGAH",1,127,78,205
https://kawalpemilu.org#68558,"UMBELE, BUNGKU SELATAN, MOROWALI, SULAWESI TENGAH",1,63,174,237
https://kawalpemilu.org#68559,"PULAU DUA, BUNGKU SELATAN, MOROWALI, SULAWESI TENGAH",1,16,149,165
https://kawalpemilu.org#68559,"PULAU DUA, BUNGKU SELATAN, MOROWALI, SULAWESI TENGAH",2,12,114,126
https://kawalpemilu.org#68560,"BAKALA, BUNGKU SELATAN, MOROWALI, SULAWESI TENGAH",1,93,89,182
https://kawalpemilu.org#68560,"BAKALA, BUNGKU SELATAN, MOROWALI, SULAWESI TENGAH",2,75,114,189
https://kawalpemilu.org#68560,"BAKALA, BUNGKU SELATAN, MOROWALI, SULAWESI TENGAH",3,55,121,176
https://kawalpemilu.org#68561,"PAKU, BUNGKU SELATAN, MOROWALI, SULAWESI TENGAH",1,41,143,184
https://kawalpemilu.org#68561,"PAKU, BUNGKU SELATAN, MOROWALI, SULAWESI TENGAH",2,23,100,123
https://kawalpemilu.org#68562,"KOBURU, BUNGKU SELATAN, MOROWALI, SULAWESI TENGAH",1,83,76,159
https://kawalpemilu.org#68563,"BUTON, BUNGKU SELATAN, MOROWALI, SULAWESI TENGAH",1,71,146,217
https://kawalpemilu.org#68563,"BUTON, BUNGKU SELATAN, MOROWALI, SULAWESI TENGAH",3,60,100,160
https://kawalpemilu.org#68564,"JAWI-JAWI, BUNGKU SELATAN, MOROWALI, SULAWESI TENGAH",1,42,88,130
https://kawalpemilu.org#68564,"JAWI-JAWI, BUNGKU SELATAN, MOROWALI, SULAWESI TENGAH",2,50,81,131
https://kawalpemilu.org#68565,"KALEROANG, BUNGKU SELATAN, MOROWALI, SULAWESI TENGAH",1,24,118,142
https://kawalpemilu.org#68565,"KALEROANG, BUNGKU SELATAN, MOROWALI, SULAWESI TENGAH",2,53,111,164
https://kawalpemilu.org#68565,"KALEROANG, BUNGKU SELATAN, MOROWALI, SULAWESI TENGAH",3,20,132,152
https://kawalpemilu.org#68565,"KALEROANG, BUNGKU SELATAN, MOROWALI, SULAWESI TENGAH",4,26,166,192
https://kawalpemilu.org#68566,"BUNGINGKELA, BUNGKU SELATAN, MOROWALI, SULAWESI TENGAH",1,74,143,217
https://kawalpemilu.org#68566,"BUNGINGKELA, BUNGKU SELATAN, MOROWALI, SULAWESI TENGAH",2,26,175,201
https://kawalpemilu.org#68567,"LOKOMBULO, BUNGKU SELATAN, MOROWALI, SULAWESI TENGAH",1,48,138,186
https://kawalpemilu.org#68567,"LOKOMBULO, BUNGKU SELATAN, MOROWALI, SULAWESI TENGAH",2,48,106,154
https://kawalpemilu.org#68568,"BUAJANGKA, BUNGKU SELATAN, MOROWALI, SULAWESI TENGAH",1,53,160,213
https://kawalpemilu.org#68568,"BUAJANGKA, BUNGKU SELATAN, MOROWALI, SULAWESI TENGAH",2,54,131,185
https://kawalpemilu.org#68569,"WARU-WARU, BUNGKU SELATAN, MOROWALI, SULAWESI TENGAH",1,62,144,206
https://kawalpemilu.org#68569,"WARU-WARU, BUNGKU SELATAN, MOROWALI, SULAWESI TENGAH",2,41,116,157
https://kawalpemilu.org#68570,"PADABALE, BUNGKU SELATAN, MOROWALI, SULAWESI TENGAH",1,84,66,150
https://kawalpemilu.org#68571,"PADO-PADO, BUNGKU SELATAN, MOROWALI, SULAWESI TENGAH",1,93,95,188
https://kawalpemilu.org#68571,"PADO-PADO, BUNGKU SELATAN, MOROWALI, SULAWESI TENGAH",2,54,48,102
https://kawalpemilu.org#68572,"PULAUBAPA, BUNGKU SELATAN, MOROWALI, SULAWESI TENGAH",1,70,93,163
https://kawalpemilu.org#68573,"LALEMO, BUNGKU SELATAN, MOROWALI, SULAWESI TENGAH",1,18,191,209
https://kawalpemilu.org#68573,"LALEMO, BUNGKU SELATAN, MOROWALI, SULAWESI TENGAH",2,3,70,73
https://kawalpemilu.org#68574,"LAMONTOLI, BUNGKU SELATAN, MOROWALI, SULAWESI TENGAH",1,11,168,179
https://kawalpemilu.org#68574,"LAMONTOLI, BUNGKU SELATAN, MOROWALI, SULAWESI TENGAH",2,22,150,172
https://kawalpemilu.org#68584,"BUNGINTENDE, BUNGKU SELATAN, MOROWALI, SULAWESI TENGAH",1,151,45,194
https://kawalpemilu.org#68584,"BUNGINTENDE, BUNGKU SELATAN, MOROWALI, SULAWESI TENGAH",2,47,27,74
https://kawalpemilu.org#68586,"PANIMBAWANG, BUNGKU SELATAN, MOROWALI, SULAWESI TENGAH",1,10,195,205
https://kawalpemilu.org#68586,"PANIMBAWANG, BUNGKU SELATAN, MOROWALI, SULAWESI TENGAH",2,23,175,198
https://kawalpemilu.org#68587,"PO'O, BUNGKU SELATAN, MOROWALI, SULAWESI TENGAH",1,54,133,187
https://kawalpemilu.org#68588,"BOELIMAU, BUNGKU SELATAN, MOROWALI, SULAWESI TENGAH",1,68,182,250
https://kawalpemilu.org#85665,"POARO, BUNGKU SELATAN, MOROWALI, SULAWESI TENGAH",1,49,170,219
https://kawalpemilu.org#89693,"UMBELE LAMA, BUNGKU SELATAN, MOROWALI, SULAWESI TENGAH",1,106,82,188
https://kawalpemilu.org#89693,"UMBELE LAMA, BUNGKU SELATAN, MOROWALI, SULAWESI TENGAH",2,52,40,92
https://kawalpemilu.org#89694,"PULAU DUA DARAT, BUNGKU SELATAN, MOROWALI, SULAWESI TENGAH",1,44,58,102
https://kawalpemilu.org#68590,"ULUNAMBO, MENUI KEPULAUAN, MOROWALI, SULAWESI TENGAH",1,37,157,194
https://kawalpemilu.org#68590,"ULUNAMBO, MENUI KEPULAUAN, MOROWALI, SULAWESI TENGAH",2,54,151,205
https://kawalpemilu.org#68590,"ULUNAMBO, MENUI KEPULAUAN, MOROWALI, SULAWESI TENGAH",3,95,101,196
https://kawalpemilu.org#68590,"ULUNAMBO, MENUI KEPULAUAN, MOROWALI, SULAWESI TENGAH",4,134,74,208
https://kawalpemilu.org#68590,"ULUNAMBO, MENUI KEPULAUAN, MOROWALI, SULAWESI TENGAH",5,32,124,156
https://kawalpemilu.org#68590,"ULUNAMBO, MENUI KEPULAUAN, MOROWALI, SULAWESI TENGAH",6,33,121,154
https://kawalpemilu.org#68590,"ULUNAMBO, MENUI KEPULAUAN, MOROWALI, SULAWESI TENGAH",7,28,113,141
https://kawalpemilu.org#68590,"ULUNAMBO, MENUI KEPULAUAN, MOROWALI, SULAWESI TENGAH",8,19,140,159
https://kawalpemilu.org#68591,"TEREBINO, MENUI KEPULAUAN, MOROWALI, SULAWESI TENGAH",1,0,0,0
https://kawalpemilu.org#68591,"TEREBINO, MENUI KEPULAUAN, MOROWALI, SULAWESI TENGAH",2,15,128,143
https://kawalpemilu.org#68591,"TEREBINO, MENUI KEPULAUAN, MOROWALI, SULAWESI TENGAH",3,31,111,142
https://kawalpemilu.org#68592,"TORUKUNE, MENUI KEPULAUAN, MOROWALI, SULAWESI TENGAH",1,9,215,224
https://kawalpemilu.org#68593,"NGAPAEA, MENUI KEPULAUAN, MOROWALI, SULAWESI TENGAH",1,32,111,143
https://kawalpemilu.org#68594,"PADALAA, MENUI KEPULAUAN, MOROWALI, SULAWESI TENGAH",1,51,113,164
https://kawalpemilu.org#68594,"PADALAA, MENUI KEPULAUAN, MOROWALI, SULAWESI TENGAH",2,50,105,155
https://kawalpemilu.org#68595,"MOROMPAITONGA, MENUI KEPULAUAN, MOROWALI, SULAWESI TENGAH",1,85,116,201
https://kawalpemilu.org#68596,"KOFALAGADI, MENUI KEPULAUAN, MOROWALI, SULAWESI TENGAH",1,61,65,126
https://kawalpemilu.org#68596,"KOFALAGADI, MENUI KEPULAUAN, MOROWALI, SULAWESI TENGAH",2,62,80,142
https://kawalpemilu.org#68597,"PADEI LAUT, MENUI KEPULAUAN, MOROWALI, SULAWESI TENGAH",1,154,84,238
https://kawalpemilu.org#68597,"PADEI LAUT, MENUI KEPULAUAN, MOROWALI, SULAWESI TENGAH",2,159,52,211
https://kawalpemilu.org#68598,"PADEI DARAT, MENUI KEPULAUAN, MOROWALI, SULAWESI TENGAH",1,59,164,223
https://kawalpemilu.org#68598,"PADEI DARAT, MENUI KEPULAUAN, MOROWALI, SULAWESI TENGAH",2,141,108,249
https://kawalpemilu.org#68599,"SAMARENGGA, MENUI KEPULAUAN, MOROWALI, SULAWESI TENGAH",1,45,155,200
https://kawalpemilu.org#68599,"SAMARENGGA, MENUI KEPULAUAN, MOROWALI, SULAWESI TENGAH",2,50,150,200
https://kawalpemilu.org#68600,"MASADIAN, MENUI KEPULAUAN, MOROWALI, SULAWESI TENGAH",1,68,195,263
https://kawalpemilu.org#68600,"MASADIAN, MENUI KEPULAUAN, MOROWALI, SULAWESI TENGAH",2,40,191,231
https://kawalpemilu.org#68600,"MASADIAN, MENUI KEPULAUAN, MOROWALI, SULAWESI TENGAH",3,31,209,240
https://kawalpemilu.org#68601,"PULAU TIGA, MENUI KEPULAUAN, MOROWALI, SULAWESI TENGAH",1,159,92,251
https://kawalpemilu.org#68601,"PULAU TIGA, MENUI KEPULAUAN, MOROWALI, SULAWESI TENGAH",2,154,74,228
https://kawalpemilu.org#68602,"MATANO, MENUI KEPULAUAN, MOROWALI, SULAWESI TENGAH",1,49,159,208
https://kawalpemilu.org#68603,"MATARAPE, MENUI KEPULAUAN, MOROWALI, SULAWESI TENGAH",1,57,137,194
https://kawalpemilu.org#68603,"MATARAPE, MENUI KEPULAUAN, MOROWALI, SULAWESI TENGAH",2,83,110,193
https://kawalpemilu.org#68604,"ULUNIPA, MENUI KEPULAUAN, MOROWALI, SULAWESI TENGAH",1,77,93,170
https://kawalpemilu.org#68604,"ULUNIPA, MENUI KEPULAUAN, MOROWALI, SULAWESI TENGAH",2,110,65,175
https://kawalpemilu.org#68605,"WAWANGKOLONO, MENUI KEPULAUAN, MOROWALI, SULAWESI TENGAH",1,5,237,242
https://kawalpemilu.org#68606,"BURANGA, MENUI KEPULAUAN, MOROWALI, SULAWESI TENGAH",1,135,66,201
https://kawalpemilu.org#68607,"DONGKALAN, MENUI KEPULAUAN, MOROWALI, SULAWESI TENGAH",1,53,103,156
https://kawalpemilu.org#68607,"DONGKALAN, MENUI KEPULAUAN, MOROWALI, SULAWESI TENGAH",2,33,88,121
https://kawalpemilu.org#85666,"TAFAGAPI, MENUI KEPULAUAN, MOROWALI, SULAWESI TENGAH",1,58,74,132
https://kawalpemilu.org#89695,"PULAU TENGAH, MENUI KEPULAUAN, MOROWALI, SULAWESI TENGAH",1,29,54,83
https://kawalpemilu.org#89696,"MBOKITTA, MENUI KEPULAUAN, MOROWALI, SULAWESI TENGAH",1,30,70,100
https://kawalpemilu.org#89697,"TANJUNG TIRAM, MENUI KEPULAUAN, MOROWALI, SULAWESI TENGAH",1,66,35,101
https://kawalpemilu.org#89698,"TANONA, MENUI KEPULAUAN, MOROWALI, SULAWESI TENGAH",1,31,119,150
https://kawalpemilu.org#89699,"TANJUNG HARAPAN, MENUI KEPULAUAN, MOROWALI, SULAWESI TENGAH",1,84,85,169
https://kawalpemilu.org#68609,"BAHOEA REKO- REKO, BUNGKU BARAT, MOROWALI, SULAWESI TENGAH",1,84,129,213
https://kawalpemilu.org#68609,"BAHOEA REKO- REKO, BUNGKU BARAT, MOROWALI, SULAWESI TENGAH",2,160,107,267
https://kawalpemilu.org#68609,"BAHOEA REKO- REKO, BUNGKU BARAT, MOROWALI, SULAWESI TENGAH",3,60,88,148
https://kawalpemilu.org#68609,"BAHOEA REKO- REKO, BUNGKU BARAT, MOROWALI, SULAWESI TENGAH",4,85,138,223
https://kawalpemilu.org#68609,"BAHOEA REKO- REKO, BUNGKU BARAT, MOROWALI, SULAWESI TENGAH",5,50,72,122
https://kawalpemilu.org#68609,"BAHOEA REKO- REKO, BUNGKU BARAT, MOROWALI, SULAWESI TENGAH",6,43,107,150
https://kawalpemilu.org#68609,"BAHOEA REKO- REKO, BUNGKU BARAT, MOROWALI, SULAWESI TENGAH",7,51,75,126
https://kawalpemilu.org#68610,"WOSU, BUNGKU BARAT, MOROWALI, SULAWESI TENGAH",1,82,165,247
https://kawalpemilu.org#68610,"WOSU, BUNGKU BARAT, MOROWALI, SULAWESI TENGAH",2,86,135,221
https://kawalpemilu.org#68610,"WOSU, BUNGKU BARAT, MOROWALI, SULAWESI TENGAH",3,105,116,221
https://kawalpemilu.org#68610,"WOSU, BUNGKU BARAT, MOROWALI, SULAWESI TENGAH",4,77,148,225
https://kawalpemilu.org#68610,"WOSU, BUNGKU BARAT, MOROWALI, SULAWESI TENGAH",5,97,115,212
https://kawalpemilu.org#68610,"WOSU, BUNGKU BARAT, MOROWALI, SULAWESI TENGAH",6,101,132,233
https://kawalpemilu.org#68610,"WOSU, BUNGKU BARAT, MOROWALI, SULAWESI TENGAH",7,130,82,212
https://kawalpemilu.org#68610,"WOSU, BUNGKU BARAT, MOROWALI, SULAWESI TENGAH",8,153,57,210
https://kawalpemilu.org#68611,"LAROBENU, BUNGKU BARAT, MOROWALI, SULAWESI TENGAH",1,63,176,239
https://kawalpemilu.org#68611,"LAROBENU, BUNGKU BARAT, MOROWALI, SULAWESI TENGAH",2,100,138,238
https://kawalpemilu.org#68611,"LAROBENU, BUNGKU BARAT, MOROWALI, SULAWESI TENGAH",3,124,117,241
https://kawalpemilu.org#68612,"UMPANGA, BUNGKU BARAT, MOROWALI, SULAWESI TENGAH",1,72,120,192
https://kawalpemilu.org#68612,"UMPANGA, BUNGKU BARAT, MOROWALI, SULAWESI TENGAH",2,103,92,195
https://kawalpemilu.org#68612,"UMPANGA, BUNGKU BARAT, MOROWALI, SULAWESI TENGAH",3,120,35,155
https://kawalpemilu.org#68612,"UMPANGA, BUNGKU BARAT, MOROWALI, SULAWESI TENGAH",4,94,111,205
https://kawalpemilu.org#68613,"TONDO, BUNGKU BARAT, MOROWALI, SULAWESI TENGAH",1,119,102,221
https://kawalpemilu.org#68613,"TONDO, BUNGKU BARAT, MOROWALI, SULAWESI TENGAH",2,109,79,188
https://kawalpemilu.org#68614,"TOPOGARO, BUNGKU BARAT, MOROWALI, SULAWESI TENGAH",1,124,112,236
https://kawalpemilu.org#68614,"TOPOGARO, BUNGKU BARAT, MOROWALI, SULAWESI TENGAH",2,97,111,208
https://kawalpemilu.org#68614,"TOPOGARO, BUNGKU BARAT, MOROWALI, SULAWESI TENGAH",3,94,114,208
https://kawalpemilu.org#68614,"TOPOGARO, BUNGKU BARAT, MOROWALI, SULAWESI TENGAH",4,59,83,142
https://kawalpemilu.org#68614,"TOPOGARO, BUNGKU BARAT, MOROWALI, SULAWESI TENGAH",5,36,56,92
https://kawalpemilu.org#68615,"AMBUNU, BUNGKU BARAT, MOROWALI, SULAWESI TENGAH",1,52,116,168
https://kawalpemilu.org#68615,"AMBUNU, BUNGKU BARAT, MOROWALI, SULAWESI TENGAH",2,65,135,200
https://kawalpemilu.org#68615,"AMBUNU, BUNGKU BARAT, MOROWALI, SULAWESI TENGAH",3,77,118,195
https://kawalpemilu.org#68616,"WATA, BUNGKU BARAT, MOROWALI, SULAWESI TENGAH",1,51,165,216
https://kawalpemilu.org#68616,"WATA, BUNGKU BARAT, MOROWALI, SULAWESI TENGAH",2,28,90,118
https://kawalpemilu.org#68617,"MARGAMULYA, BUNGKU BARAT, MOROWALI, SULAWESI TENGAH",1,100,120,220
https://kawalpemilu.org#68617,"MARGAMULYA, BUNGKU BARAT, MOROWALI, SULAWESI TENGAH",2,114,104,218
https://kawalpemilu.org#68617,"MARGAMULYA, BUNGKU BARAT, MOROWALI, SULAWESI TENGAH",3,90,92,182
https://kawalpemilu.org#68618,"UEDAGO, BUNGKU BARAT, MOROWALI, SULAWESI TENGAH",1,59,158,217
https://kawalpemilu.org#68620,"PARILANGKE, BUMI RAYA, MOROWALI, SULAWESI TENGAH",1,114,112,226
https://kawalpemilu.org#68620,"PARILANGKE, BUMI RAYA, MOROWALI, SULAWESI TENGAH",2,79,143,222
https://kawalpemilu.org#68621,"BAHONSUAI, BUMI RAYA, MOROWALI, SULAWESI TENGAH",1,60,121,181
https://kawalpemilu.org#68621,"BAHONSUAI, BUMI RAYA, MOROWALI, SULAWESI TENGAH",2,64,127,191
https://kawalpemilu.org#68621,"BAHONSUAI, BUMI RAYA, MOROWALI, SULAWESI TENGAH",3,44,163,207
https://kawalpemilu.org#68621,"BAHONSUAI, BUMI RAYA, MOROWALI, SULAWESI TENGAH",4,51,113,164
https://kawalpemilu.org#68621,"BAHONSUAI, BUMI RAYA, MOROWALI, SULAWESI TENGAH",5,86,89,175
https://kawalpemilu.org#68622,"ATANANGA, BUMI RAYA, MOROWALI, SULAWESI TENGAH",1,39,111,150
https://kawalpemilu.org#68622,"ATANANGA, BUMI RAYA, MOROWALI, SULAWESI TENGAH",2,44,107,151
https://kawalpemilu.org#68623,"PEBATAE, BUMI RAYA, MOROWALI, SULAWESI TENGAH",1,63,147,210
https://kawalpemilu.org#68623,"PEBATAE, BUMI RAYA, MOROWALI, SULAWESI TENGAH",2,52,123,175
https://kawalpemilu.org#68623,"PEBATAE, BUMI RAYA, MOROWALI, SULAWESI TENGAH",3,47,194,242
https://kawalpemilu.org#68623,"PEBATAE, BUMI RAYA, MOROWALI, SULAWESI TENGAH",4,40,126,166
https://kawalpemilu.org#68624,"UMBELE, BUMI RAYA, MOROWALI, SULAWESI TENGAH",1,52,127,179
https://kawalpemilu.org#68624,"UMBELE, BUMI RAYA, MOROWALI, SULAWESI TENGAH",2,24,71,95
https://kawalpemilu.org#68624,"UMBELE, BUMI RAYA, MOROWALI, SULAWESI TENGAH",3,63,117,180
https://kawalpemilu.org#68624,"UMBELE, BUMI RAYA, MOROWALI, SULAWESI TENGAH",4,56,104,160
https://kawalpemilu.org#68625,"LAMBELU, BUMI RAYA, MOROWALI, SULAWESI TENGAH",1,169,55,224
https://kawalpemilu.org#68625,"LAMBELU, BUMI RAYA, MOROWALI, SULAWESI TENGAH",2,84,140,224
https://kawalpemilu.org#68625,"LAMBELU, BUMI RAYA, MOROWALI, SULAWESI TENGAH",3,169,23,192
https://kawalpemilu.org#68625,"LAMBELU, BUMI RAYA, MOROWALI, SULAWESI TENGAH",4,168,14,182
https://kawalpemilu.org#68626,"LIMBO MAKMUR, BUMI RAYA, MOROWALI, SULAWESI TENGAH",1,151,88,239
https://kawalpemilu.org#68626,"LIMBO MAKMUR, BUMI RAYA, MOROWALI, SULAWESI TENGAH",2,157,73,230
https://kawalpemilu.org#68626,"LIMBO MAKMUR, BUMI RAYA, MOROWALI, SULAWESI TENGAH",3,158,54,212
https://kawalpemilu.org#68626,"LIMBO MAKMUR, BUMI RAYA, MOROWALI, SULAWESI TENGAH",4,169,59,228
https://kawalpemilu.org#68626,"LIMBO MAKMUR, BUMI RAYA, MOROWALI, SULAWESI TENGAH",5,145,71,216
https://kawalpemilu.org#68626,"LIMBO MAKMUR, BUMI RAYA, MOROWALI, SULAWESI TENGAH",6,123,104,227
https://kawalpemilu.org#68627,"BERINGIN JAYA, BUMI RAYA, MOROWALI, SULAWESI TENGAH",1,200,25,225
https://kawalpemilu.org#68627,"BERINGIN JAYA, BUMI RAYA, MOROWALI, SULAWESI TENGAH",2,166,64,230
https://kawalpemilu.org#68627,"BERINGIN JAYA, BUMI RAYA, MOROWALI, SULAWESI TENGAH",3,107,23,130
https://kawalpemilu.org#68628,"SAMARENDA, BUMI RAYA, MOROWALI, SULAWESI TENGAH",1,62,125,187
https://kawalpemilu.org#68628,"SAMARENDA, BUMI RAYA, MOROWALI, SULAWESI TENGAH",2,42,95,137
https://kawalpemilu.org#68628,"SAMARENDA, BUMI RAYA, MOROWALI, SULAWESI TENGAH",3,44,84,128
https://kawalpemilu.org#68629,"LASAMPI, BUMI RAYA, MOROWALI, SULAWESI TENGAH",1,78,95,173
https://kawalpemilu.org#68629,"LASAMPI, BUMI RAYA, MOROWALI, SULAWESI TENGAH",2,73,38,111
https://kawalpemilu.org#68629,"LASAMPI, BUMI RAYA, MOROWALI, SULAWESI TENGAH",3,165,61,226
https://kawalpemilu.org#68630,"HARAPAN JAYA, BUMI RAYA, MOROWALI, SULAWESI TENGAH",1,161,55,216
https://kawalpemilu.org#68630,"HARAPAN JAYA, BUMI RAYA, MOROWALI, SULAWESI TENGAH",2,156,69,225
https://kawalpemilu.org#68630,"HARAPAN JAYA, BUMI RAYA, MOROWALI, SULAWESI TENGAH",3,154,62,216
https://kawalpemilu.org#68631,"PEBOTOA, BUMI RAYA, MOROWALI, SULAWESI TENGAH",1,63,157,220
https://kawalpemilu.org#68631,"PEBOTOA, BUMI RAYA, MOROWALI, SULAWESI TENGAH",2,51,104,155
https://kawalpemilu.org#68632,"KARAUPA, BUMI RAYA, MOROWALI, SULAWESI TENGAH",1,99,135,234
https://kawalpemilu.org#68634,"BETE-BETE, BAHODOPI, MOROWALI, SULAWESI TENGAH",1,43,172,215
https://kawalpemilu.org#68634,"BETE-BETE, BAHODOPI, MOROWALI, SULAWESI TENGAH",2,52,143,195
https://kawalpemilu.org#68634,"BETE-BETE, BAHODOPI, MOROWALI, SULAWESI TENGAH",3,69,141,210
https://kawalpemilu.org#68635,"PADABAHAO, BAHODOPI, MOROWALI, SULAWESI TENGAH",1,38,140,178
https://kawalpemilu.org#68635,"PADABAHAO, BAHODOPI, MOROWALI, SULAWESI TENGAH",2,63,127,190
https://kawalpemilu.org#68636,"LABOTA, BAHODOPI, MOROWALI, SULAWESI TENGAH",1,55,149,204
https://kawalpemilu.org#68636,"LABOTA, BAHODOPI, MOROWALI, SULAWESI TENGAH",2,62,131,193
https://kawalpemilu.org#68636,"LABOTA, BAHODOPI, MOROWALI, SULAWESI TENGAH",3,53,112,165
https://kawalpemilu.org#68636,"LABOTA, BAHODOPI, MOROWALI, SULAWESI TENGAH",4,48,130,178
https://kawalpemilu.org#68636,"LABOTA, BAHODOPI, MOROWALI, SULAWESI TENGAH",5,45,104,149
https://kawalpemilu.org#68636,"LABOTA, BAHODOPI, MOROWALI, SULAWESI TENGAH",6,71,126,197
https://kawalpemilu.org#68636,"LABOTA, BAHODOPI, MOROWALI, SULAWESI TENGAH",7,70,163,233
https://kawalpemilu.org#68636,"LABOTA, BAHODOPI, MOROWALI, SULAWESI TENGAH",8,52,198,250
https://kawalpemilu.org#68637,"FATUFIA, BAHODOPI, MOROWALI, SULAWESI TENGAH",1,63,136,199
https://kawalpemilu.org#68637,"FATUFIA, BAHODOPI, MOROWALI, SULAWESI TENGAH",2,79,179,258
https://kawalpemilu.org#68637,"FATUFIA, BAHODOPI, MOROWALI, SULAWESI TENGAH",3,57,131,188
https://kawalpemilu.org#68637,"FATUFIA, BAHODOPI, MOROWALI, SULAWESI TENGAH",4,31,117,148
https://kawalpemilu.org#68637,"FATUFIA, BAHODOPI, MOROWALI, SULAWESI TENGAH",5,32,113,145
https://kawalpemilu.org#68638,"KEUREA, BAHODOPI, MOROWALI, SULAWESI TENGAH",1,52,177,229
https://kawalpemilu.org#68638,"KEUREA, BAHODOPI, MOROWALI, SULAWESI TENGAH",2,56,171,227
https://kawalpemilu.org#68638,"KEUREA, BAHODOPI, MOROWALI, SULAWESI TENGAH",3,46,112,158
https://kawalpemilu.org#68638,"KEUREA, BAHODOPI, MOROWALI, SULAWESI TENGAH",4,0,0,0
https://kawalpemilu.org#68638,"KEUREA, BAHODOPI, MOROWALI, SULAWESI TENGAH",5,38,151,189
https://kawalpemilu.org#68638,"KEUREA, BAHODOPI, MOROWALI, SULAWESI TENGAH",6,27,68,95
https://kawalpemilu.org#68638,"KEUREA, BAHODOPI, MOROWALI, SULAWESI TENGAH",7,32,105,137
https://kawalpemilu.org#68638,"KEUREA, BAHODOPI, MOROWALI, SULAWESI TENGAH",8,51,131,182
https://kawalpemilu.org#68639,"BAHODOPI, BAHODOPI, MOROWALI, SULAWESI TENGAH",1,52,143,195
https://kawalpemilu.org#68639,"BAHODOPI, BAHODOPI, MOROWALI, SULAWESI TENGAH",2,54,153,207
https://kawalpemilu.org#68639,"BAHODOPI, BAHODOPI, MOROWALI, SULAWESI TENGAH",3,54,128,182
https://kawalpemilu.org#68639,"BAHODOPI, BAHODOPI, MOROWALI, SULAWESI TENGAH",4,48,136,184
https://kawalpemilu.org#68640,"LALAMPU, BAHODOPI, MOROWALI, SULAWESI TENGAH",1,55,124,179
https://kawalpemilu.org#68640,"LALAMPU, BAHODOPI, MOROWALI, SULAWESI TENGAH",2,61,120,181
https://kawalpemilu.org#68640,"LALAMPU, BAHODOPI, MOROWALI, SULAWESI TENGAH",3,54,115,169
https://kawalpemilu.org#68640,"LALAMPU, BAHODOPI, MOROWALI, SULAWESI TENGAH",4,34,92,126
https://kawalpemilu.org#68640,"LALAMPU, BAHODOPI, MOROWALI, SULAWESI TENGAH",5,62,125,187
https://kawalpemilu.org#68640,"LALAMPU, BAHODOPI, MOROWALI, SULAWESI TENGAH",6,51,126,177
https://kawalpemilu.org#68640,"LALAMPU, BAHODOPI, MOROWALI, SULAWESI TENGAH",7,38,109,147
https://kawalpemilu.org#68640,"LALAMPU, BAHODOPI, MOROWALI, SULAWESI TENGAH",8,54,139,193
https://kawalpemilu.org#68640,"LALAMPU, BAHODOPI, MOROWALI, SULAWESI TENGAH",9,55,142,197
https://kawalpemilu.org#68641,"SIUMBATU, BAHODOPI, MOROWALI, SULAWESI TENGAH",1,76,103,179
https://kawalpemilu.org#68641,"SIUMBATU, BAHODOPI, MOROWALI, SULAWESI TENGAH",2,77,128,205
https://kawalpemilu.org#68641,"SIUMBATU, BAHODOPI, MOROWALI, SULAWESI TENGAH",3,100,127,227
https://kawalpemilu.org#68641,"SIUMBATU, BAHODOPI, MOROWALI, SULAWESI TENGAH",4,44,103,147
https://kawalpemilu.org#68642,"DAMPALA, BAHODOPI, MOROWALI, SULAWESI TENGAH",1,112,155,267
https://kawalpemilu.org#68642,"DAMPALA, BAHODOPI, MOROWALI, SULAWESI TENGAH",2,72,179,251
https://kawalpemilu.org#68642,"DAMPALA, BAHODOPI, MOROWALI, SULAWESI TENGAH",3,67,141,208
https://kawalpemilu.org#68643,"LE-LE, BAHODOPI, MOROWALI, SULAWESI TENGAH",1,43,88,131
https://kawalpemilu.org#68643,"LE-LE, BAHODOPI, MOROWALI, SULAWESI TENGAH",2,50,74,124
https://kawalpemilu.org#68643,"LE-LE, BAHODOPI, MOROWALI, SULAWESI TENGAH",3,49,110,159
https://kawalpemilu.org#68643,"LE-LE, BAHODOPI, MOROWALI, SULAWESI TENGAH",4,12,35,47
https://kawalpemilu.org#68644,"BAHO MAKMUR, BAHODOPI, MOROWALI, SULAWESI TENGAH",1,119,119,238
https://kawalpemilu.org#68644,"BAHO MAKMUR, BAHODOPI, MOROWALI, SULAWESI TENGAH",2,116,95,211
https://kawalpemilu.org#68644,"BAHO MAKMUR, BAHODOPI, MOROWALI, SULAWESI TENGAH",3,109,105,214
https://kawalpemilu.org#68644,"BAHO MAKMUR, BAHODOPI, MOROWALI, SULAWESI TENGAH",4,140,88,228
https://kawalpemilu.org#68644,"BAHO MAKMUR, BAHODOPI, MOROWALI, SULAWESI TENGAH",5,97,101,198
https://kawalpemilu.org#68644,"BAHO MAKMUR, BAHODOPI, MOROWALI, SULAWESI TENGAH",6,86,59,145
https://kawalpemilu.org#68644,"BAHO MAKMUR, BAHODOPI, MOROWALI, SULAWESI TENGAH",7,97,98,195
https://kawalpemilu.org#68644,"BAHO MAKMUR, BAHODOPI, MOROWALI, SULAWESI TENGAH",8,95,57,152
https://kawalpemilu.org#68645,"MAKARTIJAYA, BAHODOPI, MOROWALI, SULAWESI TENGAH",1,55,132,187
https://kawalpemilu.org#68645,"MAKARTIJAYA, BAHODOPI, MOROWALI, SULAWESI TENGAH",2,63,131,194
https://kawalpemilu.org#68645,"MAKARTIJAYA, BAHODOPI, MOROWALI, SULAWESI TENGAH",3,68,137,205
https://kawalpemilu.org#68657,"SAMPEANTABA, WITA PONDA, MOROWALI, SULAWESI TENGAH",1,137,67,204
https://kawalpemilu.org#68657,"SAMPEANTABA, WITA PONDA, MOROWALI, SULAWESI TENGAH",2,133,88,221
https://kawalpemilu.org#68657,"SAMPEANTABA, WITA PONDA, MOROWALI, SULAWESI TENGAH",3,100,109,209
https://kawalpemilu.org#68657,"SAMPEANTABA, WITA PONDA, MOROWALI, SULAWESI TENGAH",4,93,89,182
https://kawalpemilu.org#68658,"EMEA, WITA PONDA, MOROWALI, SULAWESI TENGAH",1,84,128,212
https://kawalpemilu.org#68658,"EMEA, WITA PONDA, MOROWALI, SULAWESI TENGAH",2,69,137,206
https://kawalpemilu.org#68658,"EMEA, WITA PONDA, MOROWALI, SULAWESI TENGAH",3,84,101,185
https://kawalpemilu.org#68658,"EMEA, WITA PONDA, MOROWALI, SULAWESI TENGAH",4,70,123,193
https://kawalpemilu.org#68658,"EMEA, WITA PONDA, MOROWALI, SULAWESI TENGAH",5,60,131,191
https://kawalpemilu.org#68658,"EMEA, WITA PONDA, MOROWALI, SULAWESI TENGAH",6,114,86,200
https://kawalpemilu.org#68659,"UNGKAYA, WITA PONDA, MOROWALI, SULAWESI TENGAH",1,55,123,178
https://kawalpemilu.org#68659,"UNGKAYA, WITA PONDA, MOROWALI, SULAWESI TENGAH",2,77,128,205
https://kawalpemilu.org#68659,"UNGKAYA, WITA PONDA, MOROWALI, SULAWESI TENGAH",3,80,127,207
https://kawalpemilu.org#68659,"UNGKAYA, WITA PONDA, MOROWALI, SULAWESI TENGAH",4,73,101,174
https://kawalpemilu.org#68659,"UNGKAYA, WITA PONDA, MOROWALI, SULAWESI TENGAH",5,116,94,210
https://kawalpemilu.org#68659,"UNGKAYA, WITA PONDA, MOROWALI, SULAWESI TENGAH",6,124,118,242
https://kawalpemilu.org#68659,"UNGKAYA, WITA PONDA, MOROWALI, SULAWESI TENGAH",7,106,38,144
https://kawalpemilu.org#68659,"UNGKAYA, WITA PONDA, MOROWALI, SULAWESI TENGAH",8,64,70,134
https://kawalpemilu.org#68660,"MOAHINO, WITA PONDA, MOROWALI, SULAWESI TENGAH",1,94,78,172
https://kawalpemilu.org#68660,"MOAHINO, WITA PONDA, MOROWALI, SULAWESI TENGAH",2,83,102,185
https://kawalpemilu.org#68660,"MOAHINO, WITA PONDA, MOROWALI, SULAWESI TENGAH",3,67,131,198
https://kawalpemilu.org#68660,"MOAHINO, WITA PONDA, MOROWALI, SULAWESI TENGAH",4,114,88,202
https://kawalpemilu.org#68660,"MOAHINO, WITA PONDA, MOROWALI, SULAWESI TENGAH",5,74,125,199
https://kawalpemilu.org#68660,"MOAHINO, WITA PONDA, MOROWALI, SULAWESI TENGAH",6,100,82,182
https://kawalpemilu.org#68661,"SOLONSA, WITA PONDA, MOROWALI, SULAWESI TENGAH",1,88,115,203
https://kawalpemilu.org#68661,"SOLONSA, WITA PONDA, MOROWALI, SULAWESI TENGAH",2,87,88,175
https://kawalpemilu.org#68661,"SOLONSA, WITA PONDA, MOROWALI, SULAWESI TENGAH",3,73,98,171
https://kawalpemilu.org#68661,"SOLONSA, WITA PONDA, MOROWALI, SULAWESI TENGAH",4,97,92,189
https://kawalpemilu.org#68661,"SOLONSA, WITA PONDA, MOROWALI, SULAWESI TENGAH",5,91,110,201
https://kawalpemilu.org#68662,"LANTULA JAYA, WITA PONDA, MOROWALI, SULAWESI TENGAH",1,170,63,233
https://kawalpemilu.org#68662,"LANTULA JAYA, WITA PONDA, MOROWALI, SULAWESI TENGAH",2,189,48,237
https://kawalpemilu.org#68662,"LANTULA JAYA, WITA PONDA, MOROWALI, SULAWESI TENGAH",3,170,52,222
https://kawalpemilu.org#68662,"LANTULA JAYA, WITA PONDA, MOROWALI, SULAWESI TENGAH",4,165,69,234
https://kawalpemilu.org#68662,"LANTULA JAYA, WITA PONDA, MOROWALI, SULAWESI TENGAH",5,173,66,239
https://kawalpemilu.org#68662,"LANTULA JAYA, WITA PONDA, MOROWALI, SULAWESI TENGAH",6,199,40,239
https://kawalpemilu.org#68662,"LANTULA JAYA, WITA PONDA, MOROWALI, SULAWESI TENGAH",7,180,44,224
https://kawalpemilu.org#68662,"LANTULA JAYA, WITA PONDA, MOROWALI, SULAWESI TENGAH",8,172,40,212
https://kawalpemilu.org#68662,"LANTULA JAYA, WITA PONDA, MOROWALI, SULAWESI TENGAH",9,190,41,231
https://kawalpemilu.org#68663,"PUNTARI MAKMUR, WITA PONDA, MOROWALI, SULAWESI TENGAH",1,169,64,233
https://kawalpemilu.org#68663,"PUNTARI MAKMUR, WITA PONDA, MOROWALI, SULAWESI TENGAH",2,144,58,202
https://kawalpemilu.org#68663,"PUNTARI MAKMUR, WITA PONDA, MOROWALI, SULAWESI TENGAH",3,204,17,221
https://kawalpemilu.org#68663,"PUNTARI MAKMUR, WITA PONDA, MOROWALI, SULAWESI TENGAH",4,145,40,185
https://kawalpemilu.org#68663,"PUNTARI MAKMUR, WITA PONDA, MOROWALI, SULAWESI TENGAH",5,182,36,218
https://kawalpemilu.org#68663,"PUNTARI MAKMUR, WITA PONDA, MOROWALI, SULAWESI TENGAH",6,170,41,211
https://kawalpemilu.org#68663,"PUNTARI MAKMUR, WITA PONDA, MOROWALI, SULAWESI TENGAH",7,143,71,214
https://kawalpemilu.org#68664,"BUMI HARAPAN, WITA PONDA, MOROWALI, SULAWESI TENGAH",1,217,19,236
https://kawalpemilu.org#68664,"BUMI HARAPAN, WITA PONDA, MOROWALI, SULAWESI TENGAH",2,149,90,239
https://kawalpemilu.org#68664,"BUMI HARAPAN, WITA PONDA, MOROWALI, SULAWESI TENGAH",3,164,52,216
https://kawalpemilu.org#68664,"BUMI HARAPAN, WITA PONDA, MOROWALI, SULAWESI TENGAH",4,180,61,241
https://kawalpemilu.org#68664,"BUMI HARAPAN, WITA PONDA, MOROWALI, SULAWESI TENGAH",5,194,38,232
https://kawalpemilu.org#68665,"SOLONSA JAYA, WITA PONDA, MOROWALI, SULAWESI TENGAH",1,115,84,199
https://kawalpemilu.org#68665,"SOLONSA JAYA, WITA PONDA, MOROWALI, SULAWESI TENGAH",2,119,70,189
https://kawalpemilu.org#68665,"SOLONSA JAYA, WITA PONDA, MOROWALI, SULAWESI TENGAH",3,133,70,203
https://kawalpemilu.org#68665,"SOLONSA JAYA, WITA PONDA, MOROWALI, SULAWESI TENGAH",4,117,62,179
https://kawalpemilu.org#68665,"SOLONSA JAYA, WITA PONDA, MOROWALI, SULAWESI TENGAH",5,113,50,163
https://kawalpemilu.org#68665,"SOLONSA JAYA, WITA PONDA, MOROWALI, SULAWESI TENGAH",6,79,107,186
https://kawalpemilu.org#68575,"SAMBALAGI, BUNGKU PESISIR, MOROWALI, SULAWESI TENGAH",1,70,109,179
https://kawalpemilu.org#68575,"SAMBALAGI, BUNGKU PESISIR, MOROWALI, SULAWESI TENGAH",2,90,83,0
https://kawalpemilu.org#68576,"LAROENAI, BUNGKU PESISIR, MOROWALI, SULAWESI TENGAH",1,105,125,230
https://kawalpemilu.org#68577,"BULELENG, BUNGKU PESISIR, MOROWALI, SULAWESI TENGAH",1,72,210,282
https://kawalpemilu.org#68577,"BULELENG, BUNGKU PESISIR, MOROWALI, SULAWESI TENGAH",2,85,157,242
https://kawalpemilu.org#68577,"BULELENG, BUNGKU PESISIR, MOROWALI, SULAWESI TENGAH",3,115,45,160
https://kawalpemilu.org#68577,"BULELENG, BUNGKU PESISIR, MOROWALI, SULAWESI TENGAH",4,98,36,134
https://kawalpemilu.org#68578,"TORETE, BUNGKU PESISIR, MOROWALI, SULAWESI TENGAH",1,98,137,235
https://kawalpemilu.org#68579,"LAFEU, BUNGKU PESISIR, MOROWALI, SULAWESI TENGAH",1,113,109,222
https://kawalpemilu.org#68579,"LAFEU, BUNGKU PESISIR, MOROWALI, SULAWESI TENGAH",2,83,120,203
https://kawalpemilu.org#68579,"LAFEU, BUNGKU PESISIR, MOROWALI, SULAWESI TENGAH",3,82,126,208
https://kawalpemilu.org#68579,"LAFEU, BUNGKU PESISIR, MOROWALI, SULAWESI TENGAH",4,79,105,184
https://kawalpemilu.org#68580,"TANDAOLEO, BUNGKU PESISIR, MOROWALI, SULAWESI TENGAH",1,102,136,238
https://kawalpemilu.org#68581,"ONE ETE, BUNGKU PESISIR, MOROWALI, SULAWESI TENGAH",1,50,94,144
https://kawalpemilu.org#68582,"TANGOFA, BUNGKU PESISIR, MOROWALI, SULAWESI TENGAH",1,46,120,166
https://kawalpemilu.org#68582,"TANGOFA, BUNGKU PESISIR, MOROWALI, SULAWESI TENGAH",2,42,132,174
https://kawalpemilu.org#68582,"TANGOFA, BUNGKU PESISIR, MOROWALI, SULAWESI TENGAH",3,44,128,172
https://kawalpemilu.org#89703,"PUUNGKEU, BUNGKU PESISIR, MOROWALI, SULAWESI TENGAH",1,44,48,130
https://kawalpemilu.org#89704,"WERE'A, BUNGKU PESISIR, MOROWALI, SULAWESI TENGAH",1,46,74,120
https://kawalpemilu.org#68532,"BAHOMOTEFE, BUNGKU TIMUR, MOROWALI, SULAWESI TENGAH",1,81,146,227
https://kawalpemilu.org#68532,"BAHOMOTEFE, BUNGKU TIMUR, MOROWALI, SULAWESI TENGAH",2,82,158,240
https://kawalpemilu.org#68532,"BAHOMOTEFE, BUNGKU TIMUR, MOROWALI, SULAWESI TENGAH",3,77,147,224
https://kawalpemilu.org#68532,"BAHOMOTEFE, BUNGKU TIMUR, MOROWALI, SULAWESI TENGAH",4,66,154,220
https://kawalpemilu.org#68532,"BAHOMOTEFE, BUNGKU TIMUR, MOROWALI, SULAWESI TENGAH",5,86,154,240
https://kawalpemilu.org#68533,"BAHOMOAHI, BUNGKU TIMUR, MOROWALI, SULAWESI TENGAH",1,72,114,186
https://kawalpemilu.org#68533,"BAHOMOAHI, BUNGKU TIMUR, MOROWALI, SULAWESI TENGAH",2,84,104,188
https://kawalpemilu.org#68533,"BAHOMOAHI, BUNGKU TIMUR, MOROWALI, SULAWESI TENGAH",3,23,82,105
https://kawalpemilu.org#68534,"ULULERE, BUNGKU TIMUR, MOROWALI, SULAWESI TENGAH",1,68,162,230
https://kawalpemilu.org#68534,"ULULERE, BUNGKU TIMUR, MOROWALI, SULAWESI TENGAH",2,145,136,231
https://kawalpemilu.org#68535,"KOLONO, BUNGKU TIMUR, MOROWALI, SULAWESI TENGAH",1,66,144,210
https://kawalpemilu.org#68535,"KOLONO, BUNGKU TIMUR, MOROWALI, SULAWESI TENGAH",2,54,180,234
https://kawalpemilu.org#68535,"KOLONO, BUNGKU TIMUR, MOROWALI, SULAWESI TENGAH",3,65,151,216
https://kawalpemilu.org#68535,"KOLONO, BUNGKU TIMUR, MOROWALI, SULAWESI TENGAH",4,85,142,227
https://kawalpemilu.org#68535,"KOLONO, BUNGKU TIMUR, MOROWALI, SULAWESI TENGAH",5,67,135,202
https://kawalpemilu.org#68536,"GERESA, BUNGKU TIMUR, MOROWALI, SULAWESI TENGAH",1,73,132,205
https://kawalpemilu.org#68536,"GERESA, BUNGKU TIMUR, MOROWALI, SULAWESI TENGAH",2,93,97,190
https://kawalpemilu.org#68536,"GERESA, BUNGKU TIMUR, MOROWALI, SULAWESI TENGAH",3,32,75,107
https://kawalpemilu.org#68537,"LAROUE, BUNGKU TIMUR, MOROWALI, SULAWESI TENGAH",1,84,133,217
https://kawalpemilu.org#68537,"LAROUE, BUNGKU TIMUR, MOROWALI, SULAWESI TENGAH",2,85,140,225
https://kawalpemilu.org#68537,"LAROUE, BUNGKU TIMUR, MOROWALI, SULAWESI TENGAH",3,73,92,165
https://kawalpemilu.org#68538,"NAMBO, BUNGKU TIMUR, MOROWALI, SULAWESI TENGAH",1,81,154,235
https://kawalpemilu.org#68538,"NAMBO, BUNGKU TIMUR, MOROWALI, SULAWESI TENGAH",2,102,127,229
https://kawalpemilu.org#68538,"NAMBO, BUNGKU TIMUR, MOROWALI, SULAWESI TENGAH",3,26,122,148
https://kawalpemilu.org#68539,"UNSONGI, BUNGKU TIMUR, MOROWALI, SULAWESI TENGAH",1,77,164,241
https://kawalpemilu.org#68539,"UNSONGI, BUNGKU TIMUR, MOROWALI, SULAWESI TENGAH",2,52,160,212
https://kawalpemilu.org#68540,"LAHUAFU, BUNGKU TIMUR, MOROWALI, SULAWESI TENGAH",1,75,145,220
https://kawalpemilu.org#68540,"LAHUAFU, BUNGKU TIMUR, MOROWALI, SULAWESI TENGAH",2,78,157,235
https://kawalpemilu.org#68540,"LAHUAFU, BUNGKU TIMUR, MOROWALI, SULAWESI TENGAH",3,34,119,153
https://kawalpemilu.org#89711,"ONEPUTEH JAYA, BUNGKU TIMUR, MOROWALI, SULAWESI TENGAH",1,128,108,236
https://kawalpemilu.org#89711,"ONEPUTEH JAYA, BUNGKU TIMUR, MOROWALI, SULAWESI TENGAH",2,78,86,164
https://kawalpemilu.org#89711,"ONEPUTEH JAYA, BUNGKU TIMUR, MOROWALI, SULAWESI TENGAH",3,190,61,151
https://kawalpemilu.org#68702,"SOBONON, TOTIKUM, BANGGAI KEPULAUAN, SULAWESI TENGAH",1,133,82,215
https://kawalpemilu.org#68703,"BOLONAN, TOTIKUM, BANGGAI KEPULAUAN, SULAWESI TENGAH",1,83,75,158
https://kawalpemilu.org#68703,"BOLONAN, TOTIKUM, BANGGAI KEPULAUAN, SULAWESI TENGAH",2,95,66,161
https://kawalpemilu.org#68704,"BATANG BABASAL, TOTIKUM, BANGGAI KEPULAUAN, SULAWESI TENGAH",1,81,141,222
https://kawalpemilu.org#68704,"BATANG BABASAL, TOTIKUM, BANGGAI KEPULAUAN, SULAWESI TENGAH",2,116,112,228
https://kawalpemilu.org#68704,"BATANG BABASAL, TOTIKUM, BANGGAI KEPULAUAN, SULAWESI TENGAH",3,97,112,209
https://kawalpemilu.org#68705,"SAMPAKA, TOTIKUM, BANGGAI KEPULAUAN, SULAWESI TENGAH",1,114,91,205
https://kawalpemilu.org#68705,"SAMPAKA, TOTIKUM, BANGGAI KEPULAUAN, SULAWESI TENGAH",2,94,87,181
https://kawalpemilu.org#68705,"SAMPAKA, TOTIKUM, BANGGAI KEPULAUAN, SULAWESI TENGAH",3,46,83,129
https://kawalpemilu.org#68706,"SALANGANO, TOTIKUM, BANGGAI KEPULAUAN, SULAWESI TENGAH",1,75,139,214
https://kawalpemilu.org#68706,"SALANGANO, TOTIKUM, BANGGAI KEPULAUAN, SULAWESI TENGAH",2,94,109,203
https://kawalpemilu.org#68706,"SALANGANO, TOTIKUM, BANGGAI KEPULAUAN, SULAWESI TENGAH",3,77,124,201
https://kawalpemilu.org#68707,"SAMBIUT, TOTIKUM, BANGGAI KEPULAUAN, SULAWESI TENGAH",1,65,124,189
https://kawalpemilu.org#68707,"SAMBIUT, TOTIKUM, BANGGAI KEPULAUAN, SULAWESI TENGAH",2,63,133,196
https://kawalpemilu.org#68707,"SAMBIUT, TOTIKUM, BANGGAI KEPULAUAN, SULAWESI TENGAH",3,47,72,119
https://kawalpemilu.org#68708,"SAKAY, TOTIKUM, BANGGAI KEPULAUAN, SULAWESI TENGAH",1,70,66,136
https://kawalpemilu.org#68708,"SAKAY, TOTIKUM, BANGGAI KEPULAUAN, SULAWESI TENGAH",2,139,69,208
https://kawalpemilu.org#68709,"TONE, TOTIKUM, BANGGAI KEPULAUAN, SULAWESI TENGAH",1,178,32,210
https://kawalpemilu.org#68710,"ABASON, TOTIKUM, BANGGAI KEPULAUAN, SULAWESI TENGAH",1,68,117,185
https://kawalpemilu.org#68710,"ABASON, TOTIKUM, BANGGAI KEPULAUAN, SULAWESI TENGAH",2,85,124,209
https://kawalpemilu.org#68710,"ABASON, TOTIKUM, BANGGAI KEPULAUAN, SULAWESI TENGAH",3,54,96,150
https://kawalpemilu.org#68710,"ABASON, TOTIKUM, BANGGAI KEPULAUAN, SULAWESI TENGAH",4,56,122,178
https://kawalpemilu.org#68711,"LOPITO, TOTIKUM, BANGGAI KEPULAUAN, SULAWESI TENGAH",1,129,80,209
https://kawalpemilu.org#68711,"LOPITO, TOTIKUM, BANGGAI KEPULAUAN, SULAWESI TENGAH",2,109,105,214
https://kawalpemilu.org#68711,"LOPITO, TOTIKUM, BANGGAI KEPULAUAN, SULAWESI TENGAH",3,114,88,202
https://kawalpemilu.org#68711,"LOPITO, TOTIKUM, BANGGAI KEPULAUAN, SULAWESI TENGAH",4,125,100,225
https://kawalpemilu.org#68712,"KOMBUTOKAN, TOTIKUM, BANGGAI KEPULAUAN, SULAWESI TENGAH",1,128,115,243
https://kawalpemilu.org#68712,"KOMBUTOKAN, TOTIKUM, BANGGAI KEPULAUAN, SULAWESI TENGAH",2,105,99,204
https://kawalpemilu.org#68712,"KOMBUTOKAN, TOTIKUM, BANGGAI KEPULAUAN, SULAWESI TENGAH",3,86,102,188
https://kawalpemilu.org#68712,"KOMBUTOKAN, TOTIKUM, BANGGAI KEPULAUAN, SULAWESI TENGAH",4,96,104,200
https://kawalpemilu.org#68712,"KOMBUTOKAN, TOTIKUM, BANGGAI KEPULAUAN, SULAWESI TENGAH",5,140,84,224
https://kawalpemilu.org#68712,"KOMBUTOKAN, TOTIKUM, BANGGAI KEPULAUAN, SULAWESI TENGAH",6,110,35,145
https://kawalpemilu.org#68712,"KOMBUTOKAN, TOTIKUM, BANGGAI KEPULAUAN, SULAWESI TENGAH",7,87,82,169
https://kawalpemilu.org#68712,"KOMBUTOKAN, TOTIKUM, BANGGAI KEPULAUAN, SULAWESI TENGAH",8,81,116,197
https://kawalpemilu.org#68714,"SALAKAN, TINANGKUNG, BANGGAI KEPULAUAN, SULAWESI TENGAH",1,45,116,161
https://kawalpemilu.org#68714,"SALAKAN, TINANGKUNG, BANGGAI KEPULAUAN, SULAWESI TENGAH",2,52,105,157
https://kawalpemilu.org#68714,"SALAKAN, TINANGKUNG, BANGGAI KEPULAUAN, SULAWESI TENGAH",3,79,111,190
https://kawalpemilu.org#68714,"SALAKAN, TINANGKUNG, BANGGAI KEPULAUAN, SULAWESI TENGAH",4,64,105,169
https://kawalpemilu.org#68714,"SALAKAN, TINANGKUNG, BANGGAI KEPULAUAN, SULAWESI TENGAH",5,36,62,98
https://kawalpemilu.org#68714,"SALAKAN, TINANGKUNG, BANGGAI KEPULAUAN, SULAWESI TENGAH",6,48,92,140
https://kawalpemilu.org#68714,"SALAKAN, TINANGKUNG, BANGGAI KEPULAUAN, SULAWESI TENGAH",7,95,92,187
https://kawalpemilu.org#68715,"MANGGALAI, TINANGKUNG, BANGGAI KEPULAUAN, SULAWESI TENGAH",1,87,53,140
https://kawalpemilu.org#68715,"MANGGALAI, TINANGKUNG, BANGGAI KEPULAUAN, SULAWESI TENGAH",2,104,68,172
https://kawalpemilu.org#68715,"MANGGALAI, TINANGKUNG, BANGGAI KEPULAUAN, SULAWESI TENGAH",3,103,49,152
https://kawalpemilu.org#68716,"AMBELANG, TINANGKUNG, BANGGAI KEPULAUAN, SULAWESI TENGAH",1,73,106,179
https://kawalpemilu.org#68716,"AMBELANG, TINANGKUNG, BANGGAI KEPULAUAN, SULAWESI TENGAH",2,91,74,165
https://kawalpemilu.org#68716,"AMBELANG, TINANGKUNG, BANGGAI KEPULAUAN, SULAWESI TENGAH",3,163,67,230
https://kawalpemilu.org#68716,"AMBELANG, TINANGKUNG, BANGGAI KEPULAUAN, SULAWESI TENGAH",4,79,93,172
https://kawalpemilu.org#68716,"AMBELANG, TINANGKUNG, BANGGAI KEPULAUAN, SULAWESI TENGAH",5,96,82,178
https://kawalpemilu.org#68717,"SAIYONG, TINANGKUNG, BANGGAI KEPULAUAN, SULAWESI TENGAH",1,96,53,149
https://kawalpemilu.org#68717,"SAIYONG, TINANGKUNG, BANGGAI KEPULAUAN, SULAWESI TENGAH",2,76,92,168
https://kawalpemilu.org#68718,"TOMPUDAU, TINANGKUNG, BANGGAI KEPULAUAN, SULAWESI TENGAH",1,146,27,173
https://kawalpemilu.org#68718,"TOMPUDAU, TINANGKUNG, BANGGAI KEPULAUAN, SULAWESI TENGAH",2,140,25,165
https://kawalpemilu.org#68718,"TOMPUDAU, TINANGKUNG, BANGGAI KEPULAUAN, SULAWESI TENGAH",3,135,37,172
https://kawalpemilu.org#68719,"BONGGANAN, TINANGKUNG, BANGGAI KEPULAUAN, SULAWESI TENGAH",1,109,83,192
https://kawalpemilu.org#68719,"BONGGANAN, TINANGKUNG, BANGGAI KEPULAUAN, SULAWESI TENGAH",2,105,87,192
https://kawalpemilu.org#68719,"BONGGANAN, TINANGKUNG, BANGGAI KEPULAUAN, SULAWESI TENGAH",3,108,91,199
https://kawalpemilu.org#68719,"BONGGANAN, TINANGKUNG, BANGGAI KEPULAUAN, SULAWESI TENGAH",4,103,81,184
https://kawalpemilu.org#68719,"BONGGANAN, TINANGKUNG, BANGGAI KEPULAUAN, SULAWESI TENGAH",5,97,78,175
https://kawalpemilu.org#68719,"BONGGANAN, TINANGKUNG, BANGGAI KEPULAUAN, SULAWESI TENGAH",6,112,74,186
https://kawalpemilu.org#68719,"BONGGANAN, TINANGKUNG, BANGGAI KEPULAUAN, SULAWESI TENGAH",7,98,73,171
https://kawalpemilu.org#68719,"BONGGANAN, TINANGKUNG, BANGGAI KEPULAUAN, SULAWESI TENGAH",8,137,80,217
https://kawalpemilu.org#68720,"BAKA, TINANGKUNG, BANGGAI KEPULAUAN, SULAWESI TENGAH",1,71,109,180
https://kawalpemilu.org#68720,"BAKA, TINANGKUNG, BANGGAI KEPULAUAN, SULAWESI TENGAH",2,55,111,166
https://kawalpemilu.org#68720,"BAKA, TINANGKUNG, BANGGAI KEPULAUAN, SULAWESI TENGAH",3,65,150,215
https://kawalpemilu.org#68720,"BAKA, TINANGKUNG, BANGGAI KEPULAUAN, SULAWESI TENGAH",4,82,19,101
https://kawalpemilu.org#68720,"BAKA, TINANGKUNG, BANGGAI KEPULAUAN, SULAWESI TENGAH",5,72,105,177
https://kawalpemilu.org#68720,"BAKA, TINANGKUNG, BANGGAI KEPULAUAN, SULAWESI TENGAH",6,60,134,194
https://kawalpemilu.org#68720,"BAKA, TINANGKUNG, BANGGAI KEPULAUAN, SULAWESI TENGAH",7,95,110,205
https://kawalpemilu.org#68720,"BAKA, TINANGKUNG, BANGGAI KEPULAUAN, SULAWESI TENGAH",8,85,147,232
https://kawalpemilu.org#68721,"BULUNGKOBIT, TINANGKUNG, BANGGAI KEPULAUAN, SULAWESI TENGAH",1,67,136,203
https://kawalpemilu.org#68721,"BULUNGKOBIT, TINANGKUNG, BANGGAI KEPULAUAN, SULAWESI TENGAH",2,48,146,194
https://kawalpemilu.org#68721,"BULUNGKOBIT, TINANGKUNG, BANGGAI KEPULAUAN, SULAWESI TENGAH",3,57,151,208
https://kawalpemilu.org#68722,"BAKALAN, TINANGKUNG, BANGGAI KEPULAUAN, SULAWESI TENGAH",1,63,134,197
https://kawalpemilu.org#68722,"BAKALAN, TINANGKUNG, BANGGAI KEPULAUAN, SULAWESI TENGAH",2,47,146,193
https://kawalpemilu.org#68723,"KAUTU, TINANGKUNG, BANGGAI KEPULAUAN, SULAWESI TENGAH",1,39,149,188
https://kawalpemilu.org#68723,"KAUTU, TINANGKUNG, BANGGAI KEPULAUAN, SULAWESI TENGAH",2,50,128,178
https://kawalpemilu.org#68723,"KAUTU, TINANGKUNG, BANGGAI KEPULAUAN, SULAWESI TENGAH",3,98,37,135
https://kawalpemilu.org#68723,"KAUTU, TINANGKUNG, BANGGAI KEPULAUAN, SULAWESI TENGAH",4,59,122,181
https://kawalpemilu.org#68723,"KAUTU, TINANGKUNG, BANGGAI KEPULAUAN, SULAWESI TENGAH",5,61,137,198
https://kawalpemilu.org#68724,"BUNGIN, TINANGKUNG, BANGGAI KEPULAUAN, SULAWESI TENGAH",1,101,70,171
https://kawalpemilu.org#68724,"BUNGIN, TINANGKUNG, BANGGAI KEPULAUAN, SULAWESI TENGAH",2,114,60,174
https://kawalpemilu.org#68724,"BUNGIN, TINANGKUNG, BANGGAI KEPULAUAN, SULAWESI TENGAH",3,87,94,181
https://kawalpemilu.org#68726,"TANGKOP, LIANG, BANGGAI KEPULAUAN, SULAWESI TENGAH",1,40,133,173
https://kawalpemilu.org#68727,"BINUNTULI, LIANG, BANGGAI KEPULAUAN, SULAWESI TENGAH",1,129,102,231
https://kawalpemilu.org#68727,"BINUNTULI, LIANG, BANGGAI KEPULAUAN, SULAWESI TENGAH",2,90,11,101
https://kawalpemilu.org#68728,"POPIDOLON, LIANG, BANGGAI KEPULAUAN, SULAWESI TENGAH",1,90,96,186
https://kawalpemilu.org#68728,"POPIDOLON, LIANG, BANGGAI KEPULAUAN, SULAWESI TENGAH",2,90,103,193
https://kawalpemilu.org#68729,"OKUMEL, LIANG, BANGGAI KEPULAUAN, SULAWESI TENGAH",1,91,108,199
https://kawalpemilu.org#68729,"OKUMEL, LIANG, BANGGAI KEPULAUAN, SULAWESI TENGAH",2,107,105,212
https://kawalpemilu.org#68729,"OKUMEL, LIANG, BANGGAI KEPULAUAN, SULAWESI TENGAH",3,57,143,200
https://kawalpemilu.org#68729,"OKUMEL, LIANG, BANGGAI KEPULAUAN, SULAWESI TENGAH",4,44,127,171
https://kawalpemilu.org#68730,"TOMBONIKI, LIANG, BANGGAI KEPULAUAN, SULAWESI TENGAH",1,80,110,190
https://kawalpemilu.org#68731,"KINDANDAL, LIANG, BANGGAI KEPULAUAN, SULAWESI TENGAH",1,56,120,176
https://kawalpemilu.org#68731,"KINDANDAL, LIANG, BANGGAI KEPULAUAN, SULAWESI TENGAH",2,72,118,190
https://kawalpemilu.org#68732,"MAMULUSAN, LIANG, BANGGAI KEPULAUAN, SULAWESI TENGAH",1,83,52,135
https://kawalpemilu.org#68732,"MAMULUSAN, LIANG, BANGGAI KEPULAUAN, SULAWESI TENGAH",2,82,61,143
https://kawalpemilu.org#68733,"SALEATI, LIANG, BANGGAI KEPULAUAN, SULAWESI TENGAH",1,39,113,152
https://kawalpemilu.org#68733,"SALEATI, LIANG, BANGGAI KEPULAUAN, SULAWESI TENGAH",2,70,90,160
https://kawalpemilu.org#68734,"LIANG, LIANG, BANGGAI KEPULAUAN, SULAWESI TENGAH",1,49,129,178
https://kawalpemilu.org#68734,"LIANG, LIANG, BANGGAI KEPULAUAN, SULAWESI TENGAH",2,48,127,175
https://kawalpemilu.org#68734,"LIANG, LIANG, BANGGAI KEPULAUAN, SULAWESI TENGAH",3,57,57,114
https://kawalpemilu.org#68734,"LIANG, LIANG, BANGGAI KEPULAUAN, SULAWESI TENGAH",4,37,128,165
https://kawalpemilu.org#68735,"BAJO, LIANG, BANGGAI KEPULAUAN, SULAWESI TENGAH",1,94,103,197
https://kawalpemilu.org#68735,"BAJO, LIANG, BANGGAI KEPULAUAN, SULAWESI TENGAH",2,87,109,196
https://kawalpemilu.org#68735,"BAJO, LIANG, BANGGAI KEPULAUAN, SULAWESI TENGAH",3,95,100,195
https://kawalpemilu.org#68736,"BALAYON, LIANG, BANGGAI KEPULAUAN, SULAWESI TENGAH",1,160,80,240
https://kawalpemilu.org#68737,"BASOSOL, LIANG, BANGGAI KEPULAUAN, SULAWESI TENGAH",1,142,28,170
https://kawalpemilu.org#68737,"BASOSOL, LIANG, BANGGAI KEPULAUAN, SULAWESI TENGAH",2,134,59,193
https://kawalpemilu.org#68738,"BOYOUMOUTE, LIANG, BANGGAI KEPULAUAN, SULAWESI TENGAH",1,98,35,133
https://kawalpemilu.org#68739,"APAL, LIANG, BANGGAI KEPULAUAN, SULAWESI TENGAH",1,106,78,184
https://kawalpemilu.org#68739,"APAL, LIANG, BANGGAI KEPULAUAN, SULAWESI TENGAH",2,103,64,167
https://kawalpemilu.org#68739,"APAL, LIANG, BANGGAI KEPULAUAN, SULAWESI TENGAH",3,87,73,160
https://kawalpemilu.org#68740,"SELEKAN, LIANG, BANGGAI KEPULAUAN, SULAWESI TENGAH",1,61,115,176
https://kawalpemilu.org#68740,"SELEKAN, LIANG, BANGGAI KEPULAUAN, SULAWESI TENGAH",2,79,86,165
https://kawalpemilu.org#85668,"LOOLONG, LIANG, BANGGAI KEPULAUAN, SULAWESI TENGAH",1,136,73,209
https://kawalpemilu.org#68742,"BULAGI I, BULAGI, BANGGAI KEPULAUAN, SULAWESI TENGAH",1,98,95,193
https://kawalpemilu.org#68742,"BULAGI I, BULAGI, BANGGAI KEPULAUAN, SULAWESI TENGAH",2,55,123,178
https://kawalpemilu.org#68742,"BULAGI I, BULAGI, BANGGAI KEPULAUAN, SULAWESI TENGAH",3,58,90,148
https://kawalpemilu.org#68742,"BULAGI I, BULAGI, BANGGAI KEPULAUAN, SULAWESI TENGAH",4,56,70,126
https://kawalpemilu.org#68743,"TOLO, BULAGI, BANGGAI KEPULAUAN, SULAWESI TENGAH",1,158,26,184
https://kawalpemilu.org#68744,"LALANDAI, BULAGI, BANGGAI KEPULAUAN, SULAWESI TENGAH",1,94,35,129
https://kawalpemilu.org#68744,"LALANDAI, BULAGI, BANGGAI KEPULAUAN, SULAWESI TENGAH",2,88,48,136
https://kawalpemilu.org#68745,"MONTOMISAN, BULAGI, BANGGAI KEPULAUAN, SULAWESI TENGAH",1,104,102,206
https://kawalpemilu.org#68746,"SOSOM, BULAGI, BANGGAI KEPULAUAN, SULAWESI TENGAH",1,182,37,219
https://kawalpemilu.org#68746,"SOSOM, BULAGI, BANGGAI KEPULAUAN, SULAWESI TENGAH",2,126,38,164
https://kawalpemilu.org#68747,"BULAGI II, BULAGI, BANGGAI KEPULAUAN, SULAWESI TENGAH",1,150,22,172
https://kawalpemilu.org#68747,"BULAGI II, BULAGI, BANGGAI KEPULAUAN, SULAWESI TENGAH",2,138,33,171
https://kawalpemilu.org#68747,"BULAGI II, BULAGI, BANGGAI KEPULAUAN, SULAWESI TENGAH",3,96,23,119
https://kawalpemilu.org#68748,"BOLOY, BULAGI, BANGGAI KEPULAUAN, SULAWESI TENGAH",1,109,16,125
https://kawalpemilu.org#68748,"BOLOY, BULAGI, BANGGAI KEPULAUAN, SULAWESI TENGAH",2,125,18,143
https://kawalpemilu.org#68749,"MESELESEK, BULAGI, BANGGAI KEPULAUAN, SULAWESI TENGAH",1,171,10,181
https://kawalpemilu.org#68749,"MESELESEK, BULAGI, BANGGAI KEPULAUAN, SULAWESI TENGAH",2,163,20,183
https://kawalpemilu.org#68750,"OLUNO, BULAGI, BANGGAI KEPULAUAN, SULAWESI TENGAH",1,91,69,160
https://kawalpemilu.org#68750,"OLUNO, BULAGI, BANGGAI KEPULAUAN, SULAWESI TENGAH",2,73,86,159
https://kawalpemilu.org#68750,"OLUNO, BULAGI, BANGGAI KEPULAUAN, SULAWESI TENGAH",3,61,78,139
https://kawalpemilu.org#68751,"SUMONDUNG, BULAGI, BANGGAI KEPULAUAN, SULAWESI TENGAH",1,100,40,140
https://kawalpemilu.org#68751,"SUMONDUNG, BULAGI, BANGGAI KEPULAUAN, SULAWESI TENGAH",2,90,47,137
https://kawalpemilu.org#68752,"PELINGSEASA, BULAGI, BANGGAI KEPULAUAN, SULAWESI TENGAH",1,47,21,68
https://kawalpemilu.org#68752,"PELINGSEASA, BULAGI, BANGGAI KEPULAUAN, SULAWESI TENGAH",2,129,41,170
https://kawalpemilu.org#68752,"PELINGSEASA, BULAGI, BANGGAI KEPULAUAN, SULAWESI TENGAH",3,106,29,135
https://kawalpemilu.org#68752,"PELINGSEASA, BULAGI, BANGGAI KEPULAUAN, SULAWESI TENGAH",4,124,35,159
https://kawalpemilu.org#68753,"KOMBA-KOMBA, BULAGI, BANGGAI KEPULAUAN, SULAWESI TENGAH",1,110,91,201
https://kawalpemilu.org#68753,"KOMBA-KOMBA, BULAGI, BANGGAI KEPULAUAN, SULAWESI TENGAH",2,119,84,203
https://kawalpemilu.org#68754,"ALUL, BULAGI, BANGGAI KEPULAUAN, SULAWESI TENGAH",1,183,37,220
https://kawalpemilu.org#68754,"ALUL, BULAGI, BANGGAI KEPULAUAN, SULAWESI TENGAH",2,156,56,212
https://kawalpemilu.org#68755,"TOOLON, BULAGI, BANGGAI KEPULAUAN, SULAWESI TENGAH",1,139,96,235
https://kawalpemilu.org#68756,"KAMBAL, BULAGI, BANGGAI KEPULAUAN, SULAWESI TENGAH",1,135,37,172
https://kawalpemilu.org#68756,"KAMBAL, BULAGI, BANGGAI KEPULAUAN, SULAWESI TENGAH",2,93,75,168
https://kawalpemilu.org#85669,"KAYUBET, BULAGI, BANGGAI KEPULAUAN, SULAWESI TENGAH",1,104,27,131
https://kawalpemilu.org#68758,"PAISUBATU, BUKO, BANGGAI KEPULAUAN, SULAWESI TENGAH",1,130,58,188
https://kawalpemilu.org#68758,"PAISUBATU, BUKO, BANGGAI KEPULAUAN, SULAWESI TENGAH",2,153,37,190
https://kawalpemilu.org#68758,"PAISUBATU, BUKO, BANGGAI KEPULAUAN, SULAWESI TENGAH",3,139,49,188
https://kawalpemilu.org#68758,"PAISUBATU, BUKO, BANGGAI KEPULAUAN, SULAWESI TENGAH",4,105,88,193
https://kawalpemilu.org#68758,"PAISUBATU, BUKO, BANGGAI KEPULAUAN, SULAWESI TENGAH",5,65,29,94
https://kawalpemilu.org#68759,"BATANGONO, BUKO, BANGGAI KEPULAUAN, SULAWESI TENGAH",1,95,60,155
https://kawalpemilu.org#68759,"BATANGONO, BUKO, BANGGAI KEPULAUAN, SULAWESI TENGAH",2,85,37,122
https://kawalpemilu.org#68759,"BATANGONO, BUKO, BANGGAI KEPULAUAN, SULAWESI TENGAH",3,87,12,99
https://kawalpemilu.org#68759,"BATANGONO, BUKO, BANGGAI KEPULAUAN, SULAWESI TENGAH",4,184,20,204
https://kawalpemilu.org#68759,"BATANGONO, BUKO, BANGGAI KEPULAUAN, SULAWESI TENGAH",5,89,45,134
https://kawalpemilu.org#68760,"LALENGAN, BUKO, BANGGAI KEPULAUAN, SULAWESI TENGAH",1,63,91,154
https://kawalpemilu.org#68760,"LALENGAN, BUKO, BANGGAI KEPULAUAN, SULAWESI TENGAH",2,102,93,195
https://kawalpemilu.org#68760,"LALENGAN, BUKO, BANGGAI KEPULAUAN, SULAWESI TENGAH",3,92,45,137
https://kawalpemilu.org#68761,"PELING LALOMO, BUKO, BANGGAI KEPULAUAN, SULAWESI TENGAH",1,68,95,163
https://kawalpemilu.org#68761,"PELING LALOMO, BUKO, BANGGAI KEPULAUAN, SULAWESI TENGAH",2,136,76,212
https://kawalpemilu.org#68761,"PELING LALOMO, BUKO, BANGGAI KEPULAUAN, SULAWESI TENGAH",3,158,76,234
https://kawalpemilu.org#68762,"LABASIANO, BUKO, BANGGAI KEPULAUAN, SULAWESI TENGAH",1,80,57,137
https://kawalpemilu.org#68762,"LABASIANO, BUKO, BANGGAI KEPULAUAN, SULAWESI TENGAH",2,53,63,116
https://kawalpemilu.org#68763,"TATABA, BUKO, BANGGAI KEPULAUAN, SULAWESI TENGAH",1,20,113,133
https://kawalpemilu.org#68763,"TATABA, BUKO, BANGGAI KEPULAUAN, SULAWESI TENGAH",2,27,85,112
https://kawalpemilu.org#68763,"TATABA, BUKO, BANGGAI KEPULAUAN, SULAWESI TENGAH",3,101,75,176
https://kawalpemilu.org#68764,"MALANGGONG, BUKO, BANGGAI KEPULAUAN, SULAWESI TENGAH",1,66,109,175
https://kawalpemilu.org#68764,"MALANGGONG, BUKO, BANGGAI KEPULAUAN, SULAWESI TENGAH",2,91,66,157
https://kawalpemilu.org#68764,"MALANGGONG, BUKO, BANGGAI KEPULAUAN, SULAWESI TENGAH",3,112,46,158
https://kawalpemilu.org#68765,"LEME-LEME BUNGIN, BUKO, BANGGAI KEPULAUAN, SULAWESI TENGAH",1,53,112,165
https://kawalpemilu.org#68765,"LEME-LEME BUNGIN, BUKO, BANGGAI KEPULAUAN, SULAWESI TENGAH",2,58,70,128
https://kawalpemilu.org#68766,"LEME-LEME DARAT, BUKO, BANGGAI KEPULAUAN, SULAWESI TENGAH",1,121,27,148
https://kawalpemilu.org#68766,"LEME-LEME DARAT, BUKO, BANGGAI KEPULAUAN, SULAWESI TENGAH",2,118,37,155
https://kawalpemilu.org#68767,"OKULO POTIL, BUKO, BANGGAI KEPULAUAN, SULAWESI TENGAH",1,170,8,178
https://kawalpemilu.org#68767,"OKULO POTIL, BUKO, BANGGAI KEPULAUAN, SULAWESI TENGAH",2,138,22,160
https://kawalpemilu.org#68767,"OKULO POTIL, BUKO, BANGGAI KEPULAUAN, SULAWESI TENGAH",3,131,6,137
https://kawalpemilu.org#85670,"TALAS-TALAS, BUKO, BANGGAI KEPULAUAN, SULAWESI TENGAH",1,104,32,136
https://kawalpemilu.org#85670,"TALAS-TALAS, BUKO, BANGGAI KEPULAUAN, SULAWESI TENGAH",2,112,28,140
https://kawalpemilu.org#85671,"TATENDENG, BUKO, BANGGAI KEPULAUAN, SULAWESI TENGAH",1,169,39,208
https://kawalpemilu.org#85671,"TATENDENG, BUKO, BANGGAI KEPULAUAN, SULAWESI TENGAH",2,190,24,214
https://kawalpemilu.org#85672,"OLUSI, BUKO, BANGGAI KEPULAUAN, SULAWESI TENGAH",1,152,44,196
https://kawalpemilu.org#85672,"OLUSI, BUKO, BANGGAI KEPULAUAN, SULAWESI TENGAH",2,62,13,75
https://kawalpemilu.org#68785,"BONEPUSO, BULAGI SELATAN, BANGGAI KEPULAUAN, SULAWESI TENGAH",1,51,136,187
https://kawalpemilu.org#68785,"BONEPUSO, BULAGI SELATAN, BANGGAI KEPULAUAN, SULAWESI TENGAH",2,71,86,157
https://kawalpemilu.org#68785,"BONEPUSO, BULAGI SELATAN, BANGGAI KEPULAUAN, SULAWESI TENGAH",3,69,137,206
https://kawalpemilu.org#68786,"PALABATU II, BULAGI SELATAN, BANGGAI KEPULAUAN, SULAWESI TENGAH",1,86,17,103
https://kawalpemilu.org#68787,"TATARANDANG, BULAGI SELATAN, BANGGAI KEPULAUAN, SULAWESI TENGAH",1,159,17,176
https://kawalpemilu.org#68787,"TATARANDANG, BULAGI SELATAN, BANGGAI KEPULAUAN, SULAWESI TENGAH",2,152,29,181
https://kawalpemilu.org#68787,"TATARANDANG, BULAGI SELATAN, BANGGAI KEPULAUAN, SULAWESI TENGAH",3,142,32,174
https://kawalpemilu.org#68787,"TATARANDANG, BULAGI SELATAN, BANGGAI KEPULAUAN, SULAWESI TENGAH",4,123,29,152
https://kawalpemilu.org#68788,"PANDALUK, BULAGI SELATAN, BANGGAI KEPULAUAN, SULAWESI TENGAH",1,114,65,179
https://kawalpemilu.org#68788,"PANDALUK, BULAGI SELATAN, BANGGAI KEPULAUAN, SULAWESI TENGAH",2,148,33,181
https://kawalpemilu.org#68789,"OSAN, BULAGI SELATAN, BANGGAI KEPULAUAN, SULAWESI TENGAH",1,120,75,195
https://kawalpemilu.org#68789,"OSAN, BULAGI SELATAN, BANGGAI KEPULAUAN, SULAWESI TENGAH",2,132,68,200
https://kawalpemilu.org#68790,"BALALON, BULAGI SELATAN, BANGGAI KEPULAUAN, SULAWESI TENGAH",1,138,45,183
https://kawalpemilu.org#68790,"BALALON, BULAGI SELATAN, BANGGAI KEPULAUAN, SULAWESI TENGAH",2,139,83,183
https://kawalpemilu.org#68791,"SABELAK, BULAGI SELATAN, BANGGAI KEPULAUAN, SULAWESI TENGAH",1,75,51,126
https://kawalpemilu.org#68791,"SABELAK, BULAGI SELATAN, BANGGAI KEPULAUAN, SULAWESI TENGAH",2,54,62,116
https://kawalpemilu.org#68792,"SUIT, BULAGI SELATAN, BANGGAI KEPULAUAN, SULAWESI TENGAH",1,96,63,159
https://kawalpemilu.org#68793,"LOLANTANG, BULAGI SELATAN, BANGGAI KEPULAUAN, SULAWESI TENGAH",1,70,83,153
https://kawalpemilu.org#68793,"LOLANTANG, BULAGI SELATAN, BANGGAI KEPULAUAN, SULAWESI TENGAH",2,73,77,150
https://kawalpemilu.org#68794,"TOI-TOI, BULAGI SELATAN, BANGGAI KEPULAUAN, SULAWESI TENGAH",1,153,40,193
https://kawalpemilu.org#68794,"TOI-TOI, BULAGI SELATAN, BANGGAI KEPULAUAN, SULAWESI TENGAH",2,147,62,209
https://kawalpemilu.org#68795,"PALABATU I, BULAGI SELATAN, BANGGAI KEPULAUAN, SULAWESI TENGAH",1,80,39,119
https://kawalpemilu.org#68795,"PALABATU I, BULAGI SELATAN, BANGGAI KEPULAUAN, SULAWESI TENGAH",2,83,4,87
https://kawalpemilu.org#68796,"MANGAIS, BULAGI SELATAN, BANGGAI KEPULAUAN, SULAWESI TENGAH",1,74,36,110
https://kawalpemilu.org#68796,"MANGAIS, BULAGI SELATAN, BANGGAI KEPULAUAN, SULAWESI TENGAH",2,39,3,42
https://kawalpemilu.org#68797,"UNU, BULAGI SELATAN, BANGGAI KEPULAUAN, SULAWESI TENGAH",1,112,20,132
https://kawalpemilu.org#68797,"UNU, BULAGI SELATAN, BANGGAI KEPULAUAN, SULAWESI TENGAH",2,94,28,122
https://kawalpemilu.org#68797,"UNU, BULAGI SELATAN, BANGGAI KEPULAUAN, SULAWESI TENGAH",3,23,6,29
https://kawalpemilu.org#68798,"LEMELU, BULAGI SELATAN, BANGGAI KEPULAUAN, SULAWESI TENGAH",1,98,105,203
https://kawalpemilu.org#68798,"LEMELU, BULAGI SELATAN, BANGGAI KEPULAUAN, SULAWESI TENGAH",2,77,78,155
https://kawalpemilu.org#85674,"MOMOTAN, BULAGI SELATAN, BANGGAI KEPULAUAN, SULAWESI TENGAH",1,104,34,138
https://kawalpemilu.org#85675,"BOLUNI, BULAGI SELATAN, BANGGAI KEPULAUAN, SULAWESI TENGAH",1,154,18,172
https://kawalpemilu.org#85676,"ALASAN NGGOLOBUTON, BULAGI SELATAN, BANGGAI KEPULAUAN, SULAWESI TENGAH",1,82,54,136
https://kawalpemilu.org#85676,"ALASAN NGGOLOBUTON, BULAGI SELATAN, BANGGAI KEPULAUAN, SULAWESI TENGAH",2,69,32,101
https://kawalpemilu.org#85677,"PIPILOGOT PAIPAISU, BULAGI SELATAN, BANGGAI KEPULAUAN, SULAWESI TENGAH",1,90,39,129
https://kawalpemilu.org#89716,"BABANG, BULAGI SELATAN, BANGGAI KEPULAUAN, SULAWESI TENGAH",1,114,48,162
https://kawalpemilu.org#89716,"BABANG, BULAGI SELATAN, BANGGAI KEPULAUAN, SULAWESI TENGAH",2,124,45,169
https://kawalpemilu.org#93118,"LABOTANKANDI, BULAGI SELATAN, BANGGAI KEPULAUAN, SULAWESI TENGAH",1,162,52,214
https://kawalpemilu.org#68807,"TOBING, TINANGKUNG SELATAN, BANGGAI KEPULAUAN, SULAWESI TENGAH",1,78,119,197
https://kawalpemilu.org#68807,"TOBING, TINANGKUNG SELATAN, BANGGAI KEPULAUAN, SULAWESI TENGAH",2,47,141,188
https://kawalpemilu.org#68808,"PAISUMUSONI, TINANGKUNG SELATAN, BANGGAI KEPULAUAN, SULAWESI TENGAH",1,64,67,131
https://kawalpemilu.org#68808,"PAISUMUSONI, TINANGKUNG SELATAN, BANGGAI KEPULAUAN, SULAWESI TENGAH",2,71,64,135
https://kawalpemilu.org#68809,"TOBUNGIN, TINANGKUNG SELATAN, BANGGAI KEPULAUAN, SULAWESI TENGAH",1,80,118,198
https://kawalpemilu.org#68809,"TOBUNGIN, TINANGKUNG SELATAN, BANGGAI KEPULAUAN, SULAWESI TENGAH",2,60,43,103
https://kawalpemilu.org#68809,"TOBUNGIN, TINANGKUNG SELATAN, BANGGAI KEPULAUAN, SULAWESI TENGAH",3,67,121,188
https://kawalpemilu.org#68810,"MANSAMAT A, TINANGKUNG SELATAN, BANGGAI KEPULAUAN, SULAWESI TENGAH",1,49,125,174
https://kawalpemilu.org#68810,"MANSAMAT A, TINANGKUNG SELATAN, BANGGAI KEPULAUAN, SULAWESI TENGAH",2,60,112,172
https://kawalpemilu.org#68810,"MANSAMAT A, TINANGKUNG SELATAN, BANGGAI KEPULAUAN, SULAWESI TENGAH",3,58,125,183
https://kawalpemilu.org#68811,"MANSAMAT B, TINANGKUNG SELATAN, BANGGAI KEPULAUAN, SULAWESI TENGAH",1,45,102,147
https://kawalpemilu.org#68811,"MANSAMAT B, TINANGKUNG SELATAN, BANGGAI KEPULAUAN, SULAWESI TENGAH",2,63,97,160
https://kawalpemilu.org#68811,"MANSAMAT B, TINANGKUNG SELATAN, BANGGAI KEPULAUAN, SULAWESI TENGAH",3,67,81,148
https://kawalpemilu.org#68812,"KAMPUNG BARU, TINANGKUNG SELATAN, BANGGAI KEPULAUAN, SULAWESI TENGAH",1,105,134,239
https://kawalpemilu.org#68812,"KAMPUNG BARU, TINANGKUNG SELATAN, BANGGAI KEPULAUAN, SULAWESI TENGAH",2,56,164,220
https://kawalpemilu.org#68812,"KAMPUNG BARU, TINANGKUNG SELATAN, BANGGAI KEPULAUAN, SULAWESI TENGAH",3,80,155,235
https://kawalpemilu.org#68812,"KAMPUNG BARU, TINANGKUNG SELATAN, BANGGAI KEPULAUAN, SULAWESI TENGAH",4,99,114,213
https://kawalpemilu.org#68813,"TINANGKUNG, TINANGKUNG SELATAN, BANGGAI KEPULAUAN, SULAWESI TENGAH",1,48,74,122
https://kawalpemilu.org#68813,"TINANGKUNG, TINANGKUNG SELATAN, BANGGAI KEPULAUAN, SULAWESI TENGAH",2,61,85,146
https://kawalpemilu.org#68813,"TINANGKUNG, TINANGKUNG SELATAN, BANGGAI KEPULAUAN, SULAWESI TENGAH",3,31,59,90
https://kawalpemilu.org#68813,"TINANGKUNG, TINANGKUNG SELATAN, BANGGAI KEPULAUAN, SULAWESI TENGAH",4,50,55,105
https://kawalpemilu.org#68813,"TINANGKUNG, TINANGKUNG SELATAN, BANGGAI KEPULAUAN, SULAWESI TENGAH",5,38,90,128
https://kawalpemilu.org#68813,"TINANGKUNG, TINANGKUNG SELATAN, BANGGAI KEPULAUAN, SULAWESI TENGAH",6,68,87,155
https://kawalpemilu.org#68814,"GANSAL, TINANGKUNG SELATAN, BANGGAI KEPULAUAN, SULAWESI TENGAH",1,132,85,217
https://kawalpemilu.org#68814,"GANSAL, TINANGKUNG SELATAN, BANGGAI KEPULAUAN, SULAWESI TENGAH",2,154,63,217
https://kawalpemilu.org#68815,"BOBU, TINANGKUNG SELATAN, BANGGAI KEPULAUAN, SULAWESI TENGAH",1,85,83,168
https://kawalpemilu.org#68815,"BOBU, TINANGKUNG SELATAN, BANGGAI KEPULAUAN, SULAWESI TENGAH",2,79,98,177
https://kawalpemilu.org#68815,"BOBU, TINANGKUNG SELATAN, BANGGAI KEPULAUAN, SULAWESI TENGAH",3,75,82,157
https://kawalpemilu.org#68841,"KALUMBATAN, TOTIKUM SELATAN, BANGGAI KEPULAUAN, SULAWESI TENGAH",1,88,111,199
https://kawalpemilu.org#68841,"KALUMBATAN, TOTIKUM SELATAN, BANGGAI KEPULAUAN, SULAWESI TENGAH",2,63,160,223
https://kawalpemilu.org#68841,"KALUMBATAN, TOTIKUM SELATAN, BANGGAI KEPULAUAN, SULAWESI TENGAH",3,103,112,215
https://kawalpemilu.org#68841,"KALUMBATAN, TOTIKUM SELATAN, BANGGAI KEPULAUAN, SULAWESI TENGAH",4,141,64,205
https://kawalpemilu.org#68841,"KALUMBATAN, TOTIKUM SELATAN, BANGGAI KEPULAUAN, SULAWESI TENGAH",5,141,63,204
https://kawalpemilu.org#68841,"KALUMBATAN, TOTIKUM SELATAN, BANGGAI KEPULAUAN, SULAWESI TENGAH",6,109,72,181
https://kawalpemilu.org#68841,"KALUMBATAN, TOTIKUM SELATAN, BANGGAI KEPULAUAN, SULAWESI TENGAH",7,150,41,191
https://kawalpemilu.org#68841,"KALUMBATAN, TOTIKUM SELATAN, BANGGAI KEPULAUAN, SULAWESI TENGAH",8,79,104,183
https://kawalpemilu.org#68841,"KALUMBATAN, TOTIKUM SELATAN, BANGGAI KEPULAUAN, SULAWESI TENGAH",9,54,115,169
https://kawalpemilu.org#68841,"KALUMBATAN, TOTIKUM SELATAN, BANGGAI KEPULAUAN, SULAWESI TENGAH",10,99,78,177
https://kawalpemilu.org#68842,"TONUSON, TOTIKUM SELATAN, BANGGAI KEPULAUAN, SULAWESI TENGAH",1,118,76,194
https://kawalpemilu.org#68842,"TONUSON, TOTIKUM SELATAN, BANGGAI KEPULAUAN, SULAWESI TENGAH",2,46,26,72
https://kawalpemilu.org#68843,"TOBUNGKU, TOTIKUM SELATAN, BANGGAI KEPULAUAN, SULAWESI TENGAH",1,98,50,148
https://kawalpemilu.org#68843,"TOBUNGKU, TOTIKUM SELATAN, BANGGAI KEPULAUAN, SULAWESI TENGAH",2,99,57,156
https://kawalpemilu.org#68844,"NULION, TOTIKUM SELATAN, BANGGAI KEPULAUAN, SULAWESI TENGAH",1,78,140,218
https://kawalpemilu.org#68844,"NULION, TOTIKUM SELATAN, BANGGAI KEPULAUAN, SULAWESI TENGAH",2,122,81,203
https://kawalpemilu.org#68844,"NULION, TOTIKUM SELATAN, BANGGAI KEPULAUAN, SULAWESI TENGAH",3,105,114,219
https://kawalpemilu.org#68844,"NULION, TOTIKUM SELATAN, BANGGAI KEPULAUAN, SULAWESI TENGAH",4,83,123,206
https://kawalpemilu.org#68845,"PELEY, TOTIKUM SELATAN, BANGGAI KEPULAUAN, SULAWESI TENGAH",1,99,70,169
https://kawalpemilu.org#68845,"PELEY, TOTIKUM SELATAN, BANGGAI KEPULAUAN, SULAWESI TENGAH",2,88,95,183
https://kawalpemilu.org#68846,"KANALI, TOTIKUM SELATAN, BANGGAI KEPULAUAN, SULAWESI TENGAH",1,59,67,126
https://kawalpemilu.org#68846,"KANALI, TOTIKUM SELATAN, BANGGAI KEPULAUAN, SULAWESI TENGAH",2,75,44,119
https://kawalpemilu.org#68847,"MATA, TOTIKUM SELATAN, BANGGAI KEPULAUAN, SULAWESI TENGAH",1,162,78,240
https://kawalpemilu.org#68847,"MATA, TOTIKUM SELATAN, BANGGAI KEPULAUAN, SULAWESI TENGAH",2,187,72,259
https://kawalpemilu.org#85682,"LOBUTON, TOTIKUM SELATAN, BANGGAI KEPULAUAN, SULAWESI TENGAH",1,134,71,205
https://kawalpemilu.org#85682,"LOBUTON, TOTIKUM SELATAN, BANGGAI KEPULAUAN, SULAWESI TENGAH",2,77,58,135
https://kawalpemilu.org#68849,"PATUKUKI, PELING TENGAH, BANGGAI KEPULAUAN, SULAWESI TENGAH",1,74,125,199
https://kawalpemilu.org#68849,"PATUKUKI, PELING TENGAH, BANGGAI KEPULAUAN, SULAWESI TENGAH",2,95,120,215
https://kawalpemilu.org#68849,"PATUKUKI, PELING TENGAH, BANGGAI KEPULAUAN, SULAWESI TENGAH",3,92,103,195
https://kawalpemilu.org#68849,"PATUKUKI, PELING TENGAH, BANGGAI KEPULAUAN, SULAWESI TENGAH",4,114,78,192
https://kawalpemilu.org#68849,"PATUKUKI, PELING TENGAH, BANGGAI KEPULAUAN, SULAWESI TENGAH",5,176,39,215
https://kawalpemilu.org#68849,"PATUKUKI, PELING TENGAH, BANGGAI KEPULAUAN, SULAWESI TENGAH",6,105,47,152
https://kawalpemilu.org#68850,"BALOMBONG, PELING TENGAH, BANGGAI KEPULAUAN, SULAWESI TENGAH",1,87,72,159
https://kawalpemilu.org#68850,"BALOMBONG, PELING TENGAH, BANGGAI KEPULAUAN, SULAWESI TENGAH",2,131,82,213
https://kawalpemilu.org#68851,"KOLAK, PELING TENGAH, BANGGAI KEPULAUAN, SULAWESI TENGAH",1,78,105,183
https://kawalpemilu.org#68851,"KOLAK, PELING TENGAH, BANGGAI KEPULAUAN, SULAWESI TENGAH",2,48,93,141
https://kawalpemilu.org#68851,"KOLAK, PELING TENGAH, BANGGAI KEPULAUAN, SULAWESI TENGAH",3,92,64,156
https://kawalpemilu.org#68852,"KOYOBUNGA, PELING TENGAH, BANGGAI KEPULAUAN, SULAWESI TENGAH",1,113,96,209
https://kawalpemilu.org#68852,"KOYOBUNGA, PELING TENGAH, BANGGAI KEPULAUAN, SULAWESI TENGAH",2,43,88,131
https://kawalpemilu.org#68853,"ALAKASING, PELING TENGAH, BANGGAI KEPULAUAN, SULAWESI TENGAH",1,139,68,207
https://kawalpemilu.org#68853,"ALAKASING, PELING TENGAH, BANGGAI KEPULAUAN, SULAWESI TENGAH",2,154,54,208
https://kawalpemilu.org#68853,"ALAKASING, PELING TENGAH, BANGGAI KEPULAUAN, SULAWESI TENGAH",3,106,78,184
https://kawalpemilu.org#68853,"ALAKASING, PELING TENGAH, BANGGAI KEPULAUAN, SULAWESI TENGAH",4,108,34,142
https://kawalpemilu.org#68853,"ALAKASING, PELING TENGAH, BANGGAI KEPULAUAN, SULAWESI TENGAH",5,72,77,149
https://kawalpemilu.org#68854,"TOMBOS, PELING TENGAH, BANGGAI KEPULAUAN, SULAWESI TENGAH",1,90,126,216
https://kawalpemilu.org#68854,"TOMBOS, PELING TENGAH, BANGGAI KEPULAUAN, SULAWESI TENGAH",2,75,121,196
https://kawalpemilu.org#68854,"TOMBOS, PELING TENGAH, BANGGAI KEPULAUAN, SULAWESI TENGAH",3,100,116,216
https://kawalpemilu.org#68855,"LUK, PELING TENGAH, BANGGAI KEPULAUAN, SULAWESI TENGAH",1,61,78,139
https://kawalpemilu.org#68855,"LUK, PELING TENGAH, BANGGAI KEPULAUAN, SULAWESI TENGAH",2,58,79,137
https://kawalpemilu.org#68855,"LUK, PELING TENGAH, BANGGAI KEPULAUAN, SULAWESI TENGAH",3,53,92,143
https://kawalpemilu.org#68856,"LABIBI, PELING TENGAH, BANGGAI KEPULAUAN, SULAWESI TENGAH",1,82,125,207
https://kawalpemilu.org#68856,"LABIBI, PELING TENGAH, BANGGAI KEPULAUAN, SULAWESI TENGAH",2,104,140,244
https://kawalpemilu.org#68857,"POPISI, PELING TENGAH, BANGGAI KEPULAUAN, SULAWESI TENGAH",1,68,128,196
https://kawalpemilu.org#68857,"POPISI, PELING TENGAH, BANGGAI KEPULAUAN, SULAWESI TENGAH",2,58,91,149
https://kawalpemilu.org#68857,"POPISI, PELING TENGAH, BANGGAI KEPULAUAN, SULAWESI TENGAH",3,66,44,110
https://kawalpemilu.org#68858,"TOLULOS, PELING TENGAH, BANGGAI KEPULAUAN, SULAWESI TENGAH",1,71,89,160
https://kawalpemilu.org#68858,"TOLULOS, PELING TENGAH, BANGGAI KEPULAUAN, SULAWESI TENGAH",2,137,21,158
https://kawalpemilu.org#68858,"TOLULOS, PELING TENGAH, BANGGAI KEPULAUAN, SULAWESI TENGAH",3,156,12,168
https://kawalpemilu.org#68859,"TUNGGALING, PELING TENGAH, BANGGAI KEPULAUAN, SULAWESI TENGAH",1,98,43,141
https://kawalpemilu.org#68859,"TUNGGALING, PELING TENGAH, BANGGAI KEPULAUAN, SULAWESI TENGAH",2,89,64,153
https://kawalpemilu.org#68861,"SABANG, BULAGI UTARA, BANGGAI KEPULAUAN, SULAWESI TENGAH",1,167,23,190
https://kawalpemilu.org#68861,"SABANG, BULAGI UTARA, BANGGAI KEPULAUAN, SULAWESI TENGAH",2,160,37,197
https://kawalpemilu.org#68861,"SABANG, BULAGI UTARA, BANGGAI KEPULAUAN, SULAWESI TENGAH",3,179,16,195
https://kawalpemilu.org#68861,"SABANG, BULAGI UTARA, BANGGAI KEPULAUAN, SULAWESI TENGAH",4,183,41,224
https://kawalpemilu.org#68862,"SAMBULANGAN, BULAGI UTARA, BANGGAI KEPULAUAN, SULAWESI TENGAH",1,143,26,169
https://kawalpemilu.org#68862,"SAMBULANGAN, BULAGI UTARA, BANGGAI KEPULAUAN, SULAWESI TENGAH",2,82,69,151
https://kawalpemilu.org#68862,"SAMBULANGAN, BULAGI UTARA, BANGGAI KEPULAUAN, SULAWESI TENGAH",3,125,47,172
https://kawalpemilu.org#68863,"BANGUNEMO, BULAGI UTARA, BANGGAI KEPULAUAN, SULAWESI TENGAH",1,98,76,174
https://kawalpemilu.org#68863,"BANGUNEMO, BULAGI UTARA, BANGGAI KEPULAUAN, SULAWESI TENGAH",2,107,68,175
https://kawalpemilu.org#68863,"BANGUNEMO, BULAGI UTARA, BANGGAI KEPULAUAN, SULAWESI TENGAH",3,133,44,177
https://kawalpemilu.org#68864,"PAISULUNO, BULAGI UTARA, BANGGAI KEPULAUAN, SULAWESI TENGAH",1,101,55,156
https://kawalpemilu.org#68864,"PAISULUNO, BULAGI UTARA, BANGGAI KEPULAUAN, SULAWESI TENGAH",2,82,62,144
https://kawalpemilu.org#68865,"MONTOP, BULAGI UTARA, BANGGAI KEPULAUAN, SULAWESI TENGAH",1,64,95,159
https://kawalpemilu.org#68865,"MONTOP, BULAGI UTARA, BANGGAI KEPULAUAN, SULAWESI TENGAH",2,56,93,149
https://kawalpemilu.org#68865,"MONTOP, BULAGI UTARA, BANGGAI KEPULAUAN, SULAWESI TENGAH",3,74,79,153
https://kawalpemilu.org#68865,"MONTOP, BULAGI UTARA, BANGGAI KEPULAUAN, SULAWESI TENGAH",4,80,90,170
https://kawalpemilu.org#68866,"BOLUBUNG, BULAGI UTARA, BANGGAI KEPULAUAN, SULAWESI TENGAH",1,68,73,141
https://kawalpemilu.org#68866,"BOLUBUNG, BULAGI UTARA, BANGGAI KEPULAUAN, SULAWESI TENGAH",2,72,81,153
https://kawalpemilu.org#68867,"BAKALINGA, BULAGI UTARA, BANGGAI KEPULAUAN, SULAWESI TENGAH",1,107,104,211
https://kawalpemilu.org#68867,"BAKALINGA, BULAGI UTARA, BANGGAI KEPULAUAN, SULAWESI TENGAH",2,125,94,219
https://kawalpemilu.org#68867,"BAKALINGA, BULAGI UTARA, BANGGAI KEPULAUAN, SULAWESI TENGAH",3,117,80,197
https://kawalpemilu.org#68868,"LUKPANENTENG, BULAGI UTARA, BANGGAI KEPULAUAN, SULAWESI TENGAH",1,143,42,185
https://kawalpemilu.org#68868,"LUKPANENTENG, BULAGI UTARA, BANGGAI KEPULAUAN, SULAWESI TENGAH",2,154,46,200
https://kawalpemilu.org#68868,"LUKPANENTENG, BULAGI UTARA, BANGGAI KEPULAUAN, SULAWESI TENGAH",3,184,11,195
https://kawalpemilu.org#68868,"LUKPANENTENG, BULAGI UTARA, BANGGAI KEPULAUAN, SULAWESI TENGAH",4,92,12,104
https://kawalpemilu.org#68869,"KOYOBUNGA, BULAGI UTARA, BANGGAI KEPULAUAN, SULAWESI TENGAH",1,199,29,228
https://kawalpemilu.org#68870,"OMBULI, BULAGI UTARA, BANGGAI KEPULAUAN, SULAWESI TENGAH",1,165,6,171
https://kawalpemilu.org#68870,"OMBULI, BULAGI UTARA, BANGGAI KEPULAUAN, SULAWESI TENGAH",2,170,15,185
https://kawalpemilu.org#68870,"OMBULI, BULAGI UTARA, BANGGAI KEPULAUAN, SULAWESI TENGAH",3,168,15,183
https://kawalpemilu.org#68871,"MANDOK, BULAGI UTARA, BANGGAI KEPULAUAN, SULAWESI TENGAH",1,101,92,193
https://kawalpemilu.org#93129,"MINANGA, BULAGI UTARA, BANGGAI KEPULAUAN, SULAWESI TENGAH",1,117,77,194
https://kawalpemilu.org#68873,"LUMBI-LUMBIA, BUKO SELATAN, BANGGAI KEPULAUAN, SULAWESI TENGAH",1,151,62,213
https://kawalpemilu.org#68873,"LUMBI-LUMBIA, BUKO SELATAN, BANGGAI KEPULAUAN, SULAWESI TENGAH",2,115,61,176
https://kawalpemilu.org#68873,"LUMBI-LUMBIA, BUKO SELATAN, BANGGAI KEPULAUAN, SULAWESI TENGAH",3,123,64,187
https://kawalpemilu.org#68873,"LUMBI-LUMBIA, BUKO SELATAN, BANGGAI KEPULAUAN, SULAWESI TENGAH",4,133,47,180
https://kawalpemilu.org#68873,"LUMBI-LUMBIA, BUKO SELATAN, BANGGAI KEPULAUAN, SULAWESI TENGAH",5,143,40,183
https://kawalpemilu.org#68873,"LUMBI-LUMBIA, BUKO SELATAN, BANGGAI KEPULAUAN, SULAWESI TENGAH",6,140,50,190
https://kawalpemilu.org#68874,"KAMBANI, BUKO SELATAN, BANGGAI KEPULAUAN, SULAWESI TENGAH",1,99,122,221
https://kawalpemilu.org#68874,"KAMBANI, BUKO SELATAN, BANGGAI KEPULAUAN, SULAWESI TENGAH",2,112,121,233
https://kawalpemilu.org#68875,"TATABAU, BUKO SELATAN, BANGGAI KEPULAUAN, SULAWESI TENGAH",1,148,41,189
https://kawalpemilu.org#68875,"TATABAU, BUKO SELATAN, BANGGAI KEPULAUAN, SULAWESI TENGAH",2,149,38,187
https://kawalpemilu.org#68875,"TATABAU, BUKO SELATAN, BANGGAI KEPULAUAN, SULAWESI TENGAH",3,150,47,197
https://kawalpemilu.org#68876,"BUKO, BUKO SELATAN, BANGGAI KEPULAUAN, SULAWESI TENGAH",1,108,69,177
https://kawalpemilu.org#68876,"BUKO, BUKO SELATAN, BANGGAI KEPULAUAN, SULAWESI TENGAH",2,55,30,85
https://kawalpemilu.org#68877,"PALAPAT, BUKO SELATAN, BANGGAI KEPULAUAN, SULAWESI TENGAH",1,192,32,224
https://kawalpemilu.org#68878,"LABANGUN, BUKO SELATAN, BANGGAI KEPULAUAN, SULAWESI TENGAH",1,104,39,143
https://kawalpemilu.org#68878,"LABANGUN, BUKO SELATAN, BANGGAI KEPULAUAN, SULAWESI TENGAH",2,78,40,118
https://kawalpemilu.org#68879,"SEANO, BUKO SELATAN, BANGGAI KEPULAUAN, SULAWESI TENGAH",1,136,105,241
https://kawalpemilu.org#68879,"SEANO, BUKO SELATAN, BANGGAI KEPULAUAN, SULAWESI TENGAH",2,177,54,231
https://kawalpemilu.org#68880,"APAL, BUKO SELATAN, BANGGAI KEPULAUAN, SULAWESI TENGAH",1,183,5,188
https://kawalpemilu.org#68880,"APAL, BUKO SELATAN, BANGGAI KEPULAUAN, SULAWESI TENGAH",2,201,15,216
https://kawalpemilu.org#85683,"LELANG MATAMALING, BUKO SELATAN, BANGGAI KEPULAUAN, SULAWESI TENGAH",1,110,78,188
https://kawalpemilu.org#85683,"LELANG MATAMALING, BUKO SELATAN, BANGGAI KEPULAUAN, SULAWESI TENGAH",2,128,69,197
https://kawalpemilu.org#85684,"SAPELANG, BUKO SELATAN, BANGGAI KEPULAUAN, SULAWESI TENGAH",1,162,36,198
https://kawalpemilu.org#85685,"LANDONAN BEBEAU, BUKO SELATAN, BANGGAI KEPULAUAN, SULAWESI TENGAH",1,107,57,164
https://kawalpemilu.org#85685,"LANDONAN BEBEAU, BUKO SELATAN, BANGGAI KEPULAUAN, SULAWESI TENGAH",2,125,47,172
https://kawalpemilu.org#85685,"LANDONAN BEBEAU, BUKO SELATAN, BANGGAI KEPULAUAN, SULAWESI TENGAH",3,111,64,175
https://kawalpemilu.org#85685,"LANDONAN BEBEAU, BUKO SELATAN, BANGGAI KEPULAUAN, SULAWESI TENGAH",4,153,43,196
https://kawalpemilu.org#68882,"TATAKALAI, TINANGKUNG UTARA, BANGGAI KEPULAUAN, SULAWESI TENGAH",1,48,148,196
https://kawalpemilu.org#68882,"TATAKALAI, TINANGKUNG UTARA, BANGGAI KEPULAUAN, SULAWESI TENGAH",2,67,137,204
https://kawalpemilu.org#68882,"TATAKALAI, TINANGKUNG UTARA, BANGGAI KEPULAUAN, SULAWESI TENGAH",3,48,169,217
https://kawalpemilu.org#68882,"TATAKALAI, TINANGKUNG UTARA, BANGGAI KEPULAUAN, SULAWESI TENGAH",4,50,97,147
https://kawalpemilu.org#68882,"TATAKALAI, TINANGKUNG UTARA, BANGGAI KEPULAUAN, SULAWESI TENGAH",5,62,153,215
https://kawalpemilu.org#68883,"LALONG, TINANGKUNG UTARA, BANGGAI KEPULAUAN, SULAWESI TENGAH",1,105,108,213
https://kawalpemilu.org#68883,"LALONG, TINANGKUNG UTARA, BANGGAI KEPULAUAN, SULAWESI TENGAH",2,90,138,228
https://kawalpemilu.org#68883,"LALONG, TINANGKUNG UTARA, BANGGAI KEPULAUAN, SULAWESI TENGAH",3,113,109,222
https://kawalpemilu.org#68884,"PONDING-PONDING, TINANGKUNG UTARA, BANGGAI KEPULAUAN, SULAWESI TENGAH",1,85,83,168
https://kawalpemilu.org#68884,"PONDING-PONDING, TINANGKUNG UTARA, BANGGAI KEPULAUAN, SULAWESI TENGAH",2,62,163,225
https://kawalpemilu.org#68884,"PONDING-PONDING, TINANGKUNG UTARA, BANGGAI KEPULAUAN, SULAWESI TENGAH",3,100,115,215
https://kawalpemilu.org#68884,"PONDING-PONDING, TINANGKUNG UTARA, BANGGAI KEPULAUAN, SULAWESI TENGAH",4,64,134,198
https://kawalpemilu.org#68884,"PONDING-PONDING, TINANGKUNG UTARA, BANGGAI KEPULAUAN, SULAWESI TENGAH",5,115,90,205
https://kawalpemilu.org#68885,"LUKSAGU, TINANGKUNG UTARA, BANGGAI KEPULAUAN, SULAWESI TENGAH",1,42,144,186
https://kawalpemilu.org#68885,"LUKSAGU, TINANGKUNG UTARA, BANGGAI KEPULAUAN, SULAWESI TENGAH",2,55,146,201
https://kawalpemilu.org#68885,"LUKSAGU, TINANGKUNG UTARA, BANGGAI KEPULAUAN, SULAWESI TENGAH",3,62,125,187
https://kawalpemilu.org#68885,"LUKSAGU, TINANGKUNG UTARA, BANGGAI KEPULAUAN, SULAWESI TENGAH",4,59,144,203
https://kawalpemilu.org#68885,"LUKSAGU, TINANGKUNG UTARA, BANGGAI KEPULAUAN, SULAWESI TENGAH",5,56,132,188
https://kawalpemilu.org#68885,"LUKSAGU, TINANGKUNG UTARA, BANGGAI KEPULAUAN, SULAWESI TENGAH",6,59,108,167
https://kawalpemilu.org#68886,"PALAM, TINANGKUNG UTARA, BANGGAI KEPULAUAN, SULAWESI TENGAH",1,33,157,190
https://kawalpemilu.org#68886,"PALAM, TINANGKUNG UTARA, BANGGAI KEPULAUAN, SULAWESI TENGAH",2,27,179,206
https://kawalpemilu.org#68886,"PALAM, TINANGKUNG UTARA, BANGGAI KEPULAUAN, SULAWESI TENGAH",3,46,158,204
https://kawalpemilu.org#68886,"PALAM, TINANGKUNG UTARA, BANGGAI KEPULAUAN, SULAWESI TENGAH",4,52,131,183
https://kawalpemilu.org#68886,"PALAM, TINANGKUNG UTARA, BANGGAI KEPULAUAN, SULAWESI TENGAH",5,41,134,175
https://kawalpemilu.org#85686,"BAMPANGA, TINANGKUNG UTARA, BANGGAI KEPULAUAN, SULAWESI TENGAH",1,113,70,183
https://kawalpemilu.org#85686,"BAMPANGA, TINANGKUNG UTARA, BANGGAI KEPULAUAN, SULAWESI TENGAH",2,69,58,127
https://kawalpemilu.org#68889,"MASIGI, PARIGI, PARIGI MOUTONG, SULAWESI TENGAH",1,83,134,217
https://kawalpemilu.org#68889,"MASIGI, PARIGI, PARIGI MOUTONG, SULAWESI TENGAH",2,38,213,251
https://kawalpemilu.org#68889,"MASIGI, PARIGI, PARIGI MOUTONG, SULAWESI TENGAH",3,60,166,226
https://kawalpemilu.org#68889,"MASIGI, PARIGI, PARIGI MOUTONG, SULAWESI TENGAH",4,80,172,252
https://kawalpemilu.org#68889,"MASIGI, PARIGI, PARIGI MOUTONG, SULAWESI TENGAH",5,110,147,257
https://kawalpemilu.org#68889,"MASIGI, PARIGI, PARIGI MOUTONG, SULAWESI TENGAH",6,116,150,266
https://kawalpemilu.org#68889,"MASIGI, PARIGI, PARIGI MOUTONG, SULAWESI TENGAH",7,94,150,244
https://kawalpemilu.org#68889,"MASIGI, PARIGI, PARIGI MOUTONG, SULAWESI TENGAH",8,79,169,248
https://kawalpemilu.org#68889,"MASIGI, PARIGI, PARIGI MOUTONG, SULAWESI TENGAH",9,74,157,231
https://kawalpemilu.org#68890,"MAESA, PARIGI, PARIGI MOUTONG, SULAWESI TENGAH",1,174,29,203
https://kawalpemilu.org#68890,"MAESA, PARIGI, PARIGI MOUTONG, SULAWESI TENGAH",2,141,59,200
https://kawalpemilu.org#68890,"MAESA, PARIGI, PARIGI MOUTONG, SULAWESI TENGAH",3,94,129,223
https://kawalpemilu.org#68890,"MAESA, PARIGI, PARIGI MOUTONG, SULAWESI TENGAH",4,187,20,207
https://kawalpemilu.org#68890,"MAESA, PARIGI, PARIGI MOUTONG, SULAWESI TENGAH",5,127,65,192
https://kawalpemilu.org#68890,"MAESA, PARIGI, PARIGI MOUTONG, SULAWESI TENGAH",6,83,118,201
https://kawalpemilu.org#68890,"MAESA, PARIGI, PARIGI MOUTONG, SULAWESI TENGAH",7,115,109,224
https://kawalpemilu.org#68890,"MAESA, PARIGI, PARIGI MOUTONG, SULAWESI TENGAH",8,117,90,207
https://kawalpemilu.org#68891,"LOJI, PARIGI, PARIGI MOUTONG, SULAWESI TENGAH",1,89,114,203
https://kawalpemilu.org#68891,"LOJI, PARIGI, PARIGI MOUTONG, SULAWESI TENGAH",2,108,104,212
https://kawalpemilu.org#68891,"LOJI, PARIGI, PARIGI MOUTONG, SULAWESI TENGAH",3,104,135,239
https://kawalpemilu.org#68891,"LOJI, PARIGI, PARIGI MOUTONG, SULAWESI TENGAH",4,106,108,214
https://kawalpemilu.org#68891,"LOJI, PARIGI, PARIGI MOUTONG, SULAWESI TENGAH",5,68,137,205
https://kawalpemilu.org#68892,"BANTAYA, PARIGI, PARIGI MOUTONG, SULAWESI TENGAH",1,75,109,184
https://kawalpemilu.org#68892,"BANTAYA, PARIGI, PARIGI MOUTONG, SULAWESI TENGAH",2,114,68,182
https://kawalpemilu.org#68892,"BANTAYA, PARIGI, PARIGI MOUTONG, SULAWESI TENGAH",3,77,71,148
https://kawalpemilu.org#68892,"BANTAYA, PARIGI, PARIGI MOUTONG, SULAWESI TENGAH",4,70,89,159
https://kawalpemilu.org#68892,"BANTAYA, PARIGI, PARIGI MOUTONG, SULAWESI TENGAH",5,89,98,187
https://kawalpemilu.org#68892,"BANTAYA, PARIGI, PARIGI MOUTONG, SULAWESI TENGAH",6,55,92,147
https://kawalpemilu.org#68892,"BANTAYA, PARIGI, PARIGI MOUTONG, SULAWESI TENGAH",7,52,84,136
https://kawalpemilu.org#68892,"BANTAYA, PARIGI, PARIGI MOUTONG, SULAWESI TENGAH",8,43,58,101
https://kawalpemilu.org#68892,"BANTAYA, PARIGI, PARIGI MOUTONG, SULAWESI TENGAH",9,94,97,191
https://kawalpemilu.org#68892,"BANTAYA, PARIGI, PARIGI MOUTONG, SULAWESI TENGAH",10,125,88,213
https://kawalpemilu.org#68892,"BANTAYA, PARIGI, PARIGI MOUTONG, SULAWESI TENGAH",11,188,81,269
https://kawalpemilu.org#68892,"BANTAYA, PARIGI, PARIGI MOUTONG, SULAWESI TENGAH",12,125,101,226
https://kawalpemilu.org#68892,"BANTAYA, PARIGI, PARIGI MOUTONG, SULAWESI TENGAH",13,140,72,212
https://kawalpemilu.org#68892,"BANTAYA, PARIGI, PARIGI MOUTONG, SULAWESI TENGAH",14,121,71,192
https://kawalpemilu.org#68892,"BANTAYA, PARIGI, PARIGI MOUTONG, SULAWESI TENGAH",15,114,96,210
https://kawalpemilu.org#68892,"BANTAYA, PARIGI, PARIGI MOUTONG, SULAWESI TENGAH",16,110,71,181
https://kawalpemilu.org#68892,"BANTAYA, PARIGI, PARIGI MOUTONG, SULAWESI TENGAH",17,19,30,49
https://kawalpemilu.org#68892,"BANTAYA, PARIGI, PARIGI MOUTONG, SULAWESI TENGAH",18,28,34,62
https://kawalpemilu.org#68893,"KAMPAL, PARIGI, PARIGI MOUTONG, SULAWESI TENGAH",1,125,88,213
https://kawalpemilu.org#68893,"KAMPAL, PARIGI, PARIGI MOUTONG, SULAWESI TENGAH",2,115,73,188
https://kawalpemilu.org#68893,"KAMPAL, PARIGI, PARIGI MOUTONG, SULAWESI TENGAH",3,76,136,212
https://kawalpemilu.org#68893,"KAMPAL, PARIGI, PARIGI MOUTONG, SULAWESI TENGAH",4,102,114,216
https://kawalpemilu.org#68893,"KAMPAL, PARIGI, PARIGI MOUTONG, SULAWESI TENGAH",5,94,129,223
https://kawalpemilu.org#68893,"KAMPAL, PARIGI, PARIGI MOUTONG, SULAWESI TENGAH",6,78,152,230
https://kawalpemilu.org#68893,"KAMPAL, PARIGI, PARIGI MOUTONG, SULAWESI TENGAH",7,64,132,196
https://kawalpemilu.org#68893,"KAMPAL, PARIGI, PARIGI MOUTONG, SULAWESI TENGAH",8,59,102,161
https://kawalpemilu.org#68893,"KAMPAL, PARIGI, PARIGI MOUTONG, SULAWESI TENGAH",9,103,146,249
https://kawalpemilu.org#68893,"KAMPAL, PARIGI, PARIGI MOUTONG, SULAWESI TENGAH",10,88,151,239
https://kawalpemilu.org#68893,"KAMPAL, PARIGI, PARIGI MOUTONG, SULAWESI TENGAH",11,79,142,221
https://kawalpemilu.org#68894,"OLAYA, PARIGI, PARIGI MOUTONG, SULAWESI TENGAH",1,113,71,184
https://kawalpemilu.org#68894,"OLAYA, PARIGI, PARIGI MOUTONG, SULAWESI TENGAH",2,80,120,200
https://kawalpemilu.org#68894,"OLAYA, PARIGI, PARIGI MOUTONG, SULAWESI TENGAH",3,73,133,206
https://kawalpemilu.org#68894,"OLAYA, PARIGI, PARIGI MOUTONG, SULAWESI TENGAH",4,55,117,172
https://kawalpemilu.org#68894,"OLAYA, PARIGI, PARIGI MOUTONG, SULAWESI TENGAH",5,91,97,188
https://kawalpemilu.org#68894,"OLAYA, PARIGI, PARIGI MOUTONG, SULAWESI TENGAH",6,114,59,173
https://kawalpemilu.org#68894,"OLAYA, PARIGI, PARIGI MOUTONG, SULAWESI TENGAH",7,47,162,209
https://kawalpemilu.org#68894,"OLAYA, PARIGI, PARIGI MOUTONG, SULAWESI TENGAH",8,167,64,231
https://kawalpemilu.org#68894,"OLAYA, PARIGI, PARIGI MOUTONG, SULAWESI TENGAH",9,37,87,128
https://kawalpemilu.org#68895,"PEMBALOWO, PARIGI, PARIGI MOUTONG, SULAWESI TENGAH",1,105,114,219
https://kawalpemilu.org#68895,"PEMBALOWO, PARIGI, PARIGI MOUTONG, SULAWESI TENGAH",2,180,45,225
https://kawalpemilu.org#68895,"PEMBALOWO, PARIGI, PARIGI MOUTONG, SULAWESI TENGAH",3,110,96,206
https://kawalpemilu.org#68896,"MERTASARI, PARIGI, PARIGI MOUTONG, SULAWESI TENGAH",1,143,50,193
https://kawalpemilu.org#68896,"MERTASARI, PARIGI, PARIGI MOUTONG, SULAWESI TENGAH",2,117,97,214
https://kawalpemilu.org#68896,"MERTASARI, PARIGI, PARIGI MOUTONG, SULAWESI TENGAH",3,149,44,193
https://kawalpemilu.org#68897,"BAMBALEMO, PARIGI, PARIGI MOUTONG, SULAWESI TENGAH",1,92,106,198
https://kawalpemilu.org#68897,"BAMBALEMO, PARIGI, PARIGI MOUTONG, SULAWESI TENGAH",2,141,110,251
https://kawalpemilu.org#68897,"BAMBALEMO, PARIGI, PARIGI MOUTONG, SULAWESI TENGAH",3,114,106,220
https://kawalpemilu.org#68897,"BAMBALEMO, PARIGI, PARIGI MOUTONG, SULAWESI TENGAH",4,134,80,214
https://kawalpemilu.org#68897,"BAMBALEMO, PARIGI, PARIGI MOUTONG, SULAWESI TENGAH",5,99,96,195
https://kawalpemilu.org#68897,"BAMBALEMO, PARIGI, PARIGI MOUTONG, SULAWESI TENGAH",6,67,107,174
https://kawalpemilu.org#68898,"LEBO, PARIGI, PARIGI MOUTONG, SULAWESI TENGAH",1,126,90,216
https://kawalpemilu.org#68898,"LEBO, PARIGI, PARIGI MOUTONG, SULAWESI TENGAH",2,99,122,221
https://kawalpemilu.org#68898,"LEBO, PARIGI, PARIGI MOUTONG, SULAWESI TENGAH",3,120,126,246
https://kawalpemilu.org#89720,"BAMBALEMO RANOMAISI, PARIGI, PARIGI MOUTONG, SULAWESI TENGAH",1,106,71,177
https://kawalpemilu.org#89720,"BAMBALEMO RANOMAISI, PARIGI, PARIGI MOUTONG, SULAWESI TENGAH",2,106,71,177
https://kawalpemilu.org#89720,"BAMBALEMO RANOMAISI, PARIGI, PARIGI MOUTONG, SULAWESI TENGAH",3,97,87,184
https://kawalpemilu.org#68900,"TOLOLE, AMPIBABO, PARIGI MOUTONG, SULAWESI TENGAH",1,90,72,162
https://kawalpemilu.org#68900,"TOLOLE, AMPIBABO, PARIGI MOUTONG, SULAWESI TENGAH",2,54,126,180
https://kawalpemilu.org#68900,"TOLOLE, AMPIBABO, PARIGI MOUTONG, SULAWESI TENGAH",3,65,102,167
https://kawalpemilu.org#68900,"TOLOLE, AMPIBABO, PARIGI MOUTONG, SULAWESI TENGAH",4,92,83,175
https://kawalpemilu.org#68901,"TOGA, AMPIBABO, PARIGI MOUTONG, SULAWESI TENGAH",1,108,95,203
https://kawalpemilu.org#68901,"TOGA, AMPIBABO, PARIGI MOUTONG, SULAWESI TENGAH",2,71,123,194
https://kawalpemilu.org#68901,"TOGA, AMPIBABO, PARIGI MOUTONG, SULAWESI TENGAH",3,53,133,186
https://kawalpemilu.org#68901,"TOGA, AMPIBABO, PARIGI MOUTONG, SULAWESI TENGAH",4,86,120,206
https://kawalpemilu.org#68902,"SIDOLE, AMPIBABO, PARIGI MOUTONG, SULAWESI TENGAH",1,67,157,224
https://kawalpemilu.org#68902,"SIDOLE, AMPIBABO, PARIGI MOUTONG, SULAWESI TENGAH",2,41,139,180
https://kawalpemilu.org#68902,"SIDOLE, AMPIBABO, PARIGI MOUTONG, SULAWESI TENGAH",3,57,137,194
https://kawalpemilu.org#68903,"PARANGGI, AMPIBABO, PARIGI MOUTONG, SULAWESI TENGAH",1,111,107,218
https://kawalpemilu.org#68903,"PARANGGI, AMPIBABO, PARIGI MOUTONG, SULAWESI TENGAH",2,63,155,218
https://kawalpemilu.org#68903,"PARANGGI, AMPIBABO, PARIGI MOUTONG, SULAWESI TENGAH",3,60,120,180
https://kawalpemilu.org#68903,"PARANGGI, AMPIBABO, PARIGI MOUTONG, SULAWESI TENGAH",4,48,121,169
https://kawalpemilu.org#68903,"PARANGGI, AMPIBABO, PARIGI MOUTONG, SULAWESI TENGAH",5,65,132,197
https://kawalpemilu.org#68903,"PARANGGI, AMPIBABO, PARIGI MOUTONG, SULAWESI TENGAH",6,51,94,145
https://kawalpemilu.org#68904,"AMPIBABO, AMPIBABO, PARIGI MOUTONG, SULAWESI TENGAH",1,79,137,216
https://kawalpemilu.org#68904,"AMPIBABO, AMPIBABO, PARIGI MOUTONG, SULAWESI TENGAH",2,45,165,210
https://kawalpemilu.org#68904,"AMPIBABO, AMPIBABO, PARIGI MOUTONG, SULAWESI TENGAH",3,26,176,202
https://kawalpemilu.org#68904,"AMPIBABO, AMPIBABO, PARIGI MOUTONG, SULAWESI TENGAH",4,41,156,197
https://kawalpemilu.org#68905,"LEMO, AMPIBABO, PARIGI MOUTONG, SULAWESI TENGAH",1,40,144,184
https://kawalpemilu.org#68905,"LEMO, AMPIBABO, PARIGI MOUTONG, SULAWESI TENGAH",2,51,138,189
https://kawalpemilu.org#68905,"LEMO, AMPIBABO, PARIGI MOUTONG, SULAWESI TENGAH",3,31,142,173
https://kawalpemilu.org#68905,"LEMO, AMPIBABO, PARIGI MOUTONG, SULAWESI TENGAH",4,37,110,147
https://kawalpemilu.org#68906,"BURANGA, AMPIBABO, PARIGI MOUTONG, SULAWESI TENGAH",1,198,51,249
https://kawalpemilu.org#68906,"BURANGA, AMPIBABO, PARIGI MOUTONG, SULAWESI TENGAH",2,151,68,219
https://kawalpemilu.org#68906,"BURANGA, AMPIBABO, PARIGI MOUTONG, SULAWESI TENGAH",3,85,100,185
https://kawalpemilu.org#68906,"BURANGA, AMPIBABO, PARIGI MOUTONG, SULAWESI TENGAH",4,97,113,210
https://kawalpemilu.org#68906,"BURANGA, AMPIBABO, PARIGI MOUTONG, SULAWESI TENGAH",5,156,42,198
https://kawalpemilu.org#68906,"BURANGA, AMPIBABO, PARIGI MOUTONG, SULAWESI TENGAH",6,172,17,189
https://kawalpemilu.org#68906,"BURANGA, AMPIBABO, PARIGI MOUTONG, SULAWESI TENGAH",7,129,78,207
https://kawalpemilu.org#68907,"TANAMPEDAGI, AMPIBABO, PARIGI MOUTONG, SULAWESI TENGAH",1,160,68,228
https://kawalpemilu.org#68907,"TANAMPEDAGI, AMPIBABO, PARIGI MOUTONG, SULAWESI TENGAH",2,162,79,241
https://kawalpemilu.org#68907,"TANAMPEDAGI, AMPIBABO, PARIGI MOUTONG, SULAWESI TENGAH",3,72,71,143
https://kawalpemilu.org#68908,"TOMBI, AMPIBABO, PARIGI MOUTONG, SULAWESI TENGAH",1,170,52,222
https://kawalpemilu.org#68908,"TOMBI, AMPIBABO, PARIGI MOUTONG, SULAWESI TENGAH",2,170,53,223
https://kawalpemilu.org#68908,"TOMBI, AMPIBABO, PARIGI MOUTONG, SULAWESI TENGAH",3,62,122,184
https://kawalpemilu.org#68908,"TOMBI, AMPIBABO, PARIGI MOUTONG, SULAWESI TENGAH",4,89,113,202
https://kawalpemilu.org#68908,"TOMBI, AMPIBABO, PARIGI MOUTONG, SULAWESI TENGAH",5,95,94,189
https://kawalpemilu.org#68909,"AMPIBABO UTARA, AMPIBABO, PARIGI MOUTONG, SULAWESI TENGAH",1,92,105,197
https://kawalpemilu.org#68909,"AMPIBABO UTARA, AMPIBABO, PARIGI MOUTONG, SULAWESI TENGAH",2,91,111,202
https://kawalpemilu.org#68909,"AMPIBABO UTARA, AMPIBABO, PARIGI MOUTONG, SULAWESI TENGAH",3,83,141,224
https://kawalpemilu.org#68909,"AMPIBABO UTARA, AMPIBABO, PARIGI MOUTONG, SULAWESI TENGAH",4,53,126,179
https://kawalpemilu.org#68910,"LEMO UTARA, AMPIBABO, PARIGI MOUTONG, SULAWESI TENGAH",1,59,142,201
https://kawalpemilu.org#68910,"LEMO UTARA, AMPIBABO, PARIGI MOUTONG, SULAWESI TENGAH",2,68,138,206
https://kawalpemilu.org#68910,"LEMO UTARA, AMPIBABO, PARIGI MOUTONG, SULAWESI TENGAH",3,86,55,141
https://kawalpemilu.org#85687,"SIDOLE BARAT, AMPIBABO, PARIGI MOUTONG, SULAWESI TENGAH",1,74,86,160
https://kawalpemilu.org#85687,"SIDOLE BARAT, AMPIBABO, PARIGI MOUTONG, SULAWESI TENGAH",2,66,93,159
https://kawalpemilu.org#85687,"SIDOLE BARAT, AMPIBABO, PARIGI MOUTONG, SULAWESI TENGAH",3,48,92,140
https://kawalpemilu.org#85688,"ALOO, AMPIBABO, PARIGI MOUTONG, SULAWESI TENGAH",1,115,116,231
https://kawalpemilu.org#85689,"AMPIBABO TIMUR, AMPIBABO, PARIGI MOUTONG, SULAWESI TENGAH",1,61,85,146
https://kawalpemilu.org#85689,"AMPIBABO TIMUR, AMPIBABO, PARIGI MOUTONG, SULAWESI TENGAH",2,30,135,165
https://kawalpemilu.org#85689,"AMPIBABO TIMUR, AMPIBABO, PARIGI MOUTONG, SULAWESI TENGAH",3,51,101,152
https://kawalpemilu.org#85690,"SIDOLE TIMUR, AMPIBABO, PARIGI MOUTONG, SULAWESI TENGAH",1,56,162,218
https://kawalpemilu.org#85690,"SIDOLE TIMUR, AMPIBABO, PARIGI MOUTONG, SULAWESI TENGAH",2,80,89,169
https://kawalpemilu.org#89722,"OGOLUGUS, AMPIBABO, PARIGI MOUTONG, SULAWESI TENGAH",1,67,171,238
https://kawalpemilu.org#89722,"OGOLUGUS, AMPIBABO, PARIGI MOUTONG, SULAWESI TENGAH",2,89,141,230
https://kawalpemilu.org#89723,"PANGKU, AMPIBABO, PARIGI MOUTONG, SULAWESI TENGAH",1,120,51,171
https://kawalpemilu.org#89723,"PANGKU, AMPIBABO, PARIGI MOUTONG, SULAWESI TENGAH",2,125,53,178
https://kawalpemilu.org#89724,"TOLOLE RAYA, AMPIBABO, PARIGI MOUTONG, SULAWESI TENGAH",1,63,95,158
https://kawalpemilu.org#89724,"TOLOLE RAYA, AMPIBABO, PARIGI MOUTONG, SULAWESI TENGAH",2,67,86,153
https://kawalpemilu.org#89725,"LEMO TENGAH, AMPIBABO, PARIGI MOUTONG, SULAWESI TENGAH",1,24,196,220
https://kawalpemilu.org#89725,"LEMO TENGAH, AMPIBABO, PARIGI MOUTONG, SULAWESI TENGAH",2,23,164,187
https://kawalpemilu.org#68914,"BAINAA, TINOMBO, PARIGI MOUTONG, SULAWESI TENGAH",1,159,55,214
https://kawalpemilu.org#68914,"BAINAA, TINOMBO, PARIGI MOUTONG, SULAWESI TENGAH",2,83,69,152
https://kawalpemilu.org#68914,"BAINAA, TINOMBO, PARIGI MOUTONG, SULAWESI TENGAH",3,99,63,162
https://kawalpemilu.org#68914,"BAINAA, TINOMBO, PARIGI MOUTONG, SULAWESI TENGAH",4,116,53,169
https://kawalpemilu.org#68915,"DONGKAS, TINOMBO, PARIGI MOUTONG, SULAWESI TENGAH",1,70,131,201
https://kawalpemilu.org#68915,"DONGKAS, TINOMBO, PARIGI MOUTONG, SULAWESI TENGAH",2,116,117,233
https://kawalpemilu.org#68915,"DONGKAS, TINOMBO, PARIGI MOUTONG, SULAWESI TENGAH",3,123,96,219
https://kawalpemilu.org#68915,"DONGKAS, TINOMBO, PARIGI MOUTONG, SULAWESI TENGAH",4,64,159,223
https://kawalpemilu.org#68915,"DONGKAS, TINOMBO, PARIGI MOUTONG, SULAWESI TENGAH",5,56,25,81
https://kawalpemilu.org#68916,"TINOMBO, TINOMBO, PARIGI MOUTONG, SULAWESI TENGAH",1,119,84,203
https://kawalpemilu.org#68916,"TINOMBO, TINOMBO, PARIGI MOUTONG, SULAWESI TENGAH",2,73,98,171
https://kawalpemilu.org#68916,"TINOMBO, TINOMBO, PARIGI MOUTONG, SULAWESI TENGAH",3,68,102,170
https://kawalpemilu.org#68916,"TINOMBO, TINOMBO, PARIGI MOUTONG, SULAWESI TENGAH",4,98,76,174
https://kawalpemilu.org#68916,"TINOMBO, TINOMBO, PARIGI MOUTONG, SULAWESI TENGAH",5,97,89,186
https://kawalpemilu.org#68916,"TINOMBO, TINOMBO, PARIGI MOUTONG, SULAWESI TENGAH",6,74,106,180
https://kawalpemilu.org#68917,"LOMBOK, TINOMBO, PARIGI MOUTONG, SULAWESI TENGAH",1,83,82,165
https://kawalpemilu.org#68917,"LOMBOK, TINOMBO, PARIGI MOUTONG, SULAWESI TENGAH",2,62,98,160
https://kawalpemilu.org#68917,"LOMBOK, TINOMBO, PARIGI MOUTONG, SULAWESI TENGAH",3,60,85,145
https://kawalpemilu.org#68917,"LOMBOK, TINOMBO, PARIGI MOUTONG, SULAWESI TENGAH",4,88,72,160
https://kawalpemilu.org#68917,"LOMBOK, TINOMBO, PARIGI MOUTONG, SULAWESI TENGAH",5,57,66,122
https://kawalpemilu.org#68918,"DUSUNAN, TINOMBO, PARIGI MOUTONG, SULAWESI TENGAH",1,92,150,242
https://kawalpemilu.org#68918,"DUSUNAN, TINOMBO, PARIGI MOUTONG, SULAWESI TENGAH",2,86,133,219
https://kawalpemilu.org#68918,"DUSUNAN, TINOMBO, PARIGI MOUTONG, SULAWESI TENGAH",3,87,118,205
https://kawalpemilu.org#68919,"TIBU, TINOMBO, PARIGI MOUTONG, SULAWESI TENGAH",1,45,138,183
https://kawalpemilu.org#68919,"TIBU, TINOMBO, PARIGI MOUTONG, SULAWESI TENGAH",2,87,86,173
https://kawalpemilu.org#68919,"TIBU, TINOMBO, PARIGI MOUTONG, SULAWESI TENGAH",3,43,105,148
https://kawalpemilu.org#68919,"TIBU, TINOMBO, PARIGI MOUTONG, SULAWESI TENGAH",4,95,101,196
https://kawalpemilu.org#68923,"BAINAA BARAT, TINOMBO, PARIGI MOUTONG, SULAWESI TENGAH",1,69,90,159
https://kawalpemilu.org#68923,"BAINAA BARAT, TINOMBO, PARIGI MOUTONG, SULAWESI TENGAH",2,136,56,192
https://kawalpemilu.org#68923,"BAINAA BARAT, TINOMBO, PARIGI MOUTONG, SULAWESI TENGAH",3,106,41,147
https://kawalpemilu.org#68923,"BAINAA BARAT, TINOMBO, PARIGI MOUTONG, SULAWESI TENGAH",4,103,85,188
https://kawalpemilu.org#68925,"OGOALAS, TINOMBO, PARIGI MOUTONG, SULAWESI TENGAH",1,89,102,191
https://kawalpemilu.org#68925,"OGOALAS, TINOMBO, PARIGI MOUTONG, SULAWESI TENGAH",2,143,35,178
https://kawalpemilu.org#68925,"OGOALAS, TINOMBO, PARIGI MOUTONG, SULAWESI TENGAH",3,74,26,100
https://kawalpemilu.org#68925,"OGOALAS, TINOMBO, PARIGI MOUTONG, SULAWESI TENGAH",4,54,27,81
https://kawalpemilu.org#68925,"OGOALAS, TINOMBO, PARIGI MOUTONG, SULAWESI TENGAH",6,88,28,116
https://kawalpemilu.org#68925,"OGOALAS, TINOMBO, PARIGI MOUTONG, SULAWESI TENGAH",7,51,33,84
https://kawalpemilu.org#68925,"OGOALAS, TINOMBO, PARIGI MOUTONG, SULAWESI TENGAH",8,65,40,105
https://kawalpemilu.org#85694,"SILABIA, TINOMBO, PARIGI MOUTONG, SULAWESI TENGAH",1,103,46,149
https://kawalpemilu.org#85694,"SILABIA, TINOMBO, PARIGI MOUTONG, SULAWESI TENGAH",2,56,74,130
https://kawalpemilu.org#85694,"SILABIA, TINOMBO, PARIGI MOUTONG, SULAWESI TENGAH",3,114,40,154
https://kawalpemilu.org#85695,"SIAVU, TINOMBO, PARIGI MOUTONG, SULAWESI TENGAH",1,55,109,164
https://kawalpemilu.org#85695,"SIAVU, TINOMBO, PARIGI MOUTONG, SULAWESI TENGAH",2,83,103,186
https://kawalpemilu.org#85695,"SIAVU, TINOMBO, PARIGI MOUTONG, SULAWESI TENGAH",3,78,93,171
https://kawalpemilu.org#85696,"AMBASON MEKAR, TINOMBO, PARIGI MOUTONG, SULAWESI TENGAH",1,150,53,203
https://kawalpemilu.org#85696,"AMBASON MEKAR, TINOMBO, PARIGI MOUTONG, SULAWESI TENGAH",2,117,44,161
https://kawalpemilu.org#85696,"AMBASON MEKAR, TINOMBO, PARIGI MOUTONG, SULAWESI TENGAH",3,83,105,188
https://kawalpemilu.org#85697,"DUSUNAN BARAT, TINOMBO, PARIGI MOUTONG, SULAWESI TENGAH",1,103,65,168
https://kawalpemilu.org#85697,"DUSUNAN BARAT, TINOMBO, PARIGI MOUTONG, SULAWESI TENGAH",2,59,79,138
https://kawalpemilu.org#85697,"DUSUNAN BARAT, TINOMBO, PARIGI MOUTONG, SULAWESI TENGAH",3,80,59,139
https://kawalpemilu.org#85697,"DUSUNAN BARAT, TINOMBO, PARIGI MOUTONG, SULAWESI TENGAH",4,116,51,167
https://kawalpemilu.org#85698,"PATINGKE, TINOMBO, PARIGI MOUTONG, SULAWESI TENGAH",1,46,58,104
https://kawalpemilu.org#85698,"PATINGKE, TINOMBO, PARIGI MOUTONG, SULAWESI TENGAH",2,56,56,112
https://kawalpemilu.org#85698,"PATINGKE, TINOMBO, PARIGI MOUTONG, SULAWESI TENGAH",3,96,35,131
https://kawalpemilu.org#85698,"PATINGKE, TINOMBO, PARIGI MOUTONG, SULAWESI TENGAH",4,91,68,159
https://kawalpemilu.org#89726,"LOMBOK BARAT, TINOMBO, PARIGI MOUTONG, SULAWESI TENGAH",1,20,56,76
https://kawalpemilu.org#89726,"LOMBOK BARAT, TINOMBO, PARIGI MOUTONG, SULAWESI TENGAH",2,28,71,99
https://kawalpemilu.org#89726,"LOMBOK BARAT, TINOMBO, PARIGI MOUTONG, SULAWESI TENGAH",3,116,29,145
https://kawalpemilu.org#89726,"LOMBOK BARAT, TINOMBO, PARIGI MOUTONG, SULAWESI TENGAH",4,102,50,152
https://kawalpemilu.org#89726,"LOMBOK BARAT, TINOMBO, PARIGI MOUTONG, SULAWESI TENGAH",5,27,48,75
https://kawalpemilu.org#89726,"LOMBOK BARAT, TINOMBO, PARIGI MOUTONG, SULAWESI TENGAH",6,114,28,142
https://kawalpemilu.org#89726,"LOMBOK BARAT, TINOMBO, PARIGI MOUTONG, SULAWESI TENGAH",7,22,33,55
https://kawalpemilu.org#89726,"LOMBOK BARAT, TINOMBO, PARIGI MOUTONG, SULAWESI TENGAH",8,17,60,77
https://kawalpemilu.org#89726,"LOMBOK BARAT, TINOMBO, PARIGI MOUTONG, SULAWESI TENGAH",9,36,31,67
https://kawalpemilu.org#89726,"LOMBOK BARAT, TINOMBO, PARIGI MOUTONG, SULAWESI TENGAH",10,17,52,69
https://kawalpemilu.org#928625,"TAIPAOBAL, TINOMBO, PARIGI MOUTONG, SULAWESI TENGAH",1,48,126,174
https://kawalpemilu.org#928625,"TAIPAOBAL, TINOMBO, PARIGI MOUTONG, SULAWESI TENGAH",2,53,137,190
https://kawalpemilu.org#68927,"MOUTONG TIMUR, MOUTONG, PARIGI MOUTONG, SULAWESI TENGAH",1,138,33,171
https://kawalpemilu.org#68927,"MOUTONG TIMUR, MOUTONG, PARIGI MOUTONG, SULAWESI TENGAH",2,139,26,165
https://kawalpemilu.org#68927,"MOUTONG TIMUR, MOUTONG, PARIGI MOUTONG, SULAWESI TENGAH",3,139,57,196
https://kawalpemilu.org#68927,"MOUTONG TIMUR, MOUTONG, PARIGI MOUTONG, SULAWESI TENGAH",4,135,52,187
https://kawalpemilu.org#68927,"MOUTONG TIMUR, MOUTONG, PARIGI MOUTONG, SULAWESI TENGAH",5,135,70,205
https://kawalpemilu.org#68927,"MOUTONG TIMUR, MOUTONG, PARIGI MOUTONG, SULAWESI TENGAH",6,106,73,179
https://kawalpemilu.org#68928,"MOUTONG BARAT, MOUTONG, PARIGI MOUTONG, SULAWESI TENGAH",1,134,49,183
https://kawalpemilu.org#68928,"MOUTONG BARAT, MOUTONG, PARIGI MOUTONG, SULAWESI TENGAH",2,115,64,179
https://kawalpemilu.org#68928,"MOUTONG BARAT, MOUTONG, PARIGI MOUTONG, SULAWESI TENGAH",3,95,65,160
https://kawalpemilu.org#68928,"MOUTONG BARAT, MOUTONG, PARIGI MOUTONG, SULAWESI TENGAH",4,137,61,198
https://kawalpemilu.org#68928,"MOUTONG BARAT, MOUTONG, PARIGI MOUTONG, SULAWESI TENGAH",5,116,93,209
https://kawalpemilu.org#68929,"MOUTONG TENGAH, MOUTONG, PARIGI MOUTONG, SULAWESI TENGAH",1,120,51,171
https://kawalpemilu.org#68929,"MOUTONG TENGAH, MOUTONG, PARIGI MOUTONG, SULAWESI TENGAH",2,102,36,138
https://kawalpemilu.org#68929,"MOUTONG TENGAH, MOUTONG, PARIGI MOUTONG, SULAWESI TENGAH",3,117,67,184
https://kawalpemilu.org#68929,"MOUTONG TENGAH, MOUTONG, PARIGI MOUTONG, SULAWESI TENGAH",4,108,57,165
https://kawalpemilu.org#68929,"MOUTONG TENGAH, MOUTONG, PARIGI MOUTONG, SULAWESI TENGAH",5,76,41,117
https://kawalpemilu.org#68929,"MOUTONG TENGAH, MOUTONG, PARIGI MOUTONG, SULAWESI TENGAH",6,89,54,143
https://kawalpemilu.org#68929,"MOUTONG TENGAH, MOUTONG, PARIGI MOUTONG, SULAWESI TENGAH",7,0,0,0
https://kawalpemilu.org#68929,"MOUTONG TENGAH, MOUTONG, PARIGI MOUTONG, SULAWESI TENGAH",8,69,41,110
https://kawalpemilu.org#68929,"MOUTONG TENGAH, MOUTONG, PARIGI MOUTONG, SULAWESI TENGAH",9,50,49,99
https://kawalpemilu.org#68930,"TULADENGGI PANTAI, MOUTONG, PARIGI MOUTONG, SULAWESI TENGAH",1,112,23,135
https://kawalpemilu.org#68930,"TULADENGGI PANTAI, MOUTONG, PARIGI MOUTONG, SULAWESI TENGAH",2,83,31,114
https://kawalpemilu.org#68931,"GIO, MOUTONG, PARIGI MOUTONG, SULAWESI TENGAH",1,104,48,152
https://kawalpemilu.org#68931,"GIO, MOUTONG, PARIGI MOUTONG, SULAWESI TENGAH",2,70,80,150
https://kawalpemilu.org#68931,"GIO, MOUTONG, PARIGI MOUTONG, SULAWESI TENGAH",3,65,105,170
https://kawalpemilu.org#68931,"GIO, MOUTONG, PARIGI MOUTONG, SULAWESI TENGAH",4,73,83,156
https://kawalpemilu.org#68931,"GIO, MOUTONG, PARIGI MOUTONG, SULAWESI TENGAH",5,39,105,144
https://kawalpemilu.org#68932,"LOBU, MOUTONG, PARIGI MOUTONG, SULAWESI TENGAH",1,76,71,147
https://kawalpemilu.org#68932,"LOBU, MOUTONG, PARIGI MOUTONG, SULAWESI TENGAH",2,93,80,173
https://kawalpemilu.org#68932,"LOBU, MOUTONG, PARIGI MOUTONG, SULAWESI TENGAH",3,84,84,168
https://kawalpemilu.org#68932,"LOBU, MOUTONG, PARIGI MOUTONG, SULAWESI TENGAH",4,103,95,198
https://kawalpemilu.org#68932,"LOBU, MOUTONG, PARIGI MOUTONG, SULAWESI TENGAH",5,87,87,174
https://kawalpemilu.org#68932,"LOBU, MOUTONG, PARIGI MOUTONG, SULAWESI TENGAH",6,98,65,3
https://kawalpemilu.org#68932,"LOBU, MOUTONG, PARIGI MOUTONG, SULAWESI TENGAH",7,102,84,186
https://kawalpemilu.org#68932,"LOBU, MOUTONG, PARIGI MOUTONG, SULAWESI TENGAH",8,90,62,152
https://kawalpemilu.org#68932,"LOBU, MOUTONG, PARIGI MOUTONG, SULAWESI TENGAH",9,115,68,183
https://kawalpemilu.org#68933,"PENDELALAP, MOUTONG, PARIGI MOUTONG, SULAWESI TENGAH",1,62,85,147
https://kawalpemilu.org#68933,"PENDELALAP, MOUTONG, PARIGI MOUTONG, SULAWESI TENGAH",2,61,81,142
https://kawalpemilu.org#68933,"PENDELALAP, MOUTONG, PARIGI MOUTONG, SULAWESI TENGAH",3,75,67,142
https://kawalpemilu.org#68934,"SEJOLI, MOUTONG, PARIGI MOUTONG, SULAWESI TENGAH",1,131,22,153
https://kawalpemilu.org#68934,"SEJOLI, MOUTONG, PARIGI MOUTONG, SULAWESI TENGAH",2,52,13,65
https://kawalpemilu.org#68934,"SEJOLI, MOUTONG, PARIGI MOUTONG, SULAWESI TENGAH",3,113,19,132
https://kawalpemilu.org#68935,"AEDAN RAYA, MOUTONG, PARIGI MOUTONG, SULAWESI TENGAH",1,175,38,213
https://kawalpemilu.org#68935,"AEDAN RAYA, MOUTONG, PARIGI MOUTONG, SULAWESI TENGAH",2,129,63,192
https://kawalpemilu.org#68935,"AEDAN RAYA, MOUTONG, PARIGI MOUTONG, SULAWESI TENGAH",3,124,64,188
https://kawalpemilu.org#68936,"SALUMPENGUT, MOUTONG, PARIGI MOUTONG, SULAWESI TENGAH",1,150,86,236
https://kawalpemilu.org#68936,"SALUMPENGUT, MOUTONG, PARIGI MOUTONG, SULAWESI TENGAH",2,97,66,163
https://kawalpemilu.org#68936,"SALUMPENGUT, MOUTONG, PARIGI MOUTONG, SULAWESI TENGAH",3,132,22,154
https://kawalpemilu.org#68937,"BOLOUNG OLONGGATA, MOUTONG, PARIGI MOUTONG, SULAWESI TENGAH",1,50,126,176
https://kawalpemilu.org#68937,"BOLOUNG OLONGGATA, MOUTONG, PARIGI MOUTONG, SULAWESI TENGAH",2,67,128,195
https://kawalpemilu.org#68937,"BOLOUNG OLONGGATA, MOUTONG, PARIGI MOUTONG, SULAWESI TENGAH",3,49,120,169
https://kawalpemilu.org#89729,"LABUAN, MOUTONG, PARIGI MOUTONG, SULAWESI TENGAH",1,96,63,159
https://kawalpemilu.org#89729,"LABUAN, MOUTONG, PARIGI MOUTONG, SULAWESI TENGAH",2,119,40,159
https://kawalpemilu.org#89729,"LABUAN, MOUTONG, PARIGI MOUTONG, SULAWESI TENGAH",3,88,89,177
https://kawalpemilu.org#89730,"MBELANG MBELANG, MOUTONG, PARIGI MOUTONG, SULAWESI TENGAH",1,136,34,170
https://kawalpemilu.org#89730,"MBELANG MBELANG, MOUTONG, PARIGI MOUTONG, SULAWESI TENGAH",2,148,42,190
https://kawalpemilu.org#89731,"PANDE, MOUTONG, PARIGI MOUTONG, SULAWESI TENGAH",1,83,114,197
https://kawalpemilu.org#89731,"PANDE, MOUTONG, PARIGI MOUTONG, SULAWESI TENGAH",2,83,111,194
https://kawalpemilu.org#89732,"MOUTONG UTARA, MOUTONG, PARIGI MOUTONG, SULAWESI TENGAH",1,71,109,180
https://kawalpemilu.org#89732,"MOUTONG UTARA, MOUTONG, PARIGI MOUTONG, SULAWESI TENGAH",2,71,130,201
https://kawalpemilu.org#89732,"MOUTONG UTARA, MOUTONG, PARIGI MOUTONG, SULAWESI TENGAH",3,69,128,197
https://kawalpemilu.org#89733,"SALEPAE, MOUTONG, PARIGI MOUTONG, SULAWESI TENGAH",1,153,33,186
https://kawalpemilu.org#89733,"SALEPAE, MOUTONG, PARIGI MOUTONG, SULAWESI TENGAH",2,126,44,170
https://kawalpemilu.org#89734,"OLONGGATA, MOUTONG, PARIGI MOUTONG, SULAWESI TENGAH",1,132,69,201
https://kawalpemilu.org#89734,"OLONGGATA, MOUTONG, PARIGI MOUTONG, SULAWESI TENGAH",2,165,72,237
https://kawalpemilu.org#928626,"GIO TIMUR, MOUTONG, PARIGI MOUTONG, SULAWESI TENGAH",1,134,78,212
https://kawalpemilu.org#928626,"GIO TIMUR, MOUTONG, PARIGI MOUTONG, SULAWESI TENGAH",2,177,60,237
https://kawalpemilu.org#928627,"GIO BARAT, MOUTONG, PARIGI MOUTONG, SULAWESI TENGAH",1,101,57,158
https://kawalpemilu.org#928627,"GIO BARAT, MOUTONG, PARIGI MOUTONG, SULAWESI TENGAH",2,107,75,182
https://kawalpemilu.org#928628,"SIALOPA, MOUTONG, PARIGI MOUTONG, SULAWESI TENGAH",1,129,84,213
https://kawalpemilu.org#68939,"TINGKULANG, TOMINI, PARIGI MOUTONG, SULAWESI TENGAH",1,41,141,182
https://kawalpemilu.org#68939,"TINGKULANG, TOMINI, PARIGI MOUTONG, SULAWESI TENGAH",2,46,129,175
https://kawalpemilu.org#68939,"TINGKULANG, TOMINI, PARIGI MOUTONG, SULAWESI TENGAH",3,104,128,232
https://kawalpemilu.org#68939,"TINGKULANG, TOMINI, PARIGI MOUTONG, SULAWESI TENGAH",4,109,81,190
https://kawalpemilu.org#68939,"TINGKULANG, TOMINI, PARIGI MOUTONG, SULAWESI TENGAH",5,76,136,212
https://kawalpemilu.org#68940,"TOMINI, TOMINI, PARIGI MOUTONG, SULAWESI TENGAH",1,59,131,190
https://kawalpemilu.org#68940,"TOMINI, TOMINI, PARIGI MOUTONG, SULAWESI TENGAH",2,66,162,228
https://kawalpemilu.org#68940,"TOMINI, TOMINI, PARIGI MOUTONG, SULAWESI TENGAH",3,49,151,200
https://kawalpemilu.org#68940,"TOMINI, TOMINI, PARIGI MOUTONG, SULAWESI TENGAH",4,177,84,260
https://kawalpemilu.org#68941,"OGOTUMUBU, TOMINI, PARIGI MOUTONG, SULAWESI TENGAH",1,24,140,164
https://kawalpemilu.org#68941,"OGOTUMUBU, TOMINI, PARIGI MOUTONG, SULAWESI TENGAH",2,76,114,190
https://kawalpemilu.org#68941,"OGOTUMUBU, TOMINI, PARIGI MOUTONG, SULAWESI TENGAH",3,61,161,222
https://kawalpemilu.org#68941,"OGOTUMUBU, TOMINI, PARIGI MOUTONG, SULAWESI TENGAH",4,63,105,168
https://kawalpemilu.org#68941,"OGOTUMUBU, TOMINI, PARIGI MOUTONG, SULAWESI TENGAH",5,22,34,56
https://kawalpemilu.org#68942,"AMBESIA, TOMINI, PARIGI MOUTONG, SULAWESI TENGAH",1,93,74,167
https://kawalpemilu.org#68942,"AMBESIA, TOMINI, PARIGI MOUTONG, SULAWESI TENGAH",2,140,35,175
https://kawalpemilu.org#68942,"AMBESIA, TOMINI, PARIGI MOUTONG, SULAWESI TENGAH",3,125,47,172
https://kawalpemilu.org#68942,"AMBESIA, TOMINI, PARIGI MOUTONG, SULAWESI TENGAH",4,85,56,141
https://kawalpemilu.org#68942,"AMBESIA, TOMINI, PARIGI MOUTONG, SULAWESI TENGAH",5,158,38,196
https://kawalpemilu.org#68942,"AMBESIA, TOMINI, PARIGI MOUTONG, SULAWESI TENGAH",6,116,62,178
https://kawalpemilu.org#68943,"TILUNG, TOMINI, PARIGI MOUTONG, SULAWESI TENGAH",1,51,97,148
https://kawalpemilu.org#68943,"TILUNG, TOMINI, PARIGI MOUTONG, SULAWESI TENGAH",2,70,124,194
https://kawalpemilu.org#68943,"TILUNG, TOMINI, PARIGI MOUTONG, SULAWESI TENGAH",3,38,95,133
https://kawalpemilu.org#68944,"BIGA, TOMINI, PARIGI MOUTONG, SULAWESI TENGAH",1,97,104,201
https://kawalpemilu.org#68944,"BIGA, TOMINI, PARIGI MOUTONG, SULAWESI TENGAH",2,105,96,201
https://kawalpemilu.org#68944,"BIGA, TOMINI, PARIGI MOUTONG, SULAWESI TENGAH",3,138,46,184
https://kawalpemilu.org#68944,"BIGA, TOMINI, PARIGI MOUTONG, SULAWESI TENGAH",4,170,36,206
https://kawalpemilu.org#68944,"BIGA, TOMINI, PARIGI MOUTONG, SULAWESI TENGAH",5,133,64,197
https://kawalpemilu.org#68945,"TOMINI UTARA, TOMINI, PARIGI MOUTONG, SULAWESI TENGAH",1,114,75,189
https://kawalpemilu.org#68945,"TOMINI UTARA, TOMINI, PARIGI MOUTONG, SULAWESI TENGAH",2,138,83,221
https://kawalpemilu.org#68945,"TOMINI UTARA, TOMINI, PARIGI MOUTONG, SULAWESI TENGAH",3,104,71,175
https://kawalpemilu.org#68945,"TOMINI UTARA, TOMINI, PARIGI MOUTONG, SULAWESI TENGAH",4,63,107,170
https://kawalpemilu.org#68946,"TOMINI BARAT, TOMINI, PARIGI MOUTONG, SULAWESI TENGAH",1,65,140,205
https://kawalpemilu.org#68946,"TOMINI BARAT, TOMINI, PARIGI MOUTONG, SULAWESI TENGAH",2,36,100,136
https://kawalpemilu.org#68946,"TOMINI BARAT, TOMINI, PARIGI MOUTONG, SULAWESI TENGAH",3,82,140,222
https://kawalpemilu.org#68947,"AMBESIA SELATAN, TOMINI, PARIGI MOUTONG, SULAWESI TENGAH",1,72,60,132
https://kawalpemilu.org#68947,"AMBESIA SELATAN, TOMINI, PARIGI MOUTONG, SULAWESI TENGAH",2,58,119,177
https://kawalpemilu.org#68947,"AMBESIA SELATAN, TOMINI, PARIGI MOUTONG, SULAWESI TENGAH",3,124,66,190
https://kawalpemilu.org#68947,"AMBESIA SELATAN, TOMINI, PARIGI MOUTONG, SULAWESI TENGAH",4,70,86,156
https://kawalpemilu.org#68947,"AMBESIA SELATAN, TOMINI, PARIGI MOUTONG, SULAWESI TENGAH",5,85,64,149
https://kawalpemilu.org#85699,"SUPILOPONG, TOMINI, PARIGI MOUTONG, SULAWESI TENGAH",1,63,113,176
https://kawalpemilu.org#85699,"SUPILOPONG, TOMINI, PARIGI MOUTONG, SULAWESI TENGAH",2,46,100,146
https://kawalpemilu.org#85699,"SUPILOPONG, TOMINI, PARIGI MOUTONG, SULAWESI TENGAH",3,83,102,185
https://kawalpemilu.org#85700,"AMBESIA BARAT, TOMINI, PARIGI MOUTONG, SULAWESI TENGAH",1,122,118,241
https://kawalpemilu.org#85700,"AMBESIA BARAT, TOMINI, PARIGI MOUTONG, SULAWESI TENGAH",2,152,70,222
https://kawalpemilu.org#85700,"AMBESIA BARAT, TOMINI, PARIGI MOUTONG, SULAWESI TENGAH",3,77,111,188
https://kawalpemilu.org#85700,"AMBESIA BARAT, TOMINI, PARIGI MOUTONG, SULAWESI TENGAH",4,59,73,132
https://kawalpemilu.org#928343,"SIPONTAN, TOMINI, PARIGI MOUTONG, SULAWESI TENGAH",1,98,113,211
https://kawalpemilu.org#928343,"SIPONTAN, TOMINI, PARIGI MOUTONG, SULAWESI TENGAH",2,142,69,211
https://kawalpemilu.org#928630,"TA'ANIUGE, TOMINI, PARIGI MOUTONG, SULAWESI TENGAH",1,32,89,121
https://kawalpemilu.org#928630,"TA'ANIUGE, TOMINI, PARIGI MOUTONG, SULAWESI TENGAH",2,56,87,143
https://kawalpemilu.org#928630,"TA'ANIUGE, TOMINI, PARIGI MOUTONG, SULAWESI TENGAH",3,92,92,184
https://kawalpemilu.org#928630,"TA'ANIUGE, TOMINI, PARIGI MOUTONG, SULAWESI TENGAH",4,59,52,111
https://kawalpemilu.org#928631,"OGOTUMUBU BARAT, TOMINI, PARIGI MOUTONG, SULAWESI TENGAH",1,30,163,193
https://kawalpemilu.org#928631,"OGOTUMUBU BARAT, TOMINI, PARIGI MOUTONG, SULAWESI TENGAH",2,53,127,180
https://kawalpemilu.org#928631,"OGOTUMUBU BARAT, TOMINI, PARIGI MOUTONG, SULAWESI TENGAH",3,65,110,175
https://kawalpemilu.org#928631,"OGOTUMUBU BARAT, TOMINI, PARIGI MOUTONG, SULAWESI TENGAH",4,63,123,186
https://kawalpemilu.org#928631,"OGOTUMUBU BARAT, TOMINI, PARIGI MOUTONG, SULAWESI TENGAH",5,78,81,159
https://kawalpemilu.org#68949,"SAUSU PEORE, SAUSU, PARIGI MOUTONG, SULAWESI TENGAH",1,115,71,226
https://kawalpemilu.org#68949,"SAUSU PEORE, SAUSU, PARIGI MOUTONG, SULAWESI TENGAH",2,81,109,190
https://kawalpemilu.org#68949,"SAUSU PEORE, SAUSU, PARIGI MOUTONG, SULAWESI TENGAH",3,57,132,189
https://kawalpemilu.org#68949,"SAUSU PEORE, SAUSU, PARIGI MOUTONG, SULAWESI TENGAH",4,190,14,204
https://kawalpemilu.org#68949,"SAUSU PEORE, SAUSU, PARIGI MOUTONG, SULAWESI TENGAH",6,188,57,245
https://kawalpemilu.org#68949,"SAUSU PEORE, SAUSU, PARIGI MOUTONG, SULAWESI TENGAH",7,184,45,229
https://kawalpemilu.org#68950,"MALEALI, SAUSU, PARIGI MOUTONG, SULAWESI TENGAH",1,177,32,209
https://kawalpemilu.org#68950,"MALEALI, SAUSU, PARIGI MOUTONG, SULAWESI TENGAH",2,177,21,198
https://kawalpemilu.org#68950,"MALEALI, SAUSU, PARIGI MOUTONG, SULAWESI TENGAH",3,135,40,175
https://kawalpemilu.org#68950,"MALEALI, SAUSU, PARIGI MOUTONG, SULAWESI TENGAH",4,140,29,169
https://kawalpemilu.org#68950,"MALEALI, SAUSU, PARIGI MOUTONG, SULAWESI TENGAH",5,119,71,190
https://kawalpemilu.org#68950,"MALEALI, SAUSU, PARIGI MOUTONG, SULAWESI TENGAH",6,71,107,178
https://kawalpemilu.org#68950,"MALEALI, SAUSU, PARIGI MOUTONG, SULAWESI TENGAH",7,83,98,181
https://kawalpemilu.org#68950,"MALEALI, SAUSU, PARIGI MOUTONG, SULAWESI TENGAH",8,95,91,186
https://kawalpemilu.org#68951,"SAUSU TRANS, SAUSU, PARIGI MOUTONG, SULAWESI TENGAH",1,141,59,200
https://kawalpemilu.org#68951,"SAUSU TRANS, SAUSU, PARIGI MOUTONG, SULAWESI TENGAH",2,142,45,187
https://kawalpemilu.org#68951,"SAUSU TRANS, SAUSU, PARIGI MOUTONG, SULAWESI TENGAH",4,132,57,189
https://kawalpemilu.org#68951,"SAUSU TRANS, SAUSU, PARIGI MOUTONG, SULAWESI TENGAH",5,149,63,212
https://kawalpemilu.org#68951,"SAUSU TRANS, SAUSU, PARIGI MOUTONG, SULAWESI TENGAH",6,159,48,207
https://kawalpemilu.org#68951,"SAUSU TRANS, SAUSU, PARIGI MOUTONG, SULAWESI TENGAH",7,136,72,208
https://kawalpemilu.org#68951,"SAUSU TRANS, SAUSU, PARIGI MOUTONG, SULAWESI TENGAH",8,135,56,191
https://kawalpemilu.org#68951,"SAUSU TRANS, SAUSU, PARIGI MOUTONG, SULAWESI TENGAH",9,156,43,199
https://kawalpemilu.org#68951,"SAUSU TRANS, SAUSU, PARIGI MOUTONG, SULAWESI TENGAH",10,142,71,213
https://kawalpemilu.org#68951,"SAUSU TRANS, SAUSU, PARIGI MOUTONG, SULAWESI TENGAH",11,124,72,196
https://kawalpemilu.org#68951,"SAUSU TRANS, SAUSU, PARIGI MOUTONG, SULAWESI TENGAH",12,130,58,188
https://kawalpemilu.org#68951,"SAUSU TRANS, SAUSU, PARIGI MOUTONG, SULAWESI TENGAH",13,156,71,227
https://kawalpemilu.org#68951,"SAUSU TRANS, SAUSU, PARIGI MOUTONG, SULAWESI TENGAH",14,169,47,216
https://kawalpemilu.org#68951,"SAUSU TRANS, SAUSU, PARIGI MOUTONG, SULAWESI TENGAH",15,201,25,226
https://kawalpemilu.org#68951,"SAUSU TRANS, SAUSU, PARIGI MOUTONG, SULAWESI TENGAH",16,180,18,198
https://kawalpemilu.org#68952,"SAUSU TORONO, SAUSU, PARIGI MOUTONG, SULAWESI TENGAH",1,164,53,217
https://kawalpemilu.org#68952,"SAUSU TORONO, SAUSU, PARIGI MOUTONG, SULAWESI TENGAH",2,181,39,220
https://kawalpemilu.org#68952,"SAUSU TORONO, SAUSU, PARIGI MOUTONG, SULAWESI TENGAH",3,175,49,224
https://kawalpemilu.org#68952,"SAUSU TORONO, SAUSU, PARIGI MOUTONG, SULAWESI TENGAH",4,173,57,230
https://kawalpemilu.org#68952,"SAUSU TORONO, SAUSU, PARIGI MOUTONG, SULAWESI TENGAH",5,181,43,224
https://kawalpemilu.org#68953,"SAUSU PAKAREME, SAUSU, PARIGI MOUTONG, SULAWESI TENGAH",1,127,47,174
https://kawalpemilu.org#68953,"SAUSU PAKAREME, SAUSU, PARIGI MOUTONG, SULAWESI TENGAH",2,132,80,212
https://kawalpemilu.org#68953,"SAUSU PAKAREME, SAUSU, PARIGI MOUTONG, SULAWESI TENGAH",3,195,6,201
https://kawalpemilu.org#68953,"SAUSU PAKAREME, SAUSU, PARIGI MOUTONG, SULAWESI TENGAH",4,180,21,201
https://kawalpemilu.org#68953,"SAUSU PAKAREME, SAUSU, PARIGI MOUTONG, SULAWESI TENGAH",5,152,13,165
https://kawalpemilu.org#68954,"SAUSU GANDASARI, SAUSU, PARIGI MOUTONG, SULAWESI TENGAH",1,233,5,238
https://kawalpemilu.org#68954,"SAUSU GANDASARI, SAUSU, PARIGI MOUTONG, SULAWESI TENGAH",2,73,38,111
https://kawalpemilu.org#68954,"SAUSU GANDASARI, SAUSU, PARIGI MOUTONG, SULAWESI TENGAH",3,115,20,135
https://kawalpemilu.org#68954,"SAUSU GANDASARI, SAUSU, PARIGI MOUTONG, SULAWESI TENGAH",4,85,30,115
https://kawalpemilu.org#68954,"SAUSU GANDASARI, SAUSU, PARIGI MOUTONG, SULAWESI TENGAH",5,109,12,121
https://kawalpemilu.org#68955,"SAUSU SALUBANGA, SAUSU, PARIGI MOUTONG, SULAWESI TENGAH",1,39,24,63
https://kawalpemilu.org#68955,"SAUSU SALUBANGA, SAUSU, PARIGI MOUTONG, SULAWESI TENGAH",2,71,25,96
https://kawalpemilu.org#68955,"SAUSU SALUBANGA, SAUSU, PARIGI MOUTONG, SULAWESI TENGAH",3,44,9,53
https://kawalpemilu.org#68956,"SAUSU TALIABO, SAUSU, PARIGI MOUTONG, SULAWESI TENGAH",1,161,47,208
https://kawalpemilu.org#68956,"SAUSU TALIABO, SAUSU, PARIGI MOUTONG, SULAWESI TENGAH",2,160,35,195
https://kawalpemilu.org#68956,"SAUSU TALIABO, SAUSU, PARIGI MOUTONG, SULAWESI TENGAH",3,186,13,199
https://kawalpemilu.org#68956,"SAUSU TALIABO, SAUSU, PARIGI MOUTONG, SULAWESI TENGAH",4,124,46,170
https://kawalpemilu.org#68956,"SAUSU TALIABO, SAUSU, PARIGI MOUTONG, SULAWESI TENGAH",5,101,50,151
https://kawalpemilu.org#85701,"SAUSU TAMBU, SAUSU, PARIGI MOUTONG, SULAWESI TENGAH",1,140,54,194
https://kawalpemilu.org#85701,"SAUSU TAMBU, SAUSU, PARIGI MOUTONG, SULAWESI TENGAH",2,121,118,239
https://kawalpemilu.org#85701,"SAUSU TAMBU, SAUSU, PARIGI MOUTONG, SULAWESI TENGAH",3,120,87,207
https://kawalpemilu.org#85701,"SAUSU TAMBU, SAUSU, PARIGI MOUTONG, SULAWESI TENGAH",4,166,53,219
https://kawalpemilu.org#85701,"SAUSU TAMBU, SAUSU, PARIGI MOUTONG, SULAWESI TENGAH",5,132,65,197
https://kawalpemilu.org#85702,"SAUSU AUMA, SAUSU, PARIGI MOUTONG, SULAWESI TENGAH",1,129,86,215
https://kawalpemilu.org#85702,"SAUSU AUMA, SAUSU, PARIGI MOUTONG, SULAWESI TENGAH",2,166,49,215
https://kawalpemilu.org#85702,"SAUSU AUMA, SAUSU, PARIGI MOUTONG, SULAWESI TENGAH",3,192,28,220
https://kawalpemilu.org#68958,"LAMBUNU, BOLANO LAMBUNU, PARIGI MOUTONG, SULAWESI TENGAH",1,97,21,118
https://kawalpemilu.org#68958,"LAMBUNU, BOLANO LAMBUNU, PARIGI MOUTONG, SULAWESI TENGAH",2,160,29,189
https://kawalpemilu.org#68958,"LAMBUNU, BOLANO LAMBUNU, PARIGI MOUTONG, SULAWESI TENGAH",3,175,39,214
https://kawalpemilu.org#68958,"LAMBUNU, BOLANO LAMBUNU, PARIGI MOUTONG, SULAWESI TENGAH",4,138,38,176
https://kawalpemilu.org#68958,"LAMBUNU, BOLANO LAMBUNU, PARIGI MOUTONG, SULAWESI TENGAH",5,195,41,236
https://kawalpemilu.org#68958,"LAMBUNU, BOLANO LAMBUNU, PARIGI MOUTONG, SULAWESI TENGAH",6,125,56,185
https://kawalpemilu.org#68958,"LAMBUNU, BOLANO LAMBUNU, PARIGI MOUTONG, SULAWESI TENGAH",7,54,135,189
https://kawalpemilu.org#68958,"LAMBUNU, BOLANO LAMBUNU, PARIGI MOUTONG, SULAWESI TENGAH",8,107,86,193
https://kawalpemilu.org#68958,"LAMBUNU, BOLANO LAMBUNU, PARIGI MOUTONG, SULAWESI TENGAH",9,91,98,189
https://kawalpemilu.org#68961,"WANAGADING, BOLANO LAMBUNU, PARIGI MOUTONG, SULAWESI TENGAH",1,119,53,172
https://kawalpemilu.org#68961,"WANAGADING, BOLANO LAMBUNU, PARIGI MOUTONG, SULAWESI TENGAH",2,120,52,172
https://kawalpemilu.org#68961,"WANAGADING, BOLANO LAMBUNU, PARIGI MOUTONG, SULAWESI TENGAH",3,139,39,178
https://kawalpemilu.org#68961,"WANAGADING, BOLANO LAMBUNU, PARIGI MOUTONG, SULAWESI TENGAH",4,134,49,183
https://kawalpemilu.org#68961,"WANAGADING, BOLANO LAMBUNU, PARIGI MOUTONG, SULAWESI TENGAH",5,133,41,174
https://kawalpemilu.org#68962,"KOTANAGAYA, BOLANO LAMBUNU, PARIGI MOUTONG, SULAWESI TENGAH",1,107,21,128
https://kawalpemilu.org#68962,"KOTANAGAYA, BOLANO LAMBUNU, PARIGI MOUTONG, SULAWESI TENGAH",2,113,39,152
https://kawalpemilu.org#68962,"KOTANAGAYA, BOLANO LAMBUNU, PARIGI MOUTONG, SULAWESI TENGAH",3,106,55,161
https://kawalpemilu.org#68962,"KOTANAGAYA, BOLANO LAMBUNU, PARIGI MOUTONG, SULAWESI TENGAH",4,83,37,120
https://kawalpemilu.org#68962,"KOTANAGAYA, BOLANO LAMBUNU, PARIGI MOUTONG, SULAWESI TENGAH",5,116,46,162
https://kawalpemilu.org#68962,"KOTANAGAYA, BOLANO LAMBUNU, PARIGI MOUTONG, SULAWESI TENGAH",6,61,42,103
https://kawalpemilu.org#68962,"KOTANAGAYA, BOLANO LAMBUNU, PARIGI MOUTONG, SULAWESI TENGAH",7,73,31,104
https://kawalpemilu.org#68963,"MARGAPURA, BOLANO LAMBUNU, PARIGI MOUTONG, SULAWESI TENGAH",1,142,30,172
https://kawalpemilu.org#68963,"MARGAPURA, BOLANO LAMBUNU, PARIGI MOUTONG, SULAWESI TENGAH",2,146,54,200
https://kawalpemilu.org#68963,"MARGAPURA, BOLANO LAMBUNU, PARIGI MOUTONG, SULAWESI TENGAH",3,156,44,200
https://kawalpemilu.org#68963,"MARGAPURA, BOLANO LAMBUNU, PARIGI MOUTONG, SULAWESI TENGAH",4,141,46,187
https://kawalpemilu.org#68963,"MARGAPURA, BOLANO LAMBUNU, PARIGI MOUTONG, SULAWESI TENGAH",5,147,24,171
https://kawalpemilu.org#68964,"PETUNASUGI, BOLANO LAMBUNU, PARIGI MOUTONG, SULAWESI TENGAH",1,160,14,174
https://kawalpemilu.org#68964,"PETUNASUGI, BOLANO LAMBUNU, PARIGI MOUTONG, SULAWESI TENGAH",2,178,10,188
https://kawalpemilu.org#68964,"PETUNASUGI, BOLANO LAMBUNU, PARIGI MOUTONG, SULAWESI TENGAH",3,125,29,154
https://kawalpemilu.org#68964,"PETUNASUGI, BOLANO LAMBUNU, PARIGI MOUTONG, SULAWESI TENGAH",4,96,64,160
https://kawalpemilu.org#68964,"PETUNASUGI, BOLANO LAMBUNU, PARIGI MOUTONG, SULAWESI TENGAH",5,148,33,181
https://kawalpemilu.org#68964,"PETUNASUGI, BOLANO LAMBUNU, PARIGI MOUTONG, SULAWESI TENGAH",6,110,34,144
https://kawalpemilu.org#68964,"PETUNASUGI, BOLANO LAMBUNU, PARIGI MOUTONG, SULAWESI TENGAH",7,102,34,136
https://kawalpemilu.org#68973,"SIENDENG, BOLANO LAMBUNU, PARIGI MOUTONG, SULAWESI TENGAH",1,120,41,161
https://kawalpemilu.org#68973,"SIENDENG, BOLANO LAMBUNU, PARIGI MOUTONG, SULAWESI TENGAH",2,154,59,213
https://kawalpemilu.org#68973,"SIENDENG, BOLANO LAMBUNU, PARIGI MOUTONG, SULAWESI TENGAH",3,150,80,230
https://kawalpemilu.org#68973,"SIENDENG, BOLANO LAMBUNU, PARIGI MOUTONG, SULAWESI TENGAH",4,80,38,118
https://kawalpemilu.org#68973,"SIENDENG, BOLANO LAMBUNU, PARIGI MOUTONG, SULAWESI TENGAH",5,130,52,182
https://kawalpemilu.org#68974,"LAMBUNU UTARA, BOLANO LAMBUNU, PARIGI MOUTONG, SULAWESI TENGAH",1,101,83,184
https://kawalpemilu.org#68974,"LAMBUNU UTARA, BOLANO LAMBUNU, PARIGI MOUTONG, SULAWESI TENGAH",2,127,77,204
https://kawalpemilu.org#68974,"LAMBUNU UTARA, BOLANO LAMBUNU, PARIGI MOUTONG, SULAWESI TENGAH",3,147,56,203
https://kawalpemilu.org#68974,"LAMBUNU UTARA, BOLANO LAMBUNU, PARIGI MOUTONG, SULAWESI TENGAH",4,96,36,132
https://kawalpemilu.org#68974,"LAMBUNU UTARA, BOLANO LAMBUNU, PARIGI MOUTONG, SULAWESI TENGAH",5,166,4,170
https://kawalpemilu.org#68978,"GUNUNGSARI, BOLANO LAMBUNU, PARIGI MOUTONG, SULAWESI TENGAH",1,157,44,201
https://kawalpemilu.org#68978,"GUNUNGSARI, BOLANO LAMBUNU, PARIGI MOUTONG, SULAWESI TENGAH",2,145,45,190
https://kawalpemilu.org#68978,"GUNUNGSARI, BOLANO LAMBUNU, PARIGI MOUTONG, SULAWESI TENGAH",3,167,37,204
https://kawalpemilu.org#85703,"TIRTANAGAYA, BOLANO LAMBUNU, PARIGI MOUTONG, SULAWESI TENGAH",1,124,63,187
https://kawalpemilu.org#85703,"TIRTANAGAYA, BOLANO LAMBUNU, PARIGI MOUTONG, SULAWESI TENGAH",2,113,35,148
https://kawalpemilu.org#85703,"TIRTANAGAYA, BOLANO LAMBUNU, PARIGI MOUTONG, SULAWESI TENGAH",3,81,37,118
https://kawalpemilu.org#85703,"TIRTANAGAYA, BOLANO LAMBUNU, PARIGI MOUTONG, SULAWESI TENGAH",4,117,42,159
https://kawalpemilu.org#85703,"TIRTANAGAYA, BOLANO LAMBUNU, PARIGI MOUTONG, SULAWESI TENGAH",6,120,57,177
https://kawalpemilu.org#85703,"TIRTANAGAYA, BOLANO LAMBUNU, PARIGI MOUTONG, SULAWESI TENGAH",7,158,52,210
https://kawalpemilu.org#85704,"ANUTAPURA, BOLANO LAMBUNU, PARIGI MOUTONG, SULAWESI TENGAH",1,148,75,223
https://kawalpemilu.org#85704,"ANUTAPURA, BOLANO LAMBUNU, PARIGI MOUTONG, SULAWESI TENGAH",2,130,83,213
https://kawalpemilu.org#85704,"ANUTAPURA, BOLANO LAMBUNU, PARIGI MOUTONG, SULAWESI TENGAH",3,135,73,208
https://kawalpemilu.org#85704,"ANUTAPURA, BOLANO LAMBUNU, PARIGI MOUTONG, SULAWESI TENGAH",4,132,80,212
https://kawalpemilu.org#85704,"ANUTAPURA, BOLANO LAMBUNU, PARIGI MOUTONG, SULAWESI TENGAH",5,116,73,189
https://kawalpemilu.org#85705,"LAMBUNU TIMUR, BOLANO LAMBUNU, PARIGI MOUTONG, SULAWESI TENGAH",1,127,17,144
https://kawalpemilu.org#85705,"LAMBUNU TIMUR, BOLANO LAMBUNU, PARIGI MOUTONG, SULAWESI TENGAH",2,108,21,129
https://kawalpemilu.org#89735,"BUKIT MAKMUR, BOLANO LAMBUNU, PARIGI MOUTONG, SULAWESI TENGAH",1,109,34,143
https://kawalpemilu.org#89735,"BUKIT MAKMUR, BOLANO LAMBUNU, PARIGI MOUTONG, SULAWESI TENGAH",2,113,32,145
https://kawalpemilu.org#89735,"BUKIT MAKMUR, BOLANO LAMBUNU, PARIGI MOUTONG, SULAWESI TENGAH",3,138,30,168
https://kawalpemilu.org#89735,"BUKIT MAKMUR, BOLANO LAMBUNU, PARIGI MOUTONG, SULAWESI TENGAH",4,95,62,157
https://kawalpemilu.org#89736,"OGORANDU, BOLANO LAMBUNU, PARIGI MOUTONG, SULAWESI TENGAH",1,161,26,187
https://kawalpemilu.org#89736,"OGORANDU, BOLANO LAMBUNU, PARIGI MOUTONG, SULAWESI TENGAH",2,132,29,161
https://kawalpemilu.org#93135,"GANONGOL SARI, BOLANO LAMBUNU, PARIGI MOUTONG, SULAWESI TENGAH",1,167,17,184
https://kawalpemilu.org#93135,"GANONGOL SARI, BOLANO LAMBUNU, PARIGI MOUTONG, SULAWESI TENGAH",2,149,16,165
https://kawalpemilu.org#68981,"KASIMBAR, KASIMBAR, PARIGI MOUTONG, SULAWESI TENGAH",1,59,184,243
https://kawalpemilu.org#68981,"KASIMBAR, KASIMBAR, PARIGI MOUTONG, SULAWESI TENGAH",2,70,138,208
https://kawalpemilu.org#68981,"KASIMBAR, KASIMBAR, PARIGI MOUTONG, SULAWESI TENGAH",3,13,107,120
https://kawalpemilu.org#68981,"KASIMBAR, KASIMBAR, PARIGI MOUTONG, SULAWESI TENGAH",4,185,17,202
https://kawalpemilu.org#68981,"KASIMBAR, KASIMBAR, PARIGI MOUTONG, SULAWESI TENGAH",5,60,118,178
https://kawalpemilu.org#68982,"POSONA, KASIMBAR, PARIGI MOUTONG, SULAWESI TENGAH",1,97,128,225
https://kawalpemilu.org#68982,"POSONA, KASIMBAR, PARIGI MOUTONG, SULAWESI TENGAH",2,77,160,237
https://kawalpemilu.org#68982,"POSONA, KASIMBAR, PARIGI MOUTONG, SULAWESI TENGAH",3,50,173,223
https://kawalpemilu.org#68982,"POSONA, KASIMBAR, PARIGI MOUTONG, SULAWESI TENGAH",4,69,128,197
https://kawalpemilu.org#68982,"POSONA, KASIMBAR, PARIGI MOUTONG, SULAWESI TENGAH",5,44,88,132
https://kawalpemilu.org#68982,"POSONA, KASIMBAR, PARIGI MOUTONG, SULAWESI TENGAH",6,57,63,120
https://kawalpemilu.org#68982,"POSONA, KASIMBAR, PARIGI MOUTONG, SULAWESI TENGAH",7,90,29,119
https://kawalpemilu.org#68983,"LAEMANTA, KASIMBAR, PARIGI MOUTONG, SULAWESI TENGAH",1,89,69,158
https://kawalpemilu.org#68983,"LAEMANTA, KASIMBAR, PARIGI MOUTONG, SULAWESI TENGAH",2,137,46,183
https://kawalpemilu.org#68983,"LAEMANTA, KASIMBAR, PARIGI MOUTONG, SULAWESI TENGAH",3,99,76,175
https://kawalpemilu.org#68984,"DONGGULU, KASIMBAR, PARIGI MOUTONG, SULAWESI TENGAH",1,112,89,201
https://kawalpemilu.org#68984,"DONGGULU, KASIMBAR, PARIGI MOUTONG, SULAWESI TENGAH",2,153,68,221
https://kawalpemilu.org#68984,"DONGGULU, KASIMBAR, PARIGI MOUTONG, SULAWESI TENGAH",3,101,100,201
https://kawalpemilu.org#68984,"DONGGULU, KASIMBAR, PARIGI MOUTONG, SULAWESI TENGAH",4,47,102,149
https://kawalpemilu.org#68984,"DONGGULU, KASIMBAR, PARIGI MOUTONG, SULAWESI TENGAH",5,105,92,197
https://kawalpemilu.org#68984,"DONGGULU, KASIMBAR, PARIGI MOUTONG, SULAWESI TENGAH",6,93,68,161
https://kawalpemilu.org#68985,"KASIMBAR SELATAN, KASIMBAR, PARIGI MOUTONG, SULAWESI TENGAH",1,112,79,191
https://kawalpemilu.org#68985,"KASIMBAR SELATAN, KASIMBAR, PARIGI MOUTONG, SULAWESI TENGAH",2,95,84,179
https://kawalpemilu.org#68985,"KASIMBAR SELATAN, KASIMBAR, PARIGI MOUTONG, SULAWESI TENGAH",3,133,72,205
https://kawalpemilu.org#68985,"KASIMBAR SELATAN, KASIMBAR, PARIGI MOUTONG, SULAWESI TENGAH",4,76,50,126
https://kawalpemilu.org#68986,"KASIMBAR BARAT, KASIMBAR, PARIGI MOUTONG, SULAWESI TENGAH",1,120,62,182
https://kawalpemilu.org#68986,"KASIMBAR BARAT, KASIMBAR, PARIGI MOUTONG, SULAWESI TENGAH",2,111,54,165
https://kawalpemilu.org#68986,"KASIMBAR BARAT, KASIMBAR, PARIGI MOUTONG, SULAWESI TENGAH",3,110,55,165
https://kawalpemilu.org#68986,"KASIMBAR BARAT, KASIMBAR, PARIGI MOUTONG, SULAWESI TENGAH",4,97,47,144
https://kawalpemilu.org#68987,"SILAMPAYANG, KASIMBAR, PARIGI MOUTONG, SULAWESI TENGAH",1,73,64,137
https://kawalpemilu.org#68987,"SILAMPAYANG, KASIMBAR, PARIGI MOUTONG, SULAWESI TENGAH",2,98,70,168
https://kawalpemilu.org#68987,"SILAMPAYANG, KASIMBAR, PARIGI MOUTONG, SULAWESI TENGAH",3,93,116,209
https://kawalpemilu.org#68987,"SILAMPAYANG, KASIMBAR, PARIGI MOUTONG, SULAWESI TENGAH",4,67,79,146
https://kawalpemilu.org#68988,"TOVALO, KASIMBAR, PARIGI MOUTONG, SULAWESI TENGAH",1,147,17,164
https://kawalpemilu.org#68988,"TOVALO, KASIMBAR, PARIGI MOUTONG, SULAWESI TENGAH",2,140,19,159
https://kawalpemilu.org#68988,"TOVALO, KASIMBAR, PARIGI MOUTONG, SULAWESI TENGAH",3,105,55,160
https://kawalpemilu.org#68988,"TOVALO, KASIMBAR, PARIGI MOUTONG, SULAWESI TENGAH",4,105,52,157
https://kawalpemilu.org#68988,"TOVALO, KASIMBAR, PARIGI MOUTONG, SULAWESI TENGAH",5,183,42,225
https://kawalpemilu.org#68988,"TOVALO, KASIMBAR, PARIGI MOUTONG, SULAWESI TENGAH",6,103,43,146
https://kawalpemilu.org#89742,"DONGGULU SELATAN, KASIMBAR, PARIGI MOUTONG, SULAWESI TENGAH",1,82,99,181
https://kawalpemilu.org#89742,"DONGGULU SELATAN, KASIMBAR, PARIGI MOUTONG, SULAWESI TENGAH",2,125,54,179
https://kawalpemilu.org#89742,"DONGGULU SELATAN, KASIMBAR, PARIGI MOUTONG, SULAWESI TENGAH",3,124,41,165
https://kawalpemilu.org#89743,"LABUAN DONGGULU, KASIMBAR, PARIGI MOUTONG, SULAWESI TENGAH",1,170,36,206
https://kawalpemilu.org#89743,"LABUAN DONGGULU, KASIMBAR, PARIGI MOUTONG, SULAWESI TENGAH",2,139,62,201
https://kawalpemilu.org#89743,"LABUAN DONGGULU, KASIMBAR, PARIGI MOUTONG, SULAWESI TENGAH",3,121,62,183
https://kawalpemilu.org#89744,"KASIMBAR PALAPI, KASIMBAR, PARIGI MOUTONG, SULAWESI TENGAH",1,86,126,212
https://kawalpemilu.org#89744,"KASIMBAR PALAPI, KASIMBAR, PARIGI MOUTONG, SULAWESI TENGAH",2,78,119,197
https://kawalpemilu.org#89744,"KASIMBAR PALAPI, KASIMBAR, PARIGI MOUTONG, SULAWESI TENGAH",3,149,70,219
https://kawalpemilu.org#89744,"KASIMBAR PALAPI, KASIMBAR, PARIGI MOUTONG, SULAWESI TENGAH",4,236,14,250
https://kawalpemilu.org#89744,"KASIMBAR PALAPI, KASIMBAR, PARIGI MOUTONG, SULAWESI TENGAH",5,196,15,211
https://kawalpemilu.org#928632,"PENINGKA, KASIMBAR, PARIGI MOUTONG, SULAWESI TENGAH",1,103,34,137
https://kawalpemilu.org#928632,"PENINGKA, KASIMBAR, PARIGI MOUTONG, SULAWESI TENGAH",2,121,11,132
https://kawalpemilu.org#928632,"PENINGKA, KASIMBAR, PARIGI MOUTONG, SULAWESI TENGAH",3,103,36,139
https://kawalpemilu.org#928633,"LAEMANTA UTARA, KASIMBAR, PARIGI MOUTONG, SULAWESI TENGAH",1,107,103,210
https://kawalpemilu.org#928633,"LAEMANTA UTARA, KASIMBAR, PARIGI MOUTONG, SULAWESI TENGAH",2,118,81,199
https://kawalpemilu.org#928634,"AGODOPI KASIMBAR, KASIMBAR, PARIGI MOUTONG, SULAWESI TENGAH",1,101,23,124
https://kawalpemilu.org#928634,"AGODOPI KASIMBAR, KASIMBAR, PARIGI MOUTONG, SULAWESI TENGAH",2,102,47,149
https://kawalpemilu.org#928634,"AGODOPI KASIMBAR, KASIMBAR, PARIGI MOUTONG, SULAWESI TENGAH",3,159,26,185
https://kawalpemilu.org#928634,"AGODOPI KASIMBAR, KASIMBAR, PARIGI MOUTONG, SULAWESI TENGAH",4,189,18,207
https://kawalpemilu.org#928634,"AGODOPI KASIMBAR, KASIMBAR, PARIGI MOUTONG, SULAWESI TENGAH",5,40,85,125
https://kawalpemilu.org#928635,"SENDANA, KASIMBAR, PARIGI MOUTONG, SULAWESI TENGAH",1,69,85,154
https://kawalpemilu.org#928635,"SENDANA, KASIMBAR, PARIGI MOUTONG, SULAWESI TENGAH",2,41,89,130
https://kawalpemilu.org#928635,"SENDANA, KASIMBAR, PARIGI MOUTONG, SULAWESI TENGAH",3,70,95,165
https://kawalpemilu.org#928636,"KASIMBAR UTARA, KASIMBAR, PARIGI MOUTONG, SULAWESI TENGAH",1,54,106,160
https://kawalpemilu.org#928636,"KASIMBAR UTARA, KASIMBAR, PARIGI MOUTONG, SULAWESI TENGAH",2,74,110,184
https://kawalpemilu.org#928636,"KASIMBAR UTARA, KASIMBAR, PARIGI MOUTONG, SULAWESI TENGAH",3,68,68,136
https://kawalpemilu.org#928637,"POSONA ATAS, KASIMBAR, PARIGI MOUTONG, SULAWESI TENGAH",1,130,31,161
https://kawalpemilu.org#928637,"POSONA ATAS, KASIMBAR, PARIGI MOUTONG, SULAWESI TENGAH",2,134,45,179
https://kawalpemilu.org#928637,"POSONA ATAS, KASIMBAR, PARIGI MOUTONG, SULAWESI TENGAH",3,117,25,142
https://kawalpemilu.org#928638,"SUMBER TANI, KASIMBAR, PARIGI MOUTONG, SULAWESI TENGAH",1,161,71,232
https://kawalpemilu.org#928638,"SUMBER TANI, KASIMBAR, PARIGI MOUTONG, SULAWESI TENGAH",2,85,42,127
https://kawalpemilu.org#928638,"SUMBER TANI, KASIMBAR, PARIGI MOUTONG, SULAWESI TENGAH",3,94,49,143
https://kawalpemilu.org#68990,"TANALANTO, TORUE, PARIGI MOUTONG, SULAWESI TENGAH",1,135,77,212
https://kawalpemilu.org#68990,"TANALANTO, TORUE, PARIGI MOUTONG, SULAWESI TENGAH",2,146,38,184
https://kawalpemilu.org#68990,"TANALANTO, TORUE, PARIGI MOUTONG, SULAWESI TENGAH",3,190,17,207
https://kawalpemilu.org#68990,"TANALANTO, TORUE, PARIGI MOUTONG, SULAWESI TENGAH",4,232,7,239
https://kawalpemilu.org#68990,"TANALANTO, TORUE, PARIGI MOUTONG, SULAWESI TENGAH",5,178,47,225
https://kawalpemilu.org#68990,"TANALANTO, TORUE, PARIGI MOUTONG, SULAWESI TENGAH",6,159,27,186
https://kawalpemilu.org#68991,"TORUE, TORUE, PARIGI MOUTONG, SULAWESI TENGAH",1,182,24,206
https://kawalpemilu.org#68991,"TORUE, TORUE, PARIGI MOUTONG, SULAWESI TENGAH",2,187,15,202
https://kawalpemilu.org#68991,"TORUE, TORUE, PARIGI MOUTONG, SULAWESI TENGAH",3,185,41,226
https://kawalpemilu.org#68991,"TORUE, TORUE, PARIGI MOUTONG, SULAWESI TENGAH",4,169,47,216
https://kawalpemilu.org#68991,"TORUE, TORUE, PARIGI MOUTONG, SULAWESI TENGAH",5,135,63,198
https://kawalpemilu.org#68991,"TORUE, TORUE, PARIGI MOUTONG, SULAWESI TENGAH",6,151,71,222
https://kawalpemilu.org#68991,"TORUE, TORUE, PARIGI MOUTONG, SULAWESI TENGAH",7,168,52,220
https://kawalpemilu.org#68991,"TORUE, TORUE, PARIGI MOUTONG, SULAWESI TENGAH",8,257,6,263
https://kawalpemilu.org#68991,"TORUE, TORUE, PARIGI MOUTONG, SULAWESI TENGAH",9,172,64,236
https://kawalpemilu.org#68992,"ASTINA, TORUE, PARIGI MOUTONG, SULAWESI TENGAH",1,184,16,200
https://kawalpemilu.org#68992,"ASTINA, TORUE, PARIGI MOUTONG, SULAWESI TENGAH",2,188,28,216
https://kawalpemilu.org#68992,"ASTINA, TORUE, PARIGI MOUTONG, SULAWESI TENGAH",3,180,28,208
https://kawalpemilu.org#68992,"ASTINA, TORUE, PARIGI MOUTONG, SULAWESI TENGAH",4,195,8,203
https://kawalpemilu.org#68992,"ASTINA, TORUE, PARIGI MOUTONG, SULAWESI TENGAH",5,165,16,181
https://kawalpemilu.org#68993,"PURWOSARI, TORUE, PARIGI MOUTONG, SULAWESI TENGAH",1,191,36,227
https://kawalpemilu.org#68993,"PURWOSARI, TORUE, PARIGI MOUTONG, SULAWESI TENGAH",2,178,37,215
https://kawalpemilu.org#68993,"PURWOSARI, TORUE, PARIGI MOUTONG, SULAWESI TENGAH",3,193,15,208
https://kawalpemilu.org#68993,"PURWOSARI, TORUE, PARIGI MOUTONG, SULAWESI TENGAH",4,215,23,238
https://kawalpemilu.org#68993,"PURWOSARI, TORUE, PARIGI MOUTONG, SULAWESI TENGAH",5,184,16,200
https://kawalpemilu.org#68993,"PURWOSARI, TORUE, PARIGI MOUTONG, SULAWESI TENGAH",6,200,14,214
https://kawalpemilu.org#68993,"PURWOSARI, TORUE, PARIGI MOUTONG, SULAWESI TENGAH",7,194,13,207
https://kawalpemilu.org#68994,"TOLAI, TORUE, PARIGI MOUTONG, SULAWESI TENGAH",1,242,11,253
https://kawalpemilu.org#68994,"TOLAI, TORUE, PARIGI MOUTONG, SULAWESI TENGAH",2,173,39,212
https://kawalpemilu.org#68994,"TOLAI, TORUE, PARIGI MOUTONG, SULAWESI TENGAH",3,182,43,225
https://kawalpemilu.org#68994,"TOLAI, TORUE, PARIGI MOUTONG, SULAWESI TENGAH",4,225,12,237
https://kawalpemilu.org#68994,"TOLAI, TORUE, PARIGI MOUTONG, SULAWESI TENGAH",5,99,137,236
https://kawalpemilu.org#68994,"TOLAI, TORUE, PARIGI MOUTONG, SULAWESI TENGAH",6,131,90,221
https://kawalpemilu.org#68994,"TOLAI, TORUE, PARIGI MOUTONG, SULAWESI TENGAH",7,96,131,227
https://kawalpemilu.org#68994,"TOLAI, TORUE, PARIGI MOUTONG, SULAWESI TENGAH",8,181,31,212
https://kawalpemilu.org#68994,"TOLAI, TORUE, PARIGI MOUTONG, SULAWESI TENGAH",9,205,16,221
https://kawalpemilu.org#68994,"TOLAI, TORUE, PARIGI MOUTONG, SULAWESI TENGAH",10,227,13,240
https://kawalpemilu.org#68994,"TOLAI, TORUE, PARIGI MOUTONG, SULAWESI TENGAH",11,157,61,218
https://kawalpemilu.org#68994,"TOLAI, TORUE, PARIGI MOUTONG, SULAWESI TENGAH",12,125,60,185
https://kawalpemilu.org#68994,"TOLAI, TORUE, PARIGI MOUTONG, SULAWESI TENGAH",13,199,14,213
https://kawalpemilu.org#68994,"TOLAI, TORUE, PARIGI MOUTONG, SULAWESI TENGAH",14,183,36,219
https://kawalpemilu.org#68994,"TOLAI, TORUE, PARIGI MOUTONG, SULAWESI TENGAH",15,204,10,214
https://kawalpemilu.org#68994,"TOLAI, TORUE, PARIGI MOUTONG, SULAWESI TENGAH",16,186,6,192
https://kawalpemilu.org#68994,"TOLAI, TORUE, PARIGI MOUTONG, SULAWESI TENGAH",17,185,10,195
https://kawalpemilu.org#68995,"TOLAI BARAT, TORUE, PARIGI MOUTONG, SULAWESI TENGAH",1,161,15,176
https://kawalpemilu.org#68995,"TOLAI BARAT, TORUE, PARIGI MOUTONG, SULAWESI TENGAH",2,172,25,197
https://kawalpemilu.org#68995,"TOLAI BARAT, TORUE, PARIGI MOUTONG, SULAWESI TENGAH",3,169,17,186
https://kawalpemilu.org#68995,"TOLAI BARAT, TORUE, PARIGI MOUTONG, SULAWESI TENGAH",4,184,15,199
https://kawalpemilu.org#68995,"TOLAI BARAT, TORUE, PARIGI MOUTONG, SULAWESI TENGAH",5,211,16,227
https://kawalpemilu.org#85706,"TOLAI TIMUR, TORUE, PARIGI MOUTONG, SULAWESI TENGAH",1,176,2,178
https://kawalpemilu.org#85706,"TOLAI TIMUR, TORUE, PARIGI MOUTONG, SULAWESI TENGAH",2,178,12,190
https://kawalpemilu.org#85706,"TOLAI TIMUR, TORUE, PARIGI MOUTONG, SULAWESI TENGAH",3,184,5,189
https://kawalpemilu.org#85706,"TOLAI TIMUR, TORUE, PARIGI MOUTONG, SULAWESI TENGAH",4,186,4,190
https://kawalpemilu.org#85706,"TOLAI TIMUR, TORUE, PARIGI MOUTONG, SULAWESI TENGAH",5,178,6,184
https://kawalpemilu.org#68997,"TADA, TINOMBO SELATAN, PARIGI MOUTONG, SULAWESI TENGAH",1,68,107,175
https://kawalpemilu.org#68997,"TADA, TINOMBO SELATAN, PARIGI MOUTONG, SULAWESI TENGAH",2,63,100,163
https://kawalpemilu.org#68997,"TADA, TINOMBO SELATAN, PARIGI MOUTONG, SULAWESI TENGAH",3,82,106,188
https://kawalpemilu.org#68997,"TADA, TINOMBO SELATAN, PARIGI MOUTONG, SULAWESI TENGAH",4,84,104,188
https://kawalpemilu.org#68997,"TADA, TINOMBO SELATAN, PARIGI MOUTONG, SULAWESI TENGAH",5,64,60,124
https://kawalpemilu.org#68997,"TADA, TINOMBO SELATAN, PARIGI MOUTONG, SULAWESI TENGAH",6,70,42,112
https://kawalpemilu.org#68998,"SINEI, TINOMBO SELATAN, PARIGI MOUTONG, SULAWESI TENGAH",1,31,192,223
https://kawalpemilu.org#68998,"SINEI, TINOMBO SELATAN, PARIGI MOUTONG, SULAWESI TENGAH",2,38,155,193
https://kawalpemilu.org#68998,"SINEI, TINOMBO SELATAN, PARIGI MOUTONG, SULAWESI TENGAH",3,104,81,185
https://kawalpemilu.org#68999,"MANINILI, TINOMBO SELATAN, PARIGI MOUTONG, SULAWESI TENGAH",1,57,116,173
https://kawalpemilu.org#68999,"MANINILI, TINOMBO SELATAN, PARIGI MOUTONG, SULAWESI TENGAH",2,51,127,178
https://kawalpemilu.org#68999,"MANINILI, TINOMBO SELATAN, PARIGI MOUTONG, SULAWESI TENGAH",3,63,101,164
https://kawalpemilu.org#68999,"MANINILI, TINOMBO SELATAN, PARIGI MOUTONG, SULAWESI TENGAH",4,51,115,166
https://kawalpemilu.org#68999,"MANINILI, TINOMBO SELATAN, PARIGI MOUTONG, SULAWESI TENGAH",5,57,117,174
https://kawalpemilu.org#68999,"MANINILI, TINOMBO SELATAN, PARIGI MOUTONG, SULAWESI TENGAH",6,78,104,182
https://kawalpemilu.org#69000,"SIGENTI, TINOMBO SELATAN, PARIGI MOUTONG, SULAWESI TENGAH",1,73,135,208
https://kawalpemilu.org#69000,"SIGENTI, TINOMBO SELATAN, PARIGI MOUTONG, SULAWESI TENGAH",2,68,94,162
https://kawalpemilu.org#69000,"SIGENTI, TINOMBO SELATAN, PARIGI MOUTONG, SULAWESI TENGAH",3,48,95,143
https://kawalpemilu.org#69000,"SIGENTI, TINOMBO SELATAN, PARIGI MOUTONG, SULAWESI TENGAH",4,48,119,167
https://kawalpemilu.org#69000,"SIGENTI, TINOMBO SELATAN, PARIGI MOUTONG, SULAWESI TENGAH",5,54,134,188
https://kawalpemilu.org#69000,"SIGENTI, TINOMBO SELATAN, PARIGI MOUTONG, SULAWESI TENGAH",6,87,90,177
https://kawalpemilu.org#69000,"SIGENTI, TINOMBO SELATAN, PARIGI MOUTONG, SULAWESI TENGAH",7,83,111,194
https://kawalpemilu.org#69000,"SIGENTI, TINOMBO SELATAN, PARIGI MOUTONG, SULAWESI TENGAH",8,103,64,167
https://kawalpemilu.org#69000,"SIGENTI, TINOMBO SELATAN, PARIGI MOUTONG, SULAWESI TENGAH",9,45,113,158
https://kawalpemilu.org#69001,"MALANGGO, TINOMBO SELATAN, PARIGI MOUTONG, SULAWESI TENGAH",1,0,0,0
https://kawalpemilu.org#69001,"MALANGGO, TINOMBO SELATAN, PARIGI MOUTONG, SULAWESI TENGAH",2,92,95,187
https://kawalpemilu.org#69001,"MALANGGO, TINOMBO SELATAN, PARIGI MOUTONG, SULAWESI TENGAH",3,104,123,227
https://kawalpemilu.org#69001,"MALANGGO, TINOMBO SELATAN, PARIGI MOUTONG, SULAWESI TENGAH",4,58,138,196
https://kawalpemilu.org#69001,"MALANGGO, TINOMBO SELATAN, PARIGI MOUTONG, SULAWESI TENGAH",5,41,126,167
https://kawalpemilu.org#69002,"SILUTUNG, TINOMBO SELATAN, PARIGI MOUTONG, SULAWESI TENGAH",1,85,79,164
https://kawalpemilu.org#69002,"SILUTUNG, TINOMBO SELATAN, PARIGI MOUTONG, SULAWESI TENGAH",2,82,63,145
https://kawalpemilu.org#69002,"SILUTUNG, TINOMBO SELATAN, PARIGI MOUTONG, SULAWESI TENGAH",3,102,44,146
https://kawalpemilu.org#69002,"SILUTUNG, TINOMBO SELATAN, PARIGI MOUTONG, SULAWESI TENGAH",4,107,42,149
https://kawalpemilu.org#69002,"SILUTUNG, TINOMBO SELATAN, PARIGI MOUTONG, SULAWESI TENGAH",5,107,22,129
https://kawalpemilu.org#69002,"SILUTUNG, TINOMBO SELATAN, PARIGI MOUTONG, SULAWESI TENGAH",6,51,8,59
https://kawalpemilu.org#69003,"TADA SELATAN, TINOMBO SELATAN, PARIGI MOUTONG, SULAWESI TENGAH",1,108,79,187
https://kawalpemilu.org#69003,"TADA SELATAN, TINOMBO SELATAN, PARIGI MOUTONG, SULAWESI TENGAH",2,97,90,187
https://kawalpemilu.org#69003,"TADA SELATAN, TINOMBO SELATAN, PARIGI MOUTONG, SULAWESI TENGAH",3,84,51,135
https://kawalpemilu.org#69003,"TADA SELATAN, TINOMBO SELATAN, PARIGI MOUTONG, SULAWESI TENGAH",4,72,59,131
https://kawalpemilu.org#69004,"SIGEGA BERSEHATI, TINOMBO SELATAN, PARIGI MOUTONG, SULAWESI TENGAH",1,111,50,161
https://kawalpemilu.org#69004,"SIGEGA BERSEHATI, TINOMBO SELATAN, PARIGI MOUTONG, SULAWESI TENGAH",2,96,80,176
https://kawalpemilu.org#69004,"SIGEGA BERSEHATI, TINOMBO SELATAN, PARIGI MOUTONG, SULAWESI TENGAH",3,142,24,166
https://kawalpemilu.org#69004,"SIGEGA BERSEHATI, TINOMBO SELATAN, PARIGI MOUTONG, SULAWESI TENGAH",4,114,57,171
https://kawalpemilu.org#69004,"SIGEGA BERSEHATI, TINOMBO SELATAN, PARIGI MOUTONG, SULAWESI TENGAH",5,102,58,160
https://kawalpemilu.org#69004,"SIGEGA BERSEHATI, TINOMBO SELATAN, PARIGI MOUTONG, SULAWESI TENGAH",6,83,66,149
https://kawalpemilu.org#69005,"SIAGA, TINOMBO SELATAN, PARIGI MOUTONG, SULAWESI TENGAH",1,51,176,227
https://kawalpemilu.org#69005,"SIAGA, TINOMBO SELATAN, PARIGI MOUTONG, SULAWESI TENGAH",2,51,162,213
https://kawalpemilu.org#69005,"SIAGA, TINOMBO SELATAN, PARIGI MOUTONG, SULAWESI TENGAH",3,75,130,205
https://kawalpemilu.org#69005,"SIAGA, TINOMBO SELATAN, PARIGI MOUTONG, SULAWESI TENGAH",4,68,147,215
https://kawalpemilu.org#69006,"KHATULISTIWA, TINOMBO SELATAN, PARIGI MOUTONG, SULAWESI TENGAH",1,59,101,160
https://kawalpemilu.org#69006,"KHATULISTIWA, TINOMBO SELATAN, PARIGI MOUTONG, SULAWESI TENGAH",2,55,79,134
https://kawalpemilu.org#69006,"KHATULISTIWA, TINOMBO SELATAN, PARIGI MOUTONG, SULAWESI TENGAH",3,75,143,219
https://kawalpemilu.org#69006,"KHATULISTIWA, TINOMBO SELATAN, PARIGI MOUTONG, SULAWESI TENGAH",4,111,89,200
https://kawalpemilu.org#69006,"KHATULISTIWA, TINOMBO SELATAN, PARIGI MOUTONG, SULAWESI TENGAH",5,36,63,99
https://kawalpemilu.org#69007,"POLY, TINOMBO SELATAN, PARIGI MOUTONG, SULAWESI TENGAH",1,135,95,230
https://kawalpemilu.org#69007,"POLY, TINOMBO SELATAN, PARIGI MOUTONG, SULAWESI TENGAH",2,166,54,220
https://kawalpemilu.org#69007,"POLY, TINOMBO SELATAN, PARIGI MOUTONG, SULAWESI TENGAH",3,101,29,130
https://kawalpemilu.org#69008,"SIGENTI SELATAN, TINOMBO SELATAN, PARIGI MOUTONG, SULAWESI TENGAH",1,53,90,143
https://kawalpemilu.org#69008,"SIGENTI SELATAN, TINOMBO SELATAN, PARIGI MOUTONG, SULAWESI TENGAH",2,97,39,136
https://kawalpemilu.org#69008,"SIGENTI SELATAN, TINOMBO SELATAN, PARIGI MOUTONG, SULAWESI TENGAH",3,168,54,222
https://kawalpemilu.org#69008,"SIGENTI SELATAN, TINOMBO SELATAN, PARIGI MOUTONG, SULAWESI TENGAH",4,106,89,195
https://kawalpemilu.org#69008,"SIGENTI SELATAN, TINOMBO SELATAN, PARIGI MOUTONG, SULAWESI TENGAH",5,83,76,159
https://kawalpemilu.org#69009,"TADA TIMUR, TINOMBO SELATAN, PARIGI MOUTONG, SULAWESI TENGAH",1,94,90,184
https://kawalpemilu.org#69009,"TADA TIMUR, TINOMBO SELATAN, PARIGI MOUTONG, SULAWESI TENGAH",2,82,86,168
https://kawalpemilu.org#69009,"TADA TIMUR, TINOMBO SELATAN, PARIGI MOUTONG, SULAWESI TENGAH",3,96,40,136
https://kawalpemilu.org#69010,"SIGENTI BARAT, TINOMBO SELATAN, PARIGI MOUTONG, SULAWESI TENGAH",1,111,87,198
https://kawalpemilu.org#69010,"SIGENTI BARAT, TINOMBO SELATAN, PARIGI MOUTONG, SULAWESI TENGAH",2,122,81,203
https://kawalpemilu.org#69010,"SIGENTI BARAT, TINOMBO SELATAN, PARIGI MOUTONG, SULAWESI TENGAH",3,79,92,171
https://kawalpemilu.org#69010,"SIGENTI BARAT, TINOMBO SELATAN, PARIGI MOUTONG, SULAWESI TENGAH",4,80,88,168
https://kawalpemilu.org#85707,"MALANGGO PESISIR, TINOMBO SELATAN, PARIGI MOUTONG, SULAWESI TENGAH",1,152,40,192
https://kawalpemilu.org#85707,"MALANGGO PESISIR, TINOMBO SELATAN, PARIGI MOUTONG, SULAWESI TENGAH",2,111,85,196
https://kawalpemilu.org#89745,"MANINILI BARAT, TINOMBO SELATAN, PARIGI MOUTONG, SULAWESI TENGAH",1,49,108,157
https://kawalpemilu.org#89745,"MANINILI BARAT, TINOMBO SELATAN, PARIGI MOUTONG, SULAWESI TENGAH",2,98,131,229
https://kawalpemilu.org#89745,"MANINILI BARAT, TINOMBO SELATAN, PARIGI MOUTONG, SULAWESI TENGAH",3,71,22,93
https://kawalpemilu.org#89746,"MANINILI UTARA, TINOMBO SELATAN, PARIGI MOUTONG, SULAWESI TENGAH",1,66,109,175
https://kawalpemilu.org#89746,"MANINILI UTARA, TINOMBO SELATAN, PARIGI MOUTONG, SULAWESI TENGAH",2,147,70,217
https://kawalpemilu.org#89746,"MANINILI UTARA, TINOMBO SELATAN, PARIGI MOUTONG, SULAWESI TENGAH",3,130,22,152
https://kawalpemilu.org#89747,"SINEY TENGAH, TINOMBO SELATAN, PARIGI MOUTONG, SULAWESI TENGAH",1,67,144,211
https://kawalpemilu.org#89747,"SINEY TENGAH, TINOMBO SELATAN, PARIGI MOUTONG, SULAWESI TENGAH",2,59,81,140
https://kawalpemilu.org#89747,"SINEY TENGAH, TINOMBO SELATAN, PARIGI MOUTONG, SULAWESI TENGAH",3,75,57,132
https://kawalpemilu.org#89748,"TADA UTARA, TINOMBO SELATAN, PARIGI MOUTONG, SULAWESI TENGAH",1,99,41,140
https://kawalpemilu.org#89748,"TADA UTARA, TINOMBO SELATAN, PARIGI MOUTONG, SULAWESI TENGAH",2,53,70,123
https://kawalpemilu.org#89748,"TADA UTARA, TINOMBO SELATAN, PARIGI MOUTONG, SULAWESI TENGAH",3,93,71,164
https://kawalpemilu.org#89748,"TADA UTARA, TINOMBO SELATAN, PARIGI MOUTONG, SULAWESI TENGAH",4,53,45,98
https://kawalpemilu.org#928639,"ONCONE RAYA, TINOMBO SELATAN, PARIGI MOUTONG, SULAWESI TENGAH",1,86,45,131
https://kawalpemilu.org#928639,"ONCONE RAYA, TINOMBO SELATAN, PARIGI MOUTONG, SULAWESI TENGAH",2,101,52,153
https://kawalpemilu.org#928639,"ONCONE RAYA, TINOMBO SELATAN, PARIGI MOUTONG, SULAWESI TENGAH",3,37,56,93
https://kawalpemilu.org#928639,"ONCONE RAYA, TINOMBO SELATAN, PARIGI MOUTONG, SULAWESI TENGAH",4,38,8,46
https://kawalpemilu.org#69012,"LEMUSA, PARIGI SELATAN, PARIGI MOUTONG, SULAWESI TENGAH",1,144,90,234
https://kawalpemilu.org#69012,"LEMUSA, PARIGI SELATAN, PARIGI MOUTONG, SULAWESI TENGAH",2,118,98,216
https://kawalpemilu.org#69012,"LEMUSA, PARIGI SELATAN, PARIGI MOUTONG, SULAWESI TENGAH",3,178,17,195
https://kawalpemilu.org#69012,"LEMUSA, PARIGI SELATAN, PARIGI MOUTONG, SULAWESI TENGAH",4,144,15,159
https://kawalpemilu.org#69012,"LEMUSA, PARIGI SELATAN, PARIGI MOUTONG, SULAWESI TENGAH",5,154,13,167
https://kawalpemilu.org#69013,"OLOBARU, PARIGI SELATAN, PARIGI MOUTONG, SULAWESI TENGAH",1,148,48,196
https://kawalpemilu.org#69013,"OLOBARU, PARIGI SELATAN, PARIGI MOUTONG, SULAWESI TENGAH",2,188,19,207
https://kawalpemilu.org#69013,"OLOBARU, PARIGI SELATAN, PARIGI MOUTONG, SULAWESI TENGAH",3,129,93,222
https://kawalpemilu.org#69014,"BOYANTONGO, PARIGI SELATAN, PARIGI MOUTONG, SULAWESI TENGAH",1,139,85,224
https://kawalpemilu.org#69014,"BOYANTONGO, PARIGI SELATAN, PARIGI MOUTONG, SULAWESI TENGAH",2,94,118,212
https://kawalpemilu.org#69014,"BOYANTONGO, PARIGI SELATAN, PARIGI MOUTONG, SULAWESI TENGAH",3,53,190,243
https://kawalpemilu.org#69014,"BOYANTONGO, PARIGI SELATAN, PARIGI MOUTONG, SULAWESI TENGAH",4,87,156,243
https://kawalpemilu.org#69014,"BOYANTONGO, PARIGI SELATAN, PARIGI MOUTONG, SULAWESI TENGAH",5,132,101,233
https://kawalpemilu.org#69015,"DOLAGO, PARIGI SELATAN, PARIGI MOUTONG, SULAWESI TENGAH",1,93,149,242
https://kawalpemilu.org#69015,"DOLAGO, PARIGI SELATAN, PARIGI MOUTONG, SULAWESI TENGAH",2,97,161,258
https://kawalpemilu.org#69015,"DOLAGO, PARIGI SELATAN, PARIGI MOUTONG, SULAWESI TENGAH",3,93,144,237
https://kawalpemilu.org#69015,"DOLAGO, PARIGI SELATAN, PARIGI MOUTONG, SULAWESI TENGAH",4,148,95,243
https://kawalpemilu.org#69015,"DOLAGO, PARIGI SELATAN, PARIGI MOUTONG, SULAWESI TENGAH",5,175,72,247
https://kawalpemilu.org#69015,"DOLAGO, PARIGI SELATAN, PARIGI MOUTONG, SULAWESI TENGAH",6,132,128,260
https://kawalpemilu.org#69015,"DOLAGO, PARIGI SELATAN, PARIGI MOUTONG, SULAWESI TENGAH",7,78,74,152
https://kawalpemilu.org#69015,"DOLAGO, PARIGI SELATAN, PARIGI MOUTONG, SULAWESI TENGAH",8,116,63,179
https://kawalpemilu.org#69015,"DOLAGO, PARIGI SELATAN, PARIGI MOUTONG, SULAWESI TENGAH",9,139,57,196
https://kawalpemilu.org#69015,"DOLAGO, PARIGI SELATAN, PARIGI MOUTONG, SULAWESI TENGAH",10,63,8,71
https://kawalpemilu.org#69016,"MASARI, PARIGI SELATAN, PARIGI MOUTONG, SULAWESI TENGAH",1,205,14,219
https://kawalpemilu.org#69016,"MASARI, PARIGI SELATAN, PARIGI MOUTONG, SULAWESI TENGAH",2,184,29,213
https://kawalpemilu.org#69016,"MASARI, PARIGI SELATAN, PARIGI MOUTONG, SULAWESI TENGAH",3,191,37,228
https://kawalpemilu.org#69017,"SUMBERSARI, PARIGI SELATAN, PARIGI MOUTONG, SULAWESI TENGAH",1,203,23,226
https://kawalpemilu.org#69017,"SUMBERSARI, PARIGI SELATAN, PARIGI MOUTONG, SULAWESI TENGAH",2,166,44,210
https://kawalpemilu.org#69017,"SUMBERSARI, PARIGI SELATAN, PARIGI MOUTONG, SULAWESI TENGAH",3,121,37,158
https://kawalpemilu.org#69017,"SUMBERSARI, PARIGI SELATAN, PARIGI MOUTONG, SULAWESI TENGAH",4,194,14,208
https://kawalpemilu.org#69017,"SUMBERSARI, PARIGI SELATAN, PARIGI MOUTONG, SULAWESI TENGAH",5,213,21,234
https://kawalpemilu.org#69017,"SUMBERSARI, PARIGI SELATAN, PARIGI MOUTONG, SULAWESI TENGAH",6,138,46,184
https://kawalpemilu.org#69017,"SUMBERSARI, PARIGI SELATAN, PARIGI MOUTONG, SULAWESI TENGAH",7,146,26,172
https://kawalpemilu.org#69018,"NAMBARU, PARIGI SELATAN, PARIGI MOUTONG, SULAWESI TENGAH",1,139,43,182
https://kawalpemilu.org#69018,"NAMBARU, PARIGI SELATAN, PARIGI MOUTONG, SULAWESI TENGAH",2,146,20,166
https://kawalpemilu.org#69018,"NAMBARU, PARIGI SELATAN, PARIGI MOUTONG, SULAWESI TENGAH",3,170,49,219
https://kawalpemilu.org#69018,"NAMBARU, PARIGI SELATAN, PARIGI MOUTONG, SULAWESI TENGAH",4,191,32,223
https://kawalpemilu.org#69018,"NAMBARU, PARIGI SELATAN, PARIGI MOUTONG, SULAWESI TENGAH",5,153,34,187
https://kawalpemilu.org#69018,"NAMBARU, PARIGI SELATAN, PARIGI MOUTONG, SULAWESI TENGAH",6,166,41,207
https://kawalpemilu.org#69018,"NAMBARU, PARIGI SELATAN, PARIGI MOUTONG, SULAWESI TENGAH",7,101,1,102
https://kawalpemilu.org#69018,"NAMBARU, PARIGI SELATAN, PARIGI MOUTONG, SULAWESI TENGAH",8,157,26,183
https://kawalpemilu.org#69018,"NAMBARU, PARIGI SELATAN, PARIGI MOUTONG, SULAWESI TENGAH",9,159,58,217
https://kawalpemilu.org#69018,"NAMBARU, PARIGI SELATAN, PARIGI MOUTONG, SULAWESI TENGAH",10,122,30,152
https://kawalpemilu.org#69018,"NAMBARU, PARIGI SELATAN, PARIGI MOUTONG, SULAWESI TENGAH",11,118,27,145
https://kawalpemilu.org#69018,"NAMBARU, PARIGI SELATAN, PARIGI MOUTONG, SULAWESI TENGAH",12,183,31,214
https://kawalpemilu.org#69019,"TINDAKI, PARIGI SELATAN, PARIGI MOUTONG, SULAWESI TENGAH",1,163,84,247
https://kawalpemilu.org#69019,"TINDAKI, PARIGI SELATAN, PARIGI MOUTONG, SULAWESI TENGAH",2,103,113,216
https://kawalpemilu.org#69019,"TINDAKI, PARIGI SELATAN, PARIGI MOUTONG, SULAWESI TENGAH",3,128,102,230
https://kawalpemilu.org#69019,"TINDAKI, PARIGI SELATAN, PARIGI MOUTONG, SULAWESI TENGAH",4,207,26,233
https://kawalpemilu.org#69019,"TINDAKI, PARIGI SELATAN, PARIGI MOUTONG, SULAWESI TENGAH",5,194,19,213
https://kawalpemilu.org#69019,"TINDAKI, PARIGI SELATAN, PARIGI MOUTONG, SULAWESI TENGAH",6,142,66,208
https://kawalpemilu.org#69019,"TINDAKI, PARIGI SELATAN, PARIGI MOUTONG, SULAWESI TENGAH",7,187,43,230
https://kawalpemilu.org#69019,"TINDAKI, PARIGI SELATAN, PARIGI MOUTONG, SULAWESI TENGAH",8,207,32,239
https://kawalpemilu.org#69019,"TINDAKI, PARIGI SELATAN, PARIGI MOUTONG, SULAWESI TENGAH",9,106,132,238
https://kawalpemilu.org#89749,"GANGGA, PARIGI SELATAN, PARIGI MOUTONG, SULAWESI TENGAH",1,169,48,217
https://kawalpemilu.org#89749,"GANGGA, PARIGI SELATAN, PARIGI MOUTONG, SULAWESI TENGAH",2,165,14,2
https://kawalpemilu.org#89749,"GANGGA, PARIGI SELATAN, PARIGI MOUTONG, SULAWESI TENGAH",3,136,15,151
https://kawalpemilu.org#928640,"DOLAGO PADANG, PARIGI SELATAN, PARIGI MOUTONG, SULAWESI TENGAH",1,49,187,236
https://kawalpemilu.org#928640,"DOLAGO PADANG, PARIGI SELATAN, PARIGI MOUTONG, SULAWESI TENGAH",2,82,91,173
https://kawalpemilu.org#928640,"DOLAGO PADANG, PARIGI SELATAN, PARIGI MOUTONG, SULAWESI TENGAH",3,177,65,242
https://kawalpemilu.org#928640,"DOLAGO PADANG, PARIGI SELATAN, PARIGI MOUTONG, SULAWESI TENGAH",4,199,31,230
https://kawalpemilu.org#928640,"DOLAGO PADANG, PARIGI SELATAN, PARIGI MOUTONG, SULAWESI TENGAH",5,58,64,122
https://kawalpemilu.org#928640,"DOLAGO PADANG, PARIGI SELATAN, PARIGI MOUTONG, SULAWESI TENGAH",6,115,26,141
https://kawalpemilu.org#928640,"DOLAGO PADANG, PARIGI SELATAN, PARIGI MOUTONG, SULAWESI TENGAH",7,43,14,57
https://kawalpemilu.org#69021,"KAYU AGUNG, MEPANGA, PARIGI MOUTONG, SULAWESI TENGAH",1,145,94,239
https://kawalpemilu.org#69021,"KAYU AGUNG, MEPANGA, PARIGI MOUTONG, SULAWESI TENGAH",2,128,74,202
https://kawalpemilu.org#69021,"KAYU AGUNG, MEPANGA, PARIGI MOUTONG, SULAWESI TENGAH",3,139,67,206
https://kawalpemilu.org#69021,"KAYU AGUNG, MEPANGA, PARIGI MOUTONG, SULAWESI TENGAH",4,145,77,222
https://kawalpemilu.org#69021,"KAYU AGUNG, MEPANGA, PARIGI MOUTONG, SULAWESI TENGAH",5,119,70,189
https://kawalpemilu.org#69021,"KAYU AGUNG, MEPANGA, PARIGI MOUTONG, SULAWESI TENGAH",6,116,73,189
https://kawalpemilu.org#69021,"KAYU AGUNG, MEPANGA, PARIGI MOUTONG, SULAWESI TENGAH",7,78,77,155
https://kawalpemilu.org#69021,"KAYU AGUNG, MEPANGA, PARIGI MOUTONG, SULAWESI TENGAH",8,131,70,201
https://kawalpemilu.org#69022,"SUMBER AGUNG, MEPANGA, PARIGI MOUTONG, SULAWESI TENGAH",1,89,128,217
https://kawalpemilu.org#69022,"SUMBER AGUNG, MEPANGA, PARIGI MOUTONG, SULAWESI TENGAH",2,65,100,165
https://kawalpemilu.org#69022,"SUMBER AGUNG, MEPANGA, PARIGI MOUTONG, SULAWESI TENGAH",3,112,76,188
https://kawalpemilu.org#69022,"SUMBER AGUNG, MEPANGA, PARIGI MOUTONG, SULAWESI TENGAH",4,91,78,169
https://kawalpemilu.org#69022,"SUMBER AGUNG, MEPANGA, PARIGI MOUTONG, SULAWESI TENGAH",5,93,150,243
https://kawalpemilu.org#69022,"SUMBER AGUNG, MEPANGA, PARIGI MOUTONG, SULAWESI TENGAH",6,91,84,175
https://kawalpemilu.org#69022,"SUMBER AGUNG, MEPANGA, PARIGI MOUTONG, SULAWESI TENGAH",7,103,102,205
https://kawalpemilu.org#69022,"SUMBER AGUNG, MEPANGA, PARIGI MOUTONG, SULAWESI TENGAH",8,117,89,206
https://kawalpemilu.org#69022,"SUMBER AGUNG, MEPANGA, PARIGI MOUTONG, SULAWESI TENGAH",9,91,80,171
https://kawalpemilu.org#69023,"KOTARAYA, MEPANGA, PARIGI MOUTONG, SULAWESI TENGAH",1,96,93,189
https://kawalpemilu.org#69023,"KOTARAYA, MEPANGA, PARIGI MOUTONG, SULAWESI TENGAH",2,86,74,160
https://kawalpemilu.org#69023,"KOTARAYA, MEPANGA, PARIGI MOUTONG, SULAWESI TENGAH",3,95,77,172
https://kawalpemilu.org#69023,"KOTARAYA, MEPANGA, PARIGI MOUTONG, SULAWESI TENGAH",4,95,87,182
https://kawalpemilu.org#69023,"KOTARAYA, MEPANGA, PARIGI MOUTONG, SULAWESI TENGAH",5,124,67,191
https://kawalpemilu.org#69023,"KOTARAYA, MEPANGA, PARIGI MOUTONG, SULAWESI TENGAH",6,83,95,178
https://kawalpemilu.org#69023,"KOTARAYA, MEPANGA, PARIGI MOUTONG, SULAWESI TENGAH",7,78,74,152
https://kawalpemilu.org#69024,"MEPANGA, MEPANGA, PARIGI MOUTONG, SULAWESI TENGAH",1,82,136,218
https://kawalpemilu.org#69024,"MEPANGA, MEPANGA, PARIGI MOUTONG, SULAWESI TENGAH",2,100,91,191
https://kawalpemilu.org#69024,"MEPANGA, MEPANGA, PARIGI MOUTONG, SULAWESI TENGAH",3,124,62,186
https://kawalpemilu.org#69024,"MEPANGA, MEPANGA, PARIGI MOUTONG, SULAWESI TENGAH",4,91,105,196
https://kawalpemilu.org#69025,"OGOTION, MEPANGA, PARIGI MOUTONG, SULAWESI TENGAH",1,130,33,163
https://kawalpemilu.org#69025,"OGOTION, MEPANGA, PARIGI MOUTONG, SULAWESI TENGAH",2,100,77,5
https://kawalpemilu.org#69025,"OGOTION, MEPANGA, PARIGI MOUTONG, SULAWESI TENGAH",3,93,64,157
https://kawalpemilu.org#69025,"OGOTION, MEPANGA, PARIGI MOUTONG, SULAWESI TENGAH",4,119,56,175
https://kawalpemilu.org#69025,"OGOTION, MEPANGA, PARIGI MOUTONG, SULAWESI TENGAH",5,204,15,219
https://kawalpemilu.org#69025,"OGOTION, MEPANGA, PARIGI MOUTONG, SULAWESI TENGAH",6,93,52,145
https://kawalpemilu.org#69026,"MENSUNG, MEPANGA, PARIGI MOUTONG, SULAWESI TENGAH",1,164,2,166
https://kawalpemilu.org#69026,"MENSUNG, MEPANGA, PARIGI MOUTONG, SULAWESI TENGAH",2,168,13,181
https://kawalpemilu.org#69026,"MENSUNG, MEPANGA, PARIGI MOUTONG, SULAWESI TENGAH",3,116,79,195
https://kawalpemilu.org#69026,"MENSUNG, MEPANGA, PARIGI MOUTONG, SULAWESI TENGAH",4,86,86,172
https://kawalpemilu.org#69026,"MENSUNG, MEPANGA, PARIGI MOUTONG, SULAWESI TENGAH",5,109,80,189
https://kawalpemilu.org#69026,"MENSUNG, MEPANGA, PARIGI MOUTONG, SULAWESI TENGAH",6,168,53,221
https://kawalpemilu.org#69027,"BUGIS, MEPANGA, PARIGI MOUTONG, SULAWESI TENGAH",1,116,36,152
https://kawalpemilu.org#69027,"BUGIS, MEPANGA, PARIGI MOUTONG, SULAWESI TENGAH",2,61,90,151
https://kawalpemilu.org#69027,"BUGIS, MEPANGA, PARIGI MOUTONG, SULAWESI TENGAH",3,66,97,163
https://kawalpemilu.org#69027,"BUGIS, MEPANGA, PARIGI MOUTONG, SULAWESI TENGAH",4,56,94,150
https://kawalpemilu.org#69030,"KOTA RAYA TIMUR, MEPANGA, PARIGI MOUTONG, SULAWESI TENGAH",1,181,18,199
https://kawalpemilu.org#69030,"KOTA RAYA TIMUR, MEPANGA, PARIGI MOUTONG, SULAWESI TENGAH",2,201,11,212
https://kawalpemilu.org#69030,"KOTA RAYA TIMUR, MEPANGA, PARIGI MOUTONG, SULAWESI TENGAH",3,159,12,171
https://kawalpemilu.org#69030,"KOTA RAYA TIMUR, MEPANGA, PARIGI MOUTONG, SULAWESI TENGAH",4,173,15,188
https://kawalpemilu.org#69030,"KOTA RAYA TIMUR, MEPANGA, PARIGI MOUTONG, SULAWESI TENGAH",5,156,7,163
https://kawalpemilu.org#85709,"KOTA RAYA SELATAN, MEPANGA, PARIGI MOUTONG, SULAWESI TENGAH",1,101,63,169
https://kawalpemilu.org#85709,"KOTA RAYA SELATAN, MEPANGA, PARIGI MOUTONG, SULAWESI TENGAH",2,140,74,214
https://kawalpemilu.org#85709,"KOTA RAYA SELATAN, MEPANGA, PARIGI MOUTONG, SULAWESI TENGAH",3,138,49,187
https://kawalpemilu.org#85709,"KOTA RAYA SELATAN, MEPANGA, PARIGI MOUTONG, SULAWESI TENGAH",4,91,112,203
https://kawalpemilu.org#85709,"KOTA RAYA SELATAN, MEPANGA, PARIGI MOUTONG, SULAWESI TENGAH",5,125,51,176
https://kawalpemilu.org#85709,"KOTA RAYA SELATAN, MEPANGA, PARIGI MOUTONG, SULAWESI TENGAH",6,114,48,162
https://kawalpemilu.org#85711,"OGOMOLOS, MEPANGA, PARIGI MOUTONG, SULAWESI TENGAH",1,116,61,177
https://kawalpemilu.org#85711,"OGOMOLOS, MEPANGA, PARIGI MOUTONG, SULAWESI TENGAH",2,109,27,136
https://kawalpemilu.org#85711,"OGOMOLOS, MEPANGA, PARIGI MOUTONG, SULAWESI TENGAH",3,109,65,174
https://kawalpemilu.org#85712,"KOTARAYA BARAT, MEPANGA, PARIGI MOUTONG, SULAWESI TENGAH",1,108,93,201
https://kawalpemilu.org#85712,"KOTARAYA BARAT, MEPANGA, PARIGI MOUTONG, SULAWESI TENGAH",2,125,44,169
https://kawalpemilu.org#85712,"KOTARAYA BARAT, MEPANGA, PARIGI MOUTONG, SULAWESI TENGAH",3,119,65,184
https://kawalpemilu.org#85712,"KOTARAYA BARAT, MEPANGA, PARIGI MOUTONG, SULAWESI TENGAH",4,151,58,209
https://kawalpemilu.org#85712,"KOTARAYA BARAT, MEPANGA, PARIGI MOUTONG, SULAWESI TENGAH",5,107,60,167
https://kawalpemilu.org#85712,"KOTARAYA BARAT, MEPANGA, PARIGI MOUTONG, SULAWESI TENGAH",6,117,58,175
https://kawalpemilu.org#928641,"BUGIS UTARA, MEPANGA, PARIGI MOUTONG, SULAWESI TENGAH",1,122,53,175
https://kawalpemilu.org#928641,"BUGIS UTARA, MEPANGA, PARIGI MOUTONG, SULAWESI TENGAH",2,142,41,183
https://kawalpemilu.org#928641,"BUGIS UTARA, MEPANGA, PARIGI MOUTONG, SULAWESI TENGAH",3,91,53,144
https://kawalpemilu.org#928642,"GURINDA, MEPANGA, PARIGI MOUTONG, SULAWESI TENGAH",1,84,65,149
https://kawalpemilu.org#928642,"GURINDA, MEPANGA, PARIGI MOUTONG, SULAWESI TENGAH",2,97,33,130
https://kawalpemilu.org#928642,"GURINDA, MEPANGA, PARIGI MOUTONG, SULAWESI TENGAH",3,126,94,220
https://kawalpemilu.org#928643,"KOTARAYA TENGGARA, MEPANGA, PARIGI MOUTONG, SULAWESI TENGAH",1,172,23,195
https://kawalpemilu.org#69032,"TOMOLI, TORIBULU, PARIGI MOUTONG, SULAWESI TENGAH",1,60,126,186
https://kawalpemilu.org#69032,"TOMOLI, TORIBULU, PARIGI MOUTONG, SULAWESI TENGAH",2,89,100,189
https://kawalpemilu.org#69032,"TOMOLI, TORIBULU, PARIGI MOUTONG, SULAWESI TENGAH",3,83,101,184
https://kawalpemilu.org#69032,"TOMOLI, TORIBULU, PARIGI MOUTONG, SULAWESI TENGAH",4,81,103,184
https://kawalpemilu.org#69032,"TOMOLI, TORIBULU, PARIGI MOUTONG, SULAWESI TENGAH",5,111,125,236
https://kawalpemilu.org#69033,"TORIBULU, TORIBULU, PARIGI MOUTONG, SULAWESI TENGAH",1,72,101,173
https://kawalpemilu.org#69033,"TORIBULU, TORIBULU, PARIGI MOUTONG, SULAWESI TENGAH",2,78,75,153
https://kawalpemilu.org#69033,"TORIBULU, TORIBULU, PARIGI MOUTONG, SULAWESI TENGAH",3,117,63,180
https://kawalpemilu.org#69033,"TORIBULU, TORIBULU, PARIGI MOUTONG, SULAWESI TENGAH",4,89,154,243
https://kawalpemilu.org#69033,"TORIBULU, TORIBULU, PARIGI MOUTONG, SULAWESI TENGAH",5,88,148,236
https://kawalpemilu.org#69033,"TORIBULU, TORIBULU, PARIGI MOUTONG, SULAWESI TENGAH",6,98,60,158
https://kawalpemilu.org#69033,"TORIBULU, TORIBULU, PARIGI MOUTONG, SULAWESI TENGAH",7,115,40,155
https://kawalpemilu.org#69033,"TORIBULU, TORIBULU, PARIGI MOUTONG, SULAWESI TENGAH",8,96,50,146
https://kawalpemilu.org#69034,"SIENJO, TORIBULU, PARIGI MOUTONG, SULAWESI TENGAH",1,69,143,212
https://kawalpemilu.org#69034,"SIENJO, TORIBULU, PARIGI MOUTONG, SULAWESI TENGAH",2,60,133,193
https://kawalpemilu.org#69034,"SIENJO, TORIBULU, PARIGI MOUTONG, SULAWESI TENGAH",3,59,129,188
https://kawalpemilu.org#69034,"SIENJO, TORIBULU, PARIGI MOUTONG, SULAWESI TENGAH",4,91,103,194
https://kawalpemilu.org#69034,"SIENJO, TORIBULU, PARIGI MOUTONG, SULAWESI TENGAH",5,118,97,215
https://kawalpemilu.org#69034,"SIENJO, TORIBULU, PARIGI MOUTONG, SULAWESI TENGAH",6,92,134,226
https://kawalpemilu.org#69035,"PINOTU, TORIBULU, PARIGI MOUTONG, SULAWESI TENGAH",1,81,104,185
https://kawalpemilu.org#69035,"PINOTU, TORIBULU, PARIGI MOUTONG, SULAWESI TENGAH",2,50,149,199
https://kawalpemilu.org#69035,"PINOTU, TORIBULU, PARIGI MOUTONG, SULAWESI TENGAH",4,95,119,214
https://kawalpemilu.org#69035,"PINOTU, TORIBULU, PARIGI MOUTONG, SULAWESI TENGAH",5,121,79,200
https://kawalpemilu.org#69035,"PINOTU, TORIBULU, PARIGI MOUTONG, SULAWESI TENGAH",6,64,127,191
https://kawalpemilu.org#69036,"SINGURA, TORIBULU, PARIGI MOUTONG, SULAWESI TENGAH",1,86,92,178
https://kawalpemilu.org#69036,"SINGURA, TORIBULU, PARIGI MOUTONG, SULAWESI TENGAH",2,183,25,208
https://kawalpemilu.org#69036,"SINGURA, TORIBULU, PARIGI MOUTONG, SULAWESI TENGAH",3,127,59,0
https://kawalpemilu.org#69036,"SINGURA, TORIBULU, PARIGI MOUTONG, SULAWESI TENGAH",4,108,82,190
https://kawalpemilu.org#69036,"SINGURA, TORIBULU, PARIGI MOUTONG, SULAWESI TENGAH",5,120,76,196
https://kawalpemilu.org#69036,"SINGURA, TORIBULU, PARIGI MOUTONG, SULAWESI TENGAH",6,100,105,205
https://kawalpemilu.org#69037,"TOMOLI SELATAN, TORIBULU, PARIGI MOUTONG, SULAWESI TENGAH",1,58,137,195
https://kawalpemilu.org#69037,"TOMOLI SELATAN, TORIBULU, PARIGI MOUTONG, SULAWESI TENGAH",2,54,111,165
https://kawalpemilu.org#69037,"TOMOLI SELATAN, TORIBULU, PARIGI MOUTONG, SULAWESI TENGAH",3,21,101,122
https://kawalpemilu.org#69037,"TOMOLI SELATAN, TORIBULU, PARIGI MOUTONG, SULAWESI TENGAH",4,57,88,145
https://kawalpemilu.org#69037,"TOMOLI SELATAN, TORIBULU, PARIGI MOUTONG, SULAWESI TENGAH",5,69,108,177
https://kawalpemilu.org#69037,"TOMOLI SELATAN, TORIBULU, PARIGI MOUTONG, SULAWESI TENGAH",6,88,9,97
https://kawalpemilu.org#69038,"SIBALAGO, TORIBULU, PARIGI MOUTONG, SULAWESI TENGAH",1,141,45,186
https://kawalpemilu.org#69038,"SIBALAGO, TORIBULU, PARIGI MOUTONG, SULAWESI TENGAH",2,150,11,161
https://kawalpemilu.org#69038,"SIBALAGO, TORIBULU, PARIGI MOUTONG, SULAWESI TENGAH",3,91,51,142
https://kawalpemilu.org#69038,"SIBALAGO, TORIBULU, PARIGI MOUTONG, SULAWESI TENGAH",4,131,14,145
https://kawalpemilu.org#89750,"TORIBULU SELATAN, TORIBULU, PARIGI MOUTONG, SULAWESI TENGAH",1,74,120,194
https://kawalpemilu.org#89750,"TORIBULU SELATAN, TORIBULU, PARIGI MOUTONG, SULAWESI TENGAH",2,60,115,175
https://kawalpemilu.org#89750,"TORIBULU SELATAN, TORIBULU, PARIGI MOUTONG, SULAWESI TENGAH",3,75,82,157
https://kawalpemilu.org#89750,"TORIBULU SELATAN, TORIBULU, PARIGI MOUTONG, SULAWESI TENGAH",4,101,84,185
https://kawalpemilu.org#89751,"TOMOLI UTARA, TORIBULU, PARIGI MOUTONG, SULAWESI TENGAH",1,108,88,196
https://kawalpemilu.org#89751,"TOMOLI UTARA, TORIBULU, PARIGI MOUTONG, SULAWESI TENGAH",2,80,119,199
https://kawalpemilu.org#89751,"TOMOLI UTARA, TORIBULU, PARIGI MOUTONG, SULAWESI TENGAH",3,80,85,165
https://kawalpemilu.org#69040,"KARYA AGUNG, TAOPA, PARIGI MOUTONG, SULAWESI TENGAH",1,90,28,118
https://kawalpemilu.org#69040,"KARYA AGUNG, TAOPA, PARIGI MOUTONG, SULAWESI TENGAH",2,92,26,118
https://kawalpemilu.org#69040,"KARYA AGUNG, TAOPA, PARIGI MOUTONG, SULAWESI TENGAH",3,114,21,135
https://kawalpemilu.org#69040,"KARYA AGUNG, TAOPA, PARIGI MOUTONG, SULAWESI TENGAH",4,117,25,142
https://kawalpemilu.org#69040,"KARYA AGUNG, TAOPA, PARIGI MOUTONG, SULAWESI TENGAH",5,112,28,140
https://kawalpemilu.org#69041,"NUNURANTAI, TAOPA, PARIGI MOUTONG, SULAWESI TENGAH",1,135,61,196
https://kawalpemilu.org#69041,"NUNURANTAI, TAOPA, PARIGI MOUTONG, SULAWESI TENGAH",2,113,52,165
https://kawalpemilu.org#69041,"NUNURANTAI, TAOPA, PARIGI MOUTONG, SULAWESI TENGAH",3,160,54,214
https://kawalpemilu.org#69041,"NUNURANTAI, TAOPA, PARIGI MOUTONG, SULAWESI TENGAH",4,128,49,177
https://kawalpemilu.org#69042,"PALAPI, TAOPA, PARIGI MOUTONG, SULAWESI TENGAH",1,66,109,175
https://kawalpemilu.org#69042,"PALAPI, TAOPA, PARIGI MOUTONG, SULAWESI TENGAH",2,94,87,180
https://kawalpemilu.org#69042,"PALAPI, TAOPA, PARIGI MOUTONG, SULAWESI TENGAH",3,104,99,203
https://kawalpemilu.org#69042,"PALAPI, TAOPA, PARIGI MOUTONG, SULAWESI TENGAH",4,98,31,129
https://kawalpemilu.org#69042,"PALAPI, TAOPA, PARIGI MOUTONG, SULAWESI TENGAH",5,107,64,171
https://kawalpemilu.org#69042,"PALAPI, TAOPA, PARIGI MOUTONG, SULAWESI TENGAH",6,24,13,37
https://kawalpemilu.org#69043,"TAOPA, TAOPA, PARIGI MOUTONG, SULAWESI TENGAH",1,154,29,183
https://kawalpemilu.org#69043,"TAOPA, TAOPA, PARIGI MOUTONG, SULAWESI TENGAH",2,111,63,174
https://kawalpemilu.org#69043,"TAOPA, TAOPA, PARIGI MOUTONG, SULAWESI TENGAH",3,101,63,164
https://kawalpemilu.org#69043,"TAOPA, TAOPA, PARIGI MOUTONG, SULAWESI TENGAH",4,157,34,191
https://kawalpemilu.org#69043,"TAOPA, TAOPA, PARIGI MOUTONG, SULAWESI TENGAH",5,121,55,176
https://kawalpemilu.org#69043,"TAOPA, TAOPA, PARIGI MOUTONG, SULAWESI TENGAH",6,83,61,144
https://kawalpemilu.org#69043,"TAOPA, TAOPA, PARIGI MOUTONG, SULAWESI TENGAH",7,64,94,158
https://kawalpemilu.org#69043,"TAOPA, TAOPA, PARIGI MOUTONG, SULAWESI TENGAH",8,84,80,164
https://kawalpemilu.org#69044,"TULADENGGI SIBATANG, TAOPA, PARIGI MOUTONG, SULAWESI TENGAH",1,96,91,187
https://kawalpemilu.org#69044,"TULADENGGI SIBATANG, TAOPA, PARIGI MOUTONG, SULAWESI TENGAH",2,65,112,177
https://kawalpemilu.org#69044,"TULADENGGI SIBATANG, TAOPA, PARIGI MOUTONG, SULAWESI TENGAH",3,80,99,179
https://kawalpemilu.org#69045,"TOMPO, TAOPA, PARIGI MOUTONG, SULAWESI TENGAH",1,100,71,171
https://kawalpemilu.org#69045,"TOMPO, TAOPA, PARIGI MOUTONG, SULAWESI TENGAH",2,85,78,163
https://kawalpemilu.org#69045,"TOMPO, TAOPA, PARIGI MOUTONG, SULAWESI TENGAH",3,86,89,175
https://kawalpemilu.org#69045,"TOMPO, TAOPA, PARIGI MOUTONG, SULAWESI TENGAH",4,94,96,190
https://kawalpemilu.org#69045,"TOMPO, TAOPA, PARIGI MOUTONG, SULAWESI TENGAH",5,70,106,176
https://kawalpemilu.org#69045,"TOMPO, TAOPA, PARIGI MOUTONG, SULAWESI TENGAH",6,86,95,181
https://kawalpemilu.org#69046,"TAOPA UTARA, TAOPA, PARIGI MOUTONG, SULAWESI TENGAH",1,93,43,136
https://kawalpemilu.org#69046,"TAOPA UTARA, TAOPA, PARIGI MOUTONG, SULAWESI TENGAH",2,121,31,152
https://kawalpemilu.org#69046,"TAOPA UTARA, TAOPA, PARIGI MOUTONG, SULAWESI TENGAH",3,90,20,110
https://kawalpemilu.org#69046,"TAOPA UTARA, TAOPA, PARIGI MOUTONG, SULAWESI TENGAH",4,114,34,148
https://kawalpemilu.org#89752,"BILALEA, TAOPA, PARIGI MOUTONG, SULAWESI TENGAH",1,86,74,160
https://kawalpemilu.org#89752,"BILALEA, TAOPA, PARIGI MOUTONG, SULAWESI TENGAH",2,102,74,176
https://kawalpemilu.org#89752,"BILALEA, TAOPA, PARIGI MOUTONG, SULAWESI TENGAH",3,102,63,165
https://kawalpemilu.org#89753,"TAOPA BARAT, TAOPA, PARIGI MOUTONG, SULAWESI TENGAH",1,80,53,133
https://kawalpemilu.org#89753,"TAOPA BARAT, TAOPA, PARIGI MOUTONG, SULAWESI TENGAH",2,80,55,135
https://kawalpemilu.org#89753,"TAOPA BARAT, TAOPA, PARIGI MOUTONG, SULAWESI TENGAH",3,56,68,124
https://kawalpemilu.org#89754,"PARIA, TAOPA, PARIGI MOUTONG, SULAWESI TENGAH",1,95,41,136
https://kawalpemilu.org#89754,"PARIA, TAOPA, PARIGI MOUTONG, SULAWESI TENGAH",2,109,49,158
https://kawalpemilu.org#89754,"PARIA, TAOPA, PARIGI MOUTONG, SULAWESI TENGAH",3,118,31,149
https://kawalpemilu.org#89755,"KARYA ABADI, TAOPA, PARIGI MOUTONG, SULAWESI TENGAH",1,111,32,143
https://kawalpemilu.org#89755,"KARYA ABADI, TAOPA, PARIGI MOUTONG, SULAWESI TENGAH",2,84,25,109
https://kawalpemilu.org#89755,"KARYA ABADI, TAOPA, PARIGI MOUTONG, SULAWESI TENGAH",3,117,24,141
https://kawalpemilu.org#69048,"MALAKOSA, BALINGGI, PARIGI MOUTONG, SULAWESI TENGAH",1,141,27,168
https://kawalpemilu.org#69048,"MALAKOSA, BALINGGI, PARIGI MOUTONG, SULAWESI TENGAH",2,122,99,221
https://kawalpemilu.org#69048,"MALAKOSA, BALINGGI, PARIGI MOUTONG, SULAWESI TENGAH",3,124,82,206
https://kawalpemilu.org#69048,"MALAKOSA, BALINGGI, PARIGI MOUTONG, SULAWESI TENGAH",4,155,13,168
https://kawalpemilu.org#69048,"MALAKOSA, BALINGGI, PARIGI MOUTONG, SULAWESI TENGAH",5,178,11,189
https://kawalpemilu.org#69048,"MALAKOSA, BALINGGI, PARIGI MOUTONG, SULAWESI TENGAH",6,173,23,196
https://kawalpemilu.org#69048,"MALAKOSA, BALINGGI, PARIGI MOUTONG, SULAWESI TENGAH",7,88,69,157
https://kawalpemilu.org#69049,"BALINGGI JATI, BALINGGI, PARIGI MOUTONG, SULAWESI TENGAH",1,190,13,203
https://kawalpemilu.org#69049,"BALINGGI JATI, BALINGGI, PARIGI MOUTONG, SULAWESI TENGAH",2,198,18,216
https://kawalpemilu.org#69049,"BALINGGI JATI, BALINGGI, PARIGI MOUTONG, SULAWESI TENGAH",3,185,9,194
https://kawalpemilu.org#69049,"BALINGGI JATI, BALINGGI, PARIGI MOUTONG, SULAWESI TENGAH",4,163,34,197
https://kawalpemilu.org#69049,"BALINGGI JATI, BALINGGI, PARIGI MOUTONG, SULAWESI TENGAH",5,241,22,263
https://kawalpemilu.org#69049,"BALINGGI JATI, BALINGGI, PARIGI MOUTONG, SULAWESI TENGAH",6,223,19,242
https://kawalpemilu.org#69049,"BALINGGI JATI, BALINGGI, PARIGI MOUTONG, SULAWESI TENGAH",7,257,19,276
https://kawalpemilu.org#69049,"BALINGGI JATI, BALINGGI, PARIGI MOUTONG, SULAWESI TENGAH",8,212,31,243
https://kawalpemilu.org#69049,"BALINGGI JATI, BALINGGI, PARIGI MOUTONG, SULAWESI TENGAH",9,213,19,232
https://kawalpemilu.org#69049,"BALINGGI JATI, BALINGGI, PARIGI MOUTONG, SULAWESI TENGAH",10,223,19,242
https://kawalpemilu.org#69050,"BALINGGI, BALINGGI, PARIGI MOUTONG, SULAWESI TENGAH",1,207,37,244
https://kawalpemilu.org#69050,"BALINGGI, BALINGGI, PARIGI MOUTONG, SULAWESI TENGAH",2,211,14,225
https://kawalpemilu.org#69050,"BALINGGI, BALINGGI, PARIGI MOUTONG, SULAWESI TENGAH",3,215,9,224
https://kawalpemilu.org#69050,"BALINGGI, BALINGGI, PARIGI MOUTONG, SULAWESI TENGAH",4,209,13,222
https://kawalpemilu.org#69050,"BALINGGI, BALINGGI, PARIGI MOUTONG, SULAWESI TENGAH",5,199,6,205
https://kawalpemilu.org#69050,"BALINGGI, BALINGGI, PARIGI MOUTONG, SULAWESI TENGAH",6,230,19,249
https://kawalpemilu.org#69051,"SULI, BALINGGI, PARIGI MOUTONG, SULAWESI TENGAH",1,161,4,165
https://kawalpemilu.org#69051,"SULI, BALINGGI, PARIGI MOUTONG, SULAWESI TENGAH",2,182,7,189
https://kawalpemilu.org#69051,"SULI, BALINGGI, PARIGI MOUTONG, SULAWESI TENGAH",3,204,16,220
https://kawalpemilu.org#69051,"SULI, BALINGGI, PARIGI MOUTONG, SULAWESI TENGAH",4,169,15,184
https://kawalpemilu.org#69051,"SULI, BALINGGI, PARIGI MOUTONG, SULAWESI TENGAH",5,110,14,124
https://kawalpemilu.org#69051,"SULI, BALINGGI, PARIGI MOUTONG, SULAWESI TENGAH",6,219,14,233
https://kawalpemilu.org#69051,"SULI, BALINGGI, PARIGI MOUTONG, SULAWESI TENGAH",7,203,6,209
https://kawalpemilu.org#69052,"SULI INDAH, BALINGGI, PARIGI MOUTONG, SULAWESI TENGAH",1,196,25,221
https://kawalpemilu.org#69052,"SULI INDAH, BALINGGI, PARIGI MOUTONG, SULAWESI TENGAH",2,164,17,181
https://kawalpemilu.org#69052,"SULI INDAH, BALINGGI, PARIGI MOUTONG, SULAWESI TENGAH",3,200,23,223
https://kawalpemilu.org#69052,"SULI INDAH, BALINGGI, PARIGI MOUTONG, SULAWESI TENGAH",4,170,19,189
https://kawalpemilu.org#69052,"SULI INDAH, BALINGGI, PARIGI MOUTONG, SULAWESI TENGAH",5,156,18,174
https://kawalpemilu.org#69052,"SULI INDAH, BALINGGI, PARIGI MOUTONG, SULAWESI TENGAH",6,164,20,184
https://kawalpemilu.org#69052,"SULI INDAH, BALINGGI, PARIGI MOUTONG, SULAWESI TENGAH",7,199,22,221
https://kawalpemilu.org#69052,"SULI INDAH, BALINGGI, PARIGI MOUTONG, SULAWESI TENGAH",8,59,16,75
https://kawalpemilu.org#69053,"BERABAN, BALINGGI, PARIGI MOUTONG, SULAWESI TENGAH",1,220,19,239
https://kawalpemilu.org#69053,"BERABAN, BALINGGI, PARIGI MOUTONG, SULAWESI TENGAH",2,228,12,240
https://kawalpemilu.org#69053,"BERABAN, BALINGGI, PARIGI MOUTONG, SULAWESI TENGAH",3,247,1,248
https://kawalpemilu.org#85713,"LEBAGU, BALINGGI, PARIGI MOUTONG, SULAWESI TENGAH",1,188,7,195
https://kawalpemilu.org#85713,"LEBAGU, BALINGGI, PARIGI MOUTONG, SULAWESI TENGAH",2,191,8,199
https://kawalpemilu.org#85713,"LEBAGU, BALINGGI, PARIGI MOUTONG, SULAWESI TENGAH",3,200,11,211
https://kawalpemilu.org#85713,"LEBAGU, BALINGGI, PARIGI MOUTONG, SULAWESI TENGAH",4,151,4,155
https://kawalpemilu.org#85713,"LEBAGU, BALINGGI, PARIGI MOUTONG, SULAWESI TENGAH",5,156,21,177
https://kawalpemilu.org#85714,"TUMPAPA INDAH, BALINGGI, PARIGI MOUTONG, SULAWESI TENGAH",1,117,33,150
https://kawalpemilu.org#85714,"TUMPAPA INDAH, BALINGGI, PARIGI MOUTONG, SULAWESI TENGAH",2,97,57,154
https://kawalpemilu.org#928644,"CATUR KARYA, BALINGGI, PARIGI MOUTONG, SULAWESI TENGAH",1,216,16,232
https://kawalpemilu.org#928644,"CATUR KARYA, BALINGGI, PARIGI MOUTONG, SULAWESI TENGAH",2,120,29,149
https://kawalpemilu.org#928644,"CATUR KARYA, BALINGGI, PARIGI MOUTONG, SULAWESI TENGAH",3,143,75,218
https://kawalpemilu.org#928644,"CATUR KARYA, BALINGGI, PARIGI MOUTONG, SULAWESI TENGAH",4,186,29,215
https://kawalpemilu.org#69055,"PARIGIMPU'U, PARIGI BARAT, PARIGI MOUTONG, SULAWESI TENGAH",1,73,157,230
https://kawalpemilu.org#69055,"PARIGIMPU'U, PARIGI BARAT, PARIGI MOUTONG, SULAWESI TENGAH",2,90,101,191
https://kawalpemilu.org#69055,"PARIGIMPU'U, PARIGI BARAT, PARIGI MOUTONG, SULAWESI TENGAH",3,99,133,232
https://kawalpemilu.org#69055,"PARIGIMPU'U, PARIGI BARAT, PARIGI MOUTONG, SULAWESI TENGAH",4,111,87,198
https://kawalpemilu.org#69056,"BALIARA, PARIGI BARAT, PARIGI MOUTONG, SULAWESI TENGAH",1,108,139,247
https://kawalpemilu.org#69056,"BALIARA, PARIGI BARAT, PARIGI MOUTONG, SULAWESI TENGAH",2,117,159,276
https://kawalpemilu.org#69056,"BALIARA, PARIGI BARAT, PARIGI MOUTONG, SULAWESI TENGAH",3,66,183,249
https://kawalpemilu.org#69056,"BALIARA, PARIGI BARAT, PARIGI MOUTONG, SULAWESI TENGAH",4,96,137,233
https://kawalpemilu.org#69057,"KAYUBOKO, PARIGI BARAT, PARIGI MOUTONG, SULAWESI TENGAH",1,65,109,174
https://kawalpemilu.org#69057,"KAYUBOKO, PARIGI BARAT, PARIGI MOUTONG, SULAWESI TENGAH",2,79,101,180
https://kawalpemilu.org#69057,"KAYUBOKO, PARIGI BARAT, PARIGI MOUTONG, SULAWESI TENGAH",3,89,106,195
https://kawalpemilu.org#69057,"KAYUBOKO, PARIGI BARAT, PARIGI MOUTONG, SULAWESI TENGAH",4,58,130,188
https://kawalpemilu.org#69057,"KAYUBOKO, PARIGI BARAT, PARIGI MOUTONG, SULAWESI TENGAH",5,87,107,194
https://kawalpemilu.org#69058,"JONO KALORA, PARIGI BARAT, PARIGI MOUTONG, SULAWESI TENGAH",1,131,110,241
https://kawalpemilu.org#69058,"JONO KALORA, PARIGI BARAT, PARIGI MOUTONG, SULAWESI TENGAH",2,104,136,240
https://kawalpemilu.org#69058,"JONO KALORA, PARIGI BARAT, PARIGI MOUTONG, SULAWESI TENGAH",3,96,145,241
https://kawalpemilu.org#69059,"AIR PANAS, PARIGI BARAT, PARIGI MOUTONG, SULAWESI TENGAH",1,109,88,197
https://kawalpemilu.org#69059,"AIR PANAS, PARIGI BARAT, PARIGI MOUTONG, SULAWESI TENGAH",2,93,113,206
https://kawalpemilu.org#69059,"AIR PANAS, PARIGI BARAT, PARIGI MOUTONG, SULAWESI TENGAH",3,36,94,130
https://kawalpemilu.org#89756,"LOBU MANDIRI, PARIGI BARAT, PARIGI MOUTONG, SULAWESI TENGAH",1,102,61,163
https://kawalpemilu.org#89756,"LOBU MANDIRI, PARIGI BARAT, PARIGI MOUTONG, SULAWESI TENGAH",2,102,57,159
https://kawalpemilu.org#89756,"LOBU MANDIRI, PARIGI BARAT, PARIGI MOUTONG, SULAWESI TENGAH",3,140,43,183
https://kawalpemilu.org#69061,"MARANTALE, SINIU, PARIGI MOUTONG, SULAWESI TENGAH",1,72,154,226
https://kawalpemilu.org#69061,"MARANTALE, SINIU, PARIGI MOUTONG, SULAWESI TENGAH",2,59,159,218
https://kawalpemilu.org#69061,"MARANTALE, SINIU, PARIGI MOUTONG, SULAWESI TENGAH",3,101,134,235
https://kawalpemilu.org#69062,"TANDAIGI, SINIU, PARIGI MOUTONG, SULAWESI TENGAH",1,57,146,203
https://kawalpemilu.org#69062,"TANDAIGI, SINIU, PARIGI MOUTONG, SULAWESI TENGAH",2,76,126,202
https://kawalpemilu.org#69062,"TANDAIGI, SINIU, PARIGI MOUTONG, SULAWESI TENGAH",3,90,100,190
https://kawalpemilu.org#69063,"SILANGA, SINIU, PARIGI MOUTONG, SULAWESI TENGAH",1,100,88,188
https://kawalpemilu.org#69063,"SILANGA, SINIU, PARIGI MOUTONG, SULAWESI TENGAH",2,95,86,181
https://kawalpemilu.org#69063,"SILANGA, SINIU, PARIGI MOUTONG, SULAWESI TENGAH",3,81,95,176
https://kawalpemilu.org#69063,"SILANGA, SINIU, PARIGI MOUTONG, SULAWESI TENGAH",4,73,101,174
https://kawalpemilu.org#69064,"SINIU, SINIU, PARIGI MOUTONG, SULAWESI TENGAH",1,55,190,245
https://kawalpemilu.org#69064,"SINIU, SINIU, PARIGI MOUTONG, SULAWESI TENGAH",2,95,86,181
https://kawalpemilu.org#69064,"SINIU, SINIU, PARIGI MOUTONG, SULAWESI TENGAH",3,81,95,176
https://kawalpemilu.org#69064,"SINIU, SINIU, PARIGI MOUTONG, SULAWESI TENGAH",4,73,101,174
https://kawalpemilu.org#69065,"TOWERA, SINIU, PARIGI MOUTONG, SULAWESI TENGAH",1,70,97,167
https://kawalpemilu.org#69065,"TOWERA, SINIU, PARIGI MOUTONG, SULAWESI TENGAH",2,70,141,211
https://kawalpemilu.org#69065,"TOWERA, SINIU, PARIGI MOUTONG, SULAWESI TENGAH",3,81,79,160
https://kawalpemilu.org#69065,"TOWERA, SINIU, PARIGI MOUTONG, SULAWESI TENGAH",4,100,89,189
https://kawalpemilu.org#69065,"TOWERA, SINIU, PARIGI MOUTONG, SULAWESI TENGAH",5,86,81,167
https://kawalpemilu.org#69065,"TOWERA, SINIU, PARIGI MOUTONG, SULAWESI TENGAH",6,117,57,174
https://kawalpemilu.org#69066,"TORARANGA, SINIU, PARIGI MOUTONG, SULAWESI TENGAH",1,80,99,179
https://kawalpemilu.org#69066,"TORARANGA, SINIU, PARIGI MOUTONG, SULAWESI TENGAH",2,106,56,162
https://kawalpemilu.org#69066,"TORARANGA, SINIU, PARIGI MOUTONG, SULAWESI TENGAH",3,103,48,151
https://kawalpemilu.org#85715,"UEVOLO, SINIU, PARIGI MOUTONG, SULAWESI TENGAH",1,96,58,154
https://kawalpemilu.org#85715,"UEVOLO, SINIU, PARIGI MOUTONG, SULAWESI TENGAH",2,83,94,177
https://kawalpemilu.org#85715,"UEVOLO, SINIU, PARIGI MOUTONG, SULAWESI TENGAH",3,83,85,168
https://kawalpemilu.org#89757,"SINIU SAYOGINDANO, SINIU, PARIGI MOUTONG, SULAWESI TENGAH",1,102,85,187
https://kawalpemilu.org#89757,"SINIU SAYOGINDANO, SINIU, PARIGI MOUTONG, SULAWESI TENGAH",2,126,57,183
https://kawalpemilu.org#928645,"SILANGA BARAT, SINIU, PARIGI MOUTONG, SULAWESI TENGAH",1,59,131,190
https://kawalpemilu.org#928645,"SILANGA BARAT, SINIU, PARIGI MOUTONG, SULAWESI TENGAH",2,45,157,201
https://kawalpemilu.org#69068,"BOBALO, PALASA, PARIGI MOUTONG, SULAWESI TENGAH",1,101,69,170
https://kawalpemilu.org#69068,"BOBALO, PALASA, PARIGI MOUTONG, SULAWESI TENGAH",2,112,74,186
https://kawalpemilu.org#69068,"BOBALO, PALASA, PARIGI MOUTONG, SULAWESI TENGAH",3,108,52,160
https://kawalpemilu.org#69068,"BOBALO, PALASA, PARIGI MOUTONG, SULAWESI TENGAH",4,88,78,166
https://kawalpemilu.org#69068,"BOBALO, PALASA, PARIGI MOUTONG, SULAWESI TENGAH",5,56,65,121
https://kawalpemilu.org#69068,"BOBALO, PALASA, PARIGI MOUTONG, SULAWESI TENGAH",6,24,55,79
https://kawalpemilu.org#69068,"BOBALO, PALASA, PARIGI MOUTONG, SULAWESI TENGAH",7,29,95,124
https://kawalpemilu.org#69068,"BOBALO, PALASA, PARIGI MOUTONG, SULAWESI TENGAH",8,90,88,178
https://kawalpemilu.org#69069,"DONGKALAN, PALASA, PARIGI MOUTONG, SULAWESI TENGAH",1,92,74,166
https://kawalpemilu.org#69069,"DONGKALAN, PALASA, PARIGI MOUTONG, SULAWESI TENGAH",2,112,60,172
https://kawalpemilu.org#69069,"DONGKALAN, PALASA, PARIGI MOUTONG, SULAWESI TENGAH",3,122,27,149
https://kawalpemilu.org#69069,"DONGKALAN, PALASA, PARIGI MOUTONG, SULAWESI TENGAH",4,79,24,103
https://kawalpemilu.org#69069,"DONGKALAN, PALASA, PARIGI MOUTONG, SULAWESI TENGAH",5,104,90,194
https://kawalpemilu.org#69069,"DONGKALAN, PALASA, PARIGI MOUTONG, SULAWESI TENGAH",6,81,61,142
https://kawalpemilu.org#69070,"EEYA, PALASA, PARIGI MOUTONG, SULAWESI TENGAH",1,96,94,190
https://kawalpemilu.org#69070,"EEYA, PALASA, PARIGI MOUTONG, SULAWESI TENGAH",2,73,57,130
https://kawalpemilu.org#69070,"EEYA, PALASA, PARIGI MOUTONG, SULAWESI TENGAH",3,100,106,1
https://kawalpemilu.org#69070,"EEYA, PALASA, PARIGI MOUTONG, SULAWESI TENGAH",4,90,124,214
https://kawalpemilu.org#69070,"EEYA, PALASA, PARIGI MOUTONG, SULAWESI TENGAH",5,62,102,164
https://kawalpemilu.org#69070,"EEYA, PALASA, PARIGI MOUTONG, SULAWESI TENGAH",6,33,68,101
https://kawalpemilu.org#69070,"EEYA, PALASA, PARIGI MOUTONG, SULAWESI TENGAH",7,61,109,170
https://kawalpemilu.org#69070,"EEYA, PALASA, PARIGI MOUTONG, SULAWESI TENGAH",8,75,102,177
https://kawalpemilu.org#69070,"EEYA, PALASA, PARIGI MOUTONG, SULAWESI TENGAH",9,131,13,144
https://kawalpemilu.org#69071,"ULATAN, PALASA, PARIGI MOUTONG, SULAWESI TENGAH",1,64,87,151
https://kawalpemilu.org#69071,"ULATAN, PALASA, PARIGI MOUTONG, SULAWESI TENGAH",2,91,111,202
https://kawalpemilu.org#69071,"ULATAN, PALASA, PARIGI MOUTONG, SULAWESI TENGAH",3,115,82,197
https://kawalpemilu.org#69071,"ULATAN, PALASA, PARIGI MOUTONG, SULAWESI TENGAH",4,65,86,151
https://kawalpemilu.org#69071,"ULATAN, PALASA, PARIGI MOUTONG, SULAWESI TENGAH",5,69,119,188
https://kawalpemilu.org#69071,"ULATAN, PALASA, PARIGI MOUTONG, SULAWESI TENGAH",6,29,116,145
https://kawalpemilu.org#69071,"ULATAN, PALASA, PARIGI MOUTONG, SULAWESI TENGAH",7,39,124,163
https://kawalpemilu.org#69071,"ULATAN, PALASA, PARIGI MOUTONG, SULAWESI TENGAH",8,27,131,158
https://kawalpemilu.org#69071,"ULATAN, PALASA, PARIGI MOUTONG, SULAWESI TENGAH",9,30,173,203
https://kawalpemilu.org#69071,"ULATAN, PALASA, PARIGI MOUTONG, SULAWESI TENGAH",11,99,62,161
https://kawalpemilu.org#69071,"ULATAN, PALASA, PARIGI MOUTONG, SULAWESI TENGAH",12,45,29,74
https://kawalpemilu.org#69071,"ULATAN, PALASA, PARIGI MOUTONG, SULAWESI TENGAH",13,127,20,147
https://kawalpemilu.org#69071,"ULATAN, PALASA, PARIGI MOUTONG, SULAWESI TENGAH",14,201,16,217
https://kawalpemilu.org#69071,"ULATAN, PALASA, PARIGI MOUTONG, SULAWESI TENGAH",15,128,2,130
https://kawalpemilu.org#69071,"ULATAN, PALASA, PARIGI MOUTONG, SULAWESI TENGAH",16,90,2,92
https://kawalpemilu.org#69072,"PALASA TANGKI, PALASA, PARIGI MOUTONG, SULAWESI TENGAH",1,77,113,190
https://kawalpemilu.org#69072,"PALASA TANGKI, PALASA, PARIGI MOUTONG, SULAWESI TENGAH",2,85,109,194
https://kawalpemilu.org#69072,"PALASA TANGKI, PALASA, PARIGI MOUTONG, SULAWESI TENGAH",3,65,84,149
https://kawalpemilu.org#69072,"PALASA TANGKI, PALASA, PARIGI MOUTONG, SULAWESI TENGAH",4,122,47,169
https://kawalpemilu.org#69073,"PALASA, PALASA, PARIGI MOUTONG, SULAWESI TENGAH",1,145,73,218
https://kawalpemilu.org#69073,"PALASA, PALASA, PARIGI MOUTONG, SULAWESI TENGAH",2,136,63,199
https://kawalpemilu.org#69073,"PALASA, PALASA, PARIGI MOUTONG, SULAWESI TENGAH",3,93,149,242
https://kawalpemilu.org#69073,"PALASA, PALASA, PARIGI MOUTONG, SULAWESI TENGAH",4,85,107,192
https://kawalpemilu.org#69073,"PALASA, PALASA, PARIGI MOUTONG, SULAWESI TENGAH",5,155,102,257
https://kawalpemilu.org#69073,"PALASA, PALASA, PARIGI MOUTONG, SULAWESI TENGAH",6,127,122,249
https://kawalpemilu.org#69073,"PALASA, PALASA, PARIGI MOUTONG, SULAWESI TENGAH",7,143,112,255
https://kawalpemilu.org#69073,"PALASA, PALASA, PARIGI MOUTONG, SULAWESI TENGAH",8,137,131,268
https://kawalpemilu.org#69074,"PALASA LAMBORI, PALASA, PARIGI MOUTONG, SULAWESI TENGAH",1,143,68,211
https://kawalpemilu.org#69074,"PALASA LAMBORI, PALASA, PARIGI MOUTONG, SULAWESI TENGAH",2,149,72,221
https://kawalpemilu.org#69074,"PALASA LAMBORI, PALASA, PARIGI MOUTONG, SULAWESI TENGAH",3,110,53,163
https://kawalpemilu.org#69074,"PALASA LAMBORI, PALASA, PARIGI MOUTONG, SULAWESI TENGAH",4,67,97,164
https://kawalpemilu.org#69074,"PALASA LAMBORI, PALASA, PARIGI MOUTONG, SULAWESI TENGAH",5,89,63,152
https://kawalpemilu.org#69074,"PALASA LAMBORI, PALASA, PARIGI MOUTONG, SULAWESI TENGAH",6,108,57,165
https://kawalpemilu.org#69074,"PALASA LAMBORI, PALASA, PARIGI MOUTONG, SULAWESI TENGAH",7,124,50,174
https://kawalpemilu.org#69074,"PALASA LAMBORI, PALASA, PARIGI MOUTONG, SULAWESI TENGAH",8,139,67,206
https://kawalpemilu.org#69074,"PALASA LAMBORI, PALASA, PARIGI MOUTONG, SULAWESI TENGAH",9,128,33,161
https://kawalpemilu.org#69074,"PALASA LAMBORI, PALASA, PARIGI MOUTONG, SULAWESI TENGAH",10,62,29,91
https://kawalpemilu.org#69075,"PEBOUNANG, PALASA, PARIGI MOUTONG, SULAWESI TENGAH",1,65,60,125
https://kawalpemilu.org#69075,"PEBOUNANG, PALASA, PARIGI MOUTONG, SULAWESI TENGAH",2,58,36,94
https://kawalpemilu.org#69075,"PEBOUNANG, PALASA, PARIGI MOUTONG, SULAWESI TENGAH",3,72,57,129
https://kawalpemilu.org#69075,"PEBOUNANG, PALASA, PARIGI MOUTONG, SULAWESI TENGAH",4,34,32,66
https://kawalpemilu.org#69075,"PEBOUNANG, PALASA, PARIGI MOUTONG, SULAWESI TENGAH",5,66,35,101
https://kawalpemilu.org#69075,"PEBOUNANG, PALASA, PARIGI MOUTONG, SULAWESI TENGAH",6,95,51,146
https://kawalpemilu.org#69075,"PEBOUNANG, PALASA, PARIGI MOUTONG, SULAWESI TENGAH",7,106,120,226
https://kawalpemilu.org#69075,"PEBOUNANG, PALASA, PARIGI MOUTONG, SULAWESI TENGAH",8,83,36,119
https://kawalpemilu.org#69075,"PEBOUNANG, PALASA, PARIGI MOUTONG, SULAWESI TENGAH",9,112,43,155
https://kawalpemilu.org#69075,"PEBOUNANG, PALASA, PARIGI MOUTONG, SULAWESI TENGAH",10,42,114,156
https://kawalpemilu.org#69075,"PEBOUNANG, PALASA, PARIGI MOUTONG, SULAWESI TENGAH",11,21,103,124
https://kawalpemilu.org#85718,"BAMBASIANG, PALASA, PARIGI MOUTONG, SULAWESI TENGAH",1,107,59,166
https://kawalpemilu.org#85718,"BAMBASIANG, PALASA, PARIGI MOUTONG, SULAWESI TENGAH",2,107,16,123
https://kawalpemilu.org#85718,"BAMBASIANG, PALASA, PARIGI MOUTONG, SULAWESI TENGAH",3,84,49,133
https://kawalpemilu.org#85718,"BAMBASIANG, PALASA, PARIGI MOUTONG, SULAWESI TENGAH",4,80,29,109
https://kawalpemilu.org#85718,"BAMBASIANG, PALASA, PARIGI MOUTONG, SULAWESI TENGAH",5,109,83,192
https://kawalpemilu.org#85718,"BAMBASIANG, PALASA, PARIGI MOUTONG, SULAWESI TENGAH",6,72,23,95
https://kawalpemilu.org#85718,"BAMBASIANG, PALASA, PARIGI MOUTONG, SULAWESI TENGAH",7,60,21,81
https://kawalpemilu.org#85718,"BAMBASIANG, PALASA, PARIGI MOUTONG, SULAWESI TENGAH",8,96,103,199
https://kawalpemilu.org#85718,"BAMBASIANG, PALASA, PARIGI MOUTONG, SULAWESI TENGAH",9,66,23,89
https://kawalpemilu.org#928646,"BEAU, PALASA, PARIGI MOUTONG, SULAWESI TENGAH",1,149,58,207
https://kawalpemilu.org#928646,"BEAU, PALASA, PARIGI MOUTONG, SULAWESI TENGAH",2,164,54,218
https://kawalpemilu.org#928646,"BEAU, PALASA, PARIGI MOUTONG, SULAWESI TENGAH",3,72,58,130
https://kawalpemilu.org#928646,"BEAU, PALASA, PARIGI MOUTONG, SULAWESI TENGAH",4,57,42,99
https://kawalpemilu.org#928647,"OGOANSAM, PALASA, PARIGI MOUTONG, SULAWESI TENGAH",1,69,72,141
https://kawalpemilu.org#928647,"OGOANSAM, PALASA, PARIGI MOUTONG, SULAWESI TENGAH",2,108,105,213
https://kawalpemilu.org#928647,"OGOANSAM, PALASA, PARIGI MOUTONG, SULAWESI TENGAH",3,67,97,164
https://kawalpemilu.org#928647,"OGOANSAM, PALASA, PARIGI MOUTONG, SULAWESI TENGAH",4,97,95,192
https://kawalpemilu.org#928647,"OGOANSAM, PALASA, PARIGI MOUTONG, SULAWESI TENGAH",5,138,47,185
https://kawalpemilu.org#69077,"AVOLUA, PARIGI UTARA, PARIGI MOUTONG, SULAWESI TENGAH",1,24,165,189
https://kawalpemilu.org#69077,"AVOLUA, PARIGI UTARA, PARIGI MOUTONG, SULAWESI TENGAH",2,29,136,165
https://kawalpemilu.org#69077,"AVOLUA, PARIGI UTARA, PARIGI MOUTONG, SULAWESI TENGAH",3,33,195,228
https://kawalpemilu.org#69077,"AVOLUA, PARIGI UTARA, PARIGI MOUTONG, SULAWESI TENGAH",4,39,39,78
https://kawalpemilu.org#69078,"TOBOLI, PARIGI UTARA, PARIGI MOUTONG, SULAWESI TENGAH",1,56,179,235
https://kawalpemilu.org#69078,"TOBOLI, PARIGI UTARA, PARIGI MOUTONG, SULAWESI TENGAH",2,53,153,206
https://kawalpemilu.org#69078,"TOBOLI, PARIGI UTARA, PARIGI MOUTONG, SULAWESI TENGAH",3,43,129,172
https://kawalpemilu.org#69078,"TOBOLI, PARIGI UTARA, PARIGI MOUTONG, SULAWESI TENGAH",4,44,198,242
https://kawalpemilu.org#69078,"TOBOLI, PARIGI UTARA, PARIGI MOUTONG, SULAWESI TENGAH",5,52,127,179
https://kawalpemilu.org#69078,"TOBOLI, PARIGI UTARA, PARIGI MOUTONG, SULAWESI TENGAH",6,75,89,164
https://kawalpemilu.org#69079,"TOBOLI BARAT, PARIGI UTARA, PARIGI MOUTONG, SULAWESI TENGAH",1,69,170,239
https://kawalpemilu.org#69079,"TOBOLI BARAT, PARIGI UTARA, PARIGI MOUTONG, SULAWESI TENGAH",2,95,149,244
https://kawalpemilu.org#69079,"TOBOLI BARAT, PARIGI UTARA, PARIGI MOUTONG, SULAWESI TENGAH",3,120,105,225
https://kawalpemilu.org#69079,"TOBOLI BARAT, PARIGI UTARA, PARIGI MOUTONG, SULAWESI TENGAH",4,21,35,56
https://kawalpemilu.org#69080,"PANGI, PARIGI UTARA, PARIGI MOUTONG, SULAWESI TENGAH",1,44,62,206
https://kawalpemilu.org#69080,"PANGI, PARIGI UTARA, PARIGI MOUTONG, SULAWESI TENGAH",2,67,156,223
https://kawalpemilu.org#69080,"PANGI, PARIGI UTARA, PARIGI MOUTONG, SULAWESI TENGAH",3,24,161,185
https://kawalpemilu.org#69080,"PANGI, PARIGI UTARA, PARIGI MOUTONG, SULAWESI TENGAH",4,45,174,219
https://kawalpemilu.org#69080,"PANGI, PARIGI UTARA, PARIGI MOUTONG, SULAWESI TENGAH",5,52,146,198
https://kawalpemilu.org#69081,"SAKINAH JAYA, PARIGI UTARA, PARIGI MOUTONG, SULAWESI TENGAH",1,21,77,98
https://kawalpemilu.org#69081,"SAKINAH JAYA, PARIGI UTARA, PARIGI MOUTONG, SULAWESI TENGAH",2,65,73,138
https://kawalpemilu.org#69083,"PELAWA BARU, PARIGI TENGAH, PARIGI MOUTONG, SULAWESI TENGAH",1,64,167,231
https://kawalpemilu.org#69083,"PELAWA BARU, PARIGI TENGAH, PARIGI MOUTONG, SULAWESI TENGAH",2,57,167,224
https://kawalpemilu.org#69083,"PELAWA BARU, PARIGI TENGAH, PARIGI MOUTONG, SULAWESI TENGAH",3,28,207,235
https://kawalpemilu.org#69083,"PELAWA BARU, PARIGI TENGAH, PARIGI MOUTONG, SULAWESI TENGAH",4,79,159,238
https://kawalpemilu.org#69083,"PELAWA BARU, PARIGI TENGAH, PARIGI MOUTONG, SULAWESI TENGAH",5,61,178,239
https://kawalpemilu.org#69083,"PELAWA BARU, PARIGI TENGAH, PARIGI MOUTONG, SULAWESI TENGAH",6,128,99,227
https://kawalpemilu.org#69084,"PELAWA, PARIGI TENGAH, PARIGI MOUTONG, SULAWESI TENGAH",1,51,125,176
https://kawalpemilu.org#69084,"PELAWA, PARIGI TENGAH, PARIGI MOUTONG, SULAWESI TENGAH",2,64,116,180
https://kawalpemilu.org#69084,"PELAWA, PARIGI TENGAH, PARIGI MOUTONG, SULAWESI TENGAH",3,78,125,203
https://kawalpemilu.org#69084,"PELAWA, PARIGI TENGAH, PARIGI MOUTONG, SULAWESI TENGAH",4,68,133,201
https://kawalpemilu.org#69084,"PELAWA, PARIGI TENGAH, PARIGI MOUTONG, SULAWESI TENGAH",5,75,106,181
https://kawalpemilu.org#69084,"PELAWA, PARIGI TENGAH, PARIGI MOUTONG, SULAWESI TENGAH",6,134,77,211
https://kawalpemilu.org#69085,"BINANGGA, PARIGI TENGAH, PARIGI MOUTONG, SULAWESI TENGAH",1,82,94,176
https://kawalpemilu.org#69085,"BINANGGA, PARIGI TENGAH, PARIGI MOUTONG, SULAWESI TENGAH",2,92,101,193
https://kawalpemilu.org#69085,"BINANGGA, PARIGI TENGAH, PARIGI MOUTONG, SULAWESI TENGAH",3,112,100,212
https://kawalpemilu.org#69085,"BINANGGA, PARIGI TENGAH, PARIGI MOUTONG, SULAWESI TENGAH",4,121,93,214
https://kawalpemilu.org#69086,"JONONUNU, PARIGI TENGAH, PARIGI MOUTONG, SULAWESI TENGAH",1,56,114,170
https://kawalpemilu.org#69086,"JONONUNU, PARIGI TENGAH, PARIGI MOUTONG, SULAWESI TENGAH",2,59,112,171
https://kawalpemilu.org#69087,"MATOLELE, PARIGI TENGAH, PARIGI MOUTONG, SULAWESI TENGAH",1,70,149,219
https://kawalpemilu.org#69087,"MATOLELE, PARIGI TENGAH, PARIGI MOUTONG, SULAWESI TENGAH",2,66,144,210
https://kawalpemilu.org#69088,"PETAPA, PARIGI TENGAH, PARIGI MOUTONG, SULAWESI TENGAH",1,74,144,218
https://kawalpemilu.org#69088,"PETAPA, PARIGI TENGAH, PARIGI MOUTONG, SULAWESI TENGAH",2,73,134,207
https://kawalpemilu.org#69088,"PETAPA, PARIGI TENGAH, PARIGI MOUTONG, SULAWESI TENGAH",3,78,143,221
https://kawalpemilu.org#69088,"PETAPA, PARIGI TENGAH, PARIGI MOUTONG, SULAWESI TENGAH",5,54,155,209
https://kawalpemilu.org#68959,"BOLANO, BOLANO, PARIGI MOUTONG, SULAWESI TENGAH",1,82,84,166
https://kawalpemilu.org#68959,"BOLANO, BOLANO, PARIGI MOUTONG, SULAWESI TENGAH",2,100,67,167
https://kawalpemilu.org#68959,"BOLANO, BOLANO, PARIGI MOUTONG, SULAWESI TENGAH",3,32,19,51
https://kawalpemilu.org#68959,"BOLANO, BOLANO, PARIGI MOUTONG, SULAWESI TENGAH",4,84,91,175
https://kawalpemilu.org#68959,"BOLANO, BOLANO, PARIGI MOUTONG, SULAWESI TENGAH",5,69,68,137
https://kawalpemilu.org#68959,"BOLANO, BOLANO, PARIGI MOUTONG, SULAWESI TENGAH",6,80,82,162
https://kawalpemilu.org#68960,"BAJO, BOLANO, PARIGI MOUTONG, SULAWESI TENGAH",1,101,70,171
https://kawalpemilu.org#68960,"BAJO, BOLANO, PARIGI MOUTONG, SULAWESI TENGAH",2,101,47,148
https://kawalpemilu.org#68960,"BAJO, BOLANO, PARIGI MOUTONG, SULAWESI TENGAH",3,136,38,174
https://kawalpemilu.org#68965,"WANAMUKTI, BOLANO, PARIGI MOUTONG, SULAWESI TENGAH",1,94,58,152
https://kawalpemilu.org#68965,"WANAMUKTI, BOLANO, PARIGI MOUTONG, SULAWESI TENGAH",2,108,63,171
https://kawalpemilu.org#68965,"WANAMUKTI, BOLANO, PARIGI MOUTONG, SULAWESI TENGAH",3,100,52,152
https://kawalpemilu.org#68965,"WANAMUKTI, BOLANO, PARIGI MOUTONG, SULAWESI TENGAH",4,111,56,167
https://kawalpemilu.org#68965,"WANAMUKTI, BOLANO, PARIGI MOUTONG, SULAWESI TENGAH",5,104,47,151
https://kawalpemilu.org#68965,"WANAMUKTI, BOLANO, PARIGI MOUTONG, SULAWESI TENGAH",6,123,48,171
https://kawalpemilu.org#68965,"WANAMUKTI, BOLANO, PARIGI MOUTONG, SULAWESI TENGAH",7,93,42,135
https://kawalpemilu.org#68966,"BERINGIN JAYA, BOLANO, PARIGI MOUTONG, SULAWESI TENGAH",1,105,62,167
https://kawalpemilu.org#68966,"BERINGIN JAYA, BOLANO, PARIGI MOUTONG, SULAWESI TENGAH",2,142,36,178
https://kawalpemilu.org#68966,"BERINGIN JAYA, BOLANO, PARIGI MOUTONG, SULAWESI TENGAH",3,121,65,186
https://kawalpemilu.org#68966,"BERINGIN JAYA, BOLANO, PARIGI MOUTONG, SULAWESI TENGAH",4,118,48,166
https://kawalpemilu.org#68977,"LEMBAH BOMBAN, BOLANO, PARIGI MOUTONG, SULAWESI TENGAH",1,158,60,218
https://kawalpemilu.org#68977,"LEMBAH BOMBAN, BOLANO, PARIGI MOUTONG, SULAWESI TENGAH",2,171,73,244
https://kawalpemilu.org#68977,"LEMBAH BOMBAN, BOLANO, PARIGI MOUTONG, SULAWESI TENGAH",3,113,0,113
https://kawalpemilu.org#89759,"BOLANO TENGAH, BOLANO, PARIGI MOUTONG, SULAWESI TENGAH",1,118,64,182
https://kawalpemilu.org#89759,"BOLANO TENGAH, BOLANO, PARIGI MOUTONG, SULAWESI TENGAH",2,116,63,179
https://kawalpemilu.org#89759,"BOLANO TENGAH, BOLANO, PARIGI MOUTONG, SULAWESI TENGAH",3,97,39,136
https://kawalpemilu.org#89759,"BOLANO TENGAH, BOLANO, PARIGI MOUTONG, SULAWESI TENGAH",4,131,40,171
https://kawalpemilu.org#89760,"BOLANO UTARA, BOLANO, PARIGI MOUTONG, SULAWESI TENGAH",1,162,56,218
https://kawalpemilu.org#89760,"BOLANO UTARA, BOLANO, PARIGI MOUTONG, SULAWESI TENGAH",2,119,65,184
https://kawalpemilu.org#89761,"SRITABAANG, BOLANO, PARIGI MOUTONG, SULAWESI TENGAH",1,107,42,149
https://kawalpemilu.org#89761,"SRITABAANG, BOLANO, PARIGI MOUTONG, SULAWESI TENGAH",2,115,23,138
https://kawalpemilu.org#89761,"SRITABAANG, BOLANO, PARIGI MOUTONG, SULAWESI TENGAH",3,151,15,166
https://kawalpemilu.org#89761,"SRITABAANG, BOLANO, PARIGI MOUTONG, SULAWESI TENGAH",4,147,10,157
https://kawalpemilu.org#89761,"SRITABAANG, BOLANO, PARIGI MOUTONG, SULAWESI TENGAH",5,109,49,158
https://kawalpemilu.org#89761,"SRITABAANG, BOLANO, PARIGI MOUTONG, SULAWESI TENGAH",6,146,34,180
https://kawalpemilu.org#89762,"WANAMUKTI UTARA, BOLANO, PARIGI MOUTONG, SULAWESI TENGAH",1,199,34,233
https://kawalpemilu.org#89762,"WANAMUKTI UTARA, BOLANO, PARIGI MOUTONG, SULAWESI TENGAH",2,209,19,228
https://kawalpemilu.org#89763,"SIDOMUKTI, BOLANO, PARIGI MOUTONG, SULAWESI TENGAH",1,134,30,164
https://kawalpemilu.org#89763,"SIDOMUKTI, BOLANO, PARIGI MOUTONG, SULAWESI TENGAH",2,176,32,208
https://kawalpemilu.org#89763,"SIDOMUKTI, BOLANO, PARIGI MOUTONG, SULAWESI TENGAH",3,125,33,158
https://kawalpemilu.org#89763,"SIDOMUKTI, BOLANO, PARIGI MOUTONG, SULAWESI TENGAH",4,99,73,172
https://kawalpemilu.org#89763,"SIDOMUKTI, BOLANO, PARIGI MOUTONG, SULAWESI TENGAH",5,88,66,154
https://kawalpemilu.org#89764,"WANAMUKTI BARAT, BOLANO, PARIGI MOUTONG, SULAWESI TENGAH",1,151,6,157
https://kawalpemilu.org#89764,"WANAMUKTI BARAT, BOLANO, PARIGI MOUTONG, SULAWESI TENGAH",2,156,11,167
https://kawalpemilu.org#89764,"WANAMUKTI BARAT, BOLANO, PARIGI MOUTONG, SULAWESI TENGAH",3,160,10,170
https://kawalpemilu.org#93145,"BOLANO BARAT, BOLANO, PARIGI MOUTONG, SULAWESI TENGAH",1,79,33,112
https://kawalpemilu.org#93145,"BOLANO BARAT, BOLANO, PARIGI MOUTONG, SULAWESI TENGAH",2,85,31,116
https://kawalpemilu.org#93145,"BOLANO BARAT, BOLANO, PARIGI MOUTONG, SULAWESI TENGAH",3,131,92,223
https://kawalpemilu.org#93145,"BOLANO BARAT, BOLANO, PARIGI MOUTONG, SULAWESI TENGAH",4,167,18,185
https://kawalpemilu.org#93145,"BOLANO BARAT, BOLANO, PARIGI MOUTONG, SULAWESI TENGAH",5,63,72,135
https://kawalpemilu.org#93145,"BOLANO BARAT, BOLANO, PARIGI MOUTONG, SULAWESI TENGAH",6,62,25,87
https://kawalpemilu.org#928648,"SAMA BAHARI, BOLANO, PARIGI MOUTONG, SULAWESI TENGAH",1,99,93,192
https://kawalpemilu.org#928648,"SAMA BAHARI, BOLANO, PARIGI MOUTONG, SULAWESI TENGAH",2,111,56,167
https://kawalpemilu.org#928648,"SAMA BAHARI, BOLANO, PARIGI MOUTONG, SULAWESI TENGAH",3,132,52,184
https://kawalpemilu.org#68968,"TINOMBALA, ONGKA MALINO, PARIGI MOUTONG, SULAWESI TENGAH",1,115,58,173
https://kawalpemilu.org#68968,"TINOMBALA, ONGKA MALINO, PARIGI MOUTONG, SULAWESI TENGAH",2,99,72,171
https://kawalpemilu.org#68968,"TINOMBALA, ONGKA MALINO, PARIGI MOUTONG, SULAWESI TENGAH",3,130,96,226
https://kawalpemilu.org#68968,"TINOMBALA, ONGKA MALINO, PARIGI MOUTONG, SULAWESI TENGAH",4,155,66,221
https://kawalpemilu.org#68968,"TINOMBALA, ONGKA MALINO, PARIGI MOUTONG, SULAWESI TENGAH",5,128,84,212
https://kawalpemilu.org#68968,"TINOMBALA, ONGKA MALINO, PARIGI MOUTONG, SULAWESI TENGAH",6,52,43,95
https://kawalpemilu.org#68969,"ONGKA, ONGKA MALINO, PARIGI MOUTONG, SULAWESI TENGAH",1,131,53,184
https://kawalpemilu.org#68969,"ONGKA, ONGKA MALINO, PARIGI MOUTONG, SULAWESI TENGAH",2,147,77,224
https://kawalpemilu.org#68969,"ONGKA, ONGKA MALINO, PARIGI MOUTONG, SULAWESI TENGAH",3,71,65,136
https://kawalpemilu.org#68969,"ONGKA, ONGKA MALINO, PARIGI MOUTONG, SULAWESI TENGAH",4,82,61,143
https://kawalpemilu.org#68969,"ONGKA, ONGKA MALINO, PARIGI MOUTONG, SULAWESI TENGAH",5,121,37,158
https://kawalpemilu.org#68970,"MALINO, ONGKA MALINO, PARIGI MOUTONG, SULAWESI TENGAH",1,154,87,241
https://kawalpemilu.org#68970,"MALINO, ONGKA MALINO, PARIGI MOUTONG, SULAWESI TENGAH",2,81,111,192
https://kawalpemilu.org#68970,"MALINO, ONGKA MALINO, PARIGI MOUTONG, SULAWESI TENGAH",3,78,85,163
https://kawalpemilu.org#68970,"MALINO, ONGKA MALINO, PARIGI MOUTONG, SULAWESI TENGAH",4,79,66,145
https://kawalpemilu.org#68971,"SANTIGI, ONGKA MALINO, PARIGI MOUTONG, SULAWESI TENGAH",1,117,50,167
https://kawalpemilu.org#68971,"SANTIGI, ONGKA MALINO, PARIGI MOUTONG, SULAWESI TENGAH",2,163,23,186
https://kawalpemilu.org#68971,"SANTIGI, ONGKA MALINO, PARIGI MOUTONG, SULAWESI TENGAH",3,178,39,217
https://kawalpemilu.org#68971,"SANTIGI, ONGKA MALINO, PARIGI MOUTONG, SULAWESI TENGAH",4,102,6,108
https://kawalpemilu.org#68972,"PERSATUAN SEJATI, ONGKA MALINO, PARIGI MOUTONG, SULAWESI TENGAH",1,104,38,142
https://kawalpemilu.org#68972,"PERSATUAN SEJATI, ONGKA MALINO, PARIGI MOUTONG, SULAWESI TENGAH",2,109,38,147
https://kawalpemilu.org#68972,"PERSATUAN SEJATI, ONGKA MALINO, PARIGI MOUTONG, SULAWESI TENGAH",3,136,39,175
https://kawalpemilu.org#68972,"PERSATUAN SEJATI, ONGKA MALINO, PARIGI MOUTONG, SULAWESI TENGAH",4,174,7,181
https://kawalpemilu.org#68972,"PERSATUAN SEJATI, ONGKA MALINO, PARIGI MOUTONG, SULAWESI TENGAH",5,142,33,175
https://kawalpemilu.org#68972,"PERSATUAN SEJATI, ONGKA MALINO, PARIGI MOUTONG, SULAWESI TENGAH",6,107,22,129
https://kawalpemilu.org#68976,"KARYA MANDIRI, ONGKA MALINO, PARIGI MOUTONG, SULAWESI TENGAH",1,119,71,190
https://kawalpemilu.org#68976,"KARYA MANDIRI, ONGKA MALINO, PARIGI MOUTONG, SULAWESI TENGAH",2,66,56,122
https://kawalpemilu.org#68976,"KARYA MANDIRI, ONGKA MALINO, PARIGI MOUTONG, SULAWESI TENGAH",3,38,60,98
https://kawalpemilu.org#89766,"TABOLOBOLO, ONGKA MALINO, PARIGI MOUTONG, SULAWESI TENGAH",1,179,32,211
https://kawalpemilu.org#89766,"TABOLOBOLO, ONGKA MALINO, PARIGI MOUTONG, SULAWESI TENGAH",2,127,42,169
https://kawalpemilu.org#89766,"TABOLOBOLO, ONGKA MALINO, PARIGI MOUTONG, SULAWESI TENGAH",3,56,13,69
https://kawalpemilu.org#89766,"TABOLOBOLO, ONGKA MALINO, PARIGI MOUTONG, SULAWESI TENGAH",4,135,46,181
https://kawalpemilu.org#89767,"KAYU JATI, ONGKA MALINO, PARIGI MOUTONG, SULAWESI TENGAH",1,114,61,175
https://kawalpemilu.org#89767,"KAYU JATI, ONGKA MALINO, PARIGI MOUTONG, SULAWESI TENGAH",2,73,48,121
https://kawalpemilu.org#89767,"KAYU JATI, ONGKA MALINO, PARIGI MOUTONG, SULAWESI TENGAH",3,165,47,212
https://kawalpemilu.org#89767,"KAYU JATI, ONGKA MALINO, PARIGI MOUTONG, SULAWESI TENGAH",4,133,69,202
https://kawalpemilu.org#89767,"KAYU JATI, ONGKA MALINO, PARIGI MOUTONG, SULAWESI TENGAH",5,149,69,218
https://kawalpemilu.org#89767,"KAYU JATI, ONGKA MALINO, PARIGI MOUTONG, SULAWESI TENGAH",6,112,50,162
https://kawalpemilu.org#89768,"LAMBANAU, ONGKA MALINO, PARIGI MOUTONG, SULAWESI TENGAH",1,117,55,172
https://kawalpemilu.org#89768,"LAMBANAU, ONGKA MALINO, PARIGI MOUTONG, SULAWESI TENGAH",2,126,53,179
https://kawalpemilu.org#89769,"BOSAGON JAYA, ONGKA MALINO, PARIGI MOUTONG, SULAWESI TENGAH",1,156,22,178
https://kawalpemilu.org#89769,"BOSAGON JAYA, ONGKA MALINO, PARIGI MOUTONG, SULAWESI TENGAH",2,98,72,170
https://kawalpemilu.org#89769,"BOSAGON JAYA, ONGKA MALINO, PARIGI MOUTONG, SULAWESI TENGAH",3,72,51,123
https://kawalpemilu.org#89770,"PERSATUAN UTARA, ONGKA MALINO, PARIGI MOUTONG, SULAWESI TENGAH",1,107,40,147
https://kawalpemilu.org#89770,"PERSATUAN UTARA, ONGKA MALINO, PARIGI MOUTONG, SULAWESI TENGAH",2,107,11,118
https://kawalpemilu.org#89770,"PERSATUAN UTARA, ONGKA MALINO, PARIGI MOUTONG, SULAWESI TENGAH",3,140,15,155
https://kawalpemilu.org#89770,"PERSATUAN UTARA, ONGKA MALINO, PARIGI MOUTONG, SULAWESI TENGAH",4,86,41,127
https://kawalpemilu.org#89771,"TINOMBALA JAYA, ONGKA MALINO, PARIGI MOUTONG, SULAWESI TENGAH",1,141,48,189
https://kawalpemilu.org#89771,"TINOMBALA JAYA, ONGKA MALINO, PARIGI MOUTONG, SULAWESI TENGAH",2,100,67,167
https://kawalpemilu.org#89771,"TINOMBALA JAYA, ONGKA MALINO, PARIGI MOUTONG, SULAWESI TENGAH",3,112,54,166
https://kawalpemilu.org#89771,"TINOMBALA JAYA, ONGKA MALINO, PARIGI MOUTONG, SULAWESI TENGAH",4,119,53,172
https://kawalpemilu.org#89771,"TINOMBALA JAYA, ONGKA MALINO, PARIGI MOUTONG, SULAWESI TENGAH",5,96,71,167
https://kawalpemilu.org#89771,"TINOMBALA JAYA, ONGKA MALINO, PARIGI MOUTONG, SULAWESI TENGAH",6,103,73,176
https://kawalpemilu.org#89772,"ONGKA TRIMUSPASARI, ONGKA MALINO, PARIGI MOUTONG, SULAWESI TENGAH",1,154,17,171
https://kawalpemilu.org#89772,"ONGKA TRIMUSPASARI, ONGKA MALINO, PARIGI MOUTONG, SULAWESI TENGAH",2,186,24,210
https://kawalpemilu.org#89773,"TINOMBALA SEJATI, ONGKA MALINO, PARIGI MOUTONG, SULAWESI TENGAH",1,150,67,217
https://kawalpemilu.org#89773,"TINOMBALA SEJATI, ONGKA MALINO, PARIGI MOUTONG, SULAWESI TENGAH",2,91,53,144
https://kawalpemilu.org#89773,"TINOMBALA SEJATI, ONGKA MALINO, PARIGI MOUTONG, SULAWESI TENGAH",3,146,69,215
https://kawalpemilu.org#89773,"TINOMBALA SEJATI, ONGKA MALINO, PARIGI MOUTONG, SULAWESI TENGAH",4,116,46,162
https://kawalpemilu.org#89774,"TINOMBALA BARAT, ONGKA MALINO, PARIGI MOUTONG, SULAWESI TENGAH",1,121,46,167
https://kawalpemilu.org#89774,"TINOMBALA BARAT, ONGKA MALINO, PARIGI MOUTONG, SULAWESI TENGAH",2,132,79,211
https://kawalpemilu.org#89774,"TINOMBALA BARAT, ONGKA MALINO, PARIGI MOUTONG, SULAWESI TENGAH",3,143,53,196
https://kawalpemilu.org#89774,"TINOMBALA BARAT, ONGKA MALINO, PARIGI MOUTONG, SULAWESI TENGAH",4,171,51,222
https://kawalpemilu.org#928649,"PADAELO, ONGKA MALINO, PARIGI MOUTONG, SULAWESI TENGAH",1,61,70,131
https://kawalpemilu.org#928649,"PADAELO, ONGKA MALINO, PARIGI MOUTONG, SULAWESI TENGAH",2,119,59,178
https://kawalpemilu.org#928650,"ONGKA PERSATUAN, ONGKA MALINO, PARIGI MOUTONG, SULAWESI TENGAH",1,63,85,148
https://kawalpemilu.org#928650,"ONGKA PERSATUAN, ONGKA MALINO, PARIGI MOUTONG, SULAWESI TENGAH",2,49,71,120
https://kawalpemilu.org#928650,"ONGKA PERSATUAN, ONGKA MALINO, PARIGI MOUTONG, SULAWESI TENGAH",3,93,69,162
https://kawalpemilu.org#68912,"SIPAYO, SIDOAN, PARIGI MOUTONG, SULAWESI TENGAH",1,95,130,225
https://kawalpemilu.org#68912,"SIPAYO, SIDOAN, PARIGI MOUTONG, SULAWESI TENGAH",2,24,92,116
https://kawalpemilu.org#68912,"SIPAYO, SIDOAN, PARIGI MOUTONG, SULAWESI TENGAH",3,48,182,230
https://kawalpemilu.org#68912,"SIPAYO, SIDOAN, PARIGI MOUTONG, SULAWESI TENGAH",4,89,100,189
https://kawalpemilu.org#68912,"SIPAYO, SIDOAN, PARIGI MOUTONG, SULAWESI TENGAH",5,132,48,180
https://kawalpemilu.org#68912,"SIPAYO, SIDOAN, PARIGI MOUTONG, SULAWESI TENGAH",6,120,25,145
https://kawalpemilu.org#68912,"SIPAYO, SIDOAN, PARIGI MOUTONG, SULAWESI TENGAH",7,155,49,204
https://kawalpemilu.org#68912,"SIPAYO, SIDOAN, PARIGI MOUTONG, SULAWESI TENGAH",8,184,31,215
https://kawalpemilu.org#68912,"SIPAYO, SIDOAN, PARIGI MOUTONG, SULAWESI TENGAH",9,97,26,123
https://kawalpemilu.org#68913,"SIDOAN, SIDOAN, PARIGI MOUTONG, SULAWESI TENGAH",1,54,122,176
https://kawalpemilu.org#68913,"SIDOAN, SIDOAN, PARIGI MOUTONG, SULAWESI TENGAH",2,77,94,171
https://kawalpemilu.org#68913,"SIDOAN, SIDOAN, PARIGI MOUTONG, SULAWESI TENGAH",3,104,82,186
https://kawalpemilu.org#68913,"SIDOAN, SIDOAN, PARIGI MOUTONG, SULAWESI TENGAH",4,106,94,200
https://kawalpemilu.org#68913,"SIDOAN, SIDOAN, PARIGI MOUTONG, SULAWESI TENGAH",5,73,137,210
https://kawalpemilu.org#68913,"SIDOAN, SIDOAN, PARIGI MOUTONG, SULAWESI TENGAH",6,56,156,212
https://kawalpemilu.org#68913,"SIDOAN, SIDOAN, PARIGI MOUTONG, SULAWESI TENGAH",7,90,124,214
https://kawalpemilu.org#68920,"SIDOAN SELATAN, SIDOAN, PARIGI MOUTONG, SULAWESI TENGAH",1,90,97,187
https://kawalpemilu.org#68920,"SIDOAN SELATAN, SIDOAN, PARIGI MOUTONG, SULAWESI TENGAH",2,81,55,136
https://kawalpemilu.org#68920,"SIDOAN SELATAN, SIDOAN, PARIGI MOUTONG, SULAWESI TENGAH",3,129,42,171
https://kawalpemilu.org#68921,"SIDOAN BARAT, SIDOAN, PARIGI MOUTONG, SULAWESI TENGAH",1,73,107,180
https://kawalpemilu.org#68921,"SIDOAN BARAT, SIDOAN, PARIGI MOUTONG, SULAWESI TENGAH",2,119,116,235
https://kawalpemilu.org#68921,"SIDOAN BARAT, SIDOAN, PARIGI MOUTONG, SULAWESI TENGAH",3,146,101,247
https://kawalpemilu.org#68921,"SIDOAN BARAT, SIDOAN, PARIGI MOUTONG, SULAWESI TENGAH",4,142,105,147
https://kawalpemilu.org#68921,"SIDOAN BARAT, SIDOAN, PARIGI MOUTONG, SULAWESI TENGAH",5,127,73,200
https://kawalpemilu.org#68921,"SIDOAN BARAT, SIDOAN, PARIGI MOUTONG, SULAWESI TENGAH",6,92,11,103
https://kawalpemilu.org#68921,"SIDOAN BARAT, SIDOAN, PARIGI MOUTONG, SULAWESI TENGAH",7,131,49,180
https://kawalpemilu.org#68921,"SIDOAN BARAT, SIDOAN, PARIGI MOUTONG, SULAWESI TENGAH",8,120,27,147
https://kawalpemilu.org#68922,"BAINAA SELATAN, SIDOAN, PARIGI MOUTONG, SULAWESI TENGAH",1,127,92,219
https://kawalpemilu.org#68922,"BAINAA SELATAN, SIDOAN, PARIGI MOUTONG, SULAWESI TENGAH",2,87,47,134
https://kawalpemilu.org#68922,"BAINAA SELATAN, SIDOAN, PARIGI MOUTONG, SULAWESI TENGAH",3,108,50,158
https://kawalpemilu.org#68924,"BONDOYONG, SIDOAN, PARIGI MOUTONG, SULAWESI TENGAH",1,142,50,192
https://kawalpemilu.org#68924,"BONDOYONG, SIDOAN, PARIGI MOUTONG, SULAWESI TENGAH",2,155,28,183
https://kawalpemilu.org#68924,"BONDOYONG, SIDOAN, PARIGI MOUTONG, SULAWESI TENGAH",3,165,61,226
https://kawalpemilu.org#68924,"BONDOYONG, SIDOAN, PARIGI MOUTONG, SULAWESI TENGAH",4,127,22,149
https://kawalpemilu.org#85691,"LADO, SIDOAN, PARIGI MOUTONG, SULAWESI TENGAH",1,151,67,218
https://kawalpemilu.org#85691,"LADO, SIDOAN, PARIGI MOUTONG, SULAWESI TENGAH",2,116,115,231
https://kawalpemilu.org#85692,"SIDOAN TIMUR, SIDOAN, PARIGI MOUTONG, SULAWESI TENGAH",1,98,49,147
https://kawalpemilu.org#85692,"SIDOAN TIMUR, SIDOAN, PARIGI MOUTONG, SULAWESI TENGAH",2,99,54,153
https://kawalpemilu.org#85692,"SIDOAN TIMUR, SIDOAN, PARIGI MOUTONG, SULAWESI TENGAH",3,46,123,169
https://kawalpemilu.org#85693,"OGOBAGIS, SIDOAN, PARIGI MOUTONG, SULAWESI TENGAH",1,127,96,223
https://kawalpemilu.org#85693,"OGOBAGIS, SIDOAN, PARIGI MOUTONG, SULAWESI TENGAH",2,147,71,218
https://kawalpemilu.org#89727,"MUARA JAYA, SIDOAN, PARIGI MOUTONG, SULAWESI TENGAH",1,83,151,234
https://kawalpemilu.org#89727,"MUARA JAYA, SIDOAN, PARIGI MOUTONG, SULAWESI TENGAH",2,166,57,223
https://kawalpemilu.org#89728,"SINTUWU RAYA, SIDOAN, PARIGI MOUTONG, SULAWESI TENGAH",1,155,15,170
https://kawalpemilu.org#89728,"SINTUWU RAYA, SIDOAN, PARIGI MOUTONG, SULAWESI TENGAH",2,148,24,172
https://kawalpemilu.org#89728,"SINTUWU RAYA, SIDOAN, PARIGI MOUTONG, SULAWESI TENGAH",3,128,14,142
https://kawalpemilu.org#69095,"TANINGKOLA, UNA UNA, TOJO UNA-UNA, SULAWESI TENGAH",1,138,87,225
https://kawalpemilu.org#69095,"TANINGKOLA, UNA UNA, TOJO UNA-UNA, SULAWESI TENGAH",2,137,78,215
https://kawalpemilu.org#69096,"BAMBU, UNA UNA, TOJO UNA-UNA, SULAWESI TENGAH",1,127,43,170
https://kawalpemilu.org#69096,"BAMBU, UNA UNA, TOJO UNA-UNA, SULAWESI TENGAH",2,73,16,89
https://kawalpemilu.org#69096,"BAMBU, UNA UNA, TOJO UNA-UNA, SULAWESI TENGAH",3,68,104,172
https://kawalpemilu.org#69096,"BAMBU, UNA UNA, TOJO UNA-UNA, SULAWESI TENGAH",4,53,23,76
https://kawalpemilu.org#69097,"WAKAI, UNA UNA, TOJO UNA-UNA, SULAWESI TENGAH",1,96,90,186
https://kawalpemilu.org#69097,"WAKAI, UNA UNA, TOJO UNA-UNA, SULAWESI TENGAH",2,119,52,171
https://kawalpemilu.org#69097,"WAKAI, UNA UNA, TOJO UNA-UNA, SULAWESI TENGAH",3,112,96,208
https://kawalpemilu.org#69097,"WAKAI, UNA UNA, TOJO UNA-UNA, SULAWESI TENGAH",4,96,99,195
https://kawalpemilu.org#69097,"WAKAI, UNA UNA, TOJO UNA-UNA, SULAWESI TENGAH",5,99,69,168
https://kawalpemilu.org#69097,"WAKAI, UNA UNA, TOJO UNA-UNA, SULAWESI TENGAH",6,52,123,175
https://kawalpemilu.org#69097,"WAKAI, UNA UNA, TOJO UNA-UNA, SULAWESI TENGAH",7,49,92,141
https://kawalpemilu.org#69098,"UNA-UNA, UNA UNA, TOJO UNA-UNA, SULAWESI TENGAH",1,75,151,226
https://kawalpemilu.org#69098,"UNA-UNA, UNA UNA, TOJO UNA-UNA, SULAWESI TENGAH",2,94,82,176
https://kawalpemilu.org#69099,"TANJUNG PUDE, UNA UNA, TOJO UNA-UNA, SULAWESI TENGAH",1,93,74,167
https://kawalpemilu.org#69100,"LEMBANYA, UNA UNA, TOJO UNA-UNA, SULAWESI TENGAH",1,89,151,240
https://kawalpemilu.org#85719,"BINANGUNA, UNA UNA, TOJO UNA-UNA, SULAWESI TENGAH",1,167,30,197
https://kawalpemilu.org#85719,"BINANGUNA, UNA UNA, TOJO UNA-UNA, SULAWESI TENGAH",2,48,58,106
https://kawalpemilu.org#85719,"BINANGUNA, UNA UNA, TOJO UNA-UNA, SULAWESI TENGAH",3,47,39,86
https://kawalpemilu.org#85720,"KAVETAN, UNA UNA, TOJO UNA-UNA, SULAWESI TENGAH",1,34,49,83
https://kawalpemilu.org#85720,"KAVETAN, UNA UNA, TOJO UNA-UNA, SULAWESI TENGAH",2,199,78,277
https://kawalpemilu.org#85721,"TANIMPO, UNA UNA, TOJO UNA-UNA, SULAWESI TENGAH",1,93,121,214
https://kawalpemilu.org#85721,"TANIMPO, UNA UNA, TOJO UNA-UNA, SULAWESI TENGAH",2,111,127,238
https://kawalpemilu.org#85722,"LUANGON, UNA UNA, TOJO UNA-UNA, SULAWESI TENGAH",1,110,34,144
https://kawalpemilu.org#85722,"LUANGON, UNA UNA, TOJO UNA-UNA, SULAWESI TENGAH",2,94,37,131
https://kawalpemilu.org#89738,"CENDANA, UNA UNA, TOJO UNA-UNA, SULAWESI TENGAH",1,63,107,170
https://kawalpemilu.org#69105,"BUNGAYO, TOGEAN, TOJO UNA-UNA, SULAWESI TENGAH",1,33,164,197
https://kawalpemilu.org#69105,"BUNGAYO, TOGEAN, TOJO UNA-UNA, SULAWESI TENGAH",2,32,149,181
https://kawalpemilu.org#69106,"BENTENG, TOGEAN, TOJO UNA-UNA, SULAWESI TENGAH",1,110,105,215
https://kawalpemilu.org#69107,"BANGKAGI, TOGEAN, TOJO UNA-UNA, SULAWESI TENGAH",1,64,139,203
https://kawalpemilu.org#69107,"BANGKAGI, TOGEAN, TOJO UNA-UNA, SULAWESI TENGAH",2,72,127,199
https://kawalpemilu.org#69107,"BANGKAGI, TOGEAN, TOJO UNA-UNA, SULAWESI TENGAH",3,74,156,230
https://kawalpemilu.org#69108,"TONGKABO, TOGEAN, TOJO UNA-UNA, SULAWESI TENGAH",1,73,112,185
https://kawalpemilu.org#69108,"TONGKABO, TOGEAN, TOJO UNA-UNA, SULAWESI TENGAH",2,76,124,200
https://kawalpemilu.org#69108,"TONGKABO, TOGEAN, TOJO UNA-UNA, SULAWESI TENGAH",3,86,16,102
https://kawalpemilu.org#69109,"PULAU ENAM, TOGEAN, TOJO UNA-UNA, SULAWESI TENGAH",1,27,164,191
https://kawalpemilu.org#69109,"PULAU ENAM, TOGEAN, TOJO UNA-UNA, SULAWESI TENGAH",2,7,123,130
https://kawalpemilu.org#69109,"PULAU ENAM, TOGEAN, TOJO UNA-UNA, SULAWESI TENGAH",3,19,170,189
https://kawalpemilu.org#69110,"KATUPAT, TOGEAN, TOJO UNA-UNA, SULAWESI TENGAH",1,132,106,238
https://kawalpemilu.org#69110,"KATUPAT, TOGEAN, TOJO UNA-UNA, SULAWESI TENGAH",2,121,59,180
https://kawalpemilu.org#69111,"AWO, TOGEAN, TOJO UNA-UNA, SULAWESI TENGAH",1,90,46,136
https://kawalpemilu.org#69112,"KOLOLIO, TOGEAN, TOJO UNA-UNA, SULAWESI TENGAH",1,89,77,166
https://kawalpemilu.org#69113,"URULEPE, TOGEAN, TOJO UNA-UNA, SULAWESI TENGAH",1,99,90,189
https://kawalpemilu.org#69114,"LEMBANATO, TOGEAN, TOJO UNA-UNA, SULAWESI TENGAH",1,76,46,122
https://kawalpemilu.org#69114,"LEMBANATO, TOGEAN, TOJO UNA-UNA, SULAWESI TENGAH",2,68,129,197
https://kawalpemilu.org#69114,"LEMBANATO, TOGEAN, TOJO UNA-UNA, SULAWESI TENGAH",3,8,91,99
https://kawalpemilu.org#69115,"LEBITI, TOGEAN, TOJO UNA-UNA, SULAWESI TENGAH",1,47,172,219
https://kawalpemilu.org#69115,"LEBITI, TOGEAN, TOJO UNA-UNA, SULAWESI TENGAH",2,50,176,226
https://kawalpemilu.org#69115,"LEBITI, TOGEAN, TOJO UNA-UNA, SULAWESI TENGAH",3,68,159,227
https://kawalpemilu.org#69115,"LEBITI, TOGEAN, TOJO UNA-UNA, SULAWESI TENGAH",4,43,144,187
https://kawalpemilu.org#69116,"TOBIL, TOGEAN, TOJO UNA-UNA, SULAWESI TENGAH",1,114,61,175
https://kawalpemilu.org#69116,"TOBIL, TOGEAN, TOJO UNA-UNA, SULAWESI TENGAH",2,128,51,179
https://kawalpemilu.org#69117,"BAULU, TOGEAN, TOJO UNA-UNA, SULAWESI TENGAH",1,64,154,218
https://kawalpemilu.org#69117,"BAULU, TOGEAN, TOJO UNA-UNA, SULAWESI TENGAH",2,37,141,178
https://kawalpemilu.org#69118,"MOTOBIAI, TOGEAN, TOJO UNA-UNA, SULAWESI TENGAH",1,88,91,179
https://kawalpemilu.org#69118,"MOTOBIAI, TOGEAN, TOJO UNA-UNA, SULAWESI TENGAH",2,105,43,148
https://kawalpemilu.org#85723,"SAMPOBAE, TOGEAN, TOJO UNA-UNA, SULAWESI TENGAH",1,189,19,208
https://kawalpemilu.org#928652,"TITIRI'I, TOGEAN, TOJO UNA-UNA, SULAWESI TENGAH",1,118,29,147
https://kawalpemilu.org#69125,"TIGA PULAU, WALEA KEPULAUAN, TOJO UNA-UNA, SULAWESI TENGAH",1,94,122,216
https://kawalpemilu.org#69125,"TIGA PULAU, WALEA KEPULAUAN, TOJO UNA-UNA, SULAWESI TENGAH",2,104,68,172
https://kawalpemilu.org#69126,"POPOLII, WALEA KEPULAUAN, TOJO UNA-UNA, SULAWESI TENGAH",1,40,128,168
https://kawalpemilu.org#69126,"POPOLII, WALEA KEPULAUAN, TOJO UNA-UNA, SULAWESI TENGAH",2,50,107,157
https://kawalpemilu.org#69126,"POPOLII, WALEA KEPULAUAN, TOJO UNA-UNA, SULAWESI TENGAH",3,42,92,134
https://kawalpemilu.org#69127,"DOLONG B, WALEA KEPULAUAN, TOJO UNA-UNA, SULAWESI TENGAH",1,23,149,172
https://kawalpemilu.org#69127,"DOLONG B, WALEA KEPULAUAN, TOJO UNA-UNA, SULAWESI TENGAH",2,38,99,137
https://kawalpemilu.org#69127,"DOLONG B, WALEA KEPULAUAN, TOJO UNA-UNA, SULAWESI TENGAH",3,37,72,109
https://kawalpemilu.org#69127,"DOLONG B, WALEA KEPULAUAN, TOJO UNA-UNA, SULAWESI TENGAH",4,81,65,146
https://kawalpemilu.org#69128,"TUTUNG, WALEA KEPULAUAN, TOJO UNA-UNA, SULAWESI TENGAH",1,59,137,196
https://kawalpemilu.org#69128,"TUTUNG, WALEA KEPULAUAN, TOJO UNA-UNA, SULAWESI TENGAH",2,96,83,179
https://kawalpemilu.org#69129,"DOLONG A, WALEA KEPULAUAN, TOJO UNA-UNA, SULAWESI TENGAH",1,41,83,124
https://kawalpemilu.org#69129,"DOLONG A, WALEA KEPULAUAN, TOJO UNA-UNA, SULAWESI TENGAH",2,38,95,133
https://kawalpemilu.org#69129,"DOLONG A, WALEA KEPULAUAN, TOJO UNA-UNA, SULAWESI TENGAH",3,53,95,148
https://kawalpemilu.org#69130,"LUOK, WALEA KEPULAUAN, TOJO UNA-UNA, SULAWESI TENGAH",1,143,29,172
https://kawalpemilu.org#69132,"OLILAN, WALEA KEPULAUAN, TOJO UNA-UNA, SULAWESI TENGAH",1,17,164,181
https://kawalpemilu.org#85725,"LOE, WALEA KEPULAUAN, TOJO UNA-UNA, SULAWESI TENGAH",1,85,103,188
https://kawalpemilu.org#93157,"KOLAMI, WALEA KEPULAUAN, TOJO UNA-UNA, SULAWESI TENGAH",1,59,81,140
https://kawalpemilu.org#93157,"KOLAMI, WALEA KEPULAUAN, TOJO UNA-UNA, SULAWESI TENGAH",2,48,86,134
https://kawalpemilu.org#69134,"PUSUNGI, AMPANA TETE, TOJO UNA-UNA, SULAWESI TENGAH",1,120,116,236
https://kawalpemilu.org#69134,"PUSUNGI, AMPANA TETE, TOJO UNA-UNA, SULAWESI TENGAH",2,76,49,125
https://kawalpemilu.org#69134,"PUSUNGI, AMPANA TETE, TOJO UNA-UNA, SULAWESI TENGAH",3,106,74,180
https://kawalpemilu.org#69134,"PUSUNGI, AMPANA TETE, TOJO UNA-UNA, SULAWESI TENGAH",4,120,94,214
https://kawalpemilu.org#69134,"PUSUNGI, AMPANA TETE, TOJO UNA-UNA, SULAWESI TENGAH",5,75,62,137
https://kawalpemilu.org#69134,"PUSUNGI, AMPANA TETE, TOJO UNA-UNA, SULAWESI TENGAH",6,73,47,120
https://kawalpemilu.org#69134,"PUSUNGI, AMPANA TETE, TOJO UNA-UNA, SULAWESI TENGAH",7,69,86,155
https://kawalpemilu.org#69134,"PUSUNGI, AMPANA TETE, TOJO UNA-UNA, SULAWESI TENGAH",8,103,65,168
https://kawalpemilu.org#69134,"PUSUNGI, AMPANA TETE, TOJO UNA-UNA, SULAWESI TENGAH",9,132,78,210
https://kawalpemilu.org#69134,"PUSUNGI, AMPANA TETE, TOJO UNA-UNA, SULAWESI TENGAH",10,61,64,125
https://kawalpemilu.org#69134,"PUSUNGI, AMPANA TETE, TOJO UNA-UNA, SULAWESI TENGAH",11,60,80,140
https://kawalpemilu.org#69134,"PUSUNGI, AMPANA TETE, TOJO UNA-UNA, SULAWESI TENGAH",12,65,60,125
https://kawalpemilu.org#69134,"PUSUNGI, AMPANA TETE, TOJO UNA-UNA, SULAWESI TENGAH",13,113,86,199
https://kawalpemilu.org#69135,"TETE B, AMPANA TETE, TOJO UNA-UNA, SULAWESI TENGAH",1,33,138,171
https://kawalpemilu.org#69135,"TETE B, AMPANA TETE, TOJO UNA-UNA, SULAWESI TENGAH",2,37,151,188
https://kawalpemilu.org#69135,"TETE B, AMPANA TETE, TOJO UNA-UNA, SULAWESI TENGAH",3,86,96,182
https://kawalpemilu.org#69135,"TETE B, AMPANA TETE, TOJO UNA-UNA, SULAWESI TENGAH",4,48,106,154
https://kawalpemilu.org#69136,"TETE A, AMPANA TETE, TOJO UNA-UNA, SULAWESI TENGAH",1,45,137,182
https://kawalpemilu.org#69136,"TETE A, AMPANA TETE, TOJO UNA-UNA, SULAWESI TENGAH",2,74,87,161
https://kawalpemilu.org#69136,"TETE A, AMPANA TETE, TOJO UNA-UNA, SULAWESI TENGAH",3,39,121,160
https://kawalpemilu.org#69137,"UEBONE, AMPANA TETE, TOJO UNA-UNA, SULAWESI TENGAH",1,58,105,163
https://kawalpemilu.org#69137,"UEBONE, AMPANA TETE, TOJO UNA-UNA, SULAWESI TENGAH",2,54,104,158
https://kawalpemilu.org#69137,"UEBONE, AMPANA TETE, TOJO UNA-UNA, SULAWESI TENGAH",3,91,114,205
https://kawalpemilu.org#69137,"UEBONE, AMPANA TETE, TOJO UNA-UNA, SULAWESI TENGAH",4,41,68,109
https://kawalpemilu.org#69137,"UEBONE, AMPANA TETE, TOJO UNA-UNA, SULAWESI TENGAH",5,76,71,147
https://kawalpemilu.org#69137,"UEBONE, AMPANA TETE, TOJO UNA-UNA, SULAWESI TENGAH",6,62,82,144
https://kawalpemilu.org#69137,"UEBONE, AMPANA TETE, TOJO UNA-UNA, SULAWESI TENGAH",7,41,83,124
https://kawalpemilu.org#69137,"UEBONE, AMPANA TETE, TOJO UNA-UNA, SULAWESI TENGAH",8,58,54,112
https://kawalpemilu.org#69137,"UEBONE, AMPANA TETE, TOJO UNA-UNA, SULAWESI TENGAH",9,56,61,117
https://kawalpemilu.org#69137,"UEBONE, AMPANA TETE, TOJO UNA-UNA, SULAWESI TENGAH",10,68,89,157
https://kawalpemilu.org#69138,"MANTANGISI, AMPANA TETE, TOJO UNA-UNA, SULAWESI TENGAH",1,127,124,251
https://kawalpemilu.org#69138,"MANTANGISI, AMPANA TETE, TOJO UNA-UNA, SULAWESI TENGAH",2,116,106,222
https://kawalpemilu.org#69138,"MANTANGISI, AMPANA TETE, TOJO UNA-UNA, SULAWESI TENGAH",3,119,72,191
https://kawalpemilu.org#69138,"MANTANGISI, AMPANA TETE, TOJO UNA-UNA, SULAWESI TENGAH",4,82,112,194
https://kawalpemilu.org#69138,"MANTANGISI, AMPANA TETE, TOJO UNA-UNA, SULAWESI TENGAH",5,93,141,234
https://kawalpemilu.org#69139,"BANTUGA, AMPANA TETE, TOJO UNA-UNA, SULAWESI TENGAH",1,52,150,202
https://kawalpemilu.org#69139,"BANTUGA, AMPANA TETE, TOJO UNA-UNA, SULAWESI TENGAH",2,89,119,208
https://kawalpemilu.org#69139,"BANTUGA, AMPANA TETE, TOJO UNA-UNA, SULAWESI TENGAH",3,91,111,202
https://kawalpemilu.org#69139,"BANTUGA, AMPANA TETE, TOJO UNA-UNA, SULAWESI TENGAH",4,67,135,202
https://kawalpemilu.org#69140,"BORONE, AMPANA TETE, TOJO UNA-UNA, SULAWESI TENGAH",1,67,119,186
https://kawalpemilu.org#69140,"BORONE, AMPANA TETE, TOJO UNA-UNA, SULAWESI TENGAH",2,71,101,172
https://kawalpemilu.org#69140,"BORONE, AMPANA TETE, TOJO UNA-UNA, SULAWESI TENGAH",3,89,79,168
https://kawalpemilu.org#69140,"BORONE, AMPANA TETE, TOJO UNA-UNA, SULAWESI TENGAH",4,59,123,182
https://kawalpemilu.org#69141,"BALANGGALA, AMPANA TETE, TOJO UNA-UNA, SULAWESI TENGAH",1,63,107,170
https://kawalpemilu.org#69141,"BALANGGALA, AMPANA TETE, TOJO UNA-UNA, SULAWESI TENGAH",2,54,114,168
https://kawalpemilu.org#69141,"BALANGGALA, AMPANA TETE, TOJO UNA-UNA, SULAWESI TENGAH",3,74,113,187
https://kawalpemilu.org#69141,"BALANGGALA, AMPANA TETE, TOJO UNA-UNA, SULAWESI TENGAH",4,99,80,179
https://kawalpemilu.org#69142,"SABO, AMPANA TETE, TOJO UNA-UNA, SULAWESI TENGAH",1,143,82,225
https://kawalpemilu.org#69142,"SABO, AMPANA TETE, TOJO UNA-UNA, SULAWESI TENGAH",2,149,76,225
https://kawalpemilu.org#69142,"SABO, AMPANA TETE, TOJO UNA-UNA, SULAWESI TENGAH",3,145,78,223
https://kawalpemilu.org#69143,"LONGGE, AMPANA TETE, TOJO UNA-UNA, SULAWESI TENGAH",1,151,74,225
https://kawalpemilu.org#69144,"TAMPABATU, AMPANA TETE, TOJO UNA-UNA, SULAWESI TENGAH",1,122,99,221
https://kawalpemilu.org#69144,"TAMPABATU, AMPANA TETE, TOJO UNA-UNA, SULAWESI TENGAH",2,68,139,207
https://kawalpemilu.org#69144,"TAMPABATU, AMPANA TETE, TOJO UNA-UNA, SULAWESI TENGAH",3,62,119,181
https://kawalpemilu.org#69144,"TAMPABATU, AMPANA TETE, TOJO UNA-UNA, SULAWESI TENGAH",4,54,89,143
https://kawalpemilu.org#69144,"TAMPABATU, AMPANA TETE, TOJO UNA-UNA, SULAWESI TENGAH",5,127,12,139
https://kawalpemilu.org#69145,"URUNDAKA, AMPANA TETE, TOJO UNA-UNA, SULAWESI TENGAH",1,61,146,207
https://kawalpemilu.org#69145,"URUNDAKA, AMPANA TETE, TOJO UNA-UNA, SULAWESI TENGAH",2,104,126,230
https://kawalpemilu.org#69145,"URUNDAKA, AMPANA TETE, TOJO UNA-UNA, SULAWESI TENGAH",3,62,112,174
https://kawalpemilu.org#69145,"URUNDAKA, AMPANA TETE, TOJO UNA-UNA, SULAWESI TENGAH",4,45,111,156
https://kawalpemilu.org#69145,"URUNDAKA, AMPANA TETE, TOJO UNA-UNA, SULAWESI TENGAH",5,61,131,192
https://kawalpemilu.org#69146,"BALINGARA, AMPANA TETE, TOJO UNA-UNA, SULAWESI TENGAH",1,69,92,161
https://kawalpemilu.org#69146,"BALINGARA, AMPANA TETE, TOJO UNA-UNA, SULAWESI TENGAH",2,128,57,185
https://kawalpemilu.org#69146,"BALINGARA, AMPANA TETE, TOJO UNA-UNA, SULAWESI TENGAH",3,78,73,151
https://kawalpemilu.org#69146,"BALINGARA, AMPANA TETE, TOJO UNA-UNA, SULAWESI TENGAH",4,118,36,154
https://kawalpemilu.org#69146,"BALINGARA, AMPANA TETE, TOJO UNA-UNA, SULAWESI TENGAH",5,90,48,138
https://kawalpemilu.org#69147,"BULAN JAYA, AMPANA TETE, TOJO UNA-UNA, SULAWESI TENGAH",1,171,86,257
https://kawalpemilu.org#69147,"BULAN JAYA, AMPANA TETE, TOJO UNA-UNA, SULAWESI TENGAH",2,168,78,246
https://kawalpemilu.org#69147,"BULAN JAYA, AMPANA TETE, TOJO UNA-UNA, SULAWESI TENGAH",3,164,26,190
https://kawalpemilu.org#69148,"GIRI MULYO, AMPANA TETE, TOJO UNA-UNA, SULAWESI TENGAH",1,118,28,146
https://kawalpemilu.org#69148,"GIRI MULYO, AMPANA TETE, TOJO UNA-UNA, SULAWESI TENGAH",2,153,33,186
https://kawalpemilu.org#69148,"GIRI MULYO, AMPANA TETE, TOJO UNA-UNA, SULAWESI TENGAH",3,167,51,218
https://kawalpemilu.org#69149,"WANASARI, AMPANA TETE, TOJO UNA-UNA, SULAWESI TENGAH",1,112,78,190
https://kawalpemilu.org#69149,"WANASARI, AMPANA TETE, TOJO UNA-UNA, SULAWESI TENGAH",2,115,51,166
https://kawalpemilu.org#69149,"WANASARI, AMPANA TETE, TOJO UNA-UNA, SULAWESI TENGAH",3,23,22,45
https://kawalpemilu.org#69150,"KAJULANGKO, AMPANA TETE, TOJO UNA-UNA, SULAWESI TENGAH",1,161,97,258
https://kawalpemilu.org#69150,"KAJULANGKO, AMPANA TETE, TOJO UNA-UNA, SULAWESI TENGAH",2,141,110,251
https://kawalpemilu.org#69150,"KAJULANGKO, AMPANA TETE, TOJO UNA-UNA, SULAWESI TENGAH",3,147,61,208
https://kawalpemilu.org#69150,"KAJULANGKO, AMPANA TETE, TOJO UNA-UNA, SULAWESI TENGAH",4,163,27,190
https://kawalpemilu.org#85726,"UEMAKUNI, AMPANA TETE, TOJO UNA-UNA, SULAWESI TENGAH",1,75,168,243
https://kawalpemilu.org#85726,"UEMAKUNI, AMPANA TETE, TOJO UNA-UNA, SULAWESI TENGAH",2,51,134,185
https://kawalpemilu.org#85726,"UEMAKUNI, AMPANA TETE, TOJO UNA-UNA, SULAWESI TENGAH",3,76,89,165
https://kawalpemilu.org#85727,"MPOA, AMPANA TETE, TOJO UNA-UNA, SULAWESI TENGAH",1,122,43,165
https://kawalpemilu.org#85727,"MPOA, AMPANA TETE, TOJO UNA-UNA, SULAWESI TENGAH",2,149,20,169
https://kawalpemilu.org#89740,"SUKAMAJU, AMPANA TETE, TOJO UNA-UNA, SULAWESI TENGAH",1,159,55,214
https://kawalpemilu.org#89740,"SUKAMAJU, AMPANA TETE, TOJO UNA-UNA, SULAWESI TENGAH",2,103,47,150
https://kawalpemilu.org#89740,"SUKAMAJU, AMPANA TETE, TOJO UNA-UNA, SULAWESI TENGAH",3,92,74,166
https://kawalpemilu.org#69152,"MALOTONG, AMPANA KOTA, TOJO UNA-UNA, SULAWESI TENGAH",1,95,121,216
https://kawalpemilu.org#69152,"MALOTONG, AMPANA KOTA, TOJO UNA-UNA, SULAWESI TENGAH",2,67,131,198
https://kawalpemilu.org#69152,"MALOTONG, AMPANA KOTA, TOJO UNA-UNA, SULAWESI TENGAH",3,115,73,188
https://kawalpemilu.org#69152,"MALOTONG, AMPANA KOTA, TOJO UNA-UNA, SULAWESI TENGAH",4,90,145,235
https://kawalpemilu.org#69152,"MALOTONG, AMPANA KOTA, TOJO UNA-UNA, SULAWESI TENGAH",5,96,133,229
https://kawalpemilu.org#69152,"MALOTONG, AMPANA KOTA, TOJO UNA-UNA, SULAWESI TENGAH",6,52,127,179
https://kawalpemilu.org#69152,"MALOTONG, AMPANA KOTA, TOJO UNA-UNA, SULAWESI TENGAH",7,53,92,145
https://kawalpemilu.org#69153,"BAILO, AMPANA KOTA, TOJO UNA-UNA, SULAWESI TENGAH",1,35,88,123
https://kawalpemilu.org#69153,"BAILO, AMPANA KOTA, TOJO UNA-UNA, SULAWESI TENGAH",2,31,64,95
https://kawalpemilu.org#69153,"BAILO, AMPANA KOTA, TOJO UNA-UNA, SULAWESI TENGAH",3,25,78,103
https://kawalpemilu.org#69153,"BAILO, AMPANA KOTA, TOJO UNA-UNA, SULAWESI TENGAH",4,43,106,149
https://kawalpemilu.org#69153,"BAILO, AMPANA KOTA, TOJO UNA-UNA, SULAWESI TENGAH",5,52,156,208
https://kawalpemilu.org#69153,"BAILO, AMPANA KOTA, TOJO UNA-UNA, SULAWESI TENGAH",6,33,159,192
https://kawalpemilu.org#69153,"BAILO, AMPANA KOTA, TOJO UNA-UNA, SULAWESI TENGAH",7,62,73,135
https://kawalpemilu.org#69153,"BAILO, AMPANA KOTA, TOJO UNA-UNA, SULAWESI TENGAH",8,34,80,114
https://kawalpemilu.org#69154,"AMPANA, AMPANA KOTA, TOJO UNA-UNA, SULAWESI TENGAH",1,45,88,133
https://kawalpemilu.org#69154,"AMPANA, AMPANA KOTA, TOJO UNA-UNA, SULAWESI TENGAH",2,44,74,118
https://kawalpemilu.org#69154,"AMPANA, AMPANA KOTA, TOJO UNA-UNA, SULAWESI TENGAH",3,25,61,86
https://kawalpemilu.org#69154,"AMPANA, AMPANA KOTA, TOJO UNA-UNA, SULAWESI TENGAH",4,38,100,138
https://kawalpemilu.org#69154,"AMPANA, AMPANA KOTA, TOJO UNA-UNA, SULAWESI TENGAH",5,50,46,96
https://kawalpemilu.org#69154,"AMPANA, AMPANA KOTA, TOJO UNA-UNA, SULAWESI TENGAH",6,69,82,151
https://kawalpemilu.org#69154,"AMPANA, AMPANA KOTA, TOJO UNA-UNA, SULAWESI TENGAH",7,40,112,152
https://kawalpemilu.org#69154,"AMPANA, AMPANA KOTA, TOJO UNA-UNA, SULAWESI TENGAH",8,93,90,183
https://kawalpemilu.org#69154,"AMPANA, AMPANA KOTA, TOJO UNA-UNA, SULAWESI TENGAH",9,81,125,206
https://kawalpemilu.org#69154,"AMPANA, AMPANA KOTA, TOJO UNA-UNA, SULAWESI TENGAH",10,28,107,135
https://kawalpemilu.org#69154,"AMPANA, AMPANA KOTA, TOJO UNA-UNA, SULAWESI TENGAH",11,72,111,183
https://kawalpemilu.org#69154,"AMPANA, AMPANA KOTA, TOJO UNA-UNA, SULAWESI TENGAH",12,33,115,148
https://kawalpemilu.org#69154,"AMPANA, AMPANA KOTA, TOJO UNA-UNA, SULAWESI TENGAH",13,18,64,82
https://kawalpemilu.org#69154,"AMPANA, AMPANA KOTA, TOJO UNA-UNA, SULAWESI TENGAH",14,53,125,178
https://kawalpemilu.org#69154,"AMPANA, AMPANA KOTA, TOJO UNA-UNA, SULAWESI TENGAH",15,43,75,118
https://kawalpemilu.org#69158,"SANSARINO, AMPANA KOTA, TOJO UNA-UNA, SULAWESI TENGAH",1,85,160,245
https://kawalpemilu.org#69158,"SANSARINO, AMPANA KOTA, TOJO UNA-UNA, SULAWESI TENGAH",2,59,100,159
https://kawalpemilu.org#69158,"SANSARINO, AMPANA KOTA, TOJO UNA-UNA, SULAWESI TENGAH",3,86,114,200
https://kawalpemilu.org#69158,"SANSARINO, AMPANA KOTA, TOJO UNA-UNA, SULAWESI TENGAH",4,94,108,202
https://kawalpemilu.org#69158,"SANSARINO, AMPANA KOTA, TOJO UNA-UNA, SULAWESI TENGAH",5,67,90,157
https://kawalpemilu.org#69158,"SANSARINO, AMPANA KOTA, TOJO UNA-UNA, SULAWESI TENGAH",6,83,77,160
https://kawalpemilu.org#69158,"SANSARINO, AMPANA KOTA, TOJO UNA-UNA, SULAWESI TENGAH",7,140,76,216
https://kawalpemilu.org#69162,"PADANG TUMBUO, AMPANA KOTA, TOJO UNA-UNA, SULAWESI TENGAH",1,120,81,201
https://kawalpemilu.org#69162,"PADANG TUMBUO, AMPANA KOTA, TOJO UNA-UNA, SULAWESI TENGAH",2,78,120,198
https://kawalpemilu.org#69162,"PADANG TUMBUO, AMPANA KOTA, TOJO UNA-UNA, SULAWESI TENGAH",3,95,115,210
https://kawalpemilu.org#69162,"PADANG TUMBUO, AMPANA KOTA, TOJO UNA-UNA, SULAWESI TENGAH",4,97,104,201
https://kawalpemilu.org#69162,"PADANG TUMBUO, AMPANA KOTA, TOJO UNA-UNA, SULAWESI TENGAH",5,142,64,206
https://kawalpemilu.org#69162,"PADANG TUMBUO, AMPANA KOTA, TOJO UNA-UNA, SULAWESI TENGAH",6,142,58,200
https://kawalpemilu.org#85728,"BONE RATO, AMPANA KOTA, TOJO UNA-UNA, SULAWESI TENGAH",1,77,80,157
https://kawalpemilu.org#85728,"BONE RATO, AMPANA KOTA, TOJO UNA-UNA, SULAWESI TENGAH",2,35,57,92
https://kawalpemilu.org#85728,"BONE RATO, AMPANA KOTA, TOJO UNA-UNA, SULAWESI TENGAH",3,69,89,158
https://kawalpemilu.org#85728,"BONE RATO, AMPANA KOTA, TOJO UNA-UNA, SULAWESI TENGAH",4,82,88,170
https://kawalpemilu.org#85728,"BONE RATO, AMPANA KOTA, TOJO UNA-UNA, SULAWESI TENGAH",5,49,160,209
https://kawalpemilu.org#85728,"BONE RATO, AMPANA KOTA, TOJO UNA-UNA, SULAWESI TENGAH",6,72,111,183
https://kawalpemilu.org#85729,"BAILO BARU, AMPANA KOTA, TOJO UNA-UNA, SULAWESI TENGAH",1,69,115,184
https://kawalpemilu.org#85729,"BAILO BARU, AMPANA KOTA, TOJO UNA-UNA, SULAWESI TENGAH",2,82,132,214
https://kawalpemilu.org#85729,"BAILO BARU, AMPANA KOTA, TOJO UNA-UNA, SULAWESI TENGAH",3,90,85,175
https://kawalpemilu.org#85729,"BAILO BARU, AMPANA KOTA, TOJO UNA-UNA, SULAWESI TENGAH",4,107,81,188
https://kawalpemilu.org#85729,"BAILO BARU, AMPANA KOTA, TOJO UNA-UNA, SULAWESI TENGAH",5,89,67,156
https://kawalpemilu.org#85729,"BAILO BARU, AMPANA KOTA, TOJO UNA-UNA, SULAWESI TENGAH",6,95,114,209
https://kawalpemilu.org#85730,"LABIABAE, AMPANA KOTA, TOJO UNA-UNA, SULAWESI TENGAH",1,54,105,159
https://kawalpemilu.org#85730,"LABIABAE, AMPANA KOTA, TOJO UNA-UNA, SULAWESI TENGAH",2,45,139,184
https://kawalpemilu.org#85730,"LABIABAE, AMPANA KOTA, TOJO UNA-UNA, SULAWESI TENGAH",3,65,154,219
https://kawalpemilu.org#85730,"LABIABAE, AMPANA KOTA, TOJO UNA-UNA, SULAWESI TENGAH",4,41,123,164
https://kawalpemilu.org#85730,"LABIABAE, AMPANA KOTA, TOJO UNA-UNA, SULAWESI TENGAH",5,64,129,193
https://kawalpemilu.org#85730,"LABIABAE, AMPANA KOTA, TOJO UNA-UNA, SULAWESI TENGAH",6,40,89,129
https://kawalpemilu.org#85734,"SALUABA, AMPANA KOTA, TOJO UNA-UNA, SULAWESI TENGAH",1,88,85,173
https://kawalpemilu.org#85734,"SALUABA, AMPANA KOTA, TOJO UNA-UNA, SULAWESI TENGAH",2,115,62,177
https://kawalpemilu.org#85734,"SALUABA, AMPANA KOTA, TOJO UNA-UNA, SULAWESI TENGAH",3,159,62,221
https://kawalpemilu.org#85735,"BUNTONGI, AMPANA KOTA, TOJO UNA-UNA, SULAWESI TENGAH",1,118,109,227
https://kawalpemilu.org#85735,"BUNTONGI, AMPANA KOTA, TOJO UNA-UNA, SULAWESI TENGAH",2,115,102,217
https://kawalpemilu.org#85735,"BUNTONGI, AMPANA KOTA, TOJO UNA-UNA, SULAWESI TENGAH",3,150,90,240
https://kawalpemilu.org#69164,"TAMPANOMBO, ULUBONGKA, TOJO UNA-UNA, SULAWESI TENGAH",1,115,93,208
https://kawalpemilu.org#69164,"TAMPANOMBO, ULUBONGKA, TOJO UNA-UNA, SULAWESI TENGAH",2,98,54,152
https://kawalpemilu.org#69165,"BONEBAE II, ULUBONGKA, TOJO UNA-UNA, SULAWESI TENGAH",1,47,199,246
https://kawalpemilu.org#69165,"BONEBAE II, ULUBONGKA, TOJO UNA-UNA, SULAWESI TENGAH",2,33,171,204
https://kawalpemilu.org#69166,"TOBAMAU, ULUBONGKA, TOJO UNA-UNA, SULAWESI TENGAH",1,230,27,257
https://kawalpemilu.org#69167,"ROMPI, ULUBONGKA, TOJO UNA-UNA, SULAWESI TENGAH",1,179,42,221
https://kawalpemilu.org#69168,"UEMATOPA, ULUBONGKA, TOJO UNA-UNA, SULAWESI TENGAH",1,175,14,190
https://kawalpemilu.org#69168,"UEMATOPA, ULUBONGKA, TOJO UNA-UNA, SULAWESI TENGAH",2,146,15,161
https://kawalpemilu.org#69168,"UEMATOPA, ULUBONGKA, TOJO UNA-UNA, SULAWESI TENGAH",3,117,55,172
https://kawalpemilu.org#69168,"UEMATOPA, ULUBONGKA, TOJO UNA-UNA, SULAWESI TENGAH",4,93,14,107
https://kawalpemilu.org#69169,"UEKAMBUNO, ULUBONGKA, TOJO UNA-UNA, SULAWESI TENGAH",1,85,109,194
https://kawalpemilu.org#69169,"UEKAMBUNO, ULUBONGKA, TOJO UNA-UNA, SULAWESI TENGAH",2,103,117,220
https://kawalpemilu.org#69170,"PARANONGE, ULUBONGKA, TOJO UNA-UNA, SULAWESI TENGAH",1,150,7,157
https://kawalpemilu.org#69170,"PARANONGE, ULUBONGKA, TOJO UNA-UNA, SULAWESI TENGAH",2,84,4,88
https://kawalpemilu.org#69171,"BONEBAE I, ULUBONGKA, TOJO UNA-UNA, SULAWESI TENGAH",1,156,7,163
https://kawalpemilu.org#69171,"BONEBAE I, ULUBONGKA, TOJO UNA-UNA, SULAWESI TENGAH",2,122,11,133
https://kawalpemilu.org#69172,"WATUSONGU, ULUBONGKA, TOJO UNA-UNA, SULAWESI TENGAH",1,200,11,211
https://kawalpemilu.org#69172,"WATUSONGU, ULUBONGKA, TOJO UNA-UNA, SULAWESI TENGAH",2,224,3,227
https://kawalpemilu.org#69173,"MIRE, ULUBONGKA, TOJO UNA-UNA, SULAWESI TENGAH",1,101,97,198
https://kawalpemilu.org#69173,"MIRE, ULUBONGKA, TOJO UNA-UNA, SULAWESI TENGAH",2,138,92,230
https://kawalpemilu.org#69173,"MIRE, ULUBONGKA, TOJO UNA-UNA, SULAWESI TENGAH",3,77,91,168
https://kawalpemilu.org#69174,"MAROWO, ULUBONGKA, TOJO UNA-UNA, SULAWESI TENGAH",1,113,95,208
https://kawalpemilu.org#69174,"MAROWO, ULUBONGKA, TOJO UNA-UNA, SULAWESI TENGAH",2,82,83,165
https://kawalpemilu.org#69174,"MAROWO, ULUBONGKA, TOJO UNA-UNA, SULAWESI TENGAH",3,85,126,211
https://kawalpemilu.org#69174,"MAROWO, ULUBONGKA, TOJO UNA-UNA, SULAWESI TENGAH",4,109,131,240
https://kawalpemilu.org#69174,"MAROWO, ULUBONGKA, TOJO UNA-UNA, SULAWESI TENGAH",5,148,80,228
https://kawalpemilu.org#69174,"MAROWO, ULUBONGKA, TOJO UNA-UNA, SULAWESI TENGAH",6,102,144,246
https://kawalpemilu.org#69175,"BORNEANG, ULUBONGKA, TOJO UNA-UNA, SULAWESI TENGAH",1,110,94,204
https://kawalpemilu.org#69175,"BORNEANG, ULUBONGKA, TOJO UNA-UNA, SULAWESI TENGAH",2,44,148,192
https://kawalpemilu.org#69175,"BORNEANG, ULUBONGKA, TOJO UNA-UNA, SULAWESI TENGAH",3,159,25,184
https://kawalpemilu.org#69175,"BORNEANG, ULUBONGKA, TOJO UNA-UNA, SULAWESI TENGAH",4,172,34,206
https://kawalpemilu.org#69176,"BONGKA MAKMUR, ULUBONGKA, TOJO UNA-UNA, SULAWESI TENGAH",1,101,112,213
https://kawalpemilu.org#69176,"BONGKA MAKMUR, ULUBONGKA, TOJO UNA-UNA, SULAWESI TENGAH",2,39,181,220
https://kawalpemilu.org#69176,"BONGKA MAKMUR, ULUBONGKA, TOJO UNA-UNA, SULAWESI TENGAH",3,85,102,187
https://kawalpemilu.org#69176,"BONGKA MAKMUR, ULUBONGKA, TOJO UNA-UNA, SULAWESI TENGAH",4,103,103,206
https://kawalpemilu.org#69177,"CEMPA, ULUBONGKA, TOJO UNA-UNA, SULAWESI TENGAH",1,79,86,165
https://kawalpemilu.org#69177,"CEMPA, ULUBONGKA, TOJO UNA-UNA, SULAWESI TENGAH",2,95,94,189
https://kawalpemilu.org#69178,"BONEVOTO, ULUBONGKA, TOJO UNA-UNA, SULAWESI TENGAH",1,153,105,258
https://kawalpemilu.org#69178,"BONEVOTO, ULUBONGKA, TOJO UNA-UNA, SULAWESI TENGAH",2,119,110,229
https://kawalpemilu.org#69178,"BONEVOTO, ULUBONGKA, TOJO UNA-UNA, SULAWESI TENGAH",3,138,100,238
https://kawalpemilu.org#69178,"BONEVOTO, ULUBONGKA, TOJO UNA-UNA, SULAWESI TENGAH",4,154,58,212
https://kawalpemilu.org#69178,"BONEVOTO, ULUBONGKA, TOJO UNA-UNA, SULAWESI TENGAH",5,64,134,198
https://kawalpemilu.org#69179,"BONGKAKOY, ULUBONGKA, TOJO UNA-UNA, SULAWESI TENGAH",1,144,61,205
https://kawalpemilu.org#69179,"BONGKAKOY, ULUBONGKA, TOJO UNA-UNA, SULAWESI TENGAH",2,128,38,166
https://kawalpemilu.org#69180,"TAKIBANGKE, ULUBONGKA, TOJO UNA-UNA, SULAWESI TENGAH",1,200,57,257
https://kawalpemilu.org#69180,"TAKIBANGKE, ULUBONGKA, TOJO UNA-UNA, SULAWESI TENGAH",2,156,69,225
https://kawalpemilu.org#69180,"TAKIBANGKE, ULUBONGKA, TOJO UNA-UNA, SULAWESI TENGAH",3,74,40,114
https://kawalpemilu.org#69180,"TAKIBANGKE, ULUBONGKA, TOJO UNA-UNA, SULAWESI TENGAH",4,53,67,120
https://kawalpemilu.org#69180,"TAKIBANGKE, ULUBONGKA, TOJO UNA-UNA, SULAWESI TENGAH",5,64,64,128
https://kawalpemilu.org#85737,"KASIALA, ULUBONGKA, TOJO UNA-UNA, SULAWESI TENGAH",1,194,6,200
https://kawalpemilu.org#85737,"KASIALA, ULUBONGKA, TOJO UNA-UNA, SULAWESI TENGAH",2,197,3,200
https://kawalpemilu.org#85737,"KASIALA, ULUBONGKA, TOJO UNA-UNA, SULAWESI TENGAH",3,189,4,193
https://kawalpemilu.org#85737,"KASIALA, ULUBONGKA, TOJO UNA-UNA, SULAWESI TENGAH",4,61,0,61
https://kawalpemilu.org#85737,"KASIALA, ULUBONGKA, TOJO UNA-UNA, SULAWESI TENGAH",5,92,12,104
https://kawalpemilu.org#85737,"KASIALA, ULUBONGKA, TOJO UNA-UNA, SULAWESI TENGAH",6,67,3,70
https://kawalpemilu.org#85737,"KASIALA, ULUBONGKA, TOJO UNA-UNA, SULAWESI TENGAH",7,53,52,105
https://kawalpemilu.org#69182,"MALEI TOJO, TOJO BARAT, TOJO UNA-UNA, SULAWESI TENGAH",1,23,175,198
https://kawalpemilu.org#69182,"MALEI TOJO, TOJO BARAT, TOJO UNA-UNA, SULAWESI TENGAH",2,63,100,163
https://kawalpemilu.org#69182,"MALEI TOJO, TOJO BARAT, TOJO UNA-UNA, SULAWESI TENGAH",3,63,95,158
https://kawalpemilu.org#69182,"MALEI TOJO, TOJO BARAT, TOJO UNA-UNA, SULAWESI TENGAH",4,94,95,189
https://kawalpemilu.org#69183,"MATAKO, TOJO BARAT, TOJO UNA-UNA, SULAWESI TENGAH",1,160,67,227
https://kawalpemilu.org#69183,"MATAKO, TOJO BARAT, TOJO UNA-UNA, SULAWESI TENGAH",2,159,13,172
https://kawalpemilu.org#69183,"MATAKO, TOJO BARAT, TOJO UNA-UNA, SULAWESI TENGAH",3,200,24,224
https://kawalpemilu.org#69183,"MATAKO, TOJO BARAT, TOJO UNA-UNA, SULAWESI TENGAH",4,168,30,198
https://kawalpemilu.org#69183,"MATAKO, TOJO BARAT, TOJO UNA-UNA, SULAWESI TENGAH",5,202,38,240
https://kawalpemilu.org#69183,"MATAKO, TOJO BARAT, TOJO UNA-UNA, SULAWESI TENGAH",6,178,29,207
https://kawalpemilu.org#69183,"MATAKO, TOJO BARAT, TOJO UNA-UNA, SULAWESI TENGAH",7,179,58,237
https://kawalpemilu.org#69184,"BAMBALO, TOJO BARAT, TOJO UNA-UNA, SULAWESI TENGAH",1,77,69,0
https://kawalpemilu.org#69184,"BAMBALO, TOJO BARAT, TOJO UNA-UNA, SULAWESI TENGAH",2,47,83,130
https://kawalpemilu.org#69185,"GALUGA, TOJO BARAT, TOJO UNA-UNA, SULAWESI TENGAH",1,105,77,182
https://kawalpemilu.org#69185,"GALUGA, TOJO BARAT, TOJO UNA-UNA, SULAWESI TENGAH",2,183,9,192
https://kawalpemilu.org#69185,"GALUGA, TOJO BARAT, TOJO UNA-UNA, SULAWESI TENGAH",3,68,54,122
https://kawalpemilu.org#69186,"TOLIBA, TOJO BARAT, TOJO UNA-UNA, SULAWESI TENGAH",1,63,180,243
https://kawalpemilu.org#69186,"TOLIBA, TOJO BARAT, TOJO UNA-UNA, SULAWESI TENGAH",2,50,136,186
https://kawalpemilu.org#69186,"TOLIBA, TOJO BARAT, TOJO UNA-UNA, SULAWESI TENGAH",3,100,109,209
https://kawalpemilu.org#69187,"UJUNG TIBU, TOJO BARAT, TOJO UNA-UNA, SULAWESI TENGAH",1,43,175,218
https://kawalpemilu.org#69187,"UJUNG TIBU, TOJO BARAT, TOJO UNA-UNA, SULAWESI TENGAH",2,45,172,217
https://kawalpemilu.org#69187,"UJUNG TIBU, TOJO BARAT, TOJO UNA-UNA, SULAWESI TENGAH",3,74,134,208
https://kawalpemilu.org#69188,"NGGAWIA, TOJO BARAT, TOJO UNA-UNA, SULAWESI TENGAH",1,94,165,259
https://kawalpemilu.org#69188,"NGGAWIA, TOJO BARAT, TOJO UNA-UNA, SULAWESI TENGAH",2,0,0,0
https://kawalpemilu.org#69188,"NGGAWIA, TOJO BARAT, TOJO UNA-UNA, SULAWESI TENGAH",3,80,167,247
https://kawalpemilu.org#69188,"NGGAWIA, TOJO BARAT, TOJO UNA-UNA, SULAWESI TENGAH",4,51,93,144
https://kawalpemilu.org#69189,"TOMBIANO, TOJO BARAT, TOJO UNA-UNA, SULAWESI TENGAH",1,74,130,204
https://kawalpemilu.org#69189,"TOMBIANO, TOJO BARAT, TOJO UNA-UNA, SULAWESI TENGAH",2,69,197,266
https://kawalpemilu.org#69189,"TOMBIANO, TOJO BARAT, TOJO UNA-UNA, SULAWESI TENGAH",3,115,148,263
https://kawalpemilu.org#69189,"TOMBIANO, TOJO BARAT, TOJO UNA-UNA, SULAWESI TENGAH",4,79,176,255
https://kawalpemilu.org#69189,"TOMBIANO, TOJO BARAT, TOJO UNA-UNA, SULAWESI TENGAH",5,49,20,69
https://kawalpemilu.org#69189,"TOMBIANO, TOJO BARAT, TOJO UNA-UNA, SULAWESI TENGAH",6,29,60,89
https://kawalpemilu.org#69190,"TATARI, TOJO BARAT, TOJO UNA-UNA, SULAWESI TENGAH",1,67,55,122
https://kawalpemilu.org#69190,"TATARI, TOJO BARAT, TOJO UNA-UNA, SULAWESI TENGAH",2,47,86,133
https://kawalpemilu.org#69191,"KABALO, TOJO BARAT, TOJO UNA-UNA, SULAWESI TENGAH",1,122,128,250
https://kawalpemilu.org#69191,"KABALO, TOJO BARAT, TOJO UNA-UNA, SULAWESI TENGAH",2,36,118,154
https://kawalpemilu.org#69192,"TANAMAWAU, TOJO BARAT, TOJO UNA-UNA, SULAWESI TENGAH",1,192,19,211
https://kawalpemilu.org#69193,"MALEWA, TOJO BARAT, TOJO UNA-UNA, SULAWESI TENGAH",1,101,29,130
https://kawalpemilu.org#69193,"MALEWA, TOJO BARAT, TOJO UNA-UNA, SULAWESI TENGAH",2,150,8,158
https://kawalpemilu.org#69194,"MAWOMBA, TOJO BARAT, TOJO UNA-UNA, SULAWESI TENGAH",1,55,111,166
https://kawalpemilu.org#69194,"MAWOMBA, TOJO BARAT, TOJO UNA-UNA, SULAWESI TENGAH",2,66,126,192
https://kawalpemilu.org#69194,"MAWOMBA, TOJO BARAT, TOJO UNA-UNA, SULAWESI TENGAH",3,72,82,154
https://kawalpemilu.org#69196,"LEMORO, TOJO, TOJO UNA-UNA, SULAWESI TENGAH",1,96,79,175
https://kawalpemilu.org#69196,"LEMORO, TOJO, TOJO UNA-UNA, SULAWESI TENGAH",2,92,89,181
https://kawalpemilu.org#69196,"LEMORO, TOJO, TOJO UNA-UNA, SULAWESI TENGAH",3,109,82,191
https://kawalpemilu.org#69197,"KORONDODA, TOJO, TOJO UNA-UNA, SULAWESI TENGAH",1,84,16,100
https://kawalpemilu.org#69197,"KORONDODA, TOJO, TOJO UNA-UNA, SULAWESI TENGAH",2,100,39,139
https://kawalpemilu.org#69198,"TAYAWA, TOJO, TOJO UNA-UNA, SULAWESI TENGAH",1,59,89,148
https://kawalpemilu.org#69198,"TAYAWA, TOJO, TOJO UNA-UNA, SULAWESI TENGAH",2,58,98,156
https://kawalpemilu.org#69198,"TAYAWA, TOJO, TOJO UNA-UNA, SULAWESI TENGAH",3,55,122,177
https://kawalpemilu.org#69198,"TAYAWA, TOJO, TOJO UNA-UNA, SULAWESI TENGAH",4,48,90,138
https://kawalpemilu.org#69198,"TAYAWA, TOJO, TOJO UNA-UNA, SULAWESI TENGAH",5,44,90,134
https://kawalpemilu.org#69199,"UEKULI, TOJO, TOJO UNA-UNA, SULAWESI TENGAH",1,44,150,194
https://kawalpemilu.org#69199,"UEKULI, TOJO, TOJO UNA-UNA, SULAWESI TENGAH",2,40,145,185
https://kawalpemilu.org#69199,"UEKULI, TOJO, TOJO UNA-UNA, SULAWESI TENGAH",3,33,162,195
https://kawalpemilu.org#69199,"UEKULI, TOJO, TOJO UNA-UNA, SULAWESI TENGAH",4,48,175,223
https://kawalpemilu.org#69199,"UEKULI, TOJO, TOJO UNA-UNA, SULAWESI TENGAH",5,74,165,239
https://kawalpemilu.org#69200,"BETAUA, TOJO, TOJO UNA-UNA, SULAWESI TENGAH",1,122,59,181
https://kawalpemilu.org#69200,"BETAUA, TOJO, TOJO UNA-UNA, SULAWESI TENGAH",2,145,63,208
https://kawalpemilu.org#69200,"BETAUA, TOJO, TOJO UNA-UNA, SULAWESI TENGAH",3,110,96,206
https://kawalpemilu.org#69200,"BETAUA, TOJO, TOJO UNA-UNA, SULAWESI TENGAH",4,81,10,91
https://kawalpemilu.org#69201,"UEDELE, TOJO, TOJO UNA-UNA, SULAWESI TENGAH",1,87,143,230
https://kawalpemilu.org#69201,"UEDELE, TOJO, TOJO UNA-UNA, SULAWESI TENGAH",2,66,135,201
https://kawalpemilu.org#69201,"UEDELE, TOJO, TOJO UNA-UNA, SULAWESI TENGAH",4,85,145,230
https://kawalpemilu.org#69202,"SANDADA, TOJO, TOJO UNA-UNA, SULAWESI TENGAH",2,68,128,196
https://kawalpemilu.org#69202,"SANDADA, TOJO, TOJO UNA-UNA, SULAWESI TENGAH",3,79,145,224
https://kawalpemilu.org#69203,"TOJO, TOJO, TOJO UNA-UNA, SULAWESI TENGAH",1,72,101,173
https://kawalpemilu.org#69203,"TOJO, TOJO, TOJO UNA-UNA, SULAWESI TENGAH",2,53,83,136
https://kawalpemilu.org#69203,"TOJO, TOJO, TOJO UNA-UNA, SULAWESI TENGAH",3,39,85,124
https://kawalpemilu.org#69203,"TOJO, TOJO, TOJO UNA-UNA, SULAWESI TENGAH",4,89,90,179
https://kawalpemilu.org#69203,"TOJO, TOJO, TOJO UNA-UNA, SULAWESI TENGAH",5,87,110,197
https://kawalpemilu.org#69203,"TOJO, TOJO, TOJO UNA-UNA, SULAWESI TENGAH",6,0,12,12
https://kawalpemilu.org#69203,"TOJO, TOJO, TOJO UNA-UNA, SULAWESI TENGAH",7,4,44,48
https://kawalpemilu.org#69204,"PANCUMA, TOJO, TOJO UNA-UNA, SULAWESI TENGAH",1,53,109,162
https://kawalpemilu.org#69204,"PANCUMA, TOJO, TOJO UNA-UNA, SULAWESI TENGAH",2,37,106,143
https://kawalpemilu.org#69204,"PANCUMA, TOJO, TOJO UNA-UNA, SULAWESI TENGAH",3,32,124,156
https://kawalpemilu.org#69205,"TONGKU, TOJO, TOJO UNA-UNA, SULAWESI TENGAH",1,87,94,181
https://kawalpemilu.org#69205,"TONGKU, TOJO, TOJO UNA-UNA, SULAWESI TENGAH",2,82,101,183
https://kawalpemilu.org#69206,"PODI, TOJO, TOJO UNA-UNA, SULAWESI TENGAH",1,70,101,171
https://kawalpemilu.org#69206,"PODI, TOJO, TOJO UNA-UNA, SULAWESI TENGAH",2,101,116,217
https://kawalpemilu.org#69206,"PODI, TOJO, TOJO UNA-UNA, SULAWESI TENGAH",3,41,98,139
https://kawalpemilu.org#69206,"PODI, TOJO, TOJO UNA-UNA, SULAWESI TENGAH",4,50,97,147
https://kawalpemilu.org#69207,"DATARAN BUGI, TOJO, TOJO UNA-UNA, SULAWESI TENGAH",1,94,35,129
https://kawalpemilu.org#69207,"DATARAN BUGI, TOJO, TOJO UNA-UNA, SULAWESI TENGAH",2,71,36,107
https://kawalpemilu.org#69208,"BANANO, TOJO, TOJO UNA-UNA, SULAWESI TENGAH",1,86,119,205
https://kawalpemilu.org#85738,"BUYUNTARIPA, TOJO, TOJO UNA-UNA, SULAWESI TENGAH",1,171,4,175
https://kawalpemilu.org#89741,"KALEMBA, TOJO, TOJO UNA-UNA, SULAWESI TENGAH",1,76,28,104
https://kawalpemilu.org#89741,"KALEMBA, TOJO, TOJO UNA-UNA, SULAWESI TENGAH",2,44,9,53
https://kawalpemilu.org#93162,"BAHARI, TOJO, TOJO UNA-UNA, SULAWESI TENGAH",1,42,165,207
https://kawalpemilu.org#93162,"BAHARI, TOJO, TOJO UNA-UNA, SULAWESI TENGAH",2,51,99,150
https://kawalpemilu.org#93162,"BAHARI, TOJO, TOJO UNA-UNA, SULAWESI TENGAH",3,34,116,150
https://kawalpemilu.org#69213,"PASOKAN, WALEA BESAR, TOJO UNA-UNA, SULAWESI TENGAH",1,66,112,178
https://kawalpemilu.org#69213,"PASOKAN, WALEA BESAR, TOJO UNA-UNA, SULAWESI TENGAH",2,42,116,158
https://kawalpemilu.org#69213,"PASOKAN, WALEA BESAR, TOJO UNA-UNA, SULAWESI TENGAH",3,29,131,160
https://kawalpemilu.org#69213,"PASOKAN, WALEA BESAR, TOJO UNA-UNA, SULAWESI TENGAH",4,21,82,103
https://kawalpemilu.org#69213,"PASOKAN, WALEA BESAR, TOJO UNA-UNA, SULAWESI TENGAH",5,20,153,173
https://kawalpemilu.org#69213,"PASOKAN, WALEA BESAR, TOJO UNA-UNA, SULAWESI TENGAH",6,29,147,2
https://kawalpemilu.org#69214,"KONDONGAN, WALEA BESAR, TOJO UNA-UNA, SULAWESI TENGAH",1,61,106,167
https://kawalpemilu.org#69214,"KONDONGAN, WALEA BESAR, TOJO UNA-UNA, SULAWESI TENGAH",2,38,108,146
https://kawalpemilu.org#69215,"KATOGOP, WALEA BESAR, TOJO UNA-UNA, SULAWESI TENGAH",1,94,34,128
https://kawalpemilu.org#69215,"KATOGOP, WALEA BESAR, TOJO UNA-UNA, SULAWESI TENGAH",2,75,40,115
https://kawalpemilu.org#69215,"KATOGOP, WALEA BESAR, TOJO UNA-UNA, SULAWESI TENGAH",3,94,15,109
https://kawalpemilu.org#69216,"MALAPO, WALEA BESAR, TOJO UNA-UNA, SULAWESI TENGAH",1,49,90,139
https://kawalpemilu.org#69217,"SALINGGOHA, WALEA BESAR, TOJO UNA-UNA, SULAWESI TENGAH",1,38,34,72
https://kawalpemilu.org#69217,"SALINGGOHA, WALEA BESAR, TOJO UNA-UNA, SULAWESI TENGAH",2,32,52,84
https://kawalpemilu.org#69218,"TINGKI, WALEA BESAR, TOJO UNA-UNA, SULAWESI TENGAH",1,105,53,158
https://kawalpemilu.org#69219,"BIGA, WALEA BESAR, TOJO UNA-UNA, SULAWESI TENGAH",1,9,157,166
https://kawalpemilu.org#69219,"BIGA, WALEA BESAR, TOJO UNA-UNA, SULAWESI TENGAH",2,28,170,198
https://kawalpemilu.org#85739,"TONGIDON, WALEA BESAR, TOJO UNA-UNA, SULAWESI TENGAH",1,115,58,173
https://kawalpemilu.org#69155,"UENTANAGA ATAS, RATOLINDO, TOJO UNA-UNA, SULAWESI TENGAH",1,79,124,203
https://kawalpemilu.org#69155,"UENTANAGA ATAS, RATOLINDO, TOJO UNA-UNA, SULAWESI TENGAH",2,51,119,170
https://kawalpemilu.org#69155,"UENTANAGA ATAS, RATOLINDO, TOJO UNA-UNA, SULAWESI TENGAH",3,78,143,221
https://kawalpemilu.org#69155,"UENTANAGA ATAS, RATOLINDO, TOJO UNA-UNA, SULAWESI TENGAH",4,71,147,218
https://kawalpemilu.org#69155,"UENTANAGA ATAS, RATOLINDO, TOJO UNA-UNA, SULAWESI TENGAH",5,90,131,221
https://kawalpemilu.org#69155,"UENTANAGA ATAS, RATOLINDO, TOJO UNA-UNA, SULAWESI TENGAH",6,64,87,151
https://kawalpemilu.org#69155,"UENTANAGA ATAS, RATOLINDO, TOJO UNA-UNA, SULAWESI TENGAH",7,74,85,159
https://kawalpemilu.org#69155,"UENTANAGA ATAS, RATOLINDO, TOJO UNA-UNA, SULAWESI TENGAH",8,87,104,191
https://kawalpemilu.org#69155,"UENTANAGA ATAS, RATOLINDO, TOJO UNA-UNA, SULAWESI TENGAH",9,80,131,211
https://kawalpemilu.org#69155,"UENTANAGA ATAS, RATOLINDO, TOJO UNA-UNA, SULAWESI TENGAH",10,100,132,232
https://kawalpemilu.org#69155,"UENTANAGA ATAS, RATOLINDO, TOJO UNA-UNA, SULAWESI TENGAH",11,105,89,194
https://kawalpemilu.org#69155,"UENTANAGA ATAS, RATOLINDO, TOJO UNA-UNA, SULAWESI TENGAH",12,55,143,198
https://kawalpemilu.org#69155,"UENTANAGA ATAS, RATOLINDO, TOJO UNA-UNA, SULAWESI TENGAH",13,68,148,216
https://kawalpemilu.org#69155,"UENTANAGA ATAS, RATOLINDO, TOJO UNA-UNA, SULAWESI TENGAH",14,54,106,160
https://kawalpemilu.org#69156,"DONDO, RATOLINDO, TOJO UNA-UNA, SULAWESI TENGAH",1,76,108,184
https://kawalpemilu.org#69156,"DONDO, RATOLINDO, TOJO UNA-UNA, SULAWESI TENGAH",2,80,84,164
https://kawalpemilu.org#69156,"DONDO, RATOLINDO, TOJO UNA-UNA, SULAWESI TENGAH",3,83,103,186
https://kawalpemilu.org#69156,"DONDO, RATOLINDO, TOJO UNA-UNA, SULAWESI TENGAH",4,98,116,214
https://kawalpemilu.org#69156,"DONDO, RATOLINDO, TOJO UNA-UNA, SULAWESI TENGAH",5,77,97,174
https://kawalpemilu.org#69156,"DONDO, RATOLINDO, TOJO UNA-UNA, SULAWESI TENGAH",6,80,113,193
https://kawalpemilu.org#69156,"DONDO, RATOLINDO, TOJO UNA-UNA, SULAWESI TENGAH",7,87,97,184
https://kawalpemilu.org#69156,"DONDO, RATOLINDO, TOJO UNA-UNA, SULAWESI TENGAH",8,97,117,214
https://kawalpemilu.org#69156,"DONDO, RATOLINDO, TOJO UNA-UNA, SULAWESI TENGAH",9,82,123,205
https://kawalpemilu.org#69156,"DONDO, RATOLINDO, TOJO UNA-UNA, SULAWESI TENGAH",10,90,130,220
https://kawalpemilu.org#69157,"UENTANAGA BAWAH, RATOLINDO, TOJO UNA-UNA, SULAWESI TENGAH",1,91,98,189
https://kawalpemilu.org#69157,"UENTANAGA BAWAH, RATOLINDO, TOJO UNA-UNA, SULAWESI TENGAH",2,63,66,129
https://kawalpemilu.org#69157,"UENTANAGA BAWAH, RATOLINDO, TOJO UNA-UNA, SULAWESI TENGAH",3,83,88,171
https://kawalpemilu.org#69157,"UENTANAGA BAWAH, RATOLINDO, TOJO UNA-UNA, SULAWESI TENGAH",4,79,49,128
https://kawalpemilu.org#69157,"UENTANAGA BAWAH, RATOLINDO, TOJO UNA-UNA, SULAWESI TENGAH",5,59,41,100
https://kawalpemilu.org#69157,"UENTANAGA BAWAH, RATOLINDO, TOJO UNA-UNA, SULAWESI TENGAH",6,0,0,0
https://kawalpemilu.org#69157,"UENTANAGA BAWAH, RATOLINDO, TOJO UNA-UNA, SULAWESI TENGAH",7,59,68,127
https://kawalpemilu.org#69157,"UENTANAGA BAWAH, RATOLINDO, TOJO UNA-UNA, SULAWESI TENGAH",8,59,81,140
https://kawalpemilu.org#69159,"SUMOLI, RATOLINDO, TOJO UNA-UNA, SULAWESI TENGAH",1,49,131,180
https://kawalpemilu.org#69159,"SUMOLI, RATOLINDO, TOJO UNA-UNA, SULAWESI TENGAH",2,83,108,191
https://kawalpemilu.org#69159,"SUMOLI, RATOLINDO, TOJO UNA-UNA, SULAWESI TENGAH",3,97,81,178
https://kawalpemilu.org#69159,"SUMOLI, RATOLINDO, TOJO UNA-UNA, SULAWESI TENGAH",4,83,80,163
https://kawalpemilu.org#69159,"SUMOLI, RATOLINDO, TOJO UNA-UNA, SULAWESI TENGAH",5,44,45,89
https://kawalpemilu.org#69159,"SUMOLI, RATOLINDO, TOJO UNA-UNA, SULAWESI TENGAH",6,122,100,222
https://kawalpemilu.org#69159,"SUMOLI, RATOLINDO, TOJO UNA-UNA, SULAWESI TENGAH",7,98,111,209
https://kawalpemilu.org#69160,"LABUAN, RATOLINDO, TOJO UNA-UNA, SULAWESI TENGAH",1,65,141,206
https://kawalpemilu.org#69160,"LABUAN, RATOLINDO, TOJO UNA-UNA, SULAWESI TENGAH",2,77,118,195
https://kawalpemilu.org#69160,"LABUAN, RATOLINDO, TOJO UNA-UNA, SULAWESI TENGAH",3,110,106,216
https://kawalpemilu.org#69160,"LABUAN, RATOLINDO, TOJO UNA-UNA, SULAWESI TENGAH",4,97,111,208
https://kawalpemilu.org#69160,"LABUAN, RATOLINDO, TOJO UNA-UNA, SULAWESI TENGAH",5,117,84,201
https://kawalpemilu.org#69160,"LABUAN, RATOLINDO, TOJO UNA-UNA, SULAWESI TENGAH",6,154,69,223
https://kawalpemilu.org#69160,"LABUAN, RATOLINDO, TOJO UNA-UNA, SULAWESI TENGAH",7,155,67,222
https://kawalpemilu.org#69161,"SABULIRA TOBA, RATOLINDO, TOJO UNA-UNA, SULAWESI TENGAH",1,104,86,190
https://kawalpemilu.org#69161,"SABULIRA TOBA, RATOLINDO, TOJO UNA-UNA, SULAWESI TENGAH",2,104,106,210
https://kawalpemilu.org#69161,"SABULIRA TOBA, RATOLINDO, TOJO UNA-UNA, SULAWESI TENGAH",3,138,104,242
https://kawalpemilu.org#69161,"SABULIRA TOBA, RATOLINDO, TOJO UNA-UNA, SULAWESI TENGAH",4,127,116,243
https://kawalpemilu.org#69161,"SABULIRA TOBA, RATOLINDO, TOJO UNA-UNA, SULAWESI TENGAH",5,112,83,195
https://kawalpemilu.org#69161,"SABULIRA TOBA, RATOLINDO, TOJO UNA-UNA, SULAWESI TENGAH",6,109,67,176
https://kawalpemilu.org#69161,"SABULIRA TOBA, RATOLINDO, TOJO UNA-UNA, SULAWESI TENGAH",7,74,86,160
https://kawalpemilu.org#69161,"SABULIRA TOBA, RATOLINDO, TOJO UNA-UNA, SULAWESI TENGAH",8,56,86,142
https://kawalpemilu.org#85731,"DONDO BARAT, RATOLINDO, TOJO UNA-UNA, SULAWESI TENGAH",1,77,106,183
https://kawalpemilu.org#85731,"DONDO BARAT, RATOLINDO, TOJO UNA-UNA, SULAWESI TENGAH",3,59,134,193
https://kawalpemilu.org#85731,"DONDO BARAT, RATOLINDO, TOJO UNA-UNA, SULAWESI TENGAH",4,73,128,273
https://kawalpemilu.org#85731,"DONDO BARAT, RATOLINDO, TOJO UNA-UNA, SULAWESI TENGAH",5,78,133,211
https://kawalpemilu.org#85731,"DONDO BARAT, RATOLINDO, TOJO UNA-UNA, SULAWESI TENGAH",6,72,119,191
https://kawalpemilu.org#85731,"DONDO BARAT, RATOLINDO, TOJO UNA-UNA, SULAWESI TENGAH",8,37,123,160
https://kawalpemilu.org#85731,"DONDO BARAT, RATOLINDO, TOJO UNA-UNA, SULAWESI TENGAH",9,34,96,130
https://kawalpemilu.org#85731,"DONDO BARAT, RATOLINDO, TOJO UNA-UNA, SULAWESI TENGAH",10,65,93,158
https://kawalpemilu.org#85733,"UEMALINGKU, RATOLINDO, TOJO UNA-UNA, SULAWESI TENGAH",1,48,118,166
https://kawalpemilu.org#85733,"UEMALINGKU, RATOLINDO, TOJO UNA-UNA, SULAWESI TENGAH",2,44,149,193
https://kawalpemilu.org#85733,"UEMALINGKU, RATOLINDO, TOJO UNA-UNA, SULAWESI TENGAH",3,69,113,182
https://kawalpemilu.org#85733,"UEMALINGKU, RATOLINDO, TOJO UNA-UNA, SULAWESI TENGAH",4,55,122,177
https://kawalpemilu.org#85733,"UEMALINGKU, RATOLINDO, TOJO UNA-UNA, SULAWESI TENGAH",5,30,89,119
https://kawalpemilu.org#85733,"UEMALINGKU, RATOLINDO, TOJO UNA-UNA, SULAWESI TENGAH",6,53,110,163
https://kawalpemilu.org#85733,"UEMALINGKU, RATOLINDO, TOJO UNA-UNA, SULAWESI TENGAH",7,74,134,208
https://kawalpemilu.org#85733,"UEMALINGKU, RATOLINDO, TOJO UNA-UNA, SULAWESI TENGAH",8,70,91,161
https://kawalpemilu.org#85733,"UEMALINGKU, RATOLINDO, TOJO UNA-UNA, SULAWESI TENGAH",9,108,111,219
https://kawalpemilu.org#85736,"PATINGKO, RATOLINDO, TOJO UNA-UNA, SULAWESI TENGAH",1,84,129,213
https://kawalpemilu.org#85736,"PATINGKO, RATOLINDO, TOJO UNA-UNA, SULAWESI TENGAH",2,126,95,221
https://kawalpemilu.org#929214,"MUARA TOBA, RATOLINDO, TOJO UNA-UNA, SULAWESI TENGAH",1,57,91,148
https://kawalpemilu.org#929214,"MUARA TOBA, RATOLINDO, TOJO UNA-UNA, SULAWESI TENGAH",2,64,108,172
https://kawalpemilu.org#929214,"MUARA TOBA, RATOLINDO, TOJO UNA-UNA, SULAWESI TENGAH",3,70,128,198
https://kawalpemilu.org#929214,"MUARA TOBA, RATOLINDO, TOJO UNA-UNA, SULAWESI TENGAH",4,33,96,129
https://kawalpemilu.org#929214,"MUARA TOBA, RATOLINDO, TOJO UNA-UNA, SULAWESI TENGAH",5,58,128,186
https://kawalpemilu.org#929214,"MUARA TOBA, RATOLINDO, TOJO UNA-UNA, SULAWESI TENGAH",6,58,84,142
https://kawalpemilu.org#929214,"MUARA TOBA, RATOLINDO, TOJO UNA-UNA, SULAWESI TENGAH",7,76,80,156
https://kawalpemilu.org#929214,"MUARA TOBA, RATOLINDO, TOJO UNA-UNA, SULAWESI TENGAH",8,66,100,166
https://kawalpemilu.org#929214,"MUARA TOBA, RATOLINDO, TOJO UNA-UNA, SULAWESI TENGAH",9,74,128,202
https://kawalpemilu.org#929214,"MUARA TOBA, RATOLINDO, TOJO UNA-UNA, SULAWESI TENGAH",10,92,137,229
https://kawalpemilu.org#69091,"KULINGKINARI, BATUDAKA, TOJO UNA-UNA, SULAWESI TENGAH",1,57,113,170
https://kawalpemilu.org#69091,"KULINGKINARI, BATUDAKA, TOJO UNA-UNA, SULAWESI TENGAH",2,57,117,174
https://kawalpemilu.org#69091,"KULINGKINARI, BATUDAKA, TOJO UNA-UNA, SULAWESI TENGAH",3,63,140,203
https://kawalpemilu.org#69091,"KULINGKINARI, BATUDAKA, TOJO UNA-UNA, SULAWESI TENGAH",4,9,44,53
https://kawalpemilu.org#69092,"MOLOWAGU, BATUDAKA, TOJO UNA-UNA, SULAWESI TENGAH",1,83,139,222
https://kawalpemilu.org#69092,"MOLOWAGU, BATUDAKA, TOJO UNA-UNA, SULAWESI TENGAH",2,56,68,124
https://kawalpemilu.org#69092,"MOLOWAGU, BATUDAKA, TOJO UNA-UNA, SULAWESI TENGAH",3,71,87,158
https://kawalpemilu.org#69092,"MOLOWAGU, BATUDAKA, TOJO UNA-UNA, SULAWESI TENGAH",4,112,118,230
https://kawalpemilu.org#69093,"BOMBA, BATUDAKA, TOJO UNA-UNA, SULAWESI TENGAH",1,72,161,233
https://kawalpemilu.org#69093,"BOMBA, BATUDAKA, TOJO UNA-UNA, SULAWESI TENGAH",2,82,141,223
https://kawalpemilu.org#69094,"TUMBULAWA, BATUDAKA, TOJO UNA-UNA, SULAWESI TENGAH",1,66,110,176
https://kawalpemilu.org#69094,"TUMBULAWA, BATUDAKA, TOJO UNA-UNA, SULAWESI TENGAH",2,110,88,198
https://kawalpemilu.org#69101,"SIATU, BATUDAKA, TOJO UNA-UNA, SULAWESI TENGAH",1,117,15,132
https://kawalpemilu.org#69101,"SIATU, BATUDAKA, TOJO UNA-UNA, SULAWESI TENGAH",2,124,27,151
https://kawalpemilu.org#69102,"KAMBUTU, BATUDAKA, TOJO UNA-UNA, SULAWESI TENGAH",1,91,68,159
https://kawalpemilu.org#69102,"KAMBUTU, BATUDAKA, TOJO UNA-UNA, SULAWESI TENGAH",2,122,42,164
https://kawalpemilu.org#69103,"MALINO, BATUDAKA, TOJO UNA-UNA, SULAWESI TENGAH",1,137,73,210
https://kawalpemilu.org#89739,"LINDO, BATUDAKA, TOJO UNA-UNA, SULAWESI TENGAH",1,193,55,248
https://kawalpemilu.org#928651,"PATOYAN, BATUDAKA, TOJO UNA-UNA, SULAWESI TENGAH",1,129,9,138
https://kawalpemilu.org#69120,"KABALUTAN, TALATAKO, TOJO UNA-UNA, SULAWESI TENGAH",1,122,103,225
https://kawalpemilu.org#69120,"KABALUTAN, TALATAKO, TOJO UNA-UNA, SULAWESI TENGAH",2,143,73,216
https://kawalpemilu.org#69120,"KABALUTAN, TALATAKO, TOJO UNA-UNA, SULAWESI TENGAH",3,133,95,288
https://kawalpemilu.org#69120,"KABALUTAN, TALATAKO, TOJO UNA-UNA, SULAWESI TENGAH",4,108,109,217
https://kawalpemilu.org#69120,"KABALUTAN, TALATAKO, TOJO UNA-UNA, SULAWESI TENGAH",5,41,170,211
https://kawalpemilu.org#69120,"KABALUTAN, TALATAKO, TOJO UNA-UNA, SULAWESI TENGAH",6,69,135,204
https://kawalpemilu.org#69121,"PAUTU, TALATAKO, TOJO UNA-UNA, SULAWESI TENGAH",1,73,74,147
https://kawalpemilu.org#69121,"PAUTU, TALATAKO, TOJO UNA-UNA, SULAWESI TENGAH",2,66,76,142
https://kawalpemilu.org#69122,"TUMOTOK, TALATAKO, TOJO UNA-UNA, SULAWESI TENGAH",1,49,101,150
https://kawalpemilu.org#69122,"TUMOTOK, TALATAKO, TOJO UNA-UNA, SULAWESI TENGAH",2,52,130,182
https://kawalpemilu.org#69123,"KALIA, TALATAKO, TOJO UNA-UNA, SULAWESI TENGAH",1,54,150,204
https://kawalpemilu.org#69123,"KALIA, TALATAKO, TOJO UNA-UNA, SULAWESI TENGAH",2,43,137,180
https://kawalpemilu.org#69123,"KALIA, TALATAKO, TOJO UNA-UNA, SULAWESI TENGAH",3,27,136,163
https://kawalpemilu.org#69123,"KALIA, TALATAKO, TOJO UNA-UNA, SULAWESI TENGAH",4,21,108,129
https://kawalpemilu.org#69123,"KALIA, TALATAKO, TOJO UNA-UNA, SULAWESI TENGAH",5,50,72,122
https://kawalpemilu.org#69124,"MALENGE, TALATAKO, TOJO UNA-UNA, SULAWESI TENGAH",1,35,67,102
https://kawalpemilu.org#69124,"MALENGE, TALATAKO, TOJO UNA-UNA, SULAWESI TENGAH",2,61,159,220
https://kawalpemilu.org#69124,"MALENGE, TALATAKO, TOJO UNA-UNA, SULAWESI TENGAH",3,35,127,162
https://kawalpemilu.org#85724,"KADODA, TALATAKO, TOJO UNA-UNA, SULAWESI TENGAH",1,44,92,136
https://kawalpemilu.org#85724,"KADODA, TALATAKO, TOJO UNA-UNA, SULAWESI TENGAH",2,125,60,185
https://kawalpemilu.org#69225,"BESUSU BARAT, PALU TIMUR, KOTA PALU, SULAWESI TENGAH",2,76,107,183
https://kawalpemilu.org#69225,"BESUSU BARAT, PALU TIMUR, KOTA PALU, SULAWESI TENGAH",3,66,117,183
https://kawalpemilu.org#69225,"BESUSU BARAT, PALU TIMUR, KOTA PALU, SULAWESI TENGAH",4,68,155,223
https://kawalpemilu.org#69225,"BESUSU BARAT, PALU TIMUR, KOTA PALU, SULAWESI TENGAH",5,80,119,199
https://kawalpemilu.org#69225,"BESUSU BARAT, PALU TIMUR, KOTA PALU, SULAWESI TENGAH",6,48,120,168
https://kawalpemilu.org#69225,"BESUSU BARAT, PALU TIMUR, KOTA PALU, SULAWESI TENGAH",7,75,120,195
https://kawalpemilu.org#69225,"BESUSU BARAT, PALU TIMUR, KOTA PALU, SULAWESI TENGAH",8,93,80,173
https://kawalpemilu.org#69225,"BESUSU BARAT, PALU TIMUR, KOTA PALU, SULAWESI TENGAH",9,82,125,207
https://kawalpemilu.org#69225,"BESUSU BARAT, PALU TIMUR, KOTA PALU, SULAWESI TENGAH",10,83,144,227
https://kawalpemilu.org#69225,"BESUSU BARAT, PALU TIMUR, KOTA PALU, SULAWESI TENGAH",11,90,108,198
https://kawalpemilu.org#69225,"BESUSU BARAT, PALU TIMUR, KOTA PALU, SULAWESI TENGAH",12,52,122,174
https://kawalpemilu.org#69225,"BESUSU BARAT, PALU TIMUR, KOTA PALU, SULAWESI TENGAH",13,75,94,169
https://kawalpemilu.org#69225,"BESUSU BARAT, PALU TIMUR, KOTA PALU, SULAWESI TENGAH",14,56,77,133
https://kawalpemilu.org#69225,"BESUSU BARAT, PALU TIMUR, KOTA PALU, SULAWESI TENGAH",15,98,58,156
https://kawalpemilu.org#69225,"BESUSU BARAT, PALU TIMUR, KOTA PALU, SULAWESI TENGAH",16,70,67,137
https://kawalpemilu.org#69225,"BESUSU BARAT, PALU TIMUR, KOTA PALU, SULAWESI TENGAH",17,46,178,224
https://kawalpemilu.org#69225,"BESUSU BARAT, PALU TIMUR, KOTA PALU, SULAWESI TENGAH",18,84,133,217
https://kawalpemilu.org#69225,"BESUSU BARAT, PALU TIMUR, KOTA PALU, SULAWESI TENGAH",19,107,81,188
https://kawalpemilu.org#69225,"BESUSU BARAT, PALU TIMUR, KOTA PALU, SULAWESI TENGAH",20,47,64,111
https://kawalpemilu.org#69225,"BESUSU BARAT, PALU TIMUR, KOTA PALU, SULAWESI TENGAH",21,89,99,188
https://kawalpemilu.org#69225,"BESUSU BARAT, PALU TIMUR, KOTA PALU, SULAWESI TENGAH",22,44,74,118
https://kawalpemilu.org#69225,"BESUSU BARAT, PALU TIMUR, KOTA PALU, SULAWESI TENGAH",23,51,56,107
https://kawalpemilu.org#69225,"BESUSU BARAT, PALU TIMUR, KOTA PALU, SULAWESI TENGAH",24,69,78,147
https://kawalpemilu.org#69225,"BESUSU BARAT, PALU TIMUR, KOTA PALU, SULAWESI TENGAH",25,33,44,77
https://kawalpemilu.org#69225,"BESUSU BARAT, PALU TIMUR, KOTA PALU, SULAWESI TENGAH",26,64,113,177
https://kawalpemilu.org#69225,"BESUSU BARAT, PALU TIMUR, KOTA PALU, SULAWESI TENGAH",27,55,129,184
https://kawalpemilu.org#69225,"BESUSU BARAT, PALU TIMUR, KOTA PALU, SULAWESI TENGAH",28,105,94,199
https://kawalpemilu.org#69225,"BESUSU BARAT, PALU TIMUR, KOTA PALU, SULAWESI TENGAH",29,57,57,114
https://kawalpemilu.org#69225,"BESUSU BARAT, PALU TIMUR, KOTA PALU, SULAWESI TENGAH",30,71,120,191
https://kawalpemilu.org#69227,"BESUSU TENGAH, PALU TIMUR, KOTA PALU, SULAWESI TENGAH",1,66,108,174
https://kawalpemilu.org#69227,"BESUSU TENGAH, PALU TIMUR, KOTA PALU, SULAWESI TENGAH",2,60,83,143
https://kawalpemilu.org#69227,"BESUSU TENGAH, PALU TIMUR, KOTA PALU, SULAWESI TENGAH",3,104,101,205
https://kawalpemilu.org#69227,"BESUSU TENGAH, PALU TIMUR, KOTA PALU, SULAWESI TENGAH",4,107,129,236
https://kawalpemilu.org#69227,"BESUSU TENGAH, PALU TIMUR, KOTA PALU, SULAWESI TENGAH",5,84,69,153
https://kawalpemilu.org#69227,"BESUSU TENGAH, PALU TIMUR, KOTA PALU, SULAWESI TENGAH",6,73,115,188
https://kawalpemilu.org#69227,"BESUSU TENGAH, PALU TIMUR, KOTA PALU, SULAWESI TENGAH",7,115,49,1
https://kawalpemilu.org#69227,"BESUSU TENGAH, PALU TIMUR, KOTA PALU, SULAWESI TENGAH",8,90,70,160
https://kawalpemilu.org#69227,"BESUSU TENGAH, PALU TIMUR, KOTA PALU, SULAWESI TENGAH",9,68,110,178
https://kawalpemilu.org#69227,"BESUSU TENGAH, PALU TIMUR, KOTA PALU, SULAWESI TENGAH",10,79,97,176
https://kawalpemilu.org#69227,"BESUSU TENGAH, PALU TIMUR, KOTA PALU, SULAWESI TENGAH",11,99,93,192
https://kawalpemilu.org#69227,"BESUSU TENGAH, PALU TIMUR, KOTA PALU, SULAWESI TENGAH",12,106,58,164
https://kawalpemilu.org#69227,"BESUSU TENGAH, PALU TIMUR, KOTA PALU, SULAWESI TENGAH",13,53,112,165
https://kawalpemilu.org#69227,"BESUSU TENGAH, PALU TIMUR, KOTA PALU, SULAWESI TENGAH",14,12,79,91
https://kawalpemilu.org#69227,"BESUSU TENGAH, PALU TIMUR, KOTA PALU, SULAWESI TENGAH",15,34,60,94
https://kawalpemilu.org#69227,"BESUSU TENGAH, PALU TIMUR, KOTA PALU, SULAWESI TENGAH",16,53,75,128
https://kawalpemilu.org#69227,"BESUSU TENGAH, PALU TIMUR, KOTA PALU, SULAWESI TENGAH",17,53,88,141
https://kawalpemilu.org#69228,"BESUSU TIMUR, PALU TIMUR, KOTA PALU, SULAWESI TENGAH",1,107,83,190
https://kawalpemilu.org#69228,"BESUSU TIMUR, PALU TIMUR, KOTA PALU, SULAWESI TENGAH",2,97,38,135
https://kawalpemilu.org#69228,"BESUSU TIMUR, PALU TIMUR, KOTA PALU, SULAWESI TENGAH",3,59,40,99
https://kawalpemilu.org#69228,"BESUSU TIMUR, PALU TIMUR, KOTA PALU, SULAWESI TENGAH",4,71,86,157
https://kawalpemilu.org#69228,"BESUSU TIMUR, PALU TIMUR, KOTA PALU, SULAWESI TENGAH",5,63,47,110
https://kawalpemilu.org#69228,"BESUSU TIMUR, PALU TIMUR, KOTA PALU, SULAWESI TENGAH",6,43,66,109
https://kawalpemilu.org#69228,"BESUSU TIMUR, PALU TIMUR, KOTA PALU, SULAWESI TENGAH",8,57,81,138
https://kawalpemilu.org#69228,"BESUSU TIMUR, PALU TIMUR, KOTA PALU, SULAWESI TENGAH",9,78,73,151
https://kawalpemilu.org#69228,"BESUSU TIMUR, PALU TIMUR, KOTA PALU, SULAWESI TENGAH",10,65,73,138
https://kawalpemilu.org#69228,"BESUSU TIMUR, PALU TIMUR, KOTA PALU, SULAWESI TENGAH",11,44,57,101
https://kawalpemilu.org#69228,"BESUSU TIMUR, PALU TIMUR, KOTA PALU, SULAWESI TENGAH",12,52,83,135
https://kawalpemilu.org#69228,"BESUSU TIMUR, PALU TIMUR, KOTA PALU, SULAWESI TENGAH",13,81,134,215
https://kawalpemilu.org#69228,"BESUSU TIMUR, PALU TIMUR, KOTA PALU, SULAWESI TENGAH",14,41,136,177
https://kawalpemilu.org#69228,"BESUSU TIMUR, PALU TIMUR, KOTA PALU, SULAWESI TENGAH",15,44,59,103
https://kawalpemilu.org#69228,"BESUSU TIMUR, PALU TIMUR, KOTA PALU, SULAWESI TENGAH",17,42,92,134
https://kawalpemilu.org#69228,"BESUSU TIMUR, PALU TIMUR, KOTA PALU, SULAWESI TENGAH",18,53,89,142
https://kawalpemilu.org#69228,"BESUSU TIMUR, PALU TIMUR, KOTA PALU, SULAWESI TENGAH",19,51,47,98
https://kawalpemilu.org#69228,"BESUSU TIMUR, PALU TIMUR, KOTA PALU, SULAWESI TENGAH",20,41,54,95
https://kawalpemilu.org#69228,"BESUSU TIMUR, PALU TIMUR, KOTA PALU, SULAWESI TENGAH",21,80,97,177
https://kawalpemilu.org#69228,"BESUSU TIMUR, PALU TIMUR, KOTA PALU, SULAWESI TENGAH",23,102,116,218
https://kawalpemilu.org#69252,"LOLU UTARA, PALU TIMUR, KOTA PALU, SULAWESI TENGAH",1,60,118,178
https://kawalpemilu.org#69252,"LOLU UTARA, PALU TIMUR, KOTA PALU, SULAWESI TENGAH",2,88,76,164
https://kawalpemilu.org#69252,"LOLU UTARA, PALU TIMUR, KOTA PALU, SULAWESI TENGAH",3,101,50,151
https://kawalpemilu.org#69252,"LOLU UTARA, PALU TIMUR, KOTA PALU, SULAWESI TENGAH",5,54,71,125
https://kawalpemilu.org#69252,"LOLU UTARA, PALU TIMUR, KOTA PALU, SULAWESI TENGAH",7,72,52,124
https://kawalpemilu.org#69252,"LOLU UTARA, PALU TIMUR, KOTA PALU, SULAWESI TENGAH",8,29,46,75
https://kawalpemilu.org#69252,"LOLU UTARA, PALU TIMUR, KOTA PALU, SULAWESI TENGAH",9,70,58,128
https://kawalpemilu.org#69252,"LOLU UTARA, PALU TIMUR, KOTA PALU, SULAWESI TENGAH",10,76,56,132
https://kawalpemilu.org#69252,"LOLU UTARA, PALU TIMUR, KOTA PALU, SULAWESI TENGAH",11,55,22,77
https://kawalpemilu.org#69252,"LOLU UTARA, PALU TIMUR, KOTA PALU, SULAWESI TENGAH",12,28,57,85
https://kawalpemilu.org#69252,"LOLU UTARA, PALU TIMUR, KOTA PALU, SULAWESI TENGAH",13,26,95,121
https://kawalpemilu.org#69252,"LOLU UTARA, PALU TIMUR, KOTA PALU, SULAWESI TENGAH",14,70,77,147
https://kawalpemilu.org#69252,"LOLU UTARA, PALU TIMUR, KOTA PALU, SULAWESI TENGAH",15,42,65,107
https://kawalpemilu.org#69252,"LOLU UTARA, PALU TIMUR, KOTA PALU, SULAWESI TENGAH",16,104,74,178
https://kawalpemilu.org#69252,"LOLU UTARA, PALU TIMUR, KOTA PALU, SULAWESI TENGAH",17,45,44,89
https://kawalpemilu.org#69252,"LOLU UTARA, PALU TIMUR, KOTA PALU, SULAWESI TENGAH",18,32,55,87
https://kawalpemilu.org#69252,"LOLU UTARA, PALU TIMUR, KOTA PALU, SULAWESI TENGAH",19,48,69,117
https://kawalpemilu.org#69252,"LOLU UTARA, PALU TIMUR, KOTA PALU, SULAWESI TENGAH",20,93,47,140
https://kawalpemilu.org#69252,"LOLU UTARA, PALU TIMUR, KOTA PALU, SULAWESI TENGAH",21,57,120,177
https://kawalpemilu.org#69252,"LOLU UTARA, PALU TIMUR, KOTA PALU, SULAWESI TENGAH",22,68,99,167
https://kawalpemilu.org#69252,"LOLU UTARA, PALU TIMUR, KOTA PALU, SULAWESI TENGAH",23,75,93,168
https://kawalpemilu.org#69252,"LOLU UTARA, PALU TIMUR, KOTA PALU, SULAWESI TENGAH",24,37,52,89
https://kawalpemilu.org#69252,"LOLU UTARA, PALU TIMUR, KOTA PALU, SULAWESI TENGAH",25,45,93,138
https://kawalpemilu.org#69252,"LOLU UTARA, PALU TIMUR, KOTA PALU, SULAWESI TENGAH",26,51,75,126
https://kawalpemilu.org#69252,"LOLU UTARA, PALU TIMUR, KOTA PALU, SULAWESI TENGAH",27,53,72,125
https://kawalpemilu.org#69252,"LOLU UTARA, PALU TIMUR, KOTA PALU, SULAWESI TENGAH",28,111,21,132
https://kawalpemilu.org#69252,"LOLU UTARA, PALU TIMUR, KOTA PALU, SULAWESI TENGAH",29,115,38,153
https://kawalpemilu.org#69252,"LOLU UTARA, PALU TIMUR, KOTA PALU, SULAWESI TENGAH",30,87,9,96
https://kawalpemilu.org#69252,"LOLU UTARA, PALU TIMUR, KOTA PALU, SULAWESI TENGAH",31,36,94,128
https://kawalpemilu.org#69252,"LOLU UTARA, PALU TIMUR, KOTA PALU, SULAWESI TENGAH",32,89,0,0
https://kawalpemilu.org#69252,"LOLU UTARA, PALU TIMUR, KOTA PALU, SULAWESI TENGAH",33,90,57,147
https://kawalpemilu.org#69252,"LOLU UTARA, PALU TIMUR, KOTA PALU, SULAWESI TENGAH",35,70,73,143
https://kawalpemilu.org#69252,"LOLU UTARA, PALU TIMUR, KOTA PALU, SULAWESI TENGAH",36,49,67,116
https://kawalpemilu.org#69252,"LOLU UTARA, PALU TIMUR, KOTA PALU, SULAWESI TENGAH",37,72,83,155
https://kawalpemilu.org#69252,"LOLU UTARA, PALU TIMUR, KOTA PALU, SULAWESI TENGAH",38,137,59,196
https://kawalpemilu.org#69252,"LOLU UTARA, PALU TIMUR, KOTA PALU, SULAWESI TENGAH",39,41,43,84
https://kawalpemilu.org#69256,"LOLU SELATAN, PALU TIMUR, KOTA PALU, SULAWESI TENGAH",1,112,106,218
https://kawalpemilu.org#69256,"LOLU SELATAN, PALU TIMUR, KOTA PALU, SULAWESI TENGAH",2,152,42,194
https://kawalpemilu.org#69256,"LOLU SELATAN, PALU TIMUR, KOTA PALU, SULAWESI TENGAH",3,79,36,115
https://kawalpemilu.org#69256,"LOLU SELATAN, PALU TIMUR, KOTA PALU, SULAWESI TENGAH",4,61,60,121
https://kawalpemilu.org#69256,"LOLU SELATAN, PALU TIMUR, KOTA PALU, SULAWESI TENGAH",5,147,106,253
https://kawalpemilu.org#69256,"LOLU SELATAN, PALU TIMUR, KOTA PALU, SULAWESI TENGAH",6,0,0,0
https://kawalpemilu.org#69256,"LOLU SELATAN, PALU TIMUR, KOTA PALU, SULAWESI TENGAH",7,96,43,139
https://kawalpemilu.org#69256,"LOLU SELATAN, PALU TIMUR, KOTA PALU, SULAWESI TENGAH",8,69,77,146
https://kawalpemilu.org#69256,"LOLU SELATAN, PALU TIMUR, KOTA PALU, SULAWESI TENGAH",9,126,63,189
https://kawalpemilu.org#69256,"LOLU SELATAN, PALU TIMUR, KOTA PALU, SULAWESI TENGAH",10,166,27,166
https://kawalpemilu.org#69256,"LOLU SELATAN, PALU TIMUR, KOTA PALU, SULAWESI TENGAH",11,120,74,194
https://kawalpemilu.org#69256,"LOLU SELATAN, PALU TIMUR, KOTA PALU, SULAWESI TENGAH",12,106,77,183
https://kawalpemilu.org#69256,"LOLU SELATAN, PALU TIMUR, KOTA PALU, SULAWESI TENGAH",13,33,111,144
https://kawalpemilu.org#69256,"LOLU SELATAN, PALU TIMUR, KOTA PALU, SULAWESI TENGAH",14,70,106,176
https://kawalpemilu.org#69256,"LOLU SELATAN, PALU TIMUR, KOTA PALU, SULAWESI TENGAH",15,49,89,138
https://kawalpemilu.org#69256,"LOLU SELATAN, PALU TIMUR, KOTA PALU, SULAWESI TENGAH",16,40,70,110
https://kawalpemilu.org#69256,"LOLU SELATAN, PALU TIMUR, KOTA PALU, SULAWESI TENGAH",17,61,116,177
https://kawalpemilu.org#69256,"LOLU SELATAN, PALU TIMUR, KOTA PALU, SULAWESI TENGAH",18,62,49,111
https://kawalpemilu.org#69256,"LOLU SELATAN, PALU TIMUR, KOTA PALU, SULAWESI TENGAH",19,59,89,148
https://kawalpemilu.org#69256,"LOLU SELATAN, PALU TIMUR, KOTA PALU, SULAWESI TENGAH",20,61,122,183
https://kawalpemilu.org#69256,"LOLU SELATAN, PALU TIMUR, KOTA PALU, SULAWESI TENGAH",21,74,92,166
https://kawalpemilu.org#69256,"LOLU SELATAN, PALU TIMUR, KOTA PALU, SULAWESI TENGAH",22,28,91,119
https://kawalpemilu.org#69256,"LOLU SELATAN, PALU TIMUR, KOTA PALU, SULAWESI TENGAH",23,80,63,143
https://kawalpemilu.org#69256,"LOLU SELATAN, PALU TIMUR, KOTA PALU, SULAWESI TENGAH",24,125,97,222
https://kawalpemilu.org#69256,"LOLU SELATAN, PALU TIMUR, KOTA PALU, SULAWESI TENGAH",25,50,63,113
https://kawalpemilu.org#69256,"LOLU SELATAN, PALU TIMUR, KOTA PALU, SULAWESI TENGAH",26,79,105,184
https://kawalpemilu.org#69256,"LOLU SELATAN, PALU TIMUR, KOTA PALU, SULAWESI TENGAH",27,72,81,153
https://kawalpemilu.org#69256,"LOLU SELATAN, PALU TIMUR, KOTA PALU, SULAWESI TENGAH",28,72,87,159
https://kawalpemilu.org#69256,"LOLU SELATAN, PALU TIMUR, KOTA PALU, SULAWESI TENGAH",29,78,109,187
https://kawalpemilu.org#69256,"LOLU SELATAN, PALU TIMUR, KOTA PALU, SULAWESI TENGAH",30,63,138,201
https://kawalpemilu.org#69256,"LOLU SELATAN, PALU TIMUR, KOTA PALU, SULAWESI TENGAH",31,128,68,196
https://kawalpemilu.org#69256,"LOLU SELATAN, PALU TIMUR, KOTA PALU, SULAWESI TENGAH",32,42,49,91
https://kawalpemilu.org#69256,"LOLU SELATAN, PALU TIMUR, KOTA PALU, SULAWESI TENGAH",33,51,68,119
https://kawalpemilu.org#69232,"UJUNA, PALU BARAT, KOTA PALU, SULAWESI TENGAH",5,66,108,174
https://kawalpemilu.org#69232,"UJUNA, PALU BARAT, KOTA PALU, SULAWESI TENGAH",11,67,73,140
https://kawalpemilu.org#69232,"UJUNA, PALU BARAT, KOTA PALU, SULAWESI TENGAH",12,62,48,110
https://kawalpemilu.org#69232,"UJUNA, PALU BARAT, KOTA PALU, SULAWESI TENGAH",13,69,64,133
https://kawalpemilu.org#69232,"UJUNA, PALU BARAT, KOTA PALU, SULAWESI TENGAH",21,48,121,169
https://kawalpemilu.org#69232,"UJUNA, PALU BARAT, KOTA PALU, SULAWESI TENGAH",27,77,46,123
https://kawalpemilu.org#69235,"BALAROA, PALU BARAT, KOTA PALU, SULAWESI TENGAH",1,50,201,251
https://kawalpemilu.org#69235,"BALAROA, PALU BARAT, KOTA PALU, SULAWESI TENGAH",2,43,154,197
https://kawalpemilu.org#69235,"BALAROA, PALU BARAT, KOTA PALU, SULAWESI TENGAH",3,27,128,155
https://kawalpemilu.org#69235,"BALAROA, PALU BARAT, KOTA PALU, SULAWESI TENGAH",4,73,170,243
https://kawalpemilu.org#69235,"BALAROA, PALU BARAT, KOTA PALU, SULAWESI TENGAH",5,34,138,172
https://kawalpemilu.org#69235,"BALAROA, PALU BARAT, KOTA PALU, SULAWESI TENGAH",6,64,170,216
https://kawalpemilu.org#69235,"BALAROA, PALU BARAT, KOTA PALU, SULAWESI TENGAH",7,28,101,129
https://kawalpemilu.org#69235,"BALAROA, PALU BARAT, KOTA PALU, SULAWESI TENGAH",8,50,118,168
https://kawalpemilu.org#69235,"BALAROA, PALU BARAT, KOTA PALU, SULAWESI TENGAH",9,18,74,92
https://kawalpemilu.org#69235,"BALAROA, PALU BARAT, KOTA PALU, SULAWESI TENGAH",10,32,84,116
https://kawalpemilu.org#69235,"BALAROA, PALU BARAT, KOTA PALU, SULAWESI TENGAH",11,20,67,87
https://kawalpemilu.org#69235,"BALAROA, PALU BARAT, KOTA PALU, SULAWESI TENGAH",12,30,49,79
https://kawalpemilu.org#69235,"BALAROA, PALU BARAT, KOTA PALU, SULAWESI TENGAH",13,30,47,77
https://kawalpemilu.org#69235,"BALAROA, PALU BARAT, KOTA PALU, SULAWESI TENGAH",14,21,73,94
https://kawalpemilu.org#69235,"BALAROA, PALU BARAT, KOTA PALU, SULAWESI TENGAH",15,27,120,147
https://kawalpemilu.org#69235,"BALAROA, PALU BARAT, KOTA PALU, SULAWESI TENGAH",16,22,45,67
https://kawalpemilu.org#69235,"BALAROA, PALU BARAT, KOTA PALU, SULAWESI TENGAH",17,29,67,96
https://kawalpemilu.org#69235,"BALAROA, PALU BARAT, KOTA PALU, SULAWESI TENGAH",18,37,82,119
https://kawalpemilu.org#69235,"BALAROA, PALU BARAT, KOTA PALU, SULAWESI TENGAH",19,49,97,146
https://kawalpemilu.org#69235,"BALAROA, PALU BARAT, KOTA PALU, SULAWESI TENGAH",20,30,123,153
https://kawalpemilu.org#69235,"BALAROA, PALU BARAT, KOTA PALU, SULAWESI TENGAH",21,24,50,74
https://kawalpemilu.org#69235,"BALAROA, PALU BARAT, KOTA PALU, SULAWESI TENGAH",22,45,142,187
https://kawalpemilu.org#69235,"BALAROA, PALU BARAT, KOTA PALU, SULAWESI TENGAH",24,51,72,123
https://kawalpemilu.org#69235,"BALAROA, PALU BARAT, KOTA PALU, SULAWESI TENGAH",25,65,62,127
https://kawalpemilu.org#69235,"BALAROA, PALU BARAT, KOTA PALU, SULAWESI TENGAH",29,68,140,208
https://kawalpemilu.org#69235,"BALAROA, PALU BARAT, KOTA PALU, SULAWESI TENGAH",30,55,88,143
https://kawalpemilu.org#69235,"BALAROA, PALU BARAT, KOTA PALU, SULAWESI TENGAH",31,89,85,174
https://kawalpemilu.org#69235,"BALAROA, PALU BARAT, KOTA PALU, SULAWESI TENGAH",34,40,89,129
https://kawalpemilu.org#69235,"BALAROA, PALU BARAT, KOTA PALU, SULAWESI TENGAH",35,37,105,142
https://kawalpemilu.org#69235,"BALAROA, PALU BARAT, KOTA PALU, SULAWESI TENGAH",37,83,122,205
https://kawalpemilu.org#69235,"BALAROA, PALU BARAT, KOTA PALU, SULAWESI TENGAH",38,57,81,138
https://kawalpemilu.org#69237,"KAMONJI, PALU BARAT, KOTA PALU, SULAWESI TENGAH",1,58,96,154
https://kawalpemilu.org#69237,"KAMONJI, PALU BARAT, KOTA PALU, SULAWESI TENGAH",2,59,93,152
https://kawalpemilu.org#69237,"KAMONJI, PALU BARAT, KOTA PALU, SULAWESI TENGAH",3,57,119,176
https://kawalpemilu.org#69237,"KAMONJI, PALU BARAT, KOTA PALU, SULAWESI TENGAH",4,31,74,105
https://kawalpemilu.org#69237,"KAMONJI, PALU BARAT, KOTA PALU, SULAWESI TENGAH",6,53,113,166
https://kawalpemilu.org#69237,"KAMONJI, PALU BARAT, KOTA PALU, SULAWESI TENGAH",7,58,58,116
https://kawalpemilu.org#69237,"KAMONJI, PALU BARAT, KOTA PALU, SULAWESI TENGAH",9,46,61,107
https://kawalpemilu.org#69237,"KAMONJI, PALU BARAT, KOTA PALU, SULAWESI TENGAH",10,56,73,129
https://kawalpemilu.org#69237,"KAMONJI, PALU BARAT, KOTA PALU, SULAWESI TENGAH",11,31,79,110
https://kawalpemilu.org#69237,"KAMONJI, PALU BARAT, KOTA PALU, SULAWESI TENGAH",12,30,81,111
https://kawalpemilu.org#69237,"KAMONJI, PALU BARAT, KOTA PALU, SULAWESI TENGAH",13,51,130,181
https://kawalpemilu.org#69237,"KAMONJI, PALU BARAT, KOTA PALU, SULAWESI TENGAH",14,34,142,176
https://kawalpemilu.org#69237,"KAMONJI, PALU BARAT, KOTA PALU, SULAWESI TENGAH",15,35,63,98
https://kawalpemilu.org#69237,"KAMONJI, PALU BARAT, KOTA PALU, SULAWESI TENGAH",16,77,64,141
https://kawalpemilu.org#69237,"KAMONJI, PALU BARAT, KOTA PALU, SULAWESI TENGAH",17,33,67,100
https://kawalpemilu.org#69237,"KAMONJI, PALU BARAT, KOTA PALU, SULAWESI TENGAH",19,57,90,147
https://kawalpemilu.org#69237,"KAMONJI, PALU BARAT, KOTA PALU, SULAWESI TENGAH",20,44,87,131
https://kawalpemilu.org#69237,"KAMONJI, PALU BARAT, KOTA PALU, SULAWESI TENGAH",21,54,129,183
https://kawalpemilu.org#69237,"KAMONJI, PALU BARAT, KOTA PALU, SULAWESI TENGAH",22,31,147,178
https://kawalpemilu.org#69237,"KAMONJI, PALU BARAT, KOTA PALU, SULAWESI TENGAH",23,95,115,210
https://kawalpemilu.org#69237,"KAMONJI, PALU BARAT, KOTA PALU, SULAWESI TENGAH",24,80,140,220
https://kawalpemilu.org#69237,"KAMONJI, PALU BARAT, KOTA PALU, SULAWESI TENGAH",25,96,86,185
https://kawalpemilu.org#69238,"BARU, PALU BARAT, KOTA PALU, SULAWESI TENGAH",1,35,75,110
https://kawalpemilu.org#69238,"BARU, PALU BARAT, KOTA PALU, SULAWESI TENGAH",2,47,76,123
https://kawalpemilu.org#69238,"BARU, PALU BARAT, KOTA PALU, SULAWESI TENGAH",3,39,61,100
https://kawalpemilu.org#69238,"BARU, PALU BARAT, KOTA PALU, SULAWESI TENGAH",5,23,95,118
https://kawalpemilu.org#69238,"BARU, PALU BARAT, KOTA PALU, SULAWESI TENGAH",6,29,72,101
https://kawalpemilu.org#69238,"BARU, PALU BARAT, KOTA PALU, SULAWESI TENGAH",7,93,109,202
https://kawalpemilu.org#69238,"BARU, PALU BARAT, KOTA PALU, SULAWESI TENGAH",8,76,101,177
https://kawalpemilu.org#69238,"BARU, PALU BARAT, KOTA PALU, SULAWESI TENGAH",9,84,68,152
https://kawalpemilu.org#69238,"BARU, PALU BARAT, KOTA PALU, SULAWESI TENGAH",10,39,64,103
https://kawalpemilu.org#69238,"BARU, PALU BARAT, KOTA PALU, SULAWESI TENGAH",11,50,58,108
https://kawalpemilu.org#69238,"BARU, PALU BARAT, KOTA PALU, SULAWESI TENGAH",12,20,92,112
https://kawalpemilu.org#69238,"BARU, PALU BARAT, KOTA PALU, SULAWESI TENGAH",13,47,95,142
https://kawalpemilu.org#69238,"BARU, PALU BARAT, KOTA PALU, SULAWESI TENGAH",14,39,53,92
https://kawalpemilu.org#69238,"BARU, PALU BARAT, KOTA PALU, SULAWESI TENGAH",15,33,129,162
https://kawalpemilu.org#69238,"BARU, PALU BARAT, KOTA PALU, SULAWESI TENGAH",16,22,84,106
https://kawalpemilu.org#69238,"BARU, PALU BARAT, KOTA PALU, SULAWESI TENGAH",17,48,114,162
https://kawalpemilu.org#69238,"BARU, PALU BARAT, KOTA PALU, SULAWESI TENGAH",18,45,66,111
https://kawalpemilu.org#69238,"BARU, PALU BARAT, KOTA PALU, SULAWESI TENGAH",19,40,78,118
https://kawalpemilu.org#69238,"BARU, PALU BARAT, KOTA PALU, SULAWESI TENGAH",20,60,103,163
https://kawalpemilu.org#69239,"LERE, PALU BARAT, KOTA PALU, SULAWESI TENGAH",2,54,117,171
https://kawalpemilu.org#69239,"LERE, PALU BARAT, KOTA PALU, SULAWESI TENGAH",5,29,70,99
https://kawalpemilu.org#69239,"LERE, PALU BARAT, KOTA PALU, SULAWESI TENGAH",6,52,73,125
https://kawalpemilu.org#69239,"LERE, PALU BARAT, KOTA PALU, SULAWESI TENGAH",7,48,85,133
https://kawalpemilu.org#69239,"LERE, PALU BARAT, KOTA PALU, SULAWESI TENGAH",8,50,108,158
https://kawalpemilu.org#69239,"LERE, PALU BARAT, KOTA PALU, SULAWESI TENGAH",9,48,111,159
https://kawalpemilu.org#69239,"LERE, PALU BARAT, KOTA PALU, SULAWESI TENGAH",10,29,113,142
https://kawalpemilu.org#69239,"LERE, PALU BARAT, KOTA PALU, SULAWESI TENGAH",11,30,125,155
https://kawalpemilu.org#69239,"LERE, PALU BARAT, KOTA PALU, SULAWESI TENGAH",13,52,86,140
https://kawalpemilu.org#69239,"LERE, PALU BARAT, KOTA PALU, SULAWESI TENGAH",16,46,82,128
https://kawalpemilu.org#69239,"LERE, PALU BARAT, KOTA PALU, SULAWESI TENGAH",18,28,63,91
https://kawalpemilu.org#69239,"LERE, PALU BARAT, KOTA PALU, SULAWESI TENGAH",19,60,67,127
https://kawalpemilu.org#69239,"LERE, PALU BARAT, KOTA PALU, SULAWESI TENGAH",21,33,75,108
https://kawalpemilu.org#69239,"LERE, PALU BARAT, KOTA PALU, SULAWESI TENGAH",23,42,67,109
https://kawalpemilu.org#69239,"LERE, PALU BARAT, KOTA PALU, SULAWESI TENGAH",25,59,108,167
https://kawalpemilu.org#69239,"LERE, PALU BARAT, KOTA PALU, SULAWESI TENGAH",27,61,72,133
https://kawalpemilu.org#69239,"LERE, PALU BARAT, KOTA PALU, SULAWESI TENGAH",31,39,65,104
https://kawalpemilu.org#69239,"LERE, PALU BARAT, KOTA PALU, SULAWESI TENGAH",32,24,58,82
https://kawalpemilu.org#69239,"LERE, PALU BARAT, KOTA PALU, SULAWESI TENGAH",33,31,46,77
https://kawalpemilu.org#69239,"LERE, PALU BARAT, KOTA PALU, SULAWESI TENGAH",34,0,0,0
https://kawalpemilu.org#69239,"LERE, PALU BARAT, KOTA PALU, SULAWESI TENGAH",35,42,64,106
https://kawalpemilu.org#69239,"LERE, PALU BARAT, KOTA PALU, SULAWESI TENGAH",36,35,46,81
https://kawalpemilu.org#69239,"LERE, PALU BARAT, KOTA PALU, SULAWESI TENGAH",39,32,75,107
https://kawalpemilu.org#69239,"LERE, PALU BARAT, KOTA PALU, SULAWESI TENGAH",40,21,37,58
https://kawalpemilu.org#69239,"LERE, PALU BARAT, KOTA PALU, SULAWESI TENGAH",43,30,72,102
https://kawalpemilu.org#69239,"LERE, PALU BARAT, KOTA PALU, SULAWESI TENGAH",44,18,57,75
https://kawalpemilu.org#69239,"LERE, PALU BARAT, KOTA PALU, SULAWESI TENGAH",45,27,57,84
https://kawalpemilu.org#69245,"SIRANINDI, PALU BARAT, KOTA PALU, SULAWESI TENGAH",1,51,55,106
https://kawalpemilu.org#69245,"SIRANINDI, PALU BARAT, KOTA PALU, SULAWESI TENGAH",2,7,85,92
https://kawalpemilu.org#69245,"SIRANINDI, PALU BARAT, KOTA PALU, SULAWESI TENGAH",3,40,69,109
https://kawalpemilu.org#69245,"SIRANINDI, PALU BARAT, KOTA PALU, SULAWESI TENGAH",4,32,94,126
https://kawalpemilu.org#69245,"SIRANINDI, PALU BARAT, KOTA PALU, SULAWESI TENGAH",5,41,63,104
https://kawalpemilu.org#69245,"SIRANINDI, PALU BARAT, KOTA PALU, SULAWESI TENGAH",6,23,60,83
https://kawalpemilu.org#69245,"SIRANINDI, PALU BARAT, KOTA PALU, SULAWESI TENGAH",7,37,93,130
https://kawalpemilu.org#69245,"SIRANINDI, PALU BARAT, KOTA PALU, SULAWESI TENGAH",8,39,84,123
https://kawalpemilu.org#69245,"SIRANINDI, PALU BARAT, KOTA PALU, SULAWESI TENGAH",9,28,56,84
https://kawalpemilu.org#69245,"SIRANINDI, PALU BARAT, KOTA PALU, SULAWESI TENGAH",10,31,117,148
https://kawalpemilu.org#69245,"SIRANINDI, PALU BARAT, KOTA PALU, SULAWESI TENGAH",13,52,80,132
https://kawalpemilu.org#69245,"SIRANINDI, PALU BARAT, KOTA PALU, SULAWESI TENGAH",14,67,125,192
https://kawalpemilu.org#69245,"SIRANINDI, PALU BARAT, KOTA PALU, SULAWESI TENGAH",15,90,74,164
https://kawalpemilu.org#69245,"SIRANINDI, PALU BARAT, KOTA PALU, SULAWESI TENGAH",17,90,109,199
https://kawalpemilu.org#69245,"SIRANINDI, PALU BARAT, KOTA PALU, SULAWESI TENGAH",19,34,61,95
https://kawalpemilu.org#69245,"SIRANINDI, PALU BARAT, KOTA PALU, SULAWESI TENGAH",20,26,95,121
https://kawalpemilu.org#69245,"SIRANINDI, PALU BARAT, KOTA PALU, SULAWESI TENGAH",23,38,47,85
https://kawalpemilu.org#69247,"TATURA UTARA, PALU SELATAN, KOTA PALU, SULAWESI TENGAH",4,89,86,175
https://kawalpemilu.org#69247,"TATURA UTARA, PALU SELATAN, KOTA PALU, SULAWESI TENGAH",6,0,0,0
https://kawalpemilu.org#69247,"TATURA UTARA, PALU SELATAN, KOTA PALU, SULAWESI TENGAH",9,34,49,83
https://kawalpemilu.org#69247,"TATURA UTARA, PALU SELATAN, KOTA PALU, SULAWESI TENGAH",12,89,114,203
https://kawalpemilu.org#69247,"TATURA UTARA, PALU SELATAN, KOTA PALU, SULAWESI TENGAH",13,89,91,180
https://kawalpemilu.org#69247,"TATURA UTARA, PALU SELATAN, KOTA PALU, SULAWESI TENGAH",14,119,52,171
https://kawalpemilu.org#69247,"TATURA UTARA, PALU SELATAN, KOTA PALU, SULAWESI TENGAH",18,56,85,141
https://kawalpemilu.org#69247,"TATURA UTARA, PALU SELATAN, KOTA PALU, SULAWESI TENGAH",19,93,62,155
https://kawalpemilu.org#69247,"TATURA UTARA, PALU SELATAN, KOTA PALU, SULAWESI TENGAH",21,101,65,166
https://kawalpemilu.org#69247,"TATURA UTARA, PALU SELATAN, KOTA PALU, SULAWESI TENGAH",22,162,20,182
https://kawalpemilu.org#69247,"TATURA UTARA, PALU SELATAN, KOTA PALU, SULAWESI TENGAH",23,147,28,175
https://kawalpemilu.org#69247,"TATURA UTARA, PALU SELATAN, KOTA PALU, SULAWESI TENGAH",24,137,66,203
https://kawalpemilu.org#69247,"TATURA UTARA, PALU SELATAN, KOTA PALU, SULAWESI TENGAH",25,69,121,190
https://kawalpemilu.org#69247,"TATURA UTARA, PALU SELATAN, KOTA PALU, SULAWESI TENGAH",27,51,125,176
https://kawalpemilu.org#69247,"TATURA UTARA, PALU SELATAN, KOTA PALU, SULAWESI TENGAH",28,46,99,145
https://kawalpemilu.org#69247,"TATURA UTARA, PALU SELATAN, KOTA PALU, SULAWESI TENGAH",29,80,94,174
https://kawalpemilu.org#69247,"TATURA UTARA, PALU SELATAN, KOTA PALU, SULAWESI TENGAH",30,61,134,195
https://kawalpemilu.org#69247,"TATURA UTARA, PALU SELATAN, KOTA PALU, SULAWESI TENGAH",32,80,104,184
https://kawalpemilu.org#69247,"TATURA UTARA, PALU SELATAN, KOTA PALU, SULAWESI TENGAH",33,72,75,147
https://kawalpemilu.org#69247,"TATURA UTARA, PALU SELATAN, KOTA PALU, SULAWESI TENGAH",34,80,150,230
https://kawalpemilu.org#69247,"TATURA UTARA, PALU SELATAN, KOTA PALU, SULAWESI TENGAH",36,186,77,263
https://kawalpemilu.org#69247,"TATURA UTARA, PALU SELATAN, KOTA PALU, SULAWESI TENGAH",37,114,68,182
https://kawalpemilu.org#69247,"TATURA UTARA, PALU SELATAN, KOTA PALU, SULAWESI TENGAH",39,99,85,184
https://kawalpemilu.org#69247,"TATURA UTARA, PALU SELATAN, KOTA PALU, SULAWESI TENGAH",40,179,30,209
https://kawalpemilu.org#69247,"TATURA UTARA, PALU SELATAN, KOTA PALU, SULAWESI TENGAH",41,211,57,268
https://kawalpemilu.org#69247,"TATURA UTARA, PALU SELATAN, KOTA PALU, SULAWESI TENGAH",42,76,92,168
https://kawalpemilu.org#69247,"TATURA UTARA, PALU SELATAN, KOTA PALU, SULAWESI TENGAH",45,78,92,170
https://kawalpemilu.org#69247,"TATURA UTARA, PALU SELATAN, KOTA PALU, SULAWESI TENGAH",46,120,89,209
https://kawalpemilu.org#69247,"TATURA UTARA, PALU SELATAN, KOTA PALU, SULAWESI TENGAH",48,44,135,179
https://kawalpemilu.org#69248,"BIROBULI UTARA, PALU SELATAN, KOTA PALU, SULAWESI TENGAH",1,33,74,107
https://kawalpemilu.org#69248,"BIROBULI UTARA, PALU SELATAN, KOTA PALU, SULAWESI TENGAH",2,113,73,186
https://kawalpemilu.org#69248,"BIROBULI UTARA, PALU SELATAN, KOTA PALU, SULAWESI TENGAH",3,94,130,224
https://kawalpemilu.org#69248,"BIROBULI UTARA, PALU SELATAN, KOTA PALU, SULAWESI TENGAH",5,43,87,130
https://kawalpemilu.org#69248,"BIROBULI UTARA, PALU SELATAN, KOTA PALU, SULAWESI TENGAH",7,80,93,173
https://kawalpemilu.org#69248,"BIROBULI UTARA, PALU SELATAN, KOTA PALU, SULAWESI TENGAH",8,0,0,202
https://kawalpemilu.org#69248,"BIROBULI UTARA, PALU SELATAN, KOTA PALU, SULAWESI TENGAH",9,99,72,171
https://kawalpemilu.org#69248,"BIROBULI UTARA, PALU SELATAN, KOTA PALU, SULAWESI TENGAH",12,89,90,179
https://kawalpemilu.org#69248,"BIROBULI UTARA, PALU SELATAN, KOTA PALU, SULAWESI TENGAH",14,94,121,215
https://kawalpemilu.org#69248,"BIROBULI UTARA, PALU SELATAN, KOTA PALU, SULAWESI TENGAH",15,103,105,208
https://kawalpemilu.org#69248,"BIROBULI UTARA, PALU SELATAN, KOTA PALU, SULAWESI TENGAH",16,52,65,117
https://kawalpemilu.org#69248,"BIROBULI UTARA, PALU SELATAN, KOTA PALU, SULAWESI TENGAH",17,110,92,202
https://kawalpemilu.org#69248,"BIROBULI UTARA, PALU SELATAN, KOTA PALU, SULAWESI TENGAH",18,82,112,194
https://kawalpemilu.org#69248,"BIROBULI UTARA, PALU SELATAN, KOTA PALU, SULAWESI TENGAH",20,66,82,148
https://kawalpemilu.org#69248,"BIROBULI UTARA, PALU SELATAN, KOTA PALU, SULAWESI TENGAH",21,91,123,212
https://kawalpemilu.org#69248,"BIROBULI UTARA, PALU SELATAN, KOTA PALU, SULAWESI TENGAH",22,78,80,158
https://kawalpemilu.org#69248,"BIROBULI UTARA, PALU SELATAN, KOTA PALU, SULAWESI TENGAH",23,0,0,0
https://kawalpemilu.org#69248,"BIROBULI UTARA, PALU SELATAN, KOTA PALU, SULAWESI TENGAH",24,129,101,230
https://kawalpemilu.org#69248,"BIROBULI UTARA, PALU SELATAN, KOTA PALU, SULAWESI TENGAH",25,54,90,144
https://kawalpemilu.org#69248,"BIROBULI UTARA, PALU SELATAN, KOTA PALU, SULAWESI TENGAH",26,78,63,141
https://kawalpemilu.org#69248,"BIROBULI UTARA, PALU SELATAN, KOTA PALU, SULAWESI TENGAH",27,82,113,195
https://kawalpemilu.org#69248,"BIROBULI UTARA, PALU SELATAN, KOTA PALU, SULAWESI TENGAH",28,68,122,190
https://kawalpemilu.org#69248,"BIROBULI UTARA, PALU SELATAN, KOTA PALU, SULAWESI TENGAH",29,48,65,113
https://kawalpemilu.org#69248,"BIROBULI UTARA, PALU SELATAN, KOTA PALU, SULAWESI TENGAH",30,95,93,188
https://kawalpemilu.org#69248,"BIROBULI UTARA, PALU SELATAN, KOTA PALU, SULAWESI TENGAH",35,126,129,255
https://kawalpemilu.org#69248,"BIROBULI UTARA, PALU SELATAN, KOTA PALU, SULAWESI TENGAH",36,109,161,270
https://kawalpemilu.org#69248,"BIROBULI UTARA, PALU SELATAN, KOTA PALU, SULAWESI TENGAH",38,129,80,209
https://kawalpemilu.org#69248,"BIROBULI UTARA, PALU SELATAN, KOTA PALU, SULAWESI TENGAH",39,68,74,142
https://kawalpemilu.org#69248,"BIROBULI UTARA, PALU SELATAN, KOTA PALU, SULAWESI TENGAH",41,60,58,595
https://kawalpemilu.org#69248,"BIROBULI UTARA, PALU SELATAN, KOTA PALU, SULAWESI TENGAH",42,72,76,148
https://kawalpemilu.org#69248,"BIROBULI UTARA, PALU SELATAN, KOTA PALU, SULAWESI TENGAH",43,64,48,112
https://kawalpemilu.org#69248,"BIROBULI UTARA, PALU SELATAN, KOTA PALU, SULAWESI TENGAH",44,110,117,227
https://kawalpemilu.org#69248,"BIROBULI UTARA, PALU SELATAN, KOTA PALU, SULAWESI TENGAH",49,140,73,1
https://kawalpemilu.org#69248,"BIROBULI UTARA, PALU SELATAN, KOTA PALU, SULAWESI TENGAH",51,114,103,217
https://kawalpemilu.org#69249,"PETOBO, PALU SELATAN, KOTA PALU, SULAWESI TENGAH",2,40,155,195
https://kawalpemilu.org#69249,"PETOBO, PALU SELATAN, KOTA PALU, SULAWESI TENGAH",3,54,170,224
https://kawalpemilu.org#69249,"PETOBO, PALU SELATAN, KOTA PALU, SULAWESI TENGAH",5,74,167,241
https://kawalpemilu.org#69249,"PETOBO, PALU SELATAN, KOTA PALU, SULAWESI TENGAH",6,65,125,190
https://kawalpemilu.org#69249,"PETOBO, PALU SELATAN, KOTA PALU, SULAWESI TENGAH",8,71,137,208
https://kawalpemilu.org#69249,"PETOBO, PALU SELATAN, KOTA PALU, SULAWESI TENGAH",9,110,88,198
https://kawalpemilu.org#69249,"PETOBO, PALU SELATAN, KOTA PALU, SULAWESI TENGAH",10,162,53,215
https://kawalpemilu.org#69249,"PETOBO, PALU SELATAN, KOTA PALU, SULAWESI TENGAH",12,108,119,227
https://kawalpemilu.org#69249,"PETOBO, PALU SELATAN, KOTA PALU, SULAWESI TENGAH",15,72,37,109
https://kawalpemilu.org#69249,"PETOBO, PALU SELATAN, KOTA PALU, SULAWESI TENGAH",16,110,140,250
https://kawalpemilu.org#69249,"PETOBO, PALU SELATAN, KOTA PALU, SULAWESI TENGAH",18,32,72,104
https://kawalpemilu.org#69249,"PETOBO, PALU SELATAN, KOTA PALU, SULAWESI TENGAH",20,48,90,138
https://kawalpemilu.org#69249,"PETOBO, PALU SELATAN, KOTA PALU, SULAWESI TENGAH",21,115,147,262
https://kawalpemilu.org#69249,"PETOBO, PALU SELATAN, KOTA PALU, SULAWESI TENGAH",24,118,88,206
https://kawalpemilu.org#69249,"PETOBO, PALU SELATAN, KOTA PALU, SULAWESI TENGAH",26,115,110,225
https://kawalpemilu.org#69249,"PETOBO, PALU SELATAN, KOTA PALU, SULAWESI TENGAH",27,79,101,180
https://kawalpemilu.org#69257,"BIROBULI SELATAN, PALU SELATAN, KOTA PALU, SULAWESI TENGAH",1,97,25,122
https://kawalpemilu.org#69257,"BIROBULI SELATAN, PALU SELATAN, KOTA PALU, SULAWESI TENGAH",3,175,70,245
https://kawalpemilu.org#69257,"BIROBULI SELATAN, PALU SELATAN, KOTA PALU, SULAWESI TENGAH",4,102,106,209
https://kawalpemilu.org#69257,"BIROBULI SELATAN, PALU SELATAN, KOTA PALU, SULAWESI TENGAH",5,118,51,169
https://kawalpemilu.org#69257,"BIROBULI SELATAN, PALU SELATAN, KOTA PALU, SULAWESI TENGAH",6,100,125,225
https://kawalpemilu.org#69257,"BIROBULI SELATAN, PALU SELATAN, KOTA PALU, SULAWESI TENGAH",9,138,65,203
https://kawalpemilu.org#69257,"BIROBULI SELATAN, PALU SELATAN, KOTA PALU, SULAWESI TENGAH",10,82,28,110
https://kawalpemilu.org#69257,"BIROBULI SELATAN, PALU SELATAN, KOTA PALU, SULAWESI TENGAH",11,72,46,118
https://kawalpemilu.org#69257,"BIROBULI SELATAN, PALU SELATAN, KOTA PALU, SULAWESI TENGAH",12,132,68,200
https://kawalpemilu.org#69257,"BIROBULI SELATAN, PALU SELATAN, KOTA PALU, SULAWESI TENGAH",13,89,70,159
https://kawalpemilu.org#69257,"BIROBULI SELATAN, PALU SELATAN, KOTA PALU, SULAWESI TENGAH",14,147,50,197
https://kawalpemilu.org#69257,"BIROBULI SELATAN, PALU SELATAN, KOTA PALU, SULAWESI TENGAH",15,84,64,148
https://kawalpemilu.org#69257,"BIROBULI SELATAN, PALU SELATAN, KOTA PALU, SULAWESI TENGAH",16,68,97,165
https://kawalpemilu.org#69257,"BIROBULI SELATAN, PALU SELATAN, KOTA PALU, SULAWESI TENGAH",17,42,49,91
https://kawalpemilu.org#69257,"BIROBULI SELATAN, PALU SELATAN, KOTA PALU, SULAWESI TENGAH",18,141,95,236
https://kawalpemilu.org#69257,"BIROBULI SELATAN, PALU SELATAN, KOTA PALU, SULAWESI TENGAH",19,94,95,189
https://kawalpemilu.org#69257,"BIROBULI SELATAN, PALU SELATAN, KOTA PALU, SULAWESI TENGAH",20,85,75,160
https://kawalpemilu.org#69257,"BIROBULI SELATAN, PALU SELATAN, KOTA PALU, SULAWESI TENGAH",21,79,76,155
https://kawalpemilu.org#69257,"BIROBULI SELATAN, PALU SELATAN, KOTA PALU, SULAWESI TENGAH",22,106,97,203
https://kawalpemilu.org#69257,"BIROBULI SELATAN, PALU SELATAN, KOTA PALU, SULAWESI TENGAH",24,81,66,147
https://kawalpemilu.org#69257,"BIROBULI SELATAN, PALU SELATAN, KOTA PALU, SULAWESI TENGAH",25,69,67,136
https://kawalpemilu.org#69257,"BIROBULI SELATAN, PALU SELATAN, KOTA PALU, SULAWESI TENGAH",27,138,85,223
https://kawalpemilu.org#69257,"BIROBULI SELATAN, PALU SELATAN, KOTA PALU, SULAWESI TENGAH",28,161,114,275
https://kawalpemilu.org#69257,"BIROBULI SELATAN, PALU SELATAN, KOTA PALU, SULAWESI TENGAH",29,157,86,243
https://kawalpemilu.org#69257,"BIROBULI SELATAN, PALU SELATAN, KOTA PALU, SULAWESI TENGAH",30,110,87,197
https://kawalpemilu.org#69257,"BIROBULI SELATAN, PALU SELATAN, KOTA PALU, SULAWESI TENGAH",31,119,103,222
https://kawalpemilu.org#69257,"BIROBULI SELATAN, PALU SELATAN, KOTA PALU, SULAWESI TENGAH",32,93,103,196
https://kawalpemilu.org#69258,"TATURA SELATAN, PALU SELATAN, KOTA PALU, SULAWESI TENGAH",1,106,89,195
https://kawalpemilu.org#69258,"TATURA SELATAN, PALU SELATAN, KOTA PALU, SULAWESI TENGAH",3,83,77,160
https://kawalpemilu.org#69258,"TATURA SELATAN, PALU SELATAN, KOTA PALU, SULAWESI TENGAH",4,131,96,227
https://kawalpemilu.org#69258,"TATURA SELATAN, PALU SELATAN, KOTA PALU, SULAWESI TENGAH",5,140,58,198
https://kawalpemilu.org#69258,"TATURA SELATAN, PALU SELATAN, KOTA PALU, SULAWESI TENGAH",6,102,92,194
https://kawalpemilu.org#69258,"TATURA SELATAN, PALU SELATAN, KOTA PALU, SULAWESI TENGAH",7,131,59,190
https://kawalpemilu.org#69258,"TATURA SELATAN, PALU SELATAN, KOTA PALU, SULAWESI TENGAH",8,117,48,165
https://kawalpemilu.org#69258,"TATURA SELATAN, PALU SELATAN, KOTA PALU, SULAWESI TENGAH",9,105,100,205
https://kawalpemilu.org#69258,"TATURA SELATAN, PALU SELATAN, KOTA PALU, SULAWESI TENGAH",10,88,68,156
https://kawalpemilu.org#69258,"TATURA SELATAN, PALU SELATAN, KOTA PALU, SULAWESI TENGAH",11,113,36,149
https://kawalpemilu.org#69258,"TATURA SELATAN, PALU SELATAN, KOTA PALU, SULAWESI TENGAH",13,159,73,232
https://kawalpemilu.org#69258,"TATURA SELATAN, PALU SELATAN, KOTA PALU, SULAWESI TENGAH",14,220,10,230
https://kawalpemilu.org#69258,"TATURA SELATAN, PALU SELATAN, KOTA PALU, SULAWESI TENGAH",16,132,29,161
https://kawalpemilu.org#69258,"TATURA SELATAN, PALU SELATAN, KOTA PALU, SULAWESI TENGAH",19,81,80,161
https://kawalpemilu.org#69258,"TATURA SELATAN, PALU SELATAN, KOTA PALU, SULAWESI TENGAH",22,57,97,154
https://kawalpemilu.org#69258,"TATURA SELATAN, PALU SELATAN, KOTA PALU, SULAWESI TENGAH",23,58,49,107
https://kawalpemilu.org#69258,"TATURA SELATAN, PALU SELATAN, KOTA PALU, SULAWESI TENGAH",25,80,58,138
https://kawalpemilu.org#69258,"TATURA SELATAN, PALU SELATAN, KOTA PALU, SULAWESI TENGAH",26,67,19,86
https://kawalpemilu.org#69258,"TATURA SELATAN, PALU SELATAN, KOTA PALU, SULAWESI TENGAH",30,58,42,100
https://kawalpemilu.org#69258,"TATURA SELATAN, PALU SELATAN, KOTA PALU, SULAWESI TENGAH",31,57,107,164
https://kawalpemilu.org#69258,"TATURA SELATAN, PALU SELATAN, KOTA PALU, SULAWESI TENGAH",32,20,93,113
https://kawalpemilu.org#69260,"MAMBORO, PALU UTARA, KOTA PALU, SULAWESI TENGAH",1,101,111,212
https://kawalpemilu.org#69260,"MAMBORO, PALU UTARA, KOTA PALU, SULAWESI TENGAH",2,108,120,228
https://kawalpemilu.org#69260,"MAMBORO, PALU UTARA, KOTA PALU, SULAWESI TENGAH",4,50,128,178
https://kawalpemilu.org#69260,"MAMBORO, PALU UTARA, KOTA PALU, SULAWESI TENGAH",5,79,136,215
https://kawalpemilu.org#69260,"MAMBORO, PALU UTARA, KOTA PALU, SULAWESI TENGAH",6,63,175,238
https://kawalpemilu.org#69260,"MAMBORO, PALU UTARA, KOTA PALU, SULAWESI TENGAH",7,81,137,218
https://kawalpemilu.org#69260,"MAMBORO, PALU UTARA, KOTA PALU, SULAWESI TENGAH",8,63,159,242
https://kawalpemilu.org#69260,"MAMBORO, PALU UTARA, KOTA PALU, SULAWESI TENGAH",9,103,85,188
https://kawalpemilu.org#69260,"MAMBORO, PALU UTARA, KOTA PALU, SULAWESI TENGAH",10,116,66,182
https://kawalpemilu.org#69260,"MAMBORO, PALU UTARA, KOTA PALU, SULAWESI TENGAH",11,111,132,243
https://kawalpemilu.org#69260,"MAMBORO, PALU UTARA, KOTA PALU, SULAWESI TENGAH",13,88,93,181
https://kawalpemilu.org#69260,"MAMBORO, PALU UTARA, KOTA PALU, SULAWESI TENGAH",14,55,126,181
https://kawalpemilu.org#69260,"MAMBORO, PALU UTARA, KOTA PALU, SULAWESI TENGAH",15,69,93,162
https://kawalpemilu.org#69261,"TAIPA, PALU UTARA, KOTA PALU, SULAWESI TENGAH",1,86,130,216
https://kawalpemilu.org#69261,"TAIPA, PALU UTARA, KOTA PALU, SULAWESI TENGAH",5,105,121,226
https://kawalpemilu.org#69261,"TAIPA, PALU UTARA, KOTA PALU, SULAWESI TENGAH",15,122,54,176
https://kawalpemilu.org#69262,"KAYUMALUE NGAPA, PALU UTARA, KOTA PALU, SULAWESI TENGAH",1,98,106,204
https://kawalpemilu.org#69262,"KAYUMALUE NGAPA, PALU UTARA, KOTA PALU, SULAWESI TENGAH",2,83,61,144
https://kawalpemilu.org#69262,"KAYUMALUE NGAPA, PALU UTARA, KOTA PALU, SULAWESI TENGAH",3,58,78,136
https://kawalpemilu.org#69262,"KAYUMALUE NGAPA, PALU UTARA, KOTA PALU, SULAWESI TENGAH",4,133,71,204
https://kawalpemilu.org#69262,"KAYUMALUE NGAPA, PALU UTARA, KOTA PALU, SULAWESI TENGAH",5,164,57,221
https://kawalpemilu.org#69262,"KAYUMALUE NGAPA, PALU UTARA, KOTA PALU, SULAWESI TENGAH",6,147,89,236
https://kawalpemilu.org#69262,"KAYUMALUE NGAPA, PALU UTARA, KOTA PALU, SULAWESI TENGAH",7,125,43,168
https://kawalpemilu.org#69262,"KAYUMALUE NGAPA, PALU UTARA, KOTA PALU, SULAWESI TENGAH",8,122,63,185
https://kawalpemilu.org#69262,"KAYUMALUE NGAPA, PALU UTARA, KOTA PALU, SULAWESI TENGAH",10,158,59,217
https://kawalpemilu.org#69262,"KAYUMALUE NGAPA, PALU UTARA, KOTA PALU, SULAWESI TENGAH",11,124,79,203
https://kawalpemilu.org#69262,"KAYUMALUE NGAPA, PALU UTARA, KOTA PALU, SULAWESI TENGAH",12,48,21,69
https://kawalpemilu.org#69263,"KAYUMALUE PAJEKO, PALU UTARA, KOTA PALU, SULAWESI TENGAH",1,86,128,214
https://kawalpemilu.org#69263,"KAYUMALUE PAJEKO, PALU UTARA, KOTA PALU, SULAWESI TENGAH",2,140,79,219
https://kawalpemilu.org#69263,"KAYUMALUE PAJEKO, PALU UTARA, KOTA PALU, SULAWESI TENGAH",3,81,81,162
https://kawalpemilu.org#69263,"KAYUMALUE PAJEKO, PALU UTARA, KOTA PALU, SULAWESI TENGAH",4,64,106,170
https://kawalpemilu.org#69263,"KAYUMALUE PAJEKO, PALU UTARA, KOTA PALU, SULAWESI TENGAH",5,124,60,184
https://kawalpemilu.org#69263,"KAYUMALUE PAJEKO, PALU UTARA, KOTA PALU, SULAWESI TENGAH",6,116,70,186
https://kawalpemilu.org#69263,"KAYUMALUE PAJEKO, PALU UTARA, KOTA PALU, SULAWESI TENGAH",7,144,36,180
https://kawalpemilu.org#69263,"KAYUMALUE PAJEKO, PALU UTARA, KOTA PALU, SULAWESI TENGAH",8,147,77,224
https://kawalpemilu.org#69263,"KAYUMALUE PAJEKO, PALU UTARA, KOTA PALU, SULAWESI TENGAH",9,140,62,202
https://kawalpemilu.org#85746,"MAMBORO BARAT, PALU UTARA, KOTA PALU, SULAWESI TENGAH",1,36,40,76
https://kawalpemilu.org#85746,"MAMBORO BARAT, PALU UTARA, KOTA PALU, SULAWESI TENGAH",2,38,116,154
https://kawalpemilu.org#85746,"MAMBORO BARAT, PALU UTARA, KOTA PALU, SULAWESI TENGAH",4,82,153,235
https://kawalpemilu.org#85746,"MAMBORO BARAT, PALU UTARA, KOTA PALU, SULAWESI TENGAH",5,88,149,237
https://kawalpemilu.org#85746,"MAMBORO BARAT, PALU UTARA, KOTA PALU, SULAWESI TENGAH",6,64,96,160
https://kawalpemilu.org#85746,"MAMBORO BARAT, PALU UTARA, KOTA PALU, SULAWESI TENGAH",7,82,57,139
https://kawalpemilu.org#85746,"MAMBORO BARAT, PALU UTARA, KOTA PALU, SULAWESI TENGAH",8,89,141,230
https://kawalpemilu.org#85746,"MAMBORO BARAT, PALU UTARA, KOTA PALU, SULAWESI TENGAH",9,70,148,218
https://kawalpemilu.org#85746,"MAMBORO BARAT, PALU UTARA, KOTA PALU, SULAWESI TENGAH",10,44,78,122
https://kawalpemilu.org#69236,"DONGGALA KODI, ULUJADI, KOTA PALU, SULAWESI TENGAH",1,42,102,144
https://kawalpemilu.org#69236,"DONGGALA KODI, ULUJADI, KOTA PALU, SULAWESI TENGAH",2,34,100,134
https://kawalpemilu.org#69236,"DONGGALA KODI, ULUJADI, KOTA PALU, SULAWESI TENGAH",3,49,98,147
https://kawalpemilu.org#69236,"DONGGALA KODI, ULUJADI, KOTA PALU, SULAWESI TENGAH",4,40,135,175
https://kawalpemilu.org#69236,"DONGGALA KODI, ULUJADI, KOTA PALU, SULAWESI TENGAH",5,29,72,101
https://kawalpemilu.org#69236,"DONGGALA KODI, ULUJADI, KOTA PALU, SULAWESI TENGAH",6,53,126,179
https://kawalpemilu.org#69236,"DONGGALA KODI, ULUJADI, KOTA PALU, SULAWESI TENGAH",7,79,178,257
https://kawalpemilu.org#69236,"DONGGALA KODI, ULUJADI, KOTA PALU, SULAWESI TENGAH",8,53,145,198
https://kawalpemilu.org#69236,"DONGGALA KODI, ULUJADI, KOTA PALU, SULAWESI TENGAH",10,51,135,186
https://kawalpemilu.org#69236,"DONGGALA KODI, ULUJADI, KOTA PALU, SULAWESI TENGAH",11,44,101,145
https://kawalpemilu.org#69236,"DONGGALA KODI, ULUJADI, KOTA PALU, SULAWESI TENGAH",12,63,168,231
https://kawalpemilu.org#69236,"DONGGALA KODI, ULUJADI, KOTA PALU, SULAWESI TENGAH",13,35,159,194
https://kawalpemilu.org#69236,"DONGGALA KODI, ULUJADI, KOTA PALU, SULAWESI TENGAH",14,42,133,175
https://kawalpemilu.org#69236,"DONGGALA KODI, ULUJADI, KOTA PALU, SULAWESI TENGAH",15,39,157,196
https://kawalpemilu.org#69236,"DONGGALA KODI, ULUJADI, KOTA PALU, SULAWESI TENGAH",16,26,117,143
https://kawalpemilu.org#69236,"DONGGALA KODI, ULUJADI, KOTA PALU, SULAWESI TENGAH",17,64,137,201
https://kawalpemilu.org#69236,"DONGGALA KODI, ULUJADI, KOTA PALU, SULAWESI TENGAH",18,76,175,251
https://kawalpemilu.org#69236,"DONGGALA KODI, ULUJADI, KOTA PALU, SULAWESI TENGAH",19,36,131,167
https://kawalpemilu.org#69236,"DONGGALA KODI, ULUJADI, KOTA PALU, SULAWESI TENGAH",20,46,124,170
https://kawalpemilu.org#69236,"DONGGALA KODI, ULUJADI, KOTA PALU, SULAWESI TENGAH",21,53,110,163
https://kawalpemilu.org#69236,"DONGGALA KODI, ULUJADI, KOTA PALU, SULAWESI TENGAH",22,68,160,228
https://kawalpemilu.org#69236,"DONGGALA KODI, ULUJADI, KOTA PALU, SULAWESI TENGAH",23,39,69,108
https://kawalpemilu.org#69236,"DONGGALA KODI, ULUJADI, KOTA PALU, SULAWESI TENGAH",25,79,140,219
https://kawalpemilu.org#69236,"DONGGALA KODI, ULUJADI, KOTA PALU, SULAWESI TENGAH",26,77,131,208
https://kawalpemilu.org#69236,"DONGGALA KODI, ULUJADI, KOTA PALU, SULAWESI TENGAH",27,144,104,248
https://kawalpemilu.org#69236,"DONGGALA KODI, ULUJADI, KOTA PALU, SULAWESI TENGAH",28,125,66,191
https://kawalpemilu.org#69240,"KABONENA, ULUJADI, KOTA PALU, SULAWESI TENGAH",1,50,144,194
https://kawalpemilu.org#69240,"KABONENA, ULUJADI, KOTA PALU, SULAWESI TENGAH",2,50,144,194
https://kawalpemilu.org#69240,"KABONENA, ULUJADI, KOTA PALU, SULAWESI TENGAH",3,76,133,209
https://kawalpemilu.org#69240,"KABONENA, ULUJADI, KOTA PALU, SULAWESI TENGAH",5,70,82,152
https://kawalpemilu.org#69240,"KABONENA, ULUJADI, KOTA PALU, SULAWESI TENGAH",6,64,88,152
https://kawalpemilu.org#69240,"KABONENA, ULUJADI, KOTA PALU, SULAWESI TENGAH",7,76,146,222
https://kawalpemilu.org#69240,"KABONENA, ULUJADI, KOTA PALU, SULAWESI TENGAH",8,71,101,172
https://kawalpemilu.org#69240,"KABONENA, ULUJADI, KOTA PALU, SULAWESI TENGAH",10,50,103,153
https://kawalpemilu.org#69240,"KABONENA, ULUJADI, KOTA PALU, SULAWESI TENGAH",11,73,145,218
https://kawalpemilu.org#69240,"KABONENA, ULUJADI, KOTA PALU, SULAWESI TENGAH",12,77,131,208
https://kawalpemilu.org#69240,"KABONENA, ULUJADI, KOTA PALU, SULAWESI TENGAH",13,27,83,110
https://kawalpemilu.org#69240,"KABONENA, ULUJADI, KOTA PALU, SULAWESI TENGAH",14,74,102,176
https://kawalpemilu.org#69240,"KABONENA, ULUJADI, KOTA PALU, SULAWESI TENGAH",15,33,78,111
https://kawalpemilu.org#69240,"KABONENA, ULUJADI, KOTA PALU, SULAWESI TENGAH",16,43,78,121
https://kawalpemilu.org#69240,"KABONENA, ULUJADI, KOTA PALU, SULAWESI TENGAH",18,23,95,118
https://kawalpemilu.org#69240,"KABONENA, ULUJADI, KOTA PALU, SULAWESI TENGAH",20,37,47,84
https://kawalpemilu.org#69240,"KABONENA, ULUJADI, KOTA PALU, SULAWESI TENGAH",21,47,97,144
https://kawalpemilu.org#69241,"TIPO, ULUJADI, KOTA PALU, SULAWESI TENGAH",2,61,123,184
https://kawalpemilu.org#69241,"TIPO, ULUJADI, KOTA PALU, SULAWESI TENGAH",4,53,149,202
https://kawalpemilu.org#69241,"TIPO, ULUJADI, KOTA PALU, SULAWESI TENGAH",5,52,158,210
https://kawalpemilu.org#69241,"TIPO, ULUJADI, KOTA PALU, SULAWESI TENGAH",6,54,153,207
https://kawalpemilu.org#69241,"TIPO, ULUJADI, KOTA PALU, SULAWESI TENGAH",8,28,152,180
https://kawalpemilu.org#69241,"TIPO, ULUJADI, KOTA PALU, SULAWESI TENGAH",9,51,163,214
https://kawalpemilu.org#69241,"TIPO, ULUJADI, KOTA PALU, SULAWESI TENGAH",10,214,11,225
https://kawalpemilu.org#69241,"TIPO, ULUJADI, KOTA PALU, SULAWESI TENGAH",11,219,4,223
https://kawalpemilu.org#69242,"BULURI, ULUJADI, KOTA PALU, SULAWESI TENGAH",1,81,151,232
https://kawalpemilu.org#69242,"BULURI, ULUJADI, KOTA PALU, SULAWESI TENGAH",2,79,114,193
https://kawalpemilu.org#69242,"BULURI, ULUJADI, KOTA PALU, SULAWESI TENGAH",3,49,148,197
https://kawalpemilu.org#69242,"BULURI, ULUJADI, KOTA PALU, SULAWESI TENGAH",4,75,104,179
https://kawalpemilu.org#69242,"BULURI, ULUJADI, KOTA PALU, SULAWESI TENGAH",5,78,94,172
https://kawalpemilu.org#69242,"BULURI, ULUJADI, KOTA PALU, SULAWESI TENGAH",6,38,70,108
https://kawalpemilu.org#69242,"BULURI, ULUJADI, KOTA PALU, SULAWESI TENGAH",7,76,52,128
https://kawalpemilu.org#69242,"BULURI, ULUJADI, KOTA PALU, SULAWESI TENGAH",8,125,56,181
https://kawalpemilu.org#69242,"BULURI, ULUJADI, KOTA PALU, SULAWESI TENGAH",9,127,58,185
https://kawalpemilu.org#69242,"BULURI, ULUJADI, KOTA PALU, SULAWESI TENGAH",10,123,17,140
https://kawalpemilu.org#69242,"BULURI, ULUJADI, KOTA PALU, SULAWESI TENGAH",11,149,9,158
https://kawalpemilu.org#69243,"SILAE, ULUJADI, KOTA PALU, SULAWESI TENGAH",1,43,171,214
https://kawalpemilu.org#69243,"SILAE, ULUJADI, KOTA PALU, SULAWESI TENGAH",2,60,148,208
https://kawalpemilu.org#69243,"SILAE, ULUJADI, KOTA PALU, SULAWESI TENGAH",3,54,117,171
https://kawalpemilu.org#69243,"SILAE, ULUJADI, KOTA PALU, SULAWESI TENGAH",4,66,146,212
https://kawalpemilu.org#69243,"SILAE, ULUJADI, KOTA PALU, SULAWESI TENGAH",5,38,122,160
https://kawalpemilu.org#69243,"SILAE, ULUJADI, KOTA PALU, SULAWESI TENGAH",6,34,133,167
https://kawalpemilu.org#69243,"SILAE, ULUJADI, KOTA PALU, SULAWESI TENGAH",7,64,145,209
https://kawalpemilu.org#69243,"SILAE, ULUJADI, KOTA PALU, SULAWESI TENGAH",8,41,147,188
https://kawalpemilu.org#69243,"SILAE, ULUJADI, KOTA PALU, SULAWESI TENGAH",9,109,109,218
https://kawalpemilu.org#69243,"SILAE, ULUJADI, KOTA PALU, SULAWESI TENGAH",10,76,112,188
https://kawalpemilu.org#69243,"SILAE, ULUJADI, KOTA PALU, SULAWESI TENGAH",11,76,145,221
https://kawalpemilu.org#69243,"SILAE, ULUJADI, KOTA PALU, SULAWESI TENGAH",12,79,153,232
https://kawalpemilu.org#69243,"SILAE, ULUJADI, KOTA PALU, SULAWESI TENGAH",13,52,124,176
https://kawalpemilu.org#69243,"SILAE, ULUJADI, KOTA PALU, SULAWESI TENGAH",14,55,72,127
https://kawalpemilu.org#69243,"SILAE, ULUJADI, KOTA PALU, SULAWESI TENGAH",15,37,132,169
https://kawalpemilu.org#69243,"SILAE, ULUJADI, KOTA PALU, SULAWESI TENGAH",16,52,157,209
https://kawalpemilu.org#69243,"SILAE, ULUJADI, KOTA PALU, SULAWESI TENGAH",17,52,121,173
https://kawalpemilu.org#69244,"WATUSAMPU, ULUJADI, KOTA PALU, SULAWESI TENGAH",1,86,142,228
https://kawalpemilu.org#69244,"WATUSAMPU, ULUJADI, KOTA PALU, SULAWESI TENGAH",2,50,101,151
https://kawalpemilu.org#69244,"WATUSAMPU, ULUJADI, KOTA PALU, SULAWESI TENGAH",3,94,120,214
https://kawalpemilu.org#69244,"WATUSAMPU, ULUJADI, KOTA PALU, SULAWESI TENGAH",4,94,113,207
https://kawalpemilu.org#69244,"WATUSAMPU, ULUJADI, KOTA PALU, SULAWESI TENGAH",5,97,73,170
https://kawalpemilu.org#69244,"WATUSAMPU, ULUJADI, KOTA PALU, SULAWESI TENGAH",6,109,92,201
https://kawalpemilu.org#69244,"WATUSAMPU, ULUJADI, KOTA PALU, SULAWESI TENGAH",7,74,78,152
https://kawalpemilu.org#69244,"WATUSAMPU, ULUJADI, KOTA PALU, SULAWESI TENGAH",8,100,44,144
https://kawalpemilu.org#69231,"DUYU, TATANGA, KOTA PALU, SULAWESI TENGAH",1,84,127,211
https://kawalpemilu.org#69231,"DUYU, TATANGA, KOTA PALU, SULAWESI TENGAH",2,71,81,152
https://kawalpemilu.org#69231,"DUYU, TATANGA, KOTA PALU, SULAWESI TENGAH",4,53,136,189
https://kawalpemilu.org#69231,"DUYU, TATANGA, KOTA PALU, SULAWESI TENGAH",5,131,86,217
https://kawalpemilu.org#69231,"DUYU, TATANGA, KOTA PALU, SULAWESI TENGAH",6,77,136,213
https://kawalpemilu.org#69231,"DUYU, TATANGA, KOTA PALU, SULAWESI TENGAH",7,81,87,168
https://kawalpemilu.org#69231,"DUYU, TATANGA, KOTA PALU, SULAWESI TENGAH",8,62,110,172
https://kawalpemilu.org#69231,"DUYU, TATANGA, KOTA PALU, SULAWESI TENGAH",9,89,172,261
https://kawalpemilu.org#69231,"DUYU, TATANGA, KOTA PALU, SULAWESI TENGAH",11,59,102,161
https://kawalpemilu.org#69231,"DUYU, TATANGA, KOTA PALU, SULAWESI TENGAH",12,126,142,268
https://kawalpemilu.org#69231,"DUYU, TATANGA, KOTA PALU, SULAWESI TENGAH",13,71,81,152
https://kawalpemilu.org#69231,"DUYU, TATANGA, KOTA PALU, SULAWESI TENGAH",14,56,130,186
https://kawalpemilu.org#69231,"DUYU, TATANGA, KOTA PALU, SULAWESI TENGAH",15,57,90,147
https://kawalpemilu.org#69231,"DUYU, TATANGA, KOTA PALU, SULAWESI TENGAH",16,93,162,255
https://kawalpemilu.org#69231,"DUYU, TATANGA, KOTA PALU, SULAWESI TENGAH",17,44,124,168
https://kawalpemilu.org#69231,"DUYU, TATANGA, KOTA PALU, SULAWESI TENGAH",18,26,154,180
https://kawalpemilu.org#69231,"DUYU, TATANGA, KOTA PALU, SULAWESI TENGAH",19,32,75,107
https://kawalpemilu.org#69231,"DUYU, TATANGA, KOTA PALU, SULAWESI TENGAH",20,57,140,197
https://kawalpemilu.org#69231,"DUYU, TATANGA, KOTA PALU, SULAWESI TENGAH",21,69,149,218
https://kawalpemilu.org#69231,"DUYU, TATANGA, KOTA PALU, SULAWESI TENGAH",22,92,133,225
https://kawalpemilu.org#69231,"DUYU, TATANGA, KOTA PALU, SULAWESI TENGAH",23,57,89,146
https://kawalpemilu.org#69231,"DUYU, TATANGA, KOTA PALU, SULAWESI TENGAH",24,38,58,96
https://kawalpemilu.org#69233,"NUNU, TATANGA, KOTA PALU, SULAWESI TENGAH",1,38,70,108
https://kawalpemilu.org#69233,"NUNU, TATANGA, KOTA PALU, SULAWESI TENGAH",3,102,137,239
https://kawalpemilu.org#69233,"NUNU, TATANGA, KOTA PALU, SULAWESI TENGAH",4,69,81,150
https://kawalpemilu.org#69233,"NUNU, TATANGA, KOTA PALU, SULAWESI TENGAH",6,71,153,224
https://kawalpemilu.org#69233,"NUNU, TATANGA, KOTA PALU, SULAWESI TENGAH",7,32,157,189
https://kawalpemilu.org#69233,"NUNU, TATANGA, KOTA PALU, SULAWESI TENGAH",8,35,136,171
https://kawalpemilu.org#69233,"NUNU, TATANGA, KOTA PALU, SULAWESI TENGAH",10,125,112,237
https://kawalpemilu.org#69233,"NUNU, TATANGA, KOTA PALU, SULAWESI TENGAH",11,50,138,188
https://kawalpemilu.org#69233,"NUNU, TATANGA, KOTA PALU, SULAWESI TENGAH",12,68,124,192
https://kawalpemilu.org#69233,"NUNU, TATANGA, KOTA PALU, SULAWESI TENGAH",13,194,38,232
https://kawalpemilu.org#69233,"NUNU, TATANGA, KOTA PALU, SULAWESI TENGAH",15,115,93,208
https://kawalpemilu.org#69233,"NUNU, TATANGA, KOTA PALU, SULAWESI TENGAH",16,37,70,107
https://kawalpemilu.org#69233,"NUNU, TATANGA, KOTA PALU, SULAWESI TENGAH",18,102,92,194
https://kawalpemilu.org#69233,"NUNU, TATANGA, KOTA PALU, SULAWESI TENGAH",19,165,57,222
https://kawalpemilu.org#69233,"NUNU, TATANGA, KOTA PALU, SULAWESI TENGAH",20,118,64,182
https://kawalpemilu.org#69233,"NUNU, TATANGA, KOTA PALU, SULAWESI TENGAH",21,95,57,152
https://kawalpemilu.org#69233,"NUNU, TATANGA, KOTA PALU, SULAWESI TENGAH",22,78,91,169
https://kawalpemilu.org#69233,"NUNU, TATANGA, KOTA PALU, SULAWESI TENGAH",23,31,83,114
https://kawalpemilu.org#69233,"NUNU, TATANGA, KOTA PALU, SULAWESI TENGAH",24,70,42,112
https://kawalpemilu.org#69234,"BOYAOGE, TATANGA, KOTA PALU, SULAWESI TENGAH",1,72,154,226
https://kawalpemilu.org#69234,"BOYAOGE, TATANGA, KOTA PALU, SULAWESI TENGAH",2,61,120,181
https://kawalpemilu.org#69234,"BOYAOGE, TATANGA, KOTA PALU, SULAWESI TENGAH",3,73,169,242
https://kawalpemilu.org#69234,"BOYAOGE, TATANGA, KOTA PALU, SULAWESI TENGAH",4,30,185,215
https://kawalpemilu.org#69234,"BOYAOGE, TATANGA, KOTA PALU, SULAWESI TENGAH",5,80,156,236
https://kawalpemilu.org#69234,"BOYAOGE, TATANGA, KOTA PALU, SULAWESI TENGAH",7,87,138,225
https://kawalpemilu.org#69234,"BOYAOGE, TATANGA, KOTA PALU, SULAWESI TENGAH",8,51,97,148
https://kawalpemilu.org#69234,"BOYAOGE, TATANGA, KOTA PALU, SULAWESI TENGAH",9,77,92,169
https://kawalpemilu.org#69234,"BOYAOGE, TATANGA, KOTA PALU, SULAWESI TENGAH",11,66,140,206
https://kawalpemilu.org#69234,"BOYAOGE, TATANGA, KOTA PALU, SULAWESI TENGAH",12,62,141,203
https://kawalpemilu.org#69234,"BOYAOGE, TATANGA, KOTA PALU, SULAWESI TENGAH",13,41,117,158
https://kawalpemilu.org#69234,"BOYAOGE, TATANGA, KOTA PALU, SULAWESI TENGAH",14,72,106,178
https://kawalpemilu.org#69234,"BOYAOGE, TATANGA, KOTA PALU, SULAWESI TENGAH",15,95,135,230
https://kawalpemilu.org#69234,"BOYAOGE, TATANGA, KOTA PALU, SULAWESI TENGAH",16,50,101,151
https://kawalpemilu.org#69234,"BOYAOGE, TATANGA, KOTA PALU, SULAWESI TENGAH",17,49,144,193
https://kawalpemilu.org#69234,"BOYAOGE, TATANGA, KOTA PALU, SULAWESI TENGAH",18,80,127,207
https://kawalpemilu.org#69234,"BOYAOGE, TATANGA, KOTA PALU, SULAWESI TENGAH",19,62,115,177
https://kawalpemilu.org#69234,"BOYAOGE, TATANGA, KOTA PALU, SULAWESI TENGAH",20,59,123,182
https://kawalpemilu.org#69234,"BOYAOGE, TATANGA, KOTA PALU, SULAWESI TENGAH",21,26,61,87
https://kawalpemilu.org#69253,"TAVANJUKA, TATANGA, KOTA PALU, SULAWESI TENGAH",1,36,126,162
https://kawalpemilu.org#69253,"TAVANJUKA, TATANGA, KOTA PALU, SULAWESI TENGAH",3,51,123,174
https://kawalpemilu.org#69253,"TAVANJUKA, TATANGA, KOTA PALU, SULAWESI TENGAH",4,69,87,156
https://kawalpemilu.org#69253,"TAVANJUKA, TATANGA, KOTA PALU, SULAWESI TENGAH",5,50,63,113
https://kawalpemilu.org#69253,"TAVANJUKA, TATANGA, KOTA PALU, SULAWESI TENGAH",6,88,79,167
https://kawalpemilu.org#69253,"TAVANJUKA, TATANGA, KOTA PALU, SULAWESI TENGAH",7,55,68,123
https://kawalpemilu.org#69253,"TAVANJUKA, TATANGA, KOTA PALU, SULAWESI TENGAH",8,62,48,110
https://kawalpemilu.org#69253,"TAVANJUKA, TATANGA, KOTA PALU, SULAWESI TENGAH",9,40,106,146
https://kawalpemilu.org#69253,"TAVANJUKA, TATANGA, KOTA PALU, SULAWESI TENGAH",10,39,160,199
https://kawalpemilu.org#69253,"TAVANJUKA, TATANGA, KOTA PALU, SULAWESI TENGAH",11,45,125,170
https://kawalpemilu.org#69253,"TAVANJUKA, TATANGA, KOTA PALU, SULAWESI TENGAH",12,27,146,173
https://kawalpemilu.org#69253,"TAVANJUKA, TATANGA, KOTA PALU, SULAWESI TENGAH",15,66,148,214
https://kawalpemilu.org#69254,"PALUPI, TATANGA, KOTA PALU, SULAWESI TENGAH",1,61,134,195
https://kawalpemilu.org#69254,"PALUPI, TATANGA, KOTA PALU, SULAWESI TENGAH",2,57,151,208
https://kawalpemilu.org#69254,"PALUPI, TATANGA, KOTA PALU, SULAWESI TENGAH",3,74,158,232
https://kawalpemilu.org#69254,"PALUPI, TATANGA, KOTA PALU, SULAWESI TENGAH",4,52,139,191
https://kawalpemilu.org#69254,"PALUPI, TATANGA, KOTA PALU, SULAWESI TENGAH",5,52,157,209
https://kawalpemilu.org#69254,"PALUPI, TATANGA, KOTA PALU, SULAWESI TENGAH",6,54,125,179
https://kawalpemilu.org#69254,"PALUPI, TATANGA, KOTA PALU, SULAWESI TENGAH",7,70,153,223
https://kawalpemilu.org#69254,"PALUPI, TATANGA, KOTA PALU, SULAWESI TENGAH",8,74,152,226
https://kawalpemilu.org#69254,"PALUPI, TATANGA, KOTA PALU, SULAWESI TENGAH",9,59,123,182
https://kawalpemilu.org#69254,"PALUPI, TATANGA, KOTA PALU, SULAWESI TENGAH",10,98,112,210
https://kawalpemilu.org#69254,"PALUPI, TATANGA, KOTA PALU, SULAWESI TENGAH",11,46,125,171
https://kawalpemilu.org#69254,"PALUPI, TATANGA, KOTA PALU, SULAWESI TENGAH",12,56,59,115
https://kawalpemilu.org#69254,"PALUPI, TATANGA, KOTA PALU, SULAWESI TENGAH",13,52,82,134
https://kawalpemilu.org#69254,"PALUPI, TATANGA, KOTA PALU, SULAWESI TENGAH",14,37,52,89
https://kawalpemilu.org#69254,"PALUPI, TATANGA, KOTA PALU, SULAWESI TENGAH",15,69,103,172
https://kawalpemilu.org#69254,"PALUPI, TATANGA, KOTA PALU, SULAWESI TENGAH",16,51,130,181
https://kawalpemilu.org#69254,"PALUPI, TATANGA, KOTA PALU, SULAWESI TENGAH",17,63,92,155
https://kawalpemilu.org#69254,"PALUPI, TATANGA, KOTA PALU, SULAWESI TENGAH",18,71,96,167
https://kawalpemilu.org#69254,"PALUPI, TATANGA, KOTA PALU, SULAWESI TENGAH",19,71,166,237
https://kawalpemilu.org#69254,"PALUPI, TATANGA, KOTA PALU, SULAWESI TENGAH",20,90,144,234
https://kawalpemilu.org#69254,"PALUPI, TATANGA, KOTA PALU, SULAWESI TENGAH",21,81,174,255
https://kawalpemilu.org#69254,"PALUPI, TATANGA, KOTA PALU, SULAWESI TENGAH",22,61,141,202
https://kawalpemilu.org#69254,"PALUPI, TATANGA, KOTA PALU, SULAWESI TENGAH",23,50,150,200
https://kawalpemilu.org#69254,"PALUPI, TATANGA, KOTA PALU, SULAWESI TENGAH",24,102,158,260
https://kawalpemilu.org#69254,"PALUPI, TATANGA, KOTA PALU, SULAWESI TENGAH",25,78,165,243
https://kawalpemilu.org#69254,"PALUPI, TATANGA, KOTA PALU, SULAWESI TENGAH",26,58,110,168
https://kawalpemilu.org#69254,"PALUPI, TATANGA, KOTA PALU, SULAWESI TENGAH",27,49,154,203
https://kawalpemilu.org#69254,"PALUPI, TATANGA, KOTA PALU, SULAWESI TENGAH",28,66,181,247
https://kawalpemilu.org#69255,"PENGAWU, TATANGA, KOTA PALU, SULAWESI TENGAH",1,45,68,113
https://kawalpemilu.org#69255,"PENGAWU, TATANGA, KOTA PALU, SULAWESI TENGAH",2,55,107,162
https://kawalpemilu.org#69255,"PENGAWU, TATANGA, KOTA PALU, SULAWESI TENGAH",3,62,157,219
https://kawalpemilu.org#69255,"PENGAWU, TATANGA, KOTA PALU, SULAWESI TENGAH",4,29,192,221
https://kawalpemilu.org#69255,"PENGAWU, TATANGA, KOTA PALU, SULAWESI TENGAH",5,39,179,218
https://kawalpemilu.org#69255,"PENGAWU, TATANGA, KOTA PALU, SULAWESI TENGAH",6,61,124,185
https://kawalpemilu.org#69255,"PENGAWU, TATANGA, KOTA PALU, SULAWESI TENGAH",7,62,166,228
https://kawalpemilu.org#69255,"PENGAWU, TATANGA, KOTA PALU, SULAWESI TENGAH",8,63,164,227
https://kawalpemilu.org#69255,"PENGAWU, TATANGA, KOTA PALU, SULAWESI TENGAH",9,47,115,162
https://kawalpemilu.org#69255,"PENGAWU, TATANGA, KOTA PALU, SULAWESI TENGAH",10,40,179,219
https://kawalpemilu.org#69255,"PENGAWU, TATANGA, KOTA PALU, SULAWESI TENGAH",11,38,147,185
https://kawalpemilu.org#69255,"PENGAWU, TATANGA, KOTA PALU, SULAWESI TENGAH",12,53,127,180
https://kawalpemilu.org#69255,"PENGAWU, TATANGA, KOTA PALU, SULAWESI TENGAH",13,59,142,201
https://kawalpemilu.org#69255,"PENGAWU, TATANGA, KOTA PALU, SULAWESI TENGAH",14,48,123,171
https://kawalpemilu.org#69255,"PENGAWU, TATANGA, KOTA PALU, SULAWESI TENGAH",15,67,120,187
https://kawalpemilu.org#69255,"PENGAWU, TATANGA, KOTA PALU, SULAWESI TENGAH",16,58,162,220
https://kawalpemilu.org#69255,"PENGAWU, TATANGA, KOTA PALU, SULAWESI TENGAH",17,59,150,209
https://kawalpemilu.org#69255,"PENGAWU, TATANGA, KOTA PALU, SULAWESI TENGAH",18,61,151,212
https://kawalpemilu.org#69255,"PENGAWU, TATANGA, KOTA PALU, SULAWESI TENGAH",19,74,184,258
https://kawalpemilu.org#69255,"PENGAWU, TATANGA, KOTA PALU, SULAWESI TENGAH",20,78,150,228
https://kawalpemilu.org#69265,"LAMBARA, TAWAELI, KOTA PALU, SULAWESI TENGAH",1,35,81,116
https://kawalpemilu.org#69265,"LAMBARA, TAWAELI, KOTA PALU, SULAWESI TENGAH",2,126,58,184
https://kawalpemilu.org#69265,"LAMBARA, TAWAELI, KOTA PALU, SULAWESI TENGAH",3,88,121,209
https://kawalpemilu.org#69265,"LAMBARA, TAWAELI, KOTA PALU, SULAWESI TENGAH",4,97,136,233
https://kawalpemilu.org#69265,"LAMBARA, TAWAELI, KOTA PALU, SULAWESI TENGAH",5,62,123,185
https://kawalpemilu.org#69265,"LAMBARA, TAWAELI, KOTA PALU, SULAWESI TENGAH",6,59,172,231
https://kawalpemilu.org#69265,"LAMBARA, TAWAELI, KOTA PALU, SULAWESI TENGAH",7,84,148,232
https://kawalpemilu.org#69265,"LAMBARA, TAWAELI, KOTA PALU, SULAWESI TENGAH",8,135,117,252
https://kawalpemilu.org#69265,"LAMBARA, TAWAELI, KOTA PALU, SULAWESI TENGAH",9,77,95,172
https://kawalpemilu.org#69265,"LAMBARA, TAWAELI, KOTA PALU, SULAWESI TENGAH",10,39,139,178
https://kawalpemilu.org#69266,"BAIYA, TAWAELI, KOTA PALU, SULAWESI TENGAH",1,79,85,164
https://kawalpemilu.org#69266,"BAIYA, TAWAELI, KOTA PALU, SULAWESI TENGAH",3,46,118,164
https://kawalpemilu.org#69266,"BAIYA, TAWAELI, KOTA PALU, SULAWESI TENGAH",4,114,99,213
https://kawalpemilu.org#69266,"BAIYA, TAWAELI, KOTA PALU, SULAWESI TENGAH",5,85,74,159
https://kawalpemilu.org#69266,"BAIYA, TAWAELI, KOTA PALU, SULAWESI TENGAH",7,90,131,221
https://kawalpemilu.org#69266,"BAIYA, TAWAELI, KOTA PALU, SULAWESI TENGAH",9,85,100,185
https://kawalpemilu.org#69266,"BAIYA, TAWAELI, KOTA PALU, SULAWESI TENGAH",10,66,85,151
https://kawalpemilu.org#69266,"BAIYA, TAWAELI, KOTA PALU, SULAWESI TENGAH",12,177,80,257
https://kawalpemilu.org#69266,"BAIYA, TAWAELI, KOTA PALU, SULAWESI TENGAH",14,132,88,220
https://kawalpemilu.org#69266,"BAIYA, TAWAELI, KOTA PALU, SULAWESI TENGAH",15,108,66,174
https://kawalpemilu.org#69266,"BAIYA, TAWAELI, KOTA PALU, SULAWESI TENGAH",16,130,57,187
https://kawalpemilu.org#69267,"PANTOLOAN, TAWAELI, KOTA PALU, SULAWESI TENGAH",8,67,122,189
https://kawalpemilu.org#69267,"PANTOLOAN, TAWAELI, KOTA PALU, SULAWESI TENGAH",12,130,75,205
https://kawalpemilu.org#85747,"PANTOLOAN BOYA, TAWAELI, KOTA PALU, SULAWESI TENGAH",1,111,55,166
https://kawalpemilu.org#85747,"PANTOLOAN BOYA, TAWAELI, KOTA PALU, SULAWESI TENGAH",2,104,78,182
https://kawalpemilu.org#85747,"PANTOLOAN BOYA, TAWAELI, KOTA PALU, SULAWESI TENGAH",3,120,38,158
https://kawalpemilu.org#85747,"PANTOLOAN BOYA, TAWAELI, KOTA PALU, SULAWESI TENGAH",4,105,76,181
https://kawalpemilu.org#85747,"PANTOLOAN BOYA, TAWAELI, KOTA PALU, SULAWESI TENGAH",5,113,61,174
https://kawalpemilu.org#85747,"PANTOLOAN BOYA, TAWAELI, KOTA PALU, SULAWESI TENGAH",6,193,23,216
https://kawalpemilu.org#85747,"PANTOLOAN BOYA, TAWAELI, KOTA PALU, SULAWESI TENGAH",7,164,50,214
https://kawalpemilu.org#85747,"PANTOLOAN BOYA, TAWAELI, KOTA PALU, SULAWESI TENGAH",8,126,54,180
https://kawalpemilu.org#85747,"PANTOLOAN BOYA, TAWAELI, KOTA PALU, SULAWESI TENGAH",9,133,43,176
https://kawalpemilu.org#85747,"PANTOLOAN BOYA, TAWAELI, KOTA PALU, SULAWESI TENGAH",10,167,27,194
https://kawalpemilu.org#85747,"PANTOLOAN BOYA, TAWAELI, KOTA PALU, SULAWESI TENGAH",11,137,67,204
https://kawalpemilu.org#85748,"PANAU, TAWAELI, KOTA PALU, SULAWESI TENGAH",1,65,116,181
https://kawalpemilu.org#85748,"PANAU, TAWAELI, KOTA PALU, SULAWESI TENGAH",2,64,181,245
https://kawalpemilu.org#85748,"PANAU, TAWAELI, KOTA PALU, SULAWESI TENGAH",3,105,149,254
https://kawalpemilu.org#85748,"PANAU, TAWAELI, KOTA PALU, SULAWESI TENGAH",8,102,135,237
https://kawalpemilu.org#85748,"PANAU, TAWAELI, KOTA PALU, SULAWESI TENGAH",10,96,67,163
https://kawalpemilu.org#85748,"PANAU, TAWAELI, KOTA PALU, SULAWESI TENGAH",11,62,168,230
https://kawalpemilu.org#69222,"LASOANI, MANTIKULORE, KOTA PALU, SULAWESI TENGAH",2,44,101,145
https://kawalpemilu.org#69222,"LASOANI, MANTIKULORE, KOTA PALU, SULAWESI TENGAH",3,45,134,179
https://kawalpemilu.org#69222,"LASOANI, MANTIKULORE, KOTA PALU, SULAWESI TENGAH",4,32,137,169
https://kawalpemilu.org#69222,"LASOANI, MANTIKULORE, KOTA PALU, SULAWESI TENGAH",5,64,124,188
https://kawalpemilu.org#69222,"LASOANI, MANTIKULORE, KOTA PALU, SULAWESI TENGAH",6,27,49,76
https://kawalpemilu.org#69222,"LASOANI, MANTIKULORE, KOTA PALU, SULAWESI TENGAH",7,76,139,215
https://kawalpemilu.org#69222,"LASOANI, MANTIKULORE, KOTA PALU, SULAWESI TENGAH",8,84,132,216
https://kawalpemilu.org#69222,"LASOANI, MANTIKULORE, KOTA PALU, SULAWESI TENGAH",9,67,76,143
https://kawalpemilu.org#69222,"LASOANI, MANTIKULORE, KOTA PALU, SULAWESI TENGAH",10,85,114,199
https://kawalpemilu.org#69222,"LASOANI, MANTIKULORE, KOTA PALU, SULAWESI TENGAH",13,77,128,205
https://kawalpemilu.org#69222,"LASOANI, MANTIKULORE, KOTA PALU, SULAWESI TENGAH",14,66,84,150
https://kawalpemilu.org#69222,"LASOANI, MANTIKULORE, KOTA PALU, SULAWESI TENGAH",15,62,106,168
https://kawalpemilu.org#69222,"LASOANI, MANTIKULORE, KOTA PALU, SULAWESI TENGAH",17,73,82,155
https://kawalpemilu.org#69222,"LASOANI, MANTIKULORE, KOTA PALU, SULAWESI TENGAH",18,60,95,155
https://kawalpemilu.org#69222,"LASOANI, MANTIKULORE, KOTA PALU, SULAWESI TENGAH",19,69,72,141
https://kawalpemilu.org#69222,"LASOANI, MANTIKULORE, KOTA PALU, SULAWESI TENGAH",20,57,79,136
https://kawalpemilu.org#69222,"LASOANI, MANTIKULORE, KOTA PALU, SULAWESI TENGAH",21,88,90,178
https://kawalpemilu.org#69222,"LASOANI, MANTIKULORE, KOTA PALU, SULAWESI TENGAH",22,77,94,171
https://kawalpemilu.org#69222,"LASOANI, MANTIKULORE, KOTA PALU, SULAWESI TENGAH",23,68,86,154
https://kawalpemilu.org#69222,"LASOANI, MANTIKULORE, KOTA PALU, SULAWESI TENGAH",24,73,90,163
https://kawalpemilu.org#69222,"LASOANI, MANTIKULORE, KOTA PALU, SULAWESI TENGAH",25,68,86,154
https://kawalpemilu.org#69222,"LASOANI, MANTIKULORE, KOTA PALU, SULAWESI TENGAH",26,58,76,134
https://kawalpemilu.org#69222,"LASOANI, MANTIKULORE, KOTA PALU, SULAWESI TENGAH",27,89,55,144
https://kawalpemilu.org#69222,"LASOANI, MANTIKULORE, KOTA PALU, SULAWESI TENGAH",28,75,48,123
https://kawalpemilu.org#69222,"LASOANI, MANTIKULORE, KOTA PALU, SULAWESI TENGAH",29,94,64,158
https://kawalpemilu.org#69222,"LASOANI, MANTIKULORE, KOTA PALU, SULAWESI TENGAH",30,96,101,197
https://kawalpemilu.org#69222,"LASOANI, MANTIKULORE, KOTA PALU, SULAWESI TENGAH",31,92,70,162
https://kawalpemilu.org#69222,"LASOANI, MANTIKULORE, KOTA PALU, SULAWESI TENGAH",32,91,81,172
https://kawalpemilu.org#69222,"LASOANI, MANTIKULORE, KOTA PALU, SULAWESI TENGAH",33,32,105,137
https://kawalpemilu.org#69223,"POBOYA, MANTIKULORE, KOTA PALU, SULAWESI TENGAH",2,30,135,165
https://kawalpemilu.org#69223,"POBOYA, MANTIKULORE, KOTA PALU, SULAWESI TENGAH",3,41,128,169
https://kawalpemilu.org#69223,"POBOYA, MANTIKULORE, KOTA PALU, SULAWESI TENGAH",4,10,173,183
https://kawalpemilu.org#69223,"POBOYA, MANTIKULORE, KOTA PALU, SULAWESI TENGAH",5,59,160,219
https://kawalpemilu.org#69223,"POBOYA, MANTIKULORE, KOTA PALU, SULAWESI TENGAH",7,22,179,201
https://kawalpemilu.org#69223,"POBOYA, MANTIKULORE, KOTA PALU, SULAWESI TENGAH",8,22,129,151
https://kawalpemilu.org#69224,"TALISE, MANTIKULORE, KOTA PALU, SULAWESI TENGAH",1,24,69,93
https://kawalpemilu.org#69224,"TALISE, MANTIKULORE, KOTA PALU, SULAWESI TENGAH",4,47,104,151
https://kawalpemilu.org#69224,"TALISE, MANTIKULORE, KOTA PALU, SULAWESI TENGAH",6,25,30,55
https://kawalpemilu.org#69224,"TALISE, MANTIKULORE, KOTA PALU, SULAWESI TENGAH",7,79,126,205
https://kawalpemilu.org#69224,"TALISE, MANTIKULORE, KOTA PALU, SULAWESI TENGAH",8,74,77,151
https://kawalpemilu.org#69224,"TALISE, MANTIKULORE, KOTA PALU, SULAWESI TENGAH",9,47,150,197
https://kawalpemilu.org#69224,"TALISE, MANTIKULORE, KOTA PALU, SULAWESI TENGAH",11,65,162,227
https://kawalpemilu.org#69224,"TALISE, MANTIKULORE, KOTA PALU, SULAWESI TENGAH",13,21,112,133
https://kawalpemilu.org#69224,"TALISE, MANTIKULORE, KOTA PALU, SULAWESI TENGAH",14,33,83,116
https://kawalpemilu.org#69224,"TALISE, MANTIKULORE, KOTA PALU, SULAWESI TENGAH",15,26,87,113
https://kawalpemilu.org#69224,"TALISE, MANTIKULORE, KOTA PALU, SULAWESI TENGAH",17,42,84,126
https://kawalpemilu.org#69224,"TALISE, MANTIKULORE, KOTA PALU, SULAWESI TENGAH",18,29,77,106
https://kawalpemilu.org#69224,"TALISE, MANTIKULORE, KOTA PALU, SULAWESI TENGAH",19,54,136,190
https://kawalpemilu.org#69224,"TALISE, MANTIKULORE, KOTA PALU, SULAWESI TENGAH",22,43,110,153
https://kawalpemilu.org#69224,"TALISE, MANTIKULORE, KOTA PALU, SULAWESI TENGAH",23,33,107,140
https://kawalpemilu.org#69224,"TALISE, MANTIKULORE, KOTA PALU, SULAWESI TENGAH",28,131,48,179
https://kawalpemilu.org#69224,"TALISE, MANTIKULORE, KOTA PALU, SULAWESI TENGAH",29,51,119,170
https://kawalpemilu.org#69224,"TALISE, MANTIKULORE, KOTA PALU, SULAWESI TENGAH",32,59,91,150
https://kawalpemilu.org#69224,"TALISE, MANTIKULORE, KOTA PALU, SULAWESI TENGAH",34,61,100,161
https://kawalpemilu.org#69224,"TALISE, MANTIKULORE, KOTA PALU, SULAWESI TENGAH",35,77,88,165
https://kawalpemilu.org#69224,"TALISE, MANTIKULORE, KOTA PALU, SULAWESI TENGAH",41,99,122,221
https://kawalpemilu.org#69224,"TALISE, MANTIKULORE, KOTA PALU, SULAWESI TENGAH",43,29,87,116
https://kawalpemilu.org#69224,"TALISE, MANTIKULORE, KOTA PALU, SULAWESI TENGAH",44,37,117,154
https://kawalpemilu.org#69224,"TALISE, MANTIKULORE, KOTA PALU, SULAWESI TENGAH",46,36,79,115
https://kawalpemilu.org#69226,"TONDO, MANTIKULORE, KOTA PALU, SULAWESI TENGAH",2,0,0,0
https://kawalpemilu.org#69226,"TONDO, MANTIKULORE, KOTA PALU, SULAWESI TENGAH",3,99,135,234
https://kawalpemilu.org#69226,"TONDO, MANTIKULORE, KOTA PALU, SULAWESI TENGAH",4,102,145,247
https://kawalpemilu.org#69226,"TONDO, MANTIKULORE, KOTA PALU, SULAWESI TENGAH",6,111,138,249
https://kawalpemilu.org#69226,"TONDO, MANTIKULORE, KOTA PALU, SULAWESI TENGAH",7,86,137,223
https://kawalpemilu.org#69226,"TONDO, MANTIKULORE, KOTA PALU, SULAWESI TENGAH",9,121,156,277
https://kawalpemilu.org#69226,"TONDO, MANTIKULORE, KOTA PALU, SULAWESI TENGAH",10,56,141,197
https://kawalpemilu.org#69226,"TONDO, MANTIKULORE, KOTA PALU, SULAWESI TENGAH",11,61,56,117
https://kawalpemilu.org#69226,"TONDO, MANTIKULORE, KOTA PALU, SULAWESI TENGAH",13,92,124,216
https://kawalpemilu.org#69226,"TONDO, MANTIKULORE, KOTA PALU, SULAWESI TENGAH",14,62,73,135
https://kawalpemilu.org#69226,"TONDO, MANTIKULORE, KOTA PALU, SULAWESI TENGAH",18,87,43,130
https://kawalpemilu.org#69226,"TONDO, MANTIKULORE, KOTA PALU, SULAWESI TENGAH",19,78,143,221
https://kawalpemilu.org#69226,"TONDO, MANTIKULORE, KOTA PALU, SULAWESI TENGAH",21,0,0,197
https://kawalpemilu.org#69226,"TONDO, MANTIKULORE, KOTA PALU, SULAWESI TENGAH",22,33,141,174
https://kawalpemilu.org#69226,"TONDO, MANTIKULORE, KOTA PALU, SULAWESI TENGAH",23,57,109,166
https://kawalpemilu.org#69226,"TONDO, MANTIKULORE, KOTA PALU, SULAWESI TENGAH",24,23,52,75
https://kawalpemilu.org#69226,"TONDO, MANTIKULORE, KOTA PALU, SULAWESI TENGAH",25,41,47,88
https://kawalpemilu.org#69226,"TONDO, MANTIKULORE, KOTA PALU, SULAWESI TENGAH",26,53,67,120
https://kawalpemilu.org#69226,"TONDO, MANTIKULORE, KOTA PALU, SULAWESI TENGAH",27,58,132,190
https://kawalpemilu.org#69226,"TONDO, MANTIKULORE, KOTA PALU, SULAWESI TENGAH",28,54,151,205
https://kawalpemilu.org#69226,"TONDO, MANTIKULORE, KOTA PALU, SULAWESI TENGAH",29,68,132,200
https://kawalpemilu.org#69226,"TONDO, MANTIKULORE, KOTA PALU, SULAWESI TENGAH",30,59,90,149
https://kawalpemilu.org#69226,"TONDO, MANTIKULORE, KOTA PALU, SULAWESI TENGAH",31,115,132,247
https://kawalpemilu.org#69226,"TONDO, MANTIKULORE, KOTA PALU, SULAWESI TENGAH",32,83,127,210
https://kawalpemilu.org#69226,"TONDO, MANTIKULORE, KOTA PALU, SULAWESI TENGAH",33,33,147,180
https://kawalpemilu.org#69226,"TONDO, MANTIKULORE, KOTA PALU, SULAWESI TENGAH",34,47,141,188
https://kawalpemilu.org#69229,"LAYANA INDAH, MANTIKULORE, KOTA PALU, SULAWESI TENGAH",1,70,42,112
https://kawalpemilu.org#69229,"LAYANA INDAH, MANTIKULORE, KOTA PALU, SULAWESI TENGAH",2,86,49,135
https://kawalpemilu.org#69229,"LAYANA INDAH, MANTIKULORE, KOTA PALU, SULAWESI TENGAH",3,107,97,204
https://kawalpemilu.org#69229,"LAYANA INDAH, MANTIKULORE, KOTA PALU, SULAWESI TENGAH",4,110,87,197
https://kawalpemilu.org#69229,"LAYANA INDAH, MANTIKULORE, KOTA PALU, SULAWESI TENGAH",5,106,115,221
https://kawalpemilu.org#69229,"LAYANA INDAH, MANTIKULORE, KOTA PALU, SULAWESI TENGAH",6,96,90,186
https://kawalpemilu.org#69229,"LAYANA INDAH, MANTIKULORE, KOTA PALU, SULAWESI TENGAH",7,98,61,159
https://kawalpemilu.org#69229,"LAYANA INDAH, MANTIKULORE, KOTA PALU, SULAWESI TENGAH",8,119,38,157
https://kawalpemilu.org#69229,"LAYANA INDAH, MANTIKULORE, KOTA PALU, SULAWESI TENGAH",9,124,71,195
https://kawalpemilu.org#69229,"LAYANA INDAH, MANTIKULORE, KOTA PALU, SULAWESI TENGAH",10,104,72,176
https://kawalpemilu.org#69229,"LAYANA INDAH, MANTIKULORE, KOTA PALU, SULAWESI TENGAH",12,166,95,261
https://kawalpemilu.org#69250,"KAWATUNA, MANTIKULORE, KOTA PALU, SULAWESI TENGAH",1,43,187,230
https://kawalpemilu.org#69250,"KAWATUNA, MANTIKULORE, KOTA PALU, SULAWESI TENGAH",2,43,157,200
https://kawalpemilu.org#69250,"KAWATUNA, MANTIKULORE, KOTA PALU, SULAWESI TENGAH",4,42,184,226
https://kawalpemilu.org#69250,"KAWATUNA, MANTIKULORE, KOTA PALU, SULAWESI TENGAH",5,29,68,97
https://kawalpemilu.org#69250,"KAWATUNA, MANTIKULORE, KOTA PALU, SULAWESI TENGAH",6,40,135,175
https://kawalpemilu.org#69250,"KAWATUNA, MANTIKULORE, KOTA PALU, SULAWESI TENGAH",7,27,125,152
https://kawalpemilu.org#69250,"KAWATUNA, MANTIKULORE, KOTA PALU, SULAWESI TENGAH",8,29,174,203
https://kawalpemilu.org#69250,"KAWATUNA, MANTIKULORE, KOTA PALU, SULAWESI TENGAH",9,34,102,136
https://kawalpemilu.org#69250,"KAWATUNA, MANTIKULORE, KOTA PALU, SULAWESI TENGAH",10,51,113,164
https://kawalpemilu.org#69250,"KAWATUNA, MANTIKULORE, KOTA PALU, SULAWESI TENGAH",11,110,94,204
https://kawalpemilu.org#69250,"KAWATUNA, MANTIKULORE, KOTA PALU, SULAWESI TENGAH",13,67,110,177
https://kawalpemilu.org#69250,"KAWATUNA, MANTIKULORE, KOTA PALU, SULAWESI TENGAH",14,50,101,151
https://kawalpemilu.org#69250,"KAWATUNA, MANTIKULORE, KOTA PALU, SULAWESI TENGAH",15,27,62,89
https://kawalpemilu.org#69251,"TANAMODINDI, MANTIKULORE, KOTA PALU, SULAWESI TENGAH",1,37,190,227
https://kawalpemilu.org#69251,"TANAMODINDI, MANTIKULORE, KOTA PALU, SULAWESI TENGAH",2,47,169,216
https://kawalpemilu.org#69251,"TANAMODINDI, MANTIKULORE, KOTA PALU, SULAWESI TENGAH",3,41,149,190
https://kawalpemilu.org#69251,"TANAMODINDI, MANTIKULORE, KOTA PALU, SULAWESI TENGAH",4,55,100,155
https://kawalpemilu.org#69251,"TANAMODINDI, MANTIKULORE, KOTA PALU, SULAWESI TENGAH",5,61,176,237
https://kawalpemilu.org#69251,"TANAMODINDI, MANTIKULORE, KOTA PALU, SULAWESI TENGAH",6,75,169,244
https://kawalpemilu.org#69251,"TANAMODINDI, MANTIKULORE, KOTA PALU, SULAWESI TENGAH",7,99,106,205
https://kawalpemilu.org#69251,"TANAMODINDI, MANTIKULORE, KOTA PALU, SULAWESI TENGAH",8,58,44,102
https://kawalpemilu.org#69251,"TANAMODINDI, MANTIKULORE, KOTA PALU, SULAWESI TENGAH",9,104,134,238
https://kawalpemilu.org#69251,"TANAMODINDI, MANTIKULORE, KOTA PALU, SULAWESI TENGAH",10,71,94,165
https://kawalpemilu.org#69251,"TANAMODINDI, MANTIKULORE, KOTA PALU, SULAWESI TENGAH",11,42,111,153
https://kawalpemilu.org#69251,"TANAMODINDI, MANTIKULORE, KOTA PALU, SULAWESI TENGAH",12,60,179,239
https://kawalpemilu.org#69251,"TANAMODINDI, MANTIKULORE, KOTA PALU, SULAWESI TENGAH",13,63,184,247
https://kawalpemilu.org#69251,"TANAMODINDI, MANTIKULORE, KOTA PALU, SULAWESI TENGAH",14,73,152,225
https://kawalpemilu.org#69251,"TANAMODINDI, MANTIKULORE, KOTA PALU, SULAWESI TENGAH",15,54,124,178
https://kawalpemilu.org#69251,"TANAMODINDI, MANTIKULORE, KOTA PALU, SULAWESI TENGAH",17,64,115,179
https://kawalpemilu.org#69251,"TANAMODINDI, MANTIKULORE, KOTA PALU, SULAWESI TENGAH",18,67,108,175
https://kawalpemilu.org#69251,"TANAMODINDI, MANTIKULORE, KOTA PALU, SULAWESI TENGAH",19,65,137,202
https://kawalpemilu.org#69251,"TANAMODINDI, MANTIKULORE, KOTA PALU, SULAWESI TENGAH",20,75,117,192
https://kawalpemilu.org#69251,"TANAMODINDI, MANTIKULORE, KOTA PALU, SULAWESI TENGAH",23,92,168,260
https://kawalpemilu.org#69251,"TANAMODINDI, MANTIKULORE, KOTA PALU, SULAWESI TENGAH",24,50,103,153
https://kawalpemilu.org#69251,"TANAMODINDI, MANTIKULORE, KOTA PALU, SULAWESI TENGAH",25,68,136,204
https://kawalpemilu.org#69251,"TANAMODINDI, MANTIKULORE, KOTA PALU, SULAWESI TENGAH",26,43,145,188
https://kawalpemilu.org#69251,"TANAMODINDI, MANTIKULORE, KOTA PALU, SULAWESI TENGAH",27,63,157,220
https://kawalpemilu.org#69251,"TANAMODINDI, MANTIKULORE, KOTA PALU, SULAWESI TENGAH",28,62,122,184
https://kawalpemilu.org#69251,"TANAMODINDI, MANTIKULORE, KOTA PALU, SULAWESI TENGAH",29,75,191,266
https://kawalpemilu.org#931042,"TALISE VALANGGUNI, MANTIKULORE, KOTA PALU, SULAWESI TENGAH",7,52,87,139
https://kawalpemilu.org#931042,"TALISE VALANGGUNI, MANTIKULORE, KOTA PALU, SULAWESI TENGAH",9,65,160,225
https://kawalpemilu.org#931042,"TALISE VALANGGUNI, MANTIKULORE, KOTA PALU, SULAWESI TENGAH",11,77,72,149
https://kawalpemilu.org#931042,"TALISE VALANGGUNI, MANTIKULORE, KOTA PALU, SULAWESI TENGAH",15,87,67,154
https://kawalpemilu.org#931042,"TALISE VALANGGUNI, MANTIKULORE, KOTA PALU, SULAWESI TENGAH",16,25,36,61
https://kawalpemilu.org#931042,"TALISE VALANGGUNI, MANTIKULORE, KOTA PALU, SULAWESI TENGAH",23,23,77,100
https://kawalpemilu.org#931042,"TALISE VALANGGUNI, MANTIKULORE, KOTA PALU, SULAWESI TENGAH",24,30,47,77
https://kawalpemilu.org#931042,"TALISE VALANGGUNI, MANTIKULORE, KOTA PALU, SULAWESI TENGAH",26,46,44,90
https://kawalpemilu.org#931042,"TALISE VALANGGUNI, MANTIKULORE, KOTA PALU, SULAWESI TENGAH",27,68,108,176
https://kawalpemilu.org#68683,"LALONG, LABOBO, BANGGAI LAUT, SULAWESI TENGAH",1,89,44,133
https://kawalpemilu.org#68683,"LALONG, LABOBO, BANGGAI LAUT, SULAWESI TENGAH",2,91,43,134
https://kawalpemilu.org#68684,"LIPULALONGO, LABOBO, BANGGAI LAUT, SULAWESI TENGAH",1,95,146,241
https://kawalpemilu.org#68684,"LIPULALONGO, LABOBO, BANGGAI LAUT, SULAWESI TENGAH",2,60,115,175
https://kawalpemilu.org#68684,"LIPULALONGO, LABOBO, BANGGAI LAUT, SULAWESI TENGAH",3,68,145,213
https://kawalpemilu.org#68685,"PAISULAMO, LABOBO, BANGGAI LAUT, SULAWESI TENGAH",1,97,110,207
https://kawalpemilu.org#68685,"PAISULAMO, LABOBO, BANGGAI LAUT, SULAWESI TENGAH",2,94,75,169
https://kawalpemilu.org#68686,"ALASAN, LABOBO, BANGGAI LAUT, SULAWESI TENGAH",1,135,113,248
https://kawalpemilu.org#68686,"ALASAN, LABOBO, BANGGAI LAUT, SULAWESI TENGAH",2,123,31,154
https://kawalpemilu.org#68687,"MANSALEAN, LABOBO, BANGGAI LAUT, SULAWESI TENGAH",1,85,119,204
https://kawalpemilu.org#68687,"MANSALEAN, LABOBO, BANGGAI LAUT, SULAWESI TENGAH",2,93,79,172
https://kawalpemilu.org#68687,"MANSALEAN, LABOBO, BANGGAI LAUT, SULAWESI TENGAH",3,51,94,145
https://kawalpemilu.org#68687,"MANSALEAN, LABOBO, BANGGAI LAUT, SULAWESI TENGAH",4,77,119,196
https://kawalpemilu.org#68687,"MANSALEAN, LABOBO, BANGGAI LAUT, SULAWESI TENGAH",5,66,88,154
https://kawalpemilu.org#68688,"BONTOSI, LABOBO, BANGGAI LAUT, SULAWESI TENGAH",1,109,104,213
https://kawalpemilu.org#68688,"BONTOSI, LABOBO, BANGGAI LAUT, SULAWESI TENGAH",2,173,78,251
https://kawalpemilu.org#68688,"BONTOSI, LABOBO, BANGGAI LAUT, SULAWESI TENGAH",3,119,89,208
https://kawalpemilu.org#68689,"LIPUTALAS, LABOBO, BANGGAI LAUT, SULAWESI TENGAH",1,130,45,175
https://kawalpemilu.org#85667,"PADINGKIAN, LABOBO, BANGGAI LAUT, SULAWESI TENGAH",1,90,49,139
https://kawalpemilu.org#68691,"LOMPIO, BANGGAI, BANGGAI LAUT, SULAWESI TENGAH",1,120,50,170
https://kawalpemilu.org#68691,"LOMPIO, BANGGAI, BANGGAI LAUT, SULAWESI TENGAH",2,102,67,170
https://kawalpemilu.org#68691,"LOMPIO, BANGGAI, BANGGAI LAUT, SULAWESI TENGAH",3,98,89,187
https://kawalpemilu.org#68691,"LOMPIO, BANGGAI, BANGGAI LAUT, SULAWESI TENGAH",4,48,48,96
https://kawalpemilu.org#68691,"LOMPIO, BANGGAI, BANGGAI LAUT, SULAWESI TENGAH",5,81,131,212
https://kawalpemilu.org#68691,"LOMPIO, BANGGAI, BANGGAI LAUT, SULAWESI TENGAH",6,74,83,157
https://kawalpemilu.org#68691,"LOMPIO, BANGGAI, BANGGAI LAUT, SULAWESI TENGAH",7,96,139,235
https://kawalpemilu.org#68691,"LOMPIO, BANGGAI, BANGGAI LAUT, SULAWESI TENGAH",8,103,116,219
https://kawalpemilu.org#68691,"LOMPIO, BANGGAI, BANGGAI LAUT, SULAWESI TENGAH",9,85,91,176
https://kawalpemilu.org#68691,"LOMPIO, BANGGAI, BANGGAI LAUT, SULAWESI TENGAH",10,95,110,205
https://kawalpemilu.org#68691,"LOMPIO, BANGGAI, BANGGAI LAUT, SULAWESI TENGAH",11,78,118,196
https://kawalpemilu.org#68691,"LOMPIO, BANGGAI, BANGGAI LAUT, SULAWESI TENGAH",12,150,118,268
https://kawalpemilu.org#68692,"TANO BONUNUNGAN, BANGGAI, BANGGAI LAUT, SULAWESI TENGAH",1,104,68,172
https://kawalpemilu.org#68692,"TANO BONUNUNGAN, BANGGAI, BANGGAI LAUT, SULAWESI TENGAH",2,90,80,170
https://kawalpemilu.org#68692,"TANO BONUNUNGAN, BANGGAI, BANGGAI LAUT, SULAWESI TENGAH",3,91,43,134
https://kawalpemilu.org#68692,"TANO BONUNUNGAN, BANGGAI, BANGGAI LAUT, SULAWESI TENGAH",4,115,66,181
https://kawalpemilu.org#68692,"TANO BONUNUNGAN, BANGGAI, BANGGAI LAUT, SULAWESI TENGAH",5,66,54,120
https://kawalpemilu.org#68692,"TANO BONUNUNGAN, BANGGAI, BANGGAI LAUT, SULAWESI TENGAH",6,108,112,220
https://kawalpemilu.org#68693,"DODUNG, BANGGAI, BANGGAI LAUT, SULAWESI TENGAH",1,76,79,155
https://kawalpemilu.org#68693,"DODUNG, BANGGAI, BANGGAI LAUT, SULAWESI TENGAH",2,67,60,127
https://kawalpemilu.org#68693,"DODUNG, BANGGAI, BANGGAI LAUT, SULAWESI TENGAH",3,70,78,148
https://kawalpemilu.org#68693,"DODUNG, BANGGAI, BANGGAI LAUT, SULAWESI TENGAH",4,121,107,228
https://kawalpemilu.org#68693,"DODUNG, BANGGAI, BANGGAI LAUT, SULAWESI TENGAH",5,62,68,130
https://kawalpemilu.org#68693,"DODUNG, BANGGAI, BANGGAI LAUT, SULAWESI TENGAH",6,45,99,144
https://kawalpemilu.org#68693,"DODUNG, BANGGAI, BANGGAI LAUT, SULAWESI TENGAH",7,65,96,161
https://kawalpemilu.org#68693,"DODUNG, BANGGAI, BANGGAI LAUT, SULAWESI TENGAH",8,106,79,185
https://kawalpemilu.org#68693,"DODUNG, BANGGAI, BANGGAI LAUT, SULAWESI TENGAH",9,94,163,257
https://kawalpemilu.org#68693,"DODUNG, BANGGAI, BANGGAI LAUT, SULAWESI TENGAH",10,96,113,209
https://kawalpemilu.org#68693,"DODUNG, BANGGAI, BANGGAI LAUT, SULAWESI TENGAH",11,86,120,206
https://kawalpemilu.org#68693,"DODUNG, BANGGAI, BANGGAI LAUT, SULAWESI TENGAH",12,105,152,257
https://kawalpemilu.org#68693,"DODUNG, BANGGAI, BANGGAI LAUT, SULAWESI TENGAH",13,93,126,219
https://kawalpemilu.org#68693,"DODUNG, BANGGAI, BANGGAI LAUT, SULAWESI TENGAH",14,105,117,222
https://kawalpemilu.org#68693,"DODUNG, BANGGAI, BANGGAI LAUT, SULAWESI TENGAH",15,117,112,229
https://kawalpemilu.org#68693,"DODUNG, BANGGAI, BANGGAI LAUT, SULAWESI TENGAH",16,51,77,128
https://kawalpemilu.org#68694,"LAMBAKO, BANGGAI, BANGGAI LAUT, SULAWESI TENGAH",1,90,116,206
https://kawalpemilu.org#68694,"LAMBAKO, BANGGAI, BANGGAI LAUT, SULAWESI TENGAH",2,110,140,250
https://kawalpemilu.org#68694,"LAMBAKO, BANGGAI, BANGGAI LAUT, SULAWESI TENGAH",3,93,139,232
https://kawalpemilu.org#68694,"LAMBAKO, BANGGAI, BANGGAI LAUT, SULAWESI TENGAH",4,86,119,205
https://kawalpemilu.org#68695,"KOKINI, BANGGAI, BANGGAI LAUT, SULAWESI TENGAH",1,150,72,222
https://kawalpemilu.org#68695,"KOKINI, BANGGAI, BANGGAI LAUT, SULAWESI TENGAH",2,83,97,180
https://kawalpemilu.org#68695,"KOKINI, BANGGAI, BANGGAI LAUT, SULAWESI TENGAH",3,94,110,204
https://kawalpemilu.org#68696,"LAMPA, BANGGAI, BANGGAI LAUT, SULAWESI TENGAH",1,132,135,267
https://kawalpemilu.org#68696,"LAMPA, BANGGAI, BANGGAI LAUT, SULAWESI TENGAH",2,87,137,224
https://kawalpemilu.org#68696,"LAMPA, BANGGAI, BANGGAI LAUT, SULAWESI TENGAH",3,89,110,199
https://kawalpemilu.org#68696,"LAMPA, BANGGAI, BANGGAI LAUT, SULAWESI TENGAH",4,111,124,235
https://kawalpemilu.org#68696,"LAMPA, BANGGAI, BANGGAI LAUT, SULAWESI TENGAH",5,99,136,235
https://kawalpemilu.org#68696,"LAMPA, BANGGAI, BANGGAI LAUT, SULAWESI TENGAH",6,88,128,216
https://kawalpemilu.org#68697,"TINAKIN LAUT, BANGGAI, BANGGAI LAUT, SULAWESI TENGAH",1,100,104,204
https://kawalpemilu.org#68697,"TINAKIN LAUT, BANGGAI, BANGGAI LAUT, SULAWESI TENGAH",2,97,72,169
https://kawalpemilu.org#68697,"TINAKIN LAUT, BANGGAI, BANGGAI LAUT, SULAWESI TENGAH",3,92,76,168
https://kawalpemilu.org#68697,"TINAKIN LAUT, BANGGAI, BANGGAI LAUT, SULAWESI TENGAH",4,92,103,195
https://kawalpemilu.org#68697,"TINAKIN LAUT, BANGGAI, BANGGAI LAUT, SULAWESI TENGAH",5,108,77,185
https://kawalpemilu.org#68697,"TINAKIN LAUT, BANGGAI, BANGGAI LAUT, SULAWESI TENGAH",6,72,128,200
https://kawalpemilu.org#68698,"POTIL POLOLOBA, BANGGAI, BANGGAI LAUT, SULAWESI TENGAH",1,123,123,246
https://kawalpemilu.org#68699,"DANGKALAN, BANGGAI, BANGGAI LAUT, SULAWESI TENGAH",1,81,165,246
https://kawalpemilu.org#68699,"DANGKALAN, BANGGAI, BANGGAI LAUT, SULAWESI TENGAH",2,72,72,144
https://kawalpemilu.org#68699,"DANGKALAN, BANGGAI, BANGGAI LAUT, SULAWESI TENGAH",3,78,89,167
https://kawalpemilu.org#68700,"PASIR PUTIH, BANGGAI, BANGGAI LAUT, SULAWESI TENGAH",1,93,139,232
https://kawalpemilu.org#68700,"PASIR PUTIH, BANGGAI, BANGGAI LAUT, SULAWESI TENGAH",2,82,153,235
https://kawalpemilu.org#68700,"PASIR PUTIH, BANGGAI, BANGGAI LAUT, SULAWESI TENGAH",3,89,133,222
https://kawalpemilu.org#68769,"TOROPOT, BOKAN KEPULAUAN, BANGGAI LAUT, SULAWESI TENGAH",1,55,94,149
https://kawalpemilu.org#68769,"TOROPOT, BOKAN KEPULAUAN, BANGGAI LAUT, SULAWESI TENGAH",2,134,140,274
https://kawalpemilu.org#68769,"TOROPOT, BOKAN KEPULAUAN, BANGGAI LAUT, SULAWESI TENGAH",3,75,176,251
https://kawalpemilu.org#68769,"TOROPOT, BOKAN KEPULAUAN, BANGGAI LAUT, SULAWESI TENGAH",4,42,102,144
https://kawalpemilu.org#68769,"TOROPOT, BOKAN KEPULAUAN, BANGGAI LAUT, SULAWESI TENGAH",5,87,152,239
https://kawalpemilu.org#68770,"KOKUDANG, BOKAN KEPULAUAN, BANGGAI LAUT, SULAWESI TENGAH",1,66,126,188
https://kawalpemilu.org#68770,"KOKUDANG, BOKAN KEPULAUAN, BANGGAI LAUT, SULAWESI TENGAH",2,72,125,197
https://kawalpemilu.org#68771,"KAUKES, BOKAN KEPULAUAN, BANGGAI LAUT, SULAWESI TENGAH",1,91,117,208
https://kawalpemilu.org#68771,"KAUKES, BOKAN KEPULAUAN, BANGGAI LAUT, SULAWESI TENGAH",2,106,66,172
https://kawalpemilu.org#68771,"KAUKES, BOKAN KEPULAUAN, BANGGAI LAUT, SULAWESI TENGAH",3,118,105,223
https://kawalpemilu.org#68772,"BUNGIN, BOKAN KEPULAUAN, BANGGAI LAUT, SULAWESI TENGAH",1,46,87,133
https://kawalpemilu.org#68772,"BUNGIN, BOKAN KEPULAUAN, BANGGAI LAUT, SULAWESI TENGAH",2,61,126,187
https://kawalpemilu.org#68772,"BUNGIN, BOKAN KEPULAUAN, BANGGAI LAUT, SULAWESI TENGAH",3,50,94,144
https://kawalpemilu.org#68772,"BUNGIN, BOKAN KEPULAUAN, BANGGAI LAUT, SULAWESI TENGAH",4,68,121,189
https://kawalpemilu.org#68773,"PANAPAT, BOKAN KEPULAUAN, BANGGAI LAUT, SULAWESI TENGAH",1,45,167,212
https://kawalpemilu.org#68773,"PANAPAT, BOKAN KEPULAUAN, BANGGAI LAUT, SULAWESI TENGAH",2,70,92,162
https://kawalpemilu.org#68773,"PANAPAT, BOKAN KEPULAUAN, BANGGAI LAUT, SULAWESI TENGAH",3,65,136,201
https://kawalpemilu.org#68773,"PANAPAT, BOKAN KEPULAUAN, BANGGAI LAUT, SULAWESI TENGAH",4,53,164,217
https://kawalpemilu.org#68774,"NDINDIBUNG, BOKAN KEPULAUAN, BANGGAI LAUT, SULAWESI TENGAH",1,42,128,170
https://kawalpemilu.org#68774,"NDINDIBUNG, BOKAN KEPULAUAN, BANGGAI LAUT, SULAWESI TENGAH",2,40,105,145
https://kawalpemilu.org#68775,"NGGASUANG, BOKAN KEPULAUAN, BANGGAI LAUT, SULAWESI TENGAH",1,71,62,133
https://kawalpemilu.org#68775,"NGGASUANG, BOKAN KEPULAUAN, BANGGAI LAUT, SULAWESI TENGAH",2,72,69,141
https://kawalpemilu.org#68775,"NGGASUANG, BOKAN KEPULAUAN, BANGGAI LAUT, SULAWESI TENGAH",3,57,13,70
https://kawalpemilu.org#68776,"MBUANG-MBUANG, BOKAN KEPULAUAN, BANGGAI LAUT, SULAWESI TENGAH",1,49,103,152
https://kawalpemilu.org#68776,"MBUANG-MBUANG, BOKAN KEPULAUAN, BANGGAI LAUT, SULAWESI TENGAH",2,33,70,103
https://kawalpemilu.org#68777,"TIMPAUS, BOKAN KEPULAUAN, BANGGAI LAUT, SULAWESI TENGAH",1,39,81,120
https://kawalpemilu.org#68777,"TIMPAUS, BOKAN KEPULAUAN, BANGGAI LAUT, SULAWESI TENGAH",2,34,84,118
https://kawalpemilu.org#68778,"KASUARI, BOKAN KEPULAUAN, BANGGAI LAUT, SULAWESI TENGAH",1,57,117,174
https://kawalpemilu.org#68778,"KASUARI, BOKAN KEPULAUAN, BANGGAI LAUT, SULAWESI TENGAH",2,56,94,150
https://kawalpemilu.org#68778,"KASUARI, BOKAN KEPULAUAN, BANGGAI LAUT, SULAWESI TENGAH",3,69,78,147
https://kawalpemilu.org#68779,"SONIT, BOKAN KEPULAUAN, BANGGAI LAUT, SULAWESI TENGAH",1,106,80,186
https://kawalpemilu.org#68779,"SONIT, BOKAN KEPULAUAN, BANGGAI LAUT, SULAWESI TENGAH",2,145,58,203
https://kawalpemilu.org#68780,"PAISU BEBE, BOKAN KEPULAUAN, BANGGAI LAUT, SULAWESI TENGAH",1,95,69,164
https://kawalpemilu.org#68780,"PAISU BEBE, BOKAN KEPULAUAN, BANGGAI LAUT, SULAWESI TENGAH",2,115,99,214
https://kawalpemilu.org#68781,"MANDEL, BOKAN KEPULAUAN, BANGGAI LAUT, SULAWESI TENGAH",1,86,164,250
https://kawalpemilu.org#68781,"MANDEL, BOKAN KEPULAUAN, BANGGAI LAUT, SULAWESI TENGAH",2,70,128,198
https://kawalpemilu.org#68782,"MINANGA, BOKAN KEPULAUAN, BANGGAI LAUT, SULAWESI TENGAH",1,37,114,151
https://kawalpemilu.org#68782,"MINANGA, BOKAN KEPULAUAN, BANGGAI LAUT, SULAWESI TENGAH",2,35,140,175
https://kawalpemilu.org#68783,"BOLOKUT, BOKAN KEPULAUAN, BANGGAI LAUT, SULAWESI TENGAH",1,13,126,139
https://kawalpemilu.org#68783,"BOLOKUT, BOKAN KEPULAUAN, BANGGAI LAUT, SULAWESI TENGAH",2,24,109,133
https://kawalpemilu.org#85673,"KEAK, BOKAN KEPULAUAN, BANGGAI LAUT, SULAWESI TENGAH",1,114,53,167
https://kawalpemilu.org#85673,"KEAK, BOKAN KEPULAUAN, BANGGAI LAUT, SULAWESI TENGAH",2,84,75,159
https://kawalpemilu.org#68800,"KENDEK, BANGGAI UTARA, BANGGAI LAUT, SULAWESI TENGAH",1,68,93,161
https://kawalpemilu.org#68800,"KENDEK, BANGGAI UTARA, BANGGAI LAUT, SULAWESI TENGAH",2,70,116,186
https://kawalpemilu.org#68800,"KENDEK, BANGGAI UTARA, BANGGAI LAUT, SULAWESI TENGAH",3,65,132,197
https://kawalpemilu.org#68800,"KENDEK, BANGGAI UTARA, BANGGAI LAUT, SULAWESI TENGAH",4,76,134,210
https://kawalpemilu.org#68800,"KENDEK, BANGGAI UTARA, BANGGAI LAUT, SULAWESI TENGAH",5,95,134,229
https://kawalpemilu.org#68800,"KENDEK, BANGGAI UTARA, BANGGAI LAUT, SULAWESI TENGAH",6,103,121,224
https://kawalpemilu.org#68800,"KENDEK, BANGGAI UTARA, BANGGAI LAUT, SULAWESI TENGAH",7,76,172,248
https://kawalpemilu.org#68801,"LOKOTOY, BANGGAI UTARA, BANGGAI LAUT, SULAWESI TENGAH",1,120,88,208
https://kawalpemilu.org#68801,"LOKOTOY, BANGGAI UTARA, BANGGAI LAUT, SULAWESI TENGAH",2,133,107,240
https://kawalpemilu.org#68801,"LOKOTOY, BANGGAI UTARA, BANGGAI LAUT, SULAWESI TENGAH",3,162,68,230
https://kawalpemilu.org#68801,"LOKOTOY, BANGGAI UTARA, BANGGAI LAUT, SULAWESI TENGAH",4,122,77,199
https://kawalpemilu.org#68802,"POPISI, BANGGAI UTARA, BANGGAI LAUT, SULAWESI TENGAH",1,157,66,223
https://kawalpemilu.org#68802,"POPISI, BANGGAI UTARA, BANGGAI LAUT, SULAWESI TENGAH",2,150,55,205
https://kawalpemilu.org#68803,"PAISUMOSONI, BANGGAI UTARA, BANGGAI LAUT, SULAWESI TENGAH",1,71,84,155
https://kawalpemilu.org#68803,"PAISUMOSONI, BANGGAI UTARA, BANGGAI LAUT, SULAWESI TENGAH",2,90,69,159
https://kawalpemilu.org#68804,"TOLISE TUBONO, BANGGAI UTARA, BANGGAI LAUT, SULAWESI TENGAH",1,78,114,192
https://kawalpemilu.org#68804,"TOLISE TUBONO, BANGGAI UTARA, BANGGAI LAUT, SULAWESI TENGAH",2,92,150,242
https://kawalpemilu.org#68805,"BONE BARU, BANGGAI UTARA, BANGGAI LAUT, SULAWESI TENGAH",1,65,151,216
https://kawalpemilu.org#68805,"BONE BARU, BANGGAI UTARA, BANGGAI LAUT, SULAWESI TENGAH",2,53,175,228
https://kawalpemilu.org#68805,"BONE BARU, BANGGAI UTARA, BANGGAI LAUT, SULAWESI TENGAH",3,93,55,148
https://kawalpemilu.org#68817,"TOGONG  SAGU, BANGKURUNG, BANGGAI LAUT, SULAWESI TENGAH",1,98,96,194
https://kawalpemilu.org#68817,"TOGONG  SAGU, BANGKURUNG, BANGGAI LAUT, SULAWESI TENGAH",2,108,87,195
https://kawalpemilu.org#68817,"TOGONG  SAGU, BANGKURUNG, BANGGAI LAUT, SULAWESI TENGAH",3,131,90,221
https://kawalpemilu.org#68818,"TADUNO, BANGKURUNG, BANGGAI LAUT, SULAWESI TENGAH",1,62,116,178
https://kawalpemilu.org#68818,"TADUNO, BANGKURUNG, BANGGAI LAUT, SULAWESI TENGAH",2,72,117,189
https://kawalpemilu.org#68819,"KANARI, BANGKURUNG, BANGGAI LAUT, SULAWESI TENGAH",1,131,71,202
https://kawalpemilu.org#68820,"LANTIBUNG, BANGKURUNG, BANGGAI LAUT, SULAWESI TENGAH",1,88,76,164
https://kawalpemilu.org#68820,"LANTIBUNG, BANGKURUNG, BANGGAI LAUT, SULAWESI TENGAH",2,84,81,165
https://kawalpemilu.org#68820,"LANTIBUNG, BANGKURUNG, BANGGAI LAUT, SULAWESI TENGAH",3,70,93,163
https://kawalpemilu.org#68820,"LANTIBUNG, BANGKURUNG, BANGGAI LAUT, SULAWESI TENGAH",4,113,69,182
https://kawalpemilu.org#68820,"LANTIBUNG, BANGKURUNG, BANGGAI LAUT, SULAWESI TENGAH",5,73,31,104
https://kawalpemilu.org#68821,"KALUPAPI, BANGKURUNG, BANGGAI LAUT, SULAWESI TENGAH",1,74,90,164
https://kawalpemilu.org#68821,"KALUPAPI, BANGKURUNG, BANGGAI LAUT, SULAWESI TENGAH",2,94,111,205
https://kawalpemilu.org#68821,"KALUPAPI, BANGKURUNG, BANGGAI LAUT, SULAWESI TENGAH",3,80,91,171
https://kawalpemilu.org#68821,"KALUPAPI, BANGKURUNG, BANGGAI LAUT, SULAWESI TENGAH",4,74,87,161
https://kawalpemilu.org#68821,"KALUPAPI, BANGKURUNG, BANGGAI LAUT, SULAWESI TENGAH",5,93,116,209
https://kawalpemilu.org#68822,"BONE-BONE, BANGKURUNG, BANGGAI LAUT, SULAWESI TENGAH",1,129,75,204
https://kawalpemilu.org#68822,"BONE-BONE, BANGKURUNG, BANGGAI LAUT, SULAWESI TENGAH",2,106,87,193
https://kawalpemilu.org#68823,"MBELEANG, BANGKURUNG, BANGGAI LAUT, SULAWESI TENGAH",1,102,66,168
https://kawalpemilu.org#68823,"MBELEANG, BANGKURUNG, BANGGAI LAUT, SULAWESI TENGAH",2,97,94,191
https://kawalpemilu.org#68823,"MBELEANG, BANGKURUNG, BANGGAI LAUT, SULAWESI TENGAH",3,64,113,177
https://kawalpemilu.org#68824,"TABULANG, BANGKURUNG, BANGGAI LAUT, SULAWESI TENGAH",1,94,139,233
https://kawalpemilu.org#68825,"SASABOBOK, BANGKURUNG, BANGGAI LAUT, SULAWESI TENGAH",1,83,67,150
https://kawalpemilu.org#68825,"SASABOBOK, BANGKURUNG, BANGGAI LAUT, SULAWESI TENGAH",2,39,85,124
https://kawalpemilu.org#68826,"BUNGIN LUEAN, BANGKURUNG, BANGGAI LAUT, SULAWESI TENGAH",1,159,72,231
https://kawalpemilu.org#68826,"BUNGIN LUEAN, BANGKURUNG, BANGGAI LAUT, SULAWESI TENGAH",2,224,46,270
https://kawalpemilu.org#85678,"DUNGKEAN, BANGKURUNG, BANGGAI LAUT, SULAWESI TENGAH",1,120,81,201
https://kawalpemilu.org#93121,"LALONG, BANGKURUNG, BANGGAI LAUT, SULAWESI TENGAH",1,64,88,152
https://kawalpemilu.org#93121,"LALONG, BANGKURUNG, BANGGAI LAUT, SULAWESI TENGAH",2,63,76,139
https://kawalpemilu.org#68828,"ADEAN, BANGGAI TENGAH, BANGGAI LAUT, SULAWESI TENGAH",1,86,141,227
https://kawalpemilu.org#68828,"ADEAN, BANGGAI TENGAH, BANGGAI LAUT, SULAWESI TENGAH",2,97,131,228
https://kawalpemilu.org#68828,"ADEAN, BANGGAI TENGAH, BANGGAI LAUT, SULAWESI TENGAH",3,79,98,177
https://kawalpemilu.org#68828,"ADEAN, BANGGAI TENGAH, BANGGAI LAUT, SULAWESI TENGAH",4,92,116,208
https://kawalpemilu.org#68828,"ADEAN, BANGGAI TENGAH, BANGGAI LAUT, SULAWESI TENGAH",5,112,111,223
https://kawalpemilu.org#68829,"BADUMPAYAN, BANGGAI TENGAH, BANGGAI LAUT, SULAWESI TENGAH",1,110,81,191
https://kawalpemilu.org#68829,"BADUMPAYAN, BANGGAI TENGAH, BANGGAI LAUT, SULAWESI TENGAH",2,109,76,185
https://kawalpemilu.org#68830,"TIMBONG, BANGGAI TENGAH, BANGGAI LAUT, SULAWESI TENGAH",1,59,120,179
https://kawalpemilu.org#68830,"TIMBONG, BANGGAI TENGAH, BANGGAI LAUT, SULAWESI TENGAH",2,25,103,128
https://kawalpemilu.org#68830,"TIMBONG, BANGGAI TENGAH, BANGGAI LAUT, SULAWESI TENGAH",3,64,123,187
https://kawalpemilu.org#68831,"MOMINIT, BANGGAI TENGAH, BANGGAI LAUT, SULAWESI TENGAH",1,39,88,127
https://kawalpemilu.org#68831,"MOMINIT, BANGGAI TENGAH, BANGGAI LAUT, SULAWESI TENGAH",2,73,127,200
https://kawalpemilu.org#68831,"MOMINIT, BANGGAI TENGAH, BANGGAI LAUT, SULAWESI TENGAH",3,63,104,167
https://kawalpemilu.org#68832,"GONG-GONG, BANGGAI TENGAH, BANGGAI LAUT, SULAWESI TENGAH",1,111,72,183
https://kawalpemilu.org#68832,"GONG-GONG, BANGGAI TENGAH, BANGGAI LAUT, SULAWESI TENGAH",2,100,61,161
https://kawalpemilu.org#68832,"GONG-GONG, BANGGAI TENGAH, BANGGAI LAUT, SULAWESI TENGAH",3,104,48,152
https://kawalpemilu.org#68832,"GONG-GONG, BANGGAI TENGAH, BANGGAI LAUT, SULAWESI TENGAH",4,129,29,158
https://kawalpemilu.org#68833,"MONSONGAN, BANGGAI TENGAH, BANGGAI LAUT, SULAWESI TENGAH",1,139,98,237
https://kawalpemilu.org#68833,"MONSONGAN, BANGGAI TENGAH, BANGGAI LAUT, SULAWESI TENGAH",2,71,58,129
https://kawalpemilu.org#68833,"MONSONGAN, BANGGAI TENGAH, BANGGAI LAUT, SULAWESI TENGAH",3,80,85,165
https://kawalpemilu.org#68833,"MONSONGAN, BANGGAI TENGAH, BANGGAI LAUT, SULAWESI TENGAH",4,84,129,213
https://kawalpemilu.org#68833,"MONSONGAN, BANGGAI TENGAH, BANGGAI LAUT, SULAWESI TENGAH",5,107,45,152
https://kawalpemilu.org#68833,"MONSONGAN, BANGGAI TENGAH, BANGGAI LAUT, SULAWESI TENGAH",6,61,51,112
https://kawalpemilu.org#85679,"TINTINGO, BANGGAI TENGAH, BANGGAI LAUT, SULAWESI TENGAH",1,153,60,213
https://kawalpemilu.org#68835,"MATANGA, BANGGAI SELATAN, BANGGAI LAUT, SULAWESI TENGAH",1,132,57,189
https://kawalpemilu.org#68835,"MATANGA, BANGGAI SELATAN, BANGGAI LAUT, SULAWESI TENGAH",2,125,33,158
https://kawalpemilu.org#68835,"MATANGA, BANGGAI SELATAN, BANGGAI LAUT, SULAWESI TENGAH",3,122,80,202
https://kawalpemilu.org#68835,"MATANGA, BANGGAI SELATAN, BANGGAI LAUT, SULAWESI TENGAH",4,119,38,157
https://kawalpemilu.org#68835,"MATANGA, BANGGAI SELATAN, BANGGAI LAUT, SULAWESI TENGAH",5,136,30,166
https://kawalpemilu.org#68835,"MATANGA, BANGGAI SELATAN, BANGGAI LAUT, SULAWESI TENGAH",6,142,114,256
https://kawalpemilu.org#68836,"TOLOKIBIT, BANGGAI SELATAN, BANGGAI LAUT, SULAWESI TENGAH",1,129,79,208
https://kawalpemilu.org#68836,"TOLOKIBIT, BANGGAI SELATAN, BANGGAI LAUT, SULAWESI TENGAH",2,150,78,228
https://kawalpemilu.org#68837,"BENTEAN, BANGGAI SELATAN, BANGGAI LAUT, SULAWESI TENGAH",1,75,147,222
https://kawalpemilu.org#68837,"BENTEAN, BANGGAI SELATAN, BANGGAI LAUT, SULAWESI TENGAH",2,71,130,201
https://kawalpemilu.org#68837,"BENTEAN, BANGGAI SELATAN, BANGGAI LAUT, SULAWESI TENGAH",3,77,136,213
https://kawalpemilu.org#68838,"MALINO PADAS, BANGGAI SELATAN, BANGGAI LAUT, SULAWESI TENGAH",1,157,75,232
https://kawalpemilu.org#68838,"MALINO PADAS, BANGGAI SELATAN, BANGGAI LAUT, SULAWESI TENGAH",2,158,88,246
https://kawalpemilu.org#68839,"KELAPA LIMA, BANGGAI SELATAN, BANGGAI LAUT, SULAWESI TENGAH",1,174,50,224
https://kawalpemilu.org#68839,"KELAPA LIMA, BANGGAI SELATAN, BANGGAI LAUT, SULAWESI TENGAH",2,156,61,217
https://kawalpemilu.org#85681,"LABUAN KAPELAK, BANGGAI SELATAN, BANGGAI LAUT, SULAWESI TENGAH",1,173,60,233
https://kawalpemilu.org#85681,"LABUAN KAPELAK, BANGGAI SELATAN, BANGGAI LAUT, SULAWESI TENGAH",2,80,37,117
https://kawalpemilu.org#68430,"SAEMBA, MORI ATAS, MOROWALI UTARA, SULAWESI TENGAH",1,144,15,159
https://kawalpemilu.org#68430,"SAEMBA, MORI ATAS, MOROWALI UTARA, SULAWESI TENGAH",2,150,9,159
https://kawalpemilu.org#68430,"SAEMBA, MORI ATAS, MOROWALI UTARA, SULAWESI TENGAH",3,139,14,153
https://kawalpemilu.org#68431,"LEE, MORI ATAS, MOROWALI UTARA, SULAWESI TENGAH",1,176,16,191
https://kawalpemilu.org#68431,"LEE, MORI ATAS, MOROWALI UTARA, SULAWESI TENGAH",2,185,12,197
https://kawalpemilu.org#68432,"KASINGOLI, MORI ATAS, MOROWALI UTARA, SULAWESI TENGAH",1,142,10,152
https://kawalpemilu.org#68432,"KASINGOLI, MORI ATAS, MOROWALI UTARA, SULAWESI TENGAH",2,157,9,166
https://kawalpemilu.org#68433,"GONTARA, MORI ATAS, MOROWALI UTARA, SULAWESI TENGAH",1,161,20,181
https://kawalpemilu.org#68433,"GONTARA, MORI ATAS, MOROWALI UTARA, SULAWESI TENGAH",2,156,31,187
https://kawalpemilu.org#68434,"TOMATA, MORI ATAS, MOROWALI UTARA, SULAWESI TENGAH",1,197,31,228
https://kawalpemilu.org#68434,"TOMATA, MORI ATAS, MOROWALI UTARA, SULAWESI TENGAH",2,162,25,187
https://kawalpemilu.org#68434,"TOMATA, MORI ATAS, MOROWALI UTARA, SULAWESI TENGAH",3,211,24,235
https://kawalpemilu.org#68435,"LONDI, MORI ATAS, MOROWALI UTARA, SULAWESI TENGAH",1,174,50,224
https://kawalpemilu.org#68435,"LONDI, MORI ATAS, MOROWALI UTARA, SULAWESI TENGAH",2,201,23,224
https://kawalpemilu.org#68435,"LONDI, MORI ATAS, MOROWALI UTARA, SULAWESI TENGAH",3,192,18,210
https://kawalpemilu.org#68436,"TAENDE, MORI ATAS, MOROWALI UTARA, SULAWESI TENGAH",1,170,15,185
https://kawalpemilu.org#68436,"TAENDE, MORI ATAS, MOROWALI UTARA, SULAWESI TENGAH",2,121,4,125
https://kawalpemilu.org#68436,"TAENDE, MORI ATAS, MOROWALI UTARA, SULAWESI TENGAH",3,191,8,199
https://kawalpemilu.org#68437,"ENSA, MORI ATAS, MOROWALI UTARA, SULAWESI TENGAH",1,223,10,233
https://kawalpemilu.org#68437,"ENSA, MORI ATAS, MOROWALI UTARA, SULAWESI TENGAH",2,145,5,150
https://kawalpemilu.org#68437,"ENSA, MORI ATAS, MOROWALI UTARA, SULAWESI TENGAH",3,101,37,138
https://kawalpemilu.org#68437,"ENSA, MORI ATAS, MOROWALI UTARA, SULAWESI TENGAH",4,166,2,168
https://kawalpemilu.org#68437,"ENSA, MORI ATAS, MOROWALI UTARA, SULAWESI TENGAH",5,133,31,164
https://kawalpemilu.org#68438,"KOLAKA, MORI ATAS, MOROWALI UTARA, SULAWESI TENGAH",1,238,18,256
https://kawalpemilu.org#68438,"KOLAKA, MORI ATAS, MOROWALI UTARA, SULAWESI TENGAH",2,125,69,194
https://kawalpemilu.org#68439,"PEONEA, MORI ATAS, MOROWALI UTARA, SULAWESI TENGAH",1,92,48,140
https://kawalpemilu.org#68439,"PEONEA, MORI ATAS, MOROWALI UTARA, SULAWESI TENGAH",2,220,23,243
https://kawalpemilu.org#68439,"PEONEA, MORI ATAS, MOROWALI UTARA, SULAWESI TENGAH",3,250,10,260
https://kawalpemilu.org#68439,"PEONEA, MORI ATAS, MOROWALI UTARA, SULAWESI TENGAH",4,77,53,130
https://kawalpemilu.org#68439,"PEONEA, MORI ATAS, MOROWALI UTARA, SULAWESI TENGAH",5,101,0,101
https://kawalpemilu.org#68440,"LANUMOR, MORI ATAS, MOROWALI UTARA, SULAWESI TENGAH",1,262,11,274
https://kawalpemilu.org#68440,"LANUMOR, MORI ATAS, MOROWALI UTARA, SULAWESI TENGAH",2,224,19,243
https://kawalpemilu.org#68449,"TOMUI KARYA, MORI ATAS, MOROWALI UTARA, SULAWESI TENGAH",1,166,8,174
https://kawalpemilu.org#68449,"TOMUI KARYA, MORI ATAS, MOROWALI UTARA, SULAWESI TENGAH",2,167,13,180
https://kawalpemilu.org#89688,"SAEMBA WALATI, MORI ATAS, MOROWALI UTARA, SULAWESI TENGAH",1,137,7,144
https://kawalpemilu.org#89688,"SAEMBA WALATI, MORI ATAS, MOROWALI UTARA, SULAWESI TENGAH",2,145,12,157
https://kawalpemilu.org#89689,"PAMBAREA, MORI ATAS, MOROWALI UTARA, SULAWESI TENGAH",1,189,21,210
https://kawalpemilu.org#89689,"PAMBAREA, MORI ATAS, MOROWALI UTARA, SULAWESI TENGAH",2,197,26,223
https://kawalpemilu.org#89689,"PAMBAREA, MORI ATAS, MOROWALI UTARA, SULAWESI TENGAH",3,191,17,208
https://kawalpemilu.org#68453,"KOROWOU, LEMBO, MOROWALI UTARA, SULAWESI TENGAH",1,219,26,245
https://kawalpemilu.org#68453,"KOROWOU, LEMBO, MOROWALI UTARA, SULAWESI TENGAH",2,167,10,177
https://kawalpemilu.org#68453,"KOROWOU, LEMBO, MOROWALI UTARA, SULAWESI TENGAH",3,137,48,185
https://kawalpemilu.org#68453,"KOROWOU, LEMBO, MOROWALI UTARA, SULAWESI TENGAH",4,212,7,219
https://kawalpemilu.org#68453,"KOROWOU, LEMBO, MOROWALI UTARA, SULAWESI TENGAH",5,122,11,133
https://kawalpemilu.org#68456,"LEMBOBARU, LEMBO, MOROWALI UTARA, SULAWESI TENGAH",1,156,7,163
https://kawalpemilu.org#68457,"WAWOPADA, LEMBO, MOROWALI UTARA, SULAWESI TENGAH",1,35,22,57
https://kawalpemilu.org#68457,"WAWOPADA, LEMBO, MOROWALI UTARA, SULAWESI TENGAH",2,167,14,181
https://kawalpemilu.org#68457,"WAWOPADA, LEMBO, MOROWALI UTARA, SULAWESI TENGAH",3,173,9,182
https://kawalpemilu.org#68457,"WAWOPADA, LEMBO, MOROWALI UTARA, SULAWESI TENGAH",4,178,8,186
https://kawalpemilu.org#68458,"WARAA, LEMBO, MOROWALI UTARA, SULAWESI TENGAH",1,155,11,166
https://kawalpemilu.org#68458,"WARAA, LEMBO, MOROWALI UTARA, SULAWESI TENGAH",2,160,16,176
https://kawalpemilu.org#68459,"TINGKEAO, LEMBO, MOROWALI UTARA, SULAWESI TENGAH",1,184,10,194
https://kawalpemilu.org#68459,"TINGKEAO, LEMBO, MOROWALI UTARA, SULAWESI TENGAH",2,173,15,188
https://kawalpemilu.org#68460,"MORA, LEMBO, MOROWALI UTARA, SULAWESI TENGAH",1,182,14,0
https://kawalpemilu.org#68461,"ULUANSO, LEMBO, MOROWALI UTARA, SULAWESI TENGAH",1,195,21,216
https://kawalpemilu.org#68462,"BETELEME, LEMBO, MOROWALI UTARA, SULAWESI TENGAH",1,215,24,239
https://kawalpemilu.org#68462,"BETELEME, LEMBO, MOROWALI UTARA, SULAWESI TENGAH",2,208,10,218
https://kawalpemilu.org#68462,"BETELEME, LEMBO, MOROWALI UTARA, SULAWESI TENGAH",3,221,13,234
https://kawalpemilu.org#68462,"BETELEME, LEMBO, MOROWALI UTARA, SULAWESI TENGAH",4,154,52,206
https://kawalpemilu.org#68462,"BETELEME, LEMBO, MOROWALI UTARA, SULAWESI TENGAH",5,182,29,211
https://kawalpemilu.org#68462,"BETELEME, LEMBO, MOROWALI UTARA, SULAWESI TENGAH",6,129,95,224
https://kawalpemilu.org#68462,"BETELEME, LEMBO, MOROWALI UTARA, SULAWESI TENGAH",7,59,55,114
https://kawalpemilu.org#68462,"BETELEME, LEMBO, MOROWALI UTARA, SULAWESI TENGAH",8,152,23,175
https://kawalpemilu.org#68462,"BETELEME, LEMBO, MOROWALI UTARA, SULAWESI TENGAH",9,149,31,180
https://kawalpemilu.org#68462,"BETELEME, LEMBO, MOROWALI UTARA, SULAWESI TENGAH",10,173,29,202
https://kawalpemilu.org#68462,"BETELEME, LEMBO, MOROWALI UTARA, SULAWESI TENGAH",11,98,59,157
https://kawalpemilu.org#68462,"BETELEME, LEMBO, MOROWALI UTARA, SULAWESI TENGAH",12,65,48,113
https://kawalpemilu.org#68463,"TINOMPO, LEMBO, MOROWALI UTARA, SULAWESI TENGAH",1,256,16,272
https://kawalpemilu.org#68463,"TINOMPO, LEMBO, MOROWALI UTARA, SULAWESI TENGAH",2,222,13,235
https://kawalpemilu.org#68463,"TINOMPO, LEMBO, MOROWALI UTARA, SULAWESI TENGAH",3,194,20,214
https://kawalpemilu.org#68463,"TINOMPO, LEMBO, MOROWALI UTARA, SULAWESI TENGAH",4,195,7,202
https://kawalpemilu.org#68464,"KUMPI, LEMBO, MOROWALI UTARA, SULAWESI TENGAH",1,154,8,162
https://kawalpemilu.org#68464,"KUMPI, LEMBO, MOROWALI UTARA, SULAWESI TENGAH",2,45,3,48
https://kawalpemilu.org#68464,"KUMPI, LEMBO, MOROWALI UTARA, SULAWESI TENGAH",3,116,7,123
https://kawalpemilu.org#68465,"KOROMPELI, LEMBO, MOROWALI UTARA, SULAWESI TENGAH",1,128,12,140
https://kawalpemilu.org#68465,"KOROMPELI, LEMBO, MOROWALI UTARA, SULAWESI TENGAH",2,110,23,133
https://kawalpemilu.org#68466,"KOROW ALELO, LEMBO, MOROWALI UTARA, SULAWESI TENGAH",1,146,13,159
https://kawalpemilu.org#68466,"KOROW ALELO, LEMBO, MOROWALI UTARA, SULAWESI TENGAH",2,136,6,142
https://kawalpemilu.org#68467,"LEMBOROMA, LEMBO, MOROWALI UTARA, SULAWESI TENGAH",1,237,22,259
https://kawalpemilu.org#68467,"LEMBOROMA, LEMBO, MOROWALI UTARA, SULAWESI TENGAH",2,202,21,223
https://kawalpemilu.org#68468,"KOROBONDE, LEMBO, MOROWALI UTARA, SULAWESI TENGAH",1,161,45,206
https://kawalpemilu.org#68468,"KOROBONDE, LEMBO, MOROWALI UTARA, SULAWESI TENGAH",2,136,53,189
https://kawalpemilu.org#68468,"KOROBONDE, LEMBO, MOROWALI UTARA, SULAWESI TENGAH",3,169,46,215
https://kawalpemilu.org#68468,"KOROBONDE, LEMBO, MOROWALI UTARA, SULAWESI TENGAH",4,139,44,183
https://kawalpemilu.org#68476,"BAHONTULA, PETASIA, MOROWALI UTARA, SULAWESI TENGAH",1,205,22,227
https://kawalpemilu.org#68476,"BAHONTULA, PETASIA, MOROWALI UTARA, SULAWESI TENGAH",2,0,0,147
https://kawalpemilu.org#68476,"BAHONTULA, PETASIA, MOROWALI UTARA, SULAWESI TENGAH",3,200,48,248
https://kawalpemilu.org#68476,"BAHONTULA, PETASIA, MOROWALI UTARA, SULAWESI TENGAH",4,126,65,191
https://kawalpemilu.org#68476,"BAHONTULA, PETASIA, MOROWALI UTARA, SULAWESI TENGAH",5,99,125,223
https://kawalpemilu.org#68476,"BAHONTULA, PETASIA, MOROWALI UTARA, SULAWESI TENGAH",6,81,102,183
https://kawalpemilu.org#68476,"BAHONTULA, PETASIA, MOROWALI UTARA, SULAWESI TENGAH",7,105,42,147
https://kawalpemilu.org#68476,"BAHONTULA, PETASIA, MOROWALI UTARA, SULAWESI TENGAH",8,196,22,218
https://kawalpemilu.org#68476,"BAHONTULA, PETASIA, MOROWALI UTARA, SULAWESI TENGAH",9,179,37,216
https://kawalpemilu.org#68476,"BAHONTULA, PETASIA, MOROWALI UTARA, SULAWESI TENGAH",10,129,32,161
https://kawalpemilu.org#68476,"BAHONTULA, PETASIA, MOROWALI UTARA, SULAWESI TENGAH",11,57,111,168
https://kawalpemilu.org#68476,"BAHONTULA, PETASIA, MOROWALI UTARA, SULAWESI TENGAH",12,52,77,129
https://kawalpemilu.org#68476,"BAHONTULA, PETASIA, MOROWALI UTARA, SULAWESI TENGAH",13,68,123,191
https://kawalpemilu.org#68477,"BAHOUE, PETASIA, MOROWALI UTARA, SULAWESI TENGAH",1,82,151,233
https://kawalpemilu.org#68477,"BAHOUE, PETASIA, MOROWALI UTARA, SULAWESI TENGAH",2,101,109,210
https://kawalpemilu.org#68477,"BAHOUE, PETASIA, MOROWALI UTARA, SULAWESI TENGAH",3,136,60,196
https://kawalpemilu.org#68477,"BAHOUE, PETASIA, MOROWALI UTARA, SULAWESI TENGAH",4,62,87,149
https://kawalpemilu.org#68477,"BAHOUE, PETASIA, MOROWALI UTARA, SULAWESI TENGAH",5,120,158,278
https://kawalpemilu.org#68477,"BAHOUE, PETASIA, MOROWALI UTARA, SULAWESI TENGAH",6,81,33,114
https://kawalpemilu.org#68478,"KOLONODALE, PETASIA, MOROWALI UTARA, SULAWESI TENGAH",1,93,113,206
https://kawalpemilu.org#68478,"KOLONODALE, PETASIA, MOROWALI UTARA, SULAWESI TENGAH",2,72,132,204
https://kawalpemilu.org#68478,"KOLONODALE, PETASIA, MOROWALI UTARA, SULAWESI TENGAH",3,44,69,113
https://kawalpemilu.org#68478,"KOLONODALE, PETASIA, MOROWALI UTARA, SULAWESI TENGAH",4,77,127,204
https://kawalpemilu.org#68478,"KOLONODALE, PETASIA, MOROWALI UTARA, SULAWESI TENGAH",5,72,103,175
https://kawalpemilu.org#68478,"KOLONODALE, PETASIA, MOROWALI UTARA, SULAWESI TENGAH",6,105,51,156
https://kawalpemilu.org#68478,"KOLONODALE, PETASIA, MOROWALI UTARA, SULAWESI TENGAH",7,94,144,238
https://kawalpemilu.org#68478,"KOLONODALE, PETASIA, MOROWALI UTARA, SULAWESI TENGAH",8,46,108,154
https://kawalpemilu.org#68478,"KOLONODALE, PETASIA, MOROWALI UTARA, SULAWESI TENGAH",9,70,97,167
https://kawalpemilu.org#68478,"KOLONODALE, PETASIA, MOROWALI UTARA, SULAWESI TENGAH",10,69,87,156
https://kawalpemilu.org#68478,"KOLONODALE, PETASIA, MOROWALI UTARA, SULAWESI TENGAH",11,73,114,187
https://kawalpemilu.org#68478,"KOLONODALE, PETASIA, MOROWALI UTARA, SULAWESI TENGAH",12,43,58,101
https://kawalpemilu.org#68484,"GILILANA, PETASIA, MOROWALI UTARA, SULAWESI TENGAH",1,73,157,230
https://kawalpemilu.org#68484,"GILILANA, PETASIA, MOROWALI UTARA, SULAWESI TENGAH",2,50,140,190
https://kawalpemilu.org#68485,"KOYA, PETASIA, MOROWALI UTARA, SULAWESI TENGAH",1,115,86,201
https://kawalpemilu.org#68485,"KOYA, PETASIA, MOROWALI UTARA, SULAWESI TENGAH",2,157,46,203
https://kawalpemilu.org#68486,"KOROLAKI, PETASIA, MOROWALI UTARA, SULAWESI TENGAH",1,128,60,188
https://kawalpemilu.org#68486,"KOROLAKI, PETASIA, MOROWALI UTARA, SULAWESI TENGAH",2,125,88,213
https://kawalpemilu.org#68486,"KOROLAKI, PETASIA, MOROWALI UTARA, SULAWESI TENGAH",3,141,74,215
https://kawalpemilu.org#68487,"KOROLAMA, PETASIA, MOROWALI UTARA, SULAWESI TENGAH",1,196,24,220
https://kawalpemilu.org#68487,"KOROLAMA, PETASIA, MOROWALI UTARA, SULAWESI TENGAH",2,158,22,180
https://kawalpemilu.org#68487,"KOROLAMA, PETASIA, MOROWALI UTARA, SULAWESI TENGAH",3,141,13,154
https://kawalpemilu.org#68488,"KOROMATANTU, PETASIA, MOROWALI UTARA, SULAWESI TENGAH",1,70,153,223
https://kawalpemilu.org#68488,"KOROMATANTU, PETASIA, MOROWALI UTARA, SULAWESI TENGAH",2,116,83,199
https://kawalpemilu.org#68488,"KOROMATANTU, PETASIA, MOROWALI UTARA, SULAWESI TENGAH",3,98,83,181
https://kawalpemilu.org#68496,"GANDA-GANDA, PETASIA, MOROWALI UTARA, SULAWESI TENGAH",1,99,136,235
https://kawalpemilu.org#68496,"GANDA-GANDA, PETASIA, MOROWALI UTARA, SULAWESI TENGAH",2,86,61,147
https://kawalpemilu.org#68496,"GANDA-GANDA, PETASIA, MOROWALI UTARA, SULAWESI TENGAH",3,150,63,213
https://kawalpemilu.org#68496,"GANDA-GANDA, PETASIA, MOROWALI UTARA, SULAWESI TENGAH",4,167,76,243
https://kawalpemilu.org#68496,"GANDA-GANDA, PETASIA, MOROWALI UTARA, SULAWESI TENGAH",5,105,58,163
https://kawalpemilu.org#68496,"GANDA-GANDA, PETASIA, MOROWALI UTARA, SULAWESI TENGAH",6,94,114,208
https://kawalpemilu.org#68501,"TANAUGE, PETASIA, MOROWALI UTARA, SULAWESI TENGAH",1,204,59,263
https://kawalpemilu.org#68505,"OPO, BUNGKU UTARA, MOROWALI UTARA, SULAWESI TENGAH",1,48,29,77
https://kawalpemilu.org#68505,"OPO, BUNGKU UTARA, MOROWALI UTARA, SULAWESI TENGAH",2,84,50,134
https://kawalpemilu.org#68505,"OPO, BUNGKU UTARA, MOROWALI UTARA, SULAWESI TENGAH",3,103,44,147
https://kawalpemilu.org#68506,"SALUBIRO, BUNGKU UTARA, MOROWALI UTARA, SULAWESI TENGAH",1,217,21,238
https://kawalpemilu.org#68506,"SALUBIRO, BUNGKU UTARA, MOROWALI UTARA, SULAWESI TENGAH",2,128,41,169
https://kawalpemilu.org#68506,"SALUBIRO, BUNGKU UTARA, MOROWALI UTARA, SULAWESI TENGAH",3,110,18,128
https://kawalpemilu.org#68506,"SALUBIRO, BUNGKU UTARA, MOROWALI UTARA, SULAWESI TENGAH",4,87,24,111
https://kawalpemilu.org#68507,"TOKALA ATAS, BUNGKU UTARA, MOROWALI UTARA, SULAWESI TENGAH",1,91,117,208
https://kawalpemilu.org#68507,"TOKALA ATAS, BUNGKU UTARA, MOROWALI UTARA, SULAWESI TENGAH",2,109,123,232
https://kawalpemilu.org#68508,"TARONGGO, BUNGKU UTARA, MOROWALI UTARA, SULAWESI TENGAH",1,115,40,155
https://kawalpemilu.org#68508,"TARONGGO, BUNGKU UTARA, MOROWALI UTARA, SULAWESI TENGAH",2,67,16,83
https://kawalpemilu.org#68508,"TARONGGO, BUNGKU UTARA, MOROWALI UTARA, SULAWESI TENGAH",3,93,26,119
https://kawalpemilu.org#68508,"TARONGGO, BUNGKU UTARA, MOROWALI UTARA, SULAWESI TENGAH",4,86,30,116
https://kawalpemilu.org#68509,"UEMASI, BUNGKU UTARA, MOROWALI UTARA, SULAWESI TENGAH",1,146,52,198
https://kawalpemilu.org#68510,"BATURUBE, BUNGKU UTARA, MOROWALI UTARA, SULAWESI TENGAH",1,65,88,153
https://kawalpemilu.org#68510,"BATURUBE, BUNGKU UTARA, MOROWALI UTARA, SULAWESI TENGAH",2,62,80,142
https://kawalpemilu.org#68510,"BATURUBE, BUNGKU UTARA, MOROWALI UTARA, SULAWESI TENGAH",3,48,154,202
https://kawalpemilu.org#68510,"BATURUBE, BUNGKU UTARA, MOROWALI UTARA, SULAWESI TENGAH",4,63,149,212
https://kawalpemilu.org#68510,"BATURUBE, BUNGKU UTARA, MOROWALI UTARA, SULAWESI TENGAH",5,45,107,152
https://kawalpemilu.org#68511,"KALOMBANG, BUNGKU UTARA, MOROWALI UTARA, SULAWESI TENGAH",1,55,80,135
https://kawalpemilu.org#68511,"KALOMBANG, BUNGKU UTARA, MOROWALI UTARA, SULAWESI TENGAH",2,72,72,144
https://kawalpemilu.org#68512,"WOOM PARIGI, BUNGKU UTARA, MOROWALI UTARA, SULAWESI TENGAH",1,112,69,181
https://kawalpemilu.org#68512,"WOOM PARIGI, BUNGKU UTARA, MOROWALI UTARA, SULAWESI TENGAH",2,119,49,168
https://kawalpemilu.org#68513,"POSANGKE, BUNGKU UTARA, MOROWALI UTARA, SULAWESI TENGAH",1,111,101,212
https://kawalpemilu.org#68513,"POSANGKE, BUNGKU UTARA, MOROWALI UTARA, SULAWESI TENGAH",2,121,11,132
https://kawalpemilu.org#68515,"TIRONGAN BAWAH, BUNGKU UTARA, MOROWALI UTARA, SULAWESI TENGAH",1,72,75,147
https://kawalpemilu.org#68515,"TIRONGAN BAWAH, BUNGKU UTARA, MOROWALI UTARA, SULAWESI TENGAH",2,58,83,141
https://kawalpemilu.org#68516,"BOBA, BUNGKU UTARA, MOROWALI UTARA, SULAWESI TENGAH",1,16,96,112
https://kawalpemilu.org#68516,"BOBA, BUNGKU UTARA, MOROWALI UTARA, SULAWESI TENGAH",2,36,83,119
https://kawalpemilu.org#68517,"UERURU, BUNGKU UTARA, MOROWALI UTARA, SULAWESI TENGAH",1,117,103,220
https://kawalpemilu.org#68518,"TOKANANAKA, BUNGKU UTARA, MOROWALI UTARA, SULAWESI TENGAH",1,58,112,170
https://kawalpemilu.org#68518,"TOKANANAKA, BUNGKU UTARA, MOROWALI UTARA, SULAWESI TENGAH",2,39,24,63
https://kawalpemilu.org#68519,"MATUBE, BUNGKU UTARA, MOROWALI UTARA, SULAWESI TENGAH",1,73,179,252
https://kawalpemilu.org#68519,"MATUBE, BUNGKU UTARA, MOROWALI UTARA, SULAWESI TENGAH",2,64,126,190
https://kawalpemilu.org#68520,"SILITI, BUNGKU UTARA, MOROWALI UTARA, SULAWESI TENGAH",1,89,124,213
https://kawalpemilu.org#68520,"SILITI, BUNGKU UTARA, MOROWALI UTARA, SULAWESI TENGAH",2,131,68,199
https://kawalpemilu.org#68521,"TIRONGAN ATAS, BUNGKU UTARA, MOROWALI UTARA, SULAWESI TENGAH",1,41,77,118
https://kawalpemilu.org#68521,"TIRONGAN ATAS, BUNGKU UTARA, MOROWALI UTARA, SULAWESI TENGAH",2,49,18,67
https://kawalpemilu.org#68521,"TIRONGAN ATAS, BUNGKU UTARA, MOROWALI UTARA, SULAWESI TENGAH",3,52,88,140
https://kawalpemilu.org#68522,"LEMO, BUNGKU UTARA, MOROWALI UTARA, SULAWESI TENGAH",1,206,52,258
https://kawalpemilu.org#68522,"LEMO, BUNGKU UTARA, MOROWALI UTARA, SULAWESI TENGAH",2,91,21,112
https://kawalpemilu.org#68523,"TAMBAROBONE, BUNGKU UTARA, MOROWALI UTARA, SULAWESI TENGAH",1,146,39,185
https://kawalpemilu.org#68523,"TAMBAROBONE, BUNGKU UTARA, MOROWALI UTARA, SULAWESI TENGAH",2,154,32,186
https://kawalpemilu.org#68523,"TAMBAROBONE, BUNGKU UTARA, MOROWALI UTARA, SULAWESI TENGAH",3,192,32,224
https://kawalpemilu.org#68524,"TANAKURAYA, BUNGKU UTARA, MOROWALI UTARA, SULAWESI TENGAH",1,86,90,176
https://kawalpemilu.org#68524,"TANAKURAYA, BUNGKU UTARA, MOROWALI UTARA, SULAWESI TENGAH",2,141,45,186
https://kawalpemilu.org#68524,"TANAKURAYA, BUNGKU UTARA, MOROWALI UTARA, SULAWESI TENGAH",3,76,48,124
https://kawalpemilu.org#89690,"LEMOWALIA, BUNGKU UTARA, MOROWALI UTARA, SULAWESI TENGAH",1,150,14,164
https://kawalpemilu.org#89691,"POKEANG, BUNGKU UTARA, MOROWALI UTARA, SULAWESI TENGAH",1,52,68,120
https://kawalpemilu.org#89691,"POKEANG, BUNGKU UTARA, MOROWALI UTARA, SULAWESI TENGAH",2,39,52,91
https://kawalpemilu.org#89691,"POKEANG, BUNGKU UTARA, MOROWALI UTARA, SULAWESI TENGAH",3,55,66,121
https://kawalpemilu.org#89692,"UEMPANAPA, BUNGKU UTARA, MOROWALI UTARA, SULAWESI TENGAH",1,150,81,231
https://kawalpemilu.org#68647,"BAU, SOYO JAYA, MOROWALI UTARA, SULAWESI TENGAH",1,0,0,0
https://kawalpemilu.org#68647,"BAU, SOYO JAYA, MOROWALI UTARA, SULAWESI TENGAH",2,164,56,220
https://kawalpemilu.org#68647,"BAU, SOYO JAYA, MOROWALI UTARA, SULAWESI TENGAH",3,0,0,0
https://kawalpemilu.org#68648,"TAMBAYOLI, SOYO JAYA, MOROWALI UTARA, SULAWESI TENGAH",1,119,90,209
https://kawalpemilu.org#68648,"TAMBAYOLI, SOYO JAYA, MOROWALI UTARA, SULAWESI TENGAH",2,39,21,60
https://kawalpemilu.org#68649,"TANDOYONDO, SOYO JAYA, MOROWALI UTARA, SULAWESI TENGAH",1,105,47,152
https://kawalpemilu.org#68649,"TANDOYONDO, SOYO JAYA, MOROWALI UTARA, SULAWESI TENGAH",2,113,37,150
https://kawalpemilu.org#68650,"TAMAINUSI, SOYO JAYA, MOROWALI UTARA, SULAWESI TENGAH",1,71,154,225
https://kawalpemilu.org#68650,"TAMAINUSI, SOYO JAYA, MOROWALI UTARA, SULAWESI TENGAH",2,27,134,161
https://kawalpemilu.org#68651,"MALINO, SOYO JAYA, MOROWALI UTARA, SULAWESI TENGAH",1,106,24,130
https://kawalpemilu.org#68651,"MALINO, SOYO JAYA, MOROWALI UTARA, SULAWESI TENGAH",2,128,20,148
https://kawalpemilu.org#68652,"LEMBAHSUMARA, SOYO JAYA, MOROWALI UTARA, SULAWESI TENGAH",1,56,136,192
https://kawalpemilu.org#68652,"LEMBAHSUMARA, SOYO JAYA, MOROWALI UTARA, SULAWESI TENGAH",2,59,158,217
https://kawalpemilu.org#68653,"SUMARA JAYA, SOYO JAYA, MOROWALI UTARA, SULAWESI TENGAH",1,134,41,175
https://kawalpemilu.org#68653,"SUMARA JAYA, SOYO JAYA, MOROWALI UTARA, SULAWESI TENGAH",2,77,35,112
https://kawalpemilu.org#68654,"MALINA JAYA, SOYO JAYA, MOROWALI UTARA, SULAWESI TENGAH",1,67,106,173
https://kawalpemilu.org#68654,"MALINA JAYA, SOYO JAYA, MOROWALI UTARA, SULAWESI TENGAH",2,114,84,198
https://kawalpemilu.org#68654,"MALINA JAYA, SOYO JAYA, MOROWALI UTARA, SULAWESI TENGAH",3,81,65,146
https://kawalpemilu.org#68655,"PANCA MAKMUR, SOYO JAYA, MOROWALI UTARA, SULAWESI TENGAH",1,193,47,240
https://kawalpemilu.org#68655,"PANCA MAKMUR, SOYO JAYA, MOROWALI UTARA, SULAWESI TENGAH",2,121,88,209
https://kawalpemilu.org#68655,"PANCA MAKMUR, SOYO JAYA, MOROWALI UTARA, SULAWESI TENGAH",3,108,120,228
https://kawalpemilu.org#68655,"PANCA MAKMUR, SOYO JAYA, MOROWALI UTARA, SULAWESI TENGAH",4,99,108,207
https://kawalpemilu.org#68655,"PANCA MAKMUR, SOYO JAYA, MOROWALI UTARA, SULAWESI TENGAH",5,176,30,206
https://kawalpemilu.org#68655,"PANCA MAKMUR, SOYO JAYA, MOROWALI UTARA, SULAWESI TENGAH",6,101,120,221
https://kawalpemilu.org#89700,"TODDOPOLI UEBANGKE, SOYO JAYA, MOROWALI UTARA, SULAWESI TENGAH",1,45,69,114
https://kawalpemilu.org#89700,"TODDOPOLI UEBANGKE, SOYO JAYA, MOROWALI UTARA, SULAWESI TENGAH",2,112,27,139
https://kawalpemilu.org#89700,"TODDOPOLI UEBANGKE, SOYO JAYA, MOROWALI UTARA, SULAWESI TENGAH",3,54,41,95
https://kawalpemilu.org#89700,"TODDOPOLI UEBANGKE, SOYO JAYA, MOROWALI UTARA, SULAWESI TENGAH",4,80,37,117
https://kawalpemilu.org#89700,"TODDOPOLI UEBANGKE, SOYO JAYA, MOROWALI UTARA, SULAWESI TENGAH",5,66,36,102
https://kawalpemilu.org#68667,"SEA, MAMOSALATO, MOROWALI UTARA, SULAWESI TENGAH",1,88,6,94
https://kawalpemilu.org#68667,"SEA, MAMOSALATO, MOROWALI UTARA, SULAWESI TENGAH",2,108,1,109
https://kawalpemilu.org#68667,"SEA, MAMOSALATO, MOROWALI UTARA, SULAWESI TENGAH",3,116,11,127
https://kawalpemilu.org#68668,"WINANGABINO, MAMOSALATO, MOROWALI UTARA, SULAWESI TENGAH",1,77,38,115
https://kawalpemilu.org#68668,"WINANGABINO, MAMOSALATO, MOROWALI UTARA, SULAWESI TENGAH",2,127,35,162
https://kawalpemilu.org#68669,"PARANGISI, MAMOSALATO, MOROWALI UTARA, SULAWESI TENGAH",1,122,8,130
https://kawalpemilu.org#68670,"LIJO, MAMOSALATO, MOROWALI UTARA, SULAWESI TENGAH",1,162,9,171
https://kawalpemilu.org#68670,"LIJO, MAMOSALATO, MOROWALI UTARA, SULAWESI TENGAH",2,180,5,185
https://kawalpemilu.org#68671,"PANDAUKE, MAMOSALATO, MOROWALI UTARA, SULAWESI TENGAH",1,109,85,194
https://kawalpemilu.org#68671,"PANDAUKE, MAMOSALATO, MOROWALI UTARA, SULAWESI TENGAH",2,136,121,257
https://kawalpemilu.org#68671,"PANDAUKE, MAMOSALATO, MOROWALI UTARA, SULAWESI TENGAH",3,152,130,282
https://kawalpemilu.org#68672,"TAMBALE, MAMOSALATO, MOROWALI UTARA, SULAWESI TENGAH",1,87,40,127
https://kawalpemilu.org#68672,"TAMBALE, MAMOSALATO, MOROWALI UTARA, SULAWESI TENGAH",2,105,39,144
https://kawalpemilu.org#68673,"KOLO ATAS, MAMOSALATO, MOROWALI UTARA, SULAWESI TENGAH",1,31,91,122
https://kawalpemilu.org#68673,"KOLO ATAS, MAMOSALATO, MOROWALI UTARA, SULAWESI TENGAH",2,65,60,125
https://kawalpemilu.org#68673,"KOLO ATAS, MAMOSALATO, MOROWALI UTARA, SULAWESI TENGAH",3,59,44,103
https://kawalpemilu.org#68674,"KOLO BAWAH, MAMOSALATO, MOROWALI UTARA, SULAWESI TENGAH",1,140,102,242
https://kawalpemilu.org#68674,"KOLO BAWAH, MAMOSALATO, MOROWALI UTARA, SULAWESI TENGAH",2,125,92,217
https://kawalpemilu.org#68674,"KOLO BAWAH, MAMOSALATO, MOROWALI UTARA, SULAWESI TENGAH",3,174,79,253
https://kawalpemilu.org#68675,"MOMO, MAMOSALATO, MOROWALI UTARA, SULAWESI TENGAH",1,171,63,234
https://kawalpemilu.org#68675,"MOMO, MAMOSALATO, MOROWALI UTARA, SULAWESI TENGAH",2,187,14,201
https://kawalpemilu.org#68676,"MENYOE, MAMOSALATO, MOROWALI UTARA, SULAWESI TENGAH",1,212,12,224
https://kawalpemilu.org#68676,"MENYOE, MAMOSALATO, MOROWALI UTARA, SULAWESI TENGAH",2,137,35,172
https://kawalpemilu.org#68676,"MENYOE, MAMOSALATO, MOROWALI UTARA, SULAWESI TENGAH",3,147,7,154
https://kawalpemilu.org#68677,"UEPAKATU, MAMOSALATO, MOROWALI UTARA, SULAWESI TENGAH",1,58,4,62
https://kawalpemilu.org#68677,"UEPAKATU, MAMOSALATO, MOROWALI UTARA, SULAWESI TENGAH",2,67,5,72
https://kawalpemilu.org#68678,"TANA SUMPU, MAMOSALATO, MOROWALI UTARA, SULAWESI TENGAH",1,152,64,216
https://kawalpemilu.org#68678,"TANA SUMPU, MAMOSALATO, MOROWALI UTARA, SULAWESI TENGAH",2,129,77,206
https://kawalpemilu.org#68678,"TANA SUMPU, MAMOSALATO, MOROWALI UTARA, SULAWESI TENGAH",3,185,63,248
https://kawalpemilu.org#68678,"TANA SUMPU, MAMOSALATO, MOROWALI UTARA, SULAWESI TENGAH",4,107,70,177
https://kawalpemilu.org#68678,"TANA SUMPU, MAMOSALATO, MOROWALI UTARA, SULAWESI TENGAH",5,130,73,203
https://kawalpemilu.org#68679,"TANANAGAYA, MAMOSALATO, MOROWALI UTARA, SULAWESI TENGAH",1,183,62,245
https://kawalpemilu.org#68679,"TANANAGAYA, MAMOSALATO, MOROWALI UTARA, SULAWESI TENGAH",2,138,38,176
https://kawalpemilu.org#68679,"TANANAGAYA, MAMOSALATO, MOROWALI UTARA, SULAWESI TENGAH",3,184,43,227
https://kawalpemilu.org#68680,"GIRIMULYA, MAMOSALATO, MOROWALI UTARA, SULAWESI TENGAH",1,135,40,175
https://kawalpemilu.org#68442,"TABARANO, MORI UTARA, MOROWALI UTARA, SULAWESI TENGAH",1,183,11,194
https://kawalpemilu.org#68442,"TABARANO, MORI UTARA, MOROWALI UTARA, SULAWESI TENGAH",2,166,2,168
https://kawalpemilu.org#68442,"TABARANO, MORI UTARA, MOROWALI UTARA, SULAWESI TENGAH",3,212,6,218
https://kawalpemilu.org#68444,"TIWAA, MORI UTARA, MOROWALI UTARA, SULAWESI TENGAH",1,146,15,161
https://kawalpemilu.org#68444,"TIWAA, MORI UTARA, MOROWALI UTARA, SULAWESI TENGAH",2,142,5,147
https://kawalpemilu.org#68445,"TAMONJENGI, MORI UTARA, MOROWALI UTARA, SULAWESI TENGAH",1,128,11,139
https://kawalpemilu.org#68445,"TAMONJENGI, MORI UTARA, MOROWALI UTARA, SULAWESI TENGAH",2,129,8,137
https://kawalpemilu.org#68446,"MAYUMBA, MORI UTARA, MOROWALI UTARA, SULAWESI TENGAH",1,228,16,244
https://kawalpemilu.org#68446,"MAYUMBA, MORI UTARA, MOROWALI UTARA, SULAWESI TENGAH",2,236,14,250
https://kawalpemilu.org#68447,"PELERU, MORI UTARA, MOROWALI UTARA, SULAWESI TENGAH",1,56,141,197
https://kawalpemilu.org#68447,"PELERU, MORI UTARA, MOROWALI UTARA, SULAWESI TENGAH",2,44,151,195
https://kawalpemilu.org#68447,"PELERU, MORI UTARA, MOROWALI UTARA, SULAWESI TENGAH",3,47,84,131
https://kawalpemilu.org#68447,"PELERU, MORI UTARA, MOROWALI UTARA, SULAWESI TENGAH",4,178,10,188
https://kawalpemilu.org#68447,"PELERU, MORI UTARA, MOROWALI UTARA, SULAWESI TENGAH",5,201,19,220
https://kawalpemilu.org#68447,"PELERU, MORI UTARA, MOROWALI UTARA, SULAWESI TENGAH",6,231,11,242
https://kawalpemilu.org#68448,"ERA, MORI UTARA, MOROWALI UTARA, SULAWESI TENGAH",1,158,8,166
https://kawalpemilu.org#68448,"ERA, MORI UTARA, MOROWALI UTARA, SULAWESI TENGAH",2,158,7,165
https://kawalpemilu.org#68448,"ERA, MORI UTARA, MOROWALI UTARA, SULAWESI TENGAH",3,136,7,143
https://kawalpemilu.org#68448,"ERA, MORI UTARA, MOROWALI UTARA, SULAWESI TENGAH",4,95,31,126
https://kawalpemilu.org#89701,"LEMBONTONARA, MORI UTARA, MOROWALI UTARA, SULAWESI TENGAH",1,189,49,238
https://kawalpemilu.org#89701,"LEMBONTONARA, MORI UTARA, MOROWALI UTARA, SULAWESI TENGAH",2,142,28,170
https://kawalpemilu.org#89701,"LEMBONTONARA, MORI UTARA, MOROWALI UTARA, SULAWESI TENGAH",3,146,43,189
https://kawalpemilu.org#89701,"LEMBONTONARA, MORI UTARA, MOROWALI UTARA, SULAWESI TENGAH",4,132,40,1
https://kawalpemilu.org#89701,"LEMBONTONARA, MORI UTARA, MOROWALI UTARA, SULAWESI TENGAH",5,115,23,138
https://kawalpemilu.org#89702,"WOWONDULA, MORI UTARA, MOROWALI UTARA, SULAWESI TENGAH",1,136,6,142
https://kawalpemilu.org#89702,"WOWONDULA, MORI UTARA, MOROWALI UTARA, SULAWESI TENGAH",2,138,5,143
https://kawalpemilu.org#89702,"WOWONDULA, MORI UTARA, MOROWALI UTARA, SULAWESI TENGAH",3,182,9,191
https://kawalpemilu.org#89702,"WOWONDULA, MORI UTARA, MOROWALI UTARA, SULAWESI TENGAH",4,185,15,200
https://kawalpemilu.org#68451,"PETUMBEA, LEMBO RAYA, MOROWALI UTARA, SULAWESI TENGAH",1,237,3,240
https://kawalpemilu.org#68451,"PETUMBEA, LEMBO RAYA, MOROWALI UTARA, SULAWESI TENGAH",2,135,21,156
https://kawalpemilu.org#68451,"PETUMBEA, LEMBO RAYA, MOROWALI UTARA, SULAWESI TENGAH",3,118,29,147
https://kawalpemilu.org#68452,"RONTA, LEMBO RAYA, MOROWALI UTARA, SULAWESI TENGAH",1,142,28,170
https://kawalpemilu.org#68452,"RONTA, LEMBO RAYA, MOROWALI UTARA, SULAWESI TENGAH",2,160,16,176
https://kawalpemilu.org#68452,"RONTA, LEMBO RAYA, MOROWALI UTARA, SULAWESI TENGAH",3,169,16,185
https://kawalpemilu.org#68455,"LEMBOBELALA, LEMBO RAYA, MOROWALI UTARA, SULAWESI TENGAH",1,257,9,266
https://kawalpemilu.org#68471,"JAMOR JAYA, LEMBO RAYA, MOROWALI UTARA, SULAWESI TENGAH",1,144,39,183
https://kawalpemilu.org#68471,"JAMOR JAYA, LEMBO RAYA, MOROWALI UTARA, SULAWESI TENGAH",2,150,32,182
https://kawalpemilu.org#68471,"JAMOR JAYA, LEMBO RAYA, MOROWALI UTARA, SULAWESI TENGAH",3,97,70,167
https://kawalpemilu.org#68471,"JAMOR JAYA, LEMBO RAYA, MOROWALI UTARA, SULAWESI TENGAH",4,177,38,215
https://kawalpemilu.org#68472,"DOLUPO KARYA, LEMBO RAYA, MOROWALI UTARA, SULAWESI TENGAH",1,215,32,247
https://kawalpemilu.org#68472,"DOLUPO KARYA, LEMBO RAYA, MOROWALI UTARA, SULAWESI TENGAH",2,144,30,174
https://kawalpemilu.org#68472,"DOLUPO KARYA, LEMBO RAYA, MOROWALI UTARA, SULAWESI TENGAH",3,112,19,131
https://kawalpemilu.org#68472,"DOLUPO KARYA, LEMBO RAYA, MOROWALI UTARA, SULAWESI TENGAH",4,117,9,126
https://kawalpemilu.org#68472,"DOLUPO KARYA, LEMBO RAYA, MOROWALI UTARA, SULAWESI TENGAH",5,96,16,112
https://kawalpemilu.org#68473,"BINTANGOR MUKTI, LEMBO RAYA, MOROWALI UTARA, SULAWESI TENGAH",1,137,63,200
https://kawalpemilu.org#68473,"BINTANGOR MUKTI, LEMBO RAYA, MOROWALI UTARA, SULAWESI TENGAH",2,113,41,154
https://kawalpemilu.org#68474,"MANDULA, LEMBO RAYA, MOROWALI UTARA, SULAWESI TENGAH",1,169,6,175
https://kawalpemilu.org#68474,"MANDULA, LEMBO RAYA, MOROWALI UTARA, SULAWESI TENGAH",2,152,16,168
https://kawalpemilu.org#89705,"PONTANGOA, LEMBO RAYA, MOROWALI UTARA, SULAWESI TENGAH",1,84,61,145
https://kawalpemilu.org#89705,"PONTANGOA, LEMBO RAYA, MOROWALI UTARA, SULAWESI TENGAH",2,77,58,135
https://kawalpemilu.org#89705,"PONTANGOA, LEMBO RAYA, MOROWALI UTARA, SULAWESI TENGAH",3,103,49,152
https://kawalpemilu.org#89706,"PO'ONA, LEMBO RAYA, MOROWALI UTARA, SULAWESI TENGAH",1,138,15,153
https://kawalpemilu.org#89706,"PO'ONA, LEMBO RAYA, MOROWALI UTARA, SULAWESI TENGAH",2,148,10,158
https://kawalpemilu.org#89706,"PO'ONA, LEMBO RAYA, MOROWALI UTARA, SULAWESI TENGAH",3,128,5,133
https://kawalpemilu.org#89707,"PA'AWARU, LEMBO RAYA, MOROWALI UTARA, SULAWESI TENGAH",1,127,67,194
https://kawalpemilu.org#89707,"PA'AWARU, LEMBO RAYA, MOROWALI UTARA, SULAWESI TENGAH",2,151,36,187
https://kawalpemilu.org#89707,"PA'AWARU, LEMBO RAYA, MOROWALI UTARA, SULAWESI TENGAH",3,147,37,184
https://kawalpemilu.org#68479,"TOWARA, PETASIA TIMUR, MOROWALI UTARA, SULAWESI TENGAH",1,106,98,204
https://kawalpemilu.org#68479,"TOWARA, PETASIA TIMUR, MOROWALI UTARA, SULAWESI TENGAH",2,112,76,188
https://kawalpemilu.org#68479,"TOWARA, PETASIA TIMUR, MOROWALI UTARA, SULAWESI TENGAH",3,110,87,197
https://kawalpemilu.org#68479,"TOWARA, PETASIA TIMUR, MOROWALI UTARA, SULAWESI TENGAH",4,42,100,142
https://kawalpemilu.org#68480,"MOHONI, PETASIA TIMUR, MOROWALI UTARA, SULAWESI TENGAH",1,137,82,219
https://kawalpemilu.org#68480,"MOHONI, PETASIA TIMUR, MOROWALI UTARA, SULAWESI TENGAH",2,187,19,206
https://kawalpemilu.org#68480,"MOHONI, PETASIA TIMUR, MOROWALI UTARA, SULAWESI TENGAH",3,199,29,228
https://kawalpemilu.org#68480,"MOHONI, PETASIA TIMUR, MOROWALI UTARA, SULAWESI TENGAH",4,147,22,169
https://kawalpemilu.org#68481,"BUNGINTIMBE, PETASIA TIMUR, MOROWALI UTARA, SULAWESI TENGAH",1,107,118,225
https://kawalpemilu.org#68481,"BUNGINTIMBE, PETASIA TIMUR, MOROWALI UTARA, SULAWESI TENGAH",2,101,108,209
https://kawalpemilu.org#68481,"BUNGINTIMBE, PETASIA TIMUR, MOROWALI UTARA, SULAWESI TENGAH",3,71,135,206
https://kawalpemilu.org#68481,"BUNGINTIMBE, PETASIA TIMUR, MOROWALI UTARA, SULAWESI TENGAH",4,100,31,131
https://kawalpemilu.org#68481,"BUNGINTIMBE, PETASIA TIMUR, MOROWALI UTARA, SULAWESI TENGAH",5,96,108,204
https://kawalpemilu.org#68481,"BUNGINTIMBE, PETASIA TIMUR, MOROWALI UTARA, SULAWESI TENGAH",6,79,58,137
https://kawalpemilu.org#68481,"BUNGINTIMBE, PETASIA TIMUR, MOROWALI UTARA, SULAWESI TENGAH",7,68,86,154
https://kawalpemilu.org#68482,"TOMPIRA, PETASIA TIMUR, MOROWALI UTARA, SULAWESI TENGAH",1,126,124,250
https://kawalpemilu.org#68482,"TOMPIRA, PETASIA TIMUR, MOROWALI UTARA, SULAWESI TENGAH",2,111,79,190
https://kawalpemilu.org#68482,"TOMPIRA, PETASIA TIMUR, MOROWALI UTARA, SULAWESI TENGAH",3,137,104,241
https://kawalpemilu.org#68482,"TOMPIRA, PETASIA TIMUR, MOROWALI UTARA, SULAWESI TENGAH",4,129,76,205
https://kawalpemilu.org#68482,"TOMPIRA, PETASIA TIMUR, MOROWALI UTARA, SULAWESI TENGAH",5,125,61,186
https://kawalpemilu.org#68482,"TOMPIRA, PETASIA TIMUR, MOROWALI UTARA, SULAWESI TENGAH",6,117,52,169
https://kawalpemilu.org#68483,"BUNTA, PETASIA TIMUR, MOROWALI UTARA, SULAWESI TENGAH",1,203,27,230
https://kawalpemilu.org#68483,"BUNTA, PETASIA TIMUR, MOROWALI UTARA, SULAWESI TENGAH",2,116,118,234
https://kawalpemilu.org#68483,"BUNTA, PETASIA TIMUR, MOROWALI UTARA, SULAWESI TENGAH",3,206,44,250
https://kawalpemilu.org#68483,"BUNTA, PETASIA TIMUR, MOROWALI UTARA, SULAWESI TENGAH",4,124,32,156
https://kawalpemilu.org#68483,"BUNTA, PETASIA TIMUR, MOROWALI UTARA, SULAWESI TENGAH",5,156,39,195
https://kawalpemilu.org#68483,"BUNTA, PETASIA TIMUR, MOROWALI UTARA, SULAWESI TENGAH",6,156,54,210
https://kawalpemilu.org#68497,"MOLINO, PETASIA TIMUR, MOROWALI UTARA, SULAWESI TENGAH",1,86,80,166
https://kawalpemilu.org#68497,"MOLINO, PETASIA TIMUR, MOROWALI UTARA, SULAWESI TENGAH",2,142,72,214
https://kawalpemilu.org#68497,"MOLINO, PETASIA TIMUR, MOROWALI UTARA, SULAWESI TENGAH",3,89,47,136
https://kawalpemilu.org#68497,"MOLINO, PETASIA TIMUR, MOROWALI UTARA, SULAWESI TENGAH",4,152,59,211
https://kawalpemilu.org#68498,"KEUNO, PETASIA TIMUR, MOROWALI UTARA, SULAWESI TENGAH",1,136,32,168
https://kawalpemilu.org#68498,"KEUNO, PETASIA TIMUR, MOROWALI UTARA, SULAWESI TENGAH",2,146,17,163
https://kawalpemilu.org#68500,"UNGKEA, PETASIA TIMUR, MOROWALI UTARA, SULAWESI TENGAH",1,125,51,176
https://kawalpemilu.org#68500,"UNGKEA, PETASIA TIMUR, MOROWALI UTARA, SULAWESI TENGAH",2,74,95,169
https://kawalpemilu.org#68500,"UNGKEA, PETASIA TIMUR, MOROWALI UTARA, SULAWESI TENGAH",3,132,63,195
https://kawalpemilu.org#68502,"MOLORES, PETASIA TIMUR, MOROWALI UTARA, SULAWESI TENGAH",1,81,147,228
https://kawalpemilu.org#68502,"MOLORES, PETASIA TIMUR, MOROWALI UTARA, SULAWESI TENGAH",2,57,148,205
https://kawalpemilu.org#68502,"MOLORES, PETASIA TIMUR, MOROWALI UTARA, SULAWESI TENGAH",3,131,13,144
https://kawalpemilu.org#68502,"MOLORES, PETASIA TIMUR, MOROWALI UTARA, SULAWESI TENGAH",4,22,148,170
https://kawalpemilu.org#89708,"bimor jaya, PETASIA TIMUR, MOROWALI UTARA, SULAWESI TENGAH",1,137,44,181
https://kawalpemilu.org#89708,"bimor jaya, PETASIA TIMUR, MOROWALI UTARA, SULAWESI TENGAH",2,105,45,150
https://kawalpemilu.org#89708,"bimor jaya, PETASIA TIMUR, MOROWALI UTARA, SULAWESI TENGAH",3,115,33,148
https://kawalpemilu.org#89709,"TOWARA PANTAI, PETASIA TIMUR, MOROWALI UTARA, SULAWESI TENGAH",1,96,34,130
https://kawalpemilu.org#89710,"PEBOA, PETASIA TIMUR, MOROWALI UTARA, SULAWESI TENGAH",1,180,20,200
https://kawalpemilu.org#89710,"PEBOA, PETASIA TIMUR, MOROWALI UTARA, SULAWESI TENGAH",2,185,35,220
https://kawalpemilu.org#68489,"MONDOWE, PETASIA BARAT, MOROWALI UTARA, SULAWESI TENGAH",1,128,84,212
https://kawalpemilu.org#68489,"MONDOWE, PETASIA BARAT, MOROWALI UTARA, SULAWESI TENGAH",2,115,53,168
https://kawalpemilu.org#68491,"SAMPALOWO, PETASIA BARAT, MOROWALI UTARA, SULAWESI TENGAH",1,153,30,183
https://kawalpemilu.org#68491,"SAMPALOWO, PETASIA BARAT, MOROWALI UTARA, SULAWESI TENGAH",2,141,18,159
https://kawalpemilu.org#68491,"SAMPALOWO, PETASIA BARAT, MOROWALI UTARA, SULAWESI TENGAH",3,143,17,160
https://kawalpemilu.org#68492,"MOLEONO, PETASIA BARAT, MOROWALI UTARA, SULAWESI TENGAH",1,123,7,130
https://kawalpemilu.org#68492,"MOLEONO, PETASIA BARAT, MOROWALI UTARA, SULAWESI TENGAH",2,50,47,97
https://kawalpemilu.org#68492,"MOLEONO, PETASIA BARAT, MOROWALI UTARA, SULAWESI TENGAH",3,142,11,153
https://kawalpemilu.org#68492,"MOLEONO, PETASIA BARAT, MOROWALI UTARA, SULAWESI TENGAH",4,34,11,45
https://kawalpemilu.org#68493,"MARALEE, PETASIA BARAT, MOROWALI UTARA, SULAWESI TENGAH",1,189,5,194
https://kawalpemilu.org#68493,"MARALEE, PETASIA BARAT, MOROWALI UTARA, SULAWESI TENGAH",2,155,7,162
https://kawalpemilu.org#68494,"TIU, PETASIA BARAT, MOROWALI UTARA, SULAWESI TENGAH",1,163,12,175
https://kawalpemilu.org#68494,"TIU, PETASIA BARAT, MOROWALI UTARA, SULAWESI TENGAH",2,178,21,199
https://kawalpemilu.org#68494,"TIU, PETASIA BARAT, MOROWALI UTARA, SULAWESI TENGAH",3,194,16,210
https://kawalpemilu.org#68494,"TIU, PETASIA BARAT, MOROWALI UTARA, SULAWESI TENGAH",4,193,33,226
https://kawalpemilu.org#68494,"TIU, PETASIA BARAT, MOROWALI UTARA, SULAWESI TENGAH",5,120,74,194
https://kawalpemilu.org#68495,"TONTOWEA, PETASIA BARAT, MOROWALI UTARA, SULAWESI TENGAH",1,190,17,207
https://kawalpemilu.org#68495,"TONTOWEA, PETASIA BARAT, MOROWALI UTARA, SULAWESI TENGAH",2,194,23,217
https://kawalpemilu.org#68495,"TONTOWEA, PETASIA BARAT, MOROWALI UTARA, SULAWESI TENGAH",3,91,6,97
https://kawalpemilu.org#89712,"TOGO MULYO, PETASIA BARAT, MOROWALI UTARA, SULAWESI TENGAH",1,133,40,173
https://kawalpemilu.org#89712,"TOGO MULYO, PETASIA BARAT, MOROWALI UTARA, SULAWESI TENGAH",2,188,26,214
https://kawalpemilu.org#89712,"TOGO MULYO, PETASIA BARAT, MOROWALI UTARA, SULAWESI TENGAH",3,181,21,202
https://kawalpemilu.org#89713,"ONEPUTE, PETASIA BARAT, MOROWALI UTARA, SULAWESI TENGAH",1,136,70,206
https://kawalpemilu.org#89713,"ONEPUTE, PETASIA BARAT, MOROWALI UTARA, SULAWESI TENGAH",2,129,115,244
https://kawalpemilu.org#89714,"ULU LAA, PETASIA BARAT, MOROWALI UTARA, SULAWESI TENGAH",1,97,80,177
https://kawalpemilu.org#89714,"ULU LAA, PETASIA BARAT, MOROWALI UTARA, SULAWESI TENGAH",2,50,51,101
https://kawalpemilu.org#89715,"TADAKU JAYA, PETASIA BARAT, MOROWALI UTARA, SULAWESI TENGAH",1,17,75,92
https://kawalpemilu.org#89715,"TADAKU JAYA, PETASIA BARAT, MOROWALI UTARA, SULAWESI TENGAH",2,30,39,69
