Link KawalPemilu,Nama Kelurahan,Nomor TPS,Suara 01,Suara 02,Suara Sah
https://kawalpemilu.org#75428,"BAMBALAMOTU, BAMBALAMOTU, MAMUJU UTARA, SULAWESI BARAT",1,142,103,245
https://kawalpemilu.org#75428,"BAMBALAMOTU, BAMBALAMOTU, MAMUJU UTARA, SULAWESI BARAT",2,101,160,261
https://kawalpemilu.org#75428,"BAMBALAMOTU, BAMBALAMOTU, MAMUJU UTARA, SULAWESI BARAT",3,101,108,209
https://kawalpemilu.org#75428,"BAMBALAMOTU, BAMBALAMOTU, MAMUJU UTARA, SULAWESI BARAT",4,143,114,257
https://kawalpemilu.org#75428,"BAMBALAMOTU, BAMBALAMOTU, MAMUJU UTARA, SULAWESI BARAT",5,107,117,224
https://kawalpemilu.org#75428,"BAMBALAMOTU, BAMBALAMOTU, MAMUJU UTARA, SULAWESI BARAT",6,89,66,155
https://kawalpemilu.org#75428,"BAMBALAMOTU, BAMBALAMOTU, MAMUJU UTARA, SULAWESI BARAT",7,133,143,276
https://kawalpemilu.org#75428,"BAMBALAMOTU, BAMBALAMOTU, MAMUJU UTARA, SULAWESI BARAT",8,123,90,213
https://kawalpemilu.org#75428,"BAMBALAMOTU, BAMBALAMOTU, MAMUJU UTARA, SULAWESI BARAT",9,169,74,243
https://kawalpemilu.org#75429,"POLEWALI, BAMBALAMOTU, MAMUJU UTARA, SULAWESI BARAT",1,62,153,215
https://kawalpemilu.org#75429,"POLEWALI, BAMBALAMOTU, MAMUJU UTARA, SULAWESI BARAT",2,126,132,258
https://kawalpemilu.org#75429,"POLEWALI, BAMBALAMOTU, MAMUJU UTARA, SULAWESI BARAT",3,59,65,124
https://kawalpemilu.org#75429,"POLEWALI, BAMBALAMOTU, MAMUJU UTARA, SULAWESI BARAT",4,61,79,140
https://kawalpemilu.org#75429,"POLEWALI, BAMBALAMOTU, MAMUJU UTARA, SULAWESI BARAT",5,162,62,224
https://kawalpemilu.org#75429,"POLEWALI, BAMBALAMOTU, MAMUJU UTARA, SULAWESI BARAT",6,132,49,181
https://kawalpemilu.org#75429,"POLEWALI, BAMBALAMOTU, MAMUJU UTARA, SULAWESI BARAT",7,212,49,261
https://kawalpemilu.org#75429,"POLEWALI, BAMBALAMOTU, MAMUJU UTARA, SULAWESI BARAT",8,57,80,137
https://kawalpemilu.org#75429,"POLEWALI, BAMBALAMOTU, MAMUJU UTARA, SULAWESI BARAT",9,199,15,214
https://kawalpemilu.org#75429,"POLEWALI, BAMBALAMOTU, MAMUJU UTARA, SULAWESI BARAT",10,65,64,129
https://kawalpemilu.org#75430,"RANDOMAYANG, BAMBALAMOTU, MAMUJU UTARA, SULAWESI BARAT",1,130,121,251
https://kawalpemilu.org#75430,"RANDOMAYANG, BAMBALAMOTU, MAMUJU UTARA, SULAWESI BARAT",2,138,127,265
https://kawalpemilu.org#75430,"RANDOMAYANG, BAMBALAMOTU, MAMUJU UTARA, SULAWESI BARAT",3,153,107,260
https://kawalpemilu.org#75430,"RANDOMAYANG, BAMBALAMOTU, MAMUJU UTARA, SULAWESI BARAT",4,136,103,239
https://kawalpemilu.org#75430,"RANDOMAYANG, BAMBALAMOTU, MAMUJU UTARA, SULAWESI BARAT",5,117,90,207
https://kawalpemilu.org#75430,"RANDOMAYANG, BAMBALAMOTU, MAMUJU UTARA, SULAWESI BARAT",6,96,20,116
https://kawalpemilu.org#75430,"RANDOMAYANG, BAMBALAMOTU, MAMUJU UTARA, SULAWESI BARAT",7,104,82,186
https://kawalpemilu.org#75430,"RANDOMAYANG, BAMBALAMOTU, MAMUJU UTARA, SULAWESI BARAT",8,170,56,226
https://kawalpemilu.org#75430,"RANDOMAYANG, BAMBALAMOTU, MAMUJU UTARA, SULAWESI BARAT",9,135,120,255
https://kawalpemilu.org#75430,"RANDOMAYANG, BAMBALAMOTU, MAMUJU UTARA, SULAWESI BARAT",10,28,65,93
https://kawalpemilu.org#75431,"PANGIANG, BAMBALAMOTU, MAMUJU UTARA, SULAWESI BARAT",1,117,31,148
https://kawalpemilu.org#75431,"PANGIANG, BAMBALAMOTU, MAMUJU UTARA, SULAWESI BARAT",2,153,44,197
https://kawalpemilu.org#75431,"PANGIANG, BAMBALAMOTU, MAMUJU UTARA, SULAWESI BARAT",3,105,30,135
https://kawalpemilu.org#75431,"PANGIANG, BAMBALAMOTU, MAMUJU UTARA, SULAWESI BARAT",4,128,86,214
https://kawalpemilu.org#75431,"PANGIANG, BAMBALAMOTU, MAMUJU UTARA, SULAWESI BARAT",5,203,59,262
https://kawalpemilu.org#75431,"PANGIANG, BAMBALAMOTU, MAMUJU UTARA, SULAWESI BARAT",6,127,81,208
https://kawalpemilu.org#75431,"PANGIANG, BAMBALAMOTU, MAMUJU UTARA, SULAWESI BARAT",7,23,10,33
https://kawalpemilu.org#75432,"KALOLA, BAMBALAMOTU, MAMUJU UTARA, SULAWESI BARAT",1,142,119,261
https://kawalpemilu.org#75432,"KALOLA, BAMBALAMOTU, MAMUJU UTARA, SULAWESI BARAT",2,180,87,267
https://kawalpemilu.org#75432,"KALOLA, BAMBALAMOTU, MAMUJU UTARA, SULAWESI BARAT",3,148,71,219
https://kawalpemilu.org#75432,"KALOLA, BAMBALAMOTU, MAMUJU UTARA, SULAWESI BARAT",4,198,13,211
https://kawalpemilu.org#75432,"KALOLA, BAMBALAMOTU, MAMUJU UTARA, SULAWESI BARAT",5,168,87,255
https://kawalpemilu.org#75432,"KALOLA, BAMBALAMOTU, MAMUJU UTARA, SULAWESI BARAT",6,211,48,259
https://kawalpemilu.org#75432,"KALOLA, BAMBALAMOTU, MAMUJU UTARA, SULAWESI BARAT",7,141,11,152
https://kawalpemilu.org#75432,"KALOLA, BAMBALAMOTU, MAMUJU UTARA, SULAWESI BARAT",8,105,60,165
https://kawalpemilu.org#75432,"KALOLA, BAMBALAMOTU, MAMUJU UTARA, SULAWESI BARAT",9,96,46,142
https://kawalpemilu.org#75433,"WULAI, BAMBALAMOTU, MAMUJU UTARA, SULAWESI BARAT",1,108,129,237
https://kawalpemilu.org#75433,"WULAI, BAMBALAMOTU, MAMUJU UTARA, SULAWESI BARAT",2,195,31,226
https://kawalpemilu.org#75433,"WULAI, BAMBALAMOTU, MAMUJU UTARA, SULAWESI BARAT",3,189,29,218
https://kawalpemilu.org#75433,"WULAI, BAMBALAMOTU, MAMUJU UTARA, SULAWESI BARAT",4,77,9,86
https://kawalpemilu.org#75433,"WULAI, BAMBALAMOTU, MAMUJU UTARA, SULAWESI BARAT",5,156,10,166
https://kawalpemilu.org#75433,"WULAI, BAMBALAMOTU, MAMUJU UTARA, SULAWESI BARAT",6,133,12,145
https://kawalpemilu.org#75435,"PASANGKAYU, PASANGKAYU, MAMUJU UTARA, SULAWESI BARAT",1,138,162,300
https://kawalpemilu.org#75435,"PASANGKAYU, PASANGKAYU, MAMUJU UTARA, SULAWESI BARAT",2,170,129,299
https://kawalpemilu.org#75435,"PASANGKAYU, PASANGKAYU, MAMUJU UTARA, SULAWESI BARAT",4,173,122,295
https://kawalpemilu.org#75435,"PASANGKAYU, PASANGKAYU, MAMUJU UTARA, SULAWESI BARAT",5,146,138,284
https://kawalpemilu.org#75435,"PASANGKAYU, PASANGKAYU, MAMUJU UTARA, SULAWESI BARAT",6,156,142,298
https://kawalpemilu.org#75435,"PASANGKAYU, PASANGKAYU, MAMUJU UTARA, SULAWESI BARAT",7,152,146,298
https://kawalpemilu.org#75435,"PASANGKAYU, PASANGKAYU, MAMUJU UTARA, SULAWESI BARAT",8,143,136,279
https://kawalpemilu.org#75435,"PASANGKAYU, PASANGKAYU, MAMUJU UTARA, SULAWESI BARAT",9,160,144,304
https://kawalpemilu.org#75435,"PASANGKAYU, PASANGKAYU, MAMUJU UTARA, SULAWESI BARAT",10,156,135,291
https://kawalpemilu.org#75435,"PASANGKAYU, PASANGKAYU, MAMUJU UTARA, SULAWESI BARAT",11,177,115,292
https://kawalpemilu.org#75435,"PASANGKAYU, PASANGKAYU, MAMUJU UTARA, SULAWESI BARAT",12,148,150,298
https://kawalpemilu.org#75435,"PASANGKAYU, PASANGKAYU, MAMUJU UTARA, SULAWESI BARAT",13,179,123,302
https://kawalpemilu.org#75435,"PASANGKAYU, PASANGKAYU, MAMUJU UTARA, SULAWESI BARAT",14,152,123,275
https://kawalpemilu.org#75435,"PASANGKAYU, PASANGKAYU, MAMUJU UTARA, SULAWESI BARAT",15,165,106,0
https://kawalpemilu.org#75435,"PASANGKAYU, PASANGKAYU, MAMUJU UTARA, SULAWESI BARAT",16,160,122,282
https://kawalpemilu.org#75435,"PASANGKAYU, PASANGKAYU, MAMUJU UTARA, SULAWESI BARAT",17,185,81,266
https://kawalpemilu.org#75435,"PASANGKAYU, PASANGKAYU, MAMUJU UTARA, SULAWESI BARAT",18,121,113,234
https://kawalpemilu.org#75435,"PASANGKAYU, PASANGKAYU, MAMUJU UTARA, SULAWESI BARAT",19,148,147,295
https://kawalpemilu.org#75435,"PASANGKAYU, PASANGKAYU, MAMUJU UTARA, SULAWESI BARAT",20,199,93,292
https://kawalpemilu.org#75435,"PASANGKAYU, PASANGKAYU, MAMUJU UTARA, SULAWESI BARAT",21,150,144,294
https://kawalpemilu.org#75435,"PASANGKAYU, PASANGKAYU, MAMUJU UTARA, SULAWESI BARAT",22,183,104,287
https://kawalpemilu.org#75435,"PASANGKAYU, PASANGKAYU, MAMUJU UTARA, SULAWESI BARAT",23,144,126,270
https://kawalpemilu.org#75435,"PASANGKAYU, PASANGKAYU, MAMUJU UTARA, SULAWESI BARAT",24,172,104,276
https://kawalpemilu.org#75435,"PASANGKAYU, PASANGKAYU, MAMUJU UTARA, SULAWESI BARAT",25,107,125,332
https://kawalpemilu.org#75435,"PASANGKAYU, PASANGKAYU, MAMUJU UTARA, SULAWESI BARAT",26,147,151,298
https://kawalpemilu.org#75435,"PASANGKAYU, PASANGKAYU, MAMUJU UTARA, SULAWESI BARAT",27,91,104,195
https://kawalpemilu.org#75436,"MARTAJAYA, PASANGKAYU, MAMUJU UTARA, SULAWESI BARAT",1,250,17,267
https://kawalpemilu.org#75436,"MARTAJAYA, PASANGKAYU, MAMUJU UTARA, SULAWESI BARAT",2,166,23,189
https://kawalpemilu.org#75436,"MARTAJAYA, PASANGKAYU, MAMUJU UTARA, SULAWESI BARAT",3,98,119,217
https://kawalpemilu.org#75436,"MARTAJAYA, PASANGKAYU, MAMUJU UTARA, SULAWESI BARAT",4,242,15,257
https://kawalpemilu.org#75436,"MARTAJAYA, PASANGKAYU, MAMUJU UTARA, SULAWESI BARAT",5,94,77,171
https://kawalpemilu.org#75437,"PAKAVA, PASANGKAYU, MAMUJU UTARA, SULAWESI BARAT",1,196,42,238
https://kawalpemilu.org#75437,"PAKAVA, PASANGKAYU, MAMUJU UTARA, SULAWESI BARAT",2,161,76,237
https://kawalpemilu.org#75437,"PAKAVA, PASANGKAYU, MAMUJU UTARA, SULAWESI BARAT",3,98,6,104
https://kawalpemilu.org#75437,"PAKAVA, PASANGKAYU, MAMUJU UTARA, SULAWESI BARAT",4,83,2,85
https://kawalpemilu.org#75437,"PAKAVA, PASANGKAYU, MAMUJU UTARA, SULAWESI BARAT",5,106,22,128
https://kawalpemilu.org#75437,"PAKAVA, PASANGKAYU, MAMUJU UTARA, SULAWESI BARAT",6,190,36,226
https://kawalpemilu.org#75437,"PAKAVA, PASANGKAYU, MAMUJU UTARA, SULAWESI BARAT",7,146,34,180
https://kawalpemilu.org#75438,"KARYA BERSAMA, PASANGKAYU, MAMUJU UTARA, SULAWESI BARAT",1,215,64,279
https://kawalpemilu.org#75438,"KARYA BERSAMA, PASANGKAYU, MAMUJU UTARA, SULAWESI BARAT",2,105,78,183
https://kawalpemilu.org#75438,"KARYA BERSAMA, PASANGKAYU, MAMUJU UTARA, SULAWESI BARAT",3,180,77,257
https://kawalpemilu.org#75438,"KARYA BERSAMA, PASANGKAYU, MAMUJU UTARA, SULAWESI BARAT",4,113,39,152
https://kawalpemilu.org#75438,"KARYA BERSAMA, PASANGKAYU, MAMUJU UTARA, SULAWESI BARAT",5,108,63,171
https://kawalpemilu.org#75438,"KARYA BERSAMA, PASANGKAYU, MAMUJU UTARA, SULAWESI BARAT",6,76,54,130
https://kawalpemilu.org#75439,"AKO, PASANGKAYU, MAMUJU UTARA, SULAWESI BARAT",1,85,154,239
https://kawalpemilu.org#75439,"AKO, PASANGKAYU, MAMUJU UTARA, SULAWESI BARAT",2,191,88,279
https://kawalpemilu.org#75439,"AKO, PASANGKAYU, MAMUJU UTARA, SULAWESI BARAT",3,201,87,288
https://kawalpemilu.org#75439,"AKO, PASANGKAYU, MAMUJU UTARA, SULAWESI BARAT",4,146,132,278
https://kawalpemilu.org#75439,"AKO, PASANGKAYU, MAMUJU UTARA, SULAWESI BARAT",5,148,69,217
https://kawalpemilu.org#75439,"AKO, PASANGKAYU, MAMUJU UTARA, SULAWESI BARAT",6,103,84,187
https://kawalpemilu.org#75439,"AKO, PASANGKAYU, MAMUJU UTARA, SULAWESI BARAT",7,154,78,232
https://kawalpemilu.org#75439,"AKO, PASANGKAYU, MAMUJU UTARA, SULAWESI BARAT",8,95,24,119
https://kawalpemilu.org#75440,"GUNUNG SARI, PASANGKAYU, MAMUJU UTARA, SULAWESI BARAT",1,236,16,252
https://kawalpemilu.org#75440,"GUNUNG SARI, PASANGKAYU, MAMUJU UTARA, SULAWESI BARAT",2,236,19,255
https://kawalpemilu.org#75440,"GUNUNG SARI, PASANGKAYU, MAMUJU UTARA, SULAWESI BARAT",3,110,110,220
https://kawalpemilu.org#75440,"GUNUNG SARI, PASANGKAYU, MAMUJU UTARA, SULAWESI BARAT",4,141,43,184
https://kawalpemilu.org#75440,"GUNUNG SARI, PASANGKAYU, MAMUJU UTARA, SULAWESI BARAT",5,142,14,156
https://kawalpemilu.org#75440,"GUNUNG SARI, PASANGKAYU, MAMUJU UTARA, SULAWESI BARAT",6,170,69,239
https://kawalpemilu.org#75440,"GUNUNG SARI, PASANGKAYU, MAMUJU UTARA, SULAWESI BARAT",7,129,95,224
https://kawalpemilu.org#75440,"GUNUNG SARI, PASANGKAYU, MAMUJU UTARA, SULAWESI BARAT",8,168,4,172
https://kawalpemilu.org#75440,"GUNUNG SARI, PASANGKAYU, MAMUJU UTARA, SULAWESI BARAT",9,99,77,176
https://kawalpemilu.org#75442,"BARAS, BARAS, MAMUJU UTARA, SULAWESI BARAT",1,108,74,182
https://kawalpemilu.org#75442,"BARAS, BARAS, MAMUJU UTARA, SULAWESI BARAT",2,111,122,233
https://kawalpemilu.org#75442,"BARAS, BARAS, MAMUJU UTARA, SULAWESI BARAT",3,112,69,181
https://kawalpemilu.org#75442,"BARAS, BARAS, MAMUJU UTARA, SULAWESI BARAT",4,96,81,177
https://kawalpemilu.org#75442,"BARAS, BARAS, MAMUJU UTARA, SULAWESI BARAT",5,169,115,284
https://kawalpemilu.org#75442,"BARAS, BARAS, MAMUJU UTARA, SULAWESI BARAT",6,177,87,264
https://kawalpemilu.org#75442,"BARAS, BARAS, MAMUJU UTARA, SULAWESI BARAT",7,193,121,314
https://kawalpemilu.org#75443,"BALANTI, BARAS, MAMUJU UTARA, SULAWESI BARAT",1,162,1,163
https://kawalpemilu.org#75443,"BALANTI, BARAS, MAMUJU UTARA, SULAWESI BARAT",2,154,9,163
https://kawalpemilu.org#75443,"BALANTI, BARAS, MAMUJU UTARA, SULAWESI BARAT",3,121,74,195
https://kawalpemilu.org#75443,"BALANTI, BARAS, MAMUJU UTARA, SULAWESI BARAT",4,162,54,216
https://kawalpemilu.org#75443,"BALANTI, BARAS, MAMUJU UTARA, SULAWESI BARAT",5,132,76,208
https://kawalpemilu.org#75443,"BALANTI, BARAS, MAMUJU UTARA, SULAWESI BARAT",6,87,92,179
https://kawalpemilu.org#75443,"BALANTI, BARAS, MAMUJU UTARA, SULAWESI BARAT",7,102,59,161
https://kawalpemilu.org#75443,"BALANTI, BARAS, MAMUJU UTARA, SULAWESI BARAT",8,99,14,113
https://kawalpemilu.org#75444,"MOTU, BARAS, MAMUJU UTARA, SULAWESI BARAT",1,200,70,270
https://kawalpemilu.org#75444,"MOTU, BARAS, MAMUJU UTARA, SULAWESI BARAT",2,224,39,263
https://kawalpemilu.org#75444,"MOTU, BARAS, MAMUJU UTARA, SULAWESI BARAT",3,106,116,222
https://kawalpemilu.org#75444,"MOTU, BARAS, MAMUJU UTARA, SULAWESI BARAT",4,156,96,252
https://kawalpemilu.org#75444,"MOTU, BARAS, MAMUJU UTARA, SULAWESI BARAT",5,149,139,288
https://kawalpemilu.org#75444,"MOTU, BARAS, MAMUJU UTARA, SULAWESI BARAT",6,171,128,299
https://kawalpemilu.org#75444,"MOTU, BARAS, MAMUJU UTARA, SULAWESI BARAT",7,149,114,263
https://kawalpemilu.org#75444,"MOTU, BARAS, MAMUJU UTARA, SULAWESI BARAT",8,101,133,234
https://kawalpemilu.org#75444,"MOTU, BARAS, MAMUJU UTARA, SULAWESI BARAT",9,141,27,168
https://kawalpemilu.org#75444,"MOTU, BARAS, MAMUJU UTARA, SULAWESI BARAT",10,136,67,203
https://kawalpemilu.org#75444,"MOTU, BARAS, MAMUJU UTARA, SULAWESI BARAT",11,154,88,242
https://kawalpemilu.org#75444,"MOTU, BARAS, MAMUJU UTARA, SULAWESI BARAT",12,159,84,238
https://kawalpemilu.org#75445,"BULU PARIGI, BARAS, MAMUJU UTARA, SULAWESI BARAT",1,154,115,269
https://kawalpemilu.org#75445,"BULU PARIGI, BARAS, MAMUJU UTARA, SULAWESI BARAT",2,215,72,287
https://kawalpemilu.org#75445,"BULU PARIGI, BARAS, MAMUJU UTARA, SULAWESI BARAT",3,164,14,178
https://kawalpemilu.org#75445,"BULU PARIGI, BARAS, MAMUJU UTARA, SULAWESI BARAT",4,24,29,53
https://kawalpemilu.org#75445,"BULU PARIGI, BARAS, MAMUJU UTARA, SULAWESI BARAT",5,160,73,233
https://kawalpemilu.org#75446,"TOWONI, BARAS, MAMUJU UTARA, SULAWESI BARAT",1,123,138,261
https://kawalpemilu.org#75446,"TOWONI, BARAS, MAMUJU UTARA, SULAWESI BARAT",2,166,30,196
https://kawalpemilu.org#75446,"TOWONI, BARAS, MAMUJU UTARA, SULAWESI BARAT",3,67,34,101
https://kawalpemilu.org#75447,"KASANO, BARAS, MAMUJU UTARA, SULAWESI BARAT",1,121,114,235
https://kawalpemilu.org#75447,"KASANO, BARAS, MAMUJU UTARA, SULAWESI BARAT",2,118,82,200
https://kawalpemilu.org#75447,"KASANO, BARAS, MAMUJU UTARA, SULAWESI BARAT",3,132,117,249
https://kawalpemilu.org#75447,"KASANO, BARAS, MAMUJU UTARA, SULAWESI BARAT",4,170,90,260
https://kawalpemilu.org#75447,"KASANO, BARAS, MAMUJU UTARA, SULAWESI BARAT",5,188,99,287
https://kawalpemilu.org#75447,"KASANO, BARAS, MAMUJU UTARA, SULAWESI BARAT",6,161,51,212
https://kawalpemilu.org#75447,"KASANO, BARAS, MAMUJU UTARA, SULAWESI BARAT",7,136,69,205
https://kawalpemilu.org#75447,"KASANO, BARAS, MAMUJU UTARA, SULAWESI BARAT",8,180,28,208
https://kawalpemilu.org#75447,"KASANO, BARAS, MAMUJU UTARA, SULAWESI BARAT",9,147,58,205
https://kawalpemilu.org#75447,"KASANO, BARAS, MAMUJU UTARA, SULAWESI BARAT",10,113,54,167
https://kawalpemilu.org#75449,"SARUDU, SARUDU, MAMUJU UTARA, SULAWESI BARAT",1,166,52,218
https://kawalpemilu.org#75449,"SARUDU, SARUDU, MAMUJU UTARA, SULAWESI BARAT",2,128,65,193
https://kawalpemilu.org#75449,"SARUDU, SARUDU, MAMUJU UTARA, SULAWESI BARAT",3,163,73,236
https://kawalpemilu.org#75449,"SARUDU, SARUDU, MAMUJU UTARA, SULAWESI BARAT",4,119,15,178
https://kawalpemilu.org#75449,"SARUDU, SARUDU, MAMUJU UTARA, SULAWESI BARAT",5,188,75,263
https://kawalpemilu.org#75449,"SARUDU, SARUDU, MAMUJU UTARA, SULAWESI BARAT",6,176,94,270
https://kawalpemilu.org#75449,"SARUDU, SARUDU, MAMUJU UTARA, SULAWESI BARAT",8,183,65,248
https://kawalpemilu.org#75449,"SARUDU, SARUDU, MAMUJU UTARA, SULAWESI BARAT",9,198,43,241
https://kawalpemilu.org#75449,"SARUDU, SARUDU, MAMUJU UTARA, SULAWESI BARAT",10,231,21,252
https://kawalpemilu.org#75449,"SARUDU, SARUDU, MAMUJU UTARA, SULAWESI BARAT",11,175,46,221
https://kawalpemilu.org#75449,"SARUDU, SARUDU, MAMUJU UTARA, SULAWESI BARAT",12,141,37,178
https://kawalpemilu.org#75449,"SARUDU, SARUDU, MAMUJU UTARA, SULAWESI BARAT",13,90,23,113
https://kawalpemilu.org#75450,"BULU MARIO, SARUDU, MAMUJU UTARA, SULAWESI BARAT",1,143,55,198
https://kawalpemilu.org#75450,"BULU MARIO, SARUDU, MAMUJU UTARA, SULAWESI BARAT",2,169,88,258
https://kawalpemilu.org#75450,"BULU MARIO, SARUDU, MAMUJU UTARA, SULAWESI BARAT",3,180,78,258
https://kawalpemilu.org#75450,"BULU MARIO, SARUDU, MAMUJU UTARA, SULAWESI BARAT",4,163,99,262
https://kawalpemilu.org#75450,"BULU MARIO, SARUDU, MAMUJU UTARA, SULAWESI BARAT",5,146,104,250
https://kawalpemilu.org#75450,"BULU MARIO, SARUDU, MAMUJU UTARA, SULAWESI BARAT",6,172,47,219
https://kawalpemilu.org#75450,"BULU MARIO, SARUDU, MAMUJU UTARA, SULAWESI BARAT",7,124,66,190
https://kawalpemilu.org#75450,"BULU MARIO, SARUDU, MAMUJU UTARA, SULAWESI BARAT",8,131,125,256
https://kawalpemilu.org#75451,"KUMASARI, SARUDU, MAMUJU UTARA, SULAWESI BARAT",1,193,38,231
https://kawalpemilu.org#75451,"KUMASARI, SARUDU, MAMUJU UTARA, SULAWESI BARAT",2,177,22,199
https://kawalpemilu.org#75451,"KUMASARI, SARUDU, MAMUJU UTARA, SULAWESI BARAT",4,167,62,229
https://kawalpemilu.org#75451,"KUMASARI, SARUDU, MAMUJU UTARA, SULAWESI BARAT",5,194,37,231
https://kawalpemilu.org#75452,"PATIKA, SARUDU, MAMUJU UTARA, SULAWESI BARAT",1,63,140,203
https://kawalpemilu.org#75452,"PATIKA, SARUDU, MAMUJU UTARA, SULAWESI BARAT",2,31,145,176
https://kawalpemilu.org#75453,"DODA, SARUDU, MAMUJU UTARA, SULAWESI BARAT",1,193,71,264
https://kawalpemilu.org#75453,"DODA, SARUDU, MAMUJU UTARA, SULAWESI BARAT",2,214,54,268
https://kawalpemilu.org#75453,"DODA, SARUDU, MAMUJU UTARA, SULAWESI BARAT",3,144,32,176
https://kawalpemilu.org#75453,"DODA, SARUDU, MAMUJU UTARA, SULAWESI BARAT",4,187,79,266
https://kawalpemilu.org#75453,"DODA, SARUDU, MAMUJU UTARA, SULAWESI BARAT",5,158,100,258
https://kawalpemilu.org#75453,"DODA, SARUDU, MAMUJU UTARA, SULAWESI BARAT",6,110,62,172
https://kawalpemilu.org#75455,"DAPURANG, DAPURANG, MAMUJU UTARA, SULAWESI BARAT",1,101,30,131
https://kawalpemilu.org#75455,"DAPURANG, DAPURANG, MAMUJU UTARA, SULAWESI BARAT",2,118,99,217
https://kawalpemilu.org#75455,"DAPURANG, DAPURANG, MAMUJU UTARA, SULAWESI BARAT",3,191,67,258
https://kawalpemilu.org#75455,"DAPURANG, DAPURANG, MAMUJU UTARA, SULAWESI BARAT",4,187,84,271
https://kawalpemilu.org#75455,"DAPURANG, DAPURANG, MAMUJU UTARA, SULAWESI BARAT",5,217,29,246
https://kawalpemilu.org#75455,"DAPURANG, DAPURANG, MAMUJU UTARA, SULAWESI BARAT",6,140,42,182
https://kawalpemilu.org#75455,"DAPURANG, DAPURANG, MAMUJU UTARA, SULAWESI BARAT",7,166,55,221
https://kawalpemilu.org#75455,"DAPURANG, DAPURANG, MAMUJU UTARA, SULAWESI BARAT",8,83,71,154
https://kawalpemilu.org#75455,"DAPURANG, DAPURANG, MAMUJU UTARA, SULAWESI BARAT",9,173,78,251
https://kawalpemilu.org#75455,"DAPURANG, DAPURANG, MAMUJU UTARA, SULAWESI BARAT",10,182,49,231
https://kawalpemilu.org#75455,"DAPURANG, DAPURANG, MAMUJU UTARA, SULAWESI BARAT",11,146,37,183
https://kawalpemilu.org#75456,"BENGGAULU, DAPURANG, MAMUJU UTARA, SULAWESI BARAT",1,137,78,215
https://kawalpemilu.org#75456,"BENGGAULU, DAPURANG, MAMUJU UTARA, SULAWESI BARAT",2,152,84,236
https://kawalpemilu.org#75456,"BENGGAULU, DAPURANG, MAMUJU UTARA, SULAWESI BARAT",3,144,63,207
https://kawalpemilu.org#75456,"BENGGAULU, DAPURANG, MAMUJU UTARA, SULAWESI BARAT",4,177,45,222
https://kawalpemilu.org#75456,"BENGGAULU, DAPURANG, MAMUJU UTARA, SULAWESI BARAT",5,89,98,192
https://kawalpemilu.org#75456,"BENGGAULU, DAPURANG, MAMUJU UTARA, SULAWESI BARAT",6,93,18,111
https://kawalpemilu.org#75456,"BENGGAULU, DAPURANG, MAMUJU UTARA, SULAWESI BARAT",7,188,13,201
https://kawalpemilu.org#75456,"BENGGAULU, DAPURANG, MAMUJU UTARA, SULAWESI BARAT",8,54,29,83
https://kawalpemilu.org#75456,"BENGGAULU, DAPURANG, MAMUJU UTARA, SULAWESI BARAT",9,77,80,157
https://kawalpemilu.org#75456,"BENGGAULU, DAPURANG, MAMUJU UTARA, SULAWESI BARAT",10,128,44,172
https://kawalpemilu.org#75456,"BENGGAULU, DAPURANG, MAMUJU UTARA, SULAWESI BARAT",11,21,56,77
https://kawalpemilu.org#75457,"TIRTABUANA, DAPURANG, MAMUJU UTARA, SULAWESI BARAT",1,119,50,169
https://kawalpemilu.org#75457,"TIRTABUANA, DAPURANG, MAMUJU UTARA, SULAWESI BARAT",2,112,19,131
https://kawalpemilu.org#75457,"TIRTABUANA, DAPURANG, MAMUJU UTARA, SULAWESI BARAT",3,136,25,161
https://kawalpemilu.org#75458,"BULU BONGGU, DAPURANG, MAMUJU UTARA, SULAWESI BARAT",1,89,67,156
https://kawalpemilu.org#75458,"BULU BONGGU, DAPURANG, MAMUJU UTARA, SULAWESI BARAT",2,163,73,236
https://kawalpemilu.org#75458,"BULU BONGGU, DAPURANG, MAMUJU UTARA, SULAWESI BARAT",3,181,56,0
https://kawalpemilu.org#75458,"BULU BONGGU, DAPURANG, MAMUJU UTARA, SULAWESI BARAT",4,175,50,225
https://kawalpemilu.org#75458,"BULU BONGGU, DAPURANG, MAMUJU UTARA, SULAWESI BARAT",5,73,17,90
https://kawalpemilu.org#75458,"BULU BONGGU, DAPURANG, MAMUJU UTARA, SULAWESI BARAT",6,132,21,153
https://kawalpemilu.org#75458,"BULU BONGGU, DAPURANG, MAMUJU UTARA, SULAWESI BARAT",7,115,47,162
https://kawalpemilu.org#75459,"SARASA, DAPURANG, MAMUJU UTARA, SULAWESI BARAT",1,88,32,120
https://kawalpemilu.org#75459,"SARASA, DAPURANG, MAMUJU UTARA, SULAWESI BARAT",2,207,50,260
https://kawalpemilu.org#75459,"SARASA, DAPURANG, MAMUJU UTARA, SULAWESI BARAT",3,215,57,272
https://kawalpemilu.org#75459,"SARASA, DAPURANG, MAMUJU UTARA, SULAWESI BARAT",4,162,29,191
https://kawalpemilu.org#75459,"SARASA, DAPURANG, MAMUJU UTARA, SULAWESI BARAT",5,66,99,165
https://kawalpemilu.org#75459,"SARASA, DAPURANG, MAMUJU UTARA, SULAWESI BARAT",6,107,76,183
https://kawalpemilu.org#75461,"TAMMARUNANG, DURIPOKU, MAMUJU UTARA, SULAWESI BARAT",1,178,81,259
https://kawalpemilu.org#75461,"TAMMARUNANG, DURIPOKU, MAMUJU UTARA, SULAWESI BARAT",2,174,77,251
https://kawalpemilu.org#75461,"TAMMARUNANG, DURIPOKU, MAMUJU UTARA, SULAWESI BARAT",3,91,147,238
https://kawalpemilu.org#75461,"TAMMARUNANG, DURIPOKU, MAMUJU UTARA, SULAWESI BARAT",4,117,142,259
https://kawalpemilu.org#75461,"TAMMARUNANG, DURIPOKU, MAMUJU UTARA, SULAWESI BARAT",5,84,127,211
https://kawalpemilu.org#75462,"SAPTANAJAYA, DURIPOKU, MAMUJU UTARA, SULAWESI BARAT",2,83,96,179
https://kawalpemilu.org#75462,"SAPTANAJAYA, DURIPOKU, MAMUJU UTARA, SULAWESI BARAT",3,108,98,206
https://kawalpemilu.org#75462,"SAPTANAJAYA, DURIPOKU, MAMUJU UTARA, SULAWESI BARAT",4,141,63,204
https://kawalpemilu.org#75463,"TARANGGI, DURIPOKU, MAMUJU UTARA, SULAWESI BARAT",1,47,95,142
https://kawalpemilu.org#75463,"TARANGGI, DURIPOKU, MAMUJU UTARA, SULAWESI BARAT",2,25,148,173
https://kawalpemilu.org#75463,"TARANGGI, DURIPOKU, MAMUJU UTARA, SULAWESI BARAT",3,88,152,240
https://kawalpemilu.org#75464,"SIPAKAINGA, DURIPOKU, MAMUJU UTARA, SULAWESI BARAT",1,123,59,182
https://kawalpemilu.org#75464,"SIPAKAINGA, DURIPOKU, MAMUJU UTARA, SULAWESI BARAT",2,85,105,190
https://kawalpemilu.org#75466,"LILIMORI, BULU TABA, MAMUJU UTARA, SULAWESI BARAT",1,171,73,244
https://kawalpemilu.org#75466,"LILIMORI, BULU TABA, MAMUJU UTARA, SULAWESI BARAT",2,88,128,216
https://kawalpemilu.org#75466,"LILIMORI, BULU TABA, MAMUJU UTARA, SULAWESI BARAT",3,152,95,247
https://kawalpemilu.org#75466,"LILIMORI, BULU TABA, MAMUJU UTARA, SULAWESI BARAT",4,180,61,241
https://kawalpemilu.org#75466,"LILIMORI, BULU TABA, MAMUJU UTARA, SULAWESI BARAT",5,186,37,223
https://kawalpemilu.org#75466,"LILIMORI, BULU TABA, MAMUJU UTARA, SULAWESI BARAT",6,89,52,141
https://kawalpemilu.org#75466,"LILIMORI, BULU TABA, MAMUJU UTARA, SULAWESI BARAT",7,182,27,209
https://kawalpemilu.org#75467,"KARAVE, BULU TABA, MAMUJU UTARA, SULAWESI BARAT",1,161,40,201
https://kawalpemilu.org#75467,"KARAVE, BULU TABA, MAMUJU UTARA, SULAWESI BARAT",2,184,40,224
https://kawalpemilu.org#75467,"KARAVE, BULU TABA, MAMUJU UTARA, SULAWESI BARAT",3,206,21,227
https://kawalpemilu.org#75467,"KARAVE, BULU TABA, MAMUJU UTARA, SULAWESI BARAT",4,164,37,201
https://kawalpemilu.org#75467,"KARAVE, BULU TABA, MAMUJU UTARA, SULAWESI BARAT",5,162,21,183
https://kawalpemilu.org#75467,"KARAVE, BULU TABA, MAMUJU UTARA, SULAWESI BARAT",6,138,19,157
https://kawalpemilu.org#75467,"KARAVE, BULU TABA, MAMUJU UTARA, SULAWESI BARAT",7,136,14,150
https://kawalpemilu.org#75468,"BUKIT HARAPAN, BULU TABA, MAMUJU UTARA, SULAWESI BARAT",1,121,58,179
https://kawalpemilu.org#75468,"BUKIT HARAPAN, BULU TABA, MAMUJU UTARA, SULAWESI BARAT",2,169,82,251
https://kawalpemilu.org#75468,"BUKIT HARAPAN, BULU TABA, MAMUJU UTARA, SULAWESI BARAT",3,72,21,93
https://kawalpemilu.org#75468,"BUKIT HARAPAN, BULU TABA, MAMUJU UTARA, SULAWESI BARAT",4,141,13,154
https://kawalpemilu.org#75469,"KASTABUANA, BULU TABA, MAMUJU UTARA, SULAWESI BARAT",1,154,11,165
https://kawalpemilu.org#75469,"KASTABUANA, BULU TABA, MAMUJU UTARA, SULAWESI BARAT",2,122,37,159
https://kawalpemilu.org#75469,"KASTABUANA, BULU TABA, MAMUJU UTARA, SULAWESI BARAT",3,119,49,168
https://kawalpemilu.org#75469,"KASTABUANA, BULU TABA, MAMUJU UTARA, SULAWESI BARAT",4,138,42,180
https://kawalpemilu.org#75469,"KASTABUANA, BULU TABA, MAMUJU UTARA, SULAWESI BARAT",5,115,37,152
https://kawalpemilu.org#75470,"SUMBER SARI, BULU TABA, MAMUJU UTARA, SULAWESI BARAT",1,119,39,158
https://kawalpemilu.org#75471,"LELEJAE, BULU TABA, MAMUJU UTARA, SULAWESI BARAT",1,208,3,211
https://kawalpemilu.org#75471,"LELEJAE, BULU TABA, MAMUJU UTARA, SULAWESI BARAT",2,179,15,194
https://kawalpemilu.org#75471,"LELEJAE, BULU TABA, MAMUJU UTARA, SULAWESI BARAT",3,128,66,194
https://kawalpemilu.org#75471,"LELEJAE, BULU TABA, MAMUJU UTARA, SULAWESI BARAT",4,109,96,205
https://kawalpemilu.org#75472,"OMPI, BULU TABA, MAMUJU UTARA, SULAWESI BARAT",1,152,22,174
https://kawalpemilu.org#75472,"OMPI, BULU TABA, MAMUJU UTARA, SULAWESI BARAT",2,128,20,148
https://kawalpemilu.org#75474,"TIKKE, TIKKE RAYA, MAMUJU UTARA, SULAWESI BARAT",1,144,20,164
https://kawalpemilu.org#75474,"TIKKE, TIKKE RAYA, MAMUJU UTARA, SULAWESI BARAT",2,161,33,194
https://kawalpemilu.org#75474,"TIKKE, TIKKE RAYA, MAMUJU UTARA, SULAWESI BARAT",3,131,67,198
https://kawalpemilu.org#75474,"TIKKE, TIKKE RAYA, MAMUJU UTARA, SULAWESI BARAT",4,110,76,186
https://kawalpemilu.org#75474,"TIKKE, TIKKE RAYA, MAMUJU UTARA, SULAWESI BARAT",5,150,52,202
https://kawalpemilu.org#75474,"TIKKE, TIKKE RAYA, MAMUJU UTARA, SULAWESI BARAT",6,117,76,193
https://kawalpemilu.org#75474,"TIKKE, TIKKE RAYA, MAMUJU UTARA, SULAWESI BARAT",7,132,117,249
https://kawalpemilu.org#75474,"TIKKE, TIKKE RAYA, MAMUJU UTARA, SULAWESI BARAT",8,116,80,196
https://kawalpemilu.org#75475,"MAKMUR JAYA, TIKKE RAYA, MAMUJU UTARA, SULAWESI BARAT",1,130,106,236
https://kawalpemilu.org#75475,"MAKMUR JAYA, TIKKE RAYA, MAMUJU UTARA, SULAWESI BARAT",2,141,114,255
https://kawalpemilu.org#75475,"MAKMUR JAYA, TIKKE RAYA, MAMUJU UTARA, SULAWESI BARAT",3,109,100,209
https://kawalpemilu.org#75475,"MAKMUR JAYA, TIKKE RAYA, MAMUJU UTARA, SULAWESI BARAT",4,81,51,132
https://kawalpemilu.org#75475,"MAKMUR JAYA, TIKKE RAYA, MAMUJU UTARA, SULAWESI BARAT",5,135,124,259
https://kawalpemilu.org#75475,"MAKMUR JAYA, TIKKE RAYA, MAMUJU UTARA, SULAWESI BARAT",6,99,172,271
https://kawalpemilu.org#75475,"MAKMUR JAYA, TIKKE RAYA, MAMUJU UTARA, SULAWESI BARAT",7,124,107,231
https://kawalpemilu.org#75475,"MAKMUR JAYA, TIKKE RAYA, MAMUJU UTARA, SULAWESI BARAT",8,137,66,203
https://kawalpemilu.org#75475,"MAKMUR JAYA, TIKKE RAYA, MAMUJU UTARA, SULAWESI BARAT",9,198,67,265
https://kawalpemilu.org#75476,"LARIANG, TIKKE RAYA, MAMUJU UTARA, SULAWESI BARAT",1,180,64,244
https://kawalpemilu.org#75476,"LARIANG, TIKKE RAYA, MAMUJU UTARA, SULAWESI BARAT",2,158,91,249
https://kawalpemilu.org#75476,"LARIANG, TIKKE RAYA, MAMUJU UTARA, SULAWESI BARAT",3,189,32,221
https://kawalpemilu.org#75476,"LARIANG, TIKKE RAYA, MAMUJU UTARA, SULAWESI BARAT",4,136,45,181
https://kawalpemilu.org#75476,"LARIANG, TIKKE RAYA, MAMUJU UTARA, SULAWESI BARAT",5,112,73,185
https://kawalpemilu.org#75476,"LARIANG, TIKKE RAYA, MAMUJU UTARA, SULAWESI BARAT",6,178,67,245
https://kawalpemilu.org#75476,"LARIANG, TIKKE RAYA, MAMUJU UTARA, SULAWESI BARAT",7,137,50,187
https://kawalpemilu.org#75476,"LARIANG, TIKKE RAYA, MAMUJU UTARA, SULAWESI BARAT",8,149,103,252
https://kawalpemilu.org#75476,"LARIANG, TIKKE RAYA, MAMUJU UTARA, SULAWESI BARAT",9,101,133,236
https://kawalpemilu.org#75476,"LARIANG, TIKKE RAYA, MAMUJU UTARA, SULAWESI BARAT",10,110,52,162
https://kawalpemilu.org#75477,"PAJALELE, TIKKE RAYA, MAMUJU UTARA, SULAWESI BARAT",1,162,73,235
https://kawalpemilu.org#75477,"PAJALELE, TIKKE RAYA, MAMUJU UTARA, SULAWESI BARAT",2,147,114,261
https://kawalpemilu.org#75477,"PAJALELE, TIKKE RAYA, MAMUJU UTARA, SULAWESI BARAT",3,165,94,259
https://kawalpemilu.org#75477,"PAJALELE, TIKKE RAYA, MAMUJU UTARA, SULAWESI BARAT",4,133,68,201
https://kawalpemilu.org#75477,"PAJALELE, TIKKE RAYA, MAMUJU UTARA, SULAWESI BARAT",5,99,40,139
https://kawalpemilu.org#75477,"PAJALELE, TIKKE RAYA, MAMUJU UTARA, SULAWESI BARAT",6,135,95,230
https://kawalpemilu.org#75478,"JENGENG RAYA, TIKKE RAYA, MAMUJU UTARA, SULAWESI BARAT",1,118,87,205
https://kawalpemilu.org#75478,"JENGENG RAYA, TIKKE RAYA, MAMUJU UTARA, SULAWESI BARAT",2,148,86,234
https://kawalpemilu.org#75478,"JENGENG RAYA, TIKKE RAYA, MAMUJU UTARA, SULAWESI BARAT",3,162,87,249
https://kawalpemilu.org#75478,"JENGENG RAYA, TIKKE RAYA, MAMUJU UTARA, SULAWESI BARAT",4,217,41,258
https://kawalpemilu.org#75478,"JENGENG RAYA, TIKKE RAYA, MAMUJU UTARA, SULAWESI BARAT",5,86,57,143
https://kawalpemilu.org#75480,"MALEI, PEDONGGA, MAMUJU UTARA, SULAWESI BARAT",1,132,106,238
https://kawalpemilu.org#75480,"MALEI, PEDONGGA, MAMUJU UTARA, SULAWESI BARAT",2,170,76,246
https://kawalpemilu.org#75480,"MALEI, PEDONGGA, MAMUJU UTARA, SULAWESI BARAT",3,146,83,229
https://kawalpemilu.org#75480,"MALEI, PEDONGGA, MAMUJU UTARA, SULAWESI BARAT",4,144,72,216
https://kawalpemilu.org#75481,"PEDANDA, PEDONGGA, MAMUJU UTARA, SULAWESI BARAT",1,156,91,247
https://kawalpemilu.org#75481,"PEDANDA, PEDONGGA, MAMUJU UTARA, SULAWESI BARAT",2,174,51,225
https://kawalpemilu.org#75481,"PEDANDA, PEDONGGA, MAMUJU UTARA, SULAWESI BARAT",3,179,80,259
https://kawalpemilu.org#75482,"BATU OGE, PEDONGGA, MAMUJU UTARA, SULAWESI BARAT",1,128,75,203
https://kawalpemilu.org#75482,"BATU OGE, PEDONGGA, MAMUJU UTARA, SULAWESI BARAT",2,168,84,252
https://kawalpemilu.org#75482,"BATU OGE, PEDONGGA, MAMUJU UTARA, SULAWESI BARAT",3,154,36,190
https://kawalpemilu.org#75483,"MARTASARI, PEDONGGA, MAMUJU UTARA, SULAWESI BARAT",1,201,34,235
https://kawalpemilu.org#75483,"MARTASARI, PEDONGGA, MAMUJU UTARA, SULAWESI BARAT",2,223,39,262
https://kawalpemilu.org#75483,"MARTASARI, PEDONGGA, MAMUJU UTARA, SULAWESI BARAT",3,235,12,247
https://kawalpemilu.org#75483,"MARTASARI, PEDONGGA, MAMUJU UTARA, SULAWESI BARAT",4,169,60,229
https://kawalpemilu.org#75483,"MARTASARI, PEDONGGA, MAMUJU UTARA, SULAWESI BARAT",5,173,100,272
https://kawalpemilu.org#75483,"MARTASARI, PEDONGGA, MAMUJU UTARA, SULAWESI BARAT",6,179,71,250
https://kawalpemilu.org#75483,"MARTASARI, PEDONGGA, MAMUJU UTARA, SULAWESI BARAT",7,178,154,332
https://kawalpemilu.org#75485,"BAMBAIRA, BAMBAIRA, MAMUJU UTARA, SULAWESI BARAT",1,105,150,255
https://kawalpemilu.org#75485,"BAMBAIRA, BAMBAIRA, MAMUJU UTARA, SULAWESI BARAT",2,132,95,227
https://kawalpemilu.org#75485,"BAMBAIRA, BAMBAIRA, MAMUJU UTARA, SULAWESI BARAT",3,130,79,209
https://kawalpemilu.org#75485,"BAMBAIRA, BAMBAIRA, MAMUJU UTARA, SULAWESI BARAT",4,80,16,96
https://kawalpemilu.org#75485,"BAMBAIRA, BAMBAIRA, MAMUJU UTARA, SULAWESI BARAT",5,141,92,233
https://kawalpemilu.org#75485,"BAMBAIRA, BAMBAIRA, MAMUJU UTARA, SULAWESI BARAT",6,160,123,283
https://kawalpemilu.org#75485,"BAMBAIRA, BAMBAIRA, MAMUJU UTARA, SULAWESI BARAT",7,150,94,244
https://kawalpemilu.org#75486,"KASOLOANG, BAMBAIRA, MAMUJU UTARA, SULAWESI BARAT",1,151,93,244
https://kawalpemilu.org#75486,"KASOLOANG, BAMBAIRA, MAMUJU UTARA, SULAWESI BARAT",2,179,78,257
https://kawalpemilu.org#75486,"KASOLOANG, BAMBAIRA, MAMUJU UTARA, SULAWESI BARAT",3,135,91,226
https://kawalpemilu.org#75486,"KASOLOANG, BAMBAIRA, MAMUJU UTARA, SULAWESI BARAT",4,154,127,281
https://kawalpemilu.org#75486,"KASOLOANG, BAMBAIRA, MAMUJU UTARA, SULAWESI BARAT",5,78,79,157
https://kawalpemilu.org#75487,"TAMPAURE, BAMBAIRA, MAMUJU UTARA, SULAWESI BARAT",1,95,47,142
https://kawalpemilu.org#75487,"TAMPAURE, BAMBAIRA, MAMUJU UTARA, SULAWESI BARAT",2,106,103,209
https://kawalpemilu.org#75487,"TAMPAURE, BAMBAIRA, MAMUJU UTARA, SULAWESI BARAT",3,101,114,215
https://kawalpemilu.org#75487,"TAMPAURE, BAMBAIRA, MAMUJU UTARA, SULAWESI BARAT",4,124,16,140
https://kawalpemilu.org#75487,"TAMPAURE, BAMBAIRA, MAMUJU UTARA, SULAWESI BARAT",5,127,84,211
https://kawalpemilu.org#75487,"TAMPAURE, BAMBAIRA, MAMUJU UTARA, SULAWESI BARAT",6,104,17,121
https://kawalpemilu.org#75487,"TAMPAURE, BAMBAIRA, MAMUJU UTARA, SULAWESI BARAT",7,119,9,128
https://kawalpemilu.org#75488,"KALUKU NANGKA, BAMBAIRA, MAMUJU UTARA, SULAWESI BARAT",1,119,127,246
https://kawalpemilu.org#75488,"KALUKU NANGKA, BAMBAIRA, MAMUJU UTARA, SULAWESI BARAT",2,91,120,211
https://kawalpemilu.org#75488,"KALUKU NANGKA, BAMBAIRA, MAMUJU UTARA, SULAWESI BARAT",3,145,83,288
https://kawalpemilu.org#75488,"KALUKU NANGKA, BAMBAIRA, MAMUJU UTARA, SULAWESI BARAT",4,186,61,247
https://kawalpemilu.org#75488,"KALUKU NANGKA, BAMBAIRA, MAMUJU UTARA, SULAWESI BARAT",5,122,120,242
https://kawalpemilu.org#75488,"KALUKU NANGKA, BAMBAIRA, MAMUJU UTARA, SULAWESI BARAT",6,145,63,208
https://kawalpemilu.org#75490,"SARJO, SARJO, MAMUJU UTARA, SULAWESI BARAT",1,176,63,239
https://kawalpemilu.org#75490,"SARJO, SARJO, MAMUJU UTARA, SULAWESI BARAT",2,172,56,228
https://kawalpemilu.org#75490,"SARJO, SARJO, MAMUJU UTARA, SULAWESI BARAT",3,125,73,198
https://kawalpemilu.org#75490,"SARJO, SARJO, MAMUJU UTARA, SULAWESI BARAT",4,138,77,215
https://kawalpemilu.org#75490,"SARJO, SARJO, MAMUJU UTARA, SULAWESI BARAT",5,131,91,222
https://kawalpemilu.org#75490,"SARJO, SARJO, MAMUJU UTARA, SULAWESI BARAT",6,137,112,249
https://kawalpemilu.org#75491,"MAPONU, SARJO, MAMUJU UTARA, SULAWESI BARAT",1,111,131,242
https://kawalpemilu.org#75491,"MAPONU, SARJO, MAMUJU UTARA, SULAWESI BARAT",2,100,109,209
https://kawalpemilu.org#75491,"MAPONU, SARJO, MAMUJU UTARA, SULAWESI BARAT",3,143,39,182
https://kawalpemilu.org#75492,"LETAWA, SARJO, MAMUJU UTARA, SULAWESI BARAT",1,130,55,185
https://kawalpemilu.org#75492,"LETAWA, SARJO, MAMUJU UTARA, SULAWESI BARAT",2,112,68,180
https://kawalpemilu.org#75492,"LETAWA, SARJO, MAMUJU UTARA, SULAWESI BARAT",3,88,120,208
https://kawalpemilu.org#75492,"LETAWA, SARJO, MAMUJU UTARA, SULAWESI BARAT",4,118,89,207
https://kawalpemilu.org#75492,"LETAWA, SARJO, MAMUJU UTARA, SULAWESI BARAT",5,113,97,210
https://kawalpemilu.org#75493,"SARUDE, SARJO, MAMUJU UTARA, SULAWESI BARAT",1,144,95,239
https://kawalpemilu.org#75493,"SARUDE, SARJO, MAMUJU UTARA, SULAWESI BARAT",2,116,58,174
https://kawalpemilu.org#75493,"SARUDE, SARJO, MAMUJU UTARA, SULAWESI BARAT",3,148,87,235
https://kawalpemilu.org#75493,"SARUDE, SARJO, MAMUJU UTARA, SULAWESI BARAT",4,118,114,232
https://kawalpemilu.org#75493,"SARUDE, SARJO, MAMUJU UTARA, SULAWESI BARAT",5,109,103,212
https://kawalpemilu.org#75493,"SARUDE, SARJO, MAMUJU UTARA, SULAWESI BARAT",6,37,106,143
https://kawalpemilu.org#75493,"SARUDE, SARJO, MAMUJU UTARA, SULAWESI BARAT",7,40,109,149
https://kawalpemilu.org#75495,"PARABU, LARIANG, MAMUJU UTARA, SULAWESI BARAT",1,142,59,201
https://kawalpemilu.org#75495,"PARABU, LARIANG, MAMUJU UTARA, SULAWESI BARAT",2,106,104,210
https://kawalpemilu.org#75495,"PARABU, LARIANG, MAMUJU UTARA, SULAWESI BARAT",3,112,63,175
https://kawalpemilu.org#75496,"KENANGAN, LARIANG, MAMUJU UTARA, SULAWESI BARAT",1,104,34,138
https://kawalpemilu.org#75497,"BAJAWALI, LARIANG, MAMUJU UTARA, SULAWESI BARAT",1,157,15,172
https://kawalpemilu.org#75497,"BAJAWALI, LARIANG, MAMUJU UTARA, SULAWESI BARAT",2,155,12,167
https://kawalpemilu.org#75497,"BAJAWALI, LARIANG, MAMUJU UTARA, SULAWESI BARAT",3,160,22,182
https://kawalpemilu.org#75498,"SINGGANI, LARIANG, MAMUJU UTARA, SULAWESI BARAT",1,176,72,248
https://kawalpemilu.org#75498,"SINGGANI, LARIANG, MAMUJU UTARA, SULAWESI BARAT",2,140,74,214
https://kawalpemilu.org#75498,"SINGGANI, LARIANG, MAMUJU UTARA, SULAWESI BARAT",3,124,57,181
https://kawalpemilu.org#75498,"SINGGANI, LARIANG, MAMUJU UTARA, SULAWESI BARAT",4,115,80,195
https://kawalpemilu.org#75499,"KULU, LARIANG, MAMUJU UTARA, SULAWESI BARAT",1,176,34,210
https://kawalpemilu.org#75499,"KULU, LARIANG, MAMUJU UTARA, SULAWESI BARAT",2,144,48,192
https://kawalpemilu.org#75500,"BATU MATORU, LARIANG, MAMUJU UTARA, SULAWESI BARAT",1,103,81,184
https://kawalpemilu.org#75500,"BATU MATORU, LARIANG, MAMUJU UTARA, SULAWESI BARAT",2,108,78,186
https://kawalpemilu.org#75500,"BATU MATORU, LARIANG, MAMUJU UTARA, SULAWESI BARAT",3,123,65,188
https://kawalpemilu.org#75501,"BAMBAKORO, LARIANG, MAMUJU UTARA, SULAWESI BARAT",1,180,66,246
https://kawalpemilu.org#75501,"BAMBAKORO, LARIANG, MAMUJU UTARA, SULAWESI BARAT",2,245,33,278
https://kawalpemilu.org#75501,"BAMBAKORO, LARIANG, MAMUJU UTARA, SULAWESI BARAT",3,126,30,156
https://kawalpemilu.org#75504,"BINANGA, MAMUJU, MAMUJU, SULAWESI BARAT",1,86,115,201
https://kawalpemilu.org#75504,"BINANGA, MAMUJU, MAMUJU, SULAWESI BARAT",2,100,143,243
https://kawalpemilu.org#75504,"BINANGA, MAMUJU, MAMUJU, SULAWESI BARAT",3,78,125,203
https://kawalpemilu.org#75504,"BINANGA, MAMUJU, MAMUJU, SULAWESI BARAT",4,105,150,255
https://kawalpemilu.org#75504,"BINANGA, MAMUJU, MAMUJU, SULAWESI BARAT",5,97,139,236
https://kawalpemilu.org#75504,"BINANGA, MAMUJU, MAMUJU, SULAWESI BARAT",6,71,153,224
https://kawalpemilu.org#75504,"BINANGA, MAMUJU, MAMUJU, SULAWESI BARAT",7,92,97,189
https://kawalpemilu.org#75504,"BINANGA, MAMUJU, MAMUJU, SULAWESI BARAT",8,71,102,173
https://kawalpemilu.org#75504,"BINANGA, MAMUJU, MAMUJU, SULAWESI BARAT",9,68,108,176
https://kawalpemilu.org#75504,"BINANGA, MAMUJU, MAMUJU, SULAWESI BARAT",10,135,166,301
https://kawalpemilu.org#75504,"BINANGA, MAMUJU, MAMUJU, SULAWESI BARAT",11,91,94,185
https://kawalpemilu.org#75504,"BINANGA, MAMUJU, MAMUJU, SULAWESI BARAT",12,86,109,195
https://kawalpemilu.org#75504,"BINANGA, MAMUJU, MAMUJU, SULAWESI BARAT",13,85,82,167
https://kawalpemilu.org#75504,"BINANGA, MAMUJU, MAMUJU, SULAWESI BARAT",14,86,182,268
https://kawalpemilu.org#75504,"BINANGA, MAMUJU, MAMUJU, SULAWESI BARAT",15,154,129,283
https://kawalpemilu.org#75504,"BINANGA, MAMUJU, MAMUJU, SULAWESI BARAT",16,76,47,123
https://kawalpemilu.org#75504,"BINANGA, MAMUJU, MAMUJU, SULAWESI BARAT",17,115,119,234
https://kawalpemilu.org#75504,"BINANGA, MAMUJU, MAMUJU, SULAWESI BARAT",19,168,117,285
https://kawalpemilu.org#75504,"BINANGA, MAMUJU, MAMUJU, SULAWESI BARAT",20,111,115,226
https://kawalpemilu.org#75504,"BINANGA, MAMUJU, MAMUJU, SULAWESI BARAT",21,152,142,294
https://kawalpemilu.org#75504,"BINANGA, MAMUJU, MAMUJU, SULAWESI BARAT",22,131,144,275
https://kawalpemilu.org#75504,"BINANGA, MAMUJU, MAMUJU, SULAWESI BARAT",23,107,81,188
https://kawalpemilu.org#75504,"BINANGA, MAMUJU, MAMUJU, SULAWESI BARAT",24,106,73,179
https://kawalpemilu.org#75504,"BINANGA, MAMUJU, MAMUJU, SULAWESI BARAT",25,100,44,144
https://kawalpemilu.org#75504,"BINANGA, MAMUJU, MAMUJU, SULAWESI BARAT",26,74,39,113
https://kawalpemilu.org#75504,"BINANGA, MAMUJU, MAMUJU, SULAWESI BARAT",27,145,56,201
https://kawalpemilu.org#75504,"BINANGA, MAMUJU, MAMUJU, SULAWESI BARAT",28,105,70,175
https://kawalpemilu.org#75504,"BINANGA, MAMUJU, MAMUJU, SULAWESI BARAT",29,95,101,196
https://kawalpemilu.org#75504,"BINANGA, MAMUJU, MAMUJU, SULAWESI BARAT",30,93,146,239
https://kawalpemilu.org#75504,"BINANGA, MAMUJU, MAMUJU, SULAWESI BARAT",31,64,81,145
https://kawalpemilu.org#75504,"BINANGA, MAMUJU, MAMUJU, SULAWESI BARAT",32,138,166,304
https://kawalpemilu.org#75504,"BINANGA, MAMUJU, MAMUJU, SULAWESI BARAT",33,134,156,290
https://kawalpemilu.org#75504,"BINANGA, MAMUJU, MAMUJU, SULAWESI BARAT",34,98,141,239
https://kawalpemilu.org#75504,"BINANGA, MAMUJU, MAMUJU, SULAWESI BARAT",35,50,117,167
https://kawalpemilu.org#75504,"BINANGA, MAMUJU, MAMUJU, SULAWESI BARAT",36,124,105,229
https://kawalpemilu.org#75504,"BINANGA, MAMUJU, MAMUJU, SULAWESI BARAT",37,80,134,214
https://kawalpemilu.org#75504,"BINANGA, MAMUJU, MAMUJU, SULAWESI BARAT",38,52,156,208
https://kawalpemilu.org#75504,"BINANGA, MAMUJU, MAMUJU, SULAWESI BARAT",39,77,130,207
https://kawalpemilu.org#75504,"BINANGA, MAMUJU, MAMUJU, SULAWESI BARAT",40,60,107,167
https://kawalpemilu.org#75504,"BINANGA, MAMUJU, MAMUJU, SULAWESI BARAT",41,177,96,273
https://kawalpemilu.org#75504,"BINANGA, MAMUJU, MAMUJU, SULAWESI BARAT",42,94,80,174
https://kawalpemilu.org#75504,"BINANGA, MAMUJU, MAMUJU, SULAWESI BARAT",43,73,100,173
https://kawalpemilu.org#75505,"MAMUNYU, MAMUJU, MAMUJU, SULAWESI BARAT",1,47,96,143
https://kawalpemilu.org#75505,"MAMUNYU, MAMUJU, MAMUJU, SULAWESI BARAT",2,38,106,144
https://kawalpemilu.org#75505,"MAMUNYU, MAMUJU, MAMUJU, SULAWESI BARAT",3,65,103,168
https://kawalpemilu.org#75505,"MAMUNYU, MAMUJU, MAMUJU, SULAWESI BARAT",4,46,132,178
https://kawalpemilu.org#75505,"MAMUNYU, MAMUJU, MAMUJU, SULAWESI BARAT",5,82,74,156
https://kawalpemilu.org#75505,"MAMUNYU, MAMUJU, MAMUJU, SULAWESI BARAT",6,86,176,262
https://kawalpemilu.org#75505,"MAMUNYU, MAMUJU, MAMUJU, SULAWESI BARAT",7,117,150,267
https://kawalpemilu.org#75505,"MAMUNYU, MAMUJU, MAMUJU, SULAWESI BARAT",8,142,108,250
https://kawalpemilu.org#75505,"MAMUNYU, MAMUJU, MAMUJU, SULAWESI BARAT",9,88,97,185
https://kawalpemilu.org#75505,"MAMUNYU, MAMUJU, MAMUJU, SULAWESI BARAT",10,111,126,237
https://kawalpemilu.org#75505,"MAMUNYU, MAMUJU, MAMUJU, SULAWESI BARAT",11,126,106,232
https://kawalpemilu.org#75505,"MAMUNYU, MAMUJU, MAMUJU, SULAWESI BARAT",12,162,77,239
https://kawalpemilu.org#75505,"MAMUNYU, MAMUJU, MAMUJU, SULAWESI BARAT",13,162,100,262
https://kawalpemilu.org#75505,"MAMUNYU, MAMUJU, MAMUJU, SULAWESI BARAT",14,140,97,237
https://kawalpemilu.org#75505,"MAMUNYU, MAMUJU, MAMUJU, SULAWESI BARAT",15,185,78,263
https://kawalpemilu.org#75505,"MAMUNYU, MAMUJU, MAMUJU, SULAWESI BARAT",16,74,44,118
https://kawalpemilu.org#75505,"MAMUNYU, MAMUJU, MAMUJU, SULAWESI BARAT",17,90,83,173
https://kawalpemilu.org#75506,"KAREMA, MAMUJU, MAMUJU, SULAWESI BARAT",1,142,141,283
https://kawalpemilu.org#75506,"KAREMA, MAMUJU, MAMUJU, SULAWESI BARAT",2,100,169,269
https://kawalpemilu.org#75506,"KAREMA, MAMUJU, MAMUJU, SULAWESI BARAT",3,131,138,269
https://kawalpemilu.org#75506,"KAREMA, MAMUJU, MAMUJU, SULAWESI BARAT",4,89,156,245
https://kawalpemilu.org#75506,"KAREMA, MAMUJU, MAMUJU, SULAWESI BARAT",5,115,173,288
https://kawalpemilu.org#75506,"KAREMA, MAMUJU, MAMUJU, SULAWESI BARAT",6,99,165,264
https://kawalpemilu.org#75506,"KAREMA, MAMUJU, MAMUJU, SULAWESI BARAT",7,97,131,228
https://kawalpemilu.org#75506,"KAREMA, MAMUJU, MAMUJU, SULAWESI BARAT",8,60,103,163
https://kawalpemilu.org#75506,"KAREMA, MAMUJU, MAMUJU, SULAWESI BARAT",9,132,124,256
https://kawalpemilu.org#75506,"KAREMA, MAMUJU, MAMUJU, SULAWESI BARAT",10,86,113,199
https://kawalpemilu.org#75506,"KAREMA, MAMUJU, MAMUJU, SULAWESI BARAT",11,62,115,177
https://kawalpemilu.org#75506,"KAREMA, MAMUJU, MAMUJU, SULAWESI BARAT",12,122,119,241
https://kawalpemilu.org#75506,"KAREMA, MAMUJU, MAMUJU, SULAWESI BARAT",13,86,120,206
https://kawalpemilu.org#75506,"KAREMA, MAMUJU, MAMUJU, SULAWESI BARAT",14,81,139,219
https://kawalpemilu.org#75506,"KAREMA, MAMUJU, MAMUJU, SULAWESI BARAT",15,71,104,175
https://kawalpemilu.org#75506,"KAREMA, MAMUJU, MAMUJU, SULAWESI BARAT",16,137,143,280
https://kawalpemilu.org#75506,"KAREMA, MAMUJU, MAMUJU, SULAWESI BARAT",17,122,154,276
https://kawalpemilu.org#75506,"KAREMA, MAMUJU, MAMUJU, SULAWESI BARAT",18,79,131,210
https://kawalpemilu.org#75506,"KAREMA, MAMUJU, MAMUJU, SULAWESI BARAT",19,111,163,274
https://kawalpemilu.org#75506,"KAREMA, MAMUJU, MAMUJU, SULAWESI BARAT",20,102,148,250
https://kawalpemilu.org#75506,"KAREMA, MAMUJU, MAMUJU, SULAWESI BARAT",21,92,178,270
https://kawalpemilu.org#75506,"KAREMA, MAMUJU, MAMUJU, SULAWESI BARAT",22,78,143,221
https://kawalpemilu.org#75506,"KAREMA, MAMUJU, MAMUJU, SULAWESI BARAT",23,104,98,202
https://kawalpemilu.org#75506,"KAREMA, MAMUJU, MAMUJU, SULAWESI BARAT",24,58,124,182
https://kawalpemilu.org#75506,"KAREMA, MAMUJU, MAMUJU, SULAWESI BARAT",25,67,108,175
https://kawalpemilu.org#75506,"KAREMA, MAMUJU, MAMUJU, SULAWESI BARAT",26,82,93,175
https://kawalpemilu.org#75507,"RIMUKU, MAMUJU, MAMUJU, SULAWESI BARAT",1,87,168,255
https://kawalpemilu.org#75507,"RIMUKU, MAMUJU, MAMUJU, SULAWESI BARAT",2,80,160,240
https://kawalpemilu.org#75507,"RIMUKU, MAMUJU, MAMUJU, SULAWESI BARAT",3,102,142,244
https://kawalpemilu.org#75507,"RIMUKU, MAMUJU, MAMUJU, SULAWESI BARAT",4,112,133,245
https://kawalpemilu.org#75507,"RIMUKU, MAMUJU, MAMUJU, SULAWESI BARAT",5,126,151,277
https://kawalpemilu.org#75507,"RIMUKU, MAMUJU, MAMUJU, SULAWESI BARAT",6,89,144,233
https://kawalpemilu.org#75507,"RIMUKU, MAMUJU, MAMUJU, SULAWESI BARAT",7,99,144,243
https://kawalpemilu.org#75507,"RIMUKU, MAMUJU, MAMUJU, SULAWESI BARAT",8,73,102,175
https://kawalpemilu.org#75507,"RIMUKU, MAMUJU, MAMUJU, SULAWESI BARAT",9,83,106,189
https://kawalpemilu.org#75507,"RIMUKU, MAMUJU, MAMUJU, SULAWESI BARAT",10,94,140,234
https://kawalpemilu.org#75507,"RIMUKU, MAMUJU, MAMUJU, SULAWESI BARAT",11,83,146,229
https://kawalpemilu.org#75507,"RIMUKU, MAMUJU, MAMUJU, SULAWESI BARAT",12,138,121,259
https://kawalpemilu.org#75507,"RIMUKU, MAMUJU, MAMUJU, SULAWESI BARAT",13,102,147,249
https://kawalpemilu.org#75507,"RIMUKU, MAMUJU, MAMUJU, SULAWESI BARAT",14,117,108,225
https://kawalpemilu.org#75507,"RIMUKU, MAMUJU, MAMUJU, SULAWESI BARAT",15,93,160,253
https://kawalpemilu.org#75507,"RIMUKU, MAMUJU, MAMUJU, SULAWESI BARAT",16,105,95,200
https://kawalpemilu.org#75507,"RIMUKU, MAMUJU, MAMUJU, SULAWESI BARAT",17,103,113,216
https://kawalpemilu.org#75507,"RIMUKU, MAMUJU, MAMUJU, SULAWESI BARAT",18,139,137,276
https://kawalpemilu.org#75507,"RIMUKU, MAMUJU, MAMUJU, SULAWESI BARAT",19,96,120,216
https://kawalpemilu.org#75507,"RIMUKU, MAMUJU, MAMUJU, SULAWESI BARAT",20,109,142,251
https://kawalpemilu.org#75507,"RIMUKU, MAMUJU, MAMUJU, SULAWESI BARAT",21,140,100,240
https://kawalpemilu.org#75507,"RIMUKU, MAMUJU, MAMUJU, SULAWESI BARAT",22,91,135,226
https://kawalpemilu.org#75507,"RIMUKU, MAMUJU, MAMUJU, SULAWESI BARAT",23,74,120,194
https://kawalpemilu.org#75507,"RIMUKU, MAMUJU, MAMUJU, SULAWESI BARAT",24,85,137,222
https://kawalpemilu.org#75507,"RIMUKU, MAMUJU, MAMUJU, SULAWESI BARAT",25,94,167,261
https://kawalpemilu.org#75507,"RIMUKU, MAMUJU, MAMUJU, SULAWESI BARAT",26,63,52,115
https://kawalpemilu.org#75507,"RIMUKU, MAMUJU, MAMUJU, SULAWESI BARAT",27,91,155,246
https://kawalpemilu.org#75508,"BAMBU, MAMUJU, MAMUJU, SULAWESI BARAT",1,70,45,115
https://kawalpemilu.org#75508,"BAMBU, MAMUJU, MAMUJU, SULAWESI BARAT",2,140,77,217
https://kawalpemilu.org#75508,"BAMBU, MAMUJU, MAMUJU, SULAWESI BARAT",3,108,81,189
https://kawalpemilu.org#75508,"BAMBU, MAMUJU, MAMUJU, SULAWESI BARAT",4,38,118,156
https://kawalpemilu.org#75508,"BAMBU, MAMUJU, MAMUJU, SULAWESI BARAT",5,95,122,217
https://kawalpemilu.org#75508,"BAMBU, MAMUJU, MAMUJU, SULAWESI BARAT",6,162,49,211
https://kawalpemilu.org#75508,"BAMBU, MAMUJU, MAMUJU, SULAWESI BARAT",7,128,81,209
https://kawalpemilu.org#75508,"BAMBU, MAMUJU, MAMUJU, SULAWESI BARAT",8,59,106,165
https://kawalpemilu.org#75508,"BAMBU, MAMUJU, MAMUJU, SULAWESI BARAT",9,34,156,190
https://kawalpemilu.org#75508,"BAMBU, MAMUJU, MAMUJU, SULAWESI BARAT",10,108,60,168
https://kawalpemilu.org#75508,"BAMBU, MAMUJU, MAMUJU, SULAWESI BARAT",11,121,53,174
https://kawalpemilu.org#75508,"BAMBU, MAMUJU, MAMUJU, SULAWESI BARAT",12,145,79,224
https://kawalpemilu.org#75508,"BAMBU, MAMUJU, MAMUJU, SULAWESI BARAT",13,102,43,145
https://kawalpemilu.org#75509,"KARAMPUANG, MAMUJU, MAMUJU, SULAWESI BARAT",1,124,115,239
https://kawalpemilu.org#75509,"KARAMPUANG, MAMUJU, MAMUJU, SULAWESI BARAT",2,103,116,219
https://kawalpemilu.org#75509,"KARAMPUANG, MAMUJU, MAMUJU, SULAWESI BARAT",3,147,23,4
https://kawalpemilu.org#75509,"KARAMPUANG, MAMUJU, MAMUJU, SULAWESI BARAT",4,150,35,185
https://kawalpemilu.org#75509,"KARAMPUANG, MAMUJU, MAMUJU, SULAWESI BARAT",5,112,67,179
https://kawalpemilu.org#75509,"KARAMPUANG, MAMUJU, MAMUJU, SULAWESI BARAT",6,219,37,256
https://kawalpemilu.org#75509,"KARAMPUANG, MAMUJU, MAMUJU, SULAWESI BARAT",7,162,31,193
https://kawalpemilu.org#75509,"KARAMPUANG, MAMUJU, MAMUJU, SULAWESI BARAT",8,150,23,173
https://kawalpemilu.org#75509,"KARAMPUANG, MAMUJU, MAMUJU, SULAWESI BARAT",9,85,82,167
https://kawalpemilu.org#75509,"KARAMPUANG, MAMUJU, MAMUJU, SULAWESI BARAT",10,37,70,107
https://kawalpemilu.org#75510,"TADUI, MAMUJU, MAMUJU, SULAWESI BARAT",1,139,113,252
https://kawalpemilu.org#75510,"TADUI, MAMUJU, MAMUJU, SULAWESI BARAT",2,141,66,207
https://kawalpemilu.org#75510,"TADUI, MAMUJU, MAMUJU, SULAWESI BARAT",3,100,55,155
https://kawalpemilu.org#75510,"TADUI, MAMUJU, MAMUJU, SULAWESI BARAT",4,88,67,155
https://kawalpemilu.org#75510,"TADUI, MAMUJU, MAMUJU, SULAWESI BARAT",5,148,109,257
https://kawalpemilu.org#75510,"TADUI, MAMUJU, MAMUJU, SULAWESI BARAT",6,142,87,229
https://kawalpemilu.org#75510,"TADUI, MAMUJU, MAMUJU, SULAWESI BARAT",7,180,79,259
https://kawalpemilu.org#75510,"TADUI, MAMUJU, MAMUJU, SULAWESI BARAT",8,97,76,173
https://kawalpemilu.org#75510,"TADUI, MAMUJU, MAMUJU, SULAWESI BARAT",9,94,73,167
https://kawalpemilu.org#75510,"TADUI, MAMUJU, MAMUJU, SULAWESI BARAT",10,171,47,218
https://kawalpemilu.org#75510,"TADUI, MAMUJU, MAMUJU, SULAWESI BARAT",11,97,16,113
https://kawalpemilu.org#75511,"BATU PANNU, MAMUJU, MAMUJU, SULAWESI BARAT",1,130,110,240
https://kawalpemilu.org#75511,"BATU PANNU, MAMUJU, MAMUJU, SULAWESI BARAT",2,160,39,199
https://kawalpemilu.org#75511,"BATU PANNU, MAMUJU, MAMUJU, SULAWESI BARAT",3,192,33,225
https://kawalpemilu.org#75511,"BATU PANNU, MAMUJU, MAMUJU, SULAWESI BARAT",4,98,35,133
https://kawalpemilu.org#75513,"GALUNG, TAPALANG, MAMUJU, SULAWESI BARAT",1,85,175,260
https://kawalpemilu.org#75513,"GALUNG, TAPALANG, MAMUJU, SULAWESI BARAT",2,100,194,294
https://kawalpemilu.org#75513,"GALUNG, TAPALANG, MAMUJU, SULAWESI BARAT",3,64,153,217
https://kawalpemilu.org#75513,"GALUNG, TAPALANG, MAMUJU, SULAWESI BARAT",4,74,109,183
https://kawalpemilu.org#75513,"GALUNG, TAPALANG, MAMUJU, SULAWESI BARAT",5,66,95,161
https://kawalpemilu.org#75513,"GALUNG, TAPALANG, MAMUJU, SULAWESI BARAT",6,160,62,222
https://kawalpemilu.org#75513,"GALUNG, TAPALANG, MAMUJU, SULAWESI BARAT",7,145,53,198
https://kawalpemilu.org#75513,"GALUNG, TAPALANG, MAMUJU, SULAWESI BARAT",8,69,97,166
https://kawalpemilu.org#75513,"GALUNG, TAPALANG, MAMUJU, SULAWESI BARAT",9,54,128,182
https://kawalpemilu.org#75514,"KASAMBANG, TAPALANG, MAMUJU, SULAWESI BARAT",1,80,138,218
https://kawalpemilu.org#75514,"KASAMBANG, TAPALANG, MAMUJU, SULAWESI BARAT",2,66,172,238
https://kawalpemilu.org#75514,"KASAMBANG, TAPALANG, MAMUJU, SULAWESI BARAT",3,96,148,244
https://kawalpemilu.org#75514,"KASAMBANG, TAPALANG, MAMUJU, SULAWESI BARAT",4,103,141,244
https://kawalpemilu.org#75514,"KASAMBANG, TAPALANG, MAMUJU, SULAWESI BARAT",5,101,84,185
https://kawalpemilu.org#75514,"KASAMBANG, TAPALANG, MAMUJU, SULAWESI BARAT",6,87,153,240
https://kawalpemilu.org#75515,"OROBATU, TAPALANG, MAMUJU, SULAWESI BARAT",1,54,172,226
https://kawalpemilu.org#75515,"OROBATU, TAPALANG, MAMUJU, SULAWESI BARAT",2,45,193,238
https://kawalpemilu.org#75515,"OROBATU, TAPALANG, MAMUJU, SULAWESI BARAT",3,65,155,220
https://kawalpemilu.org#75516,"TAKANDEANG, TAPALANG, MAMUJU, SULAWESI BARAT",1,142,111,253
https://kawalpemilu.org#75516,"TAKANDEANG, TAPALANG, MAMUJU, SULAWESI BARAT",2,121,122,243
https://kawalpemilu.org#75516,"TAKANDEANG, TAPALANG, MAMUJU, SULAWESI BARAT",3,138,72,210
https://kawalpemilu.org#75516,"TAKANDEANG, TAPALANG, MAMUJU, SULAWESI BARAT",4,139,95,234
https://kawalpemilu.org#75516,"TAKANDEANG, TAPALANG, MAMUJU, SULAWESI BARAT",5,136,37,173
https://kawalpemilu.org#75516,"TAKANDEANG, TAPALANG, MAMUJU, SULAWESI BARAT",6,75,60,135
https://kawalpemilu.org#75517,"BELA, TAPALANG, MAMUJU, SULAWESI BARAT",1,117,24,141
https://kawalpemilu.org#75517,"BELA, TAPALANG, MAMUJU, SULAWESI BARAT",2,121,9,130
https://kawalpemilu.org#75518,"TAAN, TAPALANG, MAMUJU, SULAWESI BARAT",1,150,84,234
https://kawalpemilu.org#75518,"TAAN, TAPALANG, MAMUJU, SULAWESI BARAT",2,121,22,143
https://kawalpemilu.org#75518,"TAAN, TAPALANG, MAMUJU, SULAWESI BARAT",3,108,99,207
https://kawalpemilu.org#75518,"TAAN, TAPALANG, MAMUJU, SULAWESI BARAT",4,146,99,245
https://kawalpemilu.org#75518,"TAAN, TAPALANG, MAMUJU, SULAWESI BARAT",5,130,125,255
https://kawalpemilu.org#75518,"TAAN, TAPALANG, MAMUJU, SULAWESI BARAT",6,100,56,156
https://kawalpemilu.org#75518,"TAAN, TAPALANG, MAMUJU, SULAWESI BARAT",7,110,124,234
https://kawalpemilu.org#75518,"TAAN, TAPALANG, MAMUJU, SULAWESI BARAT",8,110,73,183
https://kawalpemilu.org#75519,"TAMPALANG, TAPALANG, MAMUJU, SULAWESI BARAT",1,92,135,227
https://kawalpemilu.org#75519,"TAMPALANG, TAPALANG, MAMUJU, SULAWESI BARAT",2,65,153,218
https://kawalpemilu.org#75519,"TAMPALANG, TAPALANG, MAMUJU, SULAWESI BARAT",3,95,114,209
https://kawalpemilu.org#75519,"TAMPALANG, TAPALANG, MAMUJU, SULAWESI BARAT",4,144,108,252
https://kawalpemilu.org#75519,"TAMPALANG, TAPALANG, MAMUJU, SULAWESI BARAT",5,109,84,193
https://kawalpemilu.org#75519,"TAMPALANG, TAPALANG, MAMUJU, SULAWESI BARAT",6,63,179,242
https://kawalpemilu.org#75520,"RANTEDODA, TAPALANG, MAMUJU, SULAWESI BARAT",1,135,67,202
https://kawalpemilu.org#75520,"RANTEDODA, TAPALANG, MAMUJU, SULAWESI BARAT",2,110,82,192
https://kawalpemilu.org#75520,"RANTEDODA, TAPALANG, MAMUJU, SULAWESI BARAT",3,33,21,54
https://kawalpemilu.org#75521,"KOPEANG, TAPALANG, MAMUJU, SULAWESI BARAT",1,130,55,185
https://kawalpemilu.org#75521,"KOPEANG, TAPALANG, MAMUJU, SULAWESI BARAT",2,84,23,107
https://kawalpemilu.org#75521,"KOPEANG, TAPALANG, MAMUJU, SULAWESI BARAT",3,104,25,129
https://kawalpemilu.org#931311,"DAYANGINNA, TAPALANG, MAMUJU, SULAWESI BARAT",1,101,145,246
https://kawalpemilu.org#931311,"DAYANGINNA, TAPALANG, MAMUJU, SULAWESI BARAT",2,145,105,250
https://kawalpemilu.org#931311,"DAYANGINNA, TAPALANG, MAMUJU, SULAWESI BARAT",3,108,140,248
https://kawalpemilu.org#931311,"DAYANGINNA, TAPALANG, MAMUJU, SULAWESI BARAT",4,84,162,264
https://kawalpemilu.org#75523,"SINYONYOI, KALUKKU, MAMUJU, SULAWESI BARAT",1,173,44,217
https://kawalpemilu.org#75523,"SINYONYOI, KALUKKU, MAMUJU, SULAWESI BARAT",2,89,199,288
https://kawalpemilu.org#75523,"SINYONYOI, KALUKKU, MAMUJU, SULAWESI BARAT",3,82,110,192
https://kawalpemilu.org#75523,"SINYONYOI, KALUKKU, MAMUJU, SULAWESI BARAT",4,169,98,267
https://kawalpemilu.org#75523,"SINYONYOI, KALUKKU, MAMUJU, SULAWESI BARAT",5,203,42,245
https://kawalpemilu.org#75523,"SINYONYOI, KALUKKU, MAMUJU, SULAWESI BARAT",6,106,121,227
https://kawalpemilu.org#75523,"SINYONYOI, KALUKKU, MAMUJU, SULAWESI BARAT",7,145,107,252
https://kawalpemilu.org#75523,"SINYONYOI, KALUKKU, MAMUJU, SULAWESI BARAT",8,143,139,282
https://kawalpemilu.org#75523,"SINYONYOI, KALUKKU, MAMUJU, SULAWESI BARAT",9,202,96,298
https://kawalpemilu.org#75523,"SINYONYOI, KALUKKU, MAMUJU, SULAWESI BARAT",10,168,134,302
https://kawalpemilu.org#75523,"SINYONYOI, KALUKKU, MAMUJU, SULAWESI BARAT",11,97,70,167
https://kawalpemilu.org#75523,"SINYONYOI, KALUKKU, MAMUJU, SULAWESI BARAT",12,187,27,214
https://kawalpemilu.org#75523,"SINYONYOI, KALUKKU, MAMUJU, SULAWESI BARAT",13,168,56,224
https://kawalpemilu.org#75523,"SINYONYOI, KALUKKU, MAMUJU, SULAWESI BARAT",14,101,35,136
https://kawalpemilu.org#75524,"BEBANGA, KALUKKU, MAMUJU, SULAWESI BARAT",1,118,109,227
https://kawalpemilu.org#75524,"BEBANGA, KALUKKU, MAMUJU, SULAWESI BARAT",2,110,85,195
https://kawalpemilu.org#75524,"BEBANGA, KALUKKU, MAMUJU, SULAWESI BARAT",3,179,110,289
https://kawalpemilu.org#75524,"BEBANGA, KALUKKU, MAMUJU, SULAWESI BARAT",4,135,18,153
https://kawalpemilu.org#75524,"BEBANGA, KALUKKU, MAMUJU, SULAWESI BARAT",5,148,131,279
https://kawalpemilu.org#75524,"BEBANGA, KALUKKU, MAMUJU, SULAWESI BARAT",6,157,105,262
https://kawalpemilu.org#75524,"BEBANGA, KALUKKU, MAMUJU, SULAWESI BARAT",7,163,126,289
https://kawalpemilu.org#75524,"BEBANGA, KALUKKU, MAMUJU, SULAWESI BARAT",8,152,136,288
https://kawalpemilu.org#75524,"BEBANGA, KALUKKU, MAMUJU, SULAWESI BARAT",10,173,83,256
https://kawalpemilu.org#75524,"BEBANGA, KALUKKU, MAMUJU, SULAWESI BARAT",11,115,70,185
https://kawalpemilu.org#75524,"BEBANGA, KALUKKU, MAMUJU, SULAWESI BARAT",12,183,101,284
https://kawalpemilu.org#75524,"BEBANGA, KALUKKU, MAMUJU, SULAWESI BARAT",13,116,96,212
https://kawalpemilu.org#75524,"BEBANGA, KALUKKU, MAMUJU, SULAWESI BARAT",14,122,82,204
https://kawalpemilu.org#75524,"BEBANGA, KALUKKU, MAMUJU, SULAWESI BARAT",15,168,40,208
https://kawalpemilu.org#75524,"BEBANGA, KALUKKU, MAMUJU, SULAWESI BARAT",16,141,75,216
https://kawalpemilu.org#75524,"BEBANGA, KALUKKU, MAMUJU, SULAWESI BARAT",17,97,111,208
https://kawalpemilu.org#75524,"BEBANGA, KALUKKU, MAMUJU, SULAWESI BARAT",18,140,40,180
https://kawalpemilu.org#75524,"BEBANGA, KALUKKU, MAMUJU, SULAWESI BARAT",19,105,20,125
https://kawalpemilu.org#75525,"KALUKKU, KALUKKU, MAMUJU, SULAWESI BARAT",1,113,97,210
https://kawalpemilu.org#75525,"KALUKKU, KALUKKU, MAMUJU, SULAWESI BARAT",2,151,112,263
https://kawalpemilu.org#75525,"KALUKKU, KALUKKU, MAMUJU, SULAWESI BARAT",3,110,110,220
https://kawalpemilu.org#75525,"KALUKKU, KALUKKU, MAMUJU, SULAWESI BARAT",4,173,114,287
https://kawalpemilu.org#75525,"KALUKKU, KALUKKU, MAMUJU, SULAWESI BARAT",5,161,144,305
https://kawalpemilu.org#75525,"KALUKKU, KALUKKU, MAMUJU, SULAWESI BARAT",6,175,118,293
https://kawalpemilu.org#75525,"KALUKKU, KALUKKU, MAMUJU, SULAWESI BARAT",7,155,33,188
https://kawalpemilu.org#75525,"KALUKKU, KALUKKU, MAMUJU, SULAWESI BARAT",8,183,54,237
https://kawalpemilu.org#75525,"KALUKKU, KALUKKU, MAMUJU, SULAWESI BARAT",9,185,73,258
https://kawalpemilu.org#75525,"KALUKKU, KALUKKU, MAMUJU, SULAWESI BARAT",10,143,81,224
https://kawalpemilu.org#75525,"KALUKKU, KALUKKU, MAMUJU, SULAWESI BARAT",11,153,102,255
https://kawalpemilu.org#75525,"KALUKKU, KALUKKU, MAMUJU, SULAWESI BARAT",12,151,120,271
https://kawalpemilu.org#75525,"KALUKKU, KALUKKU, MAMUJU, SULAWESI BARAT",13,127,66,193
https://kawalpemilu.org#75525,"KALUKKU, KALUKKU, MAMUJU, SULAWESI BARAT",14,159,37,196
https://kawalpemilu.org#75525,"KALUKKU, KALUKKU, MAMUJU, SULAWESI BARAT",15,89,91,180
https://kawalpemilu.org#75526,"SONDOANG, KALUKKU, MAMUJU, SULAWESI BARAT",1,205,80,285
https://kawalpemilu.org#75526,"SONDOANG, KALUKKU, MAMUJU, SULAWESI BARAT",2,162,37,199
https://kawalpemilu.org#75526,"SONDOANG, KALUKKU, MAMUJU, SULAWESI BARAT",3,87,25,112
https://kawalpemilu.org#75526,"SONDOANG, KALUKKU, MAMUJU, SULAWESI BARAT",4,158,77,235
https://kawalpemilu.org#75526,"SONDOANG, KALUKKU, MAMUJU, SULAWESI BARAT",5,150,74,224
https://kawalpemilu.org#75526,"SONDOANG, KALUKKU, MAMUJU, SULAWESI BARAT",6,107,6,113
https://kawalpemilu.org#75526,"SONDOANG, KALUKKU, MAMUJU, SULAWESI BARAT",7,83,27,110
https://kawalpemilu.org#75526,"SONDOANG, KALUKKU, MAMUJU, SULAWESI BARAT",8,79,28,107
https://kawalpemilu.org#75527,"BERU-BERU, KALUKKU, MAMUJU, SULAWESI BARAT",1,116,170,286
https://kawalpemilu.org#75527,"BERU-BERU, KALUKKU, MAMUJU, SULAWESI BARAT",2,131,101,232
https://kawalpemilu.org#75527,"BERU-BERU, KALUKKU, MAMUJU, SULAWESI BARAT",3,100,134,234
https://kawalpemilu.org#75527,"BERU-BERU, KALUKKU, MAMUJU, SULAWESI BARAT",4,136,68,204
https://kawalpemilu.org#75527,"BERU-BERU, KALUKKU, MAMUJU, SULAWESI BARAT",5,107,74,181
https://kawalpemilu.org#75527,"BERU-BERU, KALUKKU, MAMUJU, SULAWESI BARAT",6,140,100,240
https://kawalpemilu.org#75527,"BERU-BERU, KALUKKU, MAMUJU, SULAWESI BARAT",7,159,89,248
https://kawalpemilu.org#75527,"BERU-BERU, KALUKKU, MAMUJU, SULAWESI BARAT",8,149,115,264
https://kawalpemilu.org#75527,"BERU-BERU, KALUKKU, MAMUJU, SULAWESI BARAT",9,151,51,202
https://kawalpemilu.org#75527,"BERU-BERU, KALUKKU, MAMUJU, SULAWESI BARAT",10,114,34,148
https://kawalpemilu.org#75527,"BERU-BERU, KALUKKU, MAMUJU, SULAWESI BARAT",11,157,12,169
https://kawalpemilu.org#75527,"BERU-BERU, KALUKKU, MAMUJU, SULAWESI BARAT",12,221,40,261
https://kawalpemilu.org#75527,"BERU-BERU, KALUKKU, MAMUJU, SULAWESI BARAT",13,119,58,177
https://kawalpemilu.org#75528,"BELANG BELANG, KALUKKU, MAMUJU, SULAWESI BARAT",1,137,44,181
https://kawalpemilu.org#75528,"BELANG BELANG, KALUKKU, MAMUJU, SULAWESI BARAT",2,142,39,181
https://kawalpemilu.org#75528,"BELANG BELANG, KALUKKU, MAMUJU, SULAWESI BARAT",3,151,56,207
https://kawalpemilu.org#75528,"BELANG BELANG, KALUKKU, MAMUJU, SULAWESI BARAT",4,171,57,228
https://kawalpemilu.org#75528,"BELANG BELANG, KALUKKU, MAMUJU, SULAWESI BARAT",5,93,24,117
https://kawalpemilu.org#75528,"BELANG BELANG, KALUKKU, MAMUJU, SULAWESI BARAT",6,141,96,237
https://kawalpemilu.org#75528,"BELANG BELANG, KALUKKU, MAMUJU, SULAWESI BARAT",7,70,18,88
https://kawalpemilu.org#75528,"BELANG BELANG, KALUKKU, MAMUJU, SULAWESI BARAT",8,160,95,255
https://kawalpemilu.org#75528,"BELANG BELANG, KALUKKU, MAMUJU, SULAWESI BARAT",9,120,55,175
https://kawalpemilu.org#75528,"BELANG BELANG, KALUKKU, MAMUJU, SULAWESI BARAT",10,172,84,256
https://kawalpemilu.org#75529,"KABULOANG, KALUKKU, MAMUJU, SULAWESI BARAT",1,188,50,238
https://kawalpemilu.org#75529,"KABULOANG, KALUKKU, MAMUJU, SULAWESI BARAT",2,129,140,269
https://kawalpemilu.org#75529,"KABULOANG, KALUKKU, MAMUJU, SULAWESI BARAT",3,178,81,259
https://kawalpemilu.org#75529,"KABULOANG, KALUKKU, MAMUJU, SULAWESI BARAT",4,186,77,263
https://kawalpemilu.org#75529,"KABULOANG, KALUKKU, MAMUJU, SULAWESI BARAT",5,124,85,209
https://kawalpemilu.org#75529,"KABULOANG, KALUKKU, MAMUJU, SULAWESI BARAT",6,188,42,230
https://kawalpemilu.org#75529,"KABULOANG, KALUKKU, MAMUJU, SULAWESI BARAT",7,197,59,256
https://kawalpemilu.org#75529,"KABULOANG, KALUKKU, MAMUJU, SULAWESI BARAT",8,172,89,261
https://kawalpemilu.org#75529,"KABULOANG, KALUKKU, MAMUJU, SULAWESI BARAT",9,143,59,202
https://kawalpemilu.org#75530,"KEANG, KALUKKU, MAMUJU, SULAWESI BARAT",1,140,70,210
https://kawalpemilu.org#75530,"KEANG, KALUKKU, MAMUJU, SULAWESI BARAT",2,123,41,164
https://kawalpemilu.org#75530,"KEANG, KALUKKU, MAMUJU, SULAWESI BARAT",3,201,12,213
https://kawalpemilu.org#75530,"KEANG, KALUKKU, MAMUJU, SULAWESI BARAT",4,54,42,96
https://kawalpemilu.org#75530,"KEANG, KALUKKU, MAMUJU, SULAWESI BARAT",5,228,13,241
https://kawalpemilu.org#75530,"KEANG, KALUKKU, MAMUJU, SULAWESI BARAT",6,200,8,208
https://kawalpemilu.org#75530,"KEANG, KALUKKU, MAMUJU, SULAWESI BARAT",7,132,51,183
https://kawalpemilu.org#75530,"KEANG, KALUKKU, MAMUJU, SULAWESI BARAT",8,120,73,193
https://kawalpemilu.org#75530,"KEANG, KALUKKU, MAMUJU, SULAWESI BARAT",9,89,4,93
https://kawalpemilu.org#75530,"KEANG, KALUKKU, MAMUJU, SULAWESI BARAT",10,108,18,126
https://kawalpemilu.org#75531,"POKKANG, KALUKKU, MAMUJU, SULAWESI BARAT",1,114,107,221
https://kawalpemilu.org#75531,"POKKANG, KALUKKU, MAMUJU, SULAWESI BARAT",2,133,109,242
https://kawalpemilu.org#75531,"POKKANG, KALUKKU, MAMUJU, SULAWESI BARAT",3,161,53,214
https://kawalpemilu.org#75531,"POKKANG, KALUKKU, MAMUJU, SULAWESI BARAT",4,75,49,124
https://kawalpemilu.org#75531,"POKKANG, KALUKKU, MAMUJU, SULAWESI BARAT",5,210,6,216
https://kawalpemilu.org#75531,"POKKANG, KALUKKU, MAMUJU, SULAWESI BARAT",6,190,19,209
https://kawalpemilu.org#75531,"POKKANG, KALUKKU, MAMUJU, SULAWESI BARAT",7,93,1,94
https://kawalpemilu.org#75531,"POKKANG, KALUKKU, MAMUJU, SULAWESI BARAT",8,105,7,112
https://kawalpemilu.org#75532,"GULILING, KALUKKU, MAMUJU, SULAWESI BARAT",1,178,25,203
https://kawalpemilu.org#75532,"GULILING, KALUKKU, MAMUJU, SULAWESI BARAT",2,172,42,214
https://kawalpemilu.org#75532,"GULILING, KALUKKU, MAMUJU, SULAWESI BARAT",3,160,10,170
https://kawalpemilu.org#75532,"GULILING, KALUKKU, MAMUJU, SULAWESI BARAT",4,82,0,82
https://kawalpemilu.org#75533,"UHAIMATE, KALUKKU, MAMUJU, SULAWESI BARAT",1,106,22,128
https://kawalpemilu.org#75533,"UHAIMATE, KALUKKU, MAMUJU, SULAWESI BARAT",2,77,15,92
https://kawalpemilu.org#75533,"UHAIMATE, KALUKKU, MAMUJU, SULAWESI BARAT",3,104,53,157
https://kawalpemilu.org#75533,"UHAIMATE, KALUKKU, MAMUJU, SULAWESI BARAT",4,131,8,139
https://kawalpemilu.org#75534,"KALUKKU BARAT, KALUKKU, MAMUJU, SULAWESI BARAT",1,150,61,211
https://kawalpemilu.org#75534,"KALUKKU BARAT, KALUKKU, MAMUJU, SULAWESI BARAT",2,128,52,180
https://kawalpemilu.org#75534,"KALUKKU BARAT, KALUKKU, MAMUJU, SULAWESI BARAT",3,152,99,251
https://kawalpemilu.org#75534,"KALUKKU BARAT, KALUKKU, MAMUJU, SULAWESI BARAT",4,150,94,244
https://kawalpemilu.org#75534,"KALUKKU BARAT, KALUKKU, MAMUJU, SULAWESI BARAT",5,209,36,245
https://kawalpemilu.org#75534,"KALUKKU BARAT, KALUKKU, MAMUJU, SULAWESI BARAT",6,133,58,191
https://kawalpemilu.org#75534,"KALUKKU BARAT, KALUKKU, MAMUJU, SULAWESI BARAT",7,168,38,206
https://kawalpemilu.org#75534,"KALUKKU BARAT, KALUKKU, MAMUJU, SULAWESI BARAT",8,106,97,203
https://kawalpemilu.org#75534,"KALUKKU BARAT, KALUKKU, MAMUJU, SULAWESI BARAT",9,109,91,200
https://kawalpemilu.org#75534,"KALUKKU BARAT, KALUKKU, MAMUJU, SULAWESI BARAT",10,90,93,183
https://kawalpemilu.org#75534,"KALUKKU BARAT, KALUKKU, MAMUJU, SULAWESI BARAT",11,183,75,258
https://kawalpemilu.org#75534,"KALUKKU BARAT, KALUKKU, MAMUJU, SULAWESI BARAT",12,141,75,216
https://kawalpemilu.org#75534,"KALUKKU BARAT, KALUKKU, MAMUJU, SULAWESI BARAT",13,149,32,181
https://kawalpemilu.org#75535,"PAMMULUKANG, KALUKKU, MAMUJU, SULAWESI BARAT",1,169,55,224
https://kawalpemilu.org#75535,"PAMMULUKANG, KALUKKU, MAMUJU, SULAWESI BARAT",2,171,64,235
https://kawalpemilu.org#75535,"PAMMULUKANG, KALUKKU, MAMUJU, SULAWESI BARAT",3,159,76,235
https://kawalpemilu.org#75535,"PAMMULUKANG, KALUKKU, MAMUJU, SULAWESI BARAT",4,133,26,159
https://kawalpemilu.org#75535,"PAMMULUKANG, KALUKKU, MAMUJU, SULAWESI BARAT",5,49,4,53
https://kawalpemilu.org#931312,"SINYONYOI SELATAN, KALUKKU, MAMUJU, SULAWESI BARAT",1,138,113,251
https://kawalpemilu.org#931312,"SINYONYOI SELATAN, KALUKKU, MAMUJU, SULAWESI BARAT",2,206,66,272
https://kawalpemilu.org#931312,"SINYONYOI SELATAN, KALUKKU, MAMUJU, SULAWESI BARAT",3,82,110,192
https://kawalpemilu.org#931312,"SINYONYOI SELATAN, KALUKKU, MAMUJU, SULAWESI BARAT",4,181,101,282
https://kawalpemilu.org#931312,"SINYONYOI SELATAN, KALUKKU, MAMUJU, SULAWESI BARAT",5,207,73,280
https://kawalpemilu.org#931312,"SINYONYOI SELATAN, KALUKKU, MAMUJU, SULAWESI BARAT",6,111,177,288
https://kawalpemilu.org#931312,"SINYONYOI SELATAN, KALUKKU, MAMUJU, SULAWESI BARAT",7,97,165,262
https://kawalpemilu.org#931312,"SINYONYOI SELATAN, KALUKKU, MAMUJU, SULAWESI BARAT",8,185,49,234
https://kawalpemilu.org#931312,"SINYONYOI SELATAN, KALUKKU, MAMUJU, SULAWESI BARAT",9,95,32,127
https://kawalpemilu.org#931312,"SINYONYOI SELATAN, KALUKKU, MAMUJU, SULAWESI BARAT",10,136,61,197
https://kawalpemilu.org#931312,"SINYONYOI SELATAN, KALUKKU, MAMUJU, SULAWESI BARAT",12,110,55,165
https://kawalpemilu.org#75537,"KALUMPANG, KALUMPANG, MAMUJU, SULAWESI BARAT",1,126,50,176
https://kawalpemilu.org#75537,"KALUMPANG, KALUMPANG, MAMUJU, SULAWESI BARAT",2,132,29,161
https://kawalpemilu.org#75537,"KALUMPANG, KALUMPANG, MAMUJU, SULAWESI BARAT",3,53,4,57
https://kawalpemilu.org#75538,"KARATAUN, KALUMPANG, MAMUJU, SULAWESI BARAT",1,157,25,182
https://kawalpemilu.org#75538,"KARATAUN, KALUMPANG, MAMUJU, SULAWESI BARAT",2,133,12,145
https://kawalpemilu.org#75538,"KARATAUN, KALUMPANG, MAMUJU, SULAWESI BARAT",3,134,18,152
https://kawalpemilu.org#75538,"KARATAUN, KALUMPANG, MAMUJU, SULAWESI BARAT",4,73,1,74
https://kawalpemilu.org#75538,"KARATAUN, KALUMPANG, MAMUJU, SULAWESI BARAT",5,100,22,122
https://kawalpemilu.org#75538,"KARATAUN, KALUMPANG, MAMUJU, SULAWESI BARAT",6,57,8,65
https://kawalpemilu.org#75539,"KARAMA, KALUMPANG, MAMUJU, SULAWESI BARAT",1,120,24,144
https://kawalpemilu.org#75539,"KARAMA, KALUMPANG, MAMUJU, SULAWESI BARAT",2,178,24,202
https://kawalpemilu.org#75539,"KARAMA, KALUMPANG, MAMUJU, SULAWESI BARAT",3,155,18,173
https://kawalpemilu.org#75539,"KARAMA, KALUMPANG, MAMUJU, SULAWESI BARAT",4,34,0,34
https://kawalpemilu.org#75539,"KARAMA, KALUMPANG, MAMUJU, SULAWESI BARAT",5,68,1,69
https://kawalpemilu.org#75540,"SIRAUN, KALUMPANG, MAMUJU, SULAWESI BARAT",1,105,10,115
https://kawalpemilu.org#75540,"SIRAUN, KALUMPANG, MAMUJU, SULAWESI BARAT",2,57,6,63
https://kawalpemilu.org#75540,"SIRAUN, KALUMPANG, MAMUJU, SULAWESI BARAT",3,136,1,136
https://kawalpemilu.org#75540,"SIRAUN, KALUMPANG, MAMUJU, SULAWESI BARAT",4,175,13,188
https://kawalpemilu.org#75540,"SIRAUN, KALUMPANG, MAMUJU, SULAWESI BARAT",5,33,3,36
https://kawalpemilu.org#75541,"TUMOGA, KALUMPANG, MAMUJU, SULAWESI BARAT",1,56,1,57
https://kawalpemilu.org#75541,"TUMOGA, KALUMPANG, MAMUJU, SULAWESI BARAT",2,67,6,70
https://kawalpemilu.org#75541,"TUMOGA, KALUMPANG, MAMUJU, SULAWESI BARAT",3,139,1,140
https://kawalpemilu.org#75541,"TUMOGA, KALUMPANG, MAMUJU, SULAWESI BARAT",4,141,6,147
https://kawalpemilu.org#75541,"TUMOGA, KALUMPANG, MAMUJU, SULAWESI BARAT",5,103,0,103
https://kawalpemilu.org#75542,"SALUMAKKI, KALUMPANG, MAMUJU, SULAWESI BARAT",1,148,31,179
https://kawalpemilu.org#75542,"SALUMAKKI, KALUMPANG, MAMUJU, SULAWESI BARAT",2,119,96,215
https://kawalpemilu.org#75542,"SALUMAKKI, KALUMPANG, MAMUJU, SULAWESI BARAT",3,72,38,110
https://kawalpemilu.org#75543,"POLIO, KALUMPANG, MAMUJU, SULAWESI BARAT",1,195,46,242
https://kawalpemilu.org#75543,"POLIO, KALUMPANG, MAMUJU, SULAWESI BARAT",2,127,13,140
https://kawalpemilu.org#75544,"LIMBONG, KALUMPANG, MAMUJU, SULAWESI BARAT",1,79,0,79
https://kawalpemilu.org#75544,"LIMBONG, KALUMPANG, MAMUJU, SULAWESI BARAT",2,135,2,136
https://kawalpemilu.org#75544,"LIMBONG, KALUMPANG, MAMUJU, SULAWESI BARAT",3,162,16,178
https://kawalpemilu.org#75544,"LIMBONG, KALUMPANG, MAMUJU, SULAWESI BARAT",4,66,5,71
https://kawalpemilu.org#75544,"LIMBONG, KALUMPANG, MAMUJU, SULAWESI BARAT",5,117,6,123
https://kawalpemilu.org#75545,"SANDAPANG, KALUMPANG, MAMUJU, SULAWESI BARAT",1,149,7,156
https://kawalpemilu.org#75545,"SANDAPANG, KALUMPANG, MAMUJU, SULAWESI BARAT",2,73,3,76
https://kawalpemilu.org#75545,"SANDAPANG, KALUMPANG, MAMUJU, SULAWESI BARAT",3,48,1,49
https://kawalpemilu.org#75545,"SANDAPANG, KALUMPANG, MAMUJU, SULAWESI BARAT",4,46,0,46
https://kawalpemilu.org#75545,"SANDAPANG, KALUMPANG, MAMUJU, SULAWESI BARAT",5,70,0,70
https://kawalpemilu.org#75545,"SANDAPANG, KALUMPANG, MAMUJU, SULAWESI BARAT",6,36,0,36
https://kawalpemilu.org#75545,"SANDAPANG, KALUMPANG, MAMUJU, SULAWESI BARAT",7,98,4,102
https://kawalpemilu.org#75546,"KONDO BULO, KALUMPANG, MAMUJU, SULAWESI BARAT",1,183,15,198
https://kawalpemilu.org#75546,"KONDO BULO, KALUMPANG, MAMUJU, SULAWESI BARAT",2,75,3,78
https://kawalpemilu.org#75546,"KONDO BULO, KALUMPANG, MAMUJU, SULAWESI BARAT",3,102,1,103
https://kawalpemilu.org#75546,"KONDO BULO, KALUMPANG, MAMUJU, SULAWESI BARAT",4,67,2,69
https://kawalpemilu.org#75546,"KONDO BULO, KALUMPANG, MAMUJU, SULAWESI BARAT",5,119,7,126
https://kawalpemilu.org#75547,"MAKKALIKI, KALUMPANG, MAMUJU, SULAWESI BARAT",1,144,10,154
https://kawalpemilu.org#75547,"MAKKALIKI, KALUMPANG, MAMUJU, SULAWESI BARAT",2,76,2,78
https://kawalpemilu.org#75547,"MAKKALIKI, KALUMPANG, MAMUJU, SULAWESI BARAT",3,105,6,111
https://kawalpemilu.org#75548,"BATU MAKKADA, KALUMPANG, MAMUJU, SULAWESI BARAT",1,125,10,135
https://kawalpemilu.org#75548,"BATU MAKKADA, KALUMPANG, MAMUJU, SULAWESI BARAT",2,148,9,157
https://kawalpemilu.org#75548,"BATU MAKKADA, KALUMPANG, MAMUJU, SULAWESI BARAT",3,178,12,190
https://kawalpemilu.org#75548,"BATU MAKKADA, KALUMPANG, MAMUJU, SULAWESI BARAT",4,57,1,57
https://kawalpemilu.org#85951,"LASA', KALUMPANG, MAMUJU, SULAWESI BARAT",1,171,8,179
https://kawalpemilu.org#85951,"LASA', KALUMPANG, MAMUJU, SULAWESI BARAT",2,160,4,164
https://kawalpemilu.org#75572,"TOABO, PAPALANG, MAMUJU, SULAWESI BARAT",1,85,87,172
https://kawalpemilu.org#75572,"TOABO, PAPALANG, MAMUJU, SULAWESI BARAT",2,175,76,251
https://kawalpemilu.org#75572,"TOABO, PAPALANG, MAMUJU, SULAWESI BARAT",3,147,110,257
https://kawalpemilu.org#75572,"TOABO, PAPALANG, MAMUJU, SULAWESI BARAT",5,138,20,158
https://kawalpemilu.org#75572,"TOABO, PAPALANG, MAMUJU, SULAWESI BARAT",6,67,164,231
https://kawalpemilu.org#75572,"TOABO, PAPALANG, MAMUJU, SULAWESI BARAT",7,115,138,253
https://kawalpemilu.org#75572,"TOABO, PAPALANG, MAMUJU, SULAWESI BARAT",8,113,32,145
https://kawalpemilu.org#75572,"TOABO, PAPALANG, MAMUJU, SULAWESI BARAT",9,108,41,149
https://kawalpemilu.org#75572,"TOABO, PAPALANG, MAMUJU, SULAWESI BARAT",10,79,60,139
https://kawalpemilu.org#75572,"TOABO, PAPALANG, MAMUJU, SULAWESI BARAT",11,78,79,157
https://kawalpemilu.org#75572,"TOABO, PAPALANG, MAMUJU, SULAWESI BARAT",12,77,81,158
https://kawalpemilu.org#75572,"TOABO, PAPALANG, MAMUJU, SULAWESI BARAT",13,141,34,175
https://kawalpemilu.org#75572,"TOABO, PAPALANG, MAMUJU, SULAWESI BARAT",14,109,46,155
https://kawalpemilu.org#75573,"PAPALANG, PAPALANG, MAMUJU, SULAWESI BARAT",1,82,145,227
https://kawalpemilu.org#75573,"PAPALANG, PAPALANG, MAMUJU, SULAWESI BARAT",2,110,101,211
https://kawalpemilu.org#75573,"PAPALANG, PAPALANG, MAMUJU, SULAWESI BARAT",3,129,66,195
https://kawalpemilu.org#75573,"PAPALANG, PAPALANG, MAMUJU, SULAWESI BARAT",4,115,103,218
https://kawalpemilu.org#75573,"PAPALANG, PAPALANG, MAMUJU, SULAWESI BARAT",5,111,120,231
https://kawalpemilu.org#75573,"PAPALANG, PAPALANG, MAMUJU, SULAWESI BARAT",6,106,95,201
https://kawalpemilu.org#75573,"PAPALANG, PAPALANG, MAMUJU, SULAWESI BARAT",7,125,111,236
https://kawalpemilu.org#75573,"PAPALANG, PAPALANG, MAMUJU, SULAWESI BARAT",8,153,51,204
https://kawalpemilu.org#75573,"PAPALANG, PAPALANG, MAMUJU, SULAWESI BARAT",9,119,129,248
https://kawalpemilu.org#75573,"PAPALANG, PAPALANG, MAMUJU, SULAWESI BARAT",10,104,110,214
https://kawalpemilu.org#75573,"PAPALANG, PAPALANG, MAMUJU, SULAWESI BARAT",11,112,112,224
https://kawalpemilu.org#75573,"PAPALANG, PAPALANG, MAMUJU, SULAWESI BARAT",12,96,90,186
https://kawalpemilu.org#75573,"PAPALANG, PAPALANG, MAMUJU, SULAWESI BARAT",13,137,82,219
https://kawalpemilu.org#75573,"PAPALANG, PAPALANG, MAMUJU, SULAWESI BARAT",14,120,64,184
https://kawalpemilu.org#75574,"BONDA, PAPALANG, MAMUJU, SULAWESI BARAT",1,85,64,149
https://kawalpemilu.org#75574,"BONDA, PAPALANG, MAMUJU, SULAWESI BARAT",2,157,57,214
https://kawalpemilu.org#75574,"BONDA, PAPALANG, MAMUJU, SULAWESI BARAT",3,132,112,244
https://kawalpemilu.org#75574,"BONDA, PAPALANG, MAMUJU, SULAWESI BARAT",4,146,120,266
https://kawalpemilu.org#75574,"BONDA, PAPALANG, MAMUJU, SULAWESI BARAT",5,117,62,179
https://kawalpemilu.org#75574,"BONDA, PAPALANG, MAMUJU, SULAWESI BARAT",6,38,12,50
https://kawalpemilu.org#75574,"BONDA, PAPALANG, MAMUJU, SULAWESI BARAT",7,162,86,248
https://kawalpemilu.org#75574,"BONDA, PAPALANG, MAMUJU, SULAWESI BARAT",8,112,57,169
https://kawalpemilu.org#75574,"BONDA, PAPALANG, MAMUJU, SULAWESI BARAT",9,108,69,177
https://kawalpemilu.org#75575,"TOPORE, PAPALANG, MAMUJU, SULAWESI BARAT",2,128,105,233
https://kawalpemilu.org#75575,"TOPORE, PAPALANG, MAMUJU, SULAWESI BARAT",3,87,136,223
https://kawalpemilu.org#75575,"TOPORE, PAPALANG, MAMUJU, SULAWESI BARAT",4,93,122,215
https://kawalpemilu.org#75575,"TOPORE, PAPALANG, MAMUJU, SULAWESI BARAT",5,82,126,208
https://kawalpemilu.org#75575,"TOPORE, PAPALANG, MAMUJU, SULAWESI BARAT",6,40,2,42
https://kawalpemilu.org#75575,"TOPORE, PAPALANG, MAMUJU, SULAWESI BARAT",7,39,50,89
https://kawalpemilu.org#75575,"TOPORE, PAPALANG, MAMUJU, SULAWESI BARAT",8,122,36,158
https://kawalpemilu.org#75575,"TOPORE, PAPALANG, MAMUJU, SULAWESI BARAT",9,109,69,178
https://kawalpemilu.org#75575,"TOPORE, PAPALANG, MAMUJU, SULAWESI BARAT",10,82,106,188
https://kawalpemilu.org#75576,"SALUKAYU, PAPALANG, MAMUJU, SULAWESI BARAT",1,121,73,194
https://kawalpemilu.org#75576,"SALUKAYU, PAPALANG, MAMUJU, SULAWESI BARAT",2,122,86,208
https://kawalpemilu.org#75576,"SALUKAYU, PAPALANG, MAMUJU, SULAWESI BARAT",3,144,77,220
https://kawalpemilu.org#75576,"SALUKAYU, PAPALANG, MAMUJU, SULAWESI BARAT",4,118,19,137
https://kawalpemilu.org#75576,"SALUKAYU, PAPALANG, MAMUJU, SULAWESI BARAT",5,70,90,160
https://kawalpemilu.org#75576,"SALUKAYU, PAPALANG, MAMUJU, SULAWESI BARAT",6,103,100,203
https://kawalpemilu.org#75576,"SALUKAYU, PAPALANG, MAMUJU, SULAWESI BARAT",7,35,84,119
https://kawalpemilu.org#75577,"SUKADAMAI, PAPALANG, MAMUJU, SULAWESI BARAT",1,114,145,259
https://kawalpemilu.org#75577,"SUKADAMAI, PAPALANG, MAMUJU, SULAWESI BARAT",2,57,59,116
https://kawalpemilu.org#75577,"SUKADAMAI, PAPALANG, MAMUJU, SULAWESI BARAT",3,76,57,133
https://kawalpemilu.org#75578,"BODA-BODA, PAPALANG, MAMUJU, SULAWESI BARAT",1,224,20,244
https://kawalpemilu.org#75578,"BODA-BODA, PAPALANG, MAMUJU, SULAWESI BARAT",2,208,19,227
https://kawalpemilu.org#75578,"BODA-BODA, PAPALANG, MAMUJU, SULAWESI BARAT",3,207,50,257
https://kawalpemilu.org#75578,"BODA-BODA, PAPALANG, MAMUJU, SULAWESI BARAT",4,45,10,55
https://kawalpemilu.org#75578,"BODA-BODA, PAPALANG, MAMUJU, SULAWESI BARAT",5,164,18,182
https://kawalpemilu.org#75579,"SISANGO, PAPALANG, MAMUJU, SULAWESI BARAT",1,150,35,185
https://kawalpemilu.org#75579,"SISANGO, PAPALANG, MAMUJU, SULAWESI BARAT",2,168,6,174
https://kawalpemilu.org#75579,"SISANGO, PAPALANG, MAMUJU, SULAWESI BARAT",3,96,7,103
https://kawalpemilu.org#75580,"BATU AMPA, PAPALANG, MAMUJU, SULAWESI BARAT",1,142,70,212
https://kawalpemilu.org#75580,"BATU AMPA, PAPALANG, MAMUJU, SULAWESI BARAT",2,153,81,234
https://kawalpemilu.org#75580,"BATU AMPA, PAPALANG, MAMUJU, SULAWESI BARAT",3,105,54,159
https://kawalpemilu.org#75580,"BATU AMPA, PAPALANG, MAMUJU, SULAWESI BARAT",4,102,44,146
https://kawalpemilu.org#75582,"BUNDE, SAMPAGA, MAMUJU, SULAWESI BARAT",1,170,59,229
https://kawalpemilu.org#75582,"BUNDE, SAMPAGA, MAMUJU, SULAWESI BARAT",2,129,27,156
https://kawalpemilu.org#75582,"BUNDE, SAMPAGA, MAMUJU, SULAWESI BARAT",3,161,23,184
https://kawalpemilu.org#75582,"BUNDE, SAMPAGA, MAMUJU, SULAWESI BARAT",4,135,66,201
https://kawalpemilu.org#75582,"BUNDE, SAMPAGA, MAMUJU, SULAWESI BARAT",5,188,72,260
https://kawalpemilu.org#75582,"BUNDE, SAMPAGA, MAMUJU, SULAWESI BARAT",6,134,81,215
https://kawalpemilu.org#75582,"BUNDE, SAMPAGA, MAMUJU, SULAWESI BARAT",7,131,87,218
https://kawalpemilu.org#75582,"BUNDE, SAMPAGA, MAMUJU, SULAWESI BARAT",8,137,102,239
https://kawalpemilu.org#75582,"BUNDE, SAMPAGA, MAMUJU, SULAWESI BARAT",9,0,0,0
https://kawalpemilu.org#75582,"BUNDE, SAMPAGA, MAMUJU, SULAWESI BARAT",10,206,43,249
https://kawalpemilu.org#75582,"BUNDE, SAMPAGA, MAMUJU, SULAWESI BARAT",11,152,62,214
https://kawalpemilu.org#75582,"BUNDE, SAMPAGA, MAMUJU, SULAWESI BARAT",12,66,25,91
https://kawalpemilu.org#75583,"KALONDING, SAMPAGA, MAMUJU, SULAWESI BARAT",1,172,80,252
https://kawalpemilu.org#75583,"KALONDING, SAMPAGA, MAMUJU, SULAWESI BARAT",2,118,97,215
https://kawalpemilu.org#75583,"KALONDING, SAMPAGA, MAMUJU, SULAWESI BARAT",3,41,74,115
https://kawalpemilu.org#75583,"KALONDING, SAMPAGA, MAMUJU, SULAWESI BARAT",4,193,50,243
https://kawalpemilu.org#75583,"KALONDING, SAMPAGA, MAMUJU, SULAWESI BARAT",5,147,57,204
https://kawalpemilu.org#75583,"KALONDING, SAMPAGA, MAMUJU, SULAWESI BARAT",6,62,11,73
https://kawalpemilu.org#75583,"KALONDING, SAMPAGA, MAMUJU, SULAWESI BARAT",7,94,92,186
https://kawalpemilu.org#75583,"KALONDING, SAMPAGA, MAMUJU, SULAWESI BARAT",8,156,58,214
https://kawalpemilu.org#75583,"KALONDING, SAMPAGA, MAMUJU, SULAWESI BARAT",9,104,20,124
https://kawalpemilu.org#75583,"KALONDING, SAMPAGA, MAMUJU, SULAWESI BARAT",10,40,5,45
https://kawalpemilu.org#75583,"KALONDING, SAMPAGA, MAMUJU, SULAWESI BARAT",11,66,13,79
https://kawalpemilu.org#75583,"KALONDING, SAMPAGA, MAMUJU, SULAWESI BARAT",12,136,86,222
https://kawalpemilu.org#75584,"TARAILU, SAMPAGA, MAMUJU, SULAWESI BARAT",1,163,99,262
https://kawalpemilu.org#75584,"TARAILU, SAMPAGA, MAMUJU, SULAWESI BARAT",2,156,87,243
https://kawalpemilu.org#75584,"TARAILU, SAMPAGA, MAMUJU, SULAWESI BARAT",3,176,96,272
https://kawalpemilu.org#75584,"TARAILU, SAMPAGA, MAMUJU, SULAWESI BARAT",4,90,68,158
https://kawalpemilu.org#75584,"TARAILU, SAMPAGA, MAMUJU, SULAWESI BARAT",5,211,73,284
https://kawalpemilu.org#75584,"TARAILU, SAMPAGA, MAMUJU, SULAWESI BARAT",6,166,78,244
https://kawalpemilu.org#75584,"TARAILU, SAMPAGA, MAMUJU, SULAWESI BARAT",7,181,88,269
https://kawalpemilu.org#75584,"TARAILU, SAMPAGA, MAMUJU, SULAWESI BARAT",8,133,61,194
https://kawalpemilu.org#75584,"TARAILU, SAMPAGA, MAMUJU, SULAWESI BARAT",9,122,75,197
https://kawalpemilu.org#75584,"TARAILU, SAMPAGA, MAMUJU, SULAWESI BARAT",10,47,31,78
https://kawalpemilu.org#75585,"SAMPAGA, SAMPAGA, MAMUJU, SULAWESI BARAT",1,136,70,206
https://kawalpemilu.org#75585,"SAMPAGA, SAMPAGA, MAMUJU, SULAWESI BARAT",2,110,19,129
https://kawalpemilu.org#75585,"SAMPAGA, SAMPAGA, MAMUJU, SULAWESI BARAT",3,169,69,238
https://kawalpemilu.org#75585,"SAMPAGA, SAMPAGA, MAMUJU, SULAWESI BARAT",4,142,30,172
https://kawalpemilu.org#75585,"SAMPAGA, SAMPAGA, MAMUJU, SULAWESI BARAT",5,134,15,149
https://kawalpemilu.org#75586,"TANAMBUAH, SAMPAGA, MAMUJU, SULAWESI BARAT",1,114,39,173
https://kawalpemilu.org#75586,"TANAMBUAH, SAMPAGA, MAMUJU, SULAWESI BARAT",2,135,68,203
https://kawalpemilu.org#75587,"SALUBARANA, SAMPAGA, MAMUJU, SULAWESI BARAT",1,59,112,171
https://kawalpemilu.org#75587,"SALUBARANA, SAMPAGA, MAMUJU, SULAWESI BARAT",2,56,121,177
https://kawalpemilu.org#75587,"SALUBARANA, SAMPAGA, MAMUJU, SULAWESI BARAT",3,48,111,159
https://kawalpemilu.org#75588,"LOSSO, SAMPAGA, MAMUJU, SULAWESI BARAT",1,150,57,207
https://kawalpemilu.org#75588,"LOSSO, SAMPAGA, MAMUJU, SULAWESI BARAT",2,122,34,156
https://kawalpemilu.org#75588,"LOSSO, SAMPAGA, MAMUJU, SULAWESI BARAT",3,106,37,143
https://kawalpemilu.org#75588,"LOSSO, SAMPAGA, MAMUJU, SULAWESI BARAT",4,119,25,144
https://kawalpemilu.org#75618,"TOMMO, TOMMO, MAMUJU, SULAWESI BARAT",1,194,8,202
https://kawalpemilu.org#75618,"TOMMO, TOMMO, MAMUJU, SULAWESI BARAT",2,225,15,240
https://kawalpemilu.org#75618,"TOMMO, TOMMO, MAMUJU, SULAWESI BARAT",3,214,14,228
https://kawalpemilu.org#75618,"TOMMO, TOMMO, MAMUJU, SULAWESI BARAT",4,177,33,210
https://kawalpemilu.org#75618,"TOMMO, TOMMO, MAMUJU, SULAWESI BARAT",5,221,13,234
https://kawalpemilu.org#75618,"TOMMO, TOMMO, MAMUJU, SULAWESI BARAT",6,188,30,218
https://kawalpemilu.org#75618,"TOMMO, TOMMO, MAMUJU, SULAWESI BARAT",7,194,15,209
https://kawalpemilu.org#75619,"CAMPALOGA, TOMMO, MAMUJU, SULAWESI BARAT",1,88,82,170
https://kawalpemilu.org#75619,"CAMPALOGA, TOMMO, MAMUJU, SULAWESI BARAT",2,127,84,211
https://kawalpemilu.org#75619,"CAMPALOGA, TOMMO, MAMUJU, SULAWESI BARAT",3,136,40,176
https://kawalpemilu.org#75619,"CAMPALOGA, TOMMO, MAMUJU, SULAWESI BARAT",4,146,73,219
https://kawalpemilu.org#75619,"CAMPALOGA, TOMMO, MAMUJU, SULAWESI BARAT",5,127,73,200
https://kawalpemilu.org#75619,"CAMPALOGA, TOMMO, MAMUJU, SULAWESI BARAT",6,82,92,174
https://kawalpemilu.org#75619,"CAMPALOGA, TOMMO, MAMUJU, SULAWESI BARAT",7,189,31,220
https://kawalpemilu.org#75619,"CAMPALOGA, TOMMO, MAMUJU, SULAWESI BARAT",8,148,12,160
https://kawalpemilu.org#75620,"BUANA SAKTI, TOMMO, MAMUJU, SULAWESI BARAT",1,113,92,205
https://kawalpemilu.org#75620,"BUANA SAKTI, TOMMO, MAMUJU, SULAWESI BARAT",2,97,34,131
https://kawalpemilu.org#75620,"BUANA SAKTI, TOMMO, MAMUJU, SULAWESI BARAT",3,166,15,181
https://kawalpemilu.org#75620,"BUANA SAKTI, TOMMO, MAMUJU, SULAWESI BARAT",4,162,40,202
https://kawalpemilu.org#75620,"BUANA SAKTI, TOMMO, MAMUJU, SULAWESI BARAT",5,196,33,229
https://kawalpemilu.org#75621,"TAMEMONGGA, TOMMO, MAMUJU, SULAWESI BARAT",1,116,82,198
https://kawalpemilu.org#75621,"TAMEMONGGA, TOMMO, MAMUJU, SULAWESI BARAT",2,112,26,138
https://kawalpemilu.org#75621,"TAMEMONGGA, TOMMO, MAMUJU, SULAWESI BARAT",3,138,40,178
https://kawalpemilu.org#75621,"TAMEMONGGA, TOMMO, MAMUJU, SULAWESI BARAT",4,190,8,198
https://kawalpemilu.org#75621,"TAMEMONGGA, TOMMO, MAMUJU, SULAWESI BARAT",5,83,34,117
https://kawalpemilu.org#75621,"TAMEMONGGA, TOMMO, MAMUJU, SULAWESI BARAT",6,126,42,168
https://kawalpemilu.org#75622,"TAMEJARRA, TOMMO, MAMUJU, SULAWESI BARAT",1,115,55,170
https://kawalpemilu.org#75622,"TAMEJARRA, TOMMO, MAMUJU, SULAWESI BARAT",2,122,102,224
https://kawalpemilu.org#75622,"TAMEJARRA, TOMMO, MAMUJU, SULAWESI BARAT",3,125,67,192
https://kawalpemilu.org#75622,"TAMEJARRA, TOMMO, MAMUJU, SULAWESI BARAT",4,158,70,228
https://kawalpemilu.org#75623,"RANTEMARIO, TOMMO, MAMUJU, SULAWESI BARAT",1,195,61,256
https://kawalpemilu.org#75623,"RANTEMARIO, TOMMO, MAMUJU, SULAWESI BARAT",2,107,68,175
https://kawalpemilu.org#75623,"RANTEMARIO, TOMMO, MAMUJU, SULAWESI BARAT",3,98,32,130
https://kawalpemilu.org#75623,"RANTEMARIO, TOMMO, MAMUJU, SULAWESI BARAT",4,145,16,161
https://kawalpemilu.org#75624,"MALINO, TOMMO, MAMUJU, SULAWESI BARAT",1,143,66,209
https://kawalpemilu.org#75624,"MALINO, TOMMO, MAMUJU, SULAWESI BARAT",2,83,82,165
https://kawalpemilu.org#75625,"KAKULLASANG, TOMMO, MAMUJU, SULAWESI BARAT",1,179,14,193
https://kawalpemilu.org#75625,"KAKULLASANG, TOMMO, MAMUJU, SULAWESI BARAT",2,201,9,210
https://kawalpemilu.org#75625,"KAKULLASANG, TOMMO, MAMUJU, SULAWESI BARAT",3,224,27,251
https://kawalpemilu.org#75625,"KAKULLASANG, TOMMO, MAMUJU, SULAWESI BARAT",4,203,15,218
https://kawalpemilu.org#75625,"KAKULLASANG, TOMMO, MAMUJU, SULAWESI BARAT",5,174,33,207
https://kawalpemilu.org#75625,"KAKULLASANG, TOMMO, MAMUJU, SULAWESI BARAT",6,98,40,138
https://kawalpemilu.org#75625,"KAKULLASANG, TOMMO, MAMUJU, SULAWESI BARAT",7,181,31,212
https://kawalpemilu.org#75625,"KAKULLASANG, TOMMO, MAMUJU, SULAWESI BARAT",8,59,8,67
https://kawalpemilu.org#75626,"LELING, TOMMO, MAMUJU, SULAWESI BARAT",1,101,80,181
https://kawalpemilu.org#75626,"LELING, TOMMO, MAMUJU, SULAWESI BARAT",2,73,23,96
https://kawalpemilu.org#75626,"LELING, TOMMO, MAMUJU, SULAWESI BARAT",3,43,5,48
https://kawalpemilu.org#75626,"LELING, TOMMO, MAMUJU, SULAWESI BARAT",4,130,53,183
https://kawalpemilu.org#75627,"KALEPU, TOMMO, MAMUJU, SULAWESI BARAT",1,134,20,154
https://kawalpemilu.org#75627,"KALEPU, TOMMO, MAMUJU, SULAWESI BARAT",2,159,83,242
https://kawalpemilu.org#75627,"KALEPU, TOMMO, MAMUJU, SULAWESI BARAT",3,35,15,50
https://kawalpemilu.org#75628,"SANDANA, TOMMO, MAMUJU, SULAWESI BARAT",1,166,14,180
https://kawalpemilu.org#75628,"SANDANA, TOMMO, MAMUJU, SULAWESI BARAT",2,172,17,189
https://kawalpemilu.org#75628,"SANDANA, TOMMO, MAMUJU, SULAWESI BARAT",3,242,8,250
https://kawalpemilu.org#75628,"SANDANA, TOMMO, MAMUJU, SULAWESI BARAT",4,25,53,78
https://kawalpemilu.org#75628,"SANDANA, TOMMO, MAMUJU, SULAWESI BARAT",5,145,33,178
https://kawalpemilu.org#75629,"LELING BARAT, TOMMO, MAMUJU, SULAWESI BARAT",1,137,27,164
https://kawalpemilu.org#75629,"LELING BARAT, TOMMO, MAMUJU, SULAWESI BARAT",2,176,48,224
https://kawalpemilu.org#75629,"LELING BARAT, TOMMO, MAMUJU, SULAWESI BARAT",3,65,18,83
https://kawalpemilu.org#75629,"LELING BARAT, TOMMO, MAMUJU, SULAWESI BARAT",4,129,31,160
https://kawalpemilu.org#75630,"LELING UTARA, TOMMO, MAMUJU, SULAWESI BARAT",1,216,8,224
https://kawalpemilu.org#75630,"LELING UTARA, TOMMO, MAMUJU, SULAWESI BARAT",2,143,46,189
https://kawalpemilu.org#75630,"LELING UTARA, TOMMO, MAMUJU, SULAWESI BARAT",3,152,12,164
https://kawalpemilu.org#75630,"LELING UTARA, TOMMO, MAMUJU, SULAWESI BARAT",4,67,8,75
https://kawalpemilu.org#75630,"LELING UTARA, TOMMO, MAMUJU, SULAWESI BARAT",5,122,14,136
https://kawalpemilu.org#75630,"LELING UTARA, TOMMO, MAMUJU, SULAWESI BARAT",6,71,5,76
https://kawalpemilu.org#75631,"SALUDENGEN, TOMMO, MAMUJU, SULAWESI BARAT",1,200,33,233
https://kawalpemilu.org#75631,"SALUDENGEN, TOMMO, MAMUJU, SULAWESI BARAT",2,63,24,87
https://kawalpemilu.org#75631,"SALUDENGEN, TOMMO, MAMUJU, SULAWESI BARAT",3,132,30,162
https://kawalpemilu.org#75631,"SALUDENGEN, TOMMO, MAMUJU, SULAWESI BARAT",4,88,3,91
https://kawalpemilu.org#75631,"SALUDENGEN, TOMMO, MAMUJU, SULAWESI BARAT",5,68,27,95
https://kawalpemilu.org#75633,"SIMBORO, SIMBORO, MAMUJU, SULAWESI BARAT",1,56,102,158
https://kawalpemilu.org#75633,"SIMBORO, SIMBORO, MAMUJU, SULAWESI BARAT",2,70,124,194
https://kawalpemilu.org#75633,"SIMBORO, SIMBORO, MAMUJU, SULAWESI BARAT",4,52,49,101
https://kawalpemilu.org#75633,"SIMBORO, SIMBORO, MAMUJU, SULAWESI BARAT",5,72,90,162
https://kawalpemilu.org#75633,"SIMBORO, SIMBORO, MAMUJU, SULAWESI BARAT",6,56,70,0
https://kawalpemilu.org#75633,"SIMBORO, SIMBORO, MAMUJU, SULAWESI BARAT",7,51,59,110
https://kawalpemilu.org#75633,"SIMBORO, SIMBORO, MAMUJU, SULAWESI BARAT",8,27,62,89
https://kawalpemilu.org#75633,"SIMBORO, SIMBORO, MAMUJU, SULAWESI BARAT",9,38,52,90
https://kawalpemilu.org#75633,"SIMBORO, SIMBORO, MAMUJU, SULAWESI BARAT",10,70,94,164
https://kawalpemilu.org#75633,"SIMBORO, SIMBORO, MAMUJU, SULAWESI BARAT",11,101,145,246
https://kawalpemilu.org#75633,"SIMBORO, SIMBORO, MAMUJU, SULAWESI BARAT",12,86,147,233
https://kawalpemilu.org#75633,"SIMBORO, SIMBORO, MAMUJU, SULAWESI BARAT",13,88,101,189
https://kawalpemilu.org#75633,"SIMBORO, SIMBORO, MAMUJU, SULAWESI BARAT",14,72,95,167
https://kawalpemilu.org#75633,"SIMBORO, SIMBORO, MAMUJU, SULAWESI BARAT",15,84,80,164
https://kawalpemilu.org#75633,"SIMBORO, SIMBORO, MAMUJU, SULAWESI BARAT",16,73,142,215
https://kawalpemilu.org#75633,"SIMBORO, SIMBORO, MAMUJU, SULAWESI BARAT",17,64,132,196
https://kawalpemilu.org#75633,"SIMBORO, SIMBORO, MAMUJU, SULAWESI BARAT",18,69,112,181
https://kawalpemilu.org#75633,"SIMBORO, SIMBORO, MAMUJU, SULAWESI BARAT",19,70,75,45
https://kawalpemilu.org#75633,"SIMBORO, SIMBORO, MAMUJU, SULAWESI BARAT",20,87,100,187
https://kawalpemilu.org#75633,"SIMBORO, SIMBORO, MAMUJU, SULAWESI BARAT",21,104,100,203
https://kawalpemilu.org#75633,"SIMBORO, SIMBORO, MAMUJU, SULAWESI BARAT",22,79,134,213
https://kawalpemilu.org#75633,"SIMBORO, SIMBORO, MAMUJU, SULAWESI BARAT",23,136,104,240
https://kawalpemilu.org#75633,"SIMBORO, SIMBORO, MAMUJU, SULAWESI BARAT",24,81,145,226
https://kawalpemilu.org#75633,"SIMBORO, SIMBORO, MAMUJU, SULAWESI BARAT",25,59,119,178
https://kawalpemilu.org#75633,"SIMBORO, SIMBORO, MAMUJU, SULAWESI BARAT",26,100,77,177
https://kawalpemilu.org#75633,"SIMBORO, SIMBORO, MAMUJU, SULAWESI BARAT",27,63,62,125
https://kawalpemilu.org#75633,"SIMBORO, SIMBORO, MAMUJU, SULAWESI BARAT",28,34,85,119
https://kawalpemilu.org#75633,"SIMBORO, SIMBORO, MAMUJU, SULAWESI BARAT",29,65,90,155
https://kawalpemilu.org#75633,"SIMBORO, SIMBORO, MAMUJU, SULAWESI BARAT",30,44,85,129
https://kawalpemilu.org#75633,"SIMBORO, SIMBORO, MAMUJU, SULAWESI BARAT",31,64,119,183
https://kawalpemilu.org#75633,"SIMBORO, SIMBORO, MAMUJU, SULAWESI BARAT",32,58,116,174
https://kawalpemilu.org#75633,"SIMBORO, SIMBORO, MAMUJU, SULAWESI BARAT",33,53,106,159
https://kawalpemilu.org#75633,"SIMBORO, SIMBORO, MAMUJU, SULAWESI BARAT",34,74,136,210
https://kawalpemilu.org#75633,"SIMBORO, SIMBORO, MAMUJU, SULAWESI BARAT",35,69,107,176
https://kawalpemilu.org#75633,"SIMBORO, SIMBORO, MAMUJU, SULAWESI BARAT",36,65,139,204
https://kawalpemilu.org#75633,"SIMBORO, SIMBORO, MAMUJU, SULAWESI BARAT",37,80,102,182
https://kawalpemilu.org#75633,"SIMBORO, SIMBORO, MAMUJU, SULAWESI BARAT",38,34,39,73
https://kawalpemilu.org#75633,"SIMBORO, SIMBORO, MAMUJU, SULAWESI BARAT",39,87,92,179
https://kawalpemilu.org#75633,"SIMBORO, SIMBORO, MAMUJU, SULAWESI BARAT",40,159,53,112
https://kawalpemilu.org#75633,"SIMBORO, SIMBORO, MAMUJU, SULAWESI BARAT",41,100,60,160
https://kawalpemilu.org#75634,"RANGAS, SIMBORO, MAMUJU, SULAWESI BARAT",2,95,110,205
https://kawalpemilu.org#75634,"RANGAS, SIMBORO, MAMUJU, SULAWESI BARAT",3,112,116,228
https://kawalpemilu.org#75634,"RANGAS, SIMBORO, MAMUJU, SULAWESI BARAT",4,97,53,150
https://kawalpemilu.org#75634,"RANGAS, SIMBORO, MAMUJU, SULAWESI BARAT",5,126,40,166
https://kawalpemilu.org#75634,"RANGAS, SIMBORO, MAMUJU, SULAWESI BARAT",6,194,32,226
https://kawalpemilu.org#75634,"RANGAS, SIMBORO, MAMUJU, SULAWESI BARAT",7,116,87,203
https://kawalpemilu.org#75634,"RANGAS, SIMBORO, MAMUJU, SULAWESI BARAT",8,99,112,211
https://kawalpemilu.org#75634,"RANGAS, SIMBORO, MAMUJU, SULAWESI BARAT",9,63,79,142
https://kawalpemilu.org#75634,"RANGAS, SIMBORO, MAMUJU, SULAWESI BARAT",10,145,76,221
https://kawalpemilu.org#75634,"RANGAS, SIMBORO, MAMUJU, SULAWESI BARAT",11,32,75,107
https://kawalpemilu.org#75634,"RANGAS, SIMBORO, MAMUJU, SULAWESI BARAT",12,67,104,171
https://kawalpemilu.org#75634,"RANGAS, SIMBORO, MAMUJU, SULAWESI BARAT",13,133,46,179
https://kawalpemilu.org#75634,"RANGAS, SIMBORO, MAMUJU, SULAWESI BARAT",14,101,85,186
https://kawalpemilu.org#75635,"BOTTENG, SIMBORO, MAMUJU, SULAWESI BARAT",1,81,92,173
https://kawalpemilu.org#75635,"BOTTENG, SIMBORO, MAMUJU, SULAWESI BARAT",2,80,77,157
https://kawalpemilu.org#75635,"BOTTENG, SIMBORO, MAMUJU, SULAWESI BARAT",3,62,96,158
https://kawalpemilu.org#75635,"BOTTENG, SIMBORO, MAMUJU, SULAWESI BARAT",4,128,37,165
https://kawalpemilu.org#75635,"BOTTENG, SIMBORO, MAMUJU, SULAWESI BARAT",5,162,85,247
https://kawalpemilu.org#75635,"BOTTENG, SIMBORO, MAMUJU, SULAWESI BARAT",6,48,33,81
https://kawalpemilu.org#75635,"BOTTENG, SIMBORO, MAMUJU, SULAWESI BARAT",7,63,23,86
https://kawalpemilu.org#75636,"SALETTO, SIMBORO, MAMUJU, SULAWESI BARAT",1,105,45,150
https://kawalpemilu.org#75636,"SALETTO, SIMBORO, MAMUJU, SULAWESI BARAT",2,142,108,250
https://kawalpemilu.org#75636,"SALETTO, SIMBORO, MAMUJU, SULAWESI BARAT",3,84,61,145
https://kawalpemilu.org#75636,"SALETTO, SIMBORO, MAMUJU, SULAWESI BARAT",4,73,180,253
https://kawalpemilu.org#75636,"SALETTO, SIMBORO, MAMUJU, SULAWESI BARAT",5,113,155,268
https://kawalpemilu.org#75636,"SALETTO, SIMBORO, MAMUJU, SULAWESI BARAT",6,113,142,255
https://kawalpemilu.org#75636,"SALETTO, SIMBORO, MAMUJU, SULAWESI BARAT",7,91,64,155
https://kawalpemilu.org#75636,"SALETTO, SIMBORO, MAMUJU, SULAWESI BARAT",8,87,60,147
https://kawalpemilu.org#75636,"SALETTO, SIMBORO, MAMUJU, SULAWESI BARAT",9,128,24,152
https://kawalpemilu.org#75636,"SALETTO, SIMBORO, MAMUJU, SULAWESI BARAT",10,94,93,187
https://kawalpemilu.org#75636,"SALETTO, SIMBORO, MAMUJU, SULAWESI BARAT",11,89,28,117
https://kawalpemilu.org#75637,"SUMARE, SIMBORO, MAMUJU, SULAWESI BARAT",1,200,31,231
https://kawalpemilu.org#75637,"SUMARE, SIMBORO, MAMUJU, SULAWESI BARAT",2,255,55,279
https://kawalpemilu.org#75637,"SUMARE, SIMBORO, MAMUJU, SULAWESI BARAT",3,236,33,269
https://kawalpemilu.org#75637,"SUMARE, SIMBORO, MAMUJU, SULAWESI BARAT",4,220,51,271
https://kawalpemilu.org#75637,"SUMARE, SIMBORO, MAMUJU, SULAWESI BARAT",5,204,39,243
https://kawalpemilu.org#75637,"SUMARE, SIMBORO, MAMUJU, SULAWESI BARAT",6,233,55,288
https://kawalpemilu.org#75639,"BOTTENG UTARA, SIMBORO, MAMUJU, SULAWESI BARAT",1,79,88,167
https://kawalpemilu.org#75639,"BOTTENG UTARA, SIMBORO, MAMUJU, SULAWESI BARAT",2,51,155,206
https://kawalpemilu.org#75639,"BOTTENG UTARA, SIMBORO, MAMUJU, SULAWESI BARAT",4,124,34,158
https://kawalpemilu.org#75639,"BOTTENG UTARA, SIMBORO, MAMUJU, SULAWESI BARAT",5,50,53,103
https://kawalpemilu.org#75639,"BOTTENG UTARA, SIMBORO, MAMUJU, SULAWESI BARAT",6,117,74,191
https://kawalpemilu.org#75639,"BOTTENG UTARA, SIMBORO, MAMUJU, SULAWESI BARAT",7,116,76,192
https://kawalpemilu.org#75640,"TAPANDULLU, SIMBORO, MAMUJU, SULAWESI BARAT",1,160,101,261
https://kawalpemilu.org#75640,"TAPANDULLU, SIMBORO, MAMUJU, SULAWESI BARAT",2,149,77,226
https://kawalpemilu.org#75641,"PATI'DI, SIMBORO, MAMUJU, SULAWESI BARAT",1,47,149,196
https://kawalpemilu.org#75641,"PATI'DI, SIMBORO, MAMUJU, SULAWESI BARAT",2,78,180,258
https://kawalpemilu.org#75641,"PATI'DI, SIMBORO, MAMUJU, SULAWESI BARAT",3,56,81,137
https://kawalpemilu.org#75641,"PATI'DI, SIMBORO, MAMUJU, SULAWESI BARAT",4,78,135,213
https://kawalpemilu.org#75641,"PATI'DI, SIMBORO, MAMUJU, SULAWESI BARAT",5,70,117,187
https://kawalpemilu.org#75641,"PATI'DI, SIMBORO, MAMUJU, SULAWESI BARAT",6,34,23,57
https://kawalpemilu.org#75644,"DUNGKAIT, TAPALANG BARAT, MAMUJU, SULAWESI BARAT",1,109,157,266
https://kawalpemilu.org#75644,"DUNGKAIT, TAPALANG BARAT, MAMUJU, SULAWESI BARAT",2,74,151,225
https://kawalpemilu.org#75644,"DUNGKAIT, TAPALANG BARAT, MAMUJU, SULAWESI BARAT",3,58,120,178
https://kawalpemilu.org#75644,"DUNGKAIT, TAPALANG BARAT, MAMUJU, SULAWESI BARAT",4,42,118,160
https://kawalpemilu.org#75644,"DUNGKAIT, TAPALANG BARAT, MAMUJU, SULAWESI BARAT",5,42,20,62
https://kawalpemilu.org#75645,"LEBANI, TAPALANG BARAT, MAMUJU, SULAWESI BARAT",1,102,153,255
https://kawalpemilu.org#75645,"LEBANI, TAPALANG BARAT, MAMUJU, SULAWESI BARAT",2,58,143,201
https://kawalpemilu.org#75645,"LEBANI, TAPALANG BARAT, MAMUJU, SULAWESI BARAT",3,190,50,240
https://kawalpemilu.org#75645,"LEBANI, TAPALANG BARAT, MAMUJU, SULAWESI BARAT",4,112,66,178
https://kawalpemilu.org#75646,"LABUANG RANO, TAPALANG BARAT, MAMUJU, SULAWESI BARAT",1,90,113,203
https://kawalpemilu.org#75646,"LABUANG RANO, TAPALANG BARAT, MAMUJU, SULAWESI BARAT",2,109,121,230
https://kawalpemilu.org#75646,"LABUANG RANO, TAPALANG BARAT, MAMUJU, SULAWESI BARAT",3,86,26,112
https://kawalpemilu.org#75646,"LABUANG RANO, TAPALANG BARAT, MAMUJU, SULAWESI BARAT",4,82,90,172
https://kawalpemilu.org#75646,"LABUANG RANO, TAPALANG BARAT, MAMUJU, SULAWESI BARAT",5,66,120,186
https://kawalpemilu.org#75646,"LABUANG RANO, TAPALANG BARAT, MAMUJU, SULAWESI BARAT",6,106,20,126
https://kawalpemilu.org#75646,"LABUANG RANO, TAPALANG BARAT, MAMUJU, SULAWESI BARAT",7,47,71,118
https://kawalpemilu.org#75646,"LABUANG RANO, TAPALANG BARAT, MAMUJU, SULAWESI BARAT",8,65,52,117
https://kawalpemilu.org#75647,"PASABU, TAPALANG BARAT, MAMUJU, SULAWESI BARAT",1,0,0,0
https://kawalpemilu.org#75647,"PASABU, TAPALANG BARAT, MAMUJU, SULAWESI BARAT",3,144,126,270
https://kawalpemilu.org#75647,"PASABU, TAPALANG BARAT, MAMUJU, SULAWESI BARAT",4,112,117,229
https://kawalpemilu.org#75648,"TANETE PAO, TAPALANG BARAT, MAMUJU, SULAWESI BARAT",1,127,55,182
https://kawalpemilu.org#75648,"TANETE PAO, TAPALANG BARAT, MAMUJU, SULAWESI BARAT",2,131,54,185
https://kawalpemilu.org#75649,"PANGASAAN, TAPALANG BARAT, MAMUJU, SULAWESI BARAT",1,68,68,136
https://kawalpemilu.org#75649,"PANGASAAN, TAPALANG BARAT, MAMUJU, SULAWESI BARAT",2,56,28,84
https://kawalpemilu.org#75649,"PANGASAAN, TAPALANG BARAT, MAMUJU, SULAWESI BARAT",3,140,30,170
https://kawalpemilu.org#75649,"PANGASAAN, TAPALANG BARAT, MAMUJU, SULAWESI BARAT",4,59,49,108
https://kawalpemilu.org#75650,"AHU, TAPALANG BARAT, MAMUJU, SULAWESI BARAT",1,98,59,157
https://kawalpemilu.org#75650,"AHU, TAPALANG BARAT, MAMUJU, SULAWESI BARAT",2,96,81,177
https://kawalpemilu.org#75650,"AHU, TAPALANG BARAT, MAMUJU, SULAWESI BARAT",3,83,95,178
https://kawalpemilu.org#75650,"AHU, TAPALANG BARAT, MAMUJU, SULAWESI BARAT",4,106,87,193
https://kawalpemilu.org#75661,"BONEHAU, BONEHAU, MAMUJU, SULAWESI BARAT",1,122,130,153
https://kawalpemilu.org#75661,"BONEHAU, BONEHAU, MAMUJU, SULAWESI BARAT",2,108,30,138
https://kawalpemilu.org#75661,"BONEHAU, BONEHAU, MAMUJU, SULAWESI BARAT",3,132,50,182
https://kawalpemilu.org#75661,"BONEHAU, BONEHAU, MAMUJU, SULAWESI BARAT",4,97,56,153
https://kawalpemilu.org#75661,"BONEHAU, BONEHAU, MAMUJU, SULAWESI BARAT",5,149,39,188
https://kawalpemilu.org#75661,"BONEHAU, BONEHAU, MAMUJU, SULAWESI BARAT",6,188,19,207
https://kawalpemilu.org#75661,"BONEHAU, BONEHAU, MAMUJU, SULAWESI BARAT",7,170,9,179
https://kawalpemilu.org#75661,"BONEHAU, BONEHAU, MAMUJU, SULAWESI BARAT",8,102,7,109
https://kawalpemilu.org#75661,"BONEHAU, BONEHAU, MAMUJU, SULAWESI BARAT",9,78,15,93
https://kawalpemilu.org#75662,"SALUTIWO, BONEHAU, MAMUJU, SULAWESI BARAT",1,135,8,143
https://kawalpemilu.org#75662,"SALUTIWO, BONEHAU, MAMUJU, SULAWESI BARAT",2,178,15,193
https://kawalpemilu.org#75662,"SALUTIWO, BONEHAU, MAMUJU, SULAWESI BARAT",3,106,13,119
https://kawalpemilu.org#75663,"BUTTUADA, BONEHAU, MAMUJU, SULAWESI BARAT",1,159,5,164
https://kawalpemilu.org#75663,"BUTTUADA, BONEHAU, MAMUJU, SULAWESI BARAT",2,129,24,153
https://kawalpemilu.org#75663,"BUTTUADA, BONEHAU, MAMUJU, SULAWESI BARAT",3,236,8,244
https://kawalpemilu.org#75663,"BUTTUADA, BONEHAU, MAMUJU, SULAWESI BARAT",4,168,8,176
https://kawalpemilu.org#75663,"BUTTUADA, BONEHAU, MAMUJU, SULAWESI BARAT",5,129,6,135
https://kawalpemilu.org#75663,"BUTTUADA, BONEHAU, MAMUJU, SULAWESI BARAT",6,141,18,159
https://kawalpemilu.org#75664,"TAMALEA, BONEHAU, MAMUJU, SULAWESI BARAT",1,168,18,186
https://kawalpemilu.org#75665,"MAPPU, BONEHAU, MAMUJU, SULAWESI BARAT",1,134,12,146
https://kawalpemilu.org#75665,"MAPPU, BONEHAU, MAMUJU, SULAWESI BARAT",2,84,1,85
https://kawalpemilu.org#75665,"MAPPU, BONEHAU, MAMUJU, SULAWESI BARAT",3,201,10,211
https://kawalpemilu.org#75665,"MAPPU, BONEHAU, MAMUJU, SULAWESI BARAT",4,63,7,70
https://kawalpemilu.org#75666,"LUMIKA I, BONEHAU, MAMUJU, SULAWESI BARAT",1,123,17,140
https://kawalpemilu.org#75666,"LUMIKA I, BONEHAU, MAMUJU, SULAWESI BARAT",2,134,40,174
https://kawalpemilu.org#75666,"LUMIKA I, BONEHAU, MAMUJU, SULAWESI BARAT",3,114,6,120
https://kawalpemilu.org#75667,"BANUADA, BONEHAU, MAMUJU, SULAWESI BARAT",1,175,16,191
https://kawalpemilu.org#75667,"BANUADA, BONEHAU, MAMUJU, SULAWESI BARAT",2,185,11,196
https://kawalpemilu.org#75668,"HINUA, BONEHAU, MAMUJU, SULAWESI BARAT",1,158,13,171
https://kawalpemilu.org#75668,"HINUA, BONEHAU, MAMUJU, SULAWESI BARAT",2,133,17,150
https://kawalpemilu.org#75668,"HINUA, BONEHAU, MAMUJU, SULAWESI BARAT",3,96,6,102
https://kawalpemilu.org#75669,"KINATANG, BONEHAU, MAMUJU, SULAWESI BARAT",1,232,22,254
https://kawalpemilu.org#75669,"KINATANG, BONEHAU, MAMUJU, SULAWESI BARAT",2,120,9,129
https://kawalpemilu.org#75669,"KINATANG, BONEHAU, MAMUJU, SULAWESI BARAT",3,54,15,69
https://kawalpemilu.org#75638,"BALA BALAKANG, KEP. BALA BALAKANG, MAMUJU, SULAWESI BARAT",1,87,112,199
https://kawalpemilu.org#75638,"BALA BALAKANG, KEP. BALA BALAKANG, MAMUJU, SULAWESI BARAT",2,65,10,75
https://kawalpemilu.org#75638,"BALA BALAKANG, KEP. BALA BALAKANG, MAMUJU, SULAWESI BARAT",3,56,52,108
https://kawalpemilu.org#75638,"BALA BALAKANG, KEP. BALA BALAKANG, MAMUJU, SULAWESI BARAT",4,63,128,191
https://kawalpemilu.org#75638,"BALA BALAKANG, KEP. BALA BALAKANG, MAMUJU, SULAWESI BARAT",5,94,52,146
https://kawalpemilu.org#75638,"BALA BALAKANG, KEP. BALA BALAKANG, MAMUJU, SULAWESI BARAT",6,63,21,84
https://kawalpemilu.org#75642,"BALA-BALAKANG TIMUR, KEP. BALA BALAKANG, MAMUJU, SULAWESI BARAT",1,124,57,181
https://kawalpemilu.org#75642,"BALA-BALAKANG TIMUR, KEP. BALA BALAKANG, MAMUJU, SULAWESI BARAT",2,56,32,88
https://kawalpemilu.org#75642,"BALA-BALAKANG TIMUR, KEP. BALA BALAKANG, MAMUJU, SULAWESI BARAT",3,56,14,70
https://kawalpemilu.org#75642,"BALA-BALAKANG TIMUR, KEP. BALA BALAKANG, MAMUJU, SULAWESI BARAT",4,75,49,124
https://kawalpemilu.org#75672,"MAMBI, MAMBI, MAMASA, SULAWESI BARAT",1,80,148,228
https://kawalpemilu.org#75672,"MAMBI, MAMBI, MAMASA, SULAWESI BARAT",2,63,148,211
https://kawalpemilu.org#75672,"MAMBI, MAMBI, MAMASA, SULAWESI BARAT",3,93,162,255
https://kawalpemilu.org#75672,"MAMBI, MAMBI, MAMASA, SULAWESI BARAT",4,91,132,223
https://kawalpemilu.org#75672,"MAMBI, MAMBI, MAMASA, SULAWESI BARAT",5,96,56,152
https://kawalpemilu.org#75673,"TALIPUKKI, MAMBI, MAMASA, SULAWESI BARAT",1,60,117,177
https://kawalpemilu.org#75673,"TALIPUKKI, MAMBI, MAMASA, SULAWESI BARAT",2,127,98,225
https://kawalpemilu.org#75673,"TALIPUKKI, MAMBI, MAMASA, SULAWESI BARAT",3,79,119,198
https://kawalpemilu.org#75673,"TALIPUKKI, MAMBI, MAMASA, SULAWESI BARAT",4,97,41,138
https://kawalpemilu.org#75675,"RANTE BULAHAN, MAMBI, MAMASA, SULAWESI BARAT",1,83,53,136
https://kawalpemilu.org#75675,"RANTE BULAHAN, MAMBI, MAMASA, SULAWESI BARAT",2,80,59,139
https://kawalpemilu.org#75676,"SONDONG LAYUK, MAMBI, MAMASA, SULAWESI BARAT",1,89,63,152
https://kawalpemilu.org#75676,"SONDONG LAYUK, MAMBI, MAMASA, SULAWESI BARAT",2,92,65,157
https://kawalpemilu.org#75679,"SALUBANUA, MAMBI, MAMASA, SULAWESI BARAT",1,54,6,60
https://kawalpemilu.org#75679,"SALUBANUA, MAMBI, MAMASA, SULAWESI BARAT",2,140,16,156
https://kawalpemilu.org#75680,"TAPALINA, MAMBI, MAMASA, SULAWESI BARAT",1,76,66,142
https://kawalpemilu.org#75680,"TAPALINA, MAMBI, MAMASA, SULAWESI BARAT",2,111,54,165
https://kawalpemilu.org#75680,"TAPALINA, MAMBI, MAMASA, SULAWESI BARAT",3,104,18,122
https://kawalpemilu.org#75681,"SENDANA, MAMBI, MAMASA, SULAWESI BARAT",1,105,109,214
https://kawalpemilu.org#75681,"SENDANA, MAMBI, MAMASA, SULAWESI BARAT",2,98,124,222
https://kawalpemilu.org#75681,"SENDANA, MAMBI, MAMASA, SULAWESI BARAT",3,136,69,205
https://kawalpemilu.org#75683,"PAMOSEANG, MAMBI, MAMASA, SULAWESI BARAT",1,105,66,171
https://kawalpemilu.org#75683,"PAMOSEANG, MAMBI, MAMASA, SULAWESI BARAT",2,122,42,164
https://kawalpemilu.org#75684,"SALUMAKA, MAMBI, MAMASA, SULAWESI BARAT",1,70,129,199
https://kawalpemilu.org#75684,"SALUMAKA, MAMBI, MAMASA, SULAWESI BARAT",2,91,119,210
https://kawalpemilu.org#75684,"SALUMAKA, MAMBI, MAMASA, SULAWESI BARAT",3,70,121,191
https://kawalpemilu.org#75684,"SALUMAKA, MAMBI, MAMASA, SULAWESI BARAT",4,23,79,102
https://kawalpemilu.org#75684,"SALUMAKA, MAMBI, MAMASA, SULAWESI BARAT",5,50,107,157
https://kawalpemilu.org#75685,"BUJUNG MANURUNG, MAMBI, MAMASA, SULAWESI BARAT",1,99,55,154
https://kawalpemilu.org#75685,"BUJUNG MANURUNG, MAMBI, MAMASA, SULAWESI BARAT",2,90,56,146
https://kawalpemilu.org#75686,"SALUALO, MAMBI, MAMASA, SULAWESI BARAT",1,170,84,254
https://kawalpemilu.org#75686,"SALUALO, MAMBI, MAMASA, SULAWESI BARAT",2,89,69,158
https://kawalpemilu.org#75687,"INDO BANUA, MAMBI, MAMASA, SULAWESI BARAT",1,120,76,196
https://kawalpemilu.org#75687,"INDO BANUA, MAMBI, MAMASA, SULAWESI BARAT",2,69,52,121
https://kawalpemilu.org#75691,"SALUDURIAN, MAMBI, MAMASA, SULAWESI BARAT",1,47,136,183
https://kawalpemilu.org#75691,"SALUDURIAN, MAMBI, MAMASA, SULAWESI BARAT",2,70,82,152
https://kawalpemilu.org#75691,"SALUDURIAN, MAMBI, MAMASA, SULAWESI BARAT",3,21,66,87
https://kawalpemilu.org#75694,"ARALLE, ARALLE, MAMASA, SULAWESI BARAT",1,138,27,165
https://kawalpemilu.org#75694,"ARALLE, ARALLE, MAMASA, SULAWESI BARAT",2,161,77,238
https://kawalpemilu.org#75694,"ARALLE, ARALLE, MAMASA, SULAWESI BARAT",3,109,94,203
https://kawalpemilu.org#75696,"RALLE ANAK, ARALLE, MAMASA, SULAWESI BARAT",1,48,60,108
https://kawalpemilu.org#75696,"RALLE ANAK, ARALLE, MAMASA, SULAWESI BARAT",2,105,82,187
https://kawalpemilu.org#75697,"PANETEAN, ARALLE, MAMASA, SULAWESI BARAT",1,67,123,190
https://kawalpemilu.org#75697,"PANETEAN, ARALLE, MAMASA, SULAWESI BARAT",2,76,100,176
https://kawalpemilu.org#75698,"UHAILANU, ARALLE, MAMASA, SULAWESI BARAT",1,113,49,162
https://kawalpemilu.org#75698,"UHAILANU, ARALLE, MAMASA, SULAWESI BARAT",2,143,42,185
https://kawalpemilu.org#75698,"UHAILANU, ARALLE, MAMASA, SULAWESI BARAT",3,126,43,169
https://kawalpemilu.org#75700,"ARALLE UTARA, ARALLE, MAMASA, SULAWESI BARAT",1,55,38,93
https://kawalpemilu.org#75700,"ARALLE UTARA, ARALLE, MAMASA, SULAWESI BARAT",2,194,84,278
https://kawalpemilu.org#75700,"ARALLE UTARA, ARALLE, MAMASA, SULAWESI BARAT",3,112,37,149
https://kawalpemilu.org#75702,"UHAIDAHO, ARALLE, MAMASA, SULAWESI BARAT",1,96,158,254
https://kawalpemilu.org#75702,"UHAIDAHO, ARALLE, MAMASA, SULAWESI BARAT",2,97,123,220
https://kawalpemilu.org#75703,"BARURU, ARALLE, MAMASA, SULAWESI BARAT",1,203,24,227
https://kawalpemilu.org#75703,"BARURU, ARALLE, MAMASA, SULAWESI BARAT",2,171,6,177
https://kawalpemilu.org#75703,"BARURU, ARALLE, MAMASA, SULAWESI BARAT",3,68,1,69
https://kawalpemilu.org#75703,"BARURU, ARALLE, MAMASA, SULAWESI BARAT",4,168,7,175
https://kawalpemilu.org#75708,"RALLEANAK UTARA, ARALLE, MAMASA, SULAWESI BARAT",1,150,83,233
https://kawalpemilu.org#75709,"PAMOSEANG PANGGA, ARALLE, MAMASA, SULAWESI BARAT",1,23,110,133
https://kawalpemilu.org#75709,"PAMOSEANG PANGGA, ARALLE, MAMASA, SULAWESI BARAT",2,64,118,182
https://kawalpemilu.org#75710,"ARALLE SELATAN, ARALLE, MAMASA, SULAWESI BARAT",1,144,75,219
https://kawalpemilu.org#75711,"HAHANGAN, ARALLE, MAMASA, SULAWESI BARAT",1,177,28,205
https://kawalpemilu.org#75715,"KALABE, ARALLE, MAMASA, SULAWESI BARAT",1,118,20,138
https://kawalpemilu.org#75715,"KALABE, ARALLE, MAMASA, SULAWESI BARAT",2,146,51,197
https://kawalpemilu.org#75682,"BUBUN BATU, MAMASA, MAMASA, SULAWESI BARAT",1,147,19,166
https://kawalpemilu.org#75682,"BUBUN BATU, MAMASA, MAMASA, SULAWESI BARAT",2,171,18,189
https://kawalpemilu.org#75682,"BUBUN BATU, MAMASA, MAMASA, SULAWESI BARAT",3,197,11,208
https://kawalpemilu.org#75717,"MAMASA, MAMASA, MAMASA, SULAWESI BARAT",1,133,43,176
https://kawalpemilu.org#75717,"MAMASA, MAMASA, MAMASA, SULAWESI BARAT",2,110,72,182
https://kawalpemilu.org#75717,"MAMASA, MAMASA, MAMASA, SULAWESI BARAT",3,131,20,151
https://kawalpemilu.org#75717,"MAMASA, MAMASA, MAMASA, SULAWESI BARAT",4,116,41,157
https://kawalpemilu.org#75717,"MAMASA, MAMASA, MAMASA, SULAWESI BARAT",5,99,16,115
https://kawalpemilu.org#75717,"MAMASA, MAMASA, MAMASA, SULAWESI BARAT",6,80,20,100
https://kawalpemilu.org#75717,"MAMASA, MAMASA, MAMASA, SULAWESI BARAT",7,194,10,204
https://kawalpemilu.org#75717,"MAMASA, MAMASA, MAMASA, SULAWESI BARAT",8,170,18,188
https://kawalpemilu.org#75717,"MAMASA, MAMASA, MAMASA, SULAWESI BARAT",9,95,21,116
https://kawalpemilu.org#75717,"MAMASA, MAMASA, MAMASA, SULAWESI BARAT",10,163,24,187
https://kawalpemilu.org#75717,"MAMASA, MAMASA, MAMASA, SULAWESI BARAT",11,106,37,143
https://kawalpemilu.org#75717,"MAMASA, MAMASA, MAMASA, SULAWESI BARAT",12,98,25,123
https://kawalpemilu.org#75717,"MAMASA, MAMASA, MAMASA, SULAWESI BARAT",13,135,20,155
https://kawalpemilu.org#75717,"MAMASA, MAMASA, MAMASA, SULAWESI BARAT",14,97,12,109
https://kawalpemilu.org#75717,"MAMASA, MAMASA, MAMASA, SULAWESI BARAT",15,122,7,129
https://kawalpemilu.org#75718,"RAMBUSARATU, MAMASA, MAMASA, SULAWESI BARAT",1,201,13,214
https://kawalpemilu.org#75718,"RAMBUSARATU, MAMASA, MAMASA, SULAWESI BARAT",2,197,37,234
https://kawalpemilu.org#75718,"RAMBUSARATU, MAMASA, MAMASA, SULAWESI BARAT",3,206,10,216
https://kawalpemilu.org#75718,"RAMBUSARATU, MAMASA, MAMASA, SULAWESI BARAT",4,180,24,204
https://kawalpemilu.org#75718,"RAMBUSARATU, MAMASA, MAMASA, SULAWESI BARAT",5,182,14,196
https://kawalpemilu.org#75718,"RAMBUSARATU, MAMASA, MAMASA, SULAWESI BARAT",6,193,13,206
https://kawalpemilu.org#75719,"OSANGO, MAMASA, MAMASA, SULAWESI BARAT",1,201,19,220
https://kawalpemilu.org#75719,"OSANGO, MAMASA, MAMASA, SULAWESI BARAT",2,192,24,216
https://kawalpemilu.org#75719,"OSANGO, MAMASA, MAMASA, SULAWESI BARAT",3,111,25,136
https://kawalpemilu.org#75719,"OSANGO, MAMASA, MAMASA, SULAWESI BARAT",4,136,21,157
https://kawalpemilu.org#75719,"OSANGO, MAMASA, MAMASA, SULAWESI BARAT",5,195,36,231
https://kawalpemilu.org#75719,"OSANGO, MAMASA, MAMASA, SULAWESI BARAT",6,180,15,195
https://kawalpemilu.org#75719,"OSANGO, MAMASA, MAMASA, SULAWESI BARAT",7,164,24,188
https://kawalpemilu.org#75719,"OSANGO, MAMASA, MAMASA, SULAWESI BARAT",8,180,30,210
https://kawalpemilu.org#75719,"OSANGO, MAMASA, MAMASA, SULAWESI BARAT",9,166,24,190
https://kawalpemilu.org#75719,"OSANGO, MAMASA, MAMASA, SULAWESI BARAT",10,163,10,173
https://kawalpemilu.org#75720,"LAMBANAN, MAMASA, MAMASA, SULAWESI BARAT",1,227,17,244
https://kawalpemilu.org#75720,"LAMBANAN, MAMASA, MAMASA, SULAWESI BARAT",2,248,20,268
https://kawalpemilu.org#75720,"LAMBANAN, MAMASA, MAMASA, SULAWESI BARAT",3,212,14,226
https://kawalpemilu.org#75720,"LAMBANAN, MAMASA, MAMASA, SULAWESI BARAT",4,196,18,214
https://kawalpemilu.org#75720,"LAMBANAN, MAMASA, MAMASA, SULAWESI BARAT",5,141,35,176
https://kawalpemilu.org#75720,"LAMBANAN, MAMASA, MAMASA, SULAWESI BARAT",6,205,15,220
https://kawalpemilu.org#75720,"LAMBANAN, MAMASA, MAMASA, SULAWESI BARAT",7,214,16,230
https://kawalpemilu.org#75721,"LEMBANA SALULO, MAMASA, MAMASA, SULAWESI BARAT",1,135,41,176
https://kawalpemilu.org#75721,"LEMBANA SALULO, MAMASA, MAMASA, SULAWESI BARAT",2,180,15,195
https://kawalpemilu.org#75721,"LEMBANA SALULO, MAMASA, MAMASA, SULAWESI BARAT",3,122,8,130
https://kawalpemilu.org#75722,"TAUPE, MAMASA, MAMASA, SULAWESI BARAT",1,192,4,196
https://kawalpemilu.org#75722,"TAUPE, MAMASA, MAMASA, SULAWESI BARAT",2,171,21,192
https://kawalpemilu.org#75722,"TAUPE, MAMASA, MAMASA, SULAWESI BARAT",3,154,9,163
https://kawalpemilu.org#75722,"TAUPE, MAMASA, MAMASA, SULAWESI BARAT",4,180,6,186
https://kawalpemilu.org#75722,"TAUPE, MAMASA, MAMASA, SULAWESI BARAT",5,150,6,156
https://kawalpemilu.org#75722,"TAUPE, MAMASA, MAMASA, SULAWESI BARAT",6,126,11,137
https://kawalpemilu.org#75723,"BUNTU BUDA, MAMASA, MAMASA, SULAWESI BARAT",1,206,35,241
https://kawalpemilu.org#75723,"BUNTU BUDA, MAMASA, MAMASA, SULAWESI BARAT",2,167,10,177
https://kawalpemilu.org#75723,"BUNTU BUDA, MAMASA, MAMASA, SULAWESI BARAT",3,170,9,179
https://kawalpemilu.org#75723,"BUNTU BUDA, MAMASA, MAMASA, SULAWESI BARAT",4,214,22,236
https://kawalpemilu.org#75723,"BUNTU BUDA, MAMASA, MAMASA, SULAWESI BARAT",5,181,17,198
https://kawalpemilu.org#75723,"BUNTU BUDA, MAMASA, MAMASA, SULAWESI BARAT",6,209,7,216
https://kawalpemilu.org#75723,"BUNTU BUDA, MAMASA, MAMASA, SULAWESI BARAT",7,130,8,138
https://kawalpemilu.org#75723,"BUNTU BUDA, MAMASA, MAMASA, SULAWESI BARAT",8,106,31,137
https://kawalpemilu.org#75724,"TONDOK BAKARU, MAMASA, MAMASA, SULAWESI BARAT",1,222,32,254
https://kawalpemilu.org#75724,"TONDOK BAKARU, MAMASA, MAMASA, SULAWESI BARAT",2,227,31,258
https://kawalpemilu.org#75724,"TONDOK BAKARU, MAMASA, MAMASA, SULAWESI BARAT",3,196,27,223
https://kawalpemilu.org#75724,"TONDOK BAKARU, MAMASA, MAMASA, SULAWESI BARAT",4,229,12,241
https://kawalpemilu.org#75724,"TONDOK BAKARU, MAMASA, MAMASA, SULAWESI BARAT",5,227,13,240
https://kawalpemilu.org#75725,"PEBASSIAN, MAMASA, MAMASA, SULAWESI BARAT",1,115,9,124
https://kawalpemilu.org#75725,"PEBASSIAN, MAMASA, MAMASA, SULAWESI BARAT",2,137,2,139
https://kawalpemilu.org#75725,"PEBASSIAN, MAMASA, MAMASA, SULAWESI BARAT",3,167,6,173
https://kawalpemilu.org#75726,"MAMBULILING, MAMASA, MAMASA, SULAWESI BARAT",1,252,20,272
https://kawalpemilu.org#75726,"MAMBULILING, MAMASA, MAMASA, SULAWESI BARAT",2,182,7,189
https://kawalpemilu.org#75726,"MAMBULILING, MAMASA, MAMASA, SULAWESI BARAT",3,170,4,174
https://kawalpemilu.org#75727,"BOMBONG LAMBE, MAMASA, MAMASA, SULAWESI BARAT",1,185,22,207
https://kawalpemilu.org#75727,"BOMBONG LAMBE, MAMASA, MAMASA, SULAWESI BARAT",2,165,10,175
https://kawalpemilu.org#75727,"BOMBONG LAMBE, MAMASA, MAMASA, SULAWESI BARAT",3,158,10,168
https://kawalpemilu.org#75727,"BOMBONG LAMBE, MAMASA, MAMASA, SULAWESI BARAT",4,160,11,171
https://kawalpemilu.org#75730,"PANA, PANA, MAMASA, SULAWESI BARAT",1,57,12,69
https://kawalpemilu.org#75730,"PANA, PANA, MAMASA, SULAWESI BARAT",2,133,8,141
https://kawalpemilu.org#75730,"PANA, PANA, MAMASA, SULAWESI BARAT",3,163,6,169
https://kawalpemilu.org#75731,"MANIPI, PANA, MAMASA, SULAWESI BARAT",1,130,12,142
https://kawalpemilu.org#75731,"MANIPI, PANA, MAMASA, SULAWESI BARAT",2,119,7,126
https://kawalpemilu.org#75731,"MANIPI, PANA, MAMASA, SULAWESI BARAT",3,117,9,126
https://kawalpemilu.org#75731,"MANIPI, PANA, MAMASA, SULAWESI BARAT",4,156,16,172
https://kawalpemilu.org#75731,"MANIPI, PANA, MAMASA, SULAWESI BARAT",5,157,10,167
https://kawalpemilu.org#75731,"MANIPI, PANA, MAMASA, SULAWESI BARAT",6,96,9,105
https://kawalpemilu.org#75732,"MAMULLU, PANA, MAMASA, SULAWESI BARAT",1,165,13,178
https://kawalpemilu.org#75732,"MAMULLU, PANA, MAMASA, SULAWESI BARAT",2,165,14,179
https://kawalpemilu.org#75732,"MAMULLU, PANA, MAMASA, SULAWESI BARAT",3,185,6,191
https://kawalpemilu.org#75733,"SAPAN, PANA, MAMASA, SULAWESI BARAT",1,195,16,211
https://kawalpemilu.org#75733,"SAPAN, PANA, MAMASA, SULAWESI BARAT",2,176,5,181
https://kawalpemilu.org#75734,"DATUBARINGAN, PANA, MAMASA, SULAWESI BARAT",1,130,4,134
https://kawalpemilu.org#75734,"DATUBARINGAN, PANA, MAMASA, SULAWESI BARAT",2,196,9,205
https://kawalpemilu.org#75734,"DATUBARINGAN, PANA, MAMASA, SULAWESI BARAT",3,182,12,194
https://kawalpemilu.org#75735,"PANURA, PANA, MAMASA, SULAWESI BARAT",1,152,9,161
https://kawalpemilu.org#75735,"PANURA, PANA, MAMASA, SULAWESI BARAT",2,124,5,129
https://kawalpemilu.org#75735,"PANURA, PANA, MAMASA, SULAWESI BARAT",3,76,18,94
https://kawalpemilu.org#75735,"PANURA, PANA, MAMASA, SULAWESI BARAT",4,73,6,79
https://kawalpemilu.org#75736,"TALLANG BULAWAN, PANA, MAMASA, SULAWESI BARAT",1,164,13,177
https://kawalpemilu.org#75736,"TALLANG BULAWAN, PANA, MAMASA, SULAWESI BARAT",2,145,10,155
https://kawalpemilu.org#75736,"TALLANG BULAWAN, PANA, MAMASA, SULAWESI BARAT",3,89,6,95
https://kawalpemilu.org#75737,"KARAKA, PANA, MAMASA, SULAWESI BARAT",1,131,11,142
https://kawalpemilu.org#75737,"KARAKA, PANA, MAMASA, SULAWESI BARAT",2,113,5,118
https://kawalpemilu.org#75737,"KARAKA, PANA, MAMASA, SULAWESI BARAT",3,72,2,74
https://kawalpemilu.org#75738,"ULUSALU, PANA, MAMASA, SULAWESI BARAT",1,118,21,139
https://kawalpemilu.org#75738,"ULUSALU, PANA, MAMASA, SULAWESI BARAT",2,87,5,92
https://kawalpemilu.org#75738,"ULUSALU, PANA, MAMASA, SULAWESI BARAT",3,92,12,104
https://kawalpemilu.org#75739,"SALOAN, PANA, MAMASA, SULAWESI BARAT",1,100,4,104
https://kawalpemilu.org#75739,"SALOAN, PANA, MAMASA, SULAWESI BARAT",2,119,2,121
https://kawalpemilu.org#75739,"SALOAN, PANA, MAMASA, SULAWESI BARAT",3,187,1,188
https://kawalpemilu.org#75739,"SALOAN, PANA, MAMASA, SULAWESI BARAT",4,115,5,120
https://kawalpemilu.org#75741,"ULUSALU INDAH, PANA, MAMASA, SULAWESI BARAT",1,141,12,153
https://kawalpemilu.org#75741,"ULUSALU INDAH, PANA, MAMASA, SULAWESI BARAT",2,170,2,172
https://kawalpemilu.org#75742,"WERI, PANA, MAMASA, SULAWESI BARAT",1,175,21,196
https://kawalpemilu.org#75742,"WERI, PANA, MAMASA, SULAWESI BARAT",2,84,1,85
https://kawalpemilu.org#93218,"SALUTAMBUN, PANA, MAMASA, SULAWESI BARAT",1,97,0,97
https://kawalpemilu.org#93218,"SALUTAMBUN, PANA, MAMASA, SULAWESI BARAT",2,100,2,102
https://kawalpemilu.org#93218,"SALUTAMBUN, PANA, MAMASA, SULAWESI BARAT",3,116,22,138
https://kawalpemilu.org#75744,"LAKAHANG, TABULAHAN, MAMASA, SULAWESI BARAT",1,200,56,256
https://kawalpemilu.org#75744,"LAKAHANG, TABULAHAN, MAMASA, SULAWESI BARAT",2,163,49,212
https://kawalpemilu.org#75744,"LAKAHANG, TABULAHAN, MAMASA, SULAWESI BARAT",3,227,39,266
https://kawalpemilu.org#75744,"LAKAHANG, TABULAHAN, MAMASA, SULAWESI BARAT",4,217,32,249
https://kawalpemilu.org#75744,"LAKAHANG, TABULAHAN, MAMASA, SULAWESI BARAT",5,215,45,260
https://kawalpemilu.org#75744,"LAKAHANG, TABULAHAN, MAMASA, SULAWESI BARAT",6,145,33,178
https://kawalpemilu.org#75745,"PERIANGAN, TABULAHAN, MAMASA, SULAWESI BARAT",1,150,14,164
https://kawalpemilu.org#75745,"PERIANGAN, TABULAHAN, MAMASA, SULAWESI BARAT",2,67,3,70
https://kawalpemilu.org#75745,"PERIANGAN, TABULAHAN, MAMASA, SULAWESI BARAT",3,31,5,36
https://kawalpemilu.org#75746,"MALATIRO, TABULAHAN, MAMASA, SULAWESI BARAT",1,206,18,224
https://kawalpemilu.org#75746,"MALATIRO, TABULAHAN, MAMASA, SULAWESI BARAT",2,111,32,143
https://kawalpemilu.org#75746,"MALATIRO, TABULAHAN, MAMASA, SULAWESI BARAT",3,79,49,128
https://kawalpemilu.org#75746,"MALATIRO, TABULAHAN, MAMASA, SULAWESI BARAT",4,155,22,177
https://kawalpemilu.org#75746,"MALATIRO, TABULAHAN, MAMASA, SULAWESI BARAT",5,217,11,228
https://kawalpemilu.org#75746,"MALATIRO, TABULAHAN, MAMASA, SULAWESI BARAT",6,117,17,134
https://kawalpemilu.org#75747,"TABULAHAN, TABULAHAN, MAMASA, SULAWESI BARAT",1,164,9,173
https://kawalpemilu.org#75747,"TABULAHAN, TABULAHAN, MAMASA, SULAWESI BARAT",2,119,10,129
https://kawalpemilu.org#75748,"SALULEANG, TABULAHAN, MAMASA, SULAWESI BARAT",1,111,7,118
https://kawalpemilu.org#75748,"SALULEANG, TABULAHAN, MAMASA, SULAWESI BARAT",2,116,9,125
https://kawalpemilu.org#75750,"TAMPAK KURRA, TABULAHAN, MAMASA, SULAWESI BARAT",1,119,19,138
https://kawalpemilu.org#75750,"TAMPAK KURRA, TABULAHAN, MAMASA, SULAWESI BARAT",2,142,39,181
https://kawalpemilu.org#75750,"TAMPAK KURRA, TABULAHAN, MAMASA, SULAWESI BARAT",3,146,19,165
https://kawalpemilu.org#75750,"TAMPAK KURRA, TABULAHAN, MAMASA, SULAWESI BARAT",4,28,8,36
https://kawalpemilu.org#75750,"TAMPAK KURRA, TABULAHAN, MAMASA, SULAWESI BARAT",5,142,17,159
https://kawalpemilu.org#75750,"TAMPAK KURRA, TABULAHAN, MAMASA, SULAWESI BARAT",6,180,11,191
https://kawalpemilu.org#75751,"GANDANG DEWATA, TABULAHAN, MAMASA, SULAWESI BARAT",1,127,4,131
https://kawalpemilu.org#75751,"GANDANG DEWATA, TABULAHAN, MAMASA, SULAWESI BARAT",2,90,1,91
https://kawalpemilu.org#75752,"BURANA, TABULAHAN, MAMASA, SULAWESI BARAT",1,208,52,260
https://kawalpemilu.org#75752,"BURANA, TABULAHAN, MAMASA, SULAWESI BARAT",2,202,59,261
https://kawalpemilu.org#75752,"BURANA, TABULAHAN, MAMASA, SULAWESI BARAT",3,244,32,276
https://kawalpemilu.org#75753,"SALUBAKKA, TABULAHAN, MAMASA, SULAWESI BARAT",1,149,16,165
https://kawalpemilu.org#75753,"SALUBAKKA, TABULAHAN, MAMASA, SULAWESI BARAT",2,161,10,171
https://kawalpemilu.org#75754,"PANGANDARAN, TABULAHAN, MAMASA, SULAWESI BARAT",1,115,2,117
https://kawalpemilu.org#75754,"PANGANDARAN, TABULAHAN, MAMASA, SULAWESI BARAT",2,124,31,155
https://kawalpemilu.org#75754,"PANGANDARAN, TABULAHAN, MAMASA, SULAWESI BARAT",3,108,5,113
https://kawalpemilu.org#75754,"PANGANDARAN, TABULAHAN, MAMASA, SULAWESI BARAT",4,46,2,48
https://kawalpemilu.org#75754,"PANGANDARAN, TABULAHAN, MAMASA, SULAWESI BARAT",5,107,0,107
https://kawalpemilu.org#75755,"LAKAHANG UTAMA, TABULAHAN, MAMASA, SULAWESI BARAT",1,86,29,115
https://kawalpemilu.org#75755,"LAKAHANG UTAMA, TABULAHAN, MAMASA, SULAWESI BARAT",2,110,23,133
https://kawalpemilu.org#75755,"LAKAHANG UTAMA, TABULAHAN, MAMASA, SULAWESI BARAT",3,118,24,142
https://kawalpemilu.org#75756,"TALOPA, TABULAHAN, MAMASA, SULAWESI BARAT",1,167,4,171
https://kawalpemilu.org#75756,"TALOPA, TABULAHAN, MAMASA, SULAWESI BARAT",2,53,5,58
https://kawalpemilu.org#75757,"TIMORO, TABULAHAN, MAMASA, SULAWESI BARAT",1,116,27,143
https://kawalpemilu.org#75757,"TIMORO, TABULAHAN, MAMASA, SULAWESI BARAT",2,130,17,147
https://kawalpemilu.org#93219,"PEU', TABULAHAN, MAMASA, SULAWESI BARAT",1,91,40,131
https://kawalpemilu.org#93219,"PEU', TABULAHAN, MAMASA, SULAWESI BARAT",2,148,22,170
https://kawalpemilu.org#75759,"SUMARORONG, SUMARORONG, MAMASA, SULAWESI BARAT",1,166,43,209
https://kawalpemilu.org#75759,"SUMARORONG, SUMARORONG, MAMASA, SULAWESI BARAT",2,134,36,170
https://kawalpemilu.org#75759,"SUMARORONG, SUMARORONG, MAMASA, SULAWESI BARAT",3,164,27,191
https://kawalpemilu.org#75759,"SUMARORONG, SUMARORONG, MAMASA, SULAWESI BARAT",4,231,32,263
https://kawalpemilu.org#75760,"TABONE, SUMARORONG, MAMASA, SULAWESI BARAT",1,137,39,176
https://kawalpemilu.org#75760,"TABONE, SUMARORONG, MAMASA, SULAWESI BARAT",2,144,21,165
https://kawalpemilu.org#75760,"TABONE, SUMARORONG, MAMASA, SULAWESI BARAT",3,133,34,167
https://kawalpemilu.org#75760,"TABONE, SUMARORONG, MAMASA, SULAWESI BARAT",4,133,29,162
https://kawalpemilu.org#75761,"BATANG  URU, SUMARORONG, MAMASA, SULAWESI BARAT",1,140,12,152
https://kawalpemilu.org#75761,"BATANG  URU, SUMARORONG, MAMASA, SULAWESI BARAT",2,105,24,129
https://kawalpemilu.org#75761,"BATANG  URU, SUMARORONG, MAMASA, SULAWESI BARAT",3,131,10,141
https://kawalpemilu.org#75761,"BATANG  URU, SUMARORONG, MAMASA, SULAWESI BARAT",4,121,25,146
https://kawalpemilu.org#75762,"SASAKAN, SUMARORONG, MAMASA, SULAWESI BARAT",1,185,7,192
https://kawalpemilu.org#75762,"SASAKAN, SUMARORONG, MAMASA, SULAWESI BARAT",2,166,12,178
https://kawalpemilu.org#75762,"SASAKAN, SUMARORONG, MAMASA, SULAWESI BARAT",3,100,19,119
https://kawalpemilu.org#75762,"SASAKAN, SUMARORONG, MAMASA, SULAWESI BARAT",4,145,8,153
https://kawalpemilu.org#75762,"SASAKAN, SUMARORONG, MAMASA, SULAWESI BARAT",5,139,14,153
https://kawalpemilu.org#75763,"TADISI, SUMARORONG, MAMASA, SULAWESI BARAT",1,144,10,154
https://kawalpemilu.org#75763,"TADISI, SUMARORONG, MAMASA, SULAWESI BARAT",2,150,8,158
https://kawalpemilu.org#75763,"TADISI, SUMARORONG, MAMASA, SULAWESI BARAT",3,196,13,209
https://kawalpemilu.org#75763,"TADISI, SUMARORONG, MAMASA, SULAWESI BARAT",4,142,13,155
https://kawalpemilu.org#75763,"TADISI, SUMARORONG, MAMASA, SULAWESI BARAT",5,123,1,124
https://kawalpemilu.org#75764,"SIBANAWA, SUMARORONG, MAMASA, SULAWESI BARAT",1,139,26,165
https://kawalpemilu.org#75764,"SIBANAWA, SUMARORONG, MAMASA, SULAWESI BARAT",2,137,17,154
https://kawalpemilu.org#75764,"SIBANAWA, SUMARORONG, MAMASA, SULAWESI BARAT",3,195,10,205
https://kawalpemilu.org#75764,"SIBANAWA, SUMARORONG, MAMASA, SULAWESI BARAT",4,93,8,101
https://kawalpemilu.org#75765,"BATANGNGURU TIMUR, SUMARORONG, MAMASA, SULAWESI BARAT",1,194,11,205
https://kawalpemilu.org#75765,"BATANGNGURU TIMUR, SUMARORONG, MAMASA, SULAWESI BARAT",2,171,15,186
https://kawalpemilu.org#75765,"BATANGNGURU TIMUR, SUMARORONG, MAMASA, SULAWESI BARAT",3,163,10,173
https://kawalpemilu.org#75766,"SALUBALO, SUMARORONG, MAMASA, SULAWESI BARAT",1,150,14,164
https://kawalpemilu.org#75766,"SALUBALO, SUMARORONG, MAMASA, SULAWESI BARAT",2,211,16,227
https://kawalpemilu.org#75766,"SALUBALO, SUMARORONG, MAMASA, SULAWESI BARAT",3,154,11,165
https://kawalpemilu.org#75767,"BANEA, SUMARORONG, MAMASA, SULAWESI BARAT",1,163,12,175
https://kawalpemilu.org#75767,"BANEA, SUMARORONG, MAMASA, SULAWESI BARAT",2,154,14,168
https://kawalpemilu.org#75767,"BANEA, SUMARORONG, MAMASA, SULAWESI BARAT",3,156,10,166
https://kawalpemilu.org#75768,"RANTEKAMASE, SUMARORONG, MAMASA, SULAWESI BARAT",1,202,3,205
https://kawalpemilu.org#75768,"RANTEKAMASE, SUMARORONG, MAMASA, SULAWESI BARAT",2,184,13,197
https://kawalpemilu.org#75768,"RANTEKAMASE, SUMARORONG, MAMASA, SULAWESI BARAT",3,178,17,195
https://kawalpemilu.org#75768,"RANTEKAMASE, SUMARORONG, MAMASA, SULAWESI BARAT",4,151,21,172
https://kawalpemilu.org#75770,"MESSAWA, MESSAWA, MAMASA, SULAWESI BARAT",1,189,24,213
https://kawalpemilu.org#75770,"MESSAWA, MESSAWA, MAMASA, SULAWESI BARAT",2,155,24,179
https://kawalpemilu.org#75770,"MESSAWA, MESSAWA, MAMASA, SULAWESI BARAT",3,117,26,143
https://kawalpemilu.org#75771,"RIPPUNG, MESSAWA, MAMASA, SULAWESI BARAT",1,190,11,201
https://kawalpemilu.org#75771,"RIPPUNG, MESSAWA, MAMASA, SULAWESI BARAT",2,129,19,148
https://kawalpemilu.org#75771,"RIPPUNG, MESSAWA, MAMASA, SULAWESI BARAT",3,131,18,149
https://kawalpemilu.org#75771,"RIPPUNG, MESSAWA, MAMASA, SULAWESI BARAT",4,230,8,238
https://kawalpemilu.org#75771,"RIPPUNG, MESSAWA, MAMASA, SULAWESI BARAT",5,107,17,124
https://kawalpemilu.org#75772,"MAKUANG, MESSAWA, MAMASA, SULAWESI BARAT",1,160,29,189
https://kawalpemilu.org#75772,"MAKUANG, MESSAWA, MAMASA, SULAWESI BARAT",2,179,10,189
https://kawalpemilu.org#75772,"MAKUANG, MESSAWA, MAMASA, SULAWESI BARAT",3,125,8,133
https://kawalpemilu.org#75772,"MAKUANG, MESSAWA, MAMASA, SULAWESI BARAT",4,121,11,132
https://kawalpemilu.org#75773,"SEPANG, MESSAWA, MAMASA, SULAWESI BARAT",1,180,9,189
https://kawalpemilu.org#75773,"SEPANG, MESSAWA, MAMASA, SULAWESI BARAT",2,191,23,214
https://kawalpemilu.org#75773,"SEPANG, MESSAWA, MAMASA, SULAWESI BARAT",3,130,14,144
https://kawalpemilu.org#75774,"MALIMBONG, MESSAWA, MAMASA, SULAWESI BARAT",1,131,2,133
https://kawalpemilu.org#75774,"MALIMBONG, MESSAWA, MAMASA, SULAWESI BARAT",2,135,5,140
https://kawalpemilu.org#75774,"MALIMBONG, MESSAWA, MAMASA, SULAWESI BARAT",3,96,6,102
https://kawalpemilu.org#75775,"MATANDE, MESSAWA, MAMASA, SULAWESI BARAT",1,166,5,171
https://kawalpemilu.org#75775,"MATANDE, MESSAWA, MAMASA, SULAWESI BARAT",2,117,7,124
https://kawalpemilu.org#75775,"MATANDE, MESSAWA, MAMASA, SULAWESI BARAT",3,138,6,144
https://kawalpemilu.org#75776,"SIPAI, MESSAWA, MAMASA, SULAWESI BARAT",1,187,8,195
https://kawalpemilu.org#75776,"SIPAI, MESSAWA, MAMASA, SULAWESI BARAT",2,173,4,177
https://kawalpemilu.org#75777,"PASAPA MAMBU, MESSAWA, MAMASA, SULAWESI BARAT",1,174,18,192
https://kawalpemilu.org#75777,"PASAPA MAMBU, MESSAWA, MAMASA, SULAWESI BARAT",2,206,17,223
https://kawalpemilu.org#75778,"TANETE BATU, MESSAWA, MAMASA, SULAWESI BARAT",1,206,14,220
https://kawalpemilu.org#75778,"TANETE BATU, MESSAWA, MAMASA, SULAWESI BARAT",2,128,13,141
https://kawalpemilu.org#75778,"TANETE BATU, MESSAWA, MAMASA, SULAWESI BARAT",3,119,11,130
https://kawalpemilu.org#75780,"OROBUA, SESENAPADANG, MAMASA, SULAWESI BARAT",1,126,6,132
https://kawalpemilu.org#75780,"OROBUA, SESENAPADANG, MAMASA, SULAWESI BARAT",2,192,15,207
https://kawalpemilu.org#75780,"OROBUA, SESENAPADANG, MAMASA, SULAWESI BARAT",3,234,12,246
https://kawalpemilu.org#75780,"OROBUA, SESENAPADANG, MAMASA, SULAWESI BARAT",4,129,13,142
https://kawalpemilu.org#75780,"OROBUA, SESENAPADANG, MAMASA, SULAWESI BARAT",5,123,5,128
https://kawalpemilu.org#75780,"OROBUA, SESENAPADANG, MAMASA, SULAWESI BARAT",6,122,9,131
https://kawalpemilu.org#75780,"OROBUA, SESENAPADANG, MAMASA, SULAWESI BARAT",7,122,13,135
https://kawalpemilu.org#75781,"PALADAN, SESENAPADANG, MAMASA, SULAWESI BARAT",1,175,19,194
https://kawalpemilu.org#75781,"PALADAN, SESENAPADANG, MAMASA, SULAWESI BARAT",2,128,4,132
https://kawalpemilu.org#75781,"PALADAN, SESENAPADANG, MAMASA, SULAWESI BARAT",3,105,2,107
https://kawalpemilu.org#75782,"OROBUA TIMUR, SESENAPADANG, MAMASA, SULAWESI BARAT",1,193,2,195
https://kawalpemilu.org#75782,"OROBUA TIMUR, SESENAPADANG, MAMASA, SULAWESI BARAT",2,211,10,221
https://kawalpemilu.org#75782,"OROBUA TIMUR, SESENAPADANG, MAMASA, SULAWESI BARAT",3,147,1,148
https://kawalpemilu.org#75782,"OROBUA TIMUR, SESENAPADANG, MAMASA, SULAWESI BARAT",4,142,5,147
https://kawalpemilu.org#75782,"OROBUA TIMUR, SESENAPADANG, MAMASA, SULAWESI BARAT",5,144,7,151
https://kawalpemilu.org#75783,"RANTE PUANG, SESENAPADANG, MAMASA, SULAWESI BARAT",1,89,34,123
https://kawalpemilu.org#75783,"RANTE PUANG, SESENAPADANG, MAMASA, SULAWESI BARAT",2,136,18,154
https://kawalpemilu.org#75783,"RANTE PUANG, SESENAPADANG, MAMASA, SULAWESI BARAT",3,141,6,147
https://kawalpemilu.org#75783,"RANTE PUANG, SESENAPADANG, MAMASA, SULAWESI BARAT",4,134,13,147
https://kawalpemilu.org#75783,"RANTE PUANG, SESENAPADANG, MAMASA, SULAWESI BARAT",5,112,6,118
https://kawalpemilu.org#75784,"SATENETEAN, SESENAPADANG, MAMASA, SULAWESI BARAT",1,188,10,198
https://kawalpemilu.org#75784,"SATENETEAN, SESENAPADANG, MAMASA, SULAWESI BARAT",2,133,6,139
https://kawalpemilu.org#75785,"LISUAN ADA, SESENAPADANG, MAMASA, SULAWESI BARAT",1,187,7,194
https://kawalpemilu.org#75785,"LISUAN ADA, SESENAPADANG, MAMASA, SULAWESI BARAT",2,162,4,166
https://kawalpemilu.org#75785,"LISUAN ADA, SESENAPADANG, MAMASA, SULAWESI BARAT",3,130,10,140
https://kawalpemilu.org#75785,"LISUAN ADA, SESENAPADANG, MAMASA, SULAWESI BARAT",4,125,8,133
https://kawalpemilu.org#75786,"OROBUA SELATAN, SESENAPADANG, MAMASA, SULAWESI BARAT",1,147,14,161
https://kawalpemilu.org#75786,"OROBUA SELATAN, SESENAPADANG, MAMASA, SULAWESI BARAT",2,146,6,152
https://kawalpemilu.org#75786,"OROBUA SELATAN, SESENAPADANG, MAMASA, SULAWESI BARAT",3,169,12,181
https://kawalpemilu.org#75786,"OROBUA SELATAN, SESENAPADANG, MAMASA, SULAWESI BARAT",4,106,4,110
https://kawalpemilu.org#75787,"MALANGKENA PADANG, SESENAPADANG, MAMASA, SULAWESI BARAT",1,153,16,169
https://kawalpemilu.org#75787,"MALANGKENA PADANG, SESENAPADANG, MAMASA, SULAWESI BARAT",2,56,1,57
https://kawalpemilu.org#75787,"MALANGKENA PADANG, SESENAPADANG, MAMASA, SULAWESI BARAT",3,66,6,72
https://kawalpemilu.org#75787,"MALANGKENA PADANG, SESENAPADANG, MAMASA, SULAWESI BARAT",4,56,24,80
https://kawalpemilu.org#75788,"MARAMPAN OROBUA, SESENAPADANG, MAMASA, SULAWESI BARAT",1,137,2,139
https://kawalpemilu.org#75788,"MARAMPAN OROBUA, SESENAPADANG, MAMASA, SULAWESI BARAT",2,114,2,116
https://kawalpemilu.org#75788,"MARAMPAN OROBUA, SESENAPADANG, MAMASA, SULAWESI BARAT",3,127,8,135
https://kawalpemilu.org#75789,"MALIMBONG, SESENAPADANG, MAMASA, SULAWESI BARAT",1,130,6,136
https://kawalpemilu.org#75789,"MALIMBONG, SESENAPADANG, MAMASA, SULAWESI BARAT",2,81,5,86
https://kawalpemilu.org#75791,"MINAKE, TANDUK KALUA, MAMASA, SULAWESI BARAT",1,163,33,196
https://kawalpemilu.org#75791,"MINAKE, TANDUK KALUA, MAMASA, SULAWESI BARAT",2,196,20,216
https://kawalpemilu.org#75791,"MINAKE, TANDUK KALUA, MAMASA, SULAWESI BARAT",3,176,20,196
https://kawalpemilu.org#75791,"MINAKE, TANDUK KALUA, MAMASA, SULAWESI BARAT",4,156,12,169
https://kawalpemilu.org#75792,"MALABO, TANDUK KALUA, MAMASA, SULAWESI BARAT",1,157,21,178
https://kawalpemilu.org#75792,"MALABO, TANDUK KALUA, MAMASA, SULAWESI BARAT",2,128,50,178
https://kawalpemilu.org#75792,"MALABO, TANDUK KALUA, MAMASA, SULAWESI BARAT",3,165,14,179
https://kawalpemilu.org#75793,"SINDAGAMANIK, TANDUK KALUA, MAMASA, SULAWESI BARAT",1,179,16,195
https://kawalpemilu.org#75793,"SINDAGAMANIK, TANDUK KALUA, MAMASA, SULAWESI BARAT",2,195,7,202
https://kawalpemilu.org#75793,"SINDAGAMANIK, TANDUK KALUA, MAMASA, SULAWESI BARAT",3,168,12,180
https://kawalpemilu.org#75793,"SINDAGAMANIK, TANDUK KALUA, MAMASA, SULAWESI BARAT",4,157,25,182
https://kawalpemilu.org#75794,"PARONDOBULAWAN, TANDUK KALUA, MAMASA, SULAWESI BARAT",1,183,13,196
https://kawalpemilu.org#75794,"PARONDOBULAWAN, TANDUK KALUA, MAMASA, SULAWESI BARAT",2,121,19,140
https://kawalpemilu.org#75794,"PARONDOBULAWAN, TANDUK KALUA, MAMASA, SULAWESI BARAT",3,159,19,178
https://kawalpemilu.org#75794,"PARONDOBULAWAN, TANDUK KALUA, MAMASA, SULAWESI BARAT",4,140,19,159
https://kawalpemilu.org#75795,"TAMALANTIK, TANDUK KALUA, MAMASA, SULAWESI BARAT",1,193,41,234
https://kawalpemilu.org#75795,"TAMALANTIK, TANDUK KALUA, MAMASA, SULAWESI BARAT",2,233,9,242
https://kawalpemilu.org#75795,"TAMALANTIK, TANDUK KALUA, MAMASA, SULAWESI BARAT",3,86,7,93
https://kawalpemilu.org#75795,"TAMALANTIK, TANDUK KALUA, MAMASA, SULAWESI BARAT",4,126,3,129
https://kawalpemilu.org#75796,"MANNABABA, TANDUK KALUA, MAMASA, SULAWESI BARAT",1,189,28,217
https://kawalpemilu.org#75796,"MANNABABA, TANDUK KALUA, MAMASA, SULAWESI BARAT",2,209,12,221
https://kawalpemilu.org#75797,"MESAKADA, TANDUK KALUA, MAMASA, SULAWESI BARAT",1,229,16,245
https://kawalpemilu.org#75797,"MESAKADA, TANDUK KALUA, MAMASA, SULAWESI BARAT",2,217,21,238
https://kawalpemilu.org#75798,"BALLABATU, TANDUK KALUA, MAMASA, SULAWESI BARAT",1,185,10,195
https://kawalpemilu.org#75798,"BALLABATU, TANDUK KALUA, MAMASA, SULAWESI BARAT",2,159,28,187
https://kawalpemilu.org#75798,"BALLABATU, TANDUK KALUA, MAMASA, SULAWESI BARAT",3,166,18,184
https://kawalpemilu.org#75799,"KANAN, TANDUK KALUA, MAMASA, SULAWESI BARAT",1,138,22,160
https://kawalpemilu.org#75799,"KANAN, TANDUK KALUA, MAMASA, SULAWESI BARAT",2,160,15,175
https://kawalpemilu.org#75799,"KANAN, TANDUK KALUA, MAMASA, SULAWESI BARAT",3,182,8,190
https://kawalpemilu.org#75800,"PAMBE, TANDUK KALUA, MAMASA, SULAWESI BARAT",1,156,30,186
https://kawalpemilu.org#75800,"PAMBE, TANDUK KALUA, MAMASA, SULAWESI BARAT",2,136,17,153
https://kawalpemilu.org#75800,"PAMBE, TANDUK KALUA, MAMASA, SULAWESI BARAT",3,161,11,172
https://kawalpemilu.org#75801,"SALURANO, TANDUK KALUA, MAMASA, SULAWESI BARAT",1,113,9,122
https://kawalpemilu.org#75801,"SALURANO, TANDUK KALUA, MAMASA, SULAWESI BARAT",2,159,5,165
https://kawalpemilu.org#75801,"SALURANO, TANDUK KALUA, MAMASA, SULAWESI BARAT",3,102,9,111
https://kawalpemilu.org#75802,"TALIMBUNG, TANDUK KALUA, MAMASA, SULAWESI BARAT",1,185,17,202
https://kawalpemilu.org#75802,"TALIMBUNG, TANDUK KALUA, MAMASA, SULAWESI BARAT",2,212,7,219
https://kawalpemilu.org#75804,"TABANG, TABANG, MAMASA, SULAWESI BARAT",1,65,97,162
https://kawalpemilu.org#75804,"TABANG, TABANG, MAMASA, SULAWESI BARAT",2,131,21,2
https://kawalpemilu.org#75804,"TABANG, TABANG, MAMASA, SULAWESI BARAT",3,90,17,107
https://kawalpemilu.org#75804,"TABANG, TABANG, MAMASA, SULAWESI BARAT",4,118,14,132
https://kawalpemilu.org#75805,"TADOKALUA, TABANG, MAMASA, SULAWESI BARAT",1,192,5,197
https://kawalpemilu.org#75805,"TADOKALUA, TABANG, MAMASA, SULAWESI BARAT",2,119,30,149
https://kawalpemilu.org#75805,"TADOKALUA, TABANG, MAMASA, SULAWESI BARAT",3,110,3,113
https://kawalpemilu.org#75805,"TADOKALUA, TABANG, MAMASA, SULAWESI BARAT",4,135,7,142
https://kawalpemilu.org#75805,"TADOKALUA, TABANG, MAMASA, SULAWESI BARAT",5,135,15,150
https://kawalpemilu.org#75806,"TABANG BARAT, TABANG, MAMASA, SULAWESI BARAT",1,119,15,134
https://kawalpemilu.org#75806,"TABANG BARAT, TABANG, MAMASA, SULAWESI BARAT",2,99,24,123
https://kawalpemilu.org#75806,"TABANG BARAT, TABANG, MAMASA, SULAWESI BARAT",3,180,32,212
https://kawalpemilu.org#75806,"TABANG BARAT, TABANG, MAMASA, SULAWESI BARAT",4,99,8,107
https://kawalpemilu.org#75806,"TABANG BARAT, TABANG, MAMASA, SULAWESI BARAT",5,147,4,151
https://kawalpemilu.org#75807,"MASUPU, TABANG, MAMASA, SULAWESI BARAT",1,102,31,133
https://kawalpemilu.org#75807,"MASUPU, TABANG, MAMASA, SULAWESI BARAT",2,93,8,101
https://kawalpemilu.org#75807,"MASUPU, TABANG, MAMASA, SULAWESI BARAT",3,136,6,142
https://kawalpemilu.org#75808,"KALAMA, TABANG, MAMASA, SULAWESI BARAT",1,102,2,104
https://kawalpemilu.org#75808,"KALAMA, TABANG, MAMASA, SULAWESI BARAT",2,148,4,152
https://kawalpemilu.org#75808,"KALAMA, TABANG, MAMASA, SULAWESI BARAT",3,123,2,125
https://kawalpemilu.org#75809,"BAKADISURA, TABANG, MAMASA, SULAWESI BARAT",1,200,13,213
https://kawalpemilu.org#75809,"BAKADISURA, TABANG, MAMASA, SULAWESI BARAT",2,105,13,118
https://kawalpemilu.org#75809,"BAKADISURA, TABANG, MAMASA, SULAWESI BARAT",3,112,3,115
https://kawalpemilu.org#75810,"SALUKONA, TABANG, MAMASA, SULAWESI BARAT",1,96,1,97
https://kawalpemilu.org#75810,"SALUKONA, TABANG, MAMASA, SULAWESI BARAT",2,105,3,108
https://kawalpemilu.org#75810,"SALUKONA, TABANG, MAMASA, SULAWESI BARAT",3,162,13,175
https://kawalpemilu.org#75810,"SALUKONA, TABANG, MAMASA, SULAWESI BARAT",4,93,7,100
https://kawalpemilu.org#75812,"LEMBANG MOKALLANG, BAMBANG, MAMASA, SULAWESI BARAT",1,146,7,153
https://kawalpemilu.org#75812,"LEMBANG MOKALLANG, BAMBANG, MAMASA, SULAWESI BARAT",2,92,15,107
https://kawalpemilu.org#75812,"LEMBANG MOKALLANG, BAMBANG, MAMASA, SULAWESI BARAT",3,103,14,117
https://kawalpemilu.org#75813,"MASOSO, BAMBANG, MAMASA, SULAWESI BARAT",1,101,24,125
https://kawalpemilu.org#75813,"MASOSO, BAMBANG, MAMASA, SULAWESI BARAT",2,126,25,151
https://kawalpemilu.org#75814,"SALUASSING, BAMBANG, MAMASA, SULAWESI BARAT",1,154,46,200
https://kawalpemilu.org#75814,"SALUASSING, BAMBANG, MAMASA, SULAWESI BARAT",2,91,104,195
https://kawalpemilu.org#75814,"SALUASSING, BAMBANG, MAMASA, SULAWESI BARAT",3,79,45,124
https://kawalpemilu.org#75814,"SALUASSING, BAMBANG, MAMASA, SULAWESI BARAT",4,99,55,154
https://kawalpemilu.org#75815,"SALUBULO, BAMBANG, MAMASA, SULAWESI BARAT",1,158,13,171
https://kawalpemilu.org#75815,"SALUBULO, BAMBANG, MAMASA, SULAWESI BARAT",2,137,9,146
https://kawalpemilu.org#75816,"SALUKADI, BAMBANG, MAMASA, SULAWESI BARAT",1,172,47,219
https://kawalpemilu.org#75816,"SALUKADI, BAMBANG, MAMASA, SULAWESI BARAT",2,216,32,248
https://kawalpemilu.org#75817,"SALUKEPOPOK, BAMBANG, MAMASA, SULAWESI BARAT",1,181,44,225
https://kawalpemilu.org#75817,"SALUKEPOPOK, BAMBANG, MAMASA, SULAWESI BARAT",2,128,38,166
https://kawalpemilu.org#75817,"SALUKEPOPOK, BAMBANG, MAMASA, SULAWESI BARAT",3,132,7,139
https://kawalpemilu.org#75818,"ULUMAMBI BARAT, BAMBANG, MAMASA, SULAWESI BARAT",1,181,13,194
https://kawalpemilu.org#75818,"ULUMAMBI BARAT, BAMBANG, MAMASA, SULAWESI BARAT",2,183,32,215
https://kawalpemilu.org#75819,"LIMBADEBATA, BAMBANG, MAMASA, SULAWESI BARAT",1,119,18,137
https://kawalpemilu.org#75819,"LIMBADEBATA, BAMBANG, MAMASA, SULAWESI BARAT",2,145,21,166
https://kawalpemilu.org#75819,"LIMBADEBATA, BAMBANG, MAMASA, SULAWESI BARAT",3,163,2,165
https://kawalpemilu.org#75820,"TANETE TOMBA, BAMBANG, MAMASA, SULAWESI BARAT",1,234,9,243
https://kawalpemilu.org#75821,"BAMBANG, BAMBANG, MAMASA, SULAWESI BARAT",1,250,29,279
https://kawalpemilu.org#75821,"BAMBANG, BAMBANG, MAMASA, SULAWESI BARAT",2,251,29,280
https://kawalpemilu.org#75821,"BAMBANG, BAMBANG, MAMASA, SULAWESI BARAT",3,246,36,282
https://kawalpemilu.org#75822,"RANTELEMO, BAMBANG, MAMASA, SULAWESI BARAT",1,108,45,153
https://kawalpemilu.org#75822,"RANTELEMO, BAMBANG, MAMASA, SULAWESI BARAT",2,128,14,142
https://kawalpemilu.org#75823,"SALUNDENGEN, BAMBANG, MAMASA, SULAWESI BARAT",1,201,11,212
https://kawalpemilu.org#75823,"SALUNDENGEN, BAMBANG, MAMASA, SULAWESI BARAT",2,144,15,159
https://kawalpemilu.org#75824,"ULUMAMBI, BAMBANG, MAMASA, SULAWESI BARAT",1,180,33,213
https://kawalpemilu.org#75824,"ULUMAMBI, BAMBANG, MAMASA, SULAWESI BARAT",2,194,14,208
https://kawalpemilu.org#75825,"BAMBANG TIMUR, BAMBANG, MAMASA, SULAWESI BARAT",1,134,32,166
https://kawalpemilu.org#75825,"BAMBANG TIMUR, BAMBANG, MAMASA, SULAWESI BARAT",2,138,17,155
https://kawalpemilu.org#75825,"BAMBANG TIMUR, BAMBANG, MAMASA, SULAWESI BARAT",3,204,20,224
https://kawalpemilu.org#75826,"MINANGA, BAMBANG, MAMASA, SULAWESI BARAT",1,202,39,241
https://kawalpemilu.org#75826,"MINANGA, BAMBANG, MAMASA, SULAWESI BARAT",2,180,41,221
https://kawalpemilu.org#75826,"MINANGA, BAMBANG, MAMASA, SULAWESI BARAT",3,197,15,212
https://kawalpemilu.org#75826,"MINANGA, BAMBANG, MAMASA, SULAWESI BARAT",4,156,10,166
https://kawalpemilu.org#75827,"SIKAMASE, BAMBANG, MAMASA, SULAWESI BARAT",1,128,12,140
https://kawalpemilu.org#75827,"SIKAMASE, BAMBANG, MAMASA, SULAWESI BARAT",2,130,7,137
https://kawalpemilu.org#75828,"RANTETARIMA, BAMBANG, MAMASA, SULAWESI BARAT",1,121,19,140
https://kawalpemilu.org#75828,"RANTETARIMA, BAMBANG, MAMASA, SULAWESI BARAT",2,111,19,130
https://kawalpemilu.org#75829,"SALURURU, BAMBANG, MAMASA, SULAWESI BARAT",1,125,11,136
https://kawalpemilu.org#75830,"SALUTABANG, BAMBANG, MAMASA, SULAWESI BARAT",1,125,6,131
https://kawalpemilu.org#75830,"SALUTABANG, BAMBANG, MAMASA, SULAWESI BARAT",2,81,10,91
https://kawalpemilu.org#75831,"BALATANA, BAMBANG, MAMASA, SULAWESI BARAT",1,233,5,238
https://kawalpemilu.org#75833,"BALLA, BALLA, MAMASA, SULAWESI BARAT",1,211,20,231
https://kawalpemilu.org#75833,"BALLA, BALLA, MAMASA, SULAWESI BARAT",2,194,46,240
https://kawalpemilu.org#75833,"BALLA, BALLA, MAMASA, SULAWESI BARAT",3,172,18,190
https://kawalpemilu.org#75833,"BALLA, BALLA, MAMASA, SULAWESI BARAT",4,139,10,149
https://kawalpemilu.org#75833,"BALLA, BALLA, MAMASA, SULAWESI BARAT",5,106,25,131
https://kawalpemilu.org#75834,"BALLA BARAT, BALLA, MAMASA, SULAWESI BARAT",1,155,36,191
https://kawalpemilu.org#75834,"BALLA BARAT, BALLA, MAMASA, SULAWESI BARAT",2,166,44,190
https://kawalpemilu.org#75834,"BALLA BARAT, BALLA, MAMASA, SULAWESI BARAT",3,176,18,194
https://kawalpemilu.org#75835,"BALLA SATANETEAN, BALLA, MAMASA, SULAWESI BARAT",1,228,17,245
https://kawalpemilu.org#75835,"BALLA SATANETEAN, BALLA, MAMASA, SULAWESI BARAT",2,122,10,132
https://kawalpemilu.org#75835,"BALLA SATANETEAN, BALLA, MAMASA, SULAWESI BARAT",3,180,27,207
https://kawalpemilu.org#75835,"BALLA SATANETEAN, BALLA, MAMASA, SULAWESI BARAT",4,131,23,154
https://kawalpemilu.org#75835,"BALLA SATANETEAN, BALLA, MAMASA, SULAWESI BARAT",5,92,7,99
https://kawalpemilu.org#75836,"BALLA TUMUKA, BALLA, MAMASA, SULAWESI BARAT",1,179,29,208
https://kawalpemilu.org#75836,"BALLA TUMUKA, BALLA, MAMASA, SULAWESI BARAT",2,179,12,191
https://kawalpemilu.org#75836,"BALLA TUMUKA, BALLA, MAMASA, SULAWESI BARAT",3,201,5,206
https://kawalpemilu.org#75836,"BALLA TUMUKA, BALLA, MAMASA, SULAWESI BARAT",4,84,1,85
https://kawalpemilu.org#75837,"SEPAKUAN, BALLA, MAMASA, SULAWESI BARAT",1,177,12,189
https://kawalpemilu.org#75837,"SEPAKUAN, BALLA, MAMASA, SULAWESI BARAT",2,229,31,260
https://kawalpemilu.org#75837,"SEPAKUAN, BALLA, MAMASA, SULAWESI BARAT",3,156,14,170
https://kawalpemilu.org#75837,"SEPAKUAN, BALLA, MAMASA, SULAWESI BARAT",4,222,17,239
https://kawalpemilu.org#75838,"PIDARA, BALLA, MAMASA, SULAWESI BARAT",1,197,32,229
https://kawalpemilu.org#75838,"PIDARA, BALLA, MAMASA, SULAWESI BARAT",2,157,19,176
https://kawalpemilu.org#75839,"BALLA TIMUR, BALLA, MAMASA, SULAWESI BARAT",1,157,14,171
https://kawalpemilu.org#75840,"BAMBAPUANG, BALLA, MAMASA, SULAWESI BARAT",1,148,12,160
https://kawalpemilu.org#75840,"BAMBAPUANG, BALLA, MAMASA, SULAWESI BARAT",2,164,20,184
https://kawalpemilu.org#75842,"NOSU, NOSU, MAMASA, SULAWESI BARAT",1,215,12,227
https://kawalpemilu.org#75842,"NOSU, NOSU, MAMASA, SULAWESI BARAT",2,139,12,151
https://kawalpemilu.org#75842,"NOSU, NOSU, MAMASA, SULAWESI BARAT",3,157,6,163
https://kawalpemilu.org#75843,"MINANGA, NOSU, MAMASA, SULAWESI BARAT",1,158,9,167
https://kawalpemilu.org#75843,"MINANGA, NOSU, MAMASA, SULAWESI BARAT",2,129,6,135
https://kawalpemilu.org#75844,"BATUPAPAN, NOSU, MAMASA, SULAWESI BARAT",1,126,6,132
https://kawalpemilu.org#75844,"BATUPAPAN, NOSU, MAMASA, SULAWESI BARAT",2,158,7,165
https://kawalpemilu.org#75844,"BATUPAPAN, NOSU, MAMASA, SULAWESI BARAT",3,172,5,177
https://kawalpemilu.org#75844,"BATUPAPAN, NOSU, MAMASA, SULAWESI BARAT",4,129,7,136
https://kawalpemilu.org#75845,"MASEWE, NOSU, MAMASA, SULAWESI BARAT",1,159,15,174
https://kawalpemilu.org#75845,"MASEWE, NOSU, MAMASA, SULAWESI BARAT",2,184,8,192
https://kawalpemilu.org#75845,"MASEWE, NOSU, MAMASA, SULAWESI BARAT",3,153,11,164
https://kawalpemilu.org#75846,"SIWI, NOSU, MAMASA, SULAWESI BARAT",1,176,11,187
https://kawalpemilu.org#75846,"SIWI, NOSU, MAMASA, SULAWESI BARAT",2,133,11,144
https://kawalpemilu.org#75847,"MINANGA TIMUR, NOSU, MAMASA, SULAWESI BARAT",1,108,6,114
https://kawalpemilu.org#75847,"MINANGA TIMUR, NOSU, MAMASA, SULAWESI BARAT",2,143,5,148
https://kawalpemilu.org#75847,"MINANGA TIMUR, NOSU, MAMASA, SULAWESI BARAT",3,103,5,108
https://kawalpemilu.org#75848,"PARINDING, NOSU, MAMASA, SULAWESI BARAT",1,110,4,114
https://kawalpemilu.org#75848,"PARINDING, NOSU, MAMASA, SULAWESI BARAT",2,123,5,128
https://kawalpemilu.org#75850,"TAWALIAN, TAWALIAN, MAMASA, SULAWESI BARAT",1,142,55,197
https://kawalpemilu.org#75850,"TAWALIAN, TAWALIAN, MAMASA, SULAWESI BARAT",2,156,5,161
https://kawalpemilu.org#75850,"TAWALIAN, TAWALIAN, MAMASA, SULAWESI BARAT",3,166,20,186
https://kawalpemilu.org#75850,"TAWALIAN, TAWALIAN, MAMASA, SULAWESI BARAT",4,120,5,125
https://kawalpemilu.org#75850,"TAWALIAN, TAWALIAN, MAMASA, SULAWESI BARAT",5,182,17,199
https://kawalpemilu.org#75850,"TAWALIAN, TAWALIAN, MAMASA, SULAWESI BARAT",6,180,4,184
https://kawalpemilu.org#75850,"TAWALIAN, TAWALIAN, MAMASA, SULAWESI BARAT",7,136,9,145
https://kawalpemilu.org#75850,"TAWALIAN, TAWALIAN, MAMASA, SULAWESI BARAT",8,106,7,131
https://kawalpemilu.org#75850,"TAWALIAN, TAWALIAN, MAMASA, SULAWESI BARAT",9,178,13,191
https://kawalpemilu.org#75850,"TAWALIAN, TAWALIAN, MAMASA, SULAWESI BARAT",10,83,4,87
https://kawalpemilu.org#75851,"TAWALIAN TIMUR, TAWALIAN, MAMASA, SULAWESI BARAT",1,183,18,201
https://kawalpemilu.org#75851,"TAWALIAN TIMUR, TAWALIAN, MAMASA, SULAWESI BARAT",2,216,31,247
https://kawalpemilu.org#75851,"TAWALIAN TIMUR, TAWALIAN, MAMASA, SULAWESI BARAT",3,218,20,238
https://kawalpemilu.org#75851,"TAWALIAN TIMUR, TAWALIAN, MAMASA, SULAWESI BARAT",4,239,13,252
https://kawalpemilu.org#75851,"TAWALIAN TIMUR, TAWALIAN, MAMASA, SULAWESI BARAT",5,174,9,183
https://kawalpemilu.org#75851,"TAWALIAN TIMUR, TAWALIAN, MAMASA, SULAWESI BARAT",6,220,14,234
https://kawalpemilu.org#75851,"TAWALIAN TIMUR, TAWALIAN, MAMASA, SULAWESI BARAT",7,136,9,145
https://kawalpemilu.org#75851,"TAWALIAN TIMUR, TAWALIAN, MAMASA, SULAWESI BARAT",8,60,5,65
https://kawalpemilu.org#75852,"KARIANGO, TAWALIAN, MAMASA, SULAWESI BARAT",1,216,22,238
https://kawalpemilu.org#75852,"KARIANGO, TAWALIAN, MAMASA, SULAWESI BARAT",2,200,16,216
https://kawalpemilu.org#75852,"KARIANGO, TAWALIAN, MAMASA, SULAWESI BARAT",3,201,11,212
https://kawalpemilu.org#75852,"KARIANGO, TAWALIAN, MAMASA, SULAWESI BARAT",4,206,25,231
https://kawalpemilu.org#75852,"KARIANGO, TAWALIAN, MAMASA, SULAWESI BARAT",5,91,3,94
https://kawalpemilu.org#75853,"RANTETANGNGA, TAWALIAN, MAMASA, SULAWESI BARAT",1,172,5,177
https://kawalpemilu.org#75853,"RANTETANGNGA, TAWALIAN, MAMASA, SULAWESI BARAT",2,209,16,225
https://kawalpemilu.org#75853,"RANTETANGNGA, TAWALIAN, MAMASA, SULAWESI BARAT",3,200,9,209
https://kawalpemilu.org#75853,"RANTETANGNGA, TAWALIAN, MAMASA, SULAWESI BARAT",4,182,6,188
https://kawalpemilu.org#75855,"SALUMOKANAN, RANTEBULAHAN TIMUR, MAMASA, SULAWESI BARAT",1,118,22,140
https://kawalpemilu.org#75855,"SALUMOKANAN, RANTEBULAHAN TIMUR, MAMASA, SULAWESI BARAT",2,139,20,159
https://kawalpemilu.org#75855,"SALUMOKANAN, RANTEBULAHAN TIMUR, MAMASA, SULAWESI BARAT",3,100,19,119
https://kawalpemilu.org#75855,"SALUMOKANAN, RANTEBULAHAN TIMUR, MAMASA, SULAWESI BARAT",4,99,5,104
https://kawalpemilu.org#75856,"SALUMOKANAN BARAT, RANTEBULAHAN TIMUR, MAMASA, SULAWESI BARAT",1,133,11,144
https://kawalpemilu.org#75856,"SALUMOKANAN BARAT, RANTEBULAHAN TIMUR, MAMASA, SULAWESI BARAT",2,145,6,151
https://kawalpemilu.org#75856,"SALUMOKANAN BARAT, RANTEBULAHAN TIMUR, MAMASA, SULAWESI BARAT",3,133,20,135
https://kawalpemilu.org#75856,"SALUMOKANAN BARAT, RANTEBULAHAN TIMUR, MAMASA, SULAWESI BARAT",4,136,17,153
https://kawalpemilu.org#75857,"BUANGIN, RANTEBULAHAN TIMUR, MAMASA, SULAWESI BARAT",1,196,4,200
https://kawalpemilu.org#75857,"BUANGIN, RANTEBULAHAN TIMUR, MAMASA, SULAWESI BARAT",2,160,3,163
https://kawalpemilu.org#75857,"BUANGIN, RANTEBULAHAN TIMUR, MAMASA, SULAWESI BARAT",3,117,6,123
https://kawalpemilu.org#75857,"BUANGIN, RANTEBULAHAN TIMUR, MAMASA, SULAWESI BARAT",4,110,1,111
https://kawalpemilu.org#75858,"BAMBANG BUDA, RANTEBULAHAN TIMUR, MAMASA, SULAWESI BARAT",1,170,8,178
https://kawalpemilu.org#75858,"BAMBANG BUDA, RANTEBULAHAN TIMUR, MAMASA, SULAWESI BARAT",2,158,10,168
https://kawalpemilu.org#75858,"BAMBANG BUDA, RANTEBULAHAN TIMUR, MAMASA, SULAWESI BARAT",3,153,18,171
https://kawalpemilu.org#75858,"BAMBANG BUDA, RANTEBULAHAN TIMUR, MAMASA, SULAWESI BARAT",4,149,8,157
https://kawalpemilu.org#75859,"LEKO, RANTEBULAHAN TIMUR, MAMASA, SULAWESI BARAT",1,115,27,142
https://kawalpemilu.org#75859,"LEKO, RANTEBULAHAN TIMUR, MAMASA, SULAWESI BARAT",2,113,25,138
https://kawalpemilu.org#75860,"KIRAK, RANTEBULAHAN TIMUR, MAMASA, SULAWESI BARAT",1,196,9,205
https://kawalpemilu.org#75860,"KIRAK, RANTEBULAHAN TIMUR, MAMASA, SULAWESI BARAT",2,185,7,192
https://kawalpemilu.org#75860,"KIRAK, RANTEBULAHAN TIMUR, MAMASA, SULAWESI BARAT",3,127,14,141
https://kawalpemilu.org#75861,"SALUMOKANAN UTARA, RANTEBULAHAN TIMUR, MAMASA, SULAWESI BARAT",1,153,9,162
https://kawalpemilu.org#75861,"SALUMOKANAN UTARA, RANTEBULAHAN TIMUR, MAMASA, SULAWESI BARAT",2,185,17,202
https://kawalpemilu.org#75861,"SALUMOKANAN UTARA, RANTEBULAHAN TIMUR, MAMASA, SULAWESI BARAT",3,83,13,96
https://kawalpemilu.org#75861,"SALUMOKANAN UTARA, RANTEBULAHAN TIMUR, MAMASA, SULAWESI BARAT",4,57,8,65
https://kawalpemilu.org#75862,"SALUBANUA SELATAN, RANTEBULAHAN TIMUR, MAMASA, SULAWESI BARAT",1,227,1,227
https://kawalpemilu.org#75862,"SALUBANUA SELATAN, RANTEBULAHAN TIMUR, MAMASA, SULAWESI BARAT",2,109,0,109
https://kawalpemilu.org#75695,"BUNTUMALANGKA, BUNTUMALANGKA, MAMASA, SULAWESI BARAT",1,127,55,182
https://kawalpemilu.org#75695,"BUNTUMALANGKA, BUNTUMALANGKA, MAMASA, SULAWESI BARAT",2,102,49,151
https://kawalpemilu.org#75695,"BUNTUMALANGKA, BUNTUMALANGKA, MAMASA, SULAWESI BARAT",3,141,36,177
https://kawalpemilu.org#75695,"BUNTUMALANGKA, BUNTUMALANGKA, MAMASA, SULAWESI BARAT",4,139,17,156
https://kawalpemilu.org#75699,"SALUTAMBUN, BUNTUMALANGKA, MAMASA, SULAWESI BARAT",1,88,54,142
https://kawalpemilu.org#75699,"SALUTAMBUN, BUNTUMALANGKA, MAMASA, SULAWESI BARAT",2,95,31,126
https://kawalpemilu.org#75704,"ARALLE TIMUR, BUNTUMALANGKA, MAMASA, SULAWESI BARAT",1,150,9,159
https://kawalpemilu.org#75704,"ARALLE TIMUR, BUNTUMALANGKA, MAMASA, SULAWESI BARAT",2,191,25,216
https://kawalpemilu.org#75705,"KABAE, BUNTUMALANGKA, MAMASA, SULAWESI BARAT",1,246,11,257
https://kawalpemilu.org#75705,"KABAE, BUNTUMALANGKA, MAMASA, SULAWESI BARAT",2,198,11,209
https://kawalpemilu.org#75707,"KEBANGA, BUNTUMALANGKA, MAMASA, SULAWESI BARAT",1,187,21,208
https://kawalpemilu.org#75707,"KEBANGA, BUNTUMALANGKA, MAMASA, SULAWESI BARAT",2,174,16,190
https://kawalpemilu.org#75712,"PENATANGAN, BUNTUMALANGKA, MAMASA, SULAWESI BARAT",1,248,24,272
https://kawalpemilu.org#75712,"PENATANGAN, BUNTUMALANGKA, MAMASA, SULAWESI BARAT",2,189,41,230
https://kawalpemilu.org#75712,"PENATANGAN, BUNTUMALANGKA, MAMASA, SULAWESI BARAT",3,212,17,229
https://kawalpemilu.org#75740,"SALUTAMBUN TIMUR, BUNTUMALANGKA, MAMASA, SULAWESI BARAT",1,120,44,164
https://kawalpemilu.org#75740,"SALUTAMBUN TIMUR, BUNTUMALANGKA, MAMASA, SULAWESI BARAT",2,124,36,160
https://kawalpemilu.org#75749,"TAORA, BUNTUMALANGKA, MAMASA, SULAWESI BARAT",1,164,24,188
https://kawalpemilu.org#75749,"TAORA, BUNTUMALANGKA, MAMASA, SULAWESI BARAT",2,171,23,194
https://kawalpemilu.org#89671,"RANTEBERANG, BUNTUMALANGKA, MAMASA, SULAWESI BARAT",1,60,72,132
https://kawalpemilu.org#89671,"RANTEBERANG, BUNTUMALANGKA, MAMASA, SULAWESI BARAT",2,145,36,181
https://kawalpemilu.org#89671,"RANTEBERANG, BUNTUMALANGKA, MAMASA, SULAWESI BARAT",3,141,81,222
https://kawalpemilu.org#89671,"RANTEBERANG, BUNTUMALANGKA, MAMASA, SULAWESI BARAT",4,76,64,140
https://kawalpemilu.org#89672,"SALURINDUK, BUNTUMALANGKA, MAMASA, SULAWESI BARAT",1,82,46,128
https://kawalpemilu.org#89672,"SALURINDUK, BUNTUMALANGKA, MAMASA, SULAWESI BARAT",2,107,48,155
https://kawalpemilu.org#927860,"SALUTAMBUN BARAT, BUNTUMALANGKA, MAMASA, SULAWESI BARAT",1,206,40,246
https://kawalpemilu.org#927860,"SALUTAMBUN BARAT, BUNTUMALANGKA, MAMASA, SULAWESI BARAT",2,197,70,267
https://kawalpemilu.org#32217,"SALUAHO, MEHALAAN, MAMASA, SULAWESI BARAT",1,123,78,201
https://kawalpemilu.org#75674,"MEHALAAN, MEHALAAN, MAMASA, SULAWESI BARAT",1,69,22,91
https://kawalpemilu.org#75674,"MEHALAAN, MEHALAAN, MAMASA, SULAWESI BARAT",2,84,24,108
https://kawalpemilu.org#75674,"MEHALAAN, MEHALAAN, MAMASA, SULAWESI BARAT",3,75,10,85
https://kawalpemilu.org#75677,"BOTTENG, MEHALAAN, MAMASA, SULAWESI BARAT",1,96,48,144
https://kawalpemilu.org#75677,"BOTTENG, MEHALAAN, MAMASA, SULAWESI BARAT",2,110,20,130
https://kawalpemilu.org#75678,"SALUKONTA, MEHALAAN, MAMASA, SULAWESI BARAT",1,124,79,203
https://kawalpemilu.org#75678,"SALUKONTA, MEHALAAN, MAMASA, SULAWESI BARAT",2,86,13,99
https://kawalpemilu.org#75688,"LEKO SUKAMAJU, MEHALAAN, MAMASA, SULAWESI BARAT",1,50,13,63
https://kawalpemilu.org#75688,"LEKO SUKAMAJU, MEHALAAN, MAMASA, SULAWESI BARAT",2,63,5,68
https://kawalpemilu.org#75689,"MEHALAAN BARAT, MEHALAAN, MAMASA, SULAWESI BARAT",1,177,16,193
https://kawalpemilu.org#75689,"MEHALAAN BARAT, MEHALAAN, MAMASA, SULAWESI BARAT",2,175,9,184
https://kawalpemilu.org#75690,"PASSEMBUK, MEHALAAN, MAMASA, SULAWESI BARAT",1,83,33,116
https://kawalpemilu.org#75690,"PASSEMBUK, MEHALAAN, MAMASA, SULAWESI BARAT",2,58,9,67
https://kawalpemilu.org#89673,"MESAKADA, MEHALAAN, MAMASA, SULAWESI BARAT",1,134,6,140
https://kawalpemilu.org#89673,"MESAKADA, MEHALAAN, MAMASA, SULAWESI BARAT",2,55,6,61
https://kawalpemilu.org#89673,"MESAKADA, MEHALAAN, MAMASA, SULAWESI BARAT",3,111,13,124
https://kawalpemilu.org#928779,"SALUBALO, MEHALAAN, MAMASA, SULAWESI BARAT",1,204,20,224
https://kawalpemilu.org#928780,"KONDO, MEHALAAN, MAMASA, SULAWESI BARAT",1,143,49,192
https://kawalpemilu.org#928781,"ULUMEA, MEHALAAN, MAMASA, SULAWESI BARAT",1,116,24,140
https://kawalpemilu.org#75865,"TINAMBUNG, TINAMBUNG, POLEWALI MANDAR, SULAWESI BARAT",1,90,110,200
https://kawalpemilu.org#75865,"TINAMBUNG, TINAMBUNG, POLEWALI MANDAR, SULAWESI BARAT",2,90,103,193
https://kawalpemilu.org#75865,"TINAMBUNG, TINAMBUNG, POLEWALI MANDAR, SULAWESI BARAT",3,92,103,195
https://kawalpemilu.org#75865,"TINAMBUNG, TINAMBUNG, POLEWALI MANDAR, SULAWESI BARAT",4,88,100,188
https://kawalpemilu.org#75865,"TINAMBUNG, TINAMBUNG, POLEWALI MANDAR, SULAWESI BARAT",5,86,89,175
https://kawalpemilu.org#75865,"TINAMBUNG, TINAMBUNG, POLEWALI MANDAR, SULAWESI BARAT",6,89,119,208
https://kawalpemilu.org#75865,"TINAMBUNG, TINAMBUNG, POLEWALI MANDAR, SULAWESI BARAT",7,118,99,217
https://kawalpemilu.org#75865,"TINAMBUNG, TINAMBUNG, POLEWALI MANDAR, SULAWESI BARAT",8,95,127,222
https://kawalpemilu.org#75865,"TINAMBUNG, TINAMBUNG, POLEWALI MANDAR, SULAWESI BARAT",9,94,101,195
https://kawalpemilu.org#75865,"TINAMBUNG, TINAMBUNG, POLEWALI MANDAR, SULAWESI BARAT",10,75,131,206
https://kawalpemilu.org#75865,"TINAMBUNG, TINAMBUNG, POLEWALI MANDAR, SULAWESI BARAT",11,81,147,228
https://kawalpemilu.org#75865,"TINAMBUNG, TINAMBUNG, POLEWALI MANDAR, SULAWESI BARAT",12,78,148,226
https://kawalpemilu.org#75866,"KARAMA, TINAMBUNG, POLEWALI MANDAR, SULAWESI BARAT",1,141,91,232
https://kawalpemilu.org#75866,"KARAMA, TINAMBUNG, POLEWALI MANDAR, SULAWESI BARAT",2,193,60,253
https://kawalpemilu.org#75866,"KARAMA, TINAMBUNG, POLEWALI MANDAR, SULAWESI BARAT",3,207,48,255
https://kawalpemilu.org#75866,"KARAMA, TINAMBUNG, POLEWALI MANDAR, SULAWESI BARAT",4,174,63,237
https://kawalpemilu.org#75866,"KARAMA, TINAMBUNG, POLEWALI MANDAR, SULAWESI BARAT",5,191,40,231
https://kawalpemilu.org#75866,"KARAMA, TINAMBUNG, POLEWALI MANDAR, SULAWESI BARAT",6,179,54,233
https://kawalpemilu.org#75866,"KARAMA, TINAMBUNG, POLEWALI MANDAR, SULAWESI BARAT",7,185,53,238
https://kawalpemilu.org#75866,"KARAMA, TINAMBUNG, POLEWALI MANDAR, SULAWESI BARAT",8,142,30,172
https://kawalpemilu.org#75866,"KARAMA, TINAMBUNG, POLEWALI MANDAR, SULAWESI BARAT",9,143,44,187
https://kawalpemilu.org#75866,"KARAMA, TINAMBUNG, POLEWALI MANDAR, SULAWESI BARAT",10,125,60,185
https://kawalpemilu.org#75866,"KARAMA, TINAMBUNG, POLEWALI MANDAR, SULAWESI BARAT",11,116,50,166
https://kawalpemilu.org#75866,"KARAMA, TINAMBUNG, POLEWALI MANDAR, SULAWESI BARAT",12,164,45,209
https://kawalpemilu.org#75866,"KARAMA, TINAMBUNG, POLEWALI MANDAR, SULAWESI BARAT",13,159,35,194
https://kawalpemilu.org#75866,"KARAMA, TINAMBUNG, POLEWALI MANDAR, SULAWESI BARAT",14,142,44,186
https://kawalpemilu.org#75867,"TANGNGA TANGNGA, TINAMBUNG, POLEWALI MANDAR, SULAWESI BARAT",1,157,82,239
https://kawalpemilu.org#75867,"TANGNGA TANGNGA, TINAMBUNG, POLEWALI MANDAR, SULAWESI BARAT",2,183,49,232
https://kawalpemilu.org#75867,"TANGNGA TANGNGA, TINAMBUNG, POLEWALI MANDAR, SULAWESI BARAT",3,172,65,237
https://kawalpemilu.org#75867,"TANGNGA TANGNGA, TINAMBUNG, POLEWALI MANDAR, SULAWESI BARAT",4,228,28,256
https://kawalpemilu.org#75867,"TANGNGA TANGNGA, TINAMBUNG, POLEWALI MANDAR, SULAWESI BARAT",5,169,67,236
https://kawalpemilu.org#75867,"TANGNGA TANGNGA, TINAMBUNG, POLEWALI MANDAR, SULAWESI BARAT",6,138,104,242
https://kawalpemilu.org#75867,"TANGNGA TANGNGA, TINAMBUNG, POLEWALI MANDAR, SULAWESI BARAT",7,143,77,220
https://kawalpemilu.org#75867,"TANGNGA TANGNGA, TINAMBUNG, POLEWALI MANDAR, SULAWESI BARAT",8,147,64,211
https://kawalpemilu.org#75868,"LEKOPADIS, TINAMBUNG, POLEWALI MANDAR, SULAWESI BARAT",1,118,121,239
https://kawalpemilu.org#75868,"LEKOPADIS, TINAMBUNG, POLEWALI MANDAR, SULAWESI BARAT",2,133,98,231
https://kawalpemilu.org#75868,"LEKOPADIS, TINAMBUNG, POLEWALI MANDAR, SULAWESI BARAT",3,95,118,213
https://kawalpemilu.org#75868,"LEKOPADIS, TINAMBUNG, POLEWALI MANDAR, SULAWESI BARAT",4,88,90,178
https://kawalpemilu.org#75868,"LEKOPADIS, TINAMBUNG, POLEWALI MANDAR, SULAWESI BARAT",5,123,104,227
https://kawalpemilu.org#75868,"LEKOPADIS, TINAMBUNG, POLEWALI MANDAR, SULAWESI BARAT",6,127,105,232
https://kawalpemilu.org#75868,"LEKOPADIS, TINAMBUNG, POLEWALI MANDAR, SULAWESI BARAT",7,152,52,204
https://kawalpemilu.org#75869,"GALUNG LOMBOK, TINAMBUNG, POLEWALI MANDAR, SULAWESI BARAT",1,96,138,234
https://kawalpemilu.org#75869,"GALUNG LOMBOK, TINAMBUNG, POLEWALI MANDAR, SULAWESI BARAT",2,104,102,206
https://kawalpemilu.org#75869,"GALUNG LOMBOK, TINAMBUNG, POLEWALI MANDAR, SULAWESI BARAT",3,132,84,216
https://kawalpemilu.org#75869,"GALUNG LOMBOK, TINAMBUNG, POLEWALI MANDAR, SULAWESI BARAT",4,102,104,206
https://kawalpemilu.org#75869,"GALUNG LOMBOK, TINAMBUNG, POLEWALI MANDAR, SULAWESI BARAT",5,94,104,198
https://kawalpemilu.org#75869,"GALUNG LOMBOK, TINAMBUNG, POLEWALI MANDAR, SULAWESI BARAT",6,91,116,207
https://kawalpemilu.org#75870,"TANDUNG, TINAMBUNG, POLEWALI MANDAR, SULAWESI BARAT",1,57,118,175
https://kawalpemilu.org#75870,"TANDUNG, TINAMBUNG, POLEWALI MANDAR, SULAWESI BARAT",2,108,103,211
https://kawalpemilu.org#75870,"TANDUNG, TINAMBUNG, POLEWALI MANDAR, SULAWESI BARAT",3,98,126,224
https://kawalpemilu.org#75870,"TANDUNG, TINAMBUNG, POLEWALI MANDAR, SULAWESI BARAT",4,99,110,209
https://kawalpemilu.org#75870,"TANDUNG, TINAMBUNG, POLEWALI MANDAR, SULAWESI BARAT",5,72,132,204
https://kawalpemilu.org#75870,"TANDUNG, TINAMBUNG, POLEWALI MANDAR, SULAWESI BARAT",6,62,137,199
https://kawalpemilu.org#75871,"BATULAYA, TINAMBUNG, POLEWALI MANDAR, SULAWESI BARAT",1,103,122,225
https://kawalpemilu.org#75871,"BATULAYA, TINAMBUNG, POLEWALI MANDAR, SULAWESI BARAT",2,123,84,207
https://kawalpemilu.org#75871,"BATULAYA, TINAMBUNG, POLEWALI MANDAR, SULAWESI BARAT",3,113,104,217
https://kawalpemilu.org#75871,"BATULAYA, TINAMBUNG, POLEWALI MANDAR, SULAWESI BARAT",4,141,80,221
https://kawalpemilu.org#75871,"BATULAYA, TINAMBUNG, POLEWALI MANDAR, SULAWESI BARAT",5,109,89,198
https://kawalpemilu.org#75872,"SEPABATU, TINAMBUNG, POLEWALI MANDAR, SULAWESI BARAT",1,121,102,223
https://kawalpemilu.org#75872,"SEPABATU, TINAMBUNG, POLEWALI MANDAR, SULAWESI BARAT",2,121,79,200
https://kawalpemilu.org#75872,"SEPABATU, TINAMBUNG, POLEWALI MANDAR, SULAWESI BARAT",3,122,53,175
https://kawalpemilu.org#75872,"SEPABATU, TINAMBUNG, POLEWALI MANDAR, SULAWESI BARAT",4,144,49,193
https://kawalpemilu.org#75872,"SEPABATU, TINAMBUNG, POLEWALI MANDAR, SULAWESI BARAT",5,130,88,218
https://kawalpemilu.org#75872,"SEPABATU, TINAMBUNG, POLEWALI MANDAR, SULAWESI BARAT",6,101,102,203
https://kawalpemilu.org#75874,"PAPPANG, CAMPALAGIAN, POLEWALI MANDAR, SULAWESI BARAT",1,88,132,220
https://kawalpemilu.org#75874,"PAPPANG, CAMPALAGIAN, POLEWALI MANDAR, SULAWESI BARAT",2,92,131,223
https://kawalpemilu.org#75874,"PAPPANG, CAMPALAGIAN, POLEWALI MANDAR, SULAWESI BARAT",3,96,141,237
https://kawalpemilu.org#75874,"PAPPANG, CAMPALAGIAN, POLEWALI MANDAR, SULAWESI BARAT",4,88,132,220
https://kawalpemilu.org#75874,"PAPPANG, CAMPALAGIAN, POLEWALI MANDAR, SULAWESI BARAT",5,54,50,104
https://kawalpemilu.org#75874,"PAPPANG, CAMPALAGIAN, POLEWALI MANDAR, SULAWESI BARAT",6,114,100,214
https://kawalpemilu.org#75874,"PAPPANG, CAMPALAGIAN, POLEWALI MANDAR, SULAWESI BARAT",7,105,87,192
https://kawalpemilu.org#75874,"PAPPANG, CAMPALAGIAN, POLEWALI MANDAR, SULAWESI BARAT",8,99,102,201
https://kawalpemilu.org#75874,"PAPPANG, CAMPALAGIAN, POLEWALI MANDAR, SULAWESI BARAT",9,145,34,179
https://kawalpemilu.org#75874,"PAPPANG, CAMPALAGIAN, POLEWALI MANDAR, SULAWESI BARAT",10,81,127,208
https://kawalpemilu.org#75875,"LALIKO, CAMPALAGIAN, POLEWALI MANDAR, SULAWESI BARAT",1,78,61,139
https://kawalpemilu.org#75875,"LALIKO, CAMPALAGIAN, POLEWALI MANDAR, SULAWESI BARAT",2,77,88,165
https://kawalpemilu.org#75875,"LALIKO, CAMPALAGIAN, POLEWALI MANDAR, SULAWESI BARAT",3,131,53,184
https://kawalpemilu.org#75875,"LALIKO, CAMPALAGIAN, POLEWALI MANDAR, SULAWESI BARAT",4,153,61,214
https://kawalpemilu.org#75875,"LALIKO, CAMPALAGIAN, POLEWALI MANDAR, SULAWESI BARAT",5,134,78,212
https://kawalpemilu.org#75875,"LALIKO, CAMPALAGIAN, POLEWALI MANDAR, SULAWESI BARAT",6,127,80,207
https://kawalpemilu.org#75875,"LALIKO, CAMPALAGIAN, POLEWALI MANDAR, SULAWESI BARAT",7,90,38,128
https://kawalpemilu.org#75875,"LALIKO, CAMPALAGIAN, POLEWALI MANDAR, SULAWESI BARAT",8,71,104,175
https://kawalpemilu.org#75875,"LALIKO, CAMPALAGIAN, POLEWALI MANDAR, SULAWESI BARAT",9,122,77,199
https://kawalpemilu.org#75875,"LALIKO, CAMPALAGIAN, POLEWALI MANDAR, SULAWESI BARAT",10,137,74,211
https://kawalpemilu.org#75876,"BONDE, CAMPALAGIAN, POLEWALI MANDAR, SULAWESI BARAT",1,80,170,250
https://kawalpemilu.org#75876,"BONDE, CAMPALAGIAN, POLEWALI MANDAR, SULAWESI BARAT",2,86,103,189
https://kawalpemilu.org#75876,"BONDE, CAMPALAGIAN, POLEWALI MANDAR, SULAWESI BARAT",3,65,158,223
https://kawalpemilu.org#75876,"BONDE, CAMPALAGIAN, POLEWALI MANDAR, SULAWESI BARAT",4,86,130,216
https://kawalpemilu.org#75876,"BONDE, CAMPALAGIAN, POLEWALI MANDAR, SULAWESI BARAT",5,69,131,200
https://kawalpemilu.org#75876,"BONDE, CAMPALAGIAN, POLEWALI MANDAR, SULAWESI BARAT",6,136,97,233
https://kawalpemilu.org#75876,"BONDE, CAMPALAGIAN, POLEWALI MANDAR, SULAWESI BARAT",7,113,94,207
https://kawalpemilu.org#75876,"BONDE, CAMPALAGIAN, POLEWALI MANDAR, SULAWESI BARAT",8,138,85,223
https://kawalpemilu.org#75876,"BONDE, CAMPALAGIAN, POLEWALI MANDAR, SULAWESI BARAT",9,133,80,213
https://kawalpemilu.org#75876,"BONDE, CAMPALAGIAN, POLEWALI MANDAR, SULAWESI BARAT",10,63,118,181
https://kawalpemilu.org#75876,"BONDE, CAMPALAGIAN, POLEWALI MANDAR, SULAWESI BARAT",11,36,130,166
https://kawalpemilu.org#75876,"BONDE, CAMPALAGIAN, POLEWALI MANDAR, SULAWESI BARAT",12,32,69,101
https://kawalpemilu.org#75876,"BONDE, CAMPALAGIAN, POLEWALI MANDAR, SULAWESI BARAT",13,51,36,87
https://kawalpemilu.org#75876,"BONDE, CAMPALAGIAN, POLEWALI MANDAR, SULAWESI BARAT",14,123,80,203
https://kawalpemilu.org#75876,"BONDE, CAMPALAGIAN, POLEWALI MANDAR, SULAWESI BARAT",15,97,122,219
https://kawalpemilu.org#75877,"KATUMBANGAN LEMO, CAMPALAGIAN, POLEWALI MANDAR, SULAWESI BARAT",1,63,132,195
https://kawalpemilu.org#75877,"KATUMBANGAN LEMO, CAMPALAGIAN, POLEWALI MANDAR, SULAWESI BARAT",2,109,77,186
https://kawalpemilu.org#75877,"KATUMBANGAN LEMO, CAMPALAGIAN, POLEWALI MANDAR, SULAWESI BARAT",3,61,154,215
https://kawalpemilu.org#75877,"KATUMBANGAN LEMO, CAMPALAGIAN, POLEWALI MANDAR, SULAWESI BARAT",4,78,135,213
https://kawalpemilu.org#75877,"KATUMBANGAN LEMO, CAMPALAGIAN, POLEWALI MANDAR, SULAWESI BARAT",5,129,98,227
https://kawalpemilu.org#75877,"KATUMBANGAN LEMO, CAMPALAGIAN, POLEWALI MANDAR, SULAWESI BARAT",6,155,58,213
https://kawalpemilu.org#75877,"KATUMBANGAN LEMO, CAMPALAGIAN, POLEWALI MANDAR, SULAWESI BARAT",7,95,81,176
https://kawalpemilu.org#75877,"KATUMBANGAN LEMO, CAMPALAGIAN, POLEWALI MANDAR, SULAWESI BARAT",8,85,106,191
https://kawalpemilu.org#75877,"KATUMBANGAN LEMO, CAMPALAGIAN, POLEWALI MANDAR, SULAWESI BARAT",9,75,149,224
https://kawalpemilu.org#75877,"KATUMBANGAN LEMO, CAMPALAGIAN, POLEWALI MANDAR, SULAWESI BARAT",10,114,78,192
https://kawalpemilu.org#75878,"PANYAMPA, CAMPALAGIAN, POLEWALI MANDAR, SULAWESI BARAT",1,128,92,220
https://kawalpemilu.org#75878,"PANYAMPA, CAMPALAGIAN, POLEWALI MANDAR, SULAWESI BARAT",2,86,149,235
https://kawalpemilu.org#75878,"PANYAMPA, CAMPALAGIAN, POLEWALI MANDAR, SULAWESI BARAT",3,63,158,221
https://kawalpemilu.org#75878,"PANYAMPA, CAMPALAGIAN, POLEWALI MANDAR, SULAWESI BARAT",4,46,138,184
https://kawalpemilu.org#75878,"PANYAMPA, CAMPALAGIAN, POLEWALI MANDAR, SULAWESI BARAT",5,133,90,223
https://kawalpemilu.org#75878,"PANYAMPA, CAMPALAGIAN, POLEWALI MANDAR, SULAWESI BARAT",6,84,125,209
https://kawalpemilu.org#75878,"PANYAMPA, CAMPALAGIAN, POLEWALI MANDAR, SULAWESI BARAT",7,78,85,163
https://kawalpemilu.org#75879,"SURUANG, CAMPALAGIAN, POLEWALI MANDAR, SULAWESI BARAT",1,90,127,217
https://kawalpemilu.org#75879,"SURUANG, CAMPALAGIAN, POLEWALI MANDAR, SULAWESI BARAT",2,85,128,213
https://kawalpemilu.org#75879,"SURUANG, CAMPALAGIAN, POLEWALI MANDAR, SULAWESI BARAT",3,99,103,202
https://kawalpemilu.org#75879,"SURUANG, CAMPALAGIAN, POLEWALI MANDAR, SULAWESI BARAT",4,71,131,202
https://kawalpemilu.org#75879,"SURUANG, CAMPALAGIAN, POLEWALI MANDAR, SULAWESI BARAT",5,119,47,166
https://kawalpemilu.org#75879,"SURUANG, CAMPALAGIAN, POLEWALI MANDAR, SULAWESI BARAT",6,73,70,143
https://kawalpemilu.org#75879,"SURUANG, CAMPALAGIAN, POLEWALI MANDAR, SULAWESI BARAT",7,73,54,127
https://kawalpemilu.org#75880,"LAMPOKO, CAMPALAGIAN, POLEWALI MANDAR, SULAWESI BARAT",1,164,66,230
https://kawalpemilu.org#75880,"LAMPOKO, CAMPALAGIAN, POLEWALI MANDAR, SULAWESI BARAT",2,87,104,191
https://kawalpemilu.org#75880,"LAMPOKO, CAMPALAGIAN, POLEWALI MANDAR, SULAWESI BARAT",3,119,70,189
https://kawalpemilu.org#75880,"LAMPOKO, CAMPALAGIAN, POLEWALI MANDAR, SULAWESI BARAT",4,122,86,208
https://kawalpemilu.org#75880,"LAMPOKO, CAMPALAGIAN, POLEWALI MANDAR, SULAWESI BARAT",5,114,104,218
https://kawalpemilu.org#75880,"LAMPOKO, CAMPALAGIAN, POLEWALI MANDAR, SULAWESI BARAT",6,109,109,218
https://kawalpemilu.org#75880,"LAMPOKO, CAMPALAGIAN, POLEWALI MANDAR, SULAWESI BARAT",7,113,112,225
https://kawalpemilu.org#75880,"LAMPOKO, CAMPALAGIAN, POLEWALI MANDAR, SULAWESI BARAT",8,105,98,203
https://kawalpemilu.org#75880,"LAMPOKO, CAMPALAGIAN, POLEWALI MANDAR, SULAWESI BARAT",9,112,86,192
https://kawalpemilu.org#75880,"LAMPOKO, CAMPALAGIAN, POLEWALI MANDAR, SULAWESI BARAT",10,122,87,209
https://kawalpemilu.org#75880,"LAMPOKO, CAMPALAGIAN, POLEWALI MANDAR, SULAWESI BARAT",11,125,96,221
https://kawalpemilu.org#75881,"KATUMBANGAN, CAMPALAGIAN, POLEWALI MANDAR, SULAWESI BARAT",1,102,154,256
https://kawalpemilu.org#75881,"KATUMBANGAN, CAMPALAGIAN, POLEWALI MANDAR, SULAWESI BARAT",2,158,68,226
https://kawalpemilu.org#75881,"KATUMBANGAN, CAMPALAGIAN, POLEWALI MANDAR, SULAWESI BARAT",3,123,117,240
https://kawalpemilu.org#75881,"KATUMBANGAN, CAMPALAGIAN, POLEWALI MANDAR, SULAWESI BARAT",4,93,103,196
https://kawalpemilu.org#75881,"KATUMBANGAN, CAMPALAGIAN, POLEWALI MANDAR, SULAWESI BARAT",5,74,130,204
https://kawalpemilu.org#75881,"KATUMBANGAN, CAMPALAGIAN, POLEWALI MANDAR, SULAWESI BARAT",6,149,77,226
https://kawalpemilu.org#75881,"KATUMBANGAN, CAMPALAGIAN, POLEWALI MANDAR, SULAWESI BARAT",7,79,150,229
https://kawalpemilu.org#75881,"KATUMBANGAN, CAMPALAGIAN, POLEWALI MANDAR, SULAWESI BARAT",8,83,162,245
https://kawalpemilu.org#75881,"KATUMBANGAN, CAMPALAGIAN, POLEWALI MANDAR, SULAWESI BARAT",9,106,140,146
https://kawalpemilu.org#75881,"KATUMBANGAN, CAMPALAGIAN, POLEWALI MANDAR, SULAWESI BARAT",10,42,145,187
https://kawalpemilu.org#75881,"KATUMBANGAN, CAMPALAGIAN, POLEWALI MANDAR, SULAWESI BARAT",11,116,96,212
https://kawalpemilu.org#75881,"KATUMBANGAN, CAMPALAGIAN, POLEWALI MANDAR, SULAWESI BARAT",12,122,62,184
https://kawalpemilu.org#75882,"LAPEO, CAMPALAGIAN, POLEWALI MANDAR, SULAWESI BARAT",1,107,84,191
https://kawalpemilu.org#75882,"LAPEO, CAMPALAGIAN, POLEWALI MANDAR, SULAWESI BARAT",2,89,133,222
https://kawalpemilu.org#75882,"LAPEO, CAMPALAGIAN, POLEWALI MANDAR, SULAWESI BARAT",3,85,119,204
https://kawalpemilu.org#75882,"LAPEO, CAMPALAGIAN, POLEWALI MANDAR, SULAWESI BARAT",4,124,78,202
https://kawalpemilu.org#75882,"LAPEO, CAMPALAGIAN, POLEWALI MANDAR, SULAWESI BARAT",5,116,105,221
https://kawalpemilu.org#75882,"LAPEO, CAMPALAGIAN, POLEWALI MANDAR, SULAWESI BARAT",6,117,100,217
https://kawalpemilu.org#75882,"LAPEO, CAMPALAGIAN, POLEWALI MANDAR, SULAWESI BARAT",7,117,101,218
https://kawalpemilu.org#75882,"LAPEO, CAMPALAGIAN, POLEWALI MANDAR, SULAWESI BARAT",8,97,85,182
https://kawalpemilu.org#75882,"LAPEO, CAMPALAGIAN, POLEWALI MANDAR, SULAWESI BARAT",9,91,81,172
https://kawalpemilu.org#75882,"LAPEO, CAMPALAGIAN, POLEWALI MANDAR, SULAWESI BARAT",10,120,80,200
https://kawalpemilu.org#75883,"PARAPPE, CAMPALAGIAN, POLEWALI MANDAR, SULAWESI BARAT",1,107,86,193
https://kawalpemilu.org#75883,"PARAPPE, CAMPALAGIAN, POLEWALI MANDAR, SULAWESI BARAT",2,93,116,209
https://kawalpemilu.org#75883,"PARAPPE, CAMPALAGIAN, POLEWALI MANDAR, SULAWESI BARAT",3,129,101,230
https://kawalpemilu.org#75883,"PARAPPE, CAMPALAGIAN, POLEWALI MANDAR, SULAWESI BARAT",4,66,156,222
https://kawalpemilu.org#75883,"PARAPPE, CAMPALAGIAN, POLEWALI MANDAR, SULAWESI BARAT",5,75,127,202
https://kawalpemilu.org#75883,"PARAPPE, CAMPALAGIAN, POLEWALI MANDAR, SULAWESI BARAT",6,92,128,220
https://kawalpemilu.org#75883,"PARAPPE, CAMPALAGIAN, POLEWALI MANDAR, SULAWESI BARAT",7,83,107,190
https://kawalpemilu.org#75883,"PARAPPE, CAMPALAGIAN, POLEWALI MANDAR, SULAWESI BARAT",8,90,115,205
https://kawalpemilu.org#75883,"PARAPPE, CAMPALAGIAN, POLEWALI MANDAR, SULAWESI BARAT",9,89,129,218
https://kawalpemilu.org#75883,"PARAPPE, CAMPALAGIAN, POLEWALI MANDAR, SULAWESI BARAT",10,97,141,238
https://kawalpemilu.org#75883,"PARAPPE, CAMPALAGIAN, POLEWALI MANDAR, SULAWESI BARAT",11,68,139,207
https://kawalpemilu.org#75884,"ONGKO, CAMPALAGIAN, POLEWALI MANDAR, SULAWESI BARAT",1,90,59,149
https://kawalpemilu.org#75884,"ONGKO, CAMPALAGIAN, POLEWALI MANDAR, SULAWESI BARAT",2,110,60,170
https://kawalpemilu.org#75884,"ONGKO, CAMPALAGIAN, POLEWALI MANDAR, SULAWESI BARAT",3,140,72,212
https://kawalpemilu.org#75884,"ONGKO, CAMPALAGIAN, POLEWALI MANDAR, SULAWESI BARAT",4,126,65,191
https://kawalpemilu.org#75884,"ONGKO, CAMPALAGIAN, POLEWALI MANDAR, SULAWESI BARAT",5,92,67,159
https://kawalpemilu.org#75885,"KENJE, CAMPALAGIAN, POLEWALI MANDAR, SULAWESI BARAT",1,90,119,209
https://kawalpemilu.org#75885,"KENJE, CAMPALAGIAN, POLEWALI MANDAR, SULAWESI BARAT",2,104,107,211
https://kawalpemilu.org#75885,"KENJE, CAMPALAGIAN, POLEWALI MANDAR, SULAWESI BARAT",3,83,88,171
https://kawalpemilu.org#75885,"KENJE, CAMPALAGIAN, POLEWALI MANDAR, SULAWESI BARAT",4,112,85,197
https://kawalpemilu.org#75885,"KENJE, CAMPALAGIAN, POLEWALI MANDAR, SULAWESI BARAT",5,115,91,206
https://kawalpemilu.org#75885,"KENJE, CAMPALAGIAN, POLEWALI MANDAR, SULAWESI BARAT",6,96,131,227
https://kawalpemilu.org#75885,"KENJE, CAMPALAGIAN, POLEWALI MANDAR, SULAWESI BARAT",7,118,77,195
https://kawalpemilu.org#75885,"KENJE, CAMPALAGIAN, POLEWALI MANDAR, SULAWESI BARAT",8,104,88,192
https://kawalpemilu.org#75885,"KENJE, CAMPALAGIAN, POLEWALI MANDAR, SULAWESI BARAT",9,102,88,190
https://kawalpemilu.org#75886,"SUMARRANG, CAMPALAGIAN, POLEWALI MANDAR, SULAWESI BARAT",1,149,46,195
https://kawalpemilu.org#75886,"SUMARRANG, CAMPALAGIAN, POLEWALI MANDAR, SULAWESI BARAT",2,157,40,197
https://kawalpemilu.org#75886,"SUMARRANG, CAMPALAGIAN, POLEWALI MANDAR, SULAWESI BARAT",3,172,37,209
https://kawalpemilu.org#75886,"SUMARRANG, CAMPALAGIAN, POLEWALI MANDAR, SULAWESI BARAT",4,122,56,178
https://kawalpemilu.org#75886,"SUMARRANG, CAMPALAGIAN, POLEWALI MANDAR, SULAWESI BARAT",5,145,70,217
https://kawalpemilu.org#75886,"SUMARRANG, CAMPALAGIAN, POLEWALI MANDAR, SULAWESI BARAT",6,106,89,195
https://kawalpemilu.org#75886,"SUMARRANG, CAMPALAGIAN, POLEWALI MANDAR, SULAWESI BARAT",7,111,84,195
https://kawalpemilu.org#75886,"SUMARRANG, CAMPALAGIAN, POLEWALI MANDAR, SULAWESI BARAT",8,121,80,201
https://kawalpemilu.org#75886,"SUMARRANG, CAMPALAGIAN, POLEWALI MANDAR, SULAWESI BARAT",9,71,91,162
https://kawalpemilu.org#75886,"SUMARRANG, CAMPALAGIAN, POLEWALI MANDAR, SULAWESI BARAT",10,119,91,210
https://kawalpemilu.org#75886,"SUMARRANG, CAMPALAGIAN, POLEWALI MANDAR, SULAWESI BARAT",11,135,67,202
https://kawalpemilu.org#75886,"SUMARRANG, CAMPALAGIAN, POLEWALI MANDAR, SULAWESI BARAT",12,58,89,147
https://kawalpemilu.org#75886,"SUMARRANG, CAMPALAGIAN, POLEWALI MANDAR, SULAWESI BARAT",13,130,58,188
https://kawalpemilu.org#75886,"SUMARRANG, CAMPALAGIAN, POLEWALI MANDAR, SULAWESI BARAT",14,164,54,218
https://kawalpemilu.org#75886,"SUMARRANG, CAMPALAGIAN, POLEWALI MANDAR, SULAWESI BARAT",15,118,71,189
https://kawalpemilu.org#75887,"BOTTO, CAMPALAGIAN, POLEWALI MANDAR, SULAWESI BARAT",1,189,56,245
https://kawalpemilu.org#75887,"BOTTO, CAMPALAGIAN, POLEWALI MANDAR, SULAWESI BARAT",2,105,91,196
https://kawalpemilu.org#75887,"BOTTO, CAMPALAGIAN, POLEWALI MANDAR, SULAWESI BARAT",3,123,113,236
https://kawalpemilu.org#75887,"BOTTO, CAMPALAGIAN, POLEWALI MANDAR, SULAWESI BARAT",4,105,80,185
https://kawalpemilu.org#75887,"BOTTO, CAMPALAGIAN, POLEWALI MANDAR, SULAWESI BARAT",5,119,34,153
https://kawalpemilu.org#75887,"BOTTO, CAMPALAGIAN, POLEWALI MANDAR, SULAWESI BARAT",6,112,65,177
https://kawalpemilu.org#75887,"BOTTO, CAMPALAGIAN, POLEWALI MANDAR, SULAWESI BARAT",7,140,54,194
https://kawalpemilu.org#75887,"BOTTO, CAMPALAGIAN, POLEWALI MANDAR, SULAWESI BARAT",8,114,104,218
https://kawalpemilu.org#75887,"BOTTO, CAMPALAGIAN, POLEWALI MANDAR, SULAWESI BARAT",9,122,68,190
https://kawalpemilu.org#75887,"BOTTO, CAMPALAGIAN, POLEWALI MANDAR, SULAWESI BARAT",10,117,46,163
https://kawalpemilu.org#75888,"GATTUNGAN, CAMPALAGIAN, POLEWALI MANDAR, SULAWESI BARAT",1,145,66,211
https://kawalpemilu.org#75888,"GATTUNGAN, CAMPALAGIAN, POLEWALI MANDAR, SULAWESI BARAT",2,168,70,238
https://kawalpemilu.org#75888,"GATTUNGAN, CAMPALAGIAN, POLEWALI MANDAR, SULAWESI BARAT",3,123,50,173
https://kawalpemilu.org#75888,"GATTUNGAN, CAMPALAGIAN, POLEWALI MANDAR, SULAWESI BARAT",4,134,48,182
https://kawalpemilu.org#75888,"GATTUNGAN, CAMPALAGIAN, POLEWALI MANDAR, SULAWESI BARAT",5,159,57,216
https://kawalpemilu.org#75889,"PADANG TIMUR, CAMPALAGIAN, POLEWALI MANDAR, SULAWESI BARAT",1,77,129,206
https://kawalpemilu.org#75889,"PADANG TIMUR, CAMPALAGIAN, POLEWALI MANDAR, SULAWESI BARAT",2,74,116,190
https://kawalpemilu.org#75889,"PADANG TIMUR, CAMPALAGIAN, POLEWALI MANDAR, SULAWESI BARAT",3,75,133,208
https://kawalpemilu.org#75889,"PADANG TIMUR, CAMPALAGIAN, POLEWALI MANDAR, SULAWESI BARAT",4,74,121,195
https://kawalpemilu.org#75889,"PADANG TIMUR, CAMPALAGIAN, POLEWALI MANDAR, SULAWESI BARAT",5,73,92,165
https://kawalpemilu.org#75890,"PADANG, CAMPALAGIAN, POLEWALI MANDAR, SULAWESI BARAT",1,130,39,169
https://kawalpemilu.org#75890,"PADANG, CAMPALAGIAN, POLEWALI MANDAR, SULAWESI BARAT",2,102,62,164
https://kawalpemilu.org#75890,"PADANG, CAMPALAGIAN, POLEWALI MANDAR, SULAWESI BARAT",3,115,57,172
https://kawalpemilu.org#75891,"LAGI-AGI, CAMPALAGIAN, POLEWALI MANDAR, SULAWESI BARAT",1,102,112,214
https://kawalpemilu.org#75891,"LAGI-AGI, CAMPALAGIAN, POLEWALI MANDAR, SULAWESI BARAT",2,116,94,210
https://kawalpemilu.org#75891,"LAGI-AGI, CAMPALAGIAN, POLEWALI MANDAR, SULAWESI BARAT",3,102,96,198
https://kawalpemilu.org#75891,"LAGI-AGI, CAMPALAGIAN, POLEWALI MANDAR, SULAWESI BARAT",4,140,95,235
https://kawalpemilu.org#75891,"LAGI-AGI, CAMPALAGIAN, POLEWALI MANDAR, SULAWESI BARAT",5,117,114,231
https://kawalpemilu.org#75891,"LAGI-AGI, CAMPALAGIAN, POLEWALI MANDAR, SULAWESI BARAT",6,134,106,240
https://kawalpemilu.org#75893,"SIDODADI, WONOMULYO, POLEWALI MANDAR, SULAWESI BARAT",1,121,139,260
https://kawalpemilu.org#75893,"SIDODADI, WONOMULYO, POLEWALI MANDAR, SULAWESI BARAT",2,79,130,209
https://kawalpemilu.org#75893,"SIDODADI, WONOMULYO, POLEWALI MANDAR, SULAWESI BARAT",3,93,137,230
https://kawalpemilu.org#75893,"SIDODADI, WONOMULYO, POLEWALI MANDAR, SULAWESI BARAT",4,67,161,228
https://kawalpemilu.org#75893,"SIDODADI, WONOMULYO, POLEWALI MANDAR, SULAWESI BARAT",5,89,146,235
https://kawalpemilu.org#75893,"SIDODADI, WONOMULYO, POLEWALI MANDAR, SULAWESI BARAT",6,67,171,238
https://kawalpemilu.org#75893,"SIDODADI, WONOMULYO, POLEWALI MANDAR, SULAWESI BARAT",7,109,164,273
https://kawalpemilu.org#75893,"SIDODADI, WONOMULYO, POLEWALI MANDAR, SULAWESI BARAT",8,101,129,230
https://kawalpemilu.org#75893,"SIDODADI, WONOMULYO, POLEWALI MANDAR, SULAWESI BARAT",9,77,106,183
https://kawalpemilu.org#75893,"SIDODADI, WONOMULYO, POLEWALI MANDAR, SULAWESI BARAT",10,147,94,241
https://kawalpemilu.org#75893,"SIDODADI, WONOMULYO, POLEWALI MANDAR, SULAWESI BARAT",11,87,103,190
https://kawalpemilu.org#75893,"SIDODADI, WONOMULYO, POLEWALI MANDAR, SULAWESI BARAT",12,75,126,201
https://kawalpemilu.org#75893,"SIDODADI, WONOMULYO, POLEWALI MANDAR, SULAWESI BARAT",13,126,110,236
https://kawalpemilu.org#75893,"SIDODADI, WONOMULYO, POLEWALI MANDAR, SULAWESI BARAT",14,104,97,201
https://kawalpemilu.org#75893,"SIDODADI, WONOMULYO, POLEWALI MANDAR, SULAWESI BARAT",15,121,119,240
https://kawalpemilu.org#75893,"SIDODADI, WONOMULYO, POLEWALI MANDAR, SULAWESI BARAT",16,87,156,243
https://kawalpemilu.org#75893,"SIDODADI, WONOMULYO, POLEWALI MANDAR, SULAWESI BARAT",17,105,115,220
https://kawalpemilu.org#75893,"SIDODADI, WONOMULYO, POLEWALI MANDAR, SULAWESI BARAT",18,102,139,241
https://kawalpemilu.org#75893,"SIDODADI, WONOMULYO, POLEWALI MANDAR, SULAWESI BARAT",19,91,124,215
https://kawalpemilu.org#75893,"SIDODADI, WONOMULYO, POLEWALI MANDAR, SULAWESI BARAT",20,98,160,258
https://kawalpemilu.org#75893,"SIDODADI, WONOMULYO, POLEWALI MANDAR, SULAWESI BARAT",21,81,139,220
https://kawalpemilu.org#75893,"SIDODADI, WONOMULYO, POLEWALI MANDAR, SULAWESI BARAT",22,96,109,205
https://kawalpemilu.org#75893,"SIDODADI, WONOMULYO, POLEWALI MANDAR, SULAWESI BARAT",23,111,67,178
https://kawalpemilu.org#75893,"SIDODADI, WONOMULYO, POLEWALI MANDAR, SULAWESI BARAT",24,95,82,177
https://kawalpemilu.org#75893,"SIDODADI, WONOMULYO, POLEWALI MANDAR, SULAWESI BARAT",25,117,102,219
https://kawalpemilu.org#75893,"SIDODADI, WONOMULYO, POLEWALI MANDAR, SULAWESI BARAT",26,130,71,201
https://kawalpemilu.org#75893,"SIDODADI, WONOMULYO, POLEWALI MANDAR, SULAWESI BARAT",27,75,87,162
https://kawalpemilu.org#75894,"SIDOREJO, WONOMULYO, POLEWALI MANDAR, SULAWESI BARAT",1,104,133,237
https://kawalpemilu.org#75894,"SIDOREJO, WONOMULYO, POLEWALI MANDAR, SULAWESI BARAT",2,122,94,216
https://kawalpemilu.org#75894,"SIDOREJO, WONOMULYO, POLEWALI MANDAR, SULAWESI BARAT",3,144,85,229
https://kawalpemilu.org#75894,"SIDOREJO, WONOMULYO, POLEWALI MANDAR, SULAWESI BARAT",4,143,87,230
https://kawalpemilu.org#75894,"SIDOREJO, WONOMULYO, POLEWALI MANDAR, SULAWESI BARAT",5,139,105,244
https://kawalpemilu.org#75894,"SIDOREJO, WONOMULYO, POLEWALI MANDAR, SULAWESI BARAT",6,170,102,272
https://kawalpemilu.org#75894,"SIDOREJO, WONOMULYO, POLEWALI MANDAR, SULAWESI BARAT",7,117,124,241
https://kawalpemilu.org#75894,"SIDOREJO, WONOMULYO, POLEWALI MANDAR, SULAWESI BARAT",8,122,109,231
https://kawalpemilu.org#75894,"SIDOREJO, WONOMULYO, POLEWALI MANDAR, SULAWESI BARAT",9,122,89,211
https://kawalpemilu.org#75894,"SIDOREJO, WONOMULYO, POLEWALI MANDAR, SULAWESI BARAT",10,121,70,191
https://kawalpemilu.org#75894,"SIDOREJO, WONOMULYO, POLEWALI MANDAR, SULAWESI BARAT",11,101,100,201
https://kawalpemilu.org#75895,"SUMBEREJO, WONOMULYO, POLEWALI MANDAR, SULAWESI BARAT",1,102,114,216
https://kawalpemilu.org#75895,"SUMBEREJO, WONOMULYO, POLEWALI MANDAR, SULAWESI BARAT",2,109,121,230
https://kawalpemilu.org#75895,"SUMBEREJO, WONOMULYO, POLEWALI MANDAR, SULAWESI BARAT",4,147,104,251
https://kawalpemilu.org#75895,"SUMBEREJO, WONOMULYO, POLEWALI MANDAR, SULAWESI BARAT",5,144,104,248
https://kawalpemilu.org#75895,"SUMBEREJO, WONOMULYO, POLEWALI MANDAR, SULAWESI BARAT",6,112,113,225
https://kawalpemilu.org#75895,"SUMBEREJO, WONOMULYO, POLEWALI MANDAR, SULAWESI BARAT",7,133,69,202
https://kawalpemilu.org#75895,"SUMBEREJO, WONOMULYO, POLEWALI MANDAR, SULAWESI BARAT",8,140,70,210
https://kawalpemilu.org#75895,"SUMBEREJO, WONOMULYO, POLEWALI MANDAR, SULAWESI BARAT",9,175,70,245
https://kawalpemilu.org#75895,"SUMBEREJO, WONOMULYO, POLEWALI MANDAR, SULAWESI BARAT",10,94,121,215
https://kawalpemilu.org#75895,"SUMBEREJO, WONOMULYO, POLEWALI MANDAR, SULAWESI BARAT",11,102,115,217
https://kawalpemilu.org#75895,"SUMBEREJO, WONOMULYO, POLEWALI MANDAR, SULAWESI BARAT",12,64,141,205
https://kawalpemilu.org#75896,"BUMIAYU, WONOMULYO, POLEWALI MANDAR, SULAWESI BARAT",1,125,126,251
https://kawalpemilu.org#75896,"BUMIAYU, WONOMULYO, POLEWALI MANDAR, SULAWESI BARAT",2,117,98,215
https://kawalpemilu.org#75896,"BUMIAYU, WONOMULYO, POLEWALI MANDAR, SULAWESI BARAT",3,149,56,205
https://kawalpemilu.org#75896,"BUMIAYU, WONOMULYO, POLEWALI MANDAR, SULAWESI BARAT",4,152,47,199
https://kawalpemilu.org#75896,"BUMIAYU, WONOMULYO, POLEWALI MANDAR, SULAWESI BARAT",5,104,100,204
https://kawalpemilu.org#75896,"BUMIAYU, WONOMULYO, POLEWALI MANDAR, SULAWESI BARAT",6,69,93,162
https://kawalpemilu.org#75896,"BUMIAYU, WONOMULYO, POLEWALI MANDAR, SULAWESI BARAT",7,160,54,214
https://kawalpemilu.org#75896,"BUMIAYU, WONOMULYO, POLEWALI MANDAR, SULAWESI BARAT",8,127,77,204
https://kawalpemilu.org#75896,"BUMIAYU, WONOMULYO, POLEWALI MANDAR, SULAWESI BARAT",9,143,66,209
https://kawalpemilu.org#75896,"BUMIAYU, WONOMULYO, POLEWALI MANDAR, SULAWESI BARAT",10,125,70,195
https://kawalpemilu.org#75897,"KEBUNSARI, WONOMULYO, POLEWALI MANDAR, SULAWESI BARAT",1,111,137,248
https://kawalpemilu.org#75897,"KEBUNSARI, WONOMULYO, POLEWALI MANDAR, SULAWESI BARAT",2,85,144,229
https://kawalpemilu.org#75897,"KEBUNSARI, WONOMULYO, POLEWALI MANDAR, SULAWESI BARAT",3,87,129,216
https://kawalpemilu.org#75897,"KEBUNSARI, WONOMULYO, POLEWALI MANDAR, SULAWESI BARAT",4,107,117,224
https://kawalpemilu.org#75897,"KEBUNSARI, WONOMULYO, POLEWALI MANDAR, SULAWESI BARAT",6,177,48,225
https://kawalpemilu.org#75898,"BANUA BARU, WONOMULYO, POLEWALI MANDAR, SULAWESI BARAT",1,99,94,193
https://kawalpemilu.org#75898,"BANUA BARU, WONOMULYO, POLEWALI MANDAR, SULAWESI BARAT",2,116,103,219
https://kawalpemilu.org#75898,"BANUA BARU, WONOMULYO, POLEWALI MANDAR, SULAWESI BARAT",3,121,113,234
https://kawalpemilu.org#75898,"BANUA BARU, WONOMULYO, POLEWALI MANDAR, SULAWESI BARAT",4,96,106,202
https://kawalpemilu.org#75898,"BANUA BARU, WONOMULYO, POLEWALI MANDAR, SULAWESI BARAT",5,100,100,200
https://kawalpemilu.org#75898,"BANUA BARU, WONOMULYO, POLEWALI MANDAR, SULAWESI BARAT",6,98,122,220
https://kawalpemilu.org#75898,"BANUA BARU, WONOMULYO, POLEWALI MANDAR, SULAWESI BARAT",7,88,99,187
https://kawalpemilu.org#75899,"NEPO, WONOMULYO, POLEWALI MANDAR, SULAWESI BARAT",1,133,80,213
https://kawalpemilu.org#75899,"NEPO, WONOMULYO, POLEWALI MANDAR, SULAWESI BARAT",2,99,135,234
https://kawalpemilu.org#75899,"NEPO, WONOMULYO, POLEWALI MANDAR, SULAWESI BARAT",3,119,98,217
https://kawalpemilu.org#75899,"NEPO, WONOMULYO, POLEWALI MANDAR, SULAWESI BARAT",4,129,88,217
https://kawalpemilu.org#75899,"NEPO, WONOMULYO, POLEWALI MANDAR, SULAWESI BARAT",5,93,138,231
https://kawalpemilu.org#75899,"NEPO, WONOMULYO, POLEWALI MANDAR, SULAWESI BARAT",6,133,66,199
https://kawalpemilu.org#75899,"NEPO, WONOMULYO, POLEWALI MANDAR, SULAWESI BARAT",7,118,66,184
https://kawalpemilu.org#75900,"SUGIHWARAS, WONOMULYO, POLEWALI MANDAR, SULAWESI BARAT",1,101,153,254
https://kawalpemilu.org#75900,"SUGIHWARAS, WONOMULYO, POLEWALI MANDAR, SULAWESI BARAT",2,158,87,245
https://kawalpemilu.org#75900,"SUGIHWARAS, WONOMULYO, POLEWALI MANDAR, SULAWESI BARAT",3,169,68,237
https://kawalpemilu.org#75900,"SUGIHWARAS, WONOMULYO, POLEWALI MANDAR, SULAWESI BARAT",4,133,95,228
https://kawalpemilu.org#75900,"SUGIHWARAS, WONOMULYO, POLEWALI MANDAR, SULAWESI BARAT",5,128,89,217
https://kawalpemilu.org#75900,"SUGIHWARAS, WONOMULYO, POLEWALI MANDAR, SULAWESI BARAT",6,156,63,219
https://kawalpemilu.org#75900,"SUGIHWARAS, WONOMULYO, POLEWALI MANDAR, SULAWESI BARAT",7,163,84,247
https://kawalpemilu.org#75900,"SUGIHWARAS, WONOMULYO, POLEWALI MANDAR, SULAWESI BARAT",8,95,107,202
https://kawalpemilu.org#75900,"SUGIHWARAS, WONOMULYO, POLEWALI MANDAR, SULAWESI BARAT",9,157,78,2
https://kawalpemilu.org#75900,"SUGIHWARAS, WONOMULYO, POLEWALI MANDAR, SULAWESI BARAT",10,124,97,221
https://kawalpemilu.org#75900,"SUGIHWARAS, WONOMULYO, POLEWALI MANDAR, SULAWESI BARAT",11,147,54,201
https://kawalpemilu.org#75900,"SUGIHWARAS, WONOMULYO, POLEWALI MANDAR, SULAWESI BARAT",12,114,65,179
https://kawalpemilu.org#75900,"SUGIHWARAS, WONOMULYO, POLEWALI MANDAR, SULAWESI BARAT",13,112,103,215
https://kawalpemilu.org#75900,"SUGIHWARAS, WONOMULYO, POLEWALI MANDAR, SULAWESI BARAT",14,146,66,212
https://kawalpemilu.org#75901,"CAMPURJO, WONOMULYO, POLEWALI MANDAR, SULAWESI BARAT",1,125,113,238
https://kawalpemilu.org#75901,"CAMPURJO, WONOMULYO, POLEWALI MANDAR, SULAWESI BARAT",2,119,113,232
https://kawalpemilu.org#75901,"CAMPURJO, WONOMULYO, POLEWALI MANDAR, SULAWESI BARAT",3,121,102,223
https://kawalpemilu.org#75901,"CAMPURJO, WONOMULYO, POLEWALI MANDAR, SULAWESI BARAT",4,112,102,214
https://kawalpemilu.org#75901,"CAMPURJO, WONOMULYO, POLEWALI MANDAR, SULAWESI BARAT",5,123,92,215
https://kawalpemilu.org#75901,"CAMPURJO, WONOMULYO, POLEWALI MANDAR, SULAWESI BARAT",6,104,91,195
https://kawalpemilu.org#75901,"CAMPURJO, WONOMULYO, POLEWALI MANDAR, SULAWESI BARAT",7,100,145,245
https://kawalpemilu.org#75902,"BUMIMULYO, WONOMULYO, POLEWALI MANDAR, SULAWESI BARAT",1,144,29,173
https://kawalpemilu.org#75902,"BUMIMULYO, WONOMULYO, POLEWALI MANDAR, SULAWESI BARAT",2,117,78,195
https://kawalpemilu.org#75902,"BUMIMULYO, WONOMULYO, POLEWALI MANDAR, SULAWESI BARAT",3,141,83,224
https://kawalpemilu.org#75902,"BUMIMULYO, WONOMULYO, POLEWALI MANDAR, SULAWESI BARAT",4,64,117,181
https://kawalpemilu.org#75902,"BUMIMULYO, WONOMULYO, POLEWALI MANDAR, SULAWESI BARAT",5,133,73,206
https://kawalpemilu.org#75902,"BUMIMULYO, WONOMULYO, POLEWALI MANDAR, SULAWESI BARAT",6,128,74,202
https://kawalpemilu.org#75903,"TUMPILING, WONOMULYO, POLEWALI MANDAR, SULAWESI BARAT",1,126,79,205
https://kawalpemilu.org#75903,"TUMPILING, WONOMULYO, POLEWALI MANDAR, SULAWESI BARAT",2,90,126,216
https://kawalpemilu.org#75903,"TUMPILING, WONOMULYO, POLEWALI MANDAR, SULAWESI BARAT",3,119,110,229
https://kawalpemilu.org#75903,"TUMPILING, WONOMULYO, POLEWALI MANDAR, SULAWESI BARAT",4,156,56,212
https://kawalpemilu.org#75903,"TUMPILING, WONOMULYO, POLEWALI MANDAR, SULAWESI BARAT",5,107,94,201
https://kawalpemilu.org#75903,"TUMPILING, WONOMULYO, POLEWALI MANDAR, SULAWESI BARAT",6,140,64,204
https://kawalpemilu.org#75903,"TUMPILING, WONOMULYO, POLEWALI MANDAR, SULAWESI BARAT",7,140,75,215
https://kawalpemilu.org#75904,"BAKKA-BAKKA, WONOMULYO, POLEWALI MANDAR, SULAWESI BARAT",1,97,133,230
https://kawalpemilu.org#75904,"BAKKA-BAKKA, WONOMULYO, POLEWALI MANDAR, SULAWESI BARAT",2,82,105,187
https://kawalpemilu.org#75904,"BAKKA-BAKKA, WONOMULYO, POLEWALI MANDAR, SULAWESI BARAT",3,106,146,252
https://kawalpemilu.org#75904,"BAKKA-BAKKA, WONOMULYO, POLEWALI MANDAR, SULAWESI BARAT",4,105,90,195
https://kawalpemilu.org#75904,"BAKKA-BAKKA, WONOMULYO, POLEWALI MANDAR, SULAWESI BARAT",5,98,76,174
https://kawalpemilu.org#75905,"ARJO SARI, WONOMULYO, POLEWALI MANDAR, SULAWESI BARAT",1,135,122,257
https://kawalpemilu.org#75905,"ARJO SARI, WONOMULYO, POLEWALI MANDAR, SULAWESI BARAT",2,135,110,245
https://kawalpemilu.org#75905,"ARJO SARI, WONOMULYO, POLEWALI MANDAR, SULAWESI BARAT",3,122,116,238
https://kawalpemilu.org#75905,"ARJO SARI, WONOMULYO, POLEWALI MANDAR, SULAWESI BARAT",4,108,70,178
https://kawalpemilu.org#75905,"ARJO SARI, WONOMULYO, POLEWALI MANDAR, SULAWESI BARAT",5,161,72,233
https://kawalpemilu.org#75905,"ARJO SARI, WONOMULYO, POLEWALI MANDAR, SULAWESI BARAT",6,113,126,239
https://kawalpemilu.org#75906,"GALESO, WONOMULYO, POLEWALI MANDAR, SULAWESI BARAT",1,103,152,255
https://kawalpemilu.org#75906,"GALESO, WONOMULYO, POLEWALI MANDAR, SULAWESI BARAT",2,82,107,189
https://kawalpemilu.org#75906,"GALESO, WONOMULYO, POLEWALI MANDAR, SULAWESI BARAT",3,83,81,164
https://kawalpemilu.org#75906,"GALESO, WONOMULYO, POLEWALI MANDAR, SULAWESI BARAT",4,140,95,235
https://kawalpemilu.org#75906,"GALESO, WONOMULYO, POLEWALI MANDAR, SULAWESI BARAT",5,94,109,203
https://kawalpemilu.org#75906,"GALESO, WONOMULYO, POLEWALI MANDAR, SULAWESI BARAT",6,99,98,197
https://kawalpemilu.org#75906,"GALESO, WONOMULYO, POLEWALI MANDAR, SULAWESI BARAT",7,90,73,163
https://kawalpemilu.org#75906,"GALESO, WONOMULYO, POLEWALI MANDAR, SULAWESI BARAT",8,100,43,143
https://kawalpemilu.org#75906,"GALESO, WONOMULYO, POLEWALI MANDAR, SULAWESI BARAT",9,94,76,170
https://kawalpemilu.org#75908,"POLEWALI, POLEWALI, POLEWALI MANDAR, SULAWESI BARAT",1,99,117,216
https://kawalpemilu.org#75908,"POLEWALI, POLEWALI, POLEWALI MANDAR, SULAWESI BARAT",2,88,125,213
https://kawalpemilu.org#75908,"POLEWALI, POLEWALI, POLEWALI MANDAR, SULAWESI BARAT",3,106,94,200
https://kawalpemilu.org#75908,"POLEWALI, POLEWALI, POLEWALI MANDAR, SULAWESI BARAT",4,82,83,165
https://kawalpemilu.org#75908,"POLEWALI, POLEWALI, POLEWALI MANDAR, SULAWESI BARAT",5,91,100,191
https://kawalpemilu.org#75908,"POLEWALI, POLEWALI, POLEWALI MANDAR, SULAWESI BARAT",6,144,85,220
https://kawalpemilu.org#75908,"POLEWALI, POLEWALI, POLEWALI MANDAR, SULAWESI BARAT",7,116,144,260
https://kawalpemilu.org#75908,"POLEWALI, POLEWALI, POLEWALI MANDAR, SULAWESI BARAT",8,128,110,238
https://kawalpemilu.org#75908,"POLEWALI, POLEWALI, POLEWALI MANDAR, SULAWESI BARAT",9,124,91,215
https://kawalpemilu.org#75908,"POLEWALI, POLEWALI, POLEWALI MANDAR, SULAWESI BARAT",10,115,81,196
https://kawalpemilu.org#75908,"POLEWALI, POLEWALI, POLEWALI MANDAR, SULAWESI BARAT",11,125,45,170
https://kawalpemilu.org#75908,"POLEWALI, POLEWALI, POLEWALI MANDAR, SULAWESI BARAT",12,123,105,228
https://kawalpemilu.org#75908,"POLEWALI, POLEWALI, POLEWALI MANDAR, SULAWESI BARAT",13,97,96,193
https://kawalpemilu.org#75908,"POLEWALI, POLEWALI, POLEWALI MANDAR, SULAWESI BARAT",14,116,97,213
https://kawalpemilu.org#75908,"POLEWALI, POLEWALI, POLEWALI MANDAR, SULAWESI BARAT",15,108,100,208
https://kawalpemilu.org#75908,"POLEWALI, POLEWALI, POLEWALI MANDAR, SULAWESI BARAT",16,125,60,185
https://kawalpemilu.org#75908,"POLEWALI, POLEWALI, POLEWALI MANDAR, SULAWESI BARAT",17,59,44,103
https://kawalpemilu.org#75908,"POLEWALI, POLEWALI, POLEWALI MANDAR, SULAWESI BARAT",18,117,100,217
https://kawalpemilu.org#75908,"POLEWALI, POLEWALI, POLEWALI MANDAR, SULAWESI BARAT",19,96,111,207
https://kawalpemilu.org#75908,"POLEWALI, POLEWALI, POLEWALI MANDAR, SULAWESI BARAT",20,77,97,174
https://kawalpemilu.org#75908,"POLEWALI, POLEWALI, POLEWALI MANDAR, SULAWESI BARAT",21,83,105,188
https://kawalpemilu.org#75908,"POLEWALI, POLEWALI, POLEWALI MANDAR, SULAWESI BARAT",22,63,98,161
https://kawalpemilu.org#75908,"POLEWALI, POLEWALI, POLEWALI MANDAR, SULAWESI BARAT",23,88,116,204
https://kawalpemilu.org#75909,"WATTANG, POLEWALI, POLEWALI MANDAR, SULAWESI BARAT",1,102,98,200
https://kawalpemilu.org#75909,"WATTANG, POLEWALI, POLEWALI MANDAR, SULAWESI BARAT",2,85,95,180
https://kawalpemilu.org#75909,"WATTANG, POLEWALI, POLEWALI MANDAR, SULAWESI BARAT",3,78,93,171
https://kawalpemilu.org#75909,"WATTANG, POLEWALI, POLEWALI MANDAR, SULAWESI BARAT",4,107,130,237
https://kawalpemilu.org#75909,"WATTANG, POLEWALI, POLEWALI MANDAR, SULAWESI BARAT",5,80,101,181
https://kawalpemilu.org#75909,"WATTANG, POLEWALI, POLEWALI MANDAR, SULAWESI BARAT",6,105,124,229
https://kawalpemilu.org#75909,"WATTANG, POLEWALI, POLEWALI MANDAR, SULAWESI BARAT",7,85,120,205
https://kawalpemilu.org#75909,"WATTANG, POLEWALI, POLEWALI MANDAR, SULAWESI BARAT",9,80,93,173
https://kawalpemilu.org#75909,"WATTANG, POLEWALI, POLEWALI MANDAR, SULAWESI BARAT",10,71,104,175
https://kawalpemilu.org#75909,"WATTANG, POLEWALI, POLEWALI MANDAR, SULAWESI BARAT",11,89,83,172
https://kawalpemilu.org#75909,"WATTANG, POLEWALI, POLEWALI MANDAR, SULAWESI BARAT",12,100,106,206
https://kawalpemilu.org#75909,"WATTANG, POLEWALI, POLEWALI MANDAR, SULAWESI BARAT",13,110,120,230
https://kawalpemilu.org#75909,"WATTANG, POLEWALI, POLEWALI MANDAR, SULAWESI BARAT",14,110,92,202
https://kawalpemilu.org#75909,"WATTANG, POLEWALI, POLEWALI MANDAR, SULAWESI BARAT",15,154,99,253
https://kawalpemilu.org#75909,"WATTANG, POLEWALI, POLEWALI MANDAR, SULAWESI BARAT",16,150,78,228
https://kawalpemilu.org#75909,"WATTANG, POLEWALI, POLEWALI MANDAR, SULAWESI BARAT",17,138,70,208
https://kawalpemilu.org#75910,"SULEWATANG, POLEWALI, POLEWALI MANDAR, SULAWESI BARAT",1,120,78,198
https://kawalpemilu.org#75910,"SULEWATANG, POLEWALI, POLEWALI MANDAR, SULAWESI BARAT",2,141,66,207
https://kawalpemilu.org#75910,"SULEWATANG, POLEWALI, POLEWALI MANDAR, SULAWESI BARAT",3,140,70,210
https://kawalpemilu.org#75910,"SULEWATANG, POLEWALI, POLEWALI MANDAR, SULAWESI BARAT",4,94,123,217
https://kawalpemilu.org#75910,"SULEWATANG, POLEWALI, POLEWALI MANDAR, SULAWESI BARAT",5,75,137,212
https://kawalpemilu.org#75910,"SULEWATANG, POLEWALI, POLEWALI MANDAR, SULAWESI BARAT",6,118,100,218
https://kawalpemilu.org#75910,"SULEWATANG, POLEWALI, POLEWALI MANDAR, SULAWESI BARAT",7,131,113,244
https://kawalpemilu.org#75910,"SULEWATANG, POLEWALI, POLEWALI MANDAR, SULAWESI BARAT",8,159,72,231
https://kawalpemilu.org#75910,"SULEWATANG, POLEWALI, POLEWALI MANDAR, SULAWESI BARAT",9,142,90,232
https://kawalpemilu.org#75910,"SULEWATANG, POLEWALI, POLEWALI MANDAR, SULAWESI BARAT",10,185,49,234
https://kawalpemilu.org#75910,"SULEWATANG, POLEWALI, POLEWALI MANDAR, SULAWESI BARAT",11,165,49,214
https://kawalpemilu.org#75911,"LANTORA, POLEWALI, POLEWALI MANDAR, SULAWESI BARAT",1,94,128,222
https://kawalpemilu.org#75911,"LANTORA, POLEWALI, POLEWALI MANDAR, SULAWESI BARAT",2,66,76,142
https://kawalpemilu.org#75911,"LANTORA, POLEWALI, POLEWALI MANDAR, SULAWESI BARAT",3,91,144,235
https://kawalpemilu.org#75911,"LANTORA, POLEWALI, POLEWALI MANDAR, SULAWESI BARAT",4,101,106,207
https://kawalpemilu.org#75911,"LANTORA, POLEWALI, POLEWALI MANDAR, SULAWESI BARAT",5,99,112,211
https://kawalpemilu.org#75911,"LANTORA, POLEWALI, POLEWALI MANDAR, SULAWESI BARAT",6,59,98,157
https://kawalpemilu.org#75911,"LANTORA, POLEWALI, POLEWALI MANDAR, SULAWESI BARAT",7,113,97,210
https://kawalpemilu.org#75911,"LANTORA, POLEWALI, POLEWALI MANDAR, SULAWESI BARAT",8,75,127,202
https://kawalpemilu.org#75911,"LANTORA, POLEWALI, POLEWALI MANDAR, SULAWESI BARAT",9,139,133,272
https://kawalpemilu.org#75911,"LANTORA, POLEWALI, POLEWALI MANDAR, SULAWESI BARAT",10,130,119,249
https://kawalpemilu.org#75911,"LANTORA, POLEWALI, POLEWALI MANDAR, SULAWESI BARAT",11,92,130,222
https://kawalpemilu.org#75911,"LANTORA, POLEWALI, POLEWALI MANDAR, SULAWESI BARAT",12,116,95,211
https://kawalpemilu.org#75911,"LANTORA, POLEWALI, POLEWALI MANDAR, SULAWESI BARAT",13,95,118,213
https://kawalpemilu.org#75911,"LANTORA, POLEWALI, POLEWALI MANDAR, SULAWESI BARAT",14,135,42,177
https://kawalpemilu.org#75911,"LANTORA, POLEWALI, POLEWALI MANDAR, SULAWESI BARAT",15,78,62,140
https://kawalpemilu.org#75911,"LANTORA, POLEWALI, POLEWALI MANDAR, SULAWESI BARAT",16,103,79,182
https://kawalpemilu.org#75912,"TAKATIDUNG, POLEWALI, POLEWALI MANDAR, SULAWESI BARAT",1,149,99,248
https://kawalpemilu.org#75912,"TAKATIDUNG, POLEWALI, POLEWALI MANDAR, SULAWESI BARAT",2,123,132,254
https://kawalpemilu.org#75912,"TAKATIDUNG, POLEWALI, POLEWALI MANDAR, SULAWESI BARAT",3,157,97,254
https://kawalpemilu.org#75912,"TAKATIDUNG, POLEWALI, POLEWALI MANDAR, SULAWESI BARAT",4,107,113,220
https://kawalpemilu.org#75912,"TAKATIDUNG, POLEWALI, POLEWALI MANDAR, SULAWESI BARAT",5,164,62,226
https://kawalpemilu.org#75912,"TAKATIDUNG, POLEWALI, POLEWALI MANDAR, SULAWESI BARAT",6,100,99,199
https://kawalpemilu.org#75912,"TAKATIDUNG, POLEWALI, POLEWALI MANDAR, SULAWESI BARAT",7,140,71,211
https://kawalpemilu.org#75912,"TAKATIDUNG, POLEWALI, POLEWALI MANDAR, SULAWESI BARAT",8,119,100,219
https://kawalpemilu.org#75912,"TAKATIDUNG, POLEWALI, POLEWALI MANDAR, SULAWESI BARAT",9,175,47,222
https://kawalpemilu.org#75912,"TAKATIDUNG, POLEWALI, POLEWALI MANDAR, SULAWESI BARAT",10,110,96,206
https://kawalpemilu.org#75912,"TAKATIDUNG, POLEWALI, POLEWALI MANDAR, SULAWESI BARAT",11,128,110,238
https://kawalpemilu.org#75912,"TAKATIDUNG, POLEWALI, POLEWALI MANDAR, SULAWESI BARAT",12,145,96,241
https://kawalpemilu.org#75912,"TAKATIDUNG, POLEWALI, POLEWALI MANDAR, SULAWESI BARAT",13,108,141,249
https://kawalpemilu.org#75912,"TAKATIDUNG, POLEWALI, POLEWALI MANDAR, SULAWESI BARAT",14,67,113,180
https://kawalpemilu.org#75912,"TAKATIDUNG, POLEWALI, POLEWALI MANDAR, SULAWESI BARAT",15,73,93,166
https://kawalpemilu.org#75912,"TAKATIDUNG, POLEWALI, POLEWALI MANDAR, SULAWESI BARAT",16,74,145,219
https://kawalpemilu.org#75912,"TAKATIDUNG, POLEWALI, POLEWALI MANDAR, SULAWESI BARAT",17,109,79,188
https://kawalpemilu.org#75913,"PEKKABATA, POLEWALI, POLEWALI MANDAR, SULAWESI BARAT",1,135,136,271
https://kawalpemilu.org#75913,"PEKKABATA, POLEWALI, POLEWALI MANDAR, SULAWESI BARAT",2,91,143,234
https://kawalpemilu.org#75913,"PEKKABATA, POLEWALI, POLEWALI MANDAR, SULAWESI BARAT",3,84,151,235
https://kawalpemilu.org#75913,"PEKKABATA, POLEWALI, POLEWALI MANDAR, SULAWESI BARAT",4,93,163,256
https://kawalpemilu.org#75913,"PEKKABATA, POLEWALI, POLEWALI MANDAR, SULAWESI BARAT",5,90,141,231
https://kawalpemilu.org#75913,"PEKKABATA, POLEWALI, POLEWALI MANDAR, SULAWESI BARAT",6,82,222,304
https://kawalpemilu.org#75913,"PEKKABATA, POLEWALI, POLEWALI MANDAR, SULAWESI BARAT",7,105,155,260
https://kawalpemilu.org#75913,"PEKKABATA, POLEWALI, POLEWALI MANDAR, SULAWESI BARAT",8,81,129,210
https://kawalpemilu.org#75913,"PEKKABATA, POLEWALI, POLEWALI MANDAR, SULAWESI BARAT",9,97,142,239
https://kawalpemilu.org#75913,"PEKKABATA, POLEWALI, POLEWALI MANDAR, SULAWESI BARAT",10,118,111,229
https://kawalpemilu.org#75913,"PEKKABATA, POLEWALI, POLEWALI MANDAR, SULAWESI BARAT",11,77,125,202
https://kawalpemilu.org#75913,"PEKKABATA, POLEWALI, POLEWALI MANDAR, SULAWESI BARAT",12,83,139,222
https://kawalpemilu.org#75913,"PEKKABATA, POLEWALI, POLEWALI MANDAR, SULAWESI BARAT",13,110,138,248
https://kawalpemilu.org#75913,"PEKKABATA, POLEWALI, POLEWALI MANDAR, SULAWESI BARAT",14,98,134,232
https://kawalpemilu.org#75914,"MADATE, POLEWALI, POLEWALI MANDAR, SULAWESI BARAT",1,106,132,238
https://kawalpemilu.org#75914,"MADATE, POLEWALI, POLEWALI MANDAR, SULAWESI BARAT",2,81,196,277
https://kawalpemilu.org#75914,"MADATE, POLEWALI, POLEWALI MANDAR, SULAWESI BARAT",3,113,120,233
https://kawalpemilu.org#75914,"MADATE, POLEWALI, POLEWALI MANDAR, SULAWESI BARAT",4,103,139,242
https://kawalpemilu.org#75914,"MADATE, POLEWALI, POLEWALI MANDAR, SULAWESI BARAT",5,130,123,253
https://kawalpemilu.org#75914,"MADATE, POLEWALI, POLEWALI MANDAR, SULAWESI BARAT",6,102,128,230
https://kawalpemilu.org#75914,"MADATE, POLEWALI, POLEWALI MANDAR, SULAWESI BARAT",7,110,119,229
https://kawalpemilu.org#75914,"MADATE, POLEWALI, POLEWALI MANDAR, SULAWESI BARAT",8,66,131,197
https://kawalpemilu.org#75914,"MADATE, POLEWALI, POLEWALI MANDAR, SULAWESI BARAT",9,76,154,230
https://kawalpemilu.org#75914,"MADATE, POLEWALI, POLEWALI MANDAR, SULAWESI BARAT",10,71,201,272
https://kawalpemilu.org#75914,"MADATE, POLEWALI, POLEWALI MANDAR, SULAWESI BARAT",11,115,150,265
https://kawalpemilu.org#75914,"MADATE, POLEWALI, POLEWALI MANDAR, SULAWESI BARAT",12,114,186,300
https://kawalpemilu.org#75914,"MADATE, POLEWALI, POLEWALI MANDAR, SULAWESI BARAT",13,60,159,219
https://kawalpemilu.org#75914,"MADATE, POLEWALI, POLEWALI MANDAR, SULAWESI BARAT",14,102,118,220
https://kawalpemilu.org#75914,"MADATE, POLEWALI, POLEWALI MANDAR, SULAWESI BARAT",15,103,138,241
https://kawalpemilu.org#75914,"MADATE, POLEWALI, POLEWALI MANDAR, SULAWESI BARAT",16,72,159,231
https://kawalpemilu.org#75914,"MADATE, POLEWALI, POLEWALI MANDAR, SULAWESI BARAT",17,116,131,247
https://kawalpemilu.org#75914,"MADATE, POLEWALI, POLEWALI MANDAR, SULAWESI BARAT",18,86,129,215
https://kawalpemilu.org#75914,"MADATE, POLEWALI, POLEWALI MANDAR, SULAWESI BARAT",19,72,147,219
https://kawalpemilu.org#75914,"MADATE, POLEWALI, POLEWALI MANDAR, SULAWESI BARAT",20,59,131,190
https://kawalpemilu.org#75915,"MANDING, POLEWALI, POLEWALI MANDAR, SULAWESI BARAT",1,132,108,240
https://kawalpemilu.org#75915,"MANDING, POLEWALI, POLEWALI MANDAR, SULAWESI BARAT",2,114,149,263
https://kawalpemilu.org#75915,"MANDING, POLEWALI, POLEWALI MANDAR, SULAWESI BARAT",3,148,126,274
https://kawalpemilu.org#75915,"MANDING, POLEWALI, POLEWALI MANDAR, SULAWESI BARAT",4,150,115,265
https://kawalpemilu.org#75915,"MANDING, POLEWALI, POLEWALI MANDAR, SULAWESI BARAT",5,114,150,264
https://kawalpemilu.org#75915,"MANDING, POLEWALI, POLEWALI MANDAR, SULAWESI BARAT",6,118,116,234
https://kawalpemilu.org#75915,"MANDING, POLEWALI, POLEWALI MANDAR, SULAWESI BARAT",7,102,106,208
https://kawalpemilu.org#75915,"MANDING, POLEWALI, POLEWALI MANDAR, SULAWESI BARAT",8,23,33,56
https://kawalpemilu.org#75915,"MANDING, POLEWALI, POLEWALI MANDAR, SULAWESI BARAT",9,106,113,219
https://kawalpemilu.org#75916,"DARMA, POLEWALI, POLEWALI MANDAR, SULAWESI BARAT",1,97,137,234
https://kawalpemilu.org#75916,"DARMA, POLEWALI, POLEWALI MANDAR, SULAWESI BARAT",2,91,100,191
https://kawalpemilu.org#75916,"DARMA, POLEWALI, POLEWALI MANDAR, SULAWESI BARAT",3,162,101,263
https://kawalpemilu.org#75916,"DARMA, POLEWALI, POLEWALI MANDAR, SULAWESI BARAT",4,91,142,233
https://kawalpemilu.org#75916,"DARMA, POLEWALI, POLEWALI MANDAR, SULAWESI BARAT",5,68,161,229
https://kawalpemilu.org#75916,"DARMA, POLEWALI, POLEWALI MANDAR, SULAWESI BARAT",6,102,144,246
https://kawalpemilu.org#75916,"DARMA, POLEWALI, POLEWALI MANDAR, SULAWESI BARAT",7,87,160,247
https://kawalpemilu.org#75916,"DARMA, POLEWALI, POLEWALI MANDAR, SULAWESI BARAT",8,88,123,211
https://kawalpemilu.org#75916,"DARMA, POLEWALI, POLEWALI MANDAR, SULAWESI BARAT",9,74,56,130
https://kawalpemilu.org#75916,"DARMA, POLEWALI, POLEWALI MANDAR, SULAWESI BARAT",10,90,100,190
https://kawalpemilu.org#75916,"DARMA, POLEWALI, POLEWALI MANDAR, SULAWESI BARAT",11,88,188,206
https://kawalpemilu.org#75916,"DARMA, POLEWALI, POLEWALI MANDAR, SULAWESI BARAT",12,78,139,217
https://kawalpemilu.org#75916,"DARMA, POLEWALI, POLEWALI MANDAR, SULAWESI BARAT",13,130,100,230
https://kawalpemilu.org#75916,"DARMA, POLEWALI, POLEWALI MANDAR, SULAWESI BARAT",14,108,120,228
https://kawalpemilu.org#75916,"DARMA, POLEWALI, POLEWALI MANDAR, SULAWESI BARAT",15,112,122,234
https://kawalpemilu.org#75916,"DARMA, POLEWALI, POLEWALI MANDAR, SULAWESI BARAT",16,177,66,183
https://kawalpemilu.org#75916,"DARMA, POLEWALI, POLEWALI MANDAR, SULAWESI BARAT",17,71,126,197
https://kawalpemilu.org#75916,"DARMA, POLEWALI, POLEWALI MANDAR, SULAWESI BARAT",18,124,132,256
https://kawalpemilu.org#75916,"DARMA, POLEWALI, POLEWALI MANDAR, SULAWESI BARAT",19,77,138,215
https://kawalpemilu.org#75916,"DARMA, POLEWALI, POLEWALI MANDAR, SULAWESI BARAT",20,120,97,217
https://kawalpemilu.org#75916,"DARMA, POLEWALI, POLEWALI MANDAR, SULAWESI BARAT",21,194,42,236
https://kawalpemilu.org#75916,"DARMA, POLEWALI, POLEWALI MANDAR, SULAWESI BARAT",22,130,74,204
https://kawalpemilu.org#75916,"DARMA, POLEWALI, POLEWALI MANDAR, SULAWESI BARAT",23,125,105,230
https://kawalpemilu.org#75916,"DARMA, POLEWALI, POLEWALI MANDAR, SULAWESI BARAT",24,132,94,226
https://kawalpemilu.org#75916,"DARMA, POLEWALI, POLEWALI MANDAR, SULAWESI BARAT",25,119,106,225
https://kawalpemilu.org#75918,"TARAMANU, TUTAR, POLEWALI MANDAR, SULAWESI BARAT",1,135,49,184
https://kawalpemilu.org#75918,"TARAMANU, TUTAR, POLEWALI MANDAR, SULAWESI BARAT",2,146,57,203
https://kawalpemilu.org#75918,"TARAMANU, TUTAR, POLEWALI MANDAR, SULAWESI BARAT",3,133,34,167
https://kawalpemilu.org#75918,"TARAMANU, TUTAR, POLEWALI MANDAR, SULAWESI BARAT",4,157,42,199
https://kawalpemilu.org#75918,"TARAMANU, TUTAR, POLEWALI MANDAR, SULAWESI BARAT",5,116,42,158
https://kawalpemilu.org#75918,"TARAMANU, TUTAR, POLEWALI MANDAR, SULAWESI BARAT",6,83,26,109
https://kawalpemilu.org#75919,"AMBOPADANG, TUTAR, POLEWALI MANDAR, SULAWESI BARAT",1,52,103,155
https://kawalpemilu.org#75919,"AMBOPADANG, TUTAR, POLEWALI MANDAR, SULAWESI BARAT",2,126,66,192
https://kawalpemilu.org#75919,"AMBOPADANG, TUTAR, POLEWALI MANDAR, SULAWESI BARAT",3,158,71,229
https://kawalpemilu.org#75919,"AMBOPADANG, TUTAR, POLEWALI MANDAR, SULAWESI BARAT",4,137,52,189
https://kawalpemilu.org#75919,"AMBOPADANG, TUTAR, POLEWALI MANDAR, SULAWESI BARAT",5,166,55,221
https://kawalpemilu.org#75919,"AMBOPADANG, TUTAR, POLEWALI MANDAR, SULAWESI BARAT",6,87,108,195
https://kawalpemilu.org#75919,"AMBOPADANG, TUTAR, POLEWALI MANDAR, SULAWESI BARAT",7,103,64,167
https://kawalpemilu.org#75919,"AMBOPADANG, TUTAR, POLEWALI MANDAR, SULAWESI BARAT",8,84,28,112
https://kawalpemilu.org#75920,"TUBBI, TUTAR, POLEWALI MANDAR, SULAWESI BARAT",1,116,113,229
https://kawalpemilu.org#75920,"TUBBI, TUTAR, POLEWALI MANDAR, SULAWESI BARAT",2,137,96,233
https://kawalpemilu.org#75920,"TUBBI, TUTAR, POLEWALI MANDAR, SULAWESI BARAT",3,113,120,233
https://kawalpemilu.org#75921,"RATTE, TUTAR, POLEWALI MANDAR, SULAWESI BARAT",1,195,26,221
https://kawalpemilu.org#75921,"RATTE, TUTAR, POLEWALI MANDAR, SULAWESI BARAT",2,175,64,239
https://kawalpemilu.org#75921,"RATTE, TUTAR, POLEWALI MANDAR, SULAWESI BARAT",3,207,24,231
https://kawalpemilu.org#75921,"RATTE, TUTAR, POLEWALI MANDAR, SULAWESI BARAT",4,121,29,150
https://kawalpemilu.org#75921,"RATTE, TUTAR, POLEWALI MANDAR, SULAWESI BARAT",5,139,30,169
https://kawalpemilu.org#75921,"RATTE, TUTAR, POLEWALI MANDAR, SULAWESI BARAT",6,193,13,206
https://kawalpemilu.org#75922,"BESOANGIN, TUTAR, POLEWALI MANDAR, SULAWESI BARAT",1,200,40,240
https://kawalpemilu.org#75922,"BESOANGIN, TUTAR, POLEWALI MANDAR, SULAWESI BARAT",2,180,40,220
https://kawalpemilu.org#75922,"BESOANGIN, TUTAR, POLEWALI MANDAR, SULAWESI BARAT",3,57,18,75
https://kawalpemilu.org#75923,"PIRIANG TAPIKO, TUTAR, POLEWALI MANDAR, SULAWESI BARAT",1,125,84,209
https://kawalpemilu.org#75923,"PIRIANG TAPIKO, TUTAR, POLEWALI MANDAR, SULAWESI BARAT",2,150,63,213
https://kawalpemilu.org#75923,"PIRIANG TAPIKO, TUTAR, POLEWALI MANDAR, SULAWESI BARAT",3,142,38,180
https://kawalpemilu.org#75923,"PIRIANG TAPIKO, TUTAR, POLEWALI MANDAR, SULAWESI BARAT",4,115,58,173
https://kawalpemilu.org#75924,"PEBURRU, TUTAR, POLEWALI MANDAR, SULAWESI BARAT",1,170,50,220
https://kawalpemilu.org#75924,"PEBURRU, TUTAR, POLEWALI MANDAR, SULAWESI BARAT",2,138,87,225
https://kawalpemilu.org#75924,"PEBURRU, TUTAR, POLEWALI MANDAR, SULAWESI BARAT",3,71,92,163
https://kawalpemilu.org#75924,"PEBURRU, TUTAR, POLEWALI MANDAR, SULAWESI BARAT",4,48,112,160
https://kawalpemilu.org#75924,"PEBURRU, TUTAR, POLEWALI MANDAR, SULAWESI BARAT",5,61,94,155
https://kawalpemilu.org#75924,"PEBURRU, TUTAR, POLEWALI MANDAR, SULAWESI BARAT",6,64,50,114
https://kawalpemilu.org#75925,"TALOBA, TUTAR, POLEWALI MANDAR, SULAWESI BARAT",1,140,30,170
https://kawalpemilu.org#75925,"TALOBA, TUTAR, POLEWALI MANDAR, SULAWESI BARAT",2,116,28,144
https://kawalpemilu.org#75925,"TALOBA, TUTAR, POLEWALI MANDAR, SULAWESI BARAT",3,69,31,100
https://kawalpemilu.org#75927,"POLLEWANI, TUTAR, POLEWALI MANDAR, SULAWESI BARAT",1,179,16,195
https://kawalpemilu.org#75927,"POLLEWANI, TUTAR, POLEWALI MANDAR, SULAWESI BARAT",2,152,37,189
https://kawalpemilu.org#75927,"POLLEWANI, TUTAR, POLEWALI MANDAR, SULAWESI BARAT",3,133,83,216
https://kawalpemilu.org#75927,"POLLEWANI, TUTAR, POLEWALI MANDAR, SULAWESI BARAT",4,101,106,207
https://kawalpemilu.org#75927,"POLLEWANI, TUTAR, POLEWALI MANDAR, SULAWESI BARAT",5,137,45,182
https://kawalpemilu.org#75927,"POLLEWANI, TUTAR, POLEWALI MANDAR, SULAWESI BARAT",6,106,19,125
https://kawalpemilu.org#75927,"POLLEWANI, TUTAR, POLEWALI MANDAR, SULAWESI BARAT",7,150,60,210
https://kawalpemilu.org#75928,"BESOANGIN UTARA, TUTAR, POLEWALI MANDAR, SULAWESI BARAT",1,163,35,198
https://kawalpemilu.org#75928,"BESOANGIN UTARA, TUTAR, POLEWALI MANDAR, SULAWESI BARAT",2,67,16,83
https://kawalpemilu.org#75928,"BESOANGIN UTARA, TUTAR, POLEWALI MANDAR, SULAWESI BARAT",3,151,10,161
https://kawalpemilu.org#75928,"BESOANGIN UTARA, TUTAR, POLEWALI MANDAR, SULAWESI BARAT",4,93,10,103
https://kawalpemilu.org#75928,"BESOANGIN UTARA, TUTAR, POLEWALI MANDAR, SULAWESI BARAT",5,88,40,128
https://kawalpemilu.org#75929,"TARAMANU TUA, TUTAR, POLEWALI MANDAR, SULAWESI BARAT",1,129,25,154
https://kawalpemilu.org#75929,"TARAMANU TUA, TUTAR, POLEWALI MANDAR, SULAWESI BARAT",2,161,32,193
https://kawalpemilu.org#75929,"TARAMANU TUA, TUTAR, POLEWALI MANDAR, SULAWESI BARAT",3,116,35,151
https://kawalpemilu.org#75929,"TARAMANU TUA, TUTAR, POLEWALI MANDAR, SULAWESI BARAT",4,108,19,127
https://kawalpemilu.org#75929,"TARAMANU TUA, TUTAR, POLEWALI MANDAR, SULAWESI BARAT",5,135,31,166
https://kawalpemilu.org#75930,"PODA, TUTAR, POLEWALI MANDAR, SULAWESI BARAT",1,106,14,120
https://kawalpemilu.org#75930,"PODA, TUTAR, POLEWALI MANDAR, SULAWESI BARAT",2,163,82,245
https://kawalpemilu.org#75930,"PODA, TUTAR, POLEWALI MANDAR, SULAWESI BARAT",3,189,32,221
https://kawalpemilu.org#75930,"PODA, TUTAR, POLEWALI MANDAR, SULAWESI BARAT",4,152,27,179
https://kawalpemilu.org#75930,"PODA, TUTAR, POLEWALI MANDAR, SULAWESI BARAT",5,97,22,119
https://kawalpemilu.org#85952,"ARABUA, TUTAR, POLEWALI MANDAR, SULAWESI BARAT",1,120,89,209
https://kawalpemilu.org#85952,"ARABUA, TUTAR, POLEWALI MANDAR, SULAWESI BARAT",2,122,26,148
https://kawalpemilu.org#85952,"ARABUA, TUTAR, POLEWALI MANDAR, SULAWESI BARAT",3,121,36,157
https://kawalpemilu.org#75932,"AMASSANGAN, BINUANG, POLEWALI MANDAR, SULAWESI BARAT",1,136,82,218
https://kawalpemilu.org#75932,"AMASSANGAN, BINUANG, POLEWALI MANDAR, SULAWESI BARAT",2,173,65,238
https://kawalpemilu.org#75932,"AMASSANGAN, BINUANG, POLEWALI MANDAR, SULAWESI BARAT",3,125,69,194
https://kawalpemilu.org#75932,"AMASSANGAN, BINUANG, POLEWALI MANDAR, SULAWESI BARAT",4,124,119,243
https://kawalpemilu.org#75932,"AMASSANGAN, BINUANG, POLEWALI MANDAR, SULAWESI BARAT",5,108,108,216
https://kawalpemilu.org#75932,"AMASSANGAN, BINUANG, POLEWALI MANDAR, SULAWESI BARAT",6,112,75,187
https://kawalpemilu.org#75932,"AMASSANGAN, BINUANG, POLEWALI MANDAR, SULAWESI BARAT",7,88,129,217
https://kawalpemilu.org#75932,"AMASSANGAN, BINUANG, POLEWALI MANDAR, SULAWESI BARAT",8,117,113,230
https://kawalpemilu.org#75932,"AMASSANGAN, BINUANG, POLEWALI MANDAR, SULAWESI BARAT",9,128,113,241
https://kawalpemilu.org#75932,"AMASSANGAN, BINUANG, POLEWALI MANDAR, SULAWESI BARAT",10,155,51,206
https://kawalpemilu.org#75933,"TONYAMAN, BINUANG, POLEWALI MANDAR, SULAWESI BARAT",1,158,115,273
https://kawalpemilu.org#75933,"TONYAMAN, BINUANG, POLEWALI MANDAR, SULAWESI BARAT",2,130,124,254
https://kawalpemilu.org#75933,"TONYAMAN, BINUANG, POLEWALI MANDAR, SULAWESI BARAT",3,113,109,222
https://kawalpemilu.org#75933,"TONYAMAN, BINUANG, POLEWALI MANDAR, SULAWESI BARAT",4,102,108,210
https://kawalpemilu.org#75933,"TONYAMAN, BINUANG, POLEWALI MANDAR, SULAWESI BARAT",5,131,68,199
https://kawalpemilu.org#75933,"TONYAMAN, BINUANG, POLEWALI MANDAR, SULAWESI BARAT",6,114,3,140
https://kawalpemilu.org#75933,"TONYAMAN, BINUANG, POLEWALI MANDAR, SULAWESI BARAT",7,117,36,153
https://kawalpemilu.org#75933,"TONYAMAN, BINUANG, POLEWALI MANDAR, SULAWESI BARAT",8,115,102,217
https://kawalpemilu.org#75933,"TONYAMAN, BINUANG, POLEWALI MANDAR, SULAWESI BARAT",9,136,120,256
https://kawalpemilu.org#75933,"TONYAMAN, BINUANG, POLEWALI MANDAR, SULAWESI BARAT",10,129,86,215
https://kawalpemilu.org#75933,"TONYAMAN, BINUANG, POLEWALI MANDAR, SULAWESI BARAT",11,142,110,252
https://kawalpemilu.org#75933,"TONYAMAN, BINUANG, POLEWALI MANDAR, SULAWESI BARAT",12,147,81,228
https://kawalpemilu.org#75933,"TONYAMAN, BINUANG, POLEWALI MANDAR, SULAWESI BARAT",13,86,104,190
https://kawalpemilu.org#75933,"TONYAMAN, BINUANG, POLEWALI MANDAR, SULAWESI BARAT",14,130,53,183
https://kawalpemilu.org#75933,"TONYAMAN, BINUANG, POLEWALI MANDAR, SULAWESI BARAT",15,104,34,138
https://kawalpemilu.org#75933,"TONYAMAN, BINUANG, POLEWALI MANDAR, SULAWESI BARAT",16,122,34,156
https://kawalpemilu.org#75934,"KUAJANG, BINUANG, POLEWALI MANDAR, SULAWESI BARAT",1,123,115,238
https://kawalpemilu.org#75934,"KUAJANG, BINUANG, POLEWALI MANDAR, SULAWESI BARAT",2,94,119,213
https://kawalpemilu.org#75934,"KUAJANG, BINUANG, POLEWALI MANDAR, SULAWESI BARAT",3,160,93,253
https://kawalpemilu.org#75934,"KUAJANG, BINUANG, POLEWALI MANDAR, SULAWESI BARAT",4,121,134,255
https://kawalpemilu.org#75934,"KUAJANG, BINUANG, POLEWALI MANDAR, SULAWESI BARAT",5,125,107,232
https://kawalpemilu.org#75934,"KUAJANG, BINUANG, POLEWALI MANDAR, SULAWESI BARAT",6,140,60,200
https://kawalpemilu.org#75934,"KUAJANG, BINUANG, POLEWALI MANDAR, SULAWESI BARAT",7,101,104,205
https://kawalpemilu.org#75934,"KUAJANG, BINUANG, POLEWALI MANDAR, SULAWESI BARAT",8,141,89,230
https://kawalpemilu.org#75934,"KUAJANG, BINUANG, POLEWALI MANDAR, SULAWESI BARAT",9,154,54,208
https://kawalpemilu.org#75935,"PAKU, BINUANG, POLEWALI MANDAR, SULAWESI BARAT",1,84,120,204
https://kawalpemilu.org#75935,"PAKU, BINUANG, POLEWALI MANDAR, SULAWESI BARAT",2,84,135,219
https://kawalpemilu.org#75935,"PAKU, BINUANG, POLEWALI MANDAR, SULAWESI BARAT",3,70,105,175
https://kawalpemilu.org#75935,"PAKU, BINUANG, POLEWALI MANDAR, SULAWESI BARAT",4,120,70,190
https://kawalpemilu.org#75935,"PAKU, BINUANG, POLEWALI MANDAR, SULAWESI BARAT",5,127,71,198
https://kawalpemilu.org#75935,"PAKU, BINUANG, POLEWALI MANDAR, SULAWESI BARAT",6,36,99,135
https://kawalpemilu.org#75935,"PAKU, BINUANG, POLEWALI MANDAR, SULAWESI BARAT",7,103,105,208
https://kawalpemilu.org#75935,"PAKU, BINUANG, POLEWALI MANDAR, SULAWESI BARAT",8,124,71,195
https://kawalpemilu.org#75935,"PAKU, BINUANG, POLEWALI MANDAR, SULAWESI BARAT",9,32,83,115
https://kawalpemilu.org#75936,"MIRRING, BINUANG, POLEWALI MANDAR, SULAWESI BARAT",1,151,89,249
https://kawalpemilu.org#75936,"MIRRING, BINUANG, POLEWALI MANDAR, SULAWESI BARAT",2,111,87,198
https://kawalpemilu.org#75936,"MIRRING, BINUANG, POLEWALI MANDAR, SULAWESI BARAT",3,160,58,218
https://kawalpemilu.org#75936,"MIRRING, BINUANG, POLEWALI MANDAR, SULAWESI BARAT",4,108,97,205
https://kawalpemilu.org#75936,"MIRRING, BINUANG, POLEWALI MANDAR, SULAWESI BARAT",5,121,53,174
https://kawalpemilu.org#75936,"MIRRING, BINUANG, POLEWALI MANDAR, SULAWESI BARAT",6,102,117,219
https://kawalpemilu.org#75936,"MIRRING, BINUANG, POLEWALI MANDAR, SULAWESI BARAT",7,122,96,218
https://kawalpemilu.org#75936,"MIRRING, BINUANG, POLEWALI MANDAR, SULAWESI BARAT",8,130,104,234
https://kawalpemilu.org#75936,"MIRRING, BINUANG, POLEWALI MANDAR, SULAWESI BARAT",9,104,93,197
https://kawalpemilu.org#75936,"MIRRING, BINUANG, POLEWALI MANDAR, SULAWESI BARAT",10,87,91,178
https://kawalpemilu.org#75937,"BATETANGNGA, BINUANG, POLEWALI MANDAR, SULAWESI BARAT",1,114,134,248
https://kawalpemilu.org#75937,"BATETANGNGA, BINUANG, POLEWALI MANDAR, SULAWESI BARAT",2,115,108,223
https://kawalpemilu.org#75937,"BATETANGNGA, BINUANG, POLEWALI MANDAR, SULAWESI BARAT",3,128,153,281
https://kawalpemilu.org#75937,"BATETANGNGA, BINUANG, POLEWALI MANDAR, SULAWESI BARAT",4,116,139,255
https://kawalpemilu.org#75937,"BATETANGNGA, BINUANG, POLEWALI MANDAR, SULAWESI BARAT",5,149,108,257
https://kawalpemilu.org#75937,"BATETANGNGA, BINUANG, POLEWALI MANDAR, SULAWESI BARAT",6,106,80,186
https://kawalpemilu.org#75937,"BATETANGNGA, BINUANG, POLEWALI MANDAR, SULAWESI BARAT",7,138,48,186
https://kawalpemilu.org#75937,"BATETANGNGA, BINUANG, POLEWALI MANDAR, SULAWESI BARAT",8,161,65,226
https://kawalpemilu.org#75937,"BATETANGNGA, BINUANG, POLEWALI MANDAR, SULAWESI BARAT",9,158,61,219
https://kawalpemilu.org#75937,"BATETANGNGA, BINUANG, POLEWALI MANDAR, SULAWESI BARAT",10,87,10,97
https://kawalpemilu.org#75937,"BATETANGNGA, BINUANG, POLEWALI MANDAR, SULAWESI BARAT",11,161,86,247
https://kawalpemilu.org#75937,"BATETANGNGA, BINUANG, POLEWALI MANDAR, SULAWESI BARAT",12,74,143,217
https://kawalpemilu.org#75937,"BATETANGNGA, BINUANG, POLEWALI MANDAR, SULAWESI BARAT",13,146,144,290
https://kawalpemilu.org#75937,"BATETANGNGA, BINUANG, POLEWALI MANDAR, SULAWESI BARAT",14,95,83,178
https://kawalpemilu.org#75937,"BATETANGNGA, BINUANG, POLEWALI MANDAR, SULAWESI BARAT",15,97,84,181
https://kawalpemilu.org#75937,"BATETANGNGA, BINUANG, POLEWALI MANDAR, SULAWESI BARAT",16,104,60,164
https://kawalpemilu.org#75937,"BATETANGNGA, BINUANG, POLEWALI MANDAR, SULAWESI BARAT",17,127,96,223
https://kawalpemilu.org#75937,"BATETANGNGA, BINUANG, POLEWALI MANDAR, SULAWESI BARAT",18,166,79,145
https://kawalpemilu.org#75938,"MAMMI, BINUANG, POLEWALI MANDAR, SULAWESI BARAT",1,71,60,131
https://kawalpemilu.org#75938,"MAMMI, BINUANG, POLEWALI MANDAR, SULAWESI BARAT",2,137,96,233
https://kawalpemilu.org#75938,"MAMMI, BINUANG, POLEWALI MANDAR, SULAWESI BARAT",3,139,54,193
https://kawalpemilu.org#75938,"MAMMI, BINUANG, POLEWALI MANDAR, SULAWESI BARAT",4,125,15,140
https://kawalpemilu.org#75938,"MAMMI, BINUANG, POLEWALI MANDAR, SULAWESI BARAT",5,86,57,144
https://kawalpemilu.org#75938,"MAMMI, BINUANG, POLEWALI MANDAR, SULAWESI BARAT",6,108,107,215
https://kawalpemilu.org#75938,"MAMMI, BINUANG, POLEWALI MANDAR, SULAWESI BARAT",7,135,71,206
https://kawalpemilu.org#75939,"KALEOK, BINUANG, POLEWALI MANDAR, SULAWESI BARAT",1,142,53,195
https://kawalpemilu.org#75939,"KALEOK, BINUANG, POLEWALI MANDAR, SULAWESI BARAT",2,180,24,204
https://kawalpemilu.org#75939,"KALEOK, BINUANG, POLEWALI MANDAR, SULAWESI BARAT",3,106,19,125
https://kawalpemilu.org#75939,"KALEOK, BINUANG, POLEWALI MANDAR, SULAWESI BARAT",4,80,31,111
https://kawalpemilu.org#75939,"KALEOK, BINUANG, POLEWALI MANDAR, SULAWESI BARAT",5,84,7,91
https://kawalpemilu.org#75940,"AMOLA, BINUANG, POLEWALI MANDAR, SULAWESI BARAT",1,109,80,189
https://kawalpemilu.org#75940,"AMOLA, BINUANG, POLEWALI MANDAR, SULAWESI BARAT",2,110,125,235
https://kawalpemilu.org#75940,"AMOLA, BINUANG, POLEWALI MANDAR, SULAWESI BARAT",3,92,160,252
https://kawalpemilu.org#75940,"AMOLA, BINUANG, POLEWALI MANDAR, SULAWESI BARAT",4,131,80,211
https://kawalpemilu.org#75940,"AMOLA, BINUANG, POLEWALI MANDAR, SULAWESI BARAT",5,128,87,215
https://kawalpemilu.org#75941,"REA, BINUANG, POLEWALI MANDAR, SULAWESI BARAT",1,60,89,149
https://kawalpemilu.org#75941,"REA, BINUANG, POLEWALI MANDAR, SULAWESI BARAT",2,97,120,217
https://kawalpemilu.org#75941,"REA, BINUANG, POLEWALI MANDAR, SULAWESI BARAT",3,136,77,213
https://kawalpemilu.org#75941,"REA, BINUANG, POLEWALI MANDAR, SULAWESI BARAT",4,140,90,230
https://kawalpemilu.org#75941,"REA, BINUANG, POLEWALI MANDAR, SULAWESI BARAT",5,69,126,195
https://kawalpemilu.org#75941,"REA, BINUANG, POLEWALI MANDAR, SULAWESI BARAT",6,75,75,150
https://kawalpemilu.org#75941,"REA, BINUANG, POLEWALI MANDAR, SULAWESI BARAT",7,111,82,193
https://kawalpemilu.org#75941,"REA, BINUANG, POLEWALI MANDAR, SULAWESI BARAT",8,111,69,180
https://kawalpemilu.org#75941,"REA, BINUANG, POLEWALI MANDAR, SULAWESI BARAT",9,121,67,188
https://kawalpemilu.org#75943,"PELITAKAN, TAPANGO, POLEWALI MANDAR, SULAWESI BARAT",1,102,125,227
https://kawalpemilu.org#75943,"PELITAKAN, TAPANGO, POLEWALI MANDAR, SULAWESI BARAT",2,81,121,202
https://kawalpemilu.org#75943,"PELITAKAN, TAPANGO, POLEWALI MANDAR, SULAWESI BARAT",3,117,107,224
https://kawalpemilu.org#75943,"PELITAKAN, TAPANGO, POLEWALI MANDAR, SULAWESI BARAT",4,81,147,228
https://kawalpemilu.org#75943,"PELITAKAN, TAPANGO, POLEWALI MANDAR, SULAWESI BARAT",5,87,115,202
https://kawalpemilu.org#75944,"TAPANGO, TAPANGO, POLEWALI MANDAR, SULAWESI BARAT",1,169,75,244
https://kawalpemilu.org#75944,"TAPANGO, TAPANGO, POLEWALI MANDAR, SULAWESI BARAT",2,138,94,232
https://kawalpemilu.org#75944,"TAPANGO, TAPANGO, POLEWALI MANDAR, SULAWESI BARAT",3,158,60,218
https://kawalpemilu.org#75944,"TAPANGO, TAPANGO, POLEWALI MANDAR, SULAWESI BARAT",4,144,69,213
https://kawalpemilu.org#75944,"TAPANGO, TAPANGO, POLEWALI MANDAR, SULAWESI BARAT",5,119,53,172
https://kawalpemilu.org#75944,"TAPANGO, TAPANGO, POLEWALI MANDAR, SULAWESI BARAT",6,128,89,220
https://kawalpemilu.org#75944,"TAPANGO, TAPANGO, POLEWALI MANDAR, SULAWESI BARAT",7,136,72,208
https://kawalpemilu.org#75944,"TAPANGO, TAPANGO, POLEWALI MANDAR, SULAWESI BARAT",8,99,58,157
https://kawalpemilu.org#75945,"RAPPANG, TAPANGO, POLEWALI MANDAR, SULAWESI BARAT",1,132,85,217
https://kawalpemilu.org#75945,"RAPPANG, TAPANGO, POLEWALI MANDAR, SULAWESI BARAT",2,116,117,233
https://kawalpemilu.org#75945,"RAPPANG, TAPANGO, POLEWALI MANDAR, SULAWESI BARAT",3,164,80,244
https://kawalpemilu.org#75945,"RAPPANG, TAPANGO, POLEWALI MANDAR, SULAWESI BARAT",4,79,64,143
https://kawalpemilu.org#75945,"RAPPANG, TAPANGO, POLEWALI MANDAR, SULAWESI BARAT",5,159,86,245
https://kawalpemilu.org#75945,"RAPPANG, TAPANGO, POLEWALI MANDAR, SULAWESI BARAT",6,94,56,150
https://kawalpemilu.org#75946,"DAKKA, TAPANGO, POLEWALI MANDAR, SULAWESI BARAT",1,95,138,233
https://kawalpemilu.org#75946,"DAKKA, TAPANGO, POLEWALI MANDAR, SULAWESI BARAT",2,98,143,241
https://kawalpemilu.org#75946,"DAKKA, TAPANGO, POLEWALI MANDAR, SULAWESI BARAT",3,113,124,237
https://kawalpemilu.org#75946,"DAKKA, TAPANGO, POLEWALI MANDAR, SULAWESI BARAT",4,99,89,188
https://kawalpemilu.org#75946,"DAKKA, TAPANGO, POLEWALI MANDAR, SULAWESI BARAT",5,97,60,157
https://kawalpemilu.org#75946,"DAKKA, TAPANGO, POLEWALI MANDAR, SULAWESI BARAT",6,101,115,216
https://kawalpemilu.org#75947,"BATU, TAPANGO, POLEWALI MANDAR, SULAWESI BARAT",1,134,63,197
https://kawalpemilu.org#75947,"BATU, TAPANGO, POLEWALI MANDAR, SULAWESI BARAT",2,138,41,179
https://kawalpemilu.org#75947,"BATU, TAPANGO, POLEWALI MANDAR, SULAWESI BARAT",3,128,52,180
https://kawalpemilu.org#75948,"RISO, TAPANGO, POLEWALI MANDAR, SULAWESI BARAT",1,140,63,203
https://kawalpemilu.org#75948,"RISO, TAPANGO, POLEWALI MANDAR, SULAWESI BARAT",2,134,61,195
https://kawalpemilu.org#75948,"RISO, TAPANGO, POLEWALI MANDAR, SULAWESI BARAT",3,135,55,190
https://kawalpemilu.org#75948,"RISO, TAPANGO, POLEWALI MANDAR, SULAWESI BARAT",4,192,17,209
https://kawalpemilu.org#75948,"RISO, TAPANGO, POLEWALI MANDAR, SULAWESI BARAT",5,137,38,211
https://kawalpemilu.org#75948,"RISO, TAPANGO, POLEWALI MANDAR, SULAWESI BARAT",6,106,71,177
https://kawalpemilu.org#75948,"RISO, TAPANGO, POLEWALI MANDAR, SULAWESI BARAT",7,100,58,158
https://kawalpemilu.org#75949,"PALATTA, TAPANGO, POLEWALI MANDAR, SULAWESI BARAT",2,118,56,174
https://kawalpemilu.org#75949,"PALATTA, TAPANGO, POLEWALI MANDAR, SULAWESI BARAT",3,137,76,213
https://kawalpemilu.org#75949,"PALATTA, TAPANGO, POLEWALI MANDAR, SULAWESI BARAT",4,111,63,174
https://kawalpemilu.org#75949,"PALATTA, TAPANGO, POLEWALI MANDAR, SULAWESI BARAT",5,93,116,209
https://kawalpemilu.org#75950,"TAPANGO BARAT, TAPANGO, POLEWALI MANDAR, SULAWESI BARAT",1,162,95,257
https://kawalpemilu.org#75950,"TAPANGO BARAT, TAPANGO, POLEWALI MANDAR, SULAWESI BARAT",2,127,93,220
https://kawalpemilu.org#75950,"TAPANGO BARAT, TAPANGO, POLEWALI MANDAR, SULAWESI BARAT",3,184,63,247
https://kawalpemilu.org#75950,"TAPANGO BARAT, TAPANGO, POLEWALI MANDAR, SULAWESI BARAT",4,157,86,243
https://kawalpemilu.org#75951,"KURRAK, TAPANGO, POLEWALI MANDAR, SULAWESI BARAT",1,114,74,188
https://kawalpemilu.org#75951,"KURRAK, TAPANGO, POLEWALI MANDAR, SULAWESI BARAT",2,71,64,135
https://kawalpemilu.org#75952,"BUSSU, TAPANGO, POLEWALI MANDAR, SULAWESI BARAT",1,95,127,222
https://kawalpemilu.org#75952,"BUSSU, TAPANGO, POLEWALI MANDAR, SULAWESI BARAT",2,114,129,243
https://kawalpemilu.org#75952,"BUSSU, TAPANGO, POLEWALI MANDAR, SULAWESI BARAT",3,105,98,203
https://kawalpemilu.org#75953,"TUTTULA, TAPANGO, POLEWALI MANDAR, SULAWESI BARAT",1,134,124,258
https://kawalpemilu.org#75953,"TUTTULA, TAPANGO, POLEWALI MANDAR, SULAWESI BARAT",2,66,176,242
https://kawalpemilu.org#75954,"JAMBU MALEA, TAPANGO, POLEWALI MANDAR, SULAWESI BARAT",1,116,58,174
https://kawalpemilu.org#75954,"JAMBU MALEA, TAPANGO, POLEWALI MANDAR, SULAWESI BARAT",2,158,41,199
https://kawalpemilu.org#75954,"JAMBU MALEA, TAPANGO, POLEWALI MANDAR, SULAWESI BARAT",3,94,100,194
https://kawalpemilu.org#75954,"JAMBU MALEA, TAPANGO, POLEWALI MANDAR, SULAWESI BARAT",4,142,64,206
https://kawalpemilu.org#75954,"JAMBU MALEA, TAPANGO, POLEWALI MANDAR, SULAWESI BARAT",5,91,51,142
https://kawalpemilu.org#75955,"KALIMBUA, TAPANGO, POLEWALI MANDAR, SULAWESI BARAT",1,108,83,191
https://kawalpemilu.org#75955,"KALIMBUA, TAPANGO, POLEWALI MANDAR, SULAWESI BARAT",2,121,95,216
https://kawalpemilu.org#75955,"KALIMBUA, TAPANGO, POLEWALI MANDAR, SULAWESI BARAT",3,149,76,225
https://kawalpemilu.org#75955,"KALIMBUA, TAPANGO, POLEWALI MANDAR, SULAWESI BARAT",4,139,95,234
https://kawalpemilu.org#75956,"BANATO REJO, TAPANGO, POLEWALI MANDAR, SULAWESI BARAT",1,113,109,222
https://kawalpemilu.org#75956,"BANATO REJO, TAPANGO, POLEWALI MANDAR, SULAWESI BARAT",2,113,134,247
https://kawalpemilu.org#75956,"BANATO REJO, TAPANGO, POLEWALI MANDAR, SULAWESI BARAT",3,125,125,250
https://kawalpemilu.org#75956,"BANATO REJO, TAPANGO, POLEWALI MANDAR, SULAWESI BARAT",4,124,115,239
https://kawalpemilu.org#75956,"BANATO REJO, TAPANGO, POLEWALI MANDAR, SULAWESI BARAT",5,128,95,223
https://kawalpemilu.org#75958,"MAPILI, MAPILLI, POLEWALI MANDAR, SULAWESI BARAT",1,105,133,238
https://kawalpemilu.org#75958,"MAPILI, MAPILLI, POLEWALI MANDAR, SULAWESI BARAT",2,89,116,205
https://kawalpemilu.org#75958,"MAPILI, MAPILLI, POLEWALI MANDAR, SULAWESI BARAT",3,104,122,226
https://kawalpemilu.org#75958,"MAPILI, MAPILLI, POLEWALI MANDAR, SULAWESI BARAT",4,120,85,205
https://kawalpemilu.org#75958,"MAPILI, MAPILLI, POLEWALI MANDAR, SULAWESI BARAT",5,96,116,212
https://kawalpemilu.org#75958,"MAPILI, MAPILLI, POLEWALI MANDAR, SULAWESI BARAT",6,128,94,222
https://kawalpemilu.org#75958,"MAPILI, MAPILLI, POLEWALI MANDAR, SULAWESI BARAT",7,112,89,201
https://kawalpemilu.org#75959,"UGIBARU, MAPILLI, POLEWALI MANDAR, SULAWESI BARAT",1,106,133,239
https://kawalpemilu.org#75959,"UGIBARU, MAPILLI, POLEWALI MANDAR, SULAWESI BARAT",2,116,74,190
https://kawalpemilu.org#75959,"UGIBARU, MAPILLI, POLEWALI MANDAR, SULAWESI BARAT",3,96,130,226
https://kawalpemilu.org#75959,"UGIBARU, MAPILLI, POLEWALI MANDAR, SULAWESI BARAT",4,142,90,232
https://kawalpemilu.org#75959,"UGIBARU, MAPILLI, POLEWALI MANDAR, SULAWESI BARAT",5,95,150,245
https://kawalpemilu.org#75959,"UGIBARU, MAPILLI, POLEWALI MANDAR, SULAWESI BARAT",6,86,132,218
https://kawalpemilu.org#75959,"UGIBARU, MAPILLI, POLEWALI MANDAR, SULAWESI BARAT",7,136,102,238
https://kawalpemilu.org#75959,"UGIBARU, MAPILLI, POLEWALI MANDAR, SULAWESI BARAT",8,129,112,241
https://kawalpemilu.org#75960,"RUMPA, MAPILLI, POLEWALI MANDAR, SULAWESI BARAT",1,74,169,243
https://kawalpemilu.org#75960,"RUMPA, MAPILLI, POLEWALI MANDAR, SULAWESI BARAT",2,82,81,163
https://kawalpemilu.org#75960,"RUMPA, MAPILLI, POLEWALI MANDAR, SULAWESI BARAT",3,100,76,176
https://kawalpemilu.org#75960,"RUMPA, MAPILLI, POLEWALI MANDAR, SULAWESI BARAT",4,97,123,220
https://kawalpemilu.org#75960,"RUMPA, MAPILLI, POLEWALI MANDAR, SULAWESI BARAT",5,75,103,178
https://kawalpemilu.org#75960,"RUMPA, MAPILLI, POLEWALI MANDAR, SULAWESI BARAT",6,101,81,182
https://kawalpemilu.org#75960,"RUMPA, MAPILLI, POLEWALI MANDAR, SULAWESI BARAT",7,84,135,219
https://kawalpemilu.org#75960,"RUMPA, MAPILLI, POLEWALI MANDAR, SULAWESI BARAT",8,79,110,189
https://kawalpemilu.org#75961,"KURMA, MAPILLI, POLEWALI MANDAR, SULAWESI BARAT",1,178,83,261
https://kawalpemilu.org#75961,"KURMA, MAPILLI, POLEWALI MANDAR, SULAWESI BARAT",2,176,45,221
https://kawalpemilu.org#75961,"KURMA, MAPILLI, POLEWALI MANDAR, SULAWESI BARAT",3,154,86,240
https://kawalpemilu.org#75961,"KURMA, MAPILLI, POLEWALI MANDAR, SULAWESI BARAT",4,167,72,239
https://kawalpemilu.org#75961,"KURMA, MAPILLI, POLEWALI MANDAR, SULAWESI BARAT",5,136,78,214
https://kawalpemilu.org#75961,"KURMA, MAPILLI, POLEWALI MANDAR, SULAWESI BARAT",6,119,117,236
https://kawalpemilu.org#75961,"KURMA, MAPILLI, POLEWALI MANDAR, SULAWESI BARAT",7,95,102,197
https://kawalpemilu.org#75961,"KURMA, MAPILLI, POLEWALI MANDAR, SULAWESI BARAT",8,64,101,165
https://kawalpemilu.org#75961,"KURMA, MAPILLI, POLEWALI MANDAR, SULAWESI BARAT",9,136,42,178
https://kawalpemilu.org#75961,"KURMA, MAPILLI, POLEWALI MANDAR, SULAWESI BARAT",10,144,37,181
https://kawalpemilu.org#75962,"LANDI KANUSUANG, MAPILLI, POLEWALI MANDAR, SULAWESI BARAT",1,106,84,190
https://kawalpemilu.org#75962,"LANDI KANUSUANG, MAPILLI, POLEWALI MANDAR, SULAWESI BARAT",2,133,67,200
https://kawalpemilu.org#75962,"LANDI KANUSUANG, MAPILLI, POLEWALI MANDAR, SULAWESI BARAT",3,132,67,199
https://kawalpemilu.org#75962,"LANDI KANUSUANG, MAPILLI, POLEWALI MANDAR, SULAWESI BARAT",4,169,22,191
https://kawalpemilu.org#75962,"LANDI KANUSUANG, MAPILLI, POLEWALI MANDAR, SULAWESI BARAT",5,80,81,161
https://kawalpemilu.org#75962,"LANDI KANUSUANG, MAPILLI, POLEWALI MANDAR, SULAWESI BARAT",6,137,64,201
https://kawalpemilu.org#75962,"LANDI KANUSUANG, MAPILLI, POLEWALI MANDAR, SULAWESI BARAT",7,171,52,223
https://kawalpemilu.org#75963,"BUKU, MAPILLI, POLEWALI MANDAR, SULAWESI BARAT",1,53,101,154
https://kawalpemilu.org#75963,"BUKU, MAPILLI, POLEWALI MANDAR, SULAWESI BARAT",2,82,59,141
https://kawalpemilu.org#75963,"BUKU, MAPILLI, POLEWALI MANDAR, SULAWESI BARAT",3,103,93,196
https://kawalpemilu.org#75963,"BUKU, MAPILLI, POLEWALI MANDAR, SULAWESI BARAT",4,88,93,181
https://kawalpemilu.org#75963,"BUKU, MAPILLI, POLEWALI MANDAR, SULAWESI BARAT",5,79,108,187
https://kawalpemilu.org#75963,"BUKU, MAPILLI, POLEWALI MANDAR, SULAWESI BARAT",6,63,90,153
https://kawalpemilu.org#75963,"BUKU, MAPILLI, POLEWALI MANDAR, SULAWESI BARAT",7,58,135,193
https://kawalpemilu.org#75963,"BUKU, MAPILLI, POLEWALI MANDAR, SULAWESI BARAT",8,83,121,204
https://kawalpemilu.org#75964,"BONNE BONNE, MAPILLI, POLEWALI MANDAR, SULAWESI BARAT",1,115,127,242
https://kawalpemilu.org#75964,"BONNE BONNE, MAPILLI, POLEWALI MANDAR, SULAWESI BARAT",2,99,127,226
https://kawalpemilu.org#75964,"BONNE BONNE, MAPILLI, POLEWALI MANDAR, SULAWESI BARAT",3,127,120,247
https://kawalpemilu.org#75964,"BONNE BONNE, MAPILLI, POLEWALI MANDAR, SULAWESI BARAT",4,110,147,257
https://kawalpemilu.org#75964,"BONNE BONNE, MAPILLI, POLEWALI MANDAR, SULAWESI BARAT",5,98,137,235
https://kawalpemilu.org#75964,"BONNE BONNE, MAPILLI, POLEWALI MANDAR, SULAWESI BARAT",6,135,99,234
https://kawalpemilu.org#75965,"BEROANGIN, MAPILLI, POLEWALI MANDAR, SULAWESI BARAT",1,173,65,238
https://kawalpemilu.org#75965,"BEROANGIN, MAPILLI, POLEWALI MANDAR, SULAWESI BARAT",2,77,85,162
https://kawalpemilu.org#75965,"BEROANGIN, MAPILLI, POLEWALI MANDAR, SULAWESI BARAT",3,73,42,115
https://kawalpemilu.org#75965,"BEROANGIN, MAPILLI, POLEWALI MANDAR, SULAWESI BARAT",4,68,71,139
https://kawalpemilu.org#75965,"BEROANGIN, MAPILLI, POLEWALI MANDAR, SULAWESI BARAT",5,120,25,145
https://kawalpemilu.org#75965,"BEROANGIN, MAPILLI, POLEWALI MANDAR, SULAWESI BARAT",6,65,33,98
https://kawalpemilu.org#75966,"SEGERANG, MAPILLI, POLEWALI MANDAR, SULAWESI BARAT",1,109,128,237
https://kawalpemilu.org#75966,"SEGERANG, MAPILLI, POLEWALI MANDAR, SULAWESI BARAT",2,111,107,218
https://kawalpemilu.org#75966,"SEGERANG, MAPILLI, POLEWALI MANDAR, SULAWESI BARAT",3,132,86,218
https://kawalpemilu.org#75966,"SEGERANG, MAPILLI, POLEWALI MANDAR, SULAWESI BARAT",4,158,79,237
https://kawalpemilu.org#75967,"BONRA, MAPILLI, POLEWALI MANDAR, SULAWESI BARAT",1,122,127,249
https://kawalpemilu.org#75967,"BONRA, MAPILLI, POLEWALI MANDAR, SULAWESI BARAT",2,122,98,220
https://kawalpemilu.org#75967,"BONRA, MAPILLI, POLEWALI MANDAR, SULAWESI BARAT",3,131,98,229
https://kawalpemilu.org#75967,"BONRA, MAPILLI, POLEWALI MANDAR, SULAWESI BARAT",4,151,81,232
https://kawalpemilu.org#75967,"BONRA, MAPILLI, POLEWALI MANDAR, SULAWESI BARAT",5,167,67,234
https://kawalpemilu.org#75967,"BONRA, MAPILLI, POLEWALI MANDAR, SULAWESI BARAT",6,177,79,256
https://kawalpemilu.org#75967,"BONRA, MAPILLI, POLEWALI MANDAR, SULAWESI BARAT",7,127,128,255
https://kawalpemilu.org#75967,"BONRA, MAPILLI, POLEWALI MANDAR, SULAWESI BARAT",8,158,64,222
https://kawalpemilu.org#75968,"SATTOKO, MAPILLI, POLEWALI MANDAR, SULAWESI BARAT",1,165,22,187
https://kawalpemilu.org#75968,"SATTOKO, MAPILLI, POLEWALI MANDAR, SULAWESI BARAT",2,142,44,186
https://kawalpemilu.org#93223,"RAPPANG BARAT, MAPILLI, POLEWALI MANDAR, SULAWESI BARAT",1,149,94,243
https://kawalpemilu.org#93223,"RAPPANG BARAT, MAPILLI, POLEWALI MANDAR, SULAWESI BARAT",2,155,87,242
https://kawalpemilu.org#93223,"RAPPANG BARAT, MAPILLI, POLEWALI MANDAR, SULAWESI BARAT",3,164,69,233
https://kawalpemilu.org#93223,"RAPPANG BARAT, MAPILLI, POLEWALI MANDAR, SULAWESI BARAT",4,133,76,209
https://kawalpemilu.org#93223,"RAPPANG BARAT, MAPILLI, POLEWALI MANDAR, SULAWESI BARAT",5,142,89,231
https://kawalpemilu.org#93223,"RAPPANG BARAT, MAPILLI, POLEWALI MANDAR, SULAWESI BARAT",6,129,84,213
https://kawalpemilu.org#93223,"RAPPANG BARAT, MAPILLI, POLEWALI MANDAR, SULAWESI BARAT",7,133,89,222
https://kawalpemilu.org#93223,"RAPPANG BARAT, MAPILLI, POLEWALI MANDAR, SULAWESI BARAT",8,186,64,250
https://kawalpemilu.org#75971,"MATANGNGA, MATANGNGA, POLEWALI MANDAR, SULAWESI BARAT",1,128,100,228
https://kawalpemilu.org#75971,"MATANGNGA, MATANGNGA, POLEWALI MANDAR, SULAWESI BARAT",2,132,91,223
https://kawalpemilu.org#75971,"MATANGNGA, MATANGNGA, POLEWALI MANDAR, SULAWESI BARAT",3,43,31,74
https://kawalpemilu.org#75972,"LILLI, MATANGNGA, POLEWALI MANDAR, SULAWESI BARAT",1,142,28,170
https://kawalpemilu.org#75972,"LILLI, MATANGNGA, POLEWALI MANDAR, SULAWESI BARAT",2,143,33,176
https://kawalpemilu.org#75973,"RANGOAN, MATANGNGA, POLEWALI MANDAR, SULAWESI BARAT",1,89,38,127
https://kawalpemilu.org#75973,"RANGOAN, MATANGNGA, POLEWALI MANDAR, SULAWESI BARAT",2,127,37,164
https://kawalpemilu.org#75973,"RANGOAN, MATANGNGA, POLEWALI MANDAR, SULAWESI BARAT",3,180,14,194
https://kawalpemilu.org#75974,"TAPUA, MATANGNGA, POLEWALI MANDAR, SULAWESI BARAT",1,82,138,220
https://kawalpemilu.org#75974,"TAPUA, MATANGNGA, POLEWALI MANDAR, SULAWESI BARAT",2,83,58,141
https://kawalpemilu.org#75974,"TAPUA, MATANGNGA, POLEWALI MANDAR, SULAWESI BARAT",3,31,85,116
https://kawalpemilu.org#75974,"TAPUA, MATANGNGA, POLEWALI MANDAR, SULAWESI BARAT",4,115,66,181
https://kawalpemilu.org#75975,"MAMBU TAPUA, MATANGNGA, POLEWALI MANDAR, SULAWESI BARAT",1,142,24,166
https://kawalpemilu.org#75975,"MAMBU TAPUA, MATANGNGA, POLEWALI MANDAR, SULAWESI BARAT",2,143,10,153
https://kawalpemilu.org#75976,"BA'BA TAPUA, MATANGNGA, POLEWALI MANDAR, SULAWESI BARAT",1,106,73,179
https://kawalpemilu.org#75976,"BA'BA TAPUA, MATANGNGA, POLEWALI MANDAR, SULAWESI BARAT",2,30,47,77
https://kawalpemilu.org#75977,"KATIMBANG, MATANGNGA, POLEWALI MANDAR, SULAWESI BARAT",1,127,68,195
https://kawalpemilu.org#75977,"KATIMBANG, MATANGNGA, POLEWALI MANDAR, SULAWESI BARAT",2,122,48,170
https://kawalpemilu.org#75977,"KATIMBANG, MATANGNGA, POLEWALI MANDAR, SULAWESI BARAT",3,28,12,40
https://kawalpemilu.org#75979,"MAMBU, LUYO, POLEWALI MANDAR, SULAWESI BARAT",1,130,83,221
https://kawalpemilu.org#75979,"MAMBU, LUYO, POLEWALI MANDAR, SULAWESI BARAT",2,132,80,212
https://kawalpemilu.org#75979,"MAMBU, LUYO, POLEWALI MANDAR, SULAWESI BARAT",3,104,43,147
https://kawalpemilu.org#75979,"MAMBU, LUYO, POLEWALI MANDAR, SULAWESI BARAT",4,120,89,209
https://kawalpemilu.org#75979,"MAMBU, LUYO, POLEWALI MANDAR, SULAWESI BARAT",5,93,85,178
https://kawalpemilu.org#75979,"MAMBU, LUYO, POLEWALI MANDAR, SULAWESI BARAT",6,124,79,203
https://kawalpemilu.org#75979,"MAMBU, LUYO, POLEWALI MANDAR, SULAWESI BARAT",7,141,44,185
https://kawalpemilu.org#75980,"TENGGELANG, LUYO, POLEWALI MANDAR, SULAWESI BARAT",1,164,66,230
https://kawalpemilu.org#75980,"TENGGELANG, LUYO, POLEWALI MANDAR, SULAWESI BARAT",2,133,70,203
https://kawalpemilu.org#75980,"TENGGELANG, LUYO, POLEWALI MANDAR, SULAWESI BARAT",3,144,39,183
https://kawalpemilu.org#75980,"TENGGELANG, LUYO, POLEWALI MANDAR, SULAWESI BARAT",4,140,84,224
https://kawalpemilu.org#75980,"TENGGELANG, LUYO, POLEWALI MANDAR, SULAWESI BARAT",5,119,86,205
https://kawalpemilu.org#75980,"TENGGELANG, LUYO, POLEWALI MANDAR, SULAWESI BARAT",6,163,52,215
https://kawalpemilu.org#75980,"TENGGELANG, LUYO, POLEWALI MANDAR, SULAWESI BARAT",7,86,39,125
https://kawalpemilu.org#75980,"TENGGELANG, LUYO, POLEWALI MANDAR, SULAWESI BARAT",8,102,33,135
https://kawalpemilu.org#75980,"TENGGELANG, LUYO, POLEWALI MANDAR, SULAWESI BARAT",9,135,54,189
https://kawalpemilu.org#75980,"TENGGELANG, LUYO, POLEWALI MANDAR, SULAWESI BARAT",10,138,70,208
https://kawalpemilu.org#75981,"BARU, LUYO, POLEWALI MANDAR, SULAWESI BARAT",1,141,36,177
https://kawalpemilu.org#75981,"BARU, LUYO, POLEWALI MANDAR, SULAWESI BARAT",2,125,95,220
https://kawalpemilu.org#75981,"BARU, LUYO, POLEWALI MANDAR, SULAWESI BARAT",3,137,74,211
https://kawalpemilu.org#75981,"BARU, LUYO, POLEWALI MANDAR, SULAWESI BARAT",4,137,82,219
https://kawalpemilu.org#75981,"BARU, LUYO, POLEWALI MANDAR, SULAWESI BARAT",5,114,86,200
https://kawalpemilu.org#75981,"BARU, LUYO, POLEWALI MANDAR, SULAWESI BARAT",6,124,120,244
https://kawalpemilu.org#75981,"BARU, LUYO, POLEWALI MANDAR, SULAWESI BARAT",7,118,55,173
https://kawalpemilu.org#75981,"BARU, LUYO, POLEWALI MANDAR, SULAWESI BARAT",8,157,36,157
https://kawalpemilu.org#75981,"BARU, LUYO, POLEWALI MANDAR, SULAWESI BARAT",9,130,77,207
https://kawalpemilu.org#75981,"BARU, LUYO, POLEWALI MANDAR, SULAWESI BARAT",10,84,89,173
https://kawalpemilu.org#75981,"BARU, LUYO, POLEWALI MANDAR, SULAWESI BARAT",11,113,76,189
https://kawalpemilu.org#75981,"BARU, LUYO, POLEWALI MANDAR, SULAWESI BARAT",12,120,100,220
https://kawalpemilu.org#75982,"BATUPANGA, LUYO, POLEWALI MANDAR, SULAWESI BARAT",1,151,55,206
https://kawalpemilu.org#75982,"BATUPANGA, LUYO, POLEWALI MANDAR, SULAWESI BARAT",2,105,80,185
https://kawalpemilu.org#75982,"BATUPANGA, LUYO, POLEWALI MANDAR, SULAWESI BARAT",3,78,129,207
https://kawalpemilu.org#75982,"BATUPANGA, LUYO, POLEWALI MANDAR, SULAWESI BARAT",4,110,71,181
https://kawalpemilu.org#75982,"BATUPANGA, LUYO, POLEWALI MANDAR, SULAWESI BARAT",5,148,62,210
https://kawalpemilu.org#75982,"BATUPANGA, LUYO, POLEWALI MANDAR, SULAWESI BARAT",6,154,62,216
https://kawalpemilu.org#75982,"BATUPANGA, LUYO, POLEWALI MANDAR, SULAWESI BARAT",7,127,112,239
https://kawalpemilu.org#75982,"BATUPANGA, LUYO, POLEWALI MANDAR, SULAWESI BARAT",8,133,83,216
https://kawalpemilu.org#75982,"BATUPANGA, LUYO, POLEWALI MANDAR, SULAWESI BARAT",9,96,57,153
https://kawalpemilu.org#75983,"PUSSUI, LUYO, POLEWALI MANDAR, SULAWESI BARAT",1,59,83,142
https://kawalpemilu.org#75983,"PUSSUI, LUYO, POLEWALI MANDAR, SULAWESI BARAT",2,144,82,226
https://kawalpemilu.org#75983,"PUSSUI, LUYO, POLEWALI MANDAR, SULAWESI BARAT",3,88,122,210
https://kawalpemilu.org#75983,"PUSSUI, LUYO, POLEWALI MANDAR, SULAWESI BARAT",4,98,65,163
https://kawalpemilu.org#75983,"PUSSUI, LUYO, POLEWALI MANDAR, SULAWESI BARAT",5,114,78,192
https://kawalpemilu.org#75983,"PUSSUI, LUYO, POLEWALI MANDAR, SULAWESI BARAT",6,86,65,151
https://kawalpemilu.org#75984,"MAPILI BARAT, LUYO, POLEWALI MANDAR, SULAWESI BARAT",1,137,77,214
https://kawalpemilu.org#75984,"MAPILI BARAT, LUYO, POLEWALI MANDAR, SULAWESI BARAT",2,110,99,209
https://kawalpemilu.org#75984,"MAPILI BARAT, LUYO, POLEWALI MANDAR, SULAWESI BARAT",3,87,79,166
https://kawalpemilu.org#75984,"MAPILI BARAT, LUYO, POLEWALI MANDAR, SULAWESI BARAT",4,83,141,224
https://kawalpemilu.org#75984,"MAPILI BARAT, LUYO, POLEWALI MANDAR, SULAWESI BARAT",5,117,90,207
https://kawalpemilu.org#75984,"MAPILI BARAT, LUYO, POLEWALI MANDAR, SULAWESI BARAT",6,77,106,183
https://kawalpemilu.org#75984,"MAPILI BARAT, LUYO, POLEWALI MANDAR, SULAWESI BARAT",7,119,102,221
https://kawalpemilu.org#75984,"MAPILI BARAT, LUYO, POLEWALI MANDAR, SULAWESI BARAT",8,69,144,213
https://kawalpemilu.org#75985,"SAMBALI WALI, LUYO, POLEWALI MANDAR, SULAWESI BARAT",1,134,76,210
https://kawalpemilu.org#75985,"SAMBALI WALI, LUYO, POLEWALI MANDAR, SULAWESI BARAT",2,169,41,210
https://kawalpemilu.org#75985,"SAMBALI WALI, LUYO, POLEWALI MANDAR, SULAWESI BARAT",3,116,60,176
https://kawalpemilu.org#75985,"SAMBALI WALI, LUYO, POLEWALI MANDAR, SULAWESI BARAT",4,144,32,176
https://kawalpemilu.org#75985,"SAMBALI WALI, LUYO, POLEWALI MANDAR, SULAWESI BARAT",5,149,57,206
https://kawalpemilu.org#75985,"SAMBALI WALI, LUYO, POLEWALI MANDAR, SULAWESI BARAT",6,137,40,177
https://kawalpemilu.org#75986,"BATUPANGA DAALA, LUYO, POLEWALI MANDAR, SULAWESI BARAT",1,121,88,209
https://kawalpemilu.org#75986,"BATUPANGA DAALA, LUYO, POLEWALI MANDAR, SULAWESI BARAT",2,113,108,221
https://kawalpemilu.org#75986,"BATUPANGA DAALA, LUYO, POLEWALI MANDAR, SULAWESI BARAT",3,175,58,233
https://kawalpemilu.org#75986,"BATUPANGA DAALA, LUYO, POLEWALI MANDAR, SULAWESI BARAT",4,93,60,153
https://kawalpemilu.org#75986,"BATUPANGA DAALA, LUYO, POLEWALI MANDAR, SULAWESI BARAT",5,106,53,159
https://kawalpemilu.org#75986,"BATUPANGA DAALA, LUYO, POLEWALI MANDAR, SULAWESI BARAT",6,111,87,198
https://kawalpemilu.org#75986,"BATUPANGA DAALA, LUYO, POLEWALI MANDAR, SULAWESI BARAT",7,166,60,226
https://kawalpemilu.org#75986,"BATUPANGA DAALA, LUYO, POLEWALI MANDAR, SULAWESI BARAT",8,127,46,173
https://kawalpemilu.org#75986,"BATUPANGA DAALA, LUYO, POLEWALI MANDAR, SULAWESI BARAT",9,109,73,182
https://kawalpemilu.org#75987,"LUYO, LUYO, POLEWALI MANDAR, SULAWESI BARAT",1,81,68,149
https://kawalpemilu.org#75987,"LUYO, LUYO, POLEWALI MANDAR, SULAWESI BARAT",2,94,92,186
https://kawalpemilu.org#75987,"LUYO, LUYO, POLEWALI MANDAR, SULAWESI BARAT",3,94,98,192
https://kawalpemilu.org#75987,"LUYO, LUYO, POLEWALI MANDAR, SULAWESI BARAT",4,53,131,184
https://kawalpemilu.org#75987,"LUYO, LUYO, POLEWALI MANDAR, SULAWESI BARAT",5,73,66,139
https://kawalpemilu.org#75987,"LUYO, LUYO, POLEWALI MANDAR, SULAWESI BARAT",6,121,109,230
https://kawalpemilu.org#75988,"PUSSUI BARAT, LUYO, POLEWALI MANDAR, SULAWESI BARAT",1,87,113,200
https://kawalpemilu.org#75988,"PUSSUI BARAT, LUYO, POLEWALI MANDAR, SULAWESI BARAT",2,131,53,184
https://kawalpemilu.org#75988,"PUSSUI BARAT, LUYO, POLEWALI MANDAR, SULAWESI BARAT",3,138,60,198
https://kawalpemilu.org#75988,"PUSSUI BARAT, LUYO, POLEWALI MANDAR, SULAWESI BARAT",4,111,64,175
https://kawalpemilu.org#75989,"PUCCADI, LUYO, POLEWALI MANDAR, SULAWESI BARAT",1,109,127,236
https://kawalpemilu.org#75989,"PUCCADI, LUYO, POLEWALI MANDAR, SULAWESI BARAT",2,150,76,226
https://kawalpemilu.org#75989,"PUCCADI, LUYO, POLEWALI MANDAR, SULAWESI BARAT",3,121,105,226
https://kawalpemilu.org#75989,"PUCCADI, LUYO, POLEWALI MANDAR, SULAWESI BARAT",4,131,90,221
https://kawalpemilu.org#75991,"LIMBORO, LIMBORO, POLEWALI MANDAR, SULAWESI BARAT",1,84,164,248
https://kawalpemilu.org#75991,"LIMBORO, LIMBORO, POLEWALI MANDAR, SULAWESI BARAT",2,70,156,226
https://kawalpemilu.org#75991,"LIMBORO, LIMBORO, POLEWALI MANDAR, SULAWESI BARAT",3,73,140,213
https://kawalpemilu.org#75991,"LIMBORO, LIMBORO, POLEWALI MANDAR, SULAWESI BARAT",4,79,122,201
https://kawalpemilu.org#75991,"LIMBORO, LIMBORO, POLEWALI MANDAR, SULAWESI BARAT",5,136,97,233
https://kawalpemilu.org#75991,"LIMBORO, LIMBORO, POLEWALI MANDAR, SULAWESI BARAT",6,100,125,225
https://kawalpemilu.org#75992,"LEMBANG LEMBANG, LIMBORO, POLEWALI MANDAR, SULAWESI BARAT",1,115,122,237
https://kawalpemilu.org#75992,"LEMBANG LEMBANG, LIMBORO, POLEWALI MANDAR, SULAWESI BARAT",2,74,175,249
https://kawalpemilu.org#75992,"LEMBANG LEMBANG, LIMBORO, POLEWALI MANDAR, SULAWESI BARAT",3,92,154,246
https://kawalpemilu.org#75992,"LEMBANG LEMBANG, LIMBORO, POLEWALI MANDAR, SULAWESI BARAT",4,116,103,219
https://kawalpemilu.org#75992,"LEMBANG LEMBANG, LIMBORO, POLEWALI MANDAR, SULAWESI BARAT",5,83,124,207
https://kawalpemilu.org#75992,"LEMBANG LEMBANG, LIMBORO, POLEWALI MANDAR, SULAWESI BARAT",6,116,121,237
https://kawalpemilu.org#75992,"LEMBANG LEMBANG, LIMBORO, POLEWALI MANDAR, SULAWESI BARAT",7,114,110,224
https://kawalpemilu.org#75992,"LEMBANG LEMBANG, LIMBORO, POLEWALI MANDAR, SULAWESI BARAT",8,144,80,224
https://kawalpemilu.org#75992,"LEMBANG LEMBANG, LIMBORO, POLEWALI MANDAR, SULAWESI BARAT",9,91,73,164
https://kawalpemilu.org#75992,"LEMBANG LEMBANG, LIMBORO, POLEWALI MANDAR, SULAWESI BARAT",10,54,56,110
https://kawalpemilu.org#75993,"TANDASURA, LIMBORO, POLEWALI MANDAR, SULAWESI BARAT",1,64,151,215
https://kawalpemilu.org#75993,"TANDASURA, LIMBORO, POLEWALI MANDAR, SULAWESI BARAT",2,74,106,180
https://kawalpemilu.org#75993,"TANDASURA, LIMBORO, POLEWALI MANDAR, SULAWESI BARAT",3,74,92,166
https://kawalpemilu.org#75993,"TANDASURA, LIMBORO, POLEWALI MANDAR, SULAWESI BARAT",4,101,82,183
https://kawalpemilu.org#75993,"TANDASURA, LIMBORO, POLEWALI MANDAR, SULAWESI BARAT",5,83,84,167
https://kawalpemilu.org#75994,"SAMASUNDU, LIMBORO, POLEWALI MANDAR, SULAWESI BARAT",1,113,100,213
https://kawalpemilu.org#75994,"SAMASUNDU, LIMBORO, POLEWALI MANDAR, SULAWESI BARAT",2,87,138,225
https://kawalpemilu.org#75994,"SAMASUNDU, LIMBORO, POLEWALI MANDAR, SULAWESI BARAT",3,111,96,207
https://kawalpemilu.org#75994,"SAMASUNDU, LIMBORO, POLEWALI MANDAR, SULAWESI BARAT",4,89,116,205
https://kawalpemilu.org#75994,"SAMASUNDU, LIMBORO, POLEWALI MANDAR, SULAWESI BARAT",5,61,53,114
https://kawalpemilu.org#75995,"NAPO, LIMBORO, POLEWALI MANDAR, SULAWESI BARAT",1,99,134,233
https://kawalpemilu.org#75995,"NAPO, LIMBORO, POLEWALI MANDAR, SULAWESI BARAT",2,141,85,226
https://kawalpemilu.org#75995,"NAPO, LIMBORO, POLEWALI MANDAR, SULAWESI BARAT",3,163,66,229
https://kawalpemilu.org#75995,"NAPO, LIMBORO, POLEWALI MANDAR, SULAWESI BARAT",4,116,120,236
https://kawalpemilu.org#75995,"NAPO, LIMBORO, POLEWALI MANDAR, SULAWESI BARAT",5,147,71,218
https://kawalpemilu.org#75996,"TODANG TODANG, LIMBORO, POLEWALI MANDAR, SULAWESI BARAT",1,91,38,129
https://kawalpemilu.org#75996,"TODANG TODANG, LIMBORO, POLEWALI MANDAR, SULAWESI BARAT",2,124,67,191
https://kawalpemilu.org#75996,"TODANG TODANG, LIMBORO, POLEWALI MANDAR, SULAWESI BARAT",3,92,32,124
https://kawalpemilu.org#75997,"PENDULANGAN, LIMBORO, POLEWALI MANDAR, SULAWESI BARAT",1,115,51,166
https://kawalpemilu.org#75997,"PENDULANGAN, LIMBORO, POLEWALI MANDAR, SULAWESI BARAT",2,159,62,221
https://kawalpemilu.org#75997,"PENDULANGAN, LIMBORO, POLEWALI MANDAR, SULAWESI BARAT",3,50,32,6
https://kawalpemilu.org#75998,"RENGGEANG, LIMBORO, POLEWALI MANDAR, SULAWESI BARAT",1,77,124,201
https://kawalpemilu.org#75998,"RENGGEANG, LIMBORO, POLEWALI MANDAR, SULAWESI BARAT",2,114,106,220
https://kawalpemilu.org#75998,"RENGGEANG, LIMBORO, POLEWALI MANDAR, SULAWESI BARAT",3,68,60,128
https://kawalpemilu.org#75998,"RENGGEANG, LIMBORO, POLEWALI MANDAR, SULAWESI BARAT",4,111,115,226
https://kawalpemilu.org#75998,"RENGGEANG, LIMBORO, POLEWALI MANDAR, SULAWESI BARAT",5,53,25,78
https://kawalpemilu.org#75999,"SALARRI, LIMBORO, POLEWALI MANDAR, SULAWESI BARAT",1,78,138,216
https://kawalpemilu.org#75999,"SALARRI, LIMBORO, POLEWALI MANDAR, SULAWESI BARAT",2,80,111,191
https://kawalpemilu.org#75999,"SALARRI, LIMBORO, POLEWALI MANDAR, SULAWESI BARAT",3,99,75,174
https://kawalpemilu.org#76000,"TANGAN BARU, LIMBORO, POLEWALI MANDAR, SULAWESI BARAT",1,73,115,188
https://kawalpemilu.org#76000,"TANGAN BARU, LIMBORO, POLEWALI MANDAR, SULAWESI BARAT",2,83,100,183
https://kawalpemilu.org#76000,"TANGAN BARU, LIMBORO, POLEWALI MANDAR, SULAWESI BARAT",3,91,85,176
https://kawalpemilu.org#76000,"TANGAN BARU, LIMBORO, POLEWALI MANDAR, SULAWESI BARAT",4,80,34,114
https://kawalpemilu.org#76001,"PALECE, LIMBORO, POLEWALI MANDAR, SULAWESI BARAT",1,106,118,224
https://kawalpemilu.org#76001,"PALECE, LIMBORO, POLEWALI MANDAR, SULAWESI BARAT",2,130,122,252
https://kawalpemilu.org#76001,"PALECE, LIMBORO, POLEWALI MANDAR, SULAWESI BARAT",3,90,130,220
https://kawalpemilu.org#76001,"PALECE, LIMBORO, POLEWALI MANDAR, SULAWESI BARAT",4,114,125,239
https://kawalpemilu.org#76001,"PALECE, LIMBORO, POLEWALI MANDAR, SULAWESI BARAT",5,53,34,87
https://kawalpemilu.org#76003,"BALANIPA, BALANIPA, POLEWALI MANDAR, SULAWESI BARAT",1,165,57,222
https://kawalpemilu.org#76003,"BALANIPA, BALANIPA, POLEWALI MANDAR, SULAWESI BARAT",2,77,78,155
https://kawalpemilu.org#76003,"BALANIPA, BALANIPA, POLEWALI MANDAR, SULAWESI BARAT",3,136,104,240
https://kawalpemilu.org#76003,"BALANIPA, BALANIPA, POLEWALI MANDAR, SULAWESI BARAT",4,101,67,168
https://kawalpemilu.org#76003,"BALANIPA, BALANIPA, POLEWALI MANDAR, SULAWESI BARAT",5,119,82,201
https://kawalpemilu.org#76003,"BALANIPA, BALANIPA, POLEWALI MANDAR, SULAWESI BARAT",6,112,90,202
https://kawalpemilu.org#76003,"BALANIPA, BALANIPA, POLEWALI MANDAR, SULAWESI BARAT",7,77,65,142
https://kawalpemilu.org#76003,"BALANIPA, BALANIPA, POLEWALI MANDAR, SULAWESI BARAT",8,120,34,154
https://kawalpemilu.org#76003,"BALANIPA, BALANIPA, POLEWALI MANDAR, SULAWESI BARAT",9,175,68,243
https://kawalpemilu.org#76004,"TAMMAJARRA, BALANIPA, POLEWALI MANDAR, SULAWESI BARAT",1,103,125,228
https://kawalpemilu.org#76004,"TAMMAJARRA, BALANIPA, POLEWALI MANDAR, SULAWESI BARAT",2,55,109,164
https://kawalpemilu.org#76004,"TAMMAJARRA, BALANIPA, POLEWALI MANDAR, SULAWESI BARAT",3,50,103,153
https://kawalpemilu.org#76004,"TAMMAJARRA, BALANIPA, POLEWALI MANDAR, SULAWESI BARAT",4,118,101,219
https://kawalpemilu.org#76004,"TAMMAJARRA, BALANIPA, POLEWALI MANDAR, SULAWESI BARAT",5,153,81,234
https://kawalpemilu.org#76005,"TAMANGGALLE, BALANIPA, POLEWALI MANDAR, SULAWESI BARAT",1,126,56,182
https://kawalpemilu.org#76005,"TAMANGGALLE, BALANIPA, POLEWALI MANDAR, SULAWESI BARAT",2,57,98,155
https://kawalpemilu.org#76005,"TAMANGGALLE, BALANIPA, POLEWALI MANDAR, SULAWESI BARAT",3,185,24,209
https://kawalpemilu.org#76005,"TAMANGGALLE, BALANIPA, POLEWALI MANDAR, SULAWESI BARAT",4,137,81,218
https://kawalpemilu.org#76005,"TAMANGGALLE, BALANIPA, POLEWALI MANDAR, SULAWESI BARAT",5,112,77,189
https://kawalpemilu.org#76005,"TAMANGGALLE, BALANIPA, POLEWALI MANDAR, SULAWESI BARAT",6,128,52,180
https://kawalpemilu.org#76005,"TAMANGGALLE, BALANIPA, POLEWALI MANDAR, SULAWESI BARAT",7,111,33,144
https://kawalpemilu.org#76006,"MOSSO, BALANIPA, POLEWALI MANDAR, SULAWESI BARAT",1,137,7,144
https://kawalpemilu.org#76006,"MOSSO, BALANIPA, POLEWALI MANDAR, SULAWESI BARAT",2,86,22,108
https://kawalpemilu.org#76006,"MOSSO, BALANIPA, POLEWALI MANDAR, SULAWESI BARAT",3,113,9,122
https://kawalpemilu.org#76006,"MOSSO, BALANIPA, POLEWALI MANDAR, SULAWESI BARAT",4,117,40,157
https://kawalpemilu.org#76007,"GALUNG TULUK, BALANIPA, POLEWALI MANDAR, SULAWESI BARAT",1,104,76,180
https://kawalpemilu.org#76007,"GALUNG TULUK, BALANIPA, POLEWALI MANDAR, SULAWESI BARAT",2,143,48,191
https://kawalpemilu.org#76007,"GALUNG TULUK, BALANIPA, POLEWALI MANDAR, SULAWESI BARAT",3,99,83,182
https://kawalpemilu.org#76007,"GALUNG TULUK, BALANIPA, POLEWALI MANDAR, SULAWESI BARAT",4,79,88,167
https://kawalpemilu.org#76007,"GALUNG TULUK, BALANIPA, POLEWALI MANDAR, SULAWESI BARAT",5,120,40,160
https://kawalpemilu.org#76007,"GALUNG TULUK, BALANIPA, POLEWALI MANDAR, SULAWESI BARAT",6,167,59,226
https://kawalpemilu.org#76007,"GALUNG TULUK, BALANIPA, POLEWALI MANDAR, SULAWESI BARAT",7,152,49,201
https://kawalpemilu.org#76007,"GALUNG TULUK, BALANIPA, POLEWALI MANDAR, SULAWESI BARAT",8,153,46,199
https://kawalpemilu.org#76007,"GALUNG TULUK, BALANIPA, POLEWALI MANDAR, SULAWESI BARAT",9,111,99,210
https://kawalpemilu.org#76007,"GALUNG TULUK, BALANIPA, POLEWALI MANDAR, SULAWESI BARAT",10,136,77,213
https://kawalpemilu.org#76008,"SABANG SUBIK, BALANIPA, POLEWALI MANDAR, SULAWESI BARAT",1,127,106,233
https://kawalpemilu.org#76008,"SABANG SUBIK, BALANIPA, POLEWALI MANDAR, SULAWESI BARAT",2,127,112,239
https://kawalpemilu.org#76008,"SABANG SUBIK, BALANIPA, POLEWALI MANDAR, SULAWESI BARAT",3,130,93,223
https://kawalpemilu.org#76008,"SABANG SUBIK, BALANIPA, POLEWALI MANDAR, SULAWESI BARAT",4,126,97,223
https://kawalpemilu.org#76008,"SABANG SUBIK, BALANIPA, POLEWALI MANDAR, SULAWESI BARAT",5,113,110,223
https://kawalpemilu.org#76008,"SABANG SUBIK, BALANIPA, POLEWALI MANDAR, SULAWESI BARAT",6,131,107,238
https://kawalpemilu.org#76008,"SABANG SUBIK, BALANIPA, POLEWALI MANDAR, SULAWESI BARAT",7,112,114,226
https://kawalpemilu.org#76008,"SABANG SUBIK, BALANIPA, POLEWALI MANDAR, SULAWESI BARAT",8,146,90,236
https://kawalpemilu.org#76009,"PAMBUSUANG, BALANIPA, POLEWALI MANDAR, SULAWESI BARAT",1,155,71,226
https://kawalpemilu.org#76009,"PAMBUSUANG, BALANIPA, POLEWALI MANDAR, SULAWESI BARAT",2,119,97,216
https://kawalpemilu.org#76009,"PAMBUSUANG, BALANIPA, POLEWALI MANDAR, SULAWESI BARAT",3,122,60,182
https://kawalpemilu.org#76009,"PAMBUSUANG, BALANIPA, POLEWALI MANDAR, SULAWESI BARAT",4,127,94,221
https://kawalpemilu.org#76009,"PAMBUSUANG, BALANIPA, POLEWALI MANDAR, SULAWESI BARAT",5,133,82,215
https://kawalpemilu.org#76009,"PAMBUSUANG, BALANIPA, POLEWALI MANDAR, SULAWESI BARAT",6,143,71,214
https://kawalpemilu.org#76009,"PAMBUSUANG, BALANIPA, POLEWALI MANDAR, SULAWESI BARAT",7,143,82,225
https://kawalpemilu.org#76009,"PAMBUSUANG, BALANIPA, POLEWALI MANDAR, SULAWESI BARAT",8,141,86,227
https://kawalpemilu.org#76009,"PAMBUSUANG, BALANIPA, POLEWALI MANDAR, SULAWESI BARAT",9,119,84,203
https://kawalpemilu.org#76009,"PAMBUSUANG, BALANIPA, POLEWALI MANDAR, SULAWESI BARAT",10,157,80,237
https://kawalpemilu.org#76009,"PAMBUSUANG, BALANIPA, POLEWALI MANDAR, SULAWESI BARAT",11,106,73,179
https://kawalpemilu.org#76009,"PAMBUSUANG, BALANIPA, POLEWALI MANDAR, SULAWESI BARAT",12,148,68,216
https://kawalpemilu.org#76009,"PAMBUSUANG, BALANIPA, POLEWALI MANDAR, SULAWESI BARAT",13,109,90,199
https://kawalpemilu.org#76009,"PAMBUSUANG, BALANIPA, POLEWALI MANDAR, SULAWESI BARAT",14,122,99,221
https://kawalpemilu.org#76009,"PAMBUSUANG, BALANIPA, POLEWALI MANDAR, SULAWESI BARAT",15,120,97,217
https://kawalpemilu.org#76010,"BALA, BALANIPA, POLEWALI MANDAR, SULAWESI BARAT",1,88,115,203
https://kawalpemilu.org#76010,"BALA, BALANIPA, POLEWALI MANDAR, SULAWESI BARAT",2,89,94,183
https://kawalpemilu.org#76010,"BALA, BALANIPA, POLEWALI MANDAR, SULAWESI BARAT",3,79,115,194
https://kawalpemilu.org#76010,"BALA, BALANIPA, POLEWALI MANDAR, SULAWESI BARAT",4,73,134,207
https://kawalpemilu.org#76010,"BALA, BALANIPA, POLEWALI MANDAR, SULAWESI BARAT",5,97,74,171
https://kawalpemilu.org#76010,"BALA, BALANIPA, POLEWALI MANDAR, SULAWESI BARAT",6,125,80,205
https://kawalpemilu.org#76010,"BALA, BALANIPA, POLEWALI MANDAR, SULAWESI BARAT",7,89,110,199
https://kawalpemilu.org#76010,"BALA, BALANIPA, POLEWALI MANDAR, SULAWESI BARAT",8,63,105,168
https://kawalpemilu.org#76010,"BALA, BALANIPA, POLEWALI MANDAR, SULAWESI BARAT",9,76,99,175
https://kawalpemilu.org#76010,"BALA, BALANIPA, POLEWALI MANDAR, SULAWESI BARAT",10,109,80,189
https://kawalpemilu.org#76010,"BALA, BALANIPA, POLEWALI MANDAR, SULAWESI BARAT",11,108,98,206
https://kawalpemilu.org#76010,"BALA, BALANIPA, POLEWALI MANDAR, SULAWESI BARAT",12,108,86,194
https://kawalpemilu.org#76011,"LAMBANAN, BALANIPA, POLEWALI MANDAR, SULAWESI BARAT",1,108,107,215
https://kawalpemilu.org#76011,"LAMBANAN, BALANIPA, POLEWALI MANDAR, SULAWESI BARAT",2,110,57,167
https://kawalpemilu.org#76012,"LEGO, BALANIPA, POLEWALI MANDAR, SULAWESI BARAT",1,67,47,114
https://kawalpemilu.org#76012,"LEGO, BALANIPA, POLEWALI MANDAR, SULAWESI BARAT",2,147,54,201
https://kawalpemilu.org#76012,"LEGO, BALANIPA, POLEWALI MANDAR, SULAWESI BARAT",3,164,34,198
https://kawalpemilu.org#76012,"LEGO, BALANIPA, POLEWALI MANDAR, SULAWESI BARAT",4,123,37,160
https://kawalpemilu.org#76013,"PALLIS, BALANIPA, POLEWALI MANDAR, SULAWESI BARAT",1,52,59,111
https://kawalpemilu.org#76013,"PALLIS, BALANIPA, POLEWALI MANDAR, SULAWESI BARAT",2,102,52,154
https://kawalpemilu.org#76013,"PALLIS, BALANIPA, POLEWALI MANDAR, SULAWESI BARAT",3,77,19,96
https://kawalpemilu.org#76015,"ANREAPI, ANREAPI, POLEWALI MANDAR, SULAWESI BARAT",1,110,80,190
https://kawalpemilu.org#76015,"ANREAPI, ANREAPI, POLEWALI MANDAR, SULAWESI BARAT",2,95,96,191
https://kawalpemilu.org#76015,"ANREAPI, ANREAPI, POLEWALI MANDAR, SULAWESI BARAT",3,98,91,198
https://kawalpemilu.org#76015,"ANREAPI, ANREAPI, POLEWALI MANDAR, SULAWESI BARAT",4,89,104,193
https://kawalpemilu.org#76015,"ANREAPI, ANREAPI, POLEWALI MANDAR, SULAWESI BARAT",5,52,92,144
https://kawalpemilu.org#76016,"DUAMPANUA, ANREAPI, POLEWALI MANDAR, SULAWESI BARAT",1,108,125,233
https://kawalpemilu.org#76016,"DUAMPANUA, ANREAPI, POLEWALI MANDAR, SULAWESI BARAT",2,80,141,221
https://kawalpemilu.org#76016,"DUAMPANUA, ANREAPI, POLEWALI MANDAR, SULAWESI BARAT",3,86,72,158
https://kawalpemilu.org#76016,"DUAMPANUA, ANREAPI, POLEWALI MANDAR, SULAWESI BARAT",4,125,47,181
https://kawalpemilu.org#76016,"DUAMPANUA, ANREAPI, POLEWALI MANDAR, SULAWESI BARAT",5,121,100,221
https://kawalpemilu.org#76016,"DUAMPANUA, ANREAPI, POLEWALI MANDAR, SULAWESI BARAT",6,157,74,231
https://kawalpemilu.org#76016,"DUAMPANUA, ANREAPI, POLEWALI MANDAR, SULAWESI BARAT",7,110,102,212
https://kawalpemilu.org#76016,"DUAMPANUA, ANREAPI, POLEWALI MANDAR, SULAWESI BARAT",8,107,133,240
https://kawalpemilu.org#76016,"DUAMPANUA, ANREAPI, POLEWALI MANDAR, SULAWESI BARAT",9,135,66,201
https://kawalpemilu.org#76017,"KELAPA DUA, ANREAPI, POLEWALI MANDAR, SULAWESI BARAT",1,84,55,139
https://kawalpemilu.org#76017,"KELAPA DUA, ANREAPI, POLEWALI MANDAR, SULAWESI BARAT",2,90,55,145
https://kawalpemilu.org#76017,"KELAPA DUA, ANREAPI, POLEWALI MANDAR, SULAWESI BARAT",3,159,70,229
https://kawalpemilu.org#76017,"KELAPA DUA, ANREAPI, POLEWALI MANDAR, SULAWESI BARAT",4,132,79,211
https://kawalpemilu.org#76017,"KELAPA DUA, ANREAPI, POLEWALI MANDAR, SULAWESI BARAT",5,100,75,175
https://kawalpemilu.org#76017,"KELAPA DUA, ANREAPI, POLEWALI MANDAR, SULAWESI BARAT",6,55,51,106
https://kawalpemilu.org#76017,"KELAPA DUA, ANREAPI, POLEWALI MANDAR, SULAWESI BARAT",7,83,39,122
https://kawalpemilu.org#76017,"KELAPA DUA, ANREAPI, POLEWALI MANDAR, SULAWESI BARAT",8,72,17,89
https://kawalpemilu.org#76018,"PAPANDANGAN, ANREAPI, POLEWALI MANDAR, SULAWESI BARAT",1,122,52,174
https://kawalpemilu.org#76018,"PAPANDANGAN, ANREAPI, POLEWALI MANDAR, SULAWESI BARAT",2,154,68,222
https://kawalpemilu.org#76018,"PAPANDANGAN, ANREAPI, POLEWALI MANDAR, SULAWESI BARAT",3,162,55,217
https://kawalpemilu.org#76018,"PAPANDANGAN, ANREAPI, POLEWALI MANDAR, SULAWESI BARAT",4,155,52,207
https://kawalpemilu.org#76018,"PAPANDANGAN, ANREAPI, POLEWALI MANDAR, SULAWESI BARAT",5,68,20,88
https://kawalpemilu.org#76019,"KUNYI, ANREAPI, POLEWALI MANDAR, SULAWESI BARAT",1,129,75,204
https://kawalpemilu.org#76019,"KUNYI, ANREAPI, POLEWALI MANDAR, SULAWESI BARAT",2,58,41,99
https://kawalpemilu.org#76019,"KUNYI, ANREAPI, POLEWALI MANDAR, SULAWESI BARAT",3,121,28,149
https://kawalpemilu.org#76019,"KUNYI, ANREAPI, POLEWALI MANDAR, SULAWESI BARAT",4,142,12,154
https://kawalpemilu.org#76019,"KUNYI, ANREAPI, POLEWALI MANDAR, SULAWESI BARAT",5,66,36,102
https://kawalpemilu.org#76019,"KUNYI, ANREAPI, POLEWALI MANDAR, SULAWESI BARAT",6,87,46,133
https://kawalpemilu.org#76019,"KUNYI, ANREAPI, POLEWALI MANDAR, SULAWESI BARAT",7,72,23,95
https://kawalpemilu.org#76021,"MATAKALI, MATAKALI, POLEWALI MANDAR, SULAWESI BARAT",1,86,124,210
https://kawalpemilu.org#76021,"MATAKALI, MATAKALI, POLEWALI MANDAR, SULAWESI BARAT",2,108,111,219
https://kawalpemilu.org#76021,"MATAKALI, MATAKALI, POLEWALI MANDAR, SULAWESI BARAT",3,123,118,241
https://kawalpemilu.org#76021,"MATAKALI, MATAKALI, POLEWALI MANDAR, SULAWESI BARAT",4,109,110,219
https://kawalpemilu.org#76021,"MATAKALI, MATAKALI, POLEWALI MANDAR, SULAWESI BARAT",5,132,93,225
https://kawalpemilu.org#76021,"MATAKALI, MATAKALI, POLEWALI MANDAR, SULAWESI BARAT",6,115,134,249
https://kawalpemilu.org#76021,"MATAKALI, MATAKALI, POLEWALI MANDAR, SULAWESI BARAT",7,101,152,253
https://kawalpemilu.org#76021,"MATAKALI, MATAKALI, POLEWALI MANDAR, SULAWESI BARAT",8,105,89,194
https://kawalpemilu.org#76021,"MATAKALI, MATAKALI, POLEWALI MANDAR, SULAWESI BARAT",9,141,94,235
https://kawalpemilu.org#76021,"MATAKALI, MATAKALI, POLEWALI MANDAR, SULAWESI BARAT",10,118,103,221
https://kawalpemilu.org#76022,"PETAMPANUA, MATAKALI, POLEWALI MANDAR, SULAWESI BARAT",1,125,134,259
https://kawalpemilu.org#76022,"PETAMPANUA, MATAKALI, POLEWALI MANDAR, SULAWESI BARAT",2,99,157,256
https://kawalpemilu.org#76022,"PETAMPANUA, MATAKALI, POLEWALI MANDAR, SULAWESI BARAT",3,110,134,244
https://kawalpemilu.org#76022,"PETAMPANUA, MATAKALI, POLEWALI MANDAR, SULAWESI BARAT",4,140,108,248
https://kawalpemilu.org#76022,"PETAMPANUA, MATAKALI, POLEWALI MANDAR, SULAWESI BARAT",5,136,100,236
https://kawalpemilu.org#76022,"PETAMPANUA, MATAKALI, POLEWALI MANDAR, SULAWESI BARAT",7,136,108,244
https://kawalpemilu.org#76022,"PETAMPANUA, MATAKALI, POLEWALI MANDAR, SULAWESI BARAT",8,128,118,246
https://kawalpemilu.org#76022,"PETAMPANUA, MATAKALI, POLEWALI MANDAR, SULAWESI BARAT",9,128,168,296
https://kawalpemilu.org#76022,"PETAMPANUA, MATAKALI, POLEWALI MANDAR, SULAWESI BARAT",10,123,89,212
https://kawalpemilu.org#76022,"PETAMPANUA, MATAKALI, POLEWALI MANDAR, SULAWESI BARAT",11,88,150,238
https://kawalpemilu.org#76022,"PETAMPANUA, MATAKALI, POLEWALI MANDAR, SULAWESI BARAT",12,94,141,235
https://kawalpemilu.org#76022,"PETAMPANUA, MATAKALI, POLEWALI MANDAR, SULAWESI BARAT",13,104,142,246
https://kawalpemilu.org#76022,"PETAMPANUA, MATAKALI, POLEWALI MANDAR, SULAWESI BARAT",14,98,46,144
https://kawalpemilu.org#76023,"BARUMBUNG, MATAKALI, POLEWALI MANDAR, SULAWESI BARAT",1,111,116,227
https://kawalpemilu.org#76023,"BARUMBUNG, MATAKALI, POLEWALI MANDAR, SULAWESI BARAT",2,91,134,225
https://kawalpemilu.org#76023,"BARUMBUNG, MATAKALI, POLEWALI MANDAR, SULAWESI BARAT",3,89,92,181
https://kawalpemilu.org#76023,"BARUMBUNG, MATAKALI, POLEWALI MANDAR, SULAWESI BARAT",4,72,118,190
https://kawalpemilu.org#76023,"BARUMBUNG, MATAKALI, POLEWALI MANDAR, SULAWESI BARAT",5,55,123,178
https://kawalpemilu.org#76023,"BARUMBUNG, MATAKALI, POLEWALI MANDAR, SULAWESI BARAT",6,53,141,194
https://kawalpemilu.org#76023,"BARUMBUNG, MATAKALI, POLEWALI MANDAR, SULAWESI BARAT",7,69,120,189
https://kawalpemilu.org#76024,"PASIANG, MATAKALI, POLEWALI MANDAR, SULAWESI BARAT",1,132,80,212
https://kawalpemilu.org#76024,"PASIANG, MATAKALI, POLEWALI MANDAR, SULAWESI BARAT",2,118,105,223
https://kawalpemilu.org#76024,"PASIANG, MATAKALI, POLEWALI MANDAR, SULAWESI BARAT",3,96,125,221
https://kawalpemilu.org#76024,"PASIANG, MATAKALI, POLEWALI MANDAR, SULAWESI BARAT",4,144,98,242
https://kawalpemilu.org#76024,"PASIANG, MATAKALI, POLEWALI MANDAR, SULAWESI BARAT",5,94,148,242
https://kawalpemilu.org#76024,"PASIANG, MATAKALI, POLEWALI MANDAR, SULAWESI BARAT",6,82,149,231
https://kawalpemilu.org#76024,"PASIANG, MATAKALI, POLEWALI MANDAR, SULAWESI BARAT",7,124,93,217
https://kawalpemilu.org#76024,"PASIANG, MATAKALI, POLEWALI MANDAR, SULAWESI BARAT",8,192,8,200
https://kawalpemilu.org#76024,"PASIANG, MATAKALI, POLEWALI MANDAR, SULAWESI BARAT",9,120,83,203
https://kawalpemilu.org#76024,"PASIANG, MATAKALI, POLEWALI MANDAR, SULAWESI BARAT",10,122,93,215
https://kawalpemilu.org#76024,"PASIANG, MATAKALI, POLEWALI MANDAR, SULAWESI BARAT",11,158,97,255
https://kawalpemilu.org#76025,"TONROLIMA, MATAKALI, POLEWALI MANDAR, SULAWESI BARAT",1,100,128,228
https://kawalpemilu.org#76025,"TONROLIMA, MATAKALI, POLEWALI MANDAR, SULAWESI BARAT",2,101,124,225
https://kawalpemilu.org#76025,"TONROLIMA, MATAKALI, POLEWALI MANDAR, SULAWESI BARAT",3,121,84,205
https://kawalpemilu.org#76025,"TONROLIMA, MATAKALI, POLEWALI MANDAR, SULAWESI BARAT",4,111,59,170
https://kawalpemilu.org#76025,"TONROLIMA, MATAKALI, POLEWALI MANDAR, SULAWESI BARAT",5,169,25,194
https://kawalpemilu.org#76025,"TONROLIMA, MATAKALI, POLEWALI MANDAR, SULAWESI BARAT",6,168,41,209
https://kawalpemilu.org#76025,"TONROLIMA, MATAKALI, POLEWALI MANDAR, SULAWESI BARAT",7,108,65,173
https://kawalpemilu.org#76025,"TONROLIMA, MATAKALI, POLEWALI MANDAR, SULAWESI BARAT",8,90,106,196
https://kawalpemilu.org#76026,"INDOMAKKOMBONG, MATAKALI, POLEWALI MANDAR, SULAWESI BARAT",1,100,114,214
https://kawalpemilu.org#76026,"INDOMAKKOMBONG, MATAKALI, POLEWALI MANDAR, SULAWESI BARAT",2,48,115,163
https://kawalpemilu.org#76026,"INDOMAKKOMBONG, MATAKALI, POLEWALI MANDAR, SULAWESI BARAT",3,181,26,207
https://kawalpemilu.org#76026,"INDOMAKKOMBONG, MATAKALI, POLEWALI MANDAR, SULAWESI BARAT",4,102,76,178
https://kawalpemilu.org#76026,"INDOMAKKOMBONG, MATAKALI, POLEWALI MANDAR, SULAWESI BARAT",5,133,61,194
https://kawalpemilu.org#76026,"INDOMAKKOMBONG, MATAKALI, POLEWALI MANDAR, SULAWESI BARAT",6,107,84,191
https://kawalpemilu.org#76026,"INDOMAKKOMBONG, MATAKALI, POLEWALI MANDAR, SULAWESI BARAT",7,126,80,206
https://kawalpemilu.org#76026,"INDOMAKKOMBONG, MATAKALI, POLEWALI MANDAR, SULAWESI BARAT",8,141,49,190
https://kawalpemilu.org#76026,"INDOMAKKOMBONG, MATAKALI, POLEWALI MANDAR, SULAWESI BARAT",9,174,37,211
https://kawalpemilu.org#76026,"INDOMAKKOMBONG, MATAKALI, POLEWALI MANDAR, SULAWESI BARAT",10,52,103,155
https://kawalpemilu.org#76026,"INDOMAKKOMBONG, MATAKALI, POLEWALI MANDAR, SULAWESI BARAT",11,79,68,147
https://kawalpemilu.org#76027,"BUNGA-BUNGA, MATAKALI, POLEWALI MANDAR, SULAWESI BARAT",1,116,92,208
https://kawalpemilu.org#76027,"BUNGA-BUNGA, MATAKALI, POLEWALI MANDAR, SULAWESI BARAT",2,131,53,184
https://kawalpemilu.org#76027,"BUNGA-BUNGA, MATAKALI, POLEWALI MANDAR, SULAWESI BARAT",3,103,87,190
https://kawalpemilu.org#76027,"BUNGA-BUNGA, MATAKALI, POLEWALI MANDAR, SULAWESI BARAT",4,131,66,197
https://kawalpemilu.org#76029,"ALU, ALLU, POLEWALI MANDAR, SULAWESI BARAT",1,107,59,166
https://kawalpemilu.org#76029,"ALU, ALLU, POLEWALI MANDAR, SULAWESI BARAT",2,95,76,171
https://kawalpemilu.org#76029,"ALU, ALLU, POLEWALI MANDAR, SULAWESI BARAT",3,81,83,164
https://kawalpemilu.org#76029,"ALU, ALLU, POLEWALI MANDAR, SULAWESI BARAT",4,77,89,166
https://kawalpemilu.org#76029,"ALU, ALLU, POLEWALI MANDAR, SULAWESI BARAT",5,91,87,178
https://kawalpemilu.org#76029,"ALU, ALLU, POLEWALI MANDAR, SULAWESI BARAT",6,107,49,156
https://kawalpemilu.org#76030,"PETOOSANG, ALLU, POLEWALI MANDAR, SULAWESI BARAT",1,101,103,204
https://kawalpemilu.org#76030,"PETOOSANG, ALLU, POLEWALI MANDAR, SULAWESI BARAT",2,71,126,197
https://kawalpemilu.org#76030,"PETOOSANG, ALLU, POLEWALI MANDAR, SULAWESI BARAT",3,91,130,221
https://kawalpemilu.org#76030,"PETOOSANG, ALLU, POLEWALI MANDAR, SULAWESI BARAT",4,83,110,193
https://kawalpemilu.org#76030,"PETOOSANG, ALLU, POLEWALI MANDAR, SULAWESI BARAT",5,17,53,70
https://kawalpemilu.org#76030,"PETOOSANG, ALLU, POLEWALI MANDAR, SULAWESI BARAT",6,88,44,132
https://kawalpemilu.org#76031,"MOMBI, ALLU, POLEWALI MANDAR, SULAWESI BARAT",1,82,137,219
https://kawalpemilu.org#76031,"MOMBI, ALLU, POLEWALI MANDAR, SULAWESI BARAT",2,107,129,236
https://kawalpemilu.org#76031,"MOMBI, ALLU, POLEWALI MANDAR, SULAWESI BARAT",3,115,112,227
https://kawalpemilu.org#76031,"MOMBI, ALLU, POLEWALI MANDAR, SULAWESI BARAT",4,121,87,208
https://kawalpemilu.org#76031,"MOMBI, ALLU, POLEWALI MANDAR, SULAWESI BARAT",5,62,168,230
https://kawalpemilu.org#76031,"MOMBI, ALLU, POLEWALI MANDAR, SULAWESI BARAT",6,108,121,229
https://kawalpemilu.org#76032,"KALUMAMMANG, ALLU, POLEWALI MANDAR, SULAWESI BARAT",1,127,54,181
https://kawalpemilu.org#76032,"KALUMAMMANG, ALLU, POLEWALI MANDAR, SULAWESI BARAT",2,95,72,167
https://kawalpemilu.org#76032,"KALUMAMMANG, ALLU, POLEWALI MANDAR, SULAWESI BARAT",3,128,30,158
https://kawalpemilu.org#76032,"KALUMAMMANG, ALLU, POLEWALI MANDAR, SULAWESI BARAT",4,156,62,218
https://kawalpemilu.org#76033,"PAO-PAO, ALLU, POLEWALI MANDAR, SULAWESI BARAT",1,69,22,91
https://kawalpemilu.org#76033,"PAO-PAO, ALLU, POLEWALI MANDAR, SULAWESI BARAT",2,148,46,194
https://kawalpemilu.org#76033,"PAO-PAO, ALLU, POLEWALI MANDAR, SULAWESI BARAT",3,156,48,204
https://kawalpemilu.org#76033,"PAO-PAO, ALLU, POLEWALI MANDAR, SULAWESI BARAT",4,141,63,204
https://kawalpemilu.org#76033,"PAO-PAO, ALLU, POLEWALI MANDAR, SULAWESI BARAT",5,88,57,145
https://kawalpemilu.org#76033,"PAO-PAO, ALLU, POLEWALI MANDAR, SULAWESI BARAT",6,161,66,227
https://kawalpemilu.org#76033,"PAO-PAO, ALLU, POLEWALI MANDAR, SULAWESI BARAT",7,114,37,151
https://kawalpemilu.org#76034,"PUPPU URING, ALLU, POLEWALI MANDAR, SULAWESI BARAT",1,171,23,194
https://kawalpemilu.org#76034,"PUPPU URING, ALLU, POLEWALI MANDAR, SULAWESI BARAT",2,182,24,206
https://kawalpemilu.org#76034,"PUPPU URING, ALLU, POLEWALI MANDAR, SULAWESI BARAT",3,71,21,92
https://kawalpemilu.org#76034,"PUPPU URING, ALLU, POLEWALI MANDAR, SULAWESI BARAT",4,88,16,104
https://kawalpemilu.org#76034,"PUPPU URING, ALLU, POLEWALI MANDAR, SULAWESI BARAT",5,114,28,142
https://kawalpemilu.org#76034,"PUPPU URING, ALLU, POLEWALI MANDAR, SULAWESI BARAT",6,96,26,122
https://kawalpemilu.org#76035,"SARAGIAN, ALLU, POLEWALI MANDAR, SULAWESI BARAT",1,100,79,191
https://kawalpemilu.org#76035,"SARAGIAN, ALLU, POLEWALI MANDAR, SULAWESI BARAT",2,113,99,212
https://kawalpemilu.org#76035,"SARAGIAN, ALLU, POLEWALI MANDAR, SULAWESI BARAT",3,106,91,197
https://kawalpemilu.org#76035,"SARAGIAN, ALLU, POLEWALI MANDAR, SULAWESI BARAT",4,83,36,119
https://kawalpemilu.org#76035,"SARAGIAN, ALLU, POLEWALI MANDAR, SULAWESI BARAT",5,76,116,192
https://kawalpemilu.org#76036,"SAYOANG, ALLU, POLEWALI MANDAR, SULAWESI BARAT",1,124,61,185
https://kawalpemilu.org#76036,"SAYOANG, ALLU, POLEWALI MANDAR, SULAWESI BARAT",2,66,16,82
https://kawalpemilu.org#76036,"SAYOANG, ALLU, POLEWALI MANDAR, SULAWESI BARAT",3,54,15,69
https://kawalpemilu.org#76038,"BULO, BULO, POLEWALI MANDAR, SULAWESI BARAT",1,148,74,222
https://kawalpemilu.org#76038,"BULO, BULO, POLEWALI MANDAR, SULAWESI BARAT",2,160,45,205
https://kawalpemilu.org#76038,"BULO, BULO, POLEWALI MANDAR, SULAWESI BARAT",3,98,66,164
https://kawalpemilu.org#76039,"PULLIWA, BULO, POLEWALI MANDAR, SULAWESI BARAT",1,67,76,143
https://kawalpemilu.org#76039,"PULLIWA, BULO, POLEWALI MANDAR, SULAWESI BARAT",2,98,126,224
https://kawalpemilu.org#76039,"PULLIWA, BULO, POLEWALI MANDAR, SULAWESI BARAT",3,142,101,243
https://kawalpemilu.org#76039,"PULLIWA, BULO, POLEWALI MANDAR, SULAWESI BARAT",4,114,103,217
https://kawalpemilu.org#76039,"PULLIWA, BULO, POLEWALI MANDAR, SULAWESI BARAT",5,91,52,143
https://kawalpemilu.org#76039,"PULLIWA, BULO, POLEWALI MANDAR, SULAWESI BARAT",6,91,53,144
https://kawalpemilu.org#76039,"PULLIWA, BULO, POLEWALI MANDAR, SULAWESI BARAT",7,131,62,193
https://kawalpemilu.org#76039,"PULLIWA, BULO, POLEWALI MANDAR, SULAWESI BARAT",8,96,118,214
https://kawalpemilu.org#76040,"PATAMBANUA, BULO, POLEWALI MANDAR, SULAWESI BARAT",1,100,40,140
https://kawalpemilu.org#76040,"PATAMBANUA, BULO, POLEWALI MANDAR, SULAWESI BARAT",2,79,42,121
https://kawalpemilu.org#76040,"PATAMBANUA, BULO, POLEWALI MANDAR, SULAWESI BARAT",3,96,62,158
https://kawalpemilu.org#76040,"PATAMBANUA, BULO, POLEWALI MANDAR, SULAWESI BARAT",4,82,43,125
https://kawalpemilu.org#76041,"KAROMBANG, BULO, POLEWALI MANDAR, SULAWESI BARAT",1,200,50,250
https://kawalpemilu.org#76041,"KAROMBANG, BULO, POLEWALI MANDAR, SULAWESI BARAT",2,106,107,213
https://kawalpemilu.org#76041,"KAROMBANG, BULO, POLEWALI MANDAR, SULAWESI BARAT",3,176,56,232
https://kawalpemilu.org#76042,"DAALA TIMUR, BULO, POLEWALI MANDAR, SULAWESI BARAT",1,143,37,180
https://kawalpemilu.org#76042,"DAALA TIMUR, BULO, POLEWALI MANDAR, SULAWESI BARAT",2,129,54,183
https://kawalpemilu.org#76042,"DAALA TIMUR, BULO, POLEWALI MANDAR, SULAWESI BARAT",3,115,31,146
https://kawalpemilu.org#76043,"LENGGO, BULO, POLEWALI MANDAR, SULAWESI BARAT",1,67,124,191
https://kawalpemilu.org#76043,"LENGGO, BULO, POLEWALI MANDAR, SULAWESI BARAT",2,80,34,114
https://kawalpemilu.org#76043,"LENGGO, BULO, POLEWALI MANDAR, SULAWESI BARAT",3,71,45,116
https://kawalpemilu.org#76043,"LENGGO, BULO, POLEWALI MANDAR, SULAWESI BARAT",5,78,18,96
https://kawalpemilu.org#76043,"LENGGO, BULO, POLEWALI MANDAR, SULAWESI BARAT",6,40,68,108
https://kawalpemilu.org#76044,"SABURA, BULO, POLEWALI MANDAR, SULAWESI BARAT",1,160,31,191
https://kawalpemilu.org#76044,"SABURA, BULO, POLEWALI MANDAR, SULAWESI BARAT",2,71,37,108
https://kawalpemilu.org#76045,"SEPPORRAKI, BULO, POLEWALI MANDAR, SULAWESI BARAT",1,109,78,187
https://kawalpemilu.org#76045,"SEPPORRAKI, BULO, POLEWALI MANDAR, SULAWESI BARAT",2,154,67,221
https://kawalpemilu.org#76046,"IHING, BULO, POLEWALI MANDAR, SULAWESI BARAT",1,149,29,178
https://kawalpemilu.org#76046,"IHING, BULO, POLEWALI MANDAR, SULAWESI BARAT",2,120,63,183
https://kawalpemilu.org#76046,"IHING, BULO, POLEWALI MANDAR, SULAWESI BARAT",3,128,42,170
https://kawalpemilu.org#76049,"BANGGAE, BANGGAE, MAJENE, SULAWESI BARAT",1,64,59,123
https://kawalpemilu.org#76049,"BANGGAE, BANGGAE, MAJENE, SULAWESI BARAT",2,66,55,121
https://kawalpemilu.org#76049,"BANGGAE, BANGGAE, MAJENE, SULAWESI BARAT",3,93,92,185
https://kawalpemilu.org#76049,"BANGGAE, BANGGAE, MAJENE, SULAWESI BARAT",4,68,104,172
https://kawalpemilu.org#76049,"BANGGAE, BANGGAE, MAJENE, SULAWESI BARAT",5,81,120,201
https://kawalpemilu.org#76049,"BANGGAE, BANGGAE, MAJENE, SULAWESI BARAT",6,66,115,181
https://kawalpemilu.org#76049,"BANGGAE, BANGGAE, MAJENE, SULAWESI BARAT",7,71,127,198
https://kawalpemilu.org#76049,"BANGGAE, BANGGAE, MAJENE, SULAWESI BARAT",8,86,117,203
https://kawalpemilu.org#76049,"BANGGAE, BANGGAE, MAJENE, SULAWESI BARAT",9,108,155,263
https://kawalpemilu.org#76049,"BANGGAE, BANGGAE, MAJENE, SULAWESI BARAT",10,92,122,214
https://kawalpemilu.org#76049,"BANGGAE, BANGGAE, MAJENE, SULAWESI BARAT",11,88,119,207
https://kawalpemilu.org#76049,"BANGGAE, BANGGAE, MAJENE, SULAWESI BARAT",12,92,126,219
https://kawalpemilu.org#76049,"BANGGAE, BANGGAE, MAJENE, SULAWESI BARAT",13,106,96,202
https://kawalpemilu.org#76049,"BANGGAE, BANGGAE, MAJENE, SULAWESI BARAT",14,134,89,223
https://kawalpemilu.org#76049,"BANGGAE, BANGGAE, MAJENE, SULAWESI BARAT",15,98,116,214
https://kawalpemilu.org#76049,"BANGGAE, BANGGAE, MAJENE, SULAWESI BARAT",16,98,110,208
https://kawalpemilu.org#76049,"BANGGAE, BANGGAE, MAJENE, SULAWESI BARAT",17,97,81,178
https://kawalpemilu.org#76049,"BANGGAE, BANGGAE, MAJENE, SULAWESI BARAT",18,131,78,209
https://kawalpemilu.org#76049,"BANGGAE, BANGGAE, MAJENE, SULAWESI BARAT",19,109,97,206
https://kawalpemilu.org#76050,"BARU, BANGGAE, MAJENE, SULAWESI BARAT",1,121,75,196
https://kawalpemilu.org#76050,"BARU, BANGGAE, MAJENE, SULAWESI BARAT",2,72,63,135
https://kawalpemilu.org#76050,"BARU, BANGGAE, MAJENE, SULAWESI BARAT",3,114,106,220
https://kawalpemilu.org#76050,"BARU, BANGGAE, MAJENE, SULAWESI BARAT",4,81,88,169
https://kawalpemilu.org#76050,"BARU, BANGGAE, MAJENE, SULAWESI BARAT",5,117,100,217
https://kawalpemilu.org#76050,"BARU, BANGGAE, MAJENE, SULAWESI BARAT",6,176,43,219
https://kawalpemilu.org#76050,"BARU, BANGGAE, MAJENE, SULAWESI BARAT",7,77,161,238
https://kawalpemilu.org#76050,"BARU, BANGGAE, MAJENE, SULAWESI BARAT",8,130,81,211
https://kawalpemilu.org#76050,"BARU, BANGGAE, MAJENE, SULAWESI BARAT",9,107,98,205
https://kawalpemilu.org#76050,"BARU, BANGGAE, MAJENE, SULAWESI BARAT",10,131,108,239
https://kawalpemilu.org#76050,"BARU, BANGGAE, MAJENE, SULAWESI BARAT",11,115,42,157
https://kawalpemilu.org#76050,"BARU, BANGGAE, MAJENE, SULAWESI BARAT",13,190,41,231
https://kawalpemilu.org#76050,"BARU, BANGGAE, MAJENE, SULAWESI BARAT",14,191,53,244
https://kawalpemilu.org#76050,"BARU, BANGGAE, MAJENE, SULAWESI BARAT",15,187,47,234
https://kawalpemilu.org#76051,"PANGALI ALI, BANGGAE, MAJENE, SULAWESI BARAT",1,76,182,258
https://kawalpemilu.org#76051,"PANGALI ALI, BANGGAE, MAJENE, SULAWESI BARAT",2,88,95,183
https://kawalpemilu.org#76051,"PANGALI ALI, BANGGAE, MAJENE, SULAWESI BARAT",3,92,78,170
https://kawalpemilu.org#76051,"PANGALI ALI, BANGGAE, MAJENE, SULAWESI BARAT",4,139,79,218
https://kawalpemilu.org#76051,"PANGALI ALI, BANGGAE, MAJENE, SULAWESI BARAT",5,125,93,8
https://kawalpemilu.org#76051,"PANGALI ALI, BANGGAE, MAJENE, SULAWESI BARAT",6,84,61,145
https://kawalpemilu.org#76051,"PANGALI ALI, BANGGAE, MAJENE, SULAWESI BARAT",8,96,71,167
https://kawalpemilu.org#76051,"PANGALI ALI, BANGGAE, MAJENE, SULAWESI BARAT",9,58,72,130
https://kawalpemilu.org#76051,"PANGALI ALI, BANGGAE, MAJENE, SULAWESI BARAT",10,135,69,204
https://kawalpemilu.org#76051,"PANGALI ALI, BANGGAE, MAJENE, SULAWESI BARAT",11,85,64,149
https://kawalpemilu.org#76051,"PANGALI ALI, BANGGAE, MAJENE, SULAWESI BARAT",12,117,77,194
https://kawalpemilu.org#76051,"PANGALI ALI, BANGGAE, MAJENE, SULAWESI BARAT",13,111,84,195
https://kawalpemilu.org#76051,"PANGALI ALI, BANGGAE, MAJENE, SULAWESI BARAT",14,112,71,183
https://kawalpemilu.org#76051,"PANGALI ALI, BANGGAE, MAJENE, SULAWESI BARAT",15,90,60,150
https://kawalpemilu.org#76051,"PANGALI ALI, BANGGAE, MAJENE, SULAWESI BARAT",16,87,83,170
https://kawalpemilu.org#76051,"PANGALI ALI, BANGGAE, MAJENE, SULAWESI BARAT",17,113,105,218
https://kawalpemilu.org#76051,"PANGALI ALI, BANGGAE, MAJENE, SULAWESI BARAT",18,109,55,164
https://kawalpemilu.org#76051,"PANGALI ALI, BANGGAE, MAJENE, SULAWESI BARAT",19,94,47,141
https://kawalpemilu.org#76051,"PANGALI ALI, BANGGAE, MAJENE, SULAWESI BARAT",20,167,30,197
https://kawalpemilu.org#76051,"PANGALI ALI, BANGGAE, MAJENE, SULAWESI BARAT",21,129,35,164
https://kawalpemilu.org#76051,"PANGALI ALI, BANGGAE, MAJENE, SULAWESI BARAT",22,175,39,214
https://kawalpemilu.org#76051,"PANGALI ALI, BANGGAE, MAJENE, SULAWESI BARAT",23,160,81,241
https://kawalpemilu.org#76051,"PANGALI ALI, BANGGAE, MAJENE, SULAWESI BARAT",24,128,45,173
https://kawalpemilu.org#76051,"PANGALI ALI, BANGGAE, MAJENE, SULAWESI BARAT",25,89,83,172
https://kawalpemilu.org#76051,"PANGALI ALI, BANGGAE, MAJENE, SULAWESI BARAT",26,74,78,152
https://kawalpemilu.org#76051,"PANGALI ALI, BANGGAE, MAJENE, SULAWESI BARAT",27,114,129,243
https://kawalpemilu.org#76051,"PANGALI ALI, BANGGAE, MAJENE, SULAWESI BARAT",28,95,156,251
https://kawalpemilu.org#76051,"PANGALI ALI, BANGGAE, MAJENE, SULAWESI BARAT",29,98,146,244
https://kawalpemilu.org#76051,"PANGALI ALI, BANGGAE, MAJENE, SULAWESI BARAT",30,126,84,210
https://kawalpemilu.org#76051,"PANGALI ALI, BANGGAE, MAJENE, SULAWESI BARAT",31,195,51,190
https://kawalpemilu.org#76051,"PANGALI ALI, BANGGAE, MAJENE, SULAWESI BARAT",32,91,71,162
https://kawalpemilu.org#76052,"TOTOLI, BANGGAE, MAJENE, SULAWESI BARAT",1,116,91,207
https://kawalpemilu.org#76052,"TOTOLI, BANGGAE, MAJENE, SULAWESI BARAT",2,112,65,177
https://kawalpemilu.org#76052,"TOTOLI, BANGGAE, MAJENE, SULAWESI BARAT",3,124,66,190
https://kawalpemilu.org#76052,"TOTOLI, BANGGAE, MAJENE, SULAWESI BARAT",4,146,73,219
https://kawalpemilu.org#76052,"TOTOLI, BANGGAE, MAJENE, SULAWESI BARAT",5,124,74,198
https://kawalpemilu.org#76052,"TOTOLI, BANGGAE, MAJENE, SULAWESI BARAT",6,127,64,191
https://kawalpemilu.org#76052,"TOTOLI, BANGGAE, MAJENE, SULAWESI BARAT",7,121,55,176
https://kawalpemilu.org#76052,"TOTOLI, BANGGAE, MAJENE, SULAWESI BARAT",8,99,64,163
https://kawalpemilu.org#76052,"TOTOLI, BANGGAE, MAJENE, SULAWESI BARAT",9,93,68,161
https://kawalpemilu.org#76052,"TOTOLI, BANGGAE, MAJENE, SULAWESI BARAT",10,135,54,189
https://kawalpemilu.org#76052,"TOTOLI, BANGGAE, MAJENE, SULAWESI BARAT",11,102,72,174
https://kawalpemilu.org#76052,"TOTOLI, BANGGAE, MAJENE, SULAWESI BARAT",12,124,102,226
https://kawalpemilu.org#76052,"TOTOLI, BANGGAE, MAJENE, SULAWESI BARAT",13,153,65,218
https://kawalpemilu.org#76052,"TOTOLI, BANGGAE, MAJENE, SULAWESI BARAT",14,154,59,213
https://kawalpemilu.org#87604,"RANGAS, BANGGAE, MAJENE, SULAWESI BARAT",1,141,52,193
https://kawalpemilu.org#87604,"RANGAS, BANGGAE, MAJENE, SULAWESI BARAT",2,142,55,197
https://kawalpemilu.org#87604,"RANGAS, BANGGAE, MAJENE, SULAWESI BARAT",3,138,49,187
https://kawalpemilu.org#87604,"RANGAS, BANGGAE, MAJENE, SULAWESI BARAT",4,137,54,191
https://kawalpemilu.org#87604,"RANGAS, BANGGAE, MAJENE, SULAWESI BARAT",5,160,55,215
https://kawalpemilu.org#87604,"RANGAS, BANGGAE, MAJENE, SULAWESI BARAT",6,118,61,179
https://kawalpemilu.org#87604,"RANGAS, BANGGAE, MAJENE, SULAWESI BARAT",7,152,52,204
https://kawalpemilu.org#87604,"RANGAS, BANGGAE, MAJENE, SULAWESI BARAT",8,159,42,201
https://kawalpemilu.org#87604,"RANGAS, BANGGAE, MAJENE, SULAWESI BARAT",9,109,65,174
https://kawalpemilu.org#87604,"RANGAS, BANGGAE, MAJENE, SULAWESI BARAT",10,111,71,182
https://kawalpemilu.org#87604,"RANGAS, BANGGAE, MAJENE, SULAWESI BARAT",11,89,79,168
https://kawalpemilu.org#87604,"RANGAS, BANGGAE, MAJENE, SULAWESI BARAT",12,110,74,184
https://kawalpemilu.org#87604,"RANGAS, BANGGAE, MAJENE, SULAWESI BARAT",13,131,49,180
https://kawalpemilu.org#87604,"RANGAS, BANGGAE, MAJENE, SULAWESI BARAT",14,126,57,183
https://kawalpemilu.org#87604,"RANGAS, BANGGAE, MAJENE, SULAWESI BARAT",15,136,64,200
https://kawalpemilu.org#87604,"RANGAS, BANGGAE, MAJENE, SULAWESI BARAT",16,126,63,189
https://kawalpemilu.org#87604,"RANGAS, BANGGAE, MAJENE, SULAWESI BARAT",17,131,75,206
https://kawalpemilu.org#87604,"RANGAS, BANGGAE, MAJENE, SULAWESI BARAT",18,113,91,204
https://kawalpemilu.org#87604,"RANGAS, BANGGAE, MAJENE, SULAWESI BARAT",19,136,72,208
https://kawalpemilu.org#87604,"RANGAS, BANGGAE, MAJENE, SULAWESI BARAT",20,124,89,213
https://kawalpemilu.org#87604,"RANGAS, BANGGAE, MAJENE, SULAWESI BARAT",21,92,91,183
https://kawalpemilu.org#87604,"RANGAS, BANGGAE, MAJENE, SULAWESI BARAT",22,143,61,204
https://kawalpemilu.org#87604,"RANGAS, BANGGAE, MAJENE, SULAWESI BARAT",23,147,55,202
https://kawalpemilu.org#87605,"GALUNG, BANGGAE, MAJENE, SULAWESI BARAT",1,109,110,219
https://kawalpemilu.org#87605,"GALUNG, BANGGAE, MAJENE, SULAWESI BARAT",2,101,104,205
https://kawalpemilu.org#87605,"GALUNG, BANGGAE, MAJENE, SULAWESI BARAT",3,93,106,199
https://kawalpemilu.org#87605,"GALUNG, BANGGAE, MAJENE, SULAWESI BARAT",4,110,115,225
https://kawalpemilu.org#87605,"GALUNG, BANGGAE, MAJENE, SULAWESI BARAT",5,79,140,219
https://kawalpemilu.org#87605,"GALUNG, BANGGAE, MAJENE, SULAWESI BARAT",6,119,82,201
https://kawalpemilu.org#87605,"GALUNG, BANGGAE, MAJENE, SULAWESI BARAT",7,104,103,207
https://kawalpemilu.org#87605,"GALUNG, BANGGAE, MAJENE, SULAWESI BARAT",8,86,126,212
https://kawalpemilu.org#87605,"GALUNG, BANGGAE, MAJENE, SULAWESI BARAT",9,82,132,214
https://kawalpemilu.org#87606,"PALIPI SOREANG, BANGGAE, MAJENE, SULAWESI BARAT",1,153,35,188
https://kawalpemilu.org#87606,"PALIPI SOREANG, BANGGAE, MAJENE, SULAWESI BARAT",2,156,29,185
https://kawalpemilu.org#87606,"PALIPI SOREANG, BANGGAE, MAJENE, SULAWESI BARAT",3,150,46,196
https://kawalpemilu.org#87606,"PALIPI SOREANG, BANGGAE, MAJENE, SULAWESI BARAT",4,120,57,177
https://kawalpemilu.org#87606,"PALIPI SOREANG, BANGGAE, MAJENE, SULAWESI BARAT",5,132,39,171
https://kawalpemilu.org#87606,"PALIPI SOREANG, BANGGAE, MAJENE, SULAWESI BARAT",6,121,78,199
https://kawalpemilu.org#87607,"PAMBOBORANG, BANGGAE, MAJENE, SULAWESI BARAT",1,123,29,152
https://kawalpemilu.org#87607,"PAMBOBORANG, BANGGAE, MAJENE, SULAWESI BARAT",2,104,50,154
https://kawalpemilu.org#87607,"PAMBOBORANG, BANGGAE, MAJENE, SULAWESI BARAT",3,106,40,146
https://kawalpemilu.org#87607,"PAMBOBORANG, BANGGAE, MAJENE, SULAWESI BARAT",4,180,82,262
https://kawalpemilu.org#87607,"PAMBOBORANG, BANGGAE, MAJENE, SULAWESI BARAT",5,181,48,229
https://kawalpemilu.org#87607,"PAMBOBORANG, BANGGAE, MAJENE, SULAWESI BARAT",6,108,65,173
https://kawalpemilu.org#87607,"PAMBOBORANG, BANGGAE, MAJENE, SULAWESI BARAT",7,175,101,276
https://kawalpemilu.org#76054,"LALAMPANUA, PAMBOANG, MAJENE, SULAWESI BARAT",1,104,89,193
https://kawalpemilu.org#76054,"LALAMPANUA, PAMBOANG, MAJENE, SULAWESI BARAT",2,89,137,226
https://kawalpemilu.org#76054,"LALAMPANUA, PAMBOANG, MAJENE, SULAWESI BARAT",3,45,83,128
https://kawalpemilu.org#76054,"LALAMPANUA, PAMBOANG, MAJENE, SULAWESI BARAT",4,48,110,158
https://kawalpemilu.org#76054,"LALAMPANUA, PAMBOANG, MAJENE, SULAWESI BARAT",5,72,111,183
https://kawalpemilu.org#76054,"LALAMPANUA, PAMBOANG, MAJENE, SULAWESI BARAT",6,110,81,191
https://kawalpemilu.org#76054,"LALAMPANUA, PAMBOANG, MAJENE, SULAWESI BARAT",7,105,89,194
https://kawalpemilu.org#76055,"SIRINDU, PAMBOANG, MAJENE, SULAWESI BARAT",1,66,61,127
https://kawalpemilu.org#76055,"SIRINDU, PAMBOANG, MAJENE, SULAWESI BARAT",2,83,69,152
https://kawalpemilu.org#76055,"SIRINDU, PAMBOANG, MAJENE, SULAWESI BARAT",3,51,58,109
https://kawalpemilu.org#76055,"SIRINDU, PAMBOANG, MAJENE, SULAWESI BARAT",4,93,71,164
https://kawalpemilu.org#76055,"SIRINDU, PAMBOANG, MAJENE, SULAWESI BARAT",5,105,32,137
https://kawalpemilu.org#76055,"SIRINDU, PAMBOANG, MAJENE, SULAWESI BARAT",6,122,92,214
https://kawalpemilu.org#76055,"SIRINDU, PAMBOANG, MAJENE, SULAWESI BARAT",7,128,70,198
https://kawalpemilu.org#76056,"ADOLANG, PAMBOANG, MAJENE, SULAWESI BARAT",1,144,37,181
https://kawalpemilu.org#76056,"ADOLANG, PAMBOANG, MAJENE, SULAWESI BARAT",2,108,68,176
https://kawalpemilu.org#76056,"ADOLANG, PAMBOANG, MAJENE, SULAWESI BARAT",3,80,31,111
https://kawalpemilu.org#76056,"ADOLANG, PAMBOANG, MAJENE, SULAWESI BARAT",4,86,43,129
https://kawalpemilu.org#76057,"BABABULO, PAMBOANG, MAJENE, SULAWESI BARAT",1,148,29,177
https://kawalpemilu.org#76057,"BABABULO, PAMBOANG, MAJENE, SULAWESI BARAT",2,134,19,153
https://kawalpemilu.org#76057,"BABABULO, PAMBOANG, MAJENE, SULAWESI BARAT",3,133,72,205
https://kawalpemilu.org#76057,"BABABULO, PAMBOANG, MAJENE, SULAWESI BARAT",4,151,62,213
https://kawalpemilu.org#76057,"BABABULO, PAMBOANG, MAJENE, SULAWESI BARAT",5,88,47,135
https://kawalpemilu.org#76057,"BABABULO, PAMBOANG, MAJENE, SULAWESI BARAT",6,89,86,175
https://kawalpemilu.org#76058,"BONDE, PAMBOANG, MAJENE, SULAWESI BARAT",1,160,44,204
https://kawalpemilu.org#76058,"BONDE, PAMBOANG, MAJENE, SULAWESI BARAT",2,173,40,213
https://kawalpemilu.org#76058,"BONDE, PAMBOANG, MAJENE, SULAWESI BARAT",3,116,40,156
https://kawalpemilu.org#76058,"BONDE, PAMBOANG, MAJENE, SULAWESI BARAT",4,125,28,153
https://kawalpemilu.org#76058,"BONDE, PAMBOANG, MAJENE, SULAWESI BARAT",5,157,65,222
https://kawalpemilu.org#76058,"BONDE, PAMBOANG, MAJENE, SULAWESI BARAT",6,142,47,189
https://kawalpemilu.org#76058,"BONDE, PAMBOANG, MAJENE, SULAWESI BARAT",7,118,58,176
https://kawalpemilu.org#76058,"BONDE, PAMBOANG, MAJENE, SULAWESI BARAT",8,97,28,125
https://kawalpemilu.org#76059,"BETTENG, PAMBOANG, MAJENE, SULAWESI BARAT",1,108,63,171
https://kawalpemilu.org#76059,"BETTENG, PAMBOANG, MAJENE, SULAWESI BARAT",2,115,92,207
https://kawalpemilu.org#76059,"BETTENG, PAMBOANG, MAJENE, SULAWESI BARAT",3,139,54,193
https://kawalpemilu.org#76060,"SIMBANG, PAMBOANG, MAJENE, SULAWESI BARAT",1,54,109,163
https://kawalpemilu.org#76060,"SIMBANG, PAMBOANG, MAJENE, SULAWESI BARAT",2,103,118,221
https://kawalpemilu.org#76060,"SIMBANG, PAMBOANG, MAJENE, SULAWESI BARAT",3,49,74,123
https://kawalpemilu.org#87608,"BONDE UTARA, PAMBOANG, MAJENE, SULAWESI BARAT",1,205,48,253
https://kawalpemilu.org#87608,"BONDE UTARA, PAMBOANG, MAJENE, SULAWESI BARAT",2,218,40,258
https://kawalpemilu.org#87608,"BONDE UTARA, PAMBOANG, MAJENE, SULAWESI BARAT",3,176,30,206
https://kawalpemilu.org#87608,"BONDE UTARA, PAMBOANG, MAJENE, SULAWESI BARAT",4,190,48,238
https://kawalpemilu.org#87608,"BONDE UTARA, PAMBOANG, MAJENE, SULAWESI BARAT",5,185,38,223
https://kawalpemilu.org#87608,"BONDE UTARA, PAMBOANG, MAJENE, SULAWESI BARAT",6,224,30,254
https://kawalpemilu.org#87608,"BONDE UTARA, PAMBOANG, MAJENE, SULAWESI BARAT",7,227,19,246
https://kawalpemilu.org#87609,"BABABULO UTARA, PAMBOANG, MAJENE, SULAWESI BARAT",1,118,70,188
https://kawalpemilu.org#87609,"BABABULO UTARA, PAMBOANG, MAJENE, SULAWESI BARAT",2,102,70,172
https://kawalpemilu.org#87609,"BABABULO UTARA, PAMBOANG, MAJENE, SULAWESI BARAT",3,104,84,188
https://kawalpemilu.org#87609,"BABABULO UTARA, PAMBOANG, MAJENE, SULAWESI BARAT",4,122,82,204
https://kawalpemilu.org#87610,"BUTTU PAMBOANG, PAMBOANG, MAJENE, SULAWESI BARAT",1,86,43,129
https://kawalpemilu.org#87610,"BUTTU PAMBOANG, PAMBOANG, MAJENE, SULAWESI BARAT",2,117,53,170
https://kawalpemilu.org#87610,"BUTTU PAMBOANG, PAMBOANG, MAJENE, SULAWESI BARAT",3,145,28,173
https://kawalpemilu.org#87610,"BUTTU PAMBOANG, PAMBOANG, MAJENE, SULAWESI BARAT",4,67,18,85
https://kawalpemilu.org#87611,"BANUA ADOLANG, PAMBOANG, MAJENE, SULAWESI BARAT",1,202,33,235
https://kawalpemilu.org#87611,"BANUA ADOLANG, PAMBOANG, MAJENE, SULAWESI BARAT",2,116,16,132
https://kawalpemilu.org#87611,"BANUA ADOLANG, PAMBOANG, MAJENE, SULAWESI BARAT",3,85,13,98
https://kawalpemilu.org#87611,"BANUA ADOLANG, PAMBOANG, MAJENE, SULAWESI BARAT",4,60,7,67
https://kawalpemilu.org#87612,"ADOLANG DHUA, PAMBOANG, MAJENE, SULAWESI BARAT",1,133,101,234
https://kawalpemilu.org#87612,"ADOLANG DHUA, PAMBOANG, MAJENE, SULAWESI BARAT",2,66,60,126
https://kawalpemilu.org#87612,"ADOLANG DHUA, PAMBOANG, MAJENE, SULAWESI BARAT",3,102,28,130
https://kawalpemilu.org#87612,"ADOLANG DHUA, PAMBOANG, MAJENE, SULAWESI BARAT",4,55,15,70
https://kawalpemilu.org#87613,"TINAMBUNG, PAMBOANG, MAJENE, SULAWESI BARAT",1,149,40,189
https://kawalpemilu.org#87613,"TINAMBUNG, PAMBOANG, MAJENE, SULAWESI BARAT",2,144,73,217
https://kawalpemilu.org#87613,"TINAMBUNG, PAMBOANG, MAJENE, SULAWESI BARAT",3,96,71,167
https://kawalpemilu.org#87613,"TINAMBUNG, PAMBOANG, MAJENE, SULAWESI BARAT",4,118,72,190
https://kawalpemilu.org#87613,"TINAMBUNG, PAMBOANG, MAJENE, SULAWESI BARAT",5,126,93,219
https://kawalpemilu.org#87613,"TINAMBUNG, PAMBOANG, MAJENE, SULAWESI BARAT",6,94,91,185
https://kawalpemilu.org#87613,"TINAMBUNG, PAMBOANG, MAJENE, SULAWESI BARAT",7,126,69,195
https://kawalpemilu.org#87614,"PESULOANG, PAMBOANG, MAJENE, SULAWESI BARAT",1,154,62,216
https://kawalpemilu.org#87614,"PESULOANG, PAMBOANG, MAJENE, SULAWESI BARAT",2,82,88,170
https://kawalpemilu.org#87614,"PESULOANG, PAMBOANG, MAJENE, SULAWESI BARAT",3,57,113,170
https://kawalpemilu.org#87615,"BALOMBONG, PAMBOANG, MAJENE, SULAWESI BARAT",1,123,70,193
https://kawalpemilu.org#87615,"BALOMBONG, PAMBOANG, MAJENE, SULAWESI BARAT",2,114,52,166
https://kawalpemilu.org#87615,"BALOMBONG, PAMBOANG, MAJENE, SULAWESI BARAT",3,132,72,204
https://kawalpemilu.org#87615,"BALOMBONG, PAMBOANG, MAJENE, SULAWESI BARAT",4,127,58,185
https://kawalpemilu.org#87615,"BALOMBONG, PAMBOANG, MAJENE, SULAWESI BARAT",5,105,11,116
https://kawalpemilu.org#76062,"MOSSO, SENDANA, MAJENE, SULAWESI BARAT",1,161,46,207
https://kawalpemilu.org#76062,"MOSSO, SENDANA, MAJENE, SULAWESI BARAT",2,150,43,193
https://kawalpemilu.org#76062,"MOSSO, SENDANA, MAJENE, SULAWESI BARAT",3,118,57,175
https://kawalpemilu.org#76062,"MOSSO, SENDANA, MAJENE, SULAWESI BARAT",4,137,39,176
https://kawalpemilu.org#76062,"MOSSO, SENDANA, MAJENE, SULAWESI BARAT",5,61,39,100
https://kawalpemilu.org#76062,"MOSSO, SENDANA, MAJENE, SULAWESI BARAT",6,116,71,187
https://kawalpemilu.org#76062,"MOSSO, SENDANA, MAJENE, SULAWESI BARAT",7,175,54,229
https://kawalpemilu.org#76062,"MOSSO, SENDANA, MAJENE, SULAWESI BARAT",8,161,63,224
https://kawalpemilu.org#76062,"MOSSO, SENDANA, MAJENE, SULAWESI BARAT",9,149,77,226
https://kawalpemilu.org#76062,"MOSSO, SENDANA, MAJENE, SULAWESI BARAT",10,100,18,118
https://kawalpemilu.org#76062,"MOSSO, SENDANA, MAJENE, SULAWESI BARAT",11,105,65,170
https://kawalpemilu.org#76062,"MOSSO, SENDANA, MAJENE, SULAWESI BARAT",12,120,113,233
https://kawalpemilu.org#76062,"MOSSO, SENDANA, MAJENE, SULAWESI BARAT",13,65,57,122
https://kawalpemilu.org#76062,"MOSSO, SENDANA, MAJENE, SULAWESI BARAT",14,57,100,157
https://kawalpemilu.org#76062,"MOSSO, SENDANA, MAJENE, SULAWESI BARAT",15,74,99,173
https://kawalpemilu.org#76063,"MOSSO DHUA, SENDANA, MAJENE, SULAWESI BARAT",1,142,35,177
https://kawalpemilu.org#76063,"MOSSO DHUA, SENDANA, MAJENE, SULAWESI BARAT",2,111,59,170
https://kawalpemilu.org#76063,"MOSSO DHUA, SENDANA, MAJENE, SULAWESI BARAT",3,122,32,154
https://kawalpemilu.org#76063,"MOSSO DHUA, SENDANA, MAJENE, SULAWESI BARAT",4,55,46,101
https://kawalpemilu.org#76063,"MOSSO DHUA, SENDANA, MAJENE, SULAWESI BARAT",5,57,82,139
https://kawalpemilu.org#76063,"MOSSO DHUA, SENDANA, MAJENE, SULAWESI BARAT",6,58,52,110
https://kawalpemilu.org#76063,"MOSSO DHUA, SENDANA, MAJENE, SULAWESI BARAT",7,142,29,171
https://kawalpemilu.org#76064,"PUNDAU, SENDANA, MAJENE, SULAWESI BARAT",1,130,49,179
https://kawalpemilu.org#76064,"PUNDAU, SENDANA, MAJENE, SULAWESI BARAT",2,121,58,179
https://kawalpemilu.org#76065,"SENDANA, SENDANA, MAJENE, SULAWESI BARAT",1,92,49,141
https://kawalpemilu.org#76065,"SENDANA, SENDANA, MAJENE, SULAWESI BARAT",2,92,49,141
https://kawalpemilu.org#76065,"SENDANA, SENDANA, MAJENE, SULAWESI BARAT",3,77,47,124
https://kawalpemilu.org#76065,"SENDANA, SENDANA, MAJENE, SULAWESI BARAT",4,108,11,119
https://kawalpemilu.org#76066,"TALLUBANUA, SENDANA, MAJENE, SULAWESI BARAT",1,111,38,149
https://kawalpemilu.org#76066,"TALLUBANUA, SENDANA, MAJENE, SULAWESI BARAT",2,97,35,132
https://kawalpemilu.org#76066,"TALLUBANUA, SENDANA, MAJENE, SULAWESI BARAT",3,89,34,123
https://kawalpemilu.org#76066,"TALLUBANUA, SENDANA, MAJENE, SULAWESI BARAT",4,72,65,137
https://kawalpemilu.org#76066,"TALLUBANUA, SENDANA, MAJENE, SULAWESI BARAT",5,82,90,172
https://kawalpemilu.org#76066,"TALLUBANUA, SENDANA, MAJENE, SULAWESI BARAT",6,114,40,154
https://kawalpemilu.org#76067,"PUTTADA, SENDANA, MAJENE, SULAWESI BARAT",1,139,29,168
https://kawalpemilu.org#76067,"PUTTADA, SENDANA, MAJENE, SULAWESI BARAT",2,125,17,142
https://kawalpemilu.org#76067,"PUTTADA, SENDANA, MAJENE, SULAWESI BARAT",3,80,59,139
https://kawalpemilu.org#87616,"TOTOLISI SENDANA, SENDANA, MAJENE, SULAWESI BARAT",1,164,57,221
https://kawalpemilu.org#87616,"TOTOLISI SENDANA, SENDANA, MAJENE, SULAWESI BARAT",2,126,54,180
https://kawalpemilu.org#87616,"TOTOLISI SENDANA, SENDANA, MAJENE, SULAWESI BARAT",3,174,33,207
https://kawalpemilu.org#87616,"TOTOLISI SENDANA, SENDANA, MAJENE, SULAWESI BARAT",4,136,45,181
https://kawalpemilu.org#87616,"TOTOLISI SENDANA, SENDANA, MAJENE, SULAWESI BARAT",5,173,48,221
https://kawalpemilu.org#87617,"LALATEDZONG, SENDANA, MAJENE, SULAWESI BARAT",1,129,46,175
https://kawalpemilu.org#87617,"LALATEDZONG, SENDANA, MAJENE, SULAWESI BARAT",2,154,81,235
https://kawalpemilu.org#87617,"LALATEDZONG, SENDANA, MAJENE, SULAWESI BARAT",3,160,85,245
https://kawalpemilu.org#87618,"BINANGA, SENDANA, MAJENE, SULAWESI BARAT",3,145,34,179
https://kawalpemilu.org#87619,"PAMINGGALAN, SENDANA, MAJENE, SULAWESI BARAT",2,102,25,127
https://kawalpemilu.org#87619,"PAMINGGALAN, SENDANA, MAJENE, SULAWESI BARAT",3,84,17,101
https://kawalpemilu.org#87620,"LEPPANGANG, SENDANA, MAJENE, SULAWESI BARAT",1,99,35,134
https://kawalpemilu.org#87620,"LEPPANGANG, SENDANA, MAJENE, SULAWESI BARAT",2,107,28,135
https://kawalpemilu.org#87620,"LEPPANGANG, SENDANA, MAJENE, SULAWESI BARAT",3,125,18,143
https://kawalpemilu.org#87621,"BANUA SENDANA, SENDANA, MAJENE, SULAWESI BARAT",1,132,73,205
https://kawalpemilu.org#87621,"BANUA SENDANA, SENDANA, MAJENE, SULAWESI BARAT",2,69,94,163
https://kawalpemilu.org#87621,"BANUA SENDANA, SENDANA, MAJENE, SULAWESI BARAT",3,95,106,201
https://kawalpemilu.org#87621,"BANUA SENDANA, SENDANA, MAJENE, SULAWESI BARAT",4,145,89,234
https://kawalpemilu.org#87622,"TALLUBANUA UTARA, SENDANA, MAJENE, SULAWESI BARAT",1,154,61,215
https://kawalpemilu.org#87622,"TALLUBANUA UTARA, SENDANA, MAJENE, SULAWESI BARAT",2,120,17,137
https://kawalpemilu.org#87622,"TALLUBANUA UTARA, SENDANA, MAJENE, SULAWESI BARAT",3,132,70,202
https://kawalpemilu.org#87622,"TALLUBANUA UTARA, SENDANA, MAJENE, SULAWESI BARAT",4,166,32,198
https://kawalpemilu.org#87622,"TALLUBANUA UTARA, SENDANA, MAJENE, SULAWESI BARAT",5,114,78,192
https://kawalpemilu.org#87622,"TALLUBANUA UTARA, SENDANA, MAJENE, SULAWESI BARAT",6,121,69,190
https://kawalpemilu.org#87623,"LIMBORO RAMBU-RAMBU, SENDANA, MAJENE, SULAWESI BARAT",1,122,45,167
https://kawalpemilu.org#87623,"LIMBORO RAMBU-RAMBU, SENDANA, MAJENE, SULAWESI BARAT",2,114,18,132
https://kawalpemilu.org#87623,"LIMBORO RAMBU-RAMBU, SENDANA, MAJENE, SULAWESI BARAT",3,114,33,147
https://kawalpemilu.org#87623,"LIMBORO RAMBU-RAMBU, SENDANA, MAJENE, SULAWESI BARAT",4,67,9,76
https://kawalpemilu.org#87624,"LIMBUA, SENDANA, MAJENE, SULAWESI BARAT",1,101,89,190
https://kawalpemilu.org#87624,"LIMBUA, SENDANA, MAJENE, SULAWESI BARAT",2,121,103,224
https://kawalpemilu.org#87624,"LIMBUA, SENDANA, MAJENE, SULAWESI BARAT",3,83,92,175
https://kawalpemilu.org#87624,"LIMBUA, SENDANA, MAJENE, SULAWESI BARAT",4,117,74,191
https://kawalpemilu.org#87624,"LIMBUA, SENDANA, MAJENE, SULAWESI BARAT",5,171,43,214
https://kawalpemilu.org#87624,"LIMBUA, SENDANA, MAJENE, SULAWESI BARAT",6,72,40,112
https://kawalpemilu.org#87624,"LIMBUA, SENDANA, MAJENE, SULAWESI BARAT",7,68,30,98
https://kawalpemilu.org#87624,"LIMBUA, SENDANA, MAJENE, SULAWESI BARAT",8,86,69,155
https://kawalpemilu.org#87625,"BUKIT SAMANG, SENDANA, MAJENE, SULAWESI BARAT",1,93,64,157
https://kawalpemilu.org#87625,"BUKIT SAMANG, SENDANA, MAJENE, SULAWESI BARAT",2,153,118,271
https://kawalpemilu.org#87625,"BUKIT SAMANG, SENDANA, MAJENE, SULAWESI BARAT",3,104,97,201
https://kawalpemilu.org#87625,"BUKIT SAMANG, SENDANA, MAJENE, SULAWESI BARAT",4,208,36,244
https://kawalpemilu.org#76069,"MALUNDA, MALUNDA, MAJENE, SULAWESI BARAT",1,94,108,202
https://kawalpemilu.org#76069,"MALUNDA, MALUNDA, MAJENE, SULAWESI BARAT",2,104,92,196
https://kawalpemilu.org#76069,"MALUNDA, MALUNDA, MAJENE, SULAWESI BARAT",3,125,104,229
https://kawalpemilu.org#76069,"MALUNDA, MALUNDA, MAJENE, SULAWESI BARAT",4,97,105,202
https://kawalpemilu.org#76069,"MALUNDA, MALUNDA, MAJENE, SULAWESI BARAT",5,129,105,234
https://kawalpemilu.org#76069,"MALUNDA, MALUNDA, MAJENE, SULAWESI BARAT",6,43,109,152
https://kawalpemilu.org#76069,"MALUNDA, MALUNDA, MAJENE, SULAWESI BARAT",7,85,56,141
https://kawalpemilu.org#76069,"MALUNDA, MALUNDA, MAJENE, SULAWESI BARAT",8,78,81,159
https://kawalpemilu.org#76070,"BAMBANGAN, MALUNDA, MAJENE, SULAWESI BARAT",1,124,30,154
https://kawalpemilu.org#76070,"BAMBANGAN, MALUNDA, MAJENE, SULAWESI BARAT",2,106,27,133
https://kawalpemilu.org#76070,"BAMBANGAN, MALUNDA, MAJENE, SULAWESI BARAT",3,118,22,140
https://kawalpemilu.org#76070,"BAMBANGAN, MALUNDA, MAJENE, SULAWESI BARAT",4,143,26,169
https://kawalpemilu.org#76070,"BAMBANGAN, MALUNDA, MAJENE, SULAWESI BARAT",5,97,17,114
https://kawalpemilu.org#76071,"LOMBANG, MALUNDA, MAJENE, SULAWESI BARAT",1,109,86,195
https://kawalpemilu.org#76071,"LOMBANG, MALUNDA, MAJENE, SULAWESI BARAT",2,67,116,183
https://kawalpemilu.org#76071,"LOMBANG, MALUNDA, MAJENE, SULAWESI BARAT",3,90,52,142
https://kawalpemilu.org#76072,"LOMBONG, MALUNDA, MAJENE, SULAWESI BARAT",1,100,52,152
https://kawalpemilu.org#76072,"LOMBONG, MALUNDA, MAJENE, SULAWESI BARAT",2,137,60,197
https://kawalpemilu.org#76072,"LOMBONG, MALUNDA, MAJENE, SULAWESI BARAT",3,83,80,163
https://kawalpemilu.org#76072,"LOMBONG, MALUNDA, MAJENE, SULAWESI BARAT",4,139,42,181
https://kawalpemilu.org#76072,"LOMBONG, MALUNDA, MAJENE, SULAWESI BARAT",5,74,79,153
https://kawalpemilu.org#76072,"LOMBONG, MALUNDA, MAJENE, SULAWESI BARAT",6,97,53,150
https://kawalpemilu.org#76072,"LOMBONG, MALUNDA, MAJENE, SULAWESI BARAT",7,123,34,157
https://kawalpemilu.org#76073,"MEKKATTA, MALUNDA, MAJENE, SULAWESI BARAT",1,113,34,147
https://kawalpemilu.org#76073,"MEKKATTA, MALUNDA, MAJENE, SULAWESI BARAT",2,87,75,162
https://kawalpemilu.org#76073,"MEKKATTA, MALUNDA, MAJENE, SULAWESI BARAT",3,108,86,194
https://kawalpemilu.org#76073,"MEKKATTA, MALUNDA, MAJENE, SULAWESI BARAT",4,131,64,195
https://kawalpemilu.org#76073,"MEKKATTA, MALUNDA, MAJENE, SULAWESI BARAT",5,129,70,199
https://kawalpemilu.org#76073,"MEKKATTA, MALUNDA, MAJENE, SULAWESI BARAT",6,125,15,140
https://kawalpemilu.org#76073,"MEKKATTA, MALUNDA, MAJENE, SULAWESI BARAT",7,78,8,86
https://kawalpemilu.org#76074,"MALIAYA, MALUNDA, MAJENE, SULAWESI BARAT",1,77,35,112
https://kawalpemilu.org#76074,"MALIAYA, MALUNDA, MAJENE, SULAWESI BARAT",2,96,62,158
https://kawalpemilu.org#76074,"MALIAYA, MALUNDA, MAJENE, SULAWESI BARAT",3,93,110,203
https://kawalpemilu.org#76074,"MALIAYA, MALUNDA, MAJENE, SULAWESI BARAT",4,105,75,180
https://kawalpemilu.org#76074,"MALIAYA, MALUNDA, MAJENE, SULAWESI BARAT",5,138,65,203
https://kawalpemilu.org#76074,"MALIAYA, MALUNDA, MAJENE, SULAWESI BARAT",6,111,34,145
https://kawalpemilu.org#87626,"LAMUNGANG BATU, MALUNDA, MAJENE, SULAWESI BARAT",1,151,80,231
https://kawalpemilu.org#87626,"LAMUNGANG BATU, MALUNDA, MAJENE, SULAWESI BARAT",2,106,110,216
https://kawalpemilu.org#87626,"LAMUNGANG BATU, MALUNDA, MAJENE, SULAWESI BARAT",3,82,112,194
https://kawalpemilu.org#87626,"LAMUNGANG BATU, MALUNDA, MAJENE, SULAWESI BARAT",4,88,79,167
https://kawalpemilu.org#87626,"LAMUNGANG BATU, MALUNDA, MAJENE, SULAWESI BARAT",5,106,67,173
https://kawalpemilu.org#87626,"LAMUNGANG BATU, MALUNDA, MAJENE, SULAWESI BARAT",6,114,62,176
https://kawalpemilu.org#87626,"LAMUNGANG BATU, MALUNDA, MAJENE, SULAWESI BARAT",7,97,73,170
https://kawalpemilu.org#87627,"LOMBANG TIMUR, MALUNDA, MAJENE, SULAWESI BARAT",1,134,24,158
https://kawalpemilu.org#87627,"LOMBANG TIMUR, MALUNDA, MAJENE, SULAWESI BARAT",2,108,25,133
https://kawalpemilu.org#87627,"LOMBANG TIMUR, MALUNDA, MAJENE, SULAWESI BARAT",3,114,7,121
https://kawalpemilu.org#87627,"LOMBANG TIMUR, MALUNDA, MAJENE, SULAWESI BARAT",4,163,36,199
https://kawalpemilu.org#87628,"SALUTAHONGAN, MALUNDA, MAJENE, SULAWESI BARAT",1,156,12,168
https://kawalpemilu.org#87628,"SALUTAHONGAN, MALUNDA, MAJENE, SULAWESI BARAT",2,107,30,137
https://kawalpemilu.org#87628,"SALUTAHONGAN, MALUNDA, MAJENE, SULAWESI BARAT",3,124,47,171
https://kawalpemilu.org#87628,"SALUTAHONGAN, MALUNDA, MAJENE, SULAWESI BARAT",4,40,36,76
https://kawalpemilu.org#87629,"LOMBONG TIMUR, MALUNDA, MAJENE, SULAWESI BARAT",1,83,124,207
https://kawalpemilu.org#87629,"LOMBONG TIMUR, MALUNDA, MAJENE, SULAWESI BARAT",2,124,104,228
https://kawalpemilu.org#87629,"LOMBONG TIMUR, MALUNDA, MAJENE, SULAWESI BARAT",3,200,29,229
https://kawalpemilu.org#87630,"MEKKATTA SELATAN, MALUNDA, MAJENE, SULAWESI BARAT",1,118,85,203
https://kawalpemilu.org#87630,"MEKKATTA SELATAN, MALUNDA, MAJENE, SULAWESI BARAT",2,127,68,195
https://kawalpemilu.org#87630,"MEKKATTA SELATAN, MALUNDA, MAJENE, SULAWESI BARAT",3,110,88,198
https://kawalpemilu.org#87631,"KAYUANGIN, MALUNDA, MAJENE, SULAWESI BARAT",1,143,51,194
https://kawalpemilu.org#87631,"KAYUANGIN, MALUNDA, MAJENE, SULAWESI BARAT",2,135,59,194
https://kawalpemilu.org#87631,"KAYUANGIN, MALUNDA, MAJENE, SULAWESI BARAT",3,162,61,223
https://kawalpemilu.org#87631,"KAYUANGIN, MALUNDA, MAJENE, SULAWESI BARAT",4,198,39,237
https://kawalpemilu.org#76076,"KABIRAAN, ULUMANDA, MAJENE, SULAWESI BARAT",1,120,77,197
https://kawalpemilu.org#76076,"KABIRAAN, ULUMANDA, MAJENE, SULAWESI BARAT",2,77,42,119
https://kawalpemilu.org#76076,"KABIRAAN, ULUMANDA, MAJENE, SULAWESI BARAT",3,118,47,165
https://kawalpemilu.org#76076,"KABIRAAN, ULUMANDA, MAJENE, SULAWESI BARAT",4,145,24,169
https://kawalpemilu.org#76076,"KABIRAAN, ULUMANDA, MAJENE, SULAWESI BARAT",5,95,37,132
https://kawalpemilu.org#76077,"SAMBABO, ULUMANDA, MAJENE, SULAWESI BARAT",1,118,53,171
https://kawalpemilu.org#76077,"SAMBABO, ULUMANDA, MAJENE, SULAWESI BARAT",2,145,45,190
https://kawalpemilu.org#76077,"SAMBABO, ULUMANDA, MAJENE, SULAWESI BARAT",3,70,19,89
https://kawalpemilu.org#76077,"SAMBABO, ULUMANDA, MAJENE, SULAWESI BARAT",4,95,28,123
https://kawalpemilu.org#76078,"TANDEALLO, ULUMANDA, MAJENE, SULAWESI BARAT",1,81,103,184
https://kawalpemilu.org#76078,"TANDEALLO, ULUMANDA, MAJENE, SULAWESI BARAT",2,125,97,222
https://kawalpemilu.org#76078,"TANDEALLO, ULUMANDA, MAJENE, SULAWESI BARAT",3,84,128,212
https://kawalpemilu.org#76078,"TANDEALLO, ULUMANDA, MAJENE, SULAWESI BARAT",4,74,50,124
https://kawalpemilu.org#76078,"TANDEALLO, ULUMANDA, MAJENE, SULAWESI BARAT",5,53,33,86
https://kawalpemilu.org#76078,"TANDEALLO, ULUMANDA, MAJENE, SULAWESI BARAT",6,75,12,87
https://kawalpemilu.org#76079,"ULUMANDA, ULUMANDA, MAJENE, SULAWESI BARAT",1,55,160,215
https://kawalpemilu.org#76079,"ULUMANDA, ULUMANDA, MAJENE, SULAWESI BARAT",2,33,19,52
https://kawalpemilu.org#76079,"ULUMANDA, ULUMANDA, MAJENE, SULAWESI BARAT",3,40,9,49
https://kawalpemilu.org#76079,"ULUMANDA, ULUMANDA, MAJENE, SULAWESI BARAT",4,3,156,159
https://kawalpemilu.org#76079,"ULUMANDA, ULUMANDA, MAJENE, SULAWESI BARAT",5,54,10,64
https://kawalpemilu.org#76079,"ULUMANDA, ULUMANDA, MAJENE, SULAWESI BARAT",6,13,39,52
https://kawalpemilu.org#87632,"SALUTAMBUNG, ULUMANDA, MAJENE, SULAWESI BARAT",1,144,30,174
https://kawalpemilu.org#87632,"SALUTAMBUNG, ULUMANDA, MAJENE, SULAWESI BARAT",2,75,78,153
https://kawalpemilu.org#87632,"SALUTAMBUNG, ULUMANDA, MAJENE, SULAWESI BARAT",3,120,90,210
https://kawalpemilu.org#87632,"SALUTAMBUNG, ULUMANDA, MAJENE, SULAWESI BARAT",4,155,68,223
https://kawalpemilu.org#87633,"POPENGA, ULUMANDA, MAJENE, SULAWESI BARAT",1,121,25,146
https://kawalpemilu.org#87633,"POPENGA, ULUMANDA, MAJENE, SULAWESI BARAT",2,84,197,281
https://kawalpemilu.org#87633,"POPENGA, ULUMANDA, MAJENE, SULAWESI BARAT",3,66,4,70
https://kawalpemilu.org#87633,"POPENGA, ULUMANDA, MAJENE, SULAWESI BARAT",4,86,31,117
https://kawalpemilu.org#87634,"SULAI, ULUMANDA, MAJENE, SULAWESI BARAT",1,90,29,119
https://kawalpemilu.org#87634,"SULAI, ULUMANDA, MAJENE, SULAWESI BARAT",2,167,25,192
https://kawalpemilu.org#87634,"SULAI, ULUMANDA, MAJENE, SULAWESI BARAT",3,58,65,123
https://kawalpemilu.org#87634,"SULAI, ULUMANDA, MAJENE, SULAWESI BARAT",4,62,14,76
https://kawalpemilu.org#87635,"PANGGALO, ULUMANDA, MAJENE, SULAWESI BARAT",1,136,36,172
https://kawalpemilu.org#87635,"PANGGALO, ULUMANDA, MAJENE, SULAWESI BARAT",2,79,38,117
https://kawalpemilu.org#87635,"PANGGALO, ULUMANDA, MAJENE, SULAWESI BARAT",3,81,65,146
https://kawalpemilu.org#87635,"PANGGALO, ULUMANDA, MAJENE, SULAWESI BARAT",4,88,31,119
https://kawalpemilu.org#87635,"PANGGALO, ULUMANDA, MAJENE, SULAWESI BARAT",5,103,9,112
https://kawalpemilu.org#76081,"SEPPONG, TAMMERODO SENDANA, MAJENE, SULAWESI BARAT",1,84,85,169
https://kawalpemilu.org#76081,"SEPPONG, TAMMERODO SENDANA, MAJENE, SULAWESI BARAT",2,64,90,154
https://kawalpemilu.org#76081,"SEPPONG, TAMMERODO SENDANA, MAJENE, SULAWESI BARAT",3,136,86,222
https://kawalpemilu.org#76081,"SEPPONG, TAMMERODO SENDANA, MAJENE, SULAWESI BARAT",4,91,52,143
https://kawalpemilu.org#76081,"SEPPONG, TAMMERODO SENDANA, MAJENE, SULAWESI BARAT",5,88,124,212
https://kawalpemilu.org#76082,"TAMMERODO, TAMMERODO SENDANA, MAJENE, SULAWESI BARAT",1,121,54,175
https://kawalpemilu.org#76082,"TAMMERODO, TAMMERODO SENDANA, MAJENE, SULAWESI BARAT",2,135,21,156
https://kawalpemilu.org#76082,"TAMMERODO, TAMMERODO SENDANA, MAJENE, SULAWESI BARAT",3,50,74,124
https://kawalpemilu.org#76082,"TAMMERODO, TAMMERODO SENDANA, MAJENE, SULAWESI BARAT",4,91,46,137
https://kawalpemilu.org#76082,"TAMMERODO, TAMMERODO SENDANA, MAJENE, SULAWESI BARAT",5,140,41,181
https://kawalpemilu.org#76082,"TAMMERODO, TAMMERODO SENDANA, MAJENE, SULAWESI BARAT",6,81,85,166
https://kawalpemilu.org#76082,"TAMMERODO, TAMMERODO SENDANA, MAJENE, SULAWESI BARAT",7,116,73,189
https://kawalpemilu.org#76083,"ULIDANG, TAMMERODO SENDANA, MAJENE, SULAWESI BARAT",1,103,18,121
https://kawalpemilu.org#76083,"ULIDANG, TAMMERODO SENDANA, MAJENE, SULAWESI BARAT",2,134,111,245
https://kawalpemilu.org#76083,"ULIDANG, TAMMERODO SENDANA, MAJENE, SULAWESI BARAT",3,125,102,227
https://kawalpemilu.org#76083,"ULIDANG, TAMMERODO SENDANA, MAJENE, SULAWESI BARAT",4,138,88,226
https://kawalpemilu.org#76083,"ULIDANG, TAMMERODO SENDANA, MAJENE, SULAWESI BARAT",5,112,57,169
https://kawalpemilu.org#76083,"ULIDANG, TAMMERODO SENDANA, MAJENE, SULAWESI BARAT",6,117,71,188
https://kawalpemilu.org#76084,"TALLAMBALAO, TAMMERODO SENDANA, MAJENE, SULAWESI BARAT",1,70,81,151
https://kawalpemilu.org#76084,"TALLAMBALAO, TAMMERODO SENDANA, MAJENE, SULAWESI BARAT",3,108,135,243
https://kawalpemilu.org#76084,"TALLAMBALAO, TAMMERODO SENDANA, MAJENE, SULAWESI BARAT",4,142,63,205
https://kawalpemilu.org#76084,"TALLAMBALAO, TAMMERODO SENDANA, MAJENE, SULAWESI BARAT",5,90,112,202
https://kawalpemilu.org#76084,"TALLAMBALAO, TAMMERODO SENDANA, MAJENE, SULAWESI BARAT",6,77,79,156
https://kawalpemilu.org#87636,"TAMMERODO UTARA, TAMMERODO SENDANA, MAJENE, SULAWESI BARAT",1,113,117,230
https://kawalpemilu.org#87636,"TAMMERODO UTARA, TAMMERODO SENDANA, MAJENE, SULAWESI BARAT",2,87,69,156
https://kawalpemilu.org#87636,"TAMMERODO UTARA, TAMMERODO SENDANA, MAJENE, SULAWESI BARAT",3,80,78,158
https://kawalpemilu.org#87636,"TAMMERODO UTARA, TAMMERODO SENDANA, MAJENE, SULAWESI BARAT",4,79,47,126
https://kawalpemilu.org#87636,"TAMMERODO UTARA, TAMMERODO SENDANA, MAJENE, SULAWESI BARAT",5,78,51,129
https://kawalpemilu.org#87636,"TAMMERODO UTARA, TAMMERODO SENDANA, MAJENE, SULAWESI BARAT",6,82,66,148
https://kawalpemilu.org#87636,"TAMMERODO UTARA, TAMMERODO SENDANA, MAJENE, SULAWESI BARAT",7,82,70,152
https://kawalpemilu.org#87637,"MANYAMBA, TAMMERODO SENDANA, MAJENE, SULAWESI BARAT",1,178,91,269
https://kawalpemilu.org#87637,"MANYAMBA, TAMMERODO SENDANA, MAJENE, SULAWESI BARAT",2,93,91,184
https://kawalpemilu.org#87637,"MANYAMBA, TAMMERODO SENDANA, MAJENE, SULAWESI BARAT",3,109,128,237
https://kawalpemilu.org#87637,"MANYAMBA, TAMMERODO SENDANA, MAJENE, SULAWESI BARAT",4,114,30,144
https://kawalpemilu.org#87637,"MANYAMBA, TAMMERODO SENDANA, MAJENE, SULAWESI BARAT",5,45,8,53
https://kawalpemilu.org#87638,"AWO, TAMMERODO SENDANA, MAJENE, SULAWESI BARAT",1,63,65,128
https://kawalpemilu.org#87638,"AWO, TAMMERODO SENDANA, MAJENE, SULAWESI BARAT",2,185,57,242
https://kawalpemilu.org#87638,"AWO, TAMMERODO SENDANA, MAJENE, SULAWESI BARAT",3,115,79,194
https://kawalpemilu.org#87638,"AWO, TAMMERODO SENDANA, MAJENE, SULAWESI BARAT",4,86,104,190
https://kawalpemilu.org#76086,"ONANG, TUBO SENDANA, MAJENE, SULAWESI BARAT",1,124,94,218
https://kawalpemilu.org#76086,"ONANG, TUBO SENDANA, MAJENE, SULAWESI BARAT",2,150,63,213
https://kawalpemilu.org#76086,"ONANG, TUBO SENDANA, MAJENE, SULAWESI BARAT",3,146,30,176
https://kawalpemilu.org#76086,"ONANG, TUBO SENDANA, MAJENE, SULAWESI BARAT",4,146,25,171
https://kawalpemilu.org#76086,"ONANG, TUBO SENDANA, MAJENE, SULAWESI BARAT",5,148,67,215
https://kawalpemilu.org#76086,"ONANG, TUBO SENDANA, MAJENE, SULAWESI BARAT",6,90,90,180
https://kawalpemilu.org#76086,"ONANG, TUBO SENDANA, MAJENE, SULAWESI BARAT",7,146,42,188
https://kawalpemilu.org#76086,"ONANG, TUBO SENDANA, MAJENE, SULAWESI BARAT",8,138,108,246
https://kawalpemilu.org#76086,"ONANG, TUBO SENDANA, MAJENE, SULAWESI BARAT",9,158,51,209
https://kawalpemilu.org#76086,"ONANG, TUBO SENDANA, MAJENE, SULAWESI BARAT",10,83,49,132
https://kawalpemilu.org#76087,"TUBO, TUBO SENDANA, MAJENE, SULAWESI BARAT",1,87,75,162
https://kawalpemilu.org#76087,"TUBO, TUBO SENDANA, MAJENE, SULAWESI BARAT",2,86,71,157
https://kawalpemilu.org#76087,"TUBO, TUBO SENDANA, MAJENE, SULAWESI BARAT",3,77,107,184
https://kawalpemilu.org#76087,"TUBO, TUBO SENDANA, MAJENE, SULAWESI BARAT",4,111,24,135
https://kawalpemilu.org#76088,"ONANG UTARA, TUBO SENDANA, MAJENE, SULAWESI BARAT",1,150,96,246
https://kawalpemilu.org#76088,"ONANG UTARA, TUBO SENDANA, MAJENE, SULAWESI BARAT",2,177,61,238
https://kawalpemilu.org#76088,"ONANG UTARA, TUBO SENDANA, MAJENE, SULAWESI BARAT",3,101,25,126
https://kawalpemilu.org#76088,"ONANG UTARA, TUBO SENDANA, MAJENE, SULAWESI BARAT",4,87,54,141
https://kawalpemilu.org#76089,"TUBO SELATAN, TUBO SENDANA, MAJENE, SULAWESI BARAT",1,63,39,102
https://kawalpemilu.org#76089,"TUBO SELATAN, TUBO SENDANA, MAJENE, SULAWESI BARAT",2,92,69,161
https://kawalpemilu.org#76089,"TUBO SELATAN, TUBO SENDANA, MAJENE, SULAWESI BARAT",3,106,137,243
https://kawalpemilu.org#87639,"BONDE BONDE, TUBO SENDANA, MAJENE, SULAWESI BARAT",1,55,48,103
https://kawalpemilu.org#87639,"BONDE BONDE, TUBO SENDANA, MAJENE, SULAWESI BARAT",2,95,133,228
https://kawalpemilu.org#87639,"BONDE BONDE, TUBO SENDANA, MAJENE, SULAWESI BARAT",3,170,86,256
https://kawalpemilu.org#87640,"TUBO TENGAH, TUBO SENDANA, MAJENE, SULAWESI BARAT",1,113,56,169
https://kawalpemilu.org#87640,"TUBO TENGAH, TUBO SENDANA, MAJENE, SULAWESI BARAT",2,108,71,179
https://kawalpemilu.org#87640,"TUBO TENGAH, TUBO SENDANA, MAJENE, SULAWESI BARAT",3,110,81,191
https://kawalpemilu.org#87641,"TUBO POANG, TUBO SENDANA, MAJENE, SULAWESI BARAT",1,92,128,220
https://kawalpemilu.org#87641,"TUBO POANG, TUBO SENDANA, MAJENE, SULAWESI BARAT",3,83,68,151
https://kawalpemilu.org#76091,"BAURUNG, BANGGAE TIMUR, MAJENE, SULAWESI BARAT",1,162,104,266
https://kawalpemilu.org#76091,"BAURUNG, BANGGAE TIMUR, MAJENE, SULAWESI BARAT",2,100,125,225
https://kawalpemilu.org#76091,"BAURUNG, BANGGAE TIMUR, MAJENE, SULAWESI BARAT",3,88,146,234
https://kawalpemilu.org#76091,"BAURUNG, BANGGAE TIMUR, MAJENE, SULAWESI BARAT",4,134,97,231
https://kawalpemilu.org#76091,"BAURUNG, BANGGAE TIMUR, MAJENE, SULAWESI BARAT",5,123,113,236
https://kawalpemilu.org#76091,"BAURUNG, BANGGAE TIMUR, MAJENE, SULAWESI BARAT",6,90,110,200
https://kawalpemilu.org#76091,"BAURUNG, BANGGAE TIMUR, MAJENE, SULAWESI BARAT",7,111,76,187
https://kawalpemilu.org#76091,"BAURUNG, BANGGAE TIMUR, MAJENE, SULAWESI BARAT",8,179,42,221
https://kawalpemilu.org#76091,"BAURUNG, BANGGAE TIMUR, MAJENE, SULAWESI BARAT",9,95,120,215
https://kawalpemilu.org#76091,"BAURUNG, BANGGAE TIMUR, MAJENE, SULAWESI BARAT",10,99,59,158
https://kawalpemilu.org#76091,"BAURUNG, BANGGAE TIMUR, MAJENE, SULAWESI BARAT",11,96,76,172
https://kawalpemilu.org#76091,"BAURUNG, BANGGAE TIMUR, MAJENE, SULAWESI BARAT",12,121,78,199
https://kawalpemilu.org#76091,"BAURUNG, BANGGAE TIMUR, MAJENE, SULAWESI BARAT",13,168,81,249
https://kawalpemilu.org#76091,"BAURUNG, BANGGAE TIMUR, MAJENE, SULAWESI BARAT",14,154,101,255
https://kawalpemilu.org#76092,"BARUGA, BANGGAE TIMUR, MAJENE, SULAWESI BARAT",1,145,45,190
https://kawalpemilu.org#76092,"BARUGA, BANGGAE TIMUR, MAJENE, SULAWESI BARAT",2,106,73,179
https://kawalpemilu.org#76092,"BARUGA, BANGGAE TIMUR, MAJENE, SULAWESI BARAT",3,92,36,128
https://kawalpemilu.org#76092,"BARUGA, BANGGAE TIMUR, MAJENE, SULAWESI BARAT",4,118,46,164
https://kawalpemilu.org#76092,"BARUGA, BANGGAE TIMUR, MAJENE, SULAWESI BARAT",5,129,113,242
https://kawalpemilu.org#76092,"BARUGA, BANGGAE TIMUR, MAJENE, SULAWESI BARAT",6,101,156,257
https://kawalpemilu.org#76092,"BARUGA, BANGGAE TIMUR, MAJENE, SULAWESI BARAT",7,41,79,120
https://kawalpemilu.org#76093,"BARUGA DHUA, BANGGAE TIMUR, MAJENE, SULAWESI BARAT",1,69,60,129
https://kawalpemilu.org#76093,"BARUGA DHUA, BANGGAE TIMUR, MAJENE, SULAWESI BARAT",2,101,70,171
https://kawalpemilu.org#76093,"BARUGA DHUA, BANGGAE TIMUR, MAJENE, SULAWESI BARAT",3,106,78,184
https://kawalpemilu.org#76093,"BARUGA DHUA, BANGGAE TIMUR, MAJENE, SULAWESI BARAT",4,87,60,147
https://kawalpemilu.org#76093,"BARUGA DHUA, BANGGAE TIMUR, MAJENE, SULAWESI BARAT",5,72,125,197
https://kawalpemilu.org#76093,"BARUGA DHUA, BANGGAE TIMUR, MAJENE, SULAWESI BARAT",6,70,47,117
https://kawalpemilu.org#76094,"LABUANG, BANGGAE TIMUR, MAJENE, SULAWESI BARAT",1,92,48,140
https://kawalpemilu.org#76094,"LABUANG, BANGGAE TIMUR, MAJENE, SULAWESI BARAT",2,88,41,129
https://kawalpemilu.org#76094,"LABUANG, BANGGAE TIMUR, MAJENE, SULAWESI BARAT",3,77,78,155
https://kawalpemilu.org#76094,"LABUANG, BANGGAE TIMUR, MAJENE, SULAWESI BARAT",4,62,59,121
https://kawalpemilu.org#76094,"LABUANG, BANGGAE TIMUR, MAJENE, SULAWESI BARAT",5,69,74,143
https://kawalpemilu.org#76094,"LABUANG, BANGGAE TIMUR, MAJENE, SULAWESI BARAT",6,67,73,140
https://kawalpemilu.org#76094,"LABUANG, BANGGAE TIMUR, MAJENE, SULAWESI BARAT",7,100,145,245
https://kawalpemilu.org#76094,"LABUANG, BANGGAE TIMUR, MAJENE, SULAWESI BARAT",8,119,99,218
https://kawalpemilu.org#76094,"LABUANG, BANGGAE TIMUR, MAJENE, SULAWESI BARAT",9,58,57,115
https://kawalpemilu.org#76094,"LABUANG, BANGGAE TIMUR, MAJENE, SULAWESI BARAT",10,53,70,123
https://kawalpemilu.org#76094,"LABUANG, BANGGAE TIMUR, MAJENE, SULAWESI BARAT",11,90,127,217
https://kawalpemilu.org#76094,"LABUANG, BANGGAE TIMUR, MAJENE, SULAWESI BARAT",12,111,67,178
https://kawalpemilu.org#76094,"LABUANG, BANGGAE TIMUR, MAJENE, SULAWESI BARAT",13,69,75,144
https://kawalpemilu.org#76094,"LABUANG, BANGGAE TIMUR, MAJENE, SULAWESI BARAT",14,73,66,139
https://kawalpemilu.org#76094,"LABUANG, BANGGAE TIMUR, MAJENE, SULAWESI BARAT",15,115,102,217
https://kawalpemilu.org#76094,"LABUANG, BANGGAE TIMUR, MAJENE, SULAWESI BARAT",16,81,92,173
https://kawalpemilu.org#76094,"LABUANG, BANGGAE TIMUR, MAJENE, SULAWESI BARAT",17,45,58,103
https://kawalpemilu.org#76094,"LABUANG, BANGGAE TIMUR, MAJENE, SULAWESI BARAT",18,57,83,140
https://kawalpemilu.org#76094,"LABUANG, BANGGAE TIMUR, MAJENE, SULAWESI BARAT",19,72,57,129
https://kawalpemilu.org#76094,"LABUANG, BANGGAE TIMUR, MAJENE, SULAWESI BARAT",20,81,75,156
https://kawalpemilu.org#76094,"LABUANG, BANGGAE TIMUR, MAJENE, SULAWESI BARAT",21,136,92,228
https://kawalpemilu.org#76095,"TANDE, BANGGAE TIMUR, MAJENE, SULAWESI BARAT",1,38,213,251
https://kawalpemilu.org#76095,"TANDE, BANGGAE TIMUR, MAJENE, SULAWESI BARAT",2,60,93,153
https://kawalpemilu.org#76095,"TANDE, BANGGAE TIMUR, MAJENE, SULAWESI BARAT",3,61,82,143
https://kawalpemilu.org#76095,"TANDE, BANGGAE TIMUR, MAJENE, SULAWESI BARAT",4,46,136,182
https://kawalpemilu.org#76095,"TANDE, BANGGAE TIMUR, MAJENE, SULAWESI BARAT",5,32,106,138
https://kawalpemilu.org#76095,"TANDE, BANGGAE TIMUR, MAJENE, SULAWESI BARAT",6,58,106,164
https://kawalpemilu.org#87642,"LEMBANG, BANGGAE TIMUR, MAJENE, SULAWESI BARAT",1,119,123,242
https://kawalpemilu.org#87642,"LEMBANG, BANGGAE TIMUR, MAJENE, SULAWESI BARAT",2,112,118,230
https://kawalpemilu.org#87642,"LEMBANG, BANGGAE TIMUR, MAJENE, SULAWESI BARAT",3,76,86,162
https://kawalpemilu.org#87642,"LEMBANG, BANGGAE TIMUR, MAJENE, SULAWESI BARAT",4,126,94,220
https://kawalpemilu.org#87642,"LEMBANG, BANGGAE TIMUR, MAJENE, SULAWESI BARAT",5,103,117,220
https://kawalpemilu.org#87642,"LEMBANG, BANGGAE TIMUR, MAJENE, SULAWESI BARAT",6,94,106,200
https://kawalpemilu.org#87642,"LEMBANG, BANGGAE TIMUR, MAJENE, SULAWESI BARAT",7,86,109,195
https://kawalpemilu.org#87642,"LEMBANG, BANGGAE TIMUR, MAJENE, SULAWESI BARAT",8,62,67,129
https://kawalpemilu.org#87642,"LEMBANG, BANGGAE TIMUR, MAJENE, SULAWESI BARAT",9,81,97,178
https://kawalpemilu.org#87642,"LEMBANG, BANGGAE TIMUR, MAJENE, SULAWESI BARAT",10,177,101,278
https://kawalpemilu.org#87642,"LEMBANG, BANGGAE TIMUR, MAJENE, SULAWESI BARAT",11,255,39,294
https://kawalpemilu.org#87642,"LEMBANG, BANGGAE TIMUR, MAJENE, SULAWESI BARAT",14,48,110,158
https://kawalpemilu.org#87642,"LEMBANG, BANGGAE TIMUR, MAJENE, SULAWESI BARAT",15,84,114,198
https://kawalpemilu.org#87642,"LEMBANG, BANGGAE TIMUR, MAJENE, SULAWESI BARAT",16,86,85,171
https://kawalpemilu.org#87642,"LEMBANG, BANGGAE TIMUR, MAJENE, SULAWESI BARAT",17,100,85,185
https://kawalpemilu.org#87643,"LABUANG UTARA, BANGGAE TIMUR, MAJENE, SULAWESI BARAT",1,182,52,234
https://kawalpemilu.org#87643,"LABUANG UTARA, BANGGAE TIMUR, MAJENE, SULAWESI BARAT",2,133,102,235
https://kawalpemilu.org#87643,"LABUANG UTARA, BANGGAE TIMUR, MAJENE, SULAWESI BARAT",3,108,111,219
https://kawalpemilu.org#87643,"LABUANG UTARA, BANGGAE TIMUR, MAJENE, SULAWESI BARAT",4,72,95,167
https://kawalpemilu.org#87643,"LABUANG UTARA, BANGGAE TIMUR, MAJENE, SULAWESI BARAT",5,120,96,216
https://kawalpemilu.org#87643,"LABUANG UTARA, BANGGAE TIMUR, MAJENE, SULAWESI BARAT",6,161,83,244
https://kawalpemilu.org#87643,"LABUANG UTARA, BANGGAE TIMUR, MAJENE, SULAWESI BARAT",7,61,113,174
https://kawalpemilu.org#87643,"LABUANG UTARA, BANGGAE TIMUR, MAJENE, SULAWESI BARAT",8,142,119,261
https://kawalpemilu.org#87643,"LABUANG UTARA, BANGGAE TIMUR, MAJENE, SULAWESI BARAT",9,118,142,260
https://kawalpemilu.org#87643,"LABUANG UTARA, BANGGAE TIMUR, MAJENE, SULAWESI BARAT",10,117,118,235
https://kawalpemilu.org#87643,"LABUANG UTARA, BANGGAE TIMUR, MAJENE, SULAWESI BARAT",11,80,91,171
https://kawalpemilu.org#87643,"LABUANG UTARA, BANGGAE TIMUR, MAJENE, SULAWESI BARAT",12,126,119,245
https://kawalpemilu.org#87643,"LABUANG UTARA, BANGGAE TIMUR, MAJENE, SULAWESI BARAT",13,87,94,181
https://kawalpemilu.org#87643,"LABUANG UTARA, BANGGAE TIMUR, MAJENE, SULAWESI BARAT",14,141,126,267
https://kawalpemilu.org#87643,"LABUANG UTARA, BANGGAE TIMUR, MAJENE, SULAWESI BARAT",15,132,122,254
https://kawalpemilu.org#87643,"LABUANG UTARA, BANGGAE TIMUR, MAJENE, SULAWESI BARAT",16,84,161,245
https://kawalpemilu.org#87644,"TANDE TIMUR, BANGGAE TIMUR, MAJENE, SULAWESI BARAT",1,65,110,175
https://kawalpemilu.org#87644,"TANDE TIMUR, BANGGAE TIMUR, MAJENE, SULAWESI BARAT",2,80,86,166
https://kawalpemilu.org#87644,"TANDE TIMUR, BANGGAE TIMUR, MAJENE, SULAWESI BARAT",3,63,107,170
https://kawalpemilu.org#87644,"TANDE TIMUR, BANGGAE TIMUR, MAJENE, SULAWESI BARAT",4,75,93,168
https://kawalpemilu.org#87644,"TANDE TIMUR, BANGGAE TIMUR, MAJENE, SULAWESI BARAT",5,104,147,251
https://kawalpemilu.org#87644,"TANDE TIMUR, BANGGAE TIMUR, MAJENE, SULAWESI BARAT",6,54,63,117
https://kawalpemilu.org#87644,"TANDE TIMUR, BANGGAE TIMUR, MAJENE, SULAWESI BARAT",7,72,76,148
https://kawalpemilu.org#87645,"BUTTU BARUGA, BANGGAE TIMUR, MAJENE, SULAWESI BARAT",1,165,58,223
https://kawalpemilu.org#87645,"BUTTU BARUGA, BANGGAE TIMUR, MAJENE, SULAWESI BARAT",2,143,100,243
https://kawalpemilu.org#75550,"BABANA, BUDONG-BUDONG, MAMUJU TENGAH, SULAWESI BARAT",1,158,95,253
https://kawalpemilu.org#75550,"BABANA, BUDONG-BUDONG, MAMUJU TENGAH, SULAWESI BARAT",2,210,50,260
https://kawalpemilu.org#75550,"BABANA, BUDONG-BUDONG, MAMUJU TENGAH, SULAWESI BARAT",3,128,91,219
https://kawalpemilu.org#75550,"BABANA, BUDONG-BUDONG, MAMUJU TENGAH, SULAWESI BARAT",4,177,74,251
https://kawalpemilu.org#75550,"BABANA, BUDONG-BUDONG, MAMUJU TENGAH, SULAWESI BARAT",5,166,113,279
https://kawalpemilu.org#75550,"BABANA, BUDONG-BUDONG, MAMUJU TENGAH, SULAWESI BARAT",6,147,74,221
https://kawalpemilu.org#75550,"BABANA, BUDONG-BUDONG, MAMUJU TENGAH, SULAWESI BARAT",7,144,63,207
https://kawalpemilu.org#75550,"BABANA, BUDONG-BUDONG, MAMUJU TENGAH, SULAWESI BARAT",8,164,73,237
https://kawalpemilu.org#75550,"BABANA, BUDONG-BUDONG, MAMUJU TENGAH, SULAWESI BARAT",9,151,36,187
https://kawalpemilu.org#75550,"BABANA, BUDONG-BUDONG, MAMUJU TENGAH, SULAWESI BARAT",10,75,182,257
https://kawalpemilu.org#75550,"BABANA, BUDONG-BUDONG, MAMUJU TENGAH, SULAWESI BARAT",11,108,8,116
https://kawalpemilu.org#75550,"BABANA, BUDONG-BUDONG, MAMUJU TENGAH, SULAWESI BARAT",12,176,26,202
https://kawalpemilu.org#75550,"BABANA, BUDONG-BUDONG, MAMUJU TENGAH, SULAWESI BARAT",13,144,127,271
https://kawalpemilu.org#75550,"BABANA, BUDONG-BUDONG, MAMUJU TENGAH, SULAWESI BARAT",14,120,35,155
https://kawalpemilu.org#75550,"BABANA, BUDONG-BUDONG, MAMUJU TENGAH, SULAWESI BARAT",15,147,49,196
https://kawalpemilu.org#75550,"BABANA, BUDONG-BUDONG, MAMUJU TENGAH, SULAWESI BARAT",16,134,72,206
https://kawalpemilu.org#75551,"LUMU, BUDONG-BUDONG, MAMUJU TENGAH, SULAWESI BARAT",1,149,62,211
https://kawalpemilu.org#75551,"LUMU, BUDONG-BUDONG, MAMUJU TENGAH, SULAWESI BARAT",2,123,66,189
https://kawalpemilu.org#75551,"LUMU, BUDONG-BUDONG, MAMUJU TENGAH, SULAWESI BARAT",3,135,125,260
https://kawalpemilu.org#75551,"LUMU, BUDONG-BUDONG, MAMUJU TENGAH, SULAWESI BARAT",4,154,78,232
https://kawalpemilu.org#75551,"LUMU, BUDONG-BUDONG, MAMUJU TENGAH, SULAWESI BARAT",5,121,34,155
https://kawalpemilu.org#75551,"LUMU, BUDONG-BUDONG, MAMUJU TENGAH, SULAWESI BARAT",6,120,87,207
https://kawalpemilu.org#75552,"PONTANAKAYANG, BUDONG-BUDONG, MAMUJU TENGAH, SULAWESI BARAT",1,143,117,260
https://kawalpemilu.org#75552,"PONTANAKAYANG, BUDONG-BUDONG, MAMUJU TENGAH, SULAWESI BARAT",2,140,45,185
https://kawalpemilu.org#75552,"PONTANAKAYANG, BUDONG-BUDONG, MAMUJU TENGAH, SULAWESI BARAT",3,135,123,258
https://kawalpemilu.org#75552,"PONTANAKAYANG, BUDONG-BUDONG, MAMUJU TENGAH, SULAWESI BARAT",4,111,71,182
https://kawalpemilu.org#75552,"PONTANAKAYANG, BUDONG-BUDONG, MAMUJU TENGAH, SULAWESI BARAT",5,127,107,234
https://kawalpemilu.org#75552,"PONTANAKAYANG, BUDONG-BUDONG, MAMUJU TENGAH, SULAWESI BARAT",6,123,84,207
https://kawalpemilu.org#75552,"PONTANAKAYANG, BUDONG-BUDONG, MAMUJU TENGAH, SULAWESI BARAT",7,90,110,200
https://kawalpemilu.org#75552,"PONTANAKAYANG, BUDONG-BUDONG, MAMUJU TENGAH, SULAWESI BARAT",8,102,57,159
https://kawalpemilu.org#75553,"SALUGATTA, BUDONG-BUDONG, MAMUJU TENGAH, SULAWESI BARAT",1,154,73,227
https://kawalpemilu.org#75553,"SALUGATTA, BUDONG-BUDONG, MAMUJU TENGAH, SULAWESI BARAT",2,165,83,248
https://kawalpemilu.org#75553,"SALUGATTA, BUDONG-BUDONG, MAMUJU TENGAH, SULAWESI BARAT",3,183,68,251
https://kawalpemilu.org#75553,"SALUGATTA, BUDONG-BUDONG, MAMUJU TENGAH, SULAWESI BARAT",4,111,133,244
https://kawalpemilu.org#75553,"SALUGATTA, BUDONG-BUDONG, MAMUJU TENGAH, SULAWESI BARAT",5,105,149,254
https://kawalpemilu.org#75553,"SALUGATTA, BUDONG-BUDONG, MAMUJU TENGAH, SULAWESI BARAT",6,87,124,211
https://kawalpemilu.org#75553,"SALUGATTA, BUDONG-BUDONG, MAMUJU TENGAH, SULAWESI BARAT",7,77,135,213
https://kawalpemilu.org#75553,"SALUGATTA, BUDONG-BUDONG, MAMUJU TENGAH, SULAWESI BARAT",8,210,78,288
https://kawalpemilu.org#75554,"KIRE, BUDONG-BUDONG, MAMUJU TENGAH, SULAWESI BARAT",1,119,43,162
https://kawalpemilu.org#75554,"KIRE, BUDONG-BUDONG, MAMUJU TENGAH, SULAWESI BARAT",2,83,49,132
https://kawalpemilu.org#75554,"KIRE, BUDONG-BUDONG, MAMUJU TENGAH, SULAWESI BARAT",3,153,73,226
https://kawalpemilu.org#75554,"KIRE, BUDONG-BUDONG, MAMUJU TENGAH, SULAWESI BARAT",4,174,89,263
https://kawalpemilu.org#75554,"KIRE, BUDONG-BUDONG, MAMUJU TENGAH, SULAWESI BARAT",5,87,11,98
https://kawalpemilu.org#75554,"KIRE, BUDONG-BUDONG, MAMUJU TENGAH, SULAWESI BARAT",6,98,62,160
https://kawalpemilu.org#75554,"KIRE, BUDONG-BUDONG, MAMUJU TENGAH, SULAWESI BARAT",7,170,36,206
https://kawalpemilu.org#75554,"KIRE, BUDONG-BUDONG, MAMUJU TENGAH, SULAWESI BARAT",8,63,32,95
https://kawalpemilu.org#75554,"KIRE, BUDONG-BUDONG, MAMUJU TENGAH, SULAWESI BARAT",9,117,39,156
https://kawalpemilu.org#75555,"TINALI, BUDONG-BUDONG, MAMUJU TENGAH, SULAWESI BARAT",1,194,52,246
https://kawalpemilu.org#75555,"TINALI, BUDONG-BUDONG, MAMUJU TENGAH, SULAWESI BARAT",2,167,34,201
https://kawalpemilu.org#75555,"TINALI, BUDONG-BUDONG, MAMUJU TENGAH, SULAWESI BARAT",3,118,137,255
https://kawalpemilu.org#75555,"TINALI, BUDONG-BUDONG, MAMUJU TENGAH, SULAWESI BARAT",4,128,76,204
https://kawalpemilu.org#75556,"SALUMANURUNG, BUDONG-BUDONG, MAMUJU TENGAH, SULAWESI BARAT",1,144,102,246
https://kawalpemilu.org#75556,"SALUMANURUNG, BUDONG-BUDONG, MAMUJU TENGAH, SULAWESI BARAT",2,178,78,256
https://kawalpemilu.org#75556,"SALUMANURUNG, BUDONG-BUDONG, MAMUJU TENGAH, SULAWESI BARAT",3,119,80,199
https://kawalpemilu.org#75556,"SALUMANURUNG, BUDONG-BUDONG, MAMUJU TENGAH, SULAWESI BARAT",4,89,33,122
https://kawalpemilu.org#75557,"PASSAPA, BUDONG-BUDONG, MAMUJU TENGAH, SULAWESI BARAT",1,160,31,191
https://kawalpemilu.org#75557,"PASSAPA, BUDONG-BUDONG, MAMUJU TENGAH, SULAWESI BARAT",2,130,26,156
https://kawalpemilu.org#75557,"PASSAPA, BUDONG-BUDONG, MAMUJU TENGAH, SULAWESI BARAT",3,137,12,149
https://kawalpemilu.org#75557,"PASSAPA, BUDONG-BUDONG, MAMUJU TENGAH, SULAWESI BARAT",4,108,3,111
https://kawalpemilu.org#75557,"PASSAPA, BUDONG-BUDONG, MAMUJU TENGAH, SULAWESI BARAT",5,172,2,174
https://kawalpemilu.org#75558,"BOJO, BUDONG-BUDONG, MAMUJU TENGAH, SULAWESI BARAT",1,188,70,258
https://kawalpemilu.org#75558,"BOJO, BUDONG-BUDONG, MAMUJU TENGAH, SULAWESI BARAT",2,70,47,117
https://kawalpemilu.org#75558,"BOJO, BUDONG-BUDONG, MAMUJU TENGAH, SULAWESI BARAT",3,70,50,120
https://kawalpemilu.org#75558,"BOJO, BUDONG-BUDONG, MAMUJU TENGAH, SULAWESI BARAT",4,99,108,207
https://kawalpemilu.org#75558,"BOJO, BUDONG-BUDONG, MAMUJU TENGAH, SULAWESI BARAT",5,236,13,249
https://kawalpemilu.org#75559,"BARAKKANG, BUDONG-BUDONG, MAMUJU TENGAH, SULAWESI BARAT",1,98,74,172
https://kawalpemilu.org#75559,"BARAKKANG, BUDONG-BUDONG, MAMUJU TENGAH, SULAWESI BARAT",2,133,52,185
https://kawalpemilu.org#75559,"BARAKKANG, BUDONG-BUDONG, MAMUJU TENGAH, SULAWESI BARAT",3,169,39,208
https://kawalpemilu.org#75559,"BARAKKANG, BUDONG-BUDONG, MAMUJU TENGAH, SULAWESI BARAT",4,50,39,89
https://kawalpemilu.org#75559,"BARAKKANG, BUDONG-BUDONG, MAMUJU TENGAH, SULAWESI BARAT",5,98,42,140
https://kawalpemilu.org#75559,"BARAKKANG, BUDONG-BUDONG, MAMUJU TENGAH, SULAWESI BARAT",6,111,26,137
https://kawalpemilu.org#75560,"LEMBAH HADA, BUDONG-BUDONG, MAMUJU TENGAH, SULAWESI BARAT",1,52,101,153
https://kawalpemilu.org#75560,"LEMBAH HADA, BUDONG-BUDONG, MAMUJU TENGAH, SULAWESI BARAT",2,107,28,135
https://kawalpemilu.org#75562,"POLO PANGALE, PANGALE, MAMUJU TENGAH, SULAWESI BARAT",1,117,33,150
https://kawalpemilu.org#75562,"POLO PANGALE, PANGALE, MAMUJU TENGAH, SULAWESI BARAT",2,117,60,177
https://kawalpemilu.org#75562,"POLO PANGALE, PANGALE, MAMUJU TENGAH, SULAWESI BARAT",3,64,93,3
https://kawalpemilu.org#75562,"POLO PANGALE, PANGALE, MAMUJU TENGAH, SULAWESI BARAT",4,127,20,147
https://kawalpemilu.org#75562,"POLO PANGALE, PANGALE, MAMUJU TENGAH, SULAWESI BARAT",5,32,12,44
https://kawalpemilu.org#75562,"POLO PANGALE, PANGALE, MAMUJU TENGAH, SULAWESI BARAT",6,115,24,139
https://kawalpemilu.org#75562,"POLO PANGALE, PANGALE, MAMUJU TENGAH, SULAWESI BARAT",7,127,59,186
https://kawalpemilu.org#75562,"POLO PANGALE, PANGALE, MAMUJU TENGAH, SULAWESI BARAT",8,114,59,173
https://kawalpemilu.org#75563,"PANGALE, PANGALE, MAMUJU TENGAH, SULAWESI BARAT",1,134,89,223
https://kawalpemilu.org#75563,"PANGALE, PANGALE, MAMUJU TENGAH, SULAWESI BARAT",2,131,66,197
https://kawalpemilu.org#75563,"PANGALE, PANGALE, MAMUJU TENGAH, SULAWESI BARAT",3,218,38,256
https://kawalpemilu.org#75563,"PANGALE, PANGALE, MAMUJU TENGAH, SULAWESI BARAT",4,167,65,232
https://kawalpemilu.org#75563,"PANGALE, PANGALE, MAMUJU TENGAH, SULAWESI BARAT",5,141,59,200
https://kawalpemilu.org#75564,"SARTANAMAJU, PANGALE, MAMUJU TENGAH, SULAWESI BARAT",1,96,54,150
https://kawalpemilu.org#75564,"SARTANAMAJU, PANGALE, MAMUJU TENGAH, SULAWESI BARAT",2,148,40,188
https://kawalpemilu.org#75565,"POLO LERENG, PANGALE, MAMUJU TENGAH, SULAWESI BARAT",1,145,52,197
https://kawalpemilu.org#75565,"POLO LERENG, PANGALE, MAMUJU TENGAH, SULAWESI BARAT",2,119,21,140
https://kawalpemilu.org#75565,"POLO LERENG, PANGALE, MAMUJU TENGAH, SULAWESI BARAT",3,132,27,159
https://kawalpemilu.org#75565,"POLO LERENG, PANGALE, MAMUJU TENGAH, SULAWESI BARAT",4,109,48,157
https://kawalpemilu.org#75565,"POLO LERENG, PANGALE, MAMUJU TENGAH, SULAWESI BARAT",5,144,30,174
https://kawalpemilu.org#75565,"POLO LERENG, PANGALE, MAMUJU TENGAH, SULAWESI BARAT",6,80,89,169
https://kawalpemilu.org#75565,"POLO LERENG, PANGALE, MAMUJU TENGAH, SULAWESI BARAT",7,122,13,135
https://kawalpemilu.org#75566,"KUO, PANGALE, MAMUJU TENGAH, SULAWESI BARAT",1,117,71,188
https://kawalpemilu.org#75566,"KUO, PANGALE, MAMUJU TENGAH, SULAWESI BARAT",2,212,50,262
https://kawalpemilu.org#75566,"KUO, PANGALE, MAMUJU TENGAH, SULAWESI BARAT",3,80,56,136
https://kawalpemilu.org#75566,"KUO, PANGALE, MAMUJU TENGAH, SULAWESI BARAT",4,171,50,221
https://kawalpemilu.org#75566,"KUO, PANGALE, MAMUJU TENGAH, SULAWESI BARAT",5,174,50,224
https://kawalpemilu.org#75566,"KUO, PANGALE, MAMUJU TENGAH, SULAWESI BARAT",6,90,76,166
https://kawalpemilu.org#75566,"KUO, PANGALE, MAMUJU TENGAH, SULAWESI BARAT",7,132,49,181
https://kawalpemilu.org#75566,"KUO, PANGALE, MAMUJU TENGAH, SULAWESI BARAT",8,90,63,153
https://kawalpemilu.org#75566,"KUO, PANGALE, MAMUJU TENGAH, SULAWESI BARAT",9,98,79,177
https://kawalpemilu.org#75567,"POLO CAMBA, PANGALE, MAMUJU TENGAH, SULAWESI BARAT",1,137,28,165
https://kawalpemilu.org#75567,"POLO CAMBA, PANGALE, MAMUJU TENGAH, SULAWESI BARAT",2,169,14,183
https://kawalpemilu.org#75567,"POLO CAMBA, PANGALE, MAMUJU TENGAH, SULAWESI BARAT",3,105,87,192
https://kawalpemilu.org#75568,"LAMBA-LAMBA, PANGALE, MAMUJU TENGAH, SULAWESI BARAT",1,76,38,114
https://kawalpemilu.org#75568,"LAMBA-LAMBA, PANGALE, MAMUJU TENGAH, SULAWESI BARAT",2,108,52,160
https://kawalpemilu.org#75568,"LAMBA-LAMBA, PANGALE, MAMUJU TENGAH, SULAWESI BARAT",3,89,71,160
https://kawalpemilu.org#75568,"LAMBA-LAMBA, PANGALE, MAMUJU TENGAH, SULAWESI BARAT",4,118,36,154
https://kawalpemilu.org#75569,"KOMBILING, PANGALE, MAMUJU TENGAH, SULAWESI BARAT",1,138,60,198
https://kawalpemilu.org#75569,"KOMBILING, PANGALE, MAMUJU TENGAH, SULAWESI BARAT",2,132,76,208
https://kawalpemilu.org#75569,"KOMBILING, PANGALE, MAMUJU TENGAH, SULAWESI BARAT",3,119,109,228
https://kawalpemilu.org#75569,"KOMBILING, PANGALE, MAMUJU TENGAH, SULAWESI BARAT",4,59,38,97
https://kawalpemilu.org#75569,"KOMBILING, PANGALE, MAMUJU TENGAH, SULAWESI BARAT",5,111,76,187
https://kawalpemilu.org#75570,"LEMO-LEMO, PANGALE, MAMUJU TENGAH, SULAWESI BARAT",1,143,59,202
https://kawalpemilu.org#75570,"LEMO-LEMO, PANGALE, MAMUJU TENGAH, SULAWESI BARAT",2,151,36,187
https://kawalpemilu.org#75570,"LEMO-LEMO, PANGALE, MAMUJU TENGAH, SULAWESI BARAT",3,98,31,129
https://kawalpemilu.org#75590,"BUDONG-BUDONG, TOPOYO, MAMUJU TENGAH, SULAWESI BARAT",1,135,75,210
https://kawalpemilu.org#75590,"BUDONG-BUDONG, TOPOYO, MAMUJU TENGAH, SULAWESI BARAT",2,213,13,226
https://kawalpemilu.org#75590,"BUDONG-BUDONG, TOPOYO, MAMUJU TENGAH, SULAWESI BARAT",3,176,73,249
https://kawalpemilu.org#75590,"BUDONG-BUDONG, TOPOYO, MAMUJU TENGAH, SULAWESI BARAT",4,103,25,128
https://kawalpemilu.org#75590,"BUDONG-BUDONG, TOPOYO, MAMUJU TENGAH, SULAWESI BARAT",5,172,14,186
https://kawalpemilu.org#75590,"BUDONG-BUDONG, TOPOYO, MAMUJU TENGAH, SULAWESI BARAT",6,115,32,147
https://kawalpemilu.org#75590,"BUDONG-BUDONG, TOPOYO, MAMUJU TENGAH, SULAWESI BARAT",7,103,29,132
https://kawalpemilu.org#75591,"TOPOYO, TOPOYO, MAMUJU TENGAH, SULAWESI BARAT",1,133,96,229
https://kawalpemilu.org#75591,"TOPOYO, TOPOYO, MAMUJU TENGAH, SULAWESI BARAT",2,130,110,240
https://kawalpemilu.org#75591,"TOPOYO, TOPOYO, MAMUJU TENGAH, SULAWESI BARAT",3,149,87,236
https://kawalpemilu.org#75591,"TOPOYO, TOPOYO, MAMUJU TENGAH, SULAWESI BARAT",4,150,96,246
https://kawalpemilu.org#75591,"TOPOYO, TOPOYO, MAMUJU TENGAH, SULAWESI BARAT",5,157,86,243
https://kawalpemilu.org#75591,"TOPOYO, TOPOYO, MAMUJU TENGAH, SULAWESI BARAT",6,148,112,260
https://kawalpemilu.org#75591,"TOPOYO, TOPOYO, MAMUJU TENGAH, SULAWESI BARAT",7,130,86,216
https://kawalpemilu.org#75591,"TOPOYO, TOPOYO, MAMUJU TENGAH, SULAWESI BARAT",8,169,82,251
https://kawalpemilu.org#75591,"TOPOYO, TOPOYO, MAMUJU TENGAH, SULAWESI BARAT",9,147,112,259
https://kawalpemilu.org#75591,"TOPOYO, TOPOYO, MAMUJU TENGAH, SULAWESI BARAT",10,185,89,274
https://kawalpemilu.org#75591,"TOPOYO, TOPOYO, MAMUJU TENGAH, SULAWESI BARAT",11,175,94,269
https://kawalpemilu.org#75591,"TOPOYO, TOPOYO, MAMUJU TENGAH, SULAWESI BARAT",12,130,89,219
https://kawalpemilu.org#75591,"TOPOYO, TOPOYO, MAMUJU TENGAH, SULAWESI BARAT",13,136,114,250
https://kawalpemilu.org#75591,"TOPOYO, TOPOYO, MAMUJU TENGAH, SULAWESI BARAT",14,147,98,245
https://kawalpemilu.org#75591,"TOPOYO, TOPOYO, MAMUJU TENGAH, SULAWESI BARAT",15,161,105,266
https://kawalpemilu.org#75591,"TOPOYO, TOPOYO, MAMUJU TENGAH, SULAWESI BARAT",16,147,102,249
https://kawalpemilu.org#75591,"TOPOYO, TOPOYO, MAMUJU TENGAH, SULAWESI BARAT",17,90,82,172
https://kawalpemilu.org#75592,"TUMBU, TOPOYO, MAMUJU TENGAH, SULAWESI BARAT",1,206,29,235
https://kawalpemilu.org#75592,"TUMBU, TOPOYO, MAMUJU TENGAH, SULAWESI BARAT",2,189,31,220
https://kawalpemilu.org#75592,"TUMBU, TOPOYO, MAMUJU TENGAH, SULAWESI BARAT",3,118,22,140
https://kawalpemilu.org#75592,"TUMBU, TOPOYO, MAMUJU TENGAH, SULAWESI BARAT",4,116,56,172
https://kawalpemilu.org#75592,"TUMBU, TOPOYO, MAMUJU TENGAH, SULAWESI BARAT",5,197,44,241
https://kawalpemilu.org#75592,"TUMBU, TOPOYO, MAMUJU TENGAH, SULAWESI BARAT",6,156,19,175
https://kawalpemilu.org#75592,"TUMBU, TOPOYO, MAMUJU TENGAH, SULAWESI BARAT",7,123,31,154
https://kawalpemilu.org#75592,"TUMBU, TOPOYO, MAMUJU TENGAH, SULAWESI BARAT",8,167,36,203
https://kawalpemilu.org#75593,"KABUBU, TOPOYO, MAMUJU TENGAH, SULAWESI BARAT",1,150,34,184
https://kawalpemilu.org#75593,"KABUBU, TOPOYO, MAMUJU TENGAH, SULAWESI BARAT",2,138,57,195
https://kawalpemilu.org#75593,"KABUBU, TOPOYO, MAMUJU TENGAH, SULAWESI BARAT",3,165,25,190
https://kawalpemilu.org#75593,"KABUBU, TOPOYO, MAMUJU TENGAH, SULAWESI BARAT",4,201,49,250
https://kawalpemilu.org#75594,"WAEPUTEH, TOPOYO, MAMUJU TENGAH, SULAWESI BARAT",1,184,73,257
https://kawalpemilu.org#75594,"WAEPUTEH, TOPOYO, MAMUJU TENGAH, SULAWESI BARAT",2,194,53,247
https://kawalpemilu.org#75594,"WAEPUTEH, TOPOYO, MAMUJU TENGAH, SULAWESI BARAT",3,193,51,244
https://kawalpemilu.org#75595,"TANGKAU, TOPOYO, MAMUJU TENGAH, SULAWESI BARAT",1,103,55,158
https://kawalpemilu.org#75595,"TANGKAU, TOPOYO, MAMUJU TENGAH, SULAWESI BARAT",2,170,18,188
https://kawalpemilu.org#75596,"TABOLANG, TOPOYO, MAMUJU TENGAH, SULAWESI BARAT",1,215,73,288
https://kawalpemilu.org#75596,"TABOLANG, TOPOYO, MAMUJU TENGAH, SULAWESI BARAT",2,152,123,275
https://kawalpemilu.org#75596,"TABOLANG, TOPOYO, MAMUJU TENGAH, SULAWESI BARAT",3,201,66,267
https://kawalpemilu.org#75596,"TABOLANG, TOPOYO, MAMUJU TENGAH, SULAWESI BARAT",4,154,49,203
https://kawalpemilu.org#75596,"TABOLANG, TOPOYO, MAMUJU TENGAH, SULAWESI BARAT",5,179,50,229
https://kawalpemilu.org#75596,"TABOLANG, TOPOYO, MAMUJU TENGAH, SULAWESI BARAT",6,160,59,219
https://kawalpemilu.org#75596,"TABOLANG, TOPOYO, MAMUJU TENGAH, SULAWESI BARAT",7,179,85,264
https://kawalpemilu.org#75597,"PARAILI, TOPOYO, MAMUJU TENGAH, SULAWESI BARAT",1,131,147,278
https://kawalpemilu.org#75597,"PARAILI, TOPOYO, MAMUJU TENGAH, SULAWESI BARAT",2,224,25,249
https://kawalpemilu.org#75597,"PARAILI, TOPOYO, MAMUJU TENGAH, SULAWESI BARAT",3,157,96,253
https://kawalpemilu.org#75598,"SALUPANGKANG, TOPOYO, MAMUJU TENGAH, SULAWESI BARAT",1,211,21,232
https://kawalpemilu.org#75598,"SALUPANGKANG, TOPOYO, MAMUJU TENGAH, SULAWESI BARAT",2,163,12,175
https://kawalpemilu.org#75598,"SALUPANGKANG, TOPOYO, MAMUJU TENGAH, SULAWESI BARAT",3,206,33,239
https://kawalpemilu.org#75598,"SALUPANGKANG, TOPOYO, MAMUJU TENGAH, SULAWESI BARAT",4,122,40,162
https://kawalpemilu.org#75598,"SALUPANGKANG, TOPOYO, MAMUJU TENGAH, SULAWESI BARAT",5,164,5,169
https://kawalpemilu.org#75598,"SALUPANGKANG, TOPOYO, MAMUJU TENGAH, SULAWESI BARAT",6,147,36,183
https://kawalpemilu.org#75599,"SALUPANGKANG IV, TOPOYO, MAMUJU TENGAH, SULAWESI BARAT",1,154,49,203
https://kawalpemilu.org#75600,"TAPPILINA, TOPOYO, MAMUJU TENGAH, SULAWESI BARAT",1,158,62,220
https://kawalpemilu.org#75600,"TAPPILINA, TOPOYO, MAMUJU TENGAH, SULAWESI BARAT",2,149,47,196
https://kawalpemilu.org#75600,"TAPPILINA, TOPOYO, MAMUJU TENGAH, SULAWESI BARAT",3,222,5,227
https://kawalpemilu.org#75600,"TAPPILINA, TOPOYO, MAMUJU TENGAH, SULAWESI BARAT",4,140,23,163
https://kawalpemilu.org#75601,"BAMBAMANURUNG, TOPOYO, MAMUJU TENGAH, SULAWESI BARAT",1,163,27,190
https://kawalpemilu.org#75601,"BAMBAMANURUNG, TOPOYO, MAMUJU TENGAH, SULAWESI BARAT",2,205,45,250
https://kawalpemilu.org#75601,"BAMBAMANURUNG, TOPOYO, MAMUJU TENGAH, SULAWESI BARAT",3,141,64,205
https://kawalpemilu.org#75602,"SALULE'BO, TOPOYO, MAMUJU TENGAH, SULAWESI BARAT",1,192,49,241
https://kawalpemilu.org#75602,"SALULE'BO, TOPOYO, MAMUJU TENGAH, SULAWESI BARAT",2,73,58,132
https://kawalpemilu.org#75602,"SALULE'BO, TOPOYO, MAMUJU TENGAH, SULAWESI BARAT",3,186,74,260
https://kawalpemilu.org#75602,"SALULE'BO, TOPOYO, MAMUJU TENGAH, SULAWESI BARAT",4,166,66,232
https://kawalpemilu.org#75602,"SALULE'BO, TOPOYO, MAMUJU TENGAH, SULAWESI BARAT",5,132,73,205
https://kawalpemilu.org#75602,"SALULE'BO, TOPOYO, MAMUJU TENGAH, SULAWESI BARAT",6,109,23,132
https://kawalpemilu.org#75602,"SALULE'BO, TOPOYO, MAMUJU TENGAH, SULAWESI BARAT",7,142,5,147
https://kawalpemilu.org#75602,"SALULE'BO, TOPOYO, MAMUJU TENGAH, SULAWESI BARAT",8,106,21,127
https://kawalpemilu.org#75602,"SALULE'BO, TOPOYO, MAMUJU TENGAH, SULAWESI BARAT",9,93,11,104
https://kawalpemilu.org#75603,"PANGALLOANG, TOPOYO, MAMUJU TENGAH, SULAWESI BARAT",1,142,20,162
https://kawalpemilu.org#75603,"PANGALLOANG, TOPOYO, MAMUJU TENGAH, SULAWESI BARAT",2,121,27,148
https://kawalpemilu.org#75603,"PANGALLOANG, TOPOYO, MAMUJU TENGAH, SULAWESI BARAT",3,142,51,193
https://kawalpemilu.org#75603,"PANGALLOANG, TOPOYO, MAMUJU TENGAH, SULAWESI BARAT",4,142,57,199
https://kawalpemilu.org#75603,"PANGALLOANG, TOPOYO, MAMUJU TENGAH, SULAWESI BARAT",5,133,26,159
https://kawalpemilu.org#75604,"SINABATTA, TOPOYO, MAMUJU TENGAH, SULAWESI BARAT",1,149,39,188
https://kawalpemilu.org#75604,"SINABATTA, TOPOYO, MAMUJU TENGAH, SULAWESI BARAT",2,169,58,227
https://kawalpemilu.org#75604,"SINABATTA, TOPOYO, MAMUJU TENGAH, SULAWESI BARAT",3,133,20,153
https://kawalpemilu.org#75606,"KAROSSA, KAROSSA, MAMUJU TENGAH, SULAWESI BARAT",1,77,63,140
https://kawalpemilu.org#75606,"KAROSSA, KAROSSA, MAMUJU TENGAH, SULAWESI BARAT",2,135,48,183
https://kawalpemilu.org#75606,"KAROSSA, KAROSSA, MAMUJU TENGAH, SULAWESI BARAT",3,122,76,198
https://kawalpemilu.org#75606,"KAROSSA, KAROSSA, MAMUJU TENGAH, SULAWESI BARAT",4,135,105,240
https://kawalpemilu.org#75606,"KAROSSA, KAROSSA, MAMUJU TENGAH, SULAWESI BARAT",5,162,79,241
https://kawalpemilu.org#75606,"KAROSSA, KAROSSA, MAMUJU TENGAH, SULAWESI BARAT",6,142,74,216
https://kawalpemilu.org#75606,"KAROSSA, KAROSSA, MAMUJU TENGAH, SULAWESI BARAT",7,174,63,283
https://kawalpemilu.org#75606,"KAROSSA, KAROSSA, MAMUJU TENGAH, SULAWESI BARAT",8,173,82,255
https://kawalpemilu.org#75606,"KAROSSA, KAROSSA, MAMUJU TENGAH, SULAWESI BARAT",9,129,87,216
https://kawalpemilu.org#75606,"KAROSSA, KAROSSA, MAMUJU TENGAH, SULAWESI BARAT",10,185,49,234
https://kawalpemilu.org#75606,"KAROSSA, KAROSSA, MAMUJU TENGAH, SULAWESI BARAT",11,151,40,191
https://kawalpemilu.org#75606,"KAROSSA, KAROSSA, MAMUJU TENGAH, SULAWESI BARAT",12,113,81,194
https://kawalpemilu.org#75606,"KAROSSA, KAROSSA, MAMUJU TENGAH, SULAWESI BARAT",13,100,80,180
https://kawalpemilu.org#75606,"KAROSSA, KAROSSA, MAMUJU TENGAH, SULAWESI BARAT",14,148,54,202
https://kawalpemilu.org#75606,"KAROSSA, KAROSSA, MAMUJU TENGAH, SULAWESI BARAT",15,150,82,232
https://kawalpemilu.org#75607,"TASOKKO, KAROSSA, MAMUJU TENGAH, SULAWESI BARAT",1,157,57,214
https://kawalpemilu.org#75607,"TASOKKO, KAROSSA, MAMUJU TENGAH, SULAWESI BARAT",2,102,22,124
https://kawalpemilu.org#75607,"TASOKKO, KAROSSA, MAMUJU TENGAH, SULAWESI BARAT",3,57,179,236
https://kawalpemilu.org#75607,"TASOKKO, KAROSSA, MAMUJU TENGAH, SULAWESI BARAT",4,196,64,260
https://kawalpemilu.org#75607,"TASOKKO, KAROSSA, MAMUJU TENGAH, SULAWESI BARAT",5,84,48,132
https://kawalpemilu.org#75607,"TASOKKO, KAROSSA, MAMUJU TENGAH, SULAWESI BARAT",6,131,74,205
https://kawalpemilu.org#75607,"TASOKKO, KAROSSA, MAMUJU TENGAH, SULAWESI BARAT",7,152,84,236
https://kawalpemilu.org#75607,"TASOKKO, KAROSSA, MAMUJU TENGAH, SULAWESI BARAT",8,121,118,239
https://kawalpemilu.org#75607,"TASOKKO, KAROSSA, MAMUJU TENGAH, SULAWESI BARAT",9,143,46,0
https://kawalpemilu.org#75607,"TASOKKO, KAROSSA, MAMUJU TENGAH, SULAWESI BARAT",10,39,73,112
https://kawalpemilu.org#75607,"TASOKKO, KAROSSA, MAMUJU TENGAH, SULAWESI BARAT",11,131,77,208
https://kawalpemilu.org#75607,"TASOKKO, KAROSSA, MAMUJU TENGAH, SULAWESI BARAT",12,118,83,201
https://kawalpemilu.org#75608,"LARA, KAROSSA, MAMUJU TENGAH, SULAWESI BARAT",1,160,49,209
https://kawalpemilu.org#75608,"LARA, KAROSSA, MAMUJU TENGAH, SULAWESI BARAT",2,142,68,210
https://kawalpemilu.org#75608,"LARA, KAROSSA, MAMUJU TENGAH, SULAWESI BARAT",3,139,25,164
https://kawalpemilu.org#75608,"LARA, KAROSSA, MAMUJU TENGAH, SULAWESI BARAT",4,144,52,196
https://kawalpemilu.org#75608,"LARA, KAROSSA, MAMUJU TENGAH, SULAWESI BARAT",5,115,29,144
https://kawalpemilu.org#75608,"LARA, KAROSSA, MAMUJU TENGAH, SULAWESI BARAT",6,113,54,167
https://kawalpemilu.org#75609,"KADAILA, KAROSSA, MAMUJU TENGAH, SULAWESI BARAT",1,166,83,249
https://kawalpemilu.org#75609,"KADAILA, KAROSSA, MAMUJU TENGAH, SULAWESI BARAT",2,213,34,247
https://kawalpemilu.org#75609,"KADAILA, KAROSSA, MAMUJU TENGAH, SULAWESI BARAT",3,204,17,221
https://kawalpemilu.org#75609,"KADAILA, KAROSSA, MAMUJU TENGAH, SULAWESI BARAT",4,164,71,235
https://kawalpemilu.org#75610,"KAYU CALLA, KAROSSA, MAMUJU TENGAH, SULAWESI BARAT",1,162,35,197
https://kawalpemilu.org#75610,"KAYU CALLA, KAROSSA, MAMUJU TENGAH, SULAWESI BARAT",2,168,66,234
https://kawalpemilu.org#75611,"LEMBAH HOPO, KAROSSA, MAMUJU TENGAH, SULAWESI BARAT",1,123,38,161
https://kawalpemilu.org#75611,"LEMBAH HOPO, KAROSSA, MAMUJU TENGAH, SULAWESI BARAT",2,180,44,224
https://kawalpemilu.org#75611,"LEMBAH HOPO, KAROSSA, MAMUJU TENGAH, SULAWESI BARAT",3,112,52,164
https://kawalpemilu.org#75612,"BENGGAULU, KAROSSA, MAMUJU TENGAH, SULAWESI BARAT",1,136,34,170
https://kawalpemilu.org#75612,"BENGGAULU, KAROSSA, MAMUJU TENGAH, SULAWESI BARAT",2,183,33,216
https://kawalpemilu.org#75612,"BENGGAULU, KAROSSA, MAMUJU TENGAH, SULAWESI BARAT",3,139,23,162
https://kawalpemilu.org#75612,"BENGGAULU, KAROSSA, MAMUJU TENGAH, SULAWESI BARAT",4,134,57,191
https://kawalpemilu.org#75612,"BENGGAULU, KAROSSA, MAMUJU TENGAH, SULAWESI BARAT",5,100,4,104
https://kawalpemilu.org#75612,"BENGGAULU, KAROSSA, MAMUJU TENGAH, SULAWESI BARAT",6,159,33,192
https://kawalpemilu.org#75613,"SUKA MAJU, KAROSSA, MAMUJU TENGAH, SULAWESI BARAT",1,71,23,94
https://kawalpemilu.org#75613,"SUKA MAJU, KAROSSA, MAMUJU TENGAH, SULAWESI BARAT",2,84,22,106
https://kawalpemilu.org#75613,"SUKA MAJU, KAROSSA, MAMUJU TENGAH, SULAWESI BARAT",3,148,34,182
https://kawalpemilu.org#75613,"SUKA MAJU, KAROSSA, MAMUJU TENGAH, SULAWESI BARAT",4,108,83,191
https://kawalpemilu.org#75613,"SUKA MAJU, KAROSSA, MAMUJU TENGAH, SULAWESI BARAT",5,120,70,190
https://kawalpemilu.org#75614,"KAMBUNONG, KAROSSA, MAMUJU TENGAH, SULAWESI BARAT",1,157,99,256
https://kawalpemilu.org#75614,"KAMBUNONG, KAROSSA, MAMUJU TENGAH, SULAWESI BARAT",2,183,94,277
https://kawalpemilu.org#75614,"KAMBUNONG, KAROSSA, MAMUJU TENGAH, SULAWESI BARAT",3,127,65,192
https://kawalpemilu.org#75614,"KAMBUNONG, KAROSSA, MAMUJU TENGAH, SULAWESI BARAT",4,209,29,238
https://kawalpemilu.org#75614,"KAMBUNONG, KAROSSA, MAMUJU TENGAH, SULAWESI BARAT",5,169,86,255
https://kawalpemilu.org#75614,"KAMBUNONG, KAROSSA, MAMUJU TENGAH, SULAWESI BARAT",6,75,16,91
https://kawalpemilu.org#75614,"KAMBUNONG, KAROSSA, MAMUJU TENGAH, SULAWESI BARAT",7,126,16,142
https://kawalpemilu.org#75614,"KAMBUNONG, KAROSSA, MAMUJU TENGAH, SULAWESI BARAT",8,94,57,151
https://kawalpemilu.org#75615,"SALUBIRO, KAROSSA, MAMUJU TENGAH, SULAWESI BARAT",1,144,57,201
https://kawalpemilu.org#75615,"SALUBIRO, KAROSSA, MAMUJU TENGAH, SULAWESI BARAT",2,74,39,113
https://kawalpemilu.org#75615,"SALUBIRO, KAROSSA, MAMUJU TENGAH, SULAWESI BARAT",3,155,49,204
https://kawalpemilu.org#75615,"SALUBIRO, KAROSSA, MAMUJU TENGAH, SULAWESI BARAT",4,82,49,131
https://kawalpemilu.org#75616,"SANJANGO, KAROSSA, MAMUJU TENGAH, SULAWESI BARAT",1,85,43,128
https://kawalpemilu.org#75616,"SANJANGO, KAROSSA, MAMUJU TENGAH, SULAWESI BARAT",2,183,33,216
https://kawalpemilu.org#75616,"SANJANGO, KAROSSA, MAMUJU TENGAH, SULAWESI BARAT",3,84,14,98
https://kawalpemilu.org#75616,"SANJANGO, KAROSSA, MAMUJU TENGAH, SULAWESI BARAT",4,126,43,169
https://kawalpemilu.org#75652,"MAHAHE, TOBADAK, MAMUJU TENGAH, SULAWESI BARAT",1,139,68,207
https://kawalpemilu.org#75652,"MAHAHE, TOBADAK, MAMUJU TENGAH, SULAWESI BARAT",2,119,66,185
https://kawalpemilu.org#75652,"MAHAHE, TOBADAK, MAMUJU TENGAH, SULAWESI BARAT",3,166,53,219
https://kawalpemilu.org#75652,"MAHAHE, TOBADAK, MAMUJU TENGAH, SULAWESI BARAT",4,175,6,181
https://kawalpemilu.org#75652,"MAHAHE, TOBADAK, MAMUJU TENGAH, SULAWESI BARAT",5,119,52,171
https://kawalpemilu.org#75652,"MAHAHE, TOBADAK, MAMUJU TENGAH, SULAWESI BARAT",6,100,54,154
https://kawalpemilu.org#75652,"MAHAHE, TOBADAK, MAMUJU TENGAH, SULAWESI BARAT",7,156,4,160
https://kawalpemilu.org#75652,"MAHAHE, TOBADAK, MAMUJU TENGAH, SULAWESI BARAT",8,191,33,224
https://kawalpemilu.org#75653,"SULOBAJA, TOBADAK, MAMUJU TENGAH, SULAWESI BARAT",1,117,28,145
https://kawalpemilu.org#75653,"SULOBAJA, TOBADAK, MAMUJU TENGAH, SULAWESI BARAT",2,105,28,133
https://kawalpemilu.org#75653,"SULOBAJA, TOBADAK, MAMUJU TENGAH, SULAWESI BARAT",3,104,46,150
https://kawalpemilu.org#75653,"SULOBAJA, TOBADAK, MAMUJU TENGAH, SULAWESI BARAT",4,137,9,146
https://kawalpemilu.org#75653,"SULOBAJA, TOBADAK, MAMUJU TENGAH, SULAWESI BARAT",5,74,42,116
https://kawalpemilu.org#75653,"SULOBAJA, TOBADAK, MAMUJU TENGAH, SULAWESI BARAT",6,180,64,244
https://kawalpemilu.org#75653,"SULOBAJA, TOBADAK, MAMUJU TENGAH, SULAWESI BARAT",7,86,47,133
https://kawalpemilu.org#75653,"SULOBAJA, TOBADAK, MAMUJU TENGAH, SULAWESI BARAT",8,73,40,113
https://kawalpemilu.org#75653,"SULOBAJA, TOBADAK, MAMUJU TENGAH, SULAWESI BARAT",9,173,39,212
https://kawalpemilu.org#75654,"TOBADAK, TOBADAK, MAMUJU TENGAH, SULAWESI BARAT",1,101,48,149
https://kawalpemilu.org#75654,"TOBADAK, TOBADAK, MAMUJU TENGAH, SULAWESI BARAT",2,241,37,278
https://kawalpemilu.org#75654,"TOBADAK, TOBADAK, MAMUJU TENGAH, SULAWESI BARAT",3,222,52,274
https://kawalpemilu.org#75654,"TOBADAK, TOBADAK, MAMUJU TENGAH, SULAWESI BARAT",4,235,26,261
https://kawalpemilu.org#75654,"TOBADAK, TOBADAK, MAMUJU TENGAH, SULAWESI BARAT",5,223,74,297
https://kawalpemilu.org#75654,"TOBADAK, TOBADAK, MAMUJU TENGAH, SULAWESI BARAT",6,192,74,266
https://kawalpemilu.org#75654,"TOBADAK, TOBADAK, MAMUJU TENGAH, SULAWESI BARAT",8,199,69,268
https://kawalpemilu.org#75654,"TOBADAK, TOBADAK, MAMUJU TENGAH, SULAWESI BARAT",9,171,75,246
https://kawalpemilu.org#75654,"TOBADAK, TOBADAK, MAMUJU TENGAH, SULAWESI BARAT",10,167,122,289
https://kawalpemilu.org#75654,"TOBADAK, TOBADAK, MAMUJU TENGAH, SULAWESI BARAT",11,301,2,303
https://kawalpemilu.org#75654,"TOBADAK, TOBADAK, MAMUJU TENGAH, SULAWESI BARAT",12,166,16,182
https://kawalpemilu.org#75654,"TOBADAK, TOBADAK, MAMUJU TENGAH, SULAWESI BARAT",13,95,8,103
https://kawalpemilu.org#75654,"TOBADAK, TOBADAK, MAMUJU TENGAH, SULAWESI BARAT",14,191,11,202
https://kawalpemilu.org#75654,"TOBADAK, TOBADAK, MAMUJU TENGAH, SULAWESI BARAT",15,140,19,159
https://kawalpemilu.org#75654,"TOBADAK, TOBADAK, MAMUJU TENGAH, SULAWESI BARAT",16,123,5,128
https://kawalpemilu.org#75654,"TOBADAK, TOBADAK, MAMUJU TENGAH, SULAWESI BARAT",17,158,62,220
https://kawalpemilu.org#75654,"TOBADAK, TOBADAK, MAMUJU TENGAH, SULAWESI BARAT",18,82,56,138
https://kawalpemilu.org#75654,"TOBADAK, TOBADAK, MAMUJU TENGAH, SULAWESI BARAT",19,164,32,196
https://kawalpemilu.org#75654,"TOBADAK, TOBADAK, MAMUJU TENGAH, SULAWESI BARAT",20,126,44,170
https://kawalpemilu.org#75654,"TOBADAK, TOBADAK, MAMUJU TENGAH, SULAWESI BARAT",21,118,12,130
https://kawalpemilu.org#75655,"POLONGAAN, TOBADAK, MAMUJU TENGAH, SULAWESI BARAT",1,215,31,246
https://kawalpemilu.org#75655,"POLONGAAN, TOBADAK, MAMUJU TENGAH, SULAWESI BARAT",2,201,54,255
https://kawalpemilu.org#75655,"POLONGAAN, TOBADAK, MAMUJU TENGAH, SULAWESI BARAT",3,166,38,204
https://kawalpemilu.org#75655,"POLONGAAN, TOBADAK, MAMUJU TENGAH, SULAWESI BARAT",4,200,23,223
https://kawalpemilu.org#75655,"POLONGAAN, TOBADAK, MAMUJU TENGAH, SULAWESI BARAT",5,130,34,164
https://kawalpemilu.org#75655,"POLONGAAN, TOBADAK, MAMUJU TENGAH, SULAWESI BARAT",6,130,32,162
https://kawalpemilu.org#75655,"POLONGAAN, TOBADAK, MAMUJU TENGAH, SULAWESI BARAT",7,129,28,157
https://kawalpemilu.org#75656,"BATU PARIGI, TOBADAK, MAMUJU TENGAH, SULAWESI BARAT",1,154,33,187
https://kawalpemilu.org#75656,"BATU PARIGI, TOBADAK, MAMUJU TENGAH, SULAWESI BARAT",2,139,56,195
https://kawalpemilu.org#75656,"BATU PARIGI, TOBADAK, MAMUJU TENGAH, SULAWESI BARAT",3,182,7,0
https://kawalpemilu.org#75656,"BATU PARIGI, TOBADAK, MAMUJU TENGAH, SULAWESI BARAT",4,179,12,191
https://kawalpemilu.org#75656,"BATU PARIGI, TOBADAK, MAMUJU TENGAH, SULAWESI BARAT",5,169,18,187
https://kawalpemilu.org#75656,"BATU PARIGI, TOBADAK, MAMUJU TENGAH, SULAWESI BARAT",6,86,54,0
https://kawalpemilu.org#75656,"BATU PARIGI, TOBADAK, MAMUJU TENGAH, SULAWESI BARAT",7,164,29,193
https://kawalpemilu.org#75656,"BATU PARIGI, TOBADAK, MAMUJU TENGAH, SULAWESI BARAT",8,123,26,149
https://kawalpemilu.org#75656,"BATU PARIGI, TOBADAK, MAMUJU TENGAH, SULAWESI BARAT",9,126,29,155
https://kawalpemilu.org#75656,"BATU PARIGI, TOBADAK, MAMUJU TENGAH, SULAWESI BARAT",10,77,4,81
https://kawalpemilu.org#75656,"BATU PARIGI, TOBADAK, MAMUJU TENGAH, SULAWESI BARAT",11,129,21,150
https://kawalpemilu.org#75656,"BATU PARIGI, TOBADAK, MAMUJU TENGAH, SULAWESI BARAT",12,99,8,107
https://kawalpemilu.org#75656,"BATU PARIGI, TOBADAK, MAMUJU TENGAH, SULAWESI BARAT",13,102,8,110
https://kawalpemilu.org#75656,"BATU PARIGI, TOBADAK, MAMUJU TENGAH, SULAWESI BARAT",14,171,4,175
https://kawalpemilu.org#75656,"BATU PARIGI, TOBADAK, MAMUJU TENGAH, SULAWESI BARAT",15,158,24,182
https://kawalpemilu.org#75656,"BATU PARIGI, TOBADAK, MAMUJU TENGAH, SULAWESI BARAT",16,103,30,133
https://kawalpemilu.org#75656,"BATU PARIGI, TOBADAK, MAMUJU TENGAH, SULAWESI BARAT",17,144,24,168
https://kawalpemilu.org#75656,"BATU PARIGI, TOBADAK, MAMUJU TENGAH, SULAWESI BARAT",18,105,20,125
https://kawalpemilu.org#75657,"BAMBADARU, TOBADAK, MAMUJU TENGAH, SULAWESI BARAT",1,157,30,187
https://kawalpemilu.org#75657,"BAMBADARU, TOBADAK, MAMUJU TENGAH, SULAWESI BARAT",2,129,21,150
https://kawalpemilu.org#75657,"BAMBADARU, TOBADAK, MAMUJU TENGAH, SULAWESI BARAT",3,153,37,190
https://kawalpemilu.org#75657,"BAMBADARU, TOBADAK, MAMUJU TENGAH, SULAWESI BARAT",4,94,9,103
https://kawalpemilu.org#75657,"BAMBADARU, TOBADAK, MAMUJU TENGAH, SULAWESI BARAT",5,176,3,179
https://kawalpemilu.org#75658,"SEJATI, TOBADAK, MAMUJU TENGAH, SULAWESI BARAT",1,67,180,247
https://kawalpemilu.org#75658,"SEJATI, TOBADAK, MAMUJU TENGAH, SULAWESI BARAT",2,38,163,201
https://kawalpemilu.org#75658,"SEJATI, TOBADAK, MAMUJU TENGAH, SULAWESI BARAT",3,69,195,264
https://kawalpemilu.org#75658,"SEJATI, TOBADAK, MAMUJU TENGAH, SULAWESI BARAT",4,20,59,79
https://kawalpemilu.org#75659,"SALUADAK, TOBADAK, MAMUJU TENGAH, SULAWESI BARAT",1,225,26,251
https://kawalpemilu.org#75659,"SALUADAK, TOBADAK, MAMUJU TENGAH, SULAWESI BARAT",2,158,47,205
https://kawalpemilu.org#75659,"SALUADAK, TOBADAK, MAMUJU TENGAH, SULAWESI BARAT",3,175,15,190
https://kawalpemilu.org#75659,"SALUADAK, TOBADAK, MAMUJU TENGAH, SULAWESI BARAT",4,188,14,202
