Link KawalPemilu,Nama Kelurahan,Nomor TPS,Suara 01,Suara 02,Suara Sah
https://kawalpemilu.org#6370,"SAGOE, TRIENGGADENG, PIDIE JAYA, ACEH",3,6,170,176
https://kawalpemilu.org#3291,"LHOK JOK, KUTA MAKMUR, ACEH UTARA, ACEH",12,24,146,170
https://kawalpemilu.org#3084,"SAGOE, KEUMALA, PIDIE, ACEH",1,14,212,226
https://kawalpemilu.org#4349,"SINGKOHOR, SINGKOHOR, ACEH SINGKIL, ACEH",2,92,153,245
https://kawalpemilu.org#1113,"ALUE BU ALUE NIREH, PEUREULAK TIMUR, ACEH TIMUR, ACEH",1,21,58,79
https://kawalpemilu.org#4409,"GLUMPANG PAYONG, SAMALANGA, BIREUEN, ACEH",1,17,131,148
https://kawalpemilu.org#6174,"MANYANG CUT, MEUREUDU, PIDIE JAYA, ACEH",2,6,193,199
https://kawalpemilu.org#2457,"PULO TUKOK, BATEE, PIDIE, ACEH",2,22,123,145
https://kawalpemilu.org#2342,"LAMBARO SAMAHANI, KUTA MALAKA, ACEH BESAR, ACEH",1,11,239,250
https://kawalpemilu.org#251,"SEUNEUBOK KEURANJI, KOTA BAHAGIA, ACEH SELATAN, ACEH",2,16,107,123
https://kawalpemilu.org#1120,"BEUSA SEBERANG, PEUREULAK BARAT, ACEH TIMUR, ACEH",2,17,139,156
https://kawalpemilu.org#6621,"PB. BLANG PASE, LANGSA KOTA, KOTA LANGSA, ACEH",4,38,153,191
https://kawalpemilu.org#1688,"RIMBA LANGGEH, ARONGAN LAMBALEK, ACEH BARAT, ACEH",1,11,135,146
https://kawalpemilu.org#3267,"TAMBON TUNONG, DEWANTARA, ACEH UTARA, ACEH",5,0,0,0
https://kawalpemilu.org#3243,"GLUMPANG SAMLAKOE, BAKTIYA, ACEH UTARA, ACEH",102,11,139,150
https://kawalpemilu.org#5856,"BENUA RAJA, RANTAU, ACEH TAMIANG, ACEH",5,36,138,174
https://kawalpemilu.org#2257,"LAMBITRA, DARUSSALAM, ACEH BESAR, ACEH",1,13,120,133
https://kawalpemilu.org#5849,"KALOY, TAMIANG HULU, ACEH TAMIANG, ACEH",6,46,85,131
https://kawalpemilu.org#3176,"MANYANG, GLUMPANG BARO, PIDIE, ACEH",1,1,169,170
https://kawalpemilu.org#1792,"BUKET MEUGAJAH, WOYLA TIMUR, ACEH BARAT, ACEH",1,17,135,152
https://kawalpemilu.org#3986,"KEUDE NIBONG, NIBONG, ACEH UTARA, ACEH",1,3,91,94
https://kawalpemilu.org#2282,"LAMTAMOT, LEMBAH SEULAWAH, ACEH BESAR, ACEH",4,32,183,215
https://kawalpemilu.org#53828,"CELUKANBAWANG, GEROKGAK, BULELENG, BALI",4,206,33,239
https://kawalpemilu.org#53499,"UNGASAN, KUTA SELATAN, BADUNG, BALI",29,195,55,250
https://kawalpemilu.org#53849,"BANJARASEM, SERIRIT, BULELENG, BALI",1,192,8,200
https://kawalpemilu.org#53910,"BANYUNING, BULELENG, BULELENG, BALI",42,156,23,179
https://kawalpemilu.org#53287,"MANISTUTU, MELAYA, JEMBRANA, BALI",15,195,45,240
https://kawalpemilu.org#53734,"PESABAN, RENDANG, KARANGASEM, BALI",6,172,4,176
https://kawalpemilu.org#53245,"BANJAR TENGAH, NEGARA, JEMBRANA, BALI",6,197,18,215
https://kawalpemilu.org#53351,"BONGAN, TABANAN, TABANAN, BALI",10,229,16,245
https://kawalpemilu.org#54016,"DANGIN PURI KAJA, DENPASAR UTARA, KOTA DENPASAR, BALI",38,140,8,148
https://kawalpemilu.org#53582,"KERTA, PAYANGAN, GIANYAR, BALI",11,236,10,246
https://kawalpemilu.org#53915,"KALIUNTU, BULELENG, BULELENG, BALI",3,182,7,189
https://kawalpemilu.org#53834,"RINGDIKIT, SERIRIT, BULELENG, BALI",5,146,8,154
https://kawalpemilu.org#53529,"BEDULU, BLAHBATUH, GIANYAR, BALI",10,244,2,246
https://kawalpemilu.org#53336,"BELUMBANG, KERAMBITAN, TABANAN, BALI",1,276,9,285
https://kawalpemilu.org#53371,"PANDAK GEDE, KEDIRI, TABANAN, BALI",5,166,5,171
https://kawalpemilu.org#53863,"BUSUNGBIU, BUSUNG BIU, BULELENG, BALI",18,218,14,232
https://kawalpemilu.org#52196,"CIBARENO, CILOGRANG, LEBAK, BANTEN",6,51,147,198
https://kawalpemilu.org#53217,"CIPAYUNG, CIPUTAT, KOTA TANGERANG SELATAN, BANTEN",32,139,120,259
https://kawalpemilu.org#53040,"PONDOK BAHAR, KARANG TENGAH, KOTA TANGERANG, BANTEN",29,96,88,184
https://kawalpemilu.org#52975,"PORIS PLAWAD, CIPONDOH, KOTA TANGERANG, BANTEN",8,41,135,176
https://kawalpemilu.org#52313,"PETE, TIGARAKSA, TANGERANG, BANTEN",12,26,148,174
https://kawalpemilu.org#51696,"RANCATEUREUP, LABUAN, PANDEGLANG, BANTEN",3,69,120,189
https://kawalpemilu.org#53161,"BANJAR AGUNG, CIPOCOK JAYA, KOTA SERANG, BANTEN",28,58,176,234
https://kawalpemilu.org#51657,"PANACARAN, MUNJUL, PANDEGLANG, BANTEN",10,34,95,129
https://kawalpemilu.org#52370,"TEGAL KUNIR KIDUL, MAUK, TANGERANG, BANTEN",11,41,178,219
https://kawalpemilu.org#52699,"LONTAR, TIRTAYASA, SERANG, BANTEN",1,85,81,166
https://kawalpemilu.org#51703,"SUKAMAJU, LABUAN, PANDEGLANG, BANTEN",9,47,121,168
https://kawalpemilu.org#53227,"BENDA BARU, PAMULANG, KOTA TANGERANG SELATAN, BANTEN",83,137,76,213
https://kawalpemilu.org#52942,"CIKOKOL, TANGERANG, KOTA TANGERANG, BANTEN",31,88,170,258
https://kawalpemilu.org#52948,"JATAKE, JATIUWUNG, KOTA TANGERANG, BANTEN",14,31,94,125
https://kawalpemilu.org#51761,"KURUNGKAMBING, MANDALAWANGI, PANDEGLANG, BANTEN",5,46,148,194
https://kawalpemilu.org#52293,"SENTUL, BALARAJA, TANGERANG, BANTEN",21,39,119,158
https://kawalpemilu.org#53114,"UNYUR, SERANG, KOTA SERANG, BANTEN",90,87,150,237
https://kawalpemilu.org#52392,"PEKAYON, SUKADIRI, TANGERANG, BANTEN",14,38,100,138
https://kawalpemilu.org#89645,"PASIR KEMBANG, PAMARAYAN, SERANG, BANTEN",7,77,122,199
https://kawalpemilu.org#52105,"MUARA CIUJUNG TIMUR, RANGKASBITUNG, LEBAK, BANTEN",16,77,167,244
https://kawalpemilu.org#53184,"LENGKONG GUDANG, SERPONG, KOTA TANGERANG SELATAN, BANTEN",28,105,80,185
https://kawalpemilu.org#52993,"CIMONE JAYA, KARAWACI, KOTA TANGERANG, BANTEN",32,72,102,174
https://kawalpemilu.org#84987,"BOJENWETAN, SOBANG, PANDEGLANG, BANTEN",1,103,77,180
https://kawalpemilu.org#52634,"PULO AMPEL, PULO AMPEL, SERANG, BANTEN",3,25,200,225
https://kawalpemilu.org#52110,"JATIMULYA, RANGKASBITUNG, LEBAK, BANTEN",13,113,83,196
https://kawalpemilu.org#52196,"CIBARENO, CILOGRANG, LEBAK, BANTEN",2,52,139,191
https://kawalpemilu.org#53070,"LEBAKGEDE, PULOMERAK, KOTA CILEGON, BANTEN",18,68,183,251
https://kawalpemilu.org#52487,"BITUNG JAYA, CIKUPA, TANGERANG, BANTEN",23,40,82,122
https://kawalpemilu.org#53126,"BANTEN, KASEMEN, KOTA SERANG, BANTEN",35,87,147,234
https://kawalpemilu.org#52330,"MEKARSARI, JAMBE, TANGERANG, BANTEN",1,81,118,199
https://kawalpemilu.org#52482,"TALAGA, CIKUPA, TANGERANG, BANTEN",22,53,196,249
https://kawalpemilu.org#53079,"RANDAKARI, CIWANDAN, KOTA CILEGON, BANTEN",7,42,182,224
https://kawalpemilu.org#53226,"PAMULANG BARAT, PAMULANG, KOTA TANGERANG SELATAN, BANTEN",89,119,18,137
https://kawalpemilu.org#52113,"RANGKASBITUNG TIMUR, RANGKASBITUNG, LEBAK, BANTEN",22,59,132,191
https://kawalpemilu.org#53212,"SERUA, CIPUTAT, KOTA TANGERANG SELATAN, BANTEN",51,88,76,164
https://kawalpemilu.org#52343,"JEUNGJING, CISOKA, TANGERANG, BANTEN",23,55,133,188
https://kawalpemilu.org#52346,"PASIR AMPO, KRESEK, TANGERANG, BANTEN",12,117,59,176
https://kawalpemilu.org#53221,"PISANGAN, CIPUTAT TIMUR, KOTA TANGERANG SELATAN, BANTEN",4,128,105,233
https://kawalpemilu.org#52066,"SANGKANMANIK, CIMARGA, LEBAK, BANTEN",4,42,171,213
https://kawalpemilu.org#52418,"PANGADEGAN, PASAR KEMIS, TANGERANG, BANTEN",22,61,80,141
https://kawalpemilu.org#52551,"WANAKERTA, SINDANG JAYA, TANGERANG, BANTEN",9,44,131,175
https://kawalpemilu.org#51586,"TAMANJAYA, SUMUR, PANDEGLANG, BANTEN",8,116,16,132
https://kawalpemilu.org#21563,"PASAR SAOH, KAUR SELATAN, KAUR, BENGKULU",1,72,152,224
https://kawalpemilu.org#21259,"PAL VIII, BERMANI ULU RAYA, REJANG LEBONG, BENGKULU",2,151,96,247
https://kawalpemilu.org#22307,"SAWAH LEBAR, RATU AGUNG, KOTA BENGKULU, BENGKULU",11,70,137,207
https://kawalpemilu.org#21371,"JAGOBAYO, LAIS, BENGKULU UTARA, BENGKULU",1,64,158,222
https://kawalpemilu.org#22255,"PAGAR DEWA, SELEBAR, KOTA BENGKULU, BENGKULU",45,102,57,159
https://kawalpemilu.org#21237,"IV SUKU MENANTI, SINDANG DATARAN, REJANG LEBONG, BENGKULU",9,95,52,117
https://kawalpemilu.org#20906,"PUNGGUK KETUPAK, MERIGI KELINDANG, BENGKULU TENGAH, BENGKULU",1,116,117,233
https://kawalpemilu.org#22297,"KANDANG MAS, KAMPUNG MELAYU, KOTA BENGKULU, BENGKULU",5,72,194,266
https://kawalpemilu.org#41990,"TRIHARJO, PANDAK, BANTUL, DAERAH ISTIMEWA YOGYAKARTA",10,186,58,244
https://kawalpemilu.org#41932,"SENDANGSARI, PENGASIH, KULON PROGO, DAERAH ISTIMEWA YOGYAKARTA",21,159,89,248
https://kawalpemilu.org#42190,"NGALANG, GEDANGSARI, GUNUNGKIDUL, DAERAH ISTIMEWA YOGYAKARTA",24,129,33,162
https://kawalpemilu.org#42119,"GIRIMULYO, PANGGANG, GUNUNGKIDUL, DAERAH ISTIMEWA YOGYAKARTA",8,198,23,221
https://kawalpemilu.org#42298,"TRIMULYO, SLEMAN, SLEMAN, DAERAH ISTIMEWA YOGYAKARTA",22,161,51,212
https://kawalpemilu.org#41942,"GIRIPURWO, GIRIMULYO, KULON PROGO, DAERAH ISTIMEWA YOGYAKARTA",7,128,67,195
https://kawalpemilu.org#42249,"MARGODADI, SEYEGAN, SLEMAN, DAERAH ISTIMEWA YOGYAKARTA",25,193,65,258
https://kawalpemilu.org#42295,"TRIHARJO, SLEMAN, SLEMAN, DAERAH ISTIMEWA YOGYAKARTA",22,158,93,251
https://kawalpemilu.org#42197,"KANIGORO, SAPTOSARI, GUNUNGKIDUL, DAERAH ISTIMEWA YOGYAKARTA",7,135,23,158
https://kawalpemilu.org#42041,"SRIMULYO, PIYUNGAN, BANTUL, DAERAH ISTIMEWA YOGYAKARTA",58,146,52,198
https://kawalpemilu.org#42161,"PETIR, RONGKOP, GUNUNGKIDUL, DAERAH ISTIMEWA YOGYAKARTA",5,138,43,181
https://kawalpemilu.org#42382,"REJOWINANGUN, KOTAGEDE, KOTA YOGYAKARTA, DAERAH ISTIMEWA YOGYAKARTA",31,104,75,179
https://kawalpemilu.org#42076,"PILANGREJO, NGLIPAR, GUNUNGKIDUL, DAERAH ISTIMEWA YOGYAKARTA",6,126,25,151
https://kawalpemilu.org#42271,"GAYAMHARJO, PRAMBANAN, SLEMAN, DAERAH ISTIMEWA YOGYAKARTA",17,94,68,162
https://kawalpemilu.org#42224,"AMBARKETAWANG, GAMPING, SLEMAN, DAERAH ISTIMEWA YOGYAKARTA",36,168,78,246
https://kawalpemilu.org#25904,"LAGOA, KOJA, JAKARTA UTARA, DKI JAKARTA",25,149,66,215
https://kawalpemilu.org#25930,"KAPUK, CENGKARENG, JAKARTA BARAT, DKI JAKARTA",233,181,61,242
https://kawalpemilu.org#26095,"BALEKAMBANG, KRAMATJATI, JAKARTA TIMUR, DKI JAKARTA",74,80,146,226
https://kawalpemilu.org#25962,"KEBON JERUK, KEBON JERUK, JAKARTA BARAT, DKI JAKARTA",22,85,124,209
https://kawalpemilu.org#26103,"GEDONG, PASAR REBO, JAKARTA TIMUR, DKI JAKARTA",9,98,114,212
https://kawalpemilu.org#26139,"LUBANG BUAYA, CIPAYUNG, JAKARTA TIMUR, DKI JAKARTA",196,106,144,250
https://kawalpemilu.org#26049,"DUREN TIGA, PANCORAN, JAKARTA SELATAN, DKI JAKARTA",46,82,129,211
https://kawalpemilu.org#26087,"CIPINANG MUARA, JATINEGARA, JAKARTA TIMUR, DKI JAKARTA",110,211,37,248
https://kawalpemilu.org#25891,"PEJAGALAN, PENJARINGAN, JAKARTA UTARA, DKI JAKARTA",70,105,100,205
https://kawalpemilu.org#26100,"KALISARI, PASAR REBO, JAKARTA TIMUR, DKI JAKARTA",120,124,148,272
https://kawalpemilu.org#26024,"CIPULIR, KEBAYORAN LAMA, JAKARTA SELATAN, DKI JAKARTA",92,87,116,203
https://kawalpemilu.org#25910,"SUKAPURA, CILINCING, JAKARTA UTARA, DKI JAKARTA",157,113,86,199
https://kawalpemilu.org#26108,"PENGGILINGAN, CAKUNG, JAKARTA TIMUR, DKI JAKARTA",90,140,113,253
https://kawalpemilu.org#25845,"GUNUNG SAHARI UTARA, SAWAH BESAR, JAKARTA PUSAT, DKI JAKARTA",45,178,59,237
https://kawalpemilu.org#25897,"SUNGAI BAMBU, TANJUNG PRIOK, JAKARTA UTARA, DKI JAKARTA",75,96,128,224
https://kawalpemilu.org#25898,"KEBON BAWANG, TANJUNG PRIOK, JAKARTA UTARA, DKI JAKARTA",150,79,97,176
https://kawalpemilu.org#26106,"JATINEGARA, CAKUNG, JAKARTA TIMUR, DKI JAKARTA",81,98,83,182
https://kawalpemilu.org#25962,"KEBON JERUK, KEBON JERUK, JAKARTA BARAT, DKI JAKARTA",98,106,113,219
https://kawalpemilu.org#26117,"MALAKA SARI, DUREN SAWIT, JAKARTA TIMUR, DKI JAKARTA",11,97,159,256
https://kawalpemilu.org#25970,"KALIDERES, KALIDERES, JAKARTA BARAT, DKI JAKARTA",134,110,103,213
https://kawalpemilu.org#25880,"KAMPUNG BALI, TANAH ABANG, JAKARTA PUSAT, DKI JAKARTA",26,93,135,228
https://kawalpemilu.org#26033,"CIPETE SELATAN, CILANDAK, JAKARTA SELATAN, DKI JAKARTA",72,103,94,197
https://kawalpemilu.org#25983,"KEMBANGAN UTARA, KEMBANGAN, JAKARTA BARAT, DKI JAKARTA",122,147,66,213
https://kawalpemilu.org#25879,"KEBON KACANG, TANAH ABANG, JAKARTA PUSAT, DKI JAKARTA",18,110,119,229
https://kawalpemilu.org#25870,"CIKINI, MENTENG, JAKARTA PUSAT, DKI JAKARTA",25,173,37,210
https://kawalpemilu.org#25926,"CENGKARENG BARAT, CENGKARENG, JAKARTA BARAT, DKI JAKARTA",40,151,50,201
https://kawalpemilu.org#25846,"MANGGA DUA SELATAN, SAWAH BESAR, JAKARTA PUSAT, DKI JAKARTA",16,122,85,207
https://kawalpemilu.org#25999,"SETIA BUDI, SETIABUDI, JAKARTA SELATAN, DKI JAKARTA",1,118,67,185
https://kawalpemilu.org#25927,"DURI KOSAMBI, CENGKARENG, JAKARTA BARAT, DKI JAKARTA",187,223,4,227
https://kawalpemilu.org#25928,"RAWA BUAYA, CENGKARENG, JAKARTA BARAT, DKI JAKARTA",153,149,134,283
https://kawalpemilu.org#25996,"MANGGARAI SELATAN, TEBET, JAKARTA SELATAN, DKI JAKARTA",74,96,100,196
https://kawalpemilu.org#25948,"PINANGSIA, TAMAN SARI, JAKARTA BARAT, DKI JAKARTA",28,88,163,251
https://kawalpemilu.org#25938,"JELAMBAR BARU, GROGOL PETAMBURAN, JAKARTA BARAT, DKI JAKARTA",115,159,7,166
https://kawalpemilu.org#25876,"KARET TENGSIN, TANAH ABANG, JAKARTA PUSAT, DKI JAKARTA",16,77,112,189
https://kawalpemilu.org#26115,"KLENDER, DUREN SAWIT, JAKARTA TIMUR, DKI JAKARTA",136,112,137,249
https://kawalpemilu.org#26134,"CILANGKAP, CIPAYUNG, JAKARTA TIMUR, DKI JAKARTA",75,88,125,213
https://kawalpemilu.org#74726,"TENILO, LIMBOTO, GORONTALO, GORONTALO",1,131,96,227
https://kawalpemilu.org#74745,"BUA, BATUDAA, GORONTALO, GORONTALO",1,135,75,210
https://kawalpemilu.org#75251,"MALANGO, TALUDITI, PAHUWATO, GORONTALO",1,95,67,162
https://kawalpemilu.org#74768,"ULOBUA, TIBAWA, GORONTALO, GORONTALO",3,206,44,250
https://kawalpemilu.org#75211,"PATUHU, RANDANGAN, PAHUWATO, GORONTALO",3,107,104,211
https://kawalpemilu.org#17290,"SUMBER SARI, RIMBO ULU, TEBO, JAMBI",1,122,83,205
https://kawalpemilu.org#17258,"PURWO HARJO, RIMBO BUJANG, TEBO, JAMBI",6,105,69,174
https://kawalpemilu.org#16649,"TEBING TINGGI, PEMAYUNG, BATANGHARI, JAMBI",4,127,120,247
https://kawalpemilu.org#17392,"KENALI BESAR, ALAM BARAJO, KOTA JAMBI, JAMBI",13,60,153,213
https://kawalpemilu.org#16764,"DANAU KEDAP, MARO SEBO, MUARO JAMBI, JAMBI",1,32,114,146
https://kawalpemilu.org#16697,"DESA TERUSAN, MARO SEBO ILIR, BATANGHARI, JAMBI",3,33,177,210
https://kawalpemilu.org#84604,"MENDALO INDAH, JAMBI LUAR KOTA, MUARO JAMBI, JAMBI",2,85,127,212
https://kawalpemilu.org#16456,"MUARA MENSAO, LIMUN, SAROLANGUN, JAMBI",1,70,183,253
https://kawalpemilu.org#17395,"BAGAN PETE, ALAM BARAJO, KOTA JAMBI, JAMBI",15,110,102,212
https://kawalpemilu.org#16822,"PETALING JAYA, SUNGAI GELAM, MUARO JAMBI, JAMBI",4,53,16,69
https://kawalpemilu.org#17354,"EKA JAYA, PAAL MERAH, KOTA JAMBI, JAMBI",28,86,136,222
https://kawalpemilu.org#16771,"SUNGAI LANDAI, MESTONG, MUARO JAMBI, JAMBI",9,152,48,200
https://kawalpemilu.org#16073,"DSN. BARU P. TENGAH, KELILING DANAU, KERINCI, JAMBI",2,27,117,144
https://kawalpemilu.org#17257,"RIMBO MULYO, RIMBO BUJANG, TEBO, JAMBI",8,97,102,199
https://kawalpemilu.org#28413,"CINUNJANG, GUNUNGTANJUNG, TASIKMALAYA, JAWA BARAT",4,41,143,184
https://kawalpemilu.org#27667,"PARUNGSERAB, SOREANG, BANDUNG, JAWA BARAT",1,68,185,253
https://kawalpemilu.org#27726,"CIMUNCANG, GARUT KOTA, GARUT, JAWA BARAT",10,81,144,225
https://kawalpemilu.org#27776,"SUKAJAYA, TAROGONG KIDUL, GARUT, JAWA BARAT",10,50,123,173
https://kawalpemilu.org#26636,"GANDASOLI, CIKAKAK, SUKABUMI, JAWA BARAT",8,36,83,119
https://kawalpemilu.org#31203,"DEPOK, DARANGDAN, PURWAKARTA, JAWA BARAT",16,21,106,127
https://kawalpemilu.org#26402,"BANTARKARET, NANGGUNG, BOGOR, JAWA BARAT",18,23,127,150
https://kawalpemilu.org#32387,"KALIJAGA, HARJAMUKTI, KOTA CIREBON, JAWA BARAT",66,78,92,170
https://kawalpemilu.org#29967,"SINDANGPANO, RAJAGALUH, MAJALENGKA, JAWA BARAT",4,137,71,208
https://kawalpemilu.org#31702,"KEBALEN, BABELAN, BEKASI, JAWA BARAT",18,75,189,264
https://kawalpemilu.org#27549,"MEKARLAKSANA, CIKANCUNG, BANDUNG, JAWA BARAT",8,106,47,153
https://kawalpemilu.org#26145,"KARADENAN, CIBINONG, BOGOR, JAWA BARAT",38,23,125,148
https://kawalpemilu.org#27777,"JAYARAGA, TAROGONG KIDUL, GARUT, JAWA BARAT",16,56,209,265
https://kawalpemilu.org#28734,"KAWUNGLARANG, RANCAH, CIAMIS, JAWA BARAT",22,53,82,135
https://kawalpemilu.org#32137,"CILUAR, BOGOR UTARA, KOTA BOGOR, JAWA BARAT",45,116,136,252
https://kawalpemilu.org#27532,"TENJOLAYA, CICALENGKA, BANDUNG, JAWA BARAT",31,45,126,171
https://kawalpemilu.org#31513,"RAWAGEMPOL KULON, CILAMAYA WETAN, KARAWANG, JAWA BARAT",16,142,51,193
https://kawalpemilu.org#32439,"BANTARGEBANG, BANTAR GEBANG, KOTA BEKASI, JAWA BARAT",26,66,94,160
https://kawalpemilu.org#31348,"ADIARSA BARAT, KARAWANG BARAT, KARAWANG, JAWA BARAT",32,95,197,292
https://kawalpemilu.org#27629,"BOJONGEMAS, SOLOKANJERUK, BANDUNG, JAWA BARAT",32,114,113,227
https://kawalpemilu.org#32596,"URUG, KAWALU, KOTA TASIKMALAYA, JAWA BARAT",6,80,160,240
https://kawalpemilu.org#28787,"BANGUNSARI, PAMARICAN, CIAMIS, JAWA BARAT",11,62,99,161
https://kawalpemilu.org#32573,"TUGURAJA, CIHIDEUNG, KOTA TASIKMALAYA, JAWA BARAT",63,70,155,225
https://kawalpemilu.org#30962,"JALANCAGAK, JALANCAGAK, SUBANG, JAWA BARAT",25,94,130,224
https://kawalpemilu.org#32576,"CIPEDES, CIPEDES, KOTA TASIKMALAYA, JAWA BARAT",23,72,125,197
https://kawalpemilu.org#31234,"KAROYA, TEGALWARU, PURWAKARTA, JAWA BARAT",11,54,190,244
https://kawalpemilu.org#26390,"PINGKU, PARUNG PANJANG, BOGOR, JAWA BARAT",9,61,102,163
https://kawalpemilu.org#28341,"PUSPARAHAYU, PUSPAHIANG, TASIKMALAYA, JAWA BARAT",1,144,113,257
https://kawalpemilu.org#29339,"CIKAHURIPAN, MALEBER, KUNINGAN, JAWA BARAT",11,91,51,142
https://kawalpemilu.org#32429,"BOJONG RAWALUMBU, RAWA LUMBU, KOTA BEKASI, JAWA BARAT",45,92,107,199
https://kawalpemilu.org#32191,"SINDANGPALAY, CIBEUREUM, KOTA SUKABUMI, JAWA BARAT",17,65,74,139
https://kawalpemilu.org#27762,"RANCABANGO, TAROGONG KALER, GARUT, JAWA BARAT",6,63,108,171
https://kawalpemilu.org#28200,"CIDADAP, KARANGNUNGGAL, TASIKMALAYA, JAWA BARAT",11,69,135,204
https://kawalpemilu.org#32612,"SETIAJAYA, CIBEUREUM, KOTA TASIKMALAYA, JAWA BARAT",5,72,170,242
https://kawalpemilu.org#32393,"JAGASATRU, PEKALIPAN, KOTA CIREBON, JAWA BARAT",13,110,116,226
https://kawalpemilu.org#29178,"RAGAWACANA, KRAMATMULYA, KUNINGAN, JAWA BARAT",9,80,101,181
https://kawalpemilu.org#32405,"BEKASI JAYA, BEKASI TIMUR, KOTA BEKASI, JAWA BARAT",28,74,93,167
https://kawalpemilu.org#27490,"SUKAMANAH, PANGALENGAN, BANDUNG, JAWA BARAT",20,65,132,197
https://kawalpemilu.org#26214,"CIBODAS, JONGGOL, BOGOR, JAWA BARAT",11,50,169,219
https://kawalpemilu.org#30704,"PANYINGKIRAN LOR, CANTIGI, INDRAMAYU, JAWA BARAT",10,116,37,153
https://kawalpemilu.org#27105,"BOJONG, KARANGTENGAH, CIANJUR, JAWA BARAT",49,104,104,208
https://kawalpemilu.org#31154,"KERTAMUKTI, CAMPAKA, PURWAKARTA, JAWA BARAT",13,39,110,149
https://kawalpemilu.org#31473,"TANJUNGBUNGIN, PAKISJAYA, KARAWANG, JAWA BARAT",1,48,150,198
https://kawalpemilu.org#28812,"PUTRAPINGGAN, KALIPUCANG, PANGANDARAN, JAWA BARAT",7,180,31,211
https://kawalpemilu.org#27252,"SINDANGKERTA, PAGELARAN, CIANJUR, JAWA BARAT",19,70,140,210
https://kawalpemilu.org#29541,"KALIWADAS, SUMBER, CIREBON, JAWA BARAT",21,186,69,255
https://kawalpemilu.org#32137,"CILUAR, BOGOR UTARA, KOTA BOGOR, JAWA BARAT",52,60,103,163
https://kawalpemilu.org#32563,"CIBABAT, CIMAHI UTARA, KOTA CIMAHI, JAWA BARAT",84,66,162,228
https://kawalpemilu.org#30150,"SUNIA BARU, BANJARAN, MAJALENGKA, JAWA BARAT",3,101,106,207
https://kawalpemilu.org#30881,"KALIJATI TIMUR, KALIJATI, SUBANG, JAWA BARAT",6,88,136,224
https://kawalpemilu.org#29108,"CIHIDEUNG GIRANG, CIDAHU, KUNINGAN, JAWA BARAT",6,48,123,171
https://kawalpemilu.org#32098,"KATULAMPA, BOGOR TIMUR, KOTA BOGOR, JAWA BARAT",23,38,138,176
https://kawalpemilu.org#27444,"SAYATI, MARGAHAYU, BANDUNG, JAWA BARAT",30,39,133,172
https://kawalpemilu.org#29844,"KALAPADUA, LEMAHSUGIH, MAJALENGKA, JAWA BARAT",12,63,89,152
https://kawalpemilu.org#31002,"TAMBAKJATI, PATOKBEUSI, SUBANG, JAWA BARAT",12,129,65,194
https://kawalpemilu.org#28184,"CIHERAS, CIPATUJAH, TASIKMALAYA, JAWA BARAT",5,143,118,261
https://kawalpemilu.org#28084,"BOJONG, BUNGBULANG, GARUT, JAWA BARAT",8,60,90,150
https://kawalpemilu.org#28434,"MANGUNREJA, MANGUNREJA, TASIKMALAYA, JAWA BARAT",23,85,150,235
https://kawalpemilu.org#26877,"CIBATU, CISAAT, SUKABUMI, JAWA BARAT",6,31,148,179
https://kawalpemilu.org#27469,"BANJARAN WETAN, BANJARAN, BANDUNG, JAWA BARAT",45,161,60,221
https://kawalpemilu.org#31962,"TANIMULYA, NGAMPRAH, BANDUNG BARAT, JAWA BARAT",17,96,139,235
https://kawalpemilu.org#27597,"CIBEUREUM, KERTASARI, BANDUNG, JAWA BARAT",10,26,186,212
https://kawalpemilu.org#30784,"SUKRAWETAN, SUKRA, INDRAMAYU, JAWA BARAT",7,123,15,138
https://kawalpemilu.org#32341,"CISARANTEN BINA HARAPAN, ARCAMANIK, KOTA BANDUNG, JAWA BARAT",21,47,98,145
https://kawalpemilu.org#26299,"PURASARI, LEUWILIANG, BOGOR, JAWA BARAT",22,37,159,196
https://kawalpemilu.org#28193,"CIPANAS, CIPATUJAH, TASIKMALAYA, JAWA BARAT",1,139,93,232
https://kawalpemilu.org#29062,"TEMBONG, GARAWANGI, KUNINGAN, JAWA BARAT",3,93,95,188
https://kawalpemilu.org#31422,"TELUKBANGO, BATUJAYA, KARAWANG, JAWA BARAT",25,73,161,234
https://kawalpemilu.org#30979,"SINDANGLAYA, TANJUNGSIANG, SUBANG, JAWA BARAT",4,43,177,220
https://kawalpemilu.org#26795,"MEKAR MUKTI, WALURAN, SUKABUMI, JAWA BARAT",15,62,94,156
https://kawalpemilu.org#32138,"TANAH BARU, BOGOR UTARA, KOTA BOGOR, JAWA BARAT",60,32,106,138
https://kawalpemilu.org#26402,"BANTARKARET, NANGGUNG, BOGOR, JAWA BARAT",22,54,185,239
https://kawalpemilu.org#30375,"CILELES, JATINANGOR, SUMEDANG, JAWA BARAT",10,69,170,239
https://kawalpemilu.org#32322,"ANTAPANI TENGAH, ANTAPANI, KOTA BANDUNG, JAWA BARAT",46,98,120,218
https://kawalpemilu.org#31995,"BATUJAJAR TIMUR, BATUJAJAR, BANDUNG BARAT, JAWA BARAT",39,46,214,260
https://kawalpemilu.org#30182,"INDRAKILA, SINDANG, MAJALENGKA, JAWA BARAT",6,106,72,178
https://kawalpemilu.org#31145,"MUNJULJAYA, PURWAKARTA, PURWAKARTA, JAWA BARAT",37,76,198,274
https://kawalpemilu.org#26296,"BOJONGGEDE, BOJONG GEDE, BOGOR, JAWA BARAT",121,67,160,227
https://kawalpemilu.org#32185,"LEMBURSITU, LEMBURSITU, KOTA SUKABUMI, JAWA BARAT",5,49,146,195
https://kawalpemilu.org#30528,"GABUS KULON, GABUSWETAN, INDRAMAYU, JAWA BARAT",9,165,33,198
https://kawalpemilu.org#26490,"CIPICUNG, CIJERUK, BOGOR, JAWA BARAT",39,19,118,137
https://kawalpemilu.org#31046,"MAYANGAN, LEGONKULON, SUBANG, JAWA BARAT",2,39,65,104
https://kawalpemilu.org#26501,"PAGELARAN, CIOMAS, BOGOR, JAWA BARAT",47,74,127,201
https://kawalpemilu.org#32090,"HARJASARI, BOGOR SELATAN, KOTA BOGOR, JAWA BARAT",13,29,102,131
https://kawalpemilu.org#31358,"TAMANSARI, PANGKALAN, KARAWANG, JAWA BARAT",10,74,136,210
https://kawalpemilu.org#29537,"WANASABA LOR, TALUN, CIREBON, JAWA BARAT",7,118,99,217
https://kawalpemilu.org#31044,"CIPEUNDEUY, CIPEUNDEUY, SUBANG, JAWA BARAT",12,55,128,183
https://kawalpemilu.org#32421,"HARAPAN JAYA, BEKASI UTARA, KOTA BEKASI, JAWA BARAT",45,81,105,186
https://kawalpemilu.org#31351,"TUNGGAKJATI, KARAWANG BARAT, KARAWANG, JAWA BARAT",12,57,150,207
https://kawalpemilu.org#26599,"WANGUNJAYA, LEUWISADENG, BOGOR, JAWA BARAT",15,50,101,151
https://kawalpemilu.org#27232,"WARINGINSARI, TAKOKAK, CIANJUR, JAWA BARAT",11,44,138,182
https://kawalpemilu.org#26843,"BANYUWANGI, CIBITUNG, SUKABUMI, JAWA BARAT",6,56,145,201
https://kawalpemilu.org#27891,"SUKAMANAH, MALANGBONG, GARUT, JAWA BARAT",12,40,104,144
https://kawalpemilu.org#32571,"ARGASARI, CIHIDEUNG, KOTA TASIKMALAYA, JAWA BARAT",31,53,79,132
https://kawalpemilu.org#26335,"CIBATOK II, CIBUNGBULANG, BOGOR, JAWA BARAT",10,42,109,151
https://kawalpemilu.org#29142,"CILIMUS, CILIMUS, KUNINGAN, JAWA BARAT",14,29,172,201
https://kawalpemilu.org#32198,"SARIJADI, SUKASARI, KOTA BANDUNG, JAWA BARAT",51,77,144,221
https://kawalpemilu.org#32229,"PAJAJARAN, CICENDO, KOTA BANDUNG, JAWA BARAT",66,89,95,184
https://kawalpemilu.org#32431,"SEPANJANG JAYA, RAWA LUMBU, KOTA BEKASI, JAWA BARAT",92,94,106,200
https://kawalpemilu.org#30679,"PLUMBON, INDRAMAYU, INDRAMAYU, JAWA BARAT",10,175,48,223
https://kawalpemilu.org#28905,"MEKARMUKTI, CISAGA, CIAMIS, JAWA BARAT",5,74,76,150
https://kawalpemilu.org#27550,"TANJUNGLAYA, CIKANCUNG, BANDUNG, JAWA BARAT",24,61,162,223
https://kawalpemilu.org#26231,"CIPENJO, CILEUNGSI, BOGOR, JAWA BARAT",36,53,53,106
https://kawalpemilu.org#32504,"BAKTIJAYA, SUKMAJAYA, KOTA DEPOK, JAWA BARAT",58,126,160,286
https://kawalpemilu.org#27773,"SUKAGALIH, TAROGONG KIDUL, GARUT, JAWA BARAT",25,53,189,242
https://kawalpemilu.org#31971,"CIPTAHARJA, CIPATAT, BANDUNG BARAT, JAWA BARAT",33,63,112,175
https://kawalpemilu.org#31128,"PUSAKAJAYA, PUSAKAJAYA, SUBANG, JAWA BARAT",14,163,45,208
https://kawalpemilu.org#32454,"JATILUHUR, JATIASIH, KOTA BEKASI, JAWA BARAT",26,75,142,217
https://kawalpemilu.org#32372,"KARANG PAMULANG, MANDALAJATI, KOTA BANDUNG, JAWA BARAT",15,75,145,220
https://kawalpemilu.org#29009,"CIBINGBIN, CIBINGBIN, KUNINGAN, JAWA BARAT",18,89,76,165
https://kawalpemilu.org#28948,"KARANGPANINGGAL, PURWADADI, CIAMIS, JAWA BARAT",11,82,76,158
https://kawalpemilu.org#32351,"PASANGGRAHAN, UJUNG BERUNG, KOTA BANDUNG, JAWA BARAT",33,86,144,230
https://kawalpemilu.org#32115,"MENTENG, BOGOR BARAT, KOTA BOGOR, JAWA BARAT",6,74,97,171
https://kawalpemilu.org#27434,"BOJONGSOANG, BOJONGSOANG, BANDUNG, JAWA BARAT",41,66,161,227
https://kawalpemilu.org#27599,"TARUMAJAYA, KERTASARI, BANDUNG, JAWA BARAT",7,109,154,263
https://kawalpemilu.org#28822,"BABAKAN, PANGANDARAN, PANGANDARAN, JAWA BARAT",3,145,107,252
https://kawalpemilu.org#28594,"NASOL, CIKONENG, CIAMIS, JAWA BARAT",14,82,65,147
https://kawalpemilu.org#32466,"MUSTIKAJAYA, MUSTIKA JAYA, KOTA BEKASI, JAWA BARAT",96,112,141,253
https://kawalpemilu.org#28917,"SUKASENANG, SINDANGKASIH, CIAMIS, JAWA BARAT",16,34,151,185
https://kawalpemilu.org#29439,"KARANGMEKAR, KARANGSEMBUNG, CIREBON, JAWA BARAT",11,128,68,196
https://kawalpemilu.org#32215,"BABAKAN TAROGONG, BOJONGLOA KALER, KOTA BANDUNG, JAWA BARAT",52,74,104,178
https://kawalpemilu.org#28864,"KERTAMUKTI, CIMERAK, PANGANDARAN, JAWA BARAT",15,98,27,125
https://kawalpemilu.org#28033,"PANGRUMASAN, PEUNDEUY, GARUT, JAWA BARAT",5,10,110,120
https://kawalpemilu.org#30937,"SUKAMANDI JAYA, CIASEM, SUBANG, JAWA BARAT",52,71,124,195
https://kawalpemilu.org#32011,"CIHAMPELAS, CIHAMPELAS, BANDUNG BARAT, JAWA BARAT",22,60,161,221
https://kawalpemilu.org#32378,"SUKAPURA, KEJAKSAN, KOTA CIREBON, JAWA BARAT",8,116,109,225
https://kawalpemilu.org#32367,"SUKAMULYA, CINAMBO, KOTA BANDUNG, JAWA BARAT",11,72,165,237
https://kawalpemilu.org#26588,"CIBURUY, CIGOMBONG, BOGOR, JAWA BARAT",20,38,155,193
https://kawalpemilu.org#27146,"CIBODAS, PACET, CIANJUR, JAWA BARAT",13,95,111,206
https://kawalpemilu.org#30069,"MAJASARI, LIGUNG, MAJALENGKA, JAWA BARAT",3,61,75,136
https://kawalpemilu.org#32483,"TUGU, CIMANGGIS, KOTA DEPOK, JAWA BARAT",255,62,98,160
https://kawalpemilu.org#27453,"SANGKANHURIP, KATAPANG, BANDUNG, JAWA BARAT",3,85,126,211
https://kawalpemilu.org#32424,"MARGA JAYA, BEKASI SELATAN, KOTA BEKASI, JAWA BARAT",36,80,144,224
https://kawalpemilu.org#31751,"MEKARWANGI, CIKARANG BARAT, BEKASI, JAWA BARAT",27,58,113,171
https://kawalpemilu.org#32025,"KARANGTANJUNG, CILILIN, BANDUNG BARAT, JAWA BARAT",20,24,160,184
https://kawalpemilu.org#30242,"CIPASANG, CIBUGEL, SUMEDANG, JAWA BARAT",1,133,88,221
https://kawalpemilu.org#28575,"CIAMIS, CIAMIS, CIAMIS, JAWA BARAT",69,80,105,185
https://kawalpemilu.org#32423,"PEKAYON JAYA, BEKASI SELATAN, KOTA BEKASI, JAWA BARAT",3,112,134,246
https://kawalpemilu.org#26164,"CIKEAS UDIK, GUNUNG PUTRI, BOGOR, JAWA BARAT",42,52,156,208
https://kawalpemilu.org#26778,"PALASARI GIRANG, KALAPA NUNGGAL, SUKABUMI, JAWA BARAT",6,23,85,108
https://kawalpemilu.org#28023,"GIRIMUKTI, SINGAJAYA, GARUT, JAWA BARAT",10,54,115,169
https://kawalpemilu.org#26875,"BABAKAN, CISAAT, SUKABUMI, JAWA BARAT",5,41,139,180
https://kawalpemilu.org#30481,"UJUNGJAYA, UJUNGJAYA, SUMEDANG, JAWA BARAT",20,99,129,228
https://kawalpemilu.org#29625,"WANAKAYA, GUNUNG JATI, CIREBON, JAWA BARAT",2,102,141,243
https://kawalpemilu.org#30753,"ERETAN WETAN, KANDANGHAUR, INDRAMAYU, JAWA BARAT",11,156,43,199
https://kawalpemilu.org#28149,"DUNGUSWIRU, BL. LIMBANGAN, GARUT, JAWA BARAT",10,60,95,155
https://kawalpemilu.org#31438,"SRIJAYA, TIRTAJAYA, KARAWANG, JAWA BARAT",12,116,85,201
https://kawalpemilu.org#26393,"LUMPANG, PARUNG PANJANG, BOGOR, JAWA BARAT",17,80,100,180
https://kawalpemilu.org#28893,"BEBER, CIMARAGAS, CIAMIS, JAWA BARAT",6,39,82,123
https://kawalpemilu.org#31742,"WANASARI, CIBITUNG, BEKASI, JAWA BARAT",134,89,197,286
https://kawalpemilu.org#26629,"CIKAKAK, CIKAKAK, SUKABUMI, JAWA BARAT",7,41,91,132
https://kawalpemilu.org#26397,"KABASIRAN, PARUNG PANJANG, BOGOR, JAWA BARAT",12,74,115,189
https://kawalpemilu.org#32423,"PEKAYON JAYA, BEKASI SELATAN, KOTA BEKASI, JAWA BARAT",35,104,159,263
https://kawalpemilu.org#84886,"MEKARWARU, GANTAR, INDRAMAYU, JAWA BARAT",12,141,31,172
https://kawalpemilu.org#26509,"CIHERANG, DRAMAGA, BOGOR, JAWA BARAT",29,50,138,188
https://kawalpemilu.org#30942,"PATIMBAN, PUSAKANAGARA, SUBANG, JAWA BARAT",10,142,21,163
https://kawalpemilu.org#31924,"PADAASIH, CISARUA, BANDUNG BARAT, JAWA BARAT",8,124,123,247
https://kawalpemilu.org#30754,"ERETAN KULON, KANDANGHAUR, INDRAMAYU, JAWA BARAT",5,150,43,193
https://kawalpemilu.org#26293,"WARINGINJAYA, BOJONG GEDE, BOGOR, JAWA BARAT",29,71,100,171
https://kawalpemilu.org#32218,"SUKA ASIH, BOJONGLOA KALER, KOTA BANDUNG, JAWA BARAT",50,56,134,190
https://kawalpemilu.org#30542,"CIKEDUNG LOR, CIKEDUNG, INDRAMAYU, JAWA BARAT",4,131,87,218
https://kawalpemilu.org#32464,"CIMUNING, MUSTIKA JAYA, KOTA BEKASI, JAWA BARAT",12,78,141,219
https://kawalpemilu.org#26291,"RAGAJAYA, BOJONG GEDE, BOGOR, JAWA BARAT",3,69,123,192
https://kawalpemilu.org#30625,"LOMBANG, JUNTINYUAT, INDRAMAYU, JAWA BARAT",19,131,29,160
https://kawalpemilu.org#31480,"DAWUAN TENGAH, CIKAMPEK, KARAWANG, JAWA BARAT",19,45,128,173
https://kawalpemilu.org#27750,"WANAMEKAR, WANARAJA, GARUT, JAWA BARAT",19,44,77,121
https://kawalpemilu.org#30790,"SANCA, GANTAR, INDRAMAYU, JAWA BARAT",20,132,51,183
https://kawalpemilu.org#27887,"MEKARASIH, MALANGBONG, GARUT, JAWA BARAT",10,69,102,171
https://kawalpemilu.org#31786,"JATIREJA, CIKARANG TIMUR, BEKASI, JAWA BARAT",16,165,68,233
https://kawalpemilu.org#30690,"RAMBATAN WETAN, SINDANG, INDRAMAYU, JAWA BARAT",10,149,66,215
https://kawalpemilu.org#38539,"KENANTI, DUKUHSETI, PATI, JAWA TENGAH",3,182,14,196
https://kawalpemilu.org#36107,"CARIKAN, JUWIRING, KLATEN, JAWA TENGAH",7,196,20,216
https://kawalpemilu.org#40778,"KENDALSARI, PETARUKAN, PEMALANG, JAWA TENGAH",7,138,56,194
https://kawalpemilu.org#38926,"BANDUNGREJO, MRANGGEN, DEMAK, JAWA TENGAH",2,126,84,210
https://kawalpemilu.org#40636,"BATURSARI, PULOSARI, PEMALANG, JAWA TENGAH",5,103,4,107
https://kawalpemilu.org#84918,"TRITIH LOR, JERUKLEGI, CILACAP, JAWA TENGAH",18,155,41,196
https://kawalpemilu.org#32877,"JENANG, MAJENANG, CILACAP, JAWA TENGAH",20,157,83,240
https://kawalpemilu.org#40929,"BALAPULANG WETAN, BALAPULANG, TEGAL, JAWA TENGAH",27,161,49,210
https://kawalpemilu.org#38025,"PADARAN, REMBANG, REMBANG, JAWA TENGAH",6,214,22,236
https://kawalpemilu.org#39052,"JATISONO, GAJAH, DEMAK, JAWA TENGAH",6,129,53,182
https://kawalpemilu.org#40580,"PEKUNCEN, WIRADESA, PEKALONGAN, JAWA TENGAH",13,133,114,247
https://kawalpemilu.org#41303,"SIGENTONG, WANASARI, BREBES, JAWA TENGAH",15,155,42,197
https://kawalpemilu.org#39508,"SOBOREJO, PRINGSURAT, TEMANGGUNG, JAWA TENGAH",4,196,34,230
https://kawalpemilu.org#37321,"SIMO, KRADENAN, GROBOGAN, JAWA TENGAH",12,237,8,245
https://kawalpemilu.org#39609,"SUKOMARTO, JUMO, TEMANGGUNG, JAWA TENGAH",4,219,15,234
https://kawalpemilu.org#41763,"BRINGIN, NGALIYAN, KOTA SEMARANG, JAWA TENGAH",30,166,83,249
https://kawalpemilu.org#34232,"SIDOMUKTI, ADIMULYO, KEBUMEN, JAWA TENGAH",2,142,62,204
https://kawalpemilu.org#36395,"GENENGSARI, POLOKARTO, SUKOHARJO, JAWA TENGAH",4,167,79,246
https://kawalpemilu.org#36914,"NGASEM, COLOMADU, KARANGANYAR, JAWA TENGAH",12,186,13,199
https://kawalpemilu.org#38822,"JERUKWANGI, BANGSRI, JEPARA, JAWA TENGAH",6,174,35,209
https://kawalpemilu.org#36414,"TELUKAN, GROGOL, SUKOHARJO, JAWA TENGAH",12,166,92,258
https://kawalpemilu.org#36366,"MULUR, BENDOSARI, SUKOHARJO, JAWA TENGAH",12,157,87,244
https://kawalpemilu.org#34904,"SUMBEREJO, WADASLINTANG, WONOSOBO, JAWA TENGAH",6,113,27,140
https://kawalpemilu.org#41626,"SAWAH BESAR, GAYAM SARI, KOTA SEMARANG, JAWA TENGAH",16,186,16,202
https://kawalpemilu.org#33347,"KEDUNGBENDA, KEMANGKON, PURBALINGGA, JAWA TENGAH",11,163,5,168
https://kawalpemilu.org#33135,"KEDUNGRANDU, PATIKRAJA, BANYUMAS, JAWA TENGAH",14,160,34,194
https://kawalpemilu.org#87452,"TARISI, WANAREJA, CILACAP, JAWA TENGAH",20,156,26,182
https://kawalpemilu.org#38356,"DENGKEK, PATI, PATI, JAWA TENGAH",7,151,40,191
https://kawalpemilu.org#33457,"CANDIWULAN, KUTASARI, PURBALINGGA, JAWA TENGAH",4,154,36,190
https://kawalpemilu.org#40080,"BANDAR, BANDAR, BATANG, JAWA TENGAH",6,137,67,204
https://kawalpemilu.org#39991,"TAMBAKSARI, ROWOSARI, KENDAL, JAWA TENGAH",8,194,11,205
https://kawalpemilu.org#36556,"BATURETNO, BATURETNO, WONOGIRI, JAWA TENGAH",13,130,58,188
https://kawalpemilu.org#35390,"NGAWONGGO, KALIANGKRIK, MAGELANG, JAWA TENGAH",3,165,42,207
https://kawalpemilu.org#41836,"PEKAUMAN, TEGAL BARAT, KOTA TEGAL, JAWA TENGAH",20,133,114,247
https://kawalpemilu.org#37342,"KARANGREJO, GABUS, GROBOGAN, JAWA TENGAH",7,177,12,189
https://kawalpemilu.org#36141,"DELANGGU, DELANGGU, KLATEN, JAWA TENGAH",19,129,21,150
https://kawalpemilu.org#35387,"SUKOMAKMUR, KAJORAN, MAGELANG, JAWA TENGAH",3,133,11,144
https://kawalpemilu.org#37007,"MANYARREJO, PLUPUH, SRAGEN, JAWA TENGAH",5,144,25,169
https://kawalpemilu.org#39269,"KESONGO, TUNTANG, SEMARANG, JAWA TENGAH",8,168,63,231
https://kawalpemilu.org#35569,"GIRIMULYO, WINDUSARI, MAGELANG, JAWA TENGAH",4,170,63,233
https://kawalpemilu.org#41682,"GAJAHMUNGKUR, GAJAH MUNGKUR, KOTA SEMARANG, JAWA TENGAH",12,197,34,231
https://kawalpemilu.org#40851,"PESANTREN, ULUJAMI, PEMALANG, JAWA TENGAH",25,163,39,202
https://kawalpemilu.org#37487,"TLOGOREJO, TEGOWANU, GROBOGAN, JAWA TENGAH",12,181,29,210
https://kawalpemilu.org#41424,"LARANGAN, LARANGAN, BREBES, JAWA TENGAH",68,125,44,169
https://kawalpemilu.org#34949,"SAPURAN, SAPURAN, WONOSOBO, JAWA TENGAH",17,163,26,189
https://kawalpemilu.org#38493,"GUNUNGWUNGKAL, GUNUNGWUNGKAL, PATI, JAWA TENGAH",7,130,30,160
https://kawalpemilu.org#41163,"DUKUHWARU, DUKUHWARU, TEGAL, JAWA TENGAH",22,97,91,188
https://kawalpemilu.org#36844,"PABLENGAN, MATESIH, KARANGANYAR, JAWA TENGAH",4,103,21,124
https://kawalpemilu.org#39399,"ROGOMULYO, KALIWUNGU, SEMARANG, JAWA TENGAH",3,198,28,226
https://kawalpemilu.org#37067,"BEDORO, SAMBUNGMACAN, SRAGEN, JAWA TENGAH",17,135,22,157
https://kawalpemilu.org#35256,"SRUMBUNG, SRUMBUNG, MAGELANG, JAWA TENGAH",11,117,65,182
https://kawalpemilu.org#33978,"GROGOLBENINGSARI, PETANAHAN, KEBUMEN, JAWA TENGAH",4,156,59,215
https://kawalpemilu.org#39994,"TANJUNGSARI, ROWOSARI, KENDAL, JAWA TENGAH",10,182,26,208
https://kawalpemilu.org#41823,"JENGGOT, PEKALONGAN SELATAN, KOTA PEKALONGAN, JAWA TENGAH",22,121,116,237
https://kawalpemilu.org#41200,"PANGEBATAN, BANTARKAWUNG, BREBES, JAWA TENGAH",37,38,88,126
https://kawalpemilu.org#39272,"TUNTANG, TUNTANG, SEMARANG, JAWA TENGAH",15,203,35,238
https://kawalpemilu.org#36252,"NGEMPLAK, KALIKOTES, KLATEN, JAWA TENGAH",10,125,59,184
https://kawalpemilu.org#33683,"KRANDEGAN, BANJARNEGARA, BANJARNEGARA, JAWA TENGAH",21,70,57,127
https://kawalpemilu.org#36695,"BULUKERTO, BULUKERTO, WONOGIRI, JAWA TENGAH",8,157,21,178
https://kawalpemilu.org#36214,"KAYUMAS, JATINOM, KLATEN, JAWA TENGAH",3,230,20,250
https://kawalpemilu.org#38579,"KALIWUNGU, KALIWUNGU, KUDUS, JAWA TENGAH",10,153,22,175
https://kawalpemilu.org#34851,"TRIREJO, LOANO, PURWOREJO, JAWA TENGAH",1,94,28,122
https://kawalpemilu.org#33052,"KECILA, KEMRANJEN, BANYUMAS, JAWA TENGAH",17,125,74,199
https://kawalpemilu.org#41023,"DUKUHSALAM, SLAWI, TEGAL, JAWA TENGAH",8,111,86,197
https://kawalpemilu.org#40181,"KEBONDALEM, GRINGSING, BATANG, JAWA TENGAH",15,138,29,167
https://kawalpemilu.org#33031,"TIPAR, RAWALO, BANYUMAS, JAWA TENGAH",6,148,32,180
https://kawalpemilu.org#40591,"REMBUN, SIWALAN, PEKALONGAN, JAWA TENGAH",1,170,15,185
https://kawalpemilu.org#35088,"KURIPAN, WATUMALANG, WONOSOBO, JAWA TENGAH",4,165,13,178
https://kawalpemilu.org#35893,"GESIKAN, GANTIWARNO, KLATEN, JAWA TENGAH",1,115,43,158
https://kawalpemilu.org#32863,"NEGARAJATI, CIMANGGU, CILACAP, JAWA TENGAH",6,105,43,148
https://kawalpemilu.org#39027,"GETAS, WONOSALAM, DEMAK, JAWA TENGAH",12,147,54,201
https://kawalpemilu.org#37964,"RINGIN, PAMOTAN, REMBANG, JAWA TENGAH",1,98,68,166
https://kawalpemilu.org#41665,"PETERONGAN, SEMARANG SELATAN, KOTA SEMARANG, JAWA TENGAH",9,216,44,183
https://kawalpemilu.org#36999,"DONOYUDAN, KALIJAMBE, SRAGEN, JAWA TENGAH",14,150,60,210
https://kawalpemilu.org#40984,"KEDUNGBANTENG, KEDUNGBANTENG, TEGAL, JAWA TENGAH",15,141,53,194
https://kawalpemilu.org#41135,"JATIMULYA, SURADADI, TEGAL, JAWA TENGAH",9,160,33,193
https://kawalpemilu.org#40794,"KLAREYAN, PETARUKAN, PEMALANG, JAWA TENGAH",39,0,0,0
https://kawalpemilu.org#33025,"MENGANTI, RAWALO, BANYUMAS, JAWA TENGAH",8,128,34,162
https://kawalpemilu.org#40291,"KARANGGENENG, KANDEMAN, BATANG, JAWA TENGAH",6,176,38,214
https://kawalpemilu.org#38122,"GEDONGMULYO, LASEM, REMBANG, JAWA TENGAH",11,146,43,189
https://kawalpemilu.org#41325,"PEMARON, BREBES, BREBES, JAWA TENGAH",1,79,96,175
https://kawalpemilu.org#41295,"KLAMPOK, WANASARI, BREBES, JAWA TENGAH",14,185,18,203
https://kawalpemilu.org#39200,"TEGALREJO, TENGARAN, SEMARANG, JAWA TENGAH",4,138,75,213
https://kawalpemilu.org#41833,"PESURUNGAN KIDUL, TEGAL BARAT, KOTA TEGAL, JAWA TENGAH",3,134,56,190
https://kawalpemilu.org#33493,"TLAGAYASA, BOBOTSARI, PURBALINGGA, JAWA TENGAH",6,140,66,206
https://kawalpemilu.org#40929,"BALAPULANG WETAN, BALAPULANG, TEGAL, JAWA TENGAH",7,162,66,228
https://kawalpemilu.org#33250,"LEDUG, KEMBARAN, BANYUMAS, JAWA TENGAH",7,150,57,207
https://kawalpemilu.org#34677,"SUMBERSARI, BUTUH, PURWOREJO, JAWA TENGAH",1,65,39,104
https://kawalpemilu.org#41673,"JOMBLANG, CANDISARI, KOTA SEMARANG, JAWA TENGAH",45,195,39,234
https://kawalpemilu.org#37247,"MOJOAGUNG, KARANGRAYUNG, GROBOGAN, JAWA TENGAH",17,168,18,186
https://kawalpemilu.org#36729,"GONDANGSARI, JATISRONO, WONOGIRI, JAWA TENGAH",13,146,21,167
https://kawalpemilu.org#40283,"BAKALAN, KANDEMAN, BATANG, JAWA TENGAH",6,219,20,239
https://kawalpemilu.org#39532,"SAMIRANAN, KANDANGAN, TEMANGGUNG, JAWA TENGAH",7,182,25,207
https://kawalpemilu.org#40020,"KEDUNGSARI, RINGINARUM, KENDAL, JAWA TENGAH",4,192,17,209
https://kawalpemilu.org#41230,"PAKUJATI, PAGUYANGAN, BREBES, JAWA TENGAH",10,128,57,185
https://kawalpemilu.org#34326,"GUNUNGSARI, KARANGGAYAM, KEBUMEN, JAWA TENGAH",11,85,27,112
https://kawalpemilu.org#35187,"NGADIREJO, SALAMAN, MAGELANG, JAWA TENGAH",9,152,43,195
https://kawalpemilu.org#40049,"MAGELUNG, KALIWUNGU SELATAN, KENDAL, JAWA TENGAH",10,175,24,199
https://kawalpemilu.org#34055,"SINGOSARI, AMBAL, KEBUMEN, JAWA TENGAH",3,153,58,211
https://kawalpemilu.org#39159,"MUTIH WETAN, WEDUNG, DEMAK, JAWA TENGAH",4,101,44,145
https://kawalpemilu.org#33028,"TAMBAKNEGARA, RAWALO, BANYUMAS, JAWA TENGAH",14,145,45,190
https://kawalpemilu.org#35940,"BENDUNGAN, CAWAS, KLATEN, JAWA TENGAH",3,109,35,144
https://kawalpemilu.org#32741,"PAGUBUGAN KULON, BINANGUN, CILACAP, JAWA TENGAH",8,154,44,198
https://kawalpemilu.org#32874,"PAHONJEAN, MAJENANG, CILACAP, JAWA TENGAH",25,123,61,184
https://kawalpemilu.org#34573,"MRANTI, PURWOREJO, PURWOREJO, JAWA TENGAH",4,142,34,176
https://kawalpemilu.org#39137,"TRIDONOREJO, BONANG, DEMAK, JAWA TENGAH",16,0,0,0
https://kawalpemilu.org#37676,"TAMANREJO, TUNJUNGAN, BLORA, JAWA TENGAH",1,121,74,195
https://kawalpemilu.org#34402,"BAKUREJO, GRABAG, PURWOREJO, JAWA TENGAH",2,102,14,116
https://kawalpemilu.org#38833,"KELING, KELING, JEPARA, JAWA TENGAH",19,159,8,167
https://kawalpemilu.org#34920,"GONDOWULAN, KEPIL, WONOSOBO, JAWA TENGAH",1,75,53,128
https://kawalpemilu.org#38854,"TAHUNAN, TAHUNAN, JEPARA, JAWA TENGAH",31,205,28,233
https://kawalpemilu.org#38984,"BEDONO, SAYUNG, DEMAK, JAWA TENGAH",8,197,29,226
https://kawalpemilu.org#38475,"NGEMPLAK LOR, MARGOYOSO, PATI, JAWA TENGAH",4,108,41,149
https://kawalpemilu.org#34836,"SALAM, GEBANG, PURWOREJO, JAWA TENGAH",2,95,16,111
https://kawalpemilu.org#37060,"PLOSOREJO, GONDANG, SRAGEN, JAWA TENGAH",10,141,16,157
https://kawalpemilu.org#38735,"LEBUAWU, PECANGAAN, JEPARA, JAWA TENGAH",5,137,56,193
https://kawalpemilu.org#41021,"KALISAPU, SLAWI, TEGAL, JAWA TENGAH",3,94,124,218
https://kawalpemilu.org#39485,"PURWOREJO, TEMANGGUNG, TEMANGGUNG, JAWA TENGAH",6,147,35,182
https://kawalpemilu.org#39009,"WONOAGUNG, KARANGTENGAH, DEMAK, JAWA TENGAH",1,158,41,199
https://kawalpemilu.org#33756,"KANDANGWANGI, WANADADI, BANJARNEGARA, JAWA TENGAH",11,162,47,209
https://kawalpemilu.org#41576,"TEGALREJO, ARGOMULYO, KOTA SALATIGA, JAWA TENGAH",35,143,90,233
https://kawalpemilu.org#33053,"NUSAMANGIR, KEMRANJEN, BANYUMAS, JAWA TENGAH",4,119,47,166
https://kawalpemilu.org#84931,"PANULISAN TIMUR, DAYEUHLUHUR, CILACAP, JAWA TENGAH",11,119,22,141
https://kawalpemilu.org#33684,"KUTABANJARNEGARA, BANJARNEGARA, BANJARNEGARA, JAWA TENGAH",24,96,124,220
https://kawalpemilu.org#33511,"LUMPANG, KARANGANYAR, PURBALINGGA, JAWA TENGAH",5,130,53,183
https://kawalpemilu.org#35965,"SAJEN, TRUCUK, KLATEN, JAWA TENGAH",1,153,37,190
https://kawalpemilu.org#87464,"DAYEUHLUHUR, DAYEUHLUHUR, CILACAP, JAWA TENGAH",17,136,53,189
https://kawalpemilu.org#33537,"LOSARI, REMBANG, PURBALINGGA, JAWA TENGAH",20,82,48,130
https://kawalpemilu.org#37848,"SENDANGMULYO, BULU, REMBANG, JAWA TENGAH",6,175,7,182
https://kawalpemilu.org#87453,"BANTAR, WANAREJA, CILACAP, JAWA TENGAH",4,114,88,202
https://kawalpemilu.org#37903,"BABAKTULUNG, SARANG, REMBANG, JAWA TENGAH",8,102,54,156
https://kawalpemilu.org#39362,"GONDORIYO, BERGAS, SEMARANG, JAWA TENGAH",4,203,23,226
https://kawalpemilu.org#35592,"NGARGOSARI, AMPEL, BOYOLALI, JAWA TENGAH",5,159,26,185
https://kawalpemilu.org#36440,"GENTAN, BAKI, SUKOHARJO, JAWA TENGAH",17,177,69,246
https://kawalpemilu.org#36945,"KEBAK, KEBAKKRAMAT, KARANGANYAR, JAWA TENGAH",8,77,33,110
https://kawalpemilu.org#33681,"PARAKANCANGGAH, BANJARNEGARA, BANJARNEGARA, JAWA TENGAH",19,163,89,252
https://kawalpemilu.org#35967,"KRADENAN, TRUCUK, KLATEN, JAWA TENGAH",11,139,65,204
https://kawalpemilu.org#41769,"WONOSARI, NGALIYAN, KOTA SEMARANG, JAWA TENGAH",37,112,76,188
https://kawalpemilu.org#87476,"SERANG, CIPARI, CILACAP, JAWA TENGAH",3,118,58,176
https://kawalpemilu.org#35132,"MENJER, GARUNG, WONOSOBO, JAWA TENGAH",3,167,36,203
https://kawalpemilu.org#41524,"SEMANGGI, PASAR KLIWON, KOTA SURAKARTA, JAWA TENGAH",61,181,54,235
https://kawalpemilu.org#41620,"REJOSARI, SEMARANG TIMUR, KOTA SEMARANG, JAWA TENGAH",19,165,45,210
https://kawalpemilu.org#48619,"KAPAS, KAPAS, BOJONEGORO, JAWA TIMUR",1,87,77,164
https://kawalpemilu.org#42947,"SUMBER BENING, DONGKO, TRENGGALEK, JAWA TIMUR",13,187,22,209
https://kawalpemilu.org#48632,"MOJOKAMPUNG, BOJONEGORO, BOJONEGORO, JAWA TIMUR",11,104,90,194
https://kawalpemilu.org#51432,"TAMBAKREJO, SIMOKERTO, KOTA SURABAYA, JAWA TIMUR",5,103,42,145
https://kawalpemilu.org#43235,"SUMBERINGIN KULON, NGUNUT, TULUNGAGUNG, JAWA TIMUR",2,151,32,183
https://kawalpemilu.org#89586,"GADUNGAN, WATES, KEDIRI, JAWA TIMUR",1,187,17,204
https://kawalpemilu.org#44973,"BENCULUK, CLURING, BANYUWANGI, JAWA TIMUR",27,170,37,207
https://kawalpemilu.org#45915,"PURUT, LUMBANG, PROBOLINGGO, JAWA TIMUR",15,104,80,184
https://kawalpemilu.org#44593,"KALIBOTO LOR, JATIROTO, LUMAJANG, JAWA TIMUR",30,94,49,143
https://kawalpemilu.org#48015,"PANDEAN, MAOSPATI, MAGETAN, JAWA TIMUR",5,178,56,234
https://kawalpemilu.org#48361,"SUMBERARUM, NGRAHO, BOJONEGORO, JAWA TIMUR",7,144,22,166
https://kawalpemilu.org#42590,"GUNDIK, SLAHUNG, PONOROGO, JAWA TIMUR",6,159,63,222
https://kawalpemilu.org#44625,"TEGALBANGSRI, RANUYOSO, LUMAJANG, JAWA TIMUR",1,87,129,216
https://kawalpemilu.org#48244,"GENTONG, PARON, NGAWI, JAWA TIMUR",4,117,89,206
https://kawalpemilu.org#42635,"CAMPURSARI, SAMBIT, PONOROGO, JAWA TIMUR",4,143,58,201
https://kawalpemilu.org#50005,"LEBAK, SANGKAPURA, GRESIK, JAWA TIMUR",11,53,88,141
https://kawalpemilu.org#44663,"SUMBERAGUNG, SUMBERBARU, JEMBER, JAWA TIMUR",30,120,54,174
https://kawalpemilu.org#51270,"KARANGKETUG, GADINGREJO, KOTA PASURUAN, JAWA TIMUR",1,109,83,192
https://kawalpemilu.org#43076,"BAGO, TULUNGAGUNG, TULUNGAGUNG, JAWA TIMUR",24,155,57,212
https://kawalpemilu.org#47573,"MUSIR LOR, REJOSO, NGANJUK, JAWA TIMUR",2,136,37,173
https://kawalpemilu.org#51214,"TANJUNGREJO, SUKUN, KOTA MALANG, JAWA TIMUR",71,209,36,245
https://kawalpemilu.org#50779,"POTERAN, TALANGO, SUMENEP, JAWA TIMUR",11,68,67,135
https://kawalpemilu.org#48162,"SIDOREJO, KENDAL, NGAWI, JAWA TIMUR",4,143,13,156
https://kawalpemilu.org#44844,"PATEMON, PAKUSARI, JEMBER, JAWA TIMUR",4,116,77,193
https://kawalpemilu.org#50341,"BUNDAH, SRESEH, SAMPANG, JAWA TIMUR",6,58,130,188
https://kawalpemilu.org#50777,"ESSANG, TALANGO, SUMENEP, JAWA TIMUR",3,111,48,159
https://kawalpemilu.org#46784,"PUNGGING, PUNGGING, MOJOKERTO, JAWA TIMUR",23,158,36,194
https://kawalpemilu.org#46451,"SIDOKARE, SIDOARJO, SIDOARJO, JAWA TIMUR",35,145,91,236
https://kawalpemilu.org#44739,"LOJEJER, WULUHAN, JEMBER, JAWA TIMUR",29,139,51,190
https://kawalpemilu.org#49096,"NGRAYUNG, PLUMPANG, TUBAN, JAWA TIMUR",3,140,57,197
https://kawalpemilu.org#42525,"NGLARAN, TULAKAN, PACITAN, JAWA TIMUR",2,35,140,175
https://kawalpemilu.org#50620,"RANGPERANG DAJA, PROPPO, PAMEKASAN, JAWA TIMUR",4,8,185,193
https://kawalpemilu.org#46051,"KALIREJO, SUKOREJO, PASURUAN, JAWA TIMUR",11,147,101,248
https://kawalpemilu.org#50547,"BUKEK, TLANAKAN, PAMEKASAN, JAWA TIMUR",1,0,0,0
https://kawalpemilu.org#44224,"KEMANTREN, JABUNG, MALANG, JAWA TIMUR",1,60,94,154
https://kawalpemilu.org#49332,"BLUMBANG, MADURAN, LAMONGAN, JAWA TIMUR",1,77,35,112
https://kawalpemilu.org#48263,"KEDUNGGALAR, KEDUNGGALAR, NGAWI, JAWA TIMUR",28,130,60,190
https://kawalpemilu.org#50646,"PLAK PAK, PEGANTENAN, PAMEKASAN, JAWA TIMUR",6,7,206,213
https://kawalpemilu.org#47680,"KAIBON, GEGER, MADIUN, JAWA TIMUR",11,152,42,194
https://kawalpemilu.org#44324,"SIDOLUHUR, LAWANG, MALANG, JAWA TIMUR",19,132,30,162
https://kawalpemilu.org#51425,"KAPASMADYA BARU, TAMBAKSARI, KOTA SURABAYA, JAWA TIMUR",25,147,62,209
https://kawalpemilu.org#49295,"TITIK, SEKARAN, LAMONGAN, JAWA TIMUR",1,73,30,103
https://kawalpemilu.org#43657,"TAMBIBENDO, MOJO, KEDIRI, JAWA TIMUR",11,127,37,164
https://kawalpemilu.org#50016,"DAUN, SANGKAPURA, GRESIK, JAWA TIMUR",14,93,86,194
https://kawalpemilu.org#49083,"SUMURGUNG, TUBAN, TUBAN, JAWA TIMUR",24,77,74,151
https://kawalpemilu.org#45234,"PETUNG, CURAHDAMI, BONDOWOSO, JAWA TIMUR",2,61,126,187
https://kawalpemilu.org#45436,"KETAH, SUBOH, SITUBONDO, JAWA TIMUR",5,124,57,181
https://kawalpemilu.org#47975,"TINAP, SUKOMORO, MAGETAN, JAWA TIMUR",12,95,50,145
https://kawalpemilu.org#48440,"WEDORO, SUGIHWARAS, BOJONEGORO, JAWA TIMUR",1,103,85,188
https://kawalpemilu.org#46556,"SEKETI, BALONGBENDO, SIDOARJO, JAWA TIMUR",2,206,26,232
https://kawalpemilu.org#51206,"ARJOWINANGUN, KEDUNGKANDANG, KOTA MALANG, JAWA TIMUR",10,143,96,239
https://kawalpemilu.org#44475,"SUKOSARI, KUNIR, LUMAJANG, JAWA TIMUR",6,138,70,208
https://kawalpemilu.org#45530,"WONOREJO, BANYUPUTIH, SITUBONDO, JAWA TIMUR",6,133,20,153
https://kawalpemilu.org#50473,"NEPA, BANYUATES, SAMPANG, JAWA TIMUR",10,13,165,178
https://kawalpemilu.org#43524,"SUMBERAGUNG, PANGGUNGREJO, BLITAR, JAWA TIMUR",2,105,48,153
https://kawalpemilu.org#50889,"AENGPANAS, PRAGAAN, SUMENEP, JAWA TIMUR",9,48,141,189
https://kawalpemilu.org#43106,"RINGINPITU, KEDUNGWARU, TULUNGAGUNG, JAWA TIMUR",19,193,22,215
https://kawalpemilu.org#44332,"KETINDAN, LAWANG, MALANG, JAWA TIMUR",11,143,69,212
https://kawalpemilu.org#51212,"BANDUNGREJOSARI, SUKUN, KOTA MALANG, JAWA TIMUR",39,130,59,189
https://kawalpemilu.org#46930,"BERATWETAN, GEDEG, MOJOKERTO, JAWA TIMUR",2,161,45,206
https://kawalpemilu.org#51308,"KRANGGAN, KRANGGAN, KOTA MOJOKERTO, JAWA TIMUR",15,140,66,206
https://kawalpemilu.org#87494,"KEBONSARI KULON, KANIGARAN, KOTA PROBOLINGGO, JAWA TIMUR",5,120,108,228
https://kawalpemilu.org#46211,"GROGOL, GONDANGWETAN, PASURUAN, JAWA TIMUR",5,192,43,235
https://kawalpemilu.org#47645,"REJOSARI, KEBONSARI, MADIUN, JAWA TIMUR",2,102,40,142
https://kawalpemilu.org#45058,"DADAPAN, KABAT, BANYUWANGI, JAWA TIMUR",9,145,83,228
https://kawalpemilu.org#49873,"SUKO ANYAR, CERME, GRESIK, JAWA TIMUR",2,96,79,175
https://kawalpemilu.org#45757,"KANDANGJATI KULON, KRAKSAAN, PROBOLINGGO, JAWA TIMUR",4,146,55,201
https://kawalpemilu.org#51405,"MOJO, GUBENG, KOTA SURABAYA, JAWA TIMUR",16,137,39,176
https://kawalpemilu.org#43885,"TERTEK, PARE, KEDIRI, JAWA TIMUR",31,125,66,191
https://kawalpemilu.org#46666,"TAMBAKSAWAH, WARU, SIDOARJO, JAWA TIMUR",7,173,49,222
https://kawalpemilu.org#46648,"TAMBAKCEMANDI, SEDATI, SIDOARJO, JAWA TIMUR",5,174,46,220
https://kawalpemilu.org#50134,"TENGGUN DAJAH, KLAMPIS, BANGKALAN, JAWA TIMUR",10,75,129,204
https://kawalpemilu.org#49601,"LALADAN, DEKET, LAMONGAN, JAWA TIMUR",3,105,42,147
https://kawalpemilu.org#43979,"KARANGREJO, NGASEM, KEDIRI, JAWA TIMUR",30,131,57,188
https://kawalpemilu.org#47435,"KALORAN, NGRONGGOT, NGANJUK, JAWA TIMUR",6,148,19,167
https://kawalpemilu.org#49207,"GIRIK, NGIMBANG, LAMONGAN, JAWA TIMUR",1,154,31,185
https://kawalpemilu.org#45471,"MIMBAAN, PANJI, SITUBONDO, JAWA TIMUR",13,87,66,153
https://kawalpemilu.org#42919,"NGULUNGWETAN, MUNJUNGAN, TRENGGALEK, JAWA TIMUR",7,173,18,191
https://kawalpemilu.org#48921,"GEMULUNG, KEREK, TUBAN, JAWA TIMUR",5,142,16,158
https://kawalpemilu.org#51374,"PENJARINGAN SARI, RUNGKUT, KOTA SURABAYA, JAWA TIMUR",32,134,103,237
https://kawalpemilu.org#45225,"DAWUHAN, GRUJUGAN, BONDOWOSO, JAWA TIMUR",1,57,139,196
https://kawalpemilu.org#45505,"JATISARI, ARJASA, SITUBONDO, JAWA TIMUR",25,102,32,134
https://kawalpemilu.org#44298,"AMPELDENTO, KARANGPLOSO, MALANG, JAWA TIMUR",2,146,77,223
https://kawalpemilu.org#48706,"KUNIRAN, PURWOSARI, BOJONEGORO, JAWA TIMUR",13,152,50,202
https://kawalpemilu.org#43572,"TANGKIL, WLINGI, BLITAR, JAWA TIMUR",10,97,59,156
https://kawalpemilu.org#46567,"TAMAN, TAMAN, SIDOARJO, JAWA TIMUR",10,118,58,176
https://kawalpemilu.org#44808,"JEMBERKIDUL, KALIWATES, JEMBER, JAWA TIMUR",55,114,58,172
https://kawalpemilu.org#43608,"WATES, WATES, BLITAR, JAWA TIMUR",10,126,53,179
https://kawalpemilu.org#51422,"PACARKEMBANG, TAMBAKSARI, KOTA SURABAYA, JAWA TIMUR",112,92,65,157
https://kawalpemilu.org#48772,"SUKOSEWU, SUKOSEWU, BOJONEGORO, JAWA TIMUR",7,128,94,222
https://kawalpemilu.org#51204,"MADYOPURO, KEDUNGKANDANG, KOTA MALANG, JAWA TIMUR",23,84,105,189
https://kawalpemilu.org#43456,"GLEDUG, SANANKULON, BLITAR, JAWA TIMUR",5,127,21,148
https://kawalpemilu.org#51407,"KERTAJAYA, GUBENG, KOTA SURABAYA, JAWA TIMUR",42,133,59,192
https://kawalpemilu.org#44818,"PATRANG, PATRANG, JEMBER, JAWA TIMUR",31,123,86,209
https://kawalpemilu.org#45403,"BOTOLINGGO, BOTOLINGGO, BONDOWOSO, JAWA TIMUR",7,64,105,169
https://kawalpemilu.org#43201,"BENDUNGAN, GONDANG, TULUNGAGUNG, JAWA TIMUR",8,136,35,171
https://kawalpemilu.org#51380,"NGAGEL, WONOKROMO, KOTA SURABAYA, JAWA TIMUR",7,177,29,206
https://kawalpemilu.org#47129,"PANDANWANGI, DIWEK, JOMBANG, JAWA TIMUR",7,124,54,178
https://kawalpemilu.org#51325,"KEDUNDUNG, MAGERSARI, KOTA MOJOKERTO, JAWA TIMUR",44,116,76,192
https://kawalpemilu.org#44295,"KEPUHARJO, KARANGPLOSO, MALANG, JAWA TIMUR",12,163,79,242
https://kawalpemilu.org#44721,"TUGUSARI, BANGSALSARI, JEMBER, JAWA TIMUR",21,84,121,205
https://kawalpemilu.org#44755,"NOGOSARI, RAMBIPUJI, JEMBER, JAWA TIMUR",51,170,26,196
https://kawalpemilu.org#44371,"SEGARAN, GEDANGAN, MALANG, JAWA TIMUR",6,171,45,216
https://kawalpemilu.org#45954,"BANJARIMBO, LUMBANG, PASURUAN, JAWA TIMUR",5,170,29,199
https://kawalpemilu.org#46879,"SUMOLAWANG, PURI, MOJOKERTO, JAWA TIMUR",3,96,87,183
https://kawalpemilu.org#46710,"WONOPLOSO, GONDANG, MOJOKERTO, JAWA TIMUR",8,157,51,208
https://kawalpemilu.org#43992,"BLARU, BADAS, KEDIRI, JAWA TIMUR",12,130,37,167
https://kawalpemilu.org#43382,"SUKOREJO, UDANAWU, BLITAR, JAWA TIMUR",6,128,37,165
https://kawalpemilu.org#44587,"BANDARAN, KEDUNGJAJANG, LUMAJANG, JAWA TIMUR",2,98,82,180
https://kawalpemilu.org#44051,"REMBUN, DAMPIT, MALANG, JAWA TIMUR",6,118,65,183
https://kawalpemilu.org#48428,"MOJORANU, DANDER, BOJONEGORO, JAWA TIMUR",2,193,21,214
https://kawalpemilu.org#47798,"PAJARAN, SARADAN, MADIUN, JAWA TIMUR",2,151,40,191
https://kawalpemilu.org#47528,"KEDONDONG, BAGOR, NGANJUK, JAWA TIMUR",5,162,27,189
https://kawalpemilu.org#44240,"MANGLIAWAN, PAKIS, MALANG, JAWA TIMUR",9,207,61,268
https://kawalpemilu.org#46394,"KEDUNGPANDAN, JABON, SIDOARJO, JAWA TIMUR",8,170,49,219
https://kawalpemilu.org#51153,"KEPANJENLOR, KEPANJENKIDUL, KOTA BLITAR, JAWA TIMUR",6,142,52,194
https://kawalpemilu.org#51312,"PULOREJO, PRAJURIT KULON, KOTA MOJOKERTO, JAWA TIMUR",10,165,73,238
https://kawalpemilu.org#44260,"NGAJUM, NGAJUM, MALANG, JAWA TIMUR",7,183,34,217
https://kawalpemilu.org#51100,"POJOK, MOJOROTO, KOTA KEDIRI, JAWA TIMUR",1,147,46,193
https://kawalpemilu.org#44116,"TALANGSUKO, TUREN, MALANG, JAWA TIMUR",17,173,42,215
https://kawalpemilu.org#47216,"PULOREJO, TEMBELANG, JOMBANG, JAWA TIMUR",11,126,43,169
https://kawalpemilu.org#45618,"KLENANG KIDUL, BANYUANYAR, PROBOLINGGO, JAWA TIMUR",4,113,25,138
https://kawalpemilu.org#47243,"PLANDAAN, PLANDAAN, JOMBANG, JAWA TIMUR",5,127,45,172
https://kawalpemilu.org#49856,"MANYAR REJO, MANYAR, GRESIK, JAWA TIMUR",1,161,102,263
https://kawalpemilu.org#50427,"BATOPORO TIMUR, KEDUNGDUNG, SAMPANG, JAWA TIMUR",30,171,55,226
https://kawalpemilu.org#45022,"SINGOJURUH, SINGOJURUH, BANYUWANGI, JAWA TIMUR",21,170,44,214
https://kawalpemilu.org#46641,"SAWOTRATAP, GEDANGAN, SIDOARJO, JAWA TIMUR",9,123,67,190
https://kawalpemilu.org#42565,"KLEPU, SUDIMORO, PACITAN, JAWA TIMUR",6,93,77,170
https://kawalpemilu.org#44808,"JEMBERKIDUL, KALIWATES, JEMBER, JAWA TIMUR",29,116,62,178
https://kawalpemilu.org#44265,"KESAMBEN, NGAJUM, MALANG, JAWA TIMUR",13,112,55,167
https://kawalpemilu.org#46321,"SEBANI, TARIK, SIDOARJO, JAWA TIMUR",8,143,65,208
https://kawalpemilu.org#46995,"KENANTEN, PURI, MOJOKERTO, JAWA TIMUR",10,154,84,238
https://kawalpemilu.org#48145,"JATEN, JOGOROGO, NGAWI, JAWA TIMUR",7,134,35,169
https://kawalpemilu.org#50422,"BANJAR, KEDUNGDUNG, SAMPANG, JAWA TIMUR",2,70,144,214
https://kawalpemilu.org#44770,"SERUT, PANTI, JEMBER, JAWA TIMUR",19,121,55,176
https://kawalpemilu.org#47850,"WONOASRI, WONOASRI, MADIUN, JAWA TIMUR",7,137,44,181
https://kawalpemilu.org#47040,"NGORO, NGORO, JOMBANG, JAWA TIMUR",5,157,45,202
https://kawalpemilu.org#50051,"JADDIH, SOCAH, BANGKALAN, JAWA TIMUR",10,31,105,136
https://kawalpemilu.org#51554,"SISIR, BATU, KOTA BATU, JAWA TIMUR",9,172,62,234
https://kawalpemilu.org#43892,"SIMAN, KEPUNG, KEDIRI, JAWA TIMUR",17,122,53,175
https://kawalpemilu.org#51178,"PURWANTORO, BLIMBING, KOTA MALANG, JAWA TIMUR",36,153,93,246
https://kawalpemilu.org#44081,"BELUNG, PONCOKUSUMO, MALANG, JAWA TIMUR",6,194,26,220
https://kawalpemilu.org#47591,"SANGGRAHAN, GONDANG, NGANJUK, JAWA TIMUR",9,146,5,151
https://kawalpemilu.org#84966,"BUGUL LOR, PANGGUNGREJO, KOTA PASURUAN, JAWA TIMUR",7,119,90,209
https://kawalpemilu.org#45885,"POHSANGIT LOR, WONOMERTO, PROBOLINGGO, JAWA TIMUR",3,111,91,202
https://kawalpemilu.org#45116,"SONGGON, SONGGON, BANYUWANGI, JAWA TIMUR",24,174,43,217
https://kawalpemilu.org#48964,"PAKEL, MONTONG, TUBAN, JAWA TIMUR",12,122,68,190
https://kawalpemilu.org#44880,"LEMBENGAN, LEDOKOMBO, JEMBER, JAWA TIMUR",12,159,57,216
https://kawalpemilu.org#49573,"TAMBAKRIGADUNG, TIKUNG, LAMONGAN, JAWA TIMUR",18,106,63,169
https://kawalpemilu.org#44817,"JEMBERLOR, PATRANG, JEMBER, JAWA TIMUR",50,72,42,114
https://kawalpemilu.org#47808,"SAMBIREJO, SARADAN, MADIUN, JAWA TIMUR",2,124,51,175
https://kawalpemilu.org#43758,"WONOREJO TRISULO, PLOSOKLATEN, KEDIRI, JAWA TIMUR",4,139,16,155
https://kawalpemilu.org#44000,"DONOMULYO, DONOMULYO, MALANG, JAWA TIMUR",23,161,35,196
https://kawalpemilu.org#44788,"MANGARAN, AJUNG, JEMBER, JAWA TIMUR",35,151,35,186
https://kawalpemilu.org#45392,"SUMBERJERUK, JAMBESARI DARUS SHOLAH, BONDOWOSO, JAWA TIMUR",9,35,98,133
https://kawalpemilu.org#49637,"BAPUHBANDUNG, GLAGAH, LAMONGAN, JAWA TIMUR",1,132,67,199
https://kawalpemilu.org#44311,"BANJARARUM, SINGOSARI, MALANG, JAWA TIMUR",34,115,123,238
https://kawalpemilu.org#45107,"SUMBERKENCONO, WONGSOREJO, BANYUWANGI, JAWA TIMUR",6,173,60,233
https://kawalpemilu.org#46546,"WONOKUPANG, BALONGBENDO, SIDOARJO, JAWA TIMUR",4,156,35,191
https://kawalpemilu.org#46833,"KALEN, DLANGGU, MOJOKERTO, JAWA TIMUR",9,177,26,203
https://kawalpemilu.org#58473,"SIMPANG EMPAT, TANGARAN, SAMBAS, KALIMANTAN BARAT",2,100,77,177
https://kawalpemilu.org#58860,"BATU MAS, NANGA TAYAP, KETAPANG, KALIMANTAN BARAT",5,151,8,159
https://kawalpemilu.org#59053,"BALAI HARAPAN, TEMPUNAK, SINTANG, KALIMANTAN BARAT",2,191,54,245
https://kawalpemilu.org#58713,"BULU BALA, BALAI, SANGGAU, KALIMANTAN BARAT",3,163,16,179
https://kawalpemilu.org#60188,"KOTA BARU, PONTIANAK SELATAN, KOTA PONTIANAK, KALIMANTAN BARAT",54,80,124,204
https://kawalpemilu.org#58726,"MELIAU HULU, MELIAU, SANGGAU, KALIMANTAN BARAT",2,39,120,159
https://kawalpemilu.org#59246,"SAWANG SENGHIANG, SERAWAI, SINTANG, KALIMANTAN BARAT",3,82,10,92
https://kawalpemilu.org#60075,"MELANA, SOKAN, MELAWI, KALIMANTAN BARAT",3,19,180,199
https://kawalpemilu.org#58653,"TANJUNG MERPATI, KEMBAYAN, SANGGAU, KALIMANTAN BARAT",1,45,87,132
https://kawalpemilu.org#60152,"SUNGAI MATA-MATA, SIMPANG HILIR, KAYONG UTARA, KALIMANTAN BARAT",3,104,129,233
https://kawalpemilu.org#59731,"GARU, MEMPAWAH HULU, LANDAK, KALIMANTAN BARAT",6,128,16,144
https://kawalpemilu.org#60253,"SIJANGKUNG, SINGKAWANG SELATAN, KOTA SINGKAWANG, KALIMANTAN BARAT",13,163,10,173
https://kawalpemilu.org#59561,"SUNGAI JAGA B, SUNGAI RAYA, BENGKAYANG, KALIMANTAN BARAT",4,49,159,208
https://kawalpemilu.org#60225,"ROBAN, SINGKAWANG TENGAH, KOTA SINGKAWANG, KALIMANTAN BARAT",70,27,142,169
https://kawalpemilu.org#58360,"SERINDANG, TEBAS, SAMBAS, KALIMANTAN BARAT",6,87,88,175
https://kawalpemilu.org#59745,"NANGKA, MENJALIN, LANDAK, KALIMANTAN BARAT",1,123,4,127
https://kawalpemilu.org#60170,"DUSUN KECIL, PULAU MAYA, KAYONG UTARA, KALIMANTAN BARAT",2,60,90,150
https://kawalpemilu.org#60207,"BATU LAYANG, PONTIANAK UTARA, KOTA PONTIANAK, KALIMANTAN BARAT",23,14,107,121
https://kawalpemilu.org#60206,"SIANTAN HILIR, PONTIANAK UTARA, KOTA PONTIANAK, KALIMANTAN BARAT",83,130,53,183
https://kawalpemilu.org#60200,"SUNGAI JAWI DALAM, PONTIANAK BARAT, KOTA PONTIANAK, KALIMANTAN BARAT",28,77,148,225
https://kawalpemilu.org#58502,"PAK LAHENG, TOHO, MEMPAWAH, KALIMANTAN BARAT",1,151,6,157
https://kawalpemilu.org#62470,"SUNGAI TUAN ULU, ASTAMBUL, BANJAR, KALIMANTAN SELATAN",1,25,159,184
https://kawalpemilu.org#63033,"JAMBU HULU, PADANG BATUNG, HULU SUNGAI SELATAN, KALIMANTAN SELATAN",3,33,129,162
https://kawalpemilu.org#63842,"KAMPUNG BARU, SIMPANG EMPAT, TANAH BUMBU, KALIMANTAN SELATAN",19,67,80,147
https://kawalpemilu.org#62412,"SEKUMPUL, MARTAPURA, BANJAR, KALIMANTAN SELATAN",16,45,116,161
https://kawalpemilu.org#62615,"BALIANGIN, SAMBUNG MAKMUR, BANJAR, KALIMANTAN SELATAN",5,45,95,140
https://kawalpemilu.org#62406,"KERATON, MARTAPURA, BANJAR, KALIMANTAN SELATAN",29,74,104,178
https://kawalpemilu.org#62615,"BALIANGIN, SAMBUNG MAKMUR, BANJAR, KALIMANTAN SELATAN",2,66,109,175
https://kawalpemilu.org#64067,"SURGI MUFTI, BANJARMASIN UTARA, KOTA BANJARMASIN, KALIMANTAN SELATAN",41,72,155,227
https://kawalpemilu.org#63255,"HILIR BANUA, PANDAWAN, HULU SUNGAI TENGAH, KALIMANTAN SELATAN",4,26,146,172
https://kawalpemilu.org#62266,"BINTURUNG, PAMUKAN UTARA, KOTABARU, KALIMANTAN SELATAN",16,80,26,106
https://kawalpemilu.org#64030,"KELAYAN SELATAN, BANJARMASIN SELATAN, KOTA BANJARMASIN, KALIMANTAN SELATAN",33,34,52,86
https://kawalpemilu.org#62661,"PURWOSARI I, TAMBAN, BARITO KUALA, KALIMANTAN SELATAN",3,69,109,178
https://kawalpemilu.org#62539,"APUAI, ARANIO, BANJAR, KALIMANTAN SELATAN",1,75,94,169
https://kawalpemilu.org#64087,"LANDASAN ULIN TIMUR, LANDASAN ULIN, KOTA BANJARBARU, KALIMANTAN SELATAN",40,121,92,213
https://kawalpemilu.org#63787,"WONOREJO, SATUI, TANAH BUMBU, KALIMANTAN SELATAN",9,145,60,205
https://kawalpemilu.org#62608,"TAMBAK ANYAR ILIR, MARTAPURA TIMUR, BANJAR, KALIMANTAN SELATAN",2,59,112,171
https://kawalpemilu.org#63856,"DUKUH REJO, MANTEWE, TANAH BUMBU, KALIMANTAN SELATAN",3,96,87,183
https://kawalpemilu.org#61365,"PADANG, SUKAMARA, SUKAMARA, KALIMANTAN TENGAH",8,131,94,225
https://kawalpemilu.org#60657,"SELAT TENGAH, SELAT, KAPUAS, KALIMANTAN TENGAH",39,35,72,107
https://kawalpemilu.org#60607,"WARINGIN AGUNG, ANTANG KALANG, KOTAWARINGIN TIMUR, KALIMANTAN TENGAH",3,120,18,138
https://kawalpemilu.org#61960,"PETUK BARUNAI, RAKUMPIT, KOTA PALANGKARAYA, KALIMANTAN TENGAH",3,94,23,117
https://kawalpemilu.org#61947,"MENTENG, JEKAN RAYA, KOTA PALANGKARAYA, KALIMANTAN TENGAH",120,87,26,113
https://kawalpemilu.org#61666,"GOHA, BANAMA TINGANG, PULANG PISAU, KALIMANTAN TENGAH",2,246,10,256
https://kawalpemilu.org#61373,"KUALA JELAI, JELAI, SUKAMARA, KALIMANTAN TENGAH",3,146,90,236
https://kawalpemilu.org#60452,"SUNGAI MELAWEN, PANGKALAN LADA, KOTAWARINGIN BARAT, KALIMANTAN TENGAH",7,177,53,230
https://kawalpemilu.org#60955,"MUARA RIPUNG, DUSUN SELATAN, BARITO SELATAN, KALIMANTAN TENGAH",2,144,10,154
https://kawalpemilu.org#60574,"HANAUT, PULAU HANAUT, KOTAWARINGIN TIMUR, KALIMANTAN TENGAH",1,70,69,139
https://kawalpemilu.org#64571,"TANJUNG BATU, PULAU DERAWAN, BERAU, KALIMANTAN TIMUR",15,125,62,187
https://kawalpemilu.org#65506,"RAWA MULIA, BABULU, PENAJAM PASER UTARA, KALIMANTAN TIMUR",2,177,41,218
https://kawalpemilu.org#65575,"SUNGAI KELEDANG, SAMARINDA SEBERANG, KOTA SAMARINDA, KALIMANTAN TIMUR",44,40,69,109
https://kawalpemilu.org#64268,"LOH SUMBER, LOA KULU, KUTAI KARTANEGARA, KALIMANTAN TIMUR",5,109,126,235
https://kawalpemilu.org#65550,"KARANG JATI, BALIKPAPAN TENGAH, KOTA BALIKPAPAN, KALIMANTAN TIMUR",12,96,58,154
https://kawalpemilu.org#65615,"SUNGAI PINANG DALAM, SUNGAI PINANG, KOTA SAMARINDA, KALIMANTAN TIMUR",82,88,104,192
https://kawalpemilu.org#65660,"LOK TUAN, BONTANG UTARA, KOTA BONTANG, KALIMANTAN TIMUR",36,73,98,171
https://kawalpemilu.org#65473,"PETUNG, PENAJAM, PENAJAM PASER UTARA, KALIMANTAN TIMUR",1,112,125,237
https://kawalpemilu.org#65481,"PENAJAM, PENAJAM, PENAJAM PASER UTARA, KALIMANTAN TIMUR",9,52,166,218
https://kawalpemilu.org#65386,"KOMBENG INDAH, KOMBENG, KUTAI TIMUR, KALIMANTAN TIMUR",2,187,33,220
https://kawalpemilu.org#65243,"LINGGANG MELAPEH, LINGGANG BIGUNG, KUTAI BARAT, KALIMANTAN TIMUR",15,200,14,214
https://kawalpemilu.org#65381,"MAKMUR JAYA, KOMBENG, KUTAI TIMUR, KALIMANTAN TIMUR",6,170,26,196
https://kawalpemilu.org#65660,"LOK TUAN, BONTANG UTARA, KOTA BONTANG, KALIMANTAN TIMUR",58,122,161,283
https://kawalpemilu.org#65493,"GIRIPURWA, PENAJAM, PENAJAM PASER UTARA, KALIMANTAN TIMUR",4,146,88,234
https://kawalpemilu.org#64945,"SELISUN, NUNUKAN SELATAN, NUNUKAN, KALIMANTAN UTARA",14,153,51,204
https://kawalpemilu.org#64724,"NUNUKAN TIMUR, NUNUKAN, NUNUKAN, KALIMANTAN UTARA",29,87,40,127
https://kawalpemilu.org#64948,"TANJUNG HARAPAN, NUNUKAN SELATAN, NUNUKAN, KALIMANTAN UTARA",4,137,51,188
https://kawalpemilu.org#25195,"DUL, PANGKALAN BARU, BANGKA TENGAH, KEPULAUAN BANGKA BELITUNG",4,81,142,223
https://kawalpemilu.org#25030,"KACE, MENDO BARAT, BANGKA, KEPULAUAN BANGKA BELITUNG",6,106,83,189
https://kawalpemilu.org#25396,"PARIT LALANG, RANGKUI, KOTA PANGKALPINANG, KEPULAUAN BANGKA BELITUNG",13,145,128,273
https://kawalpemilu.org#25315,"TELUK LIMAU, PARITTIGA, BANGKA BARAT, KEPULAUAN BANGKA BELITUNG",7,151,48,199
https://kawalpemilu.org#25333,"BATU PENYU, GANTUNG, BELITUNG TIMUR, KEPULAUAN BANGKA BELITUNG",8,191,24,215
https://kawalpemilu.org#25788,"MANGSANG, SEI BEDUK, KOTA BATAM, KEPULAUAN RIAU",96,129,54,183
https://kawalpemilu.org#25809,"SUNGAI PANAS, BATAM KOTA, KOTA BATAM, KEPULAUAN RIAU",69,120,45,165
https://kawalpemilu.org#25783,"TANJUNG UMA, LUBUK BAJA, KOTA BATAM, KEPULAUAN RIAU",13,90,151,241
https://kawalpemilu.org#25812,"TEMBESI, SAGULUNG, KOTA BATAM, KEPULAUAN RIAU",21,72,154,226
https://kawalpemilu.org#25764,"SUNGAI HARAPAN, SEKUPANG, KOTA BATAM, KEPULAUAN RIAU",32,213,6,219
https://kawalpemilu.org#25817,"SUNGAI PELUNGGUT, SAGULUNG, KOTA BATAM, KEPULAUAN RIAU",9,94,32,126
https://kawalpemilu.org#25559,"MERAL KOTA, MERAL, KARIMUN, KEPULAUAN RIAU",9,121,37,158
https://kawalpemilu.org#24086,"BETUNG, PEMATANG SAWA, TANGGAMUS, LAMPUNG",2,25,141,166
https://kawalpemilu.org#22965,"YUKUM JAYA, TERBANGGI BESAR, LAMPUNG TENGAH, LAMPUNG",14,37,148,185
https://kawalpemilu.org#23055,"RENGAS, BEKRI, LAMPUNG TENGAH, LAMPUNG",9,119,78,197
https://kawalpemilu.org#24727,"SUKAJAWA, TANJUNGKARANG BARAT, KOTA BANDAR LAMPUNG, LAMPUNG",18,63,124,187
https://kawalpemilu.org#23735,"TEMBELANG, BANDAR NEGERI SUOH, LAMPUNG BARAT, LAMPUNG",2,113,37,150
https://kawalpemilu.org#84831,"PANGGUNG REJO UTARA, SUKOHARJO, PRINGSEWU, LAMPUNG",5,123,32,155
https://kawalpemilu.org#22984,"RAMA NIRWANA, SEPUTIH RAMAN, LAMPUNG TENGAH, LAMPUNG",1,157,54,211
https://kawalpemilu.org#23667,"ULU KRUI, WAY KRUI, PESISIR BARAT, LAMPUNG",2,96,126,222
https://kawalpemilu.org#22954,"BADRAN SARI, PUNGGUR, LAMPUNG TENGAH, LAMPUNG",2,97,55,152
https://kawalpemilu.org#22909,"BANDAR SARI, PADANG RATU, LAMPUNG TENGAH, LAMPUNG",9,98,80,178
https://kawalpemilu.org#87255,"KOTA SEPANG, LABUHAN RATU, KOTA BANDAR LAMPUNG, LAMPUNG",7,68,100,168
https://kawalpemilu.org#23220,"KOTA AGUNG, SUNGKAI SELATAN, LAMPUNG UTARA, LAMPUNG",6,0,0,0
https://kawalpemilu.org#22693,"PARDASUKA, KATIBUNG, LAMPUNG SELATAN, LAMPUNG",26,166,57,223
https://kawalpemilu.org#22945,"TEMPURAN, TRIMURJO, LAMPUNG TENGAH, LAMPUNG",8,129,132,261
https://kawalpemilu.org#24261,"SUMBERGEDE, SEKAMPUNG, LAMPUNG TIMUR, LAMPUNG",8,97,83,180
https://kawalpemilu.org#23135,"SENDANG MULYO, SENDANG AGUNG, LAMPUNG TENGAH, LAMPUNG",18,134,74,208
https://kawalpemilu.org#23574,"TANJUNGRAYA, SUKAU, LAMPUNG BARAT, LAMPUNG",4,71,114,185
https://kawalpemilu.org#23316,"KELAPA TUJUH, KOTABUMI SELATAN, LAMPUNG UTARA, LAMPUNG",139,41,133,174
https://kawalpemilu.org#23764,"MORIS JAYA, BANJAR AGUNG, TULANG BAWANG, LAMPUNG",5,211,12,223
https://kawalpemilu.org#23086,"MATARAM UDIK, BANDAR MATARAM, LAMPUNG TENGAH, LAMPUNG",81,158,69,227
https://kawalpemilu.org#23881,"PANCA KARSA PURNA JAYA, BANJAR BARU, TULANG BAWANG, LAMPUNG",4,84,139,223
https://kawalpemilu.org#24227,"KARYA TANI, LABUHAN MARINGGAI, LAMPUNG TIMUR, LAMPUNG",8,141,23,164
https://kawalpemilu.org#23802,"BOGATAMA, PENAWAR TAMA, TULANG BAWANG, LAMPUNG",2,115,43,158
https://kawalpemilu.org#23040,"GUNUNG AGUNG, TERUSAN NUNYAI, LAMPUNG TENGAH, LAMPUNG",24,147,57,204
https://kawalpemilu.org#22834,"BARU RANJI, MERBAU MATARAM, LAMPUNG SELATAN, LAMPUNG",7,63,64,127
https://kawalpemilu.org#23830,"AGUNG JAYA, BANJAR MARGO, TULANG BAWANG, LAMPUNG",9,179,46,225
https://kawalpemilu.org#24825,"HADIMULYO TIMUR, METRO PUSAT, KOTA METRO, LAMPUNG",2,84,136,220
https://kawalpemilu.org#22525,"PANARAGAN, TULANG BAWANG TENGAH, TULANG BAWANG BARAT, LAMPUNG",7,30,101,131
https://kawalpemilu.org#22607,"HAJIMENA, NATAR, LAMPUNG SELATAN, LAMPUNG",16,42,70,112
https://kawalpemilu.org#24420,"NEGERI AGUNG, GUNUNG PELINDUNG, LAMPUNG TIMUR, LAMPUNG",11,174,17,191
https://kawalpemilu.org#23769,"TRI TUNGGAL JAYA, BANJAR AGUNG, TULANG BAWANG, LAMPUNG",3,101,95,196
https://kawalpemilu.org#22744,"MEKAR MULYA, PALAS, LAMPUNG SELATAN, LAMPUNG",15,107,74,181
https://kawalpemilu.org#24648,"BANJAR SAKTI, GUNUNG LABUHAN, WAY KANAN, LAMPUNG",1,64,114,178
https://kawalpemilu.org#22943,"NOTO HARJO, TRIMURJO, LAMPUNG TENGAH, LAMPUNG",11,149,55,204
https://kawalpemilu.org#24227,"KARYA TANI, LABUHAN MARINGGAI, LAMPUNG TIMUR, LAMPUNG",15,121,54,175
https://kawalpemilu.org#-990474,"Kuwait City, Kuwait City, Kuwait, Luar Negeri",5,183,189,372
https://kawalpemilu.org#-991204,"Perth, Perth, Australia, Luar Negeri",18,63,13,76
https://kawalpemilu.org#-991304,"Taipei, Taipei, Taiwan, Luar Negeri",1002,922,148,1070
https://kawalpemilu.org#-990594,"New Delhi, New Delhi, India, Luar Negeri",1001,67,21,88
https://kawalpemilu.org#77631,"LEMO LEMO, GANE BARAT, HALMAHERA SELATAN, MALUKU UTARA",2,62,80,142
https://kawalpemilu.org#77313,"NUSLIKO, WEDA, HALMAHERA TENGAH, MALUKU UTARA",2,125,8,133
https://kawalpemilu.org#89622,"SAMA, SULABESI TIMUR, KEPULAUAN SULA, MALUKU UTARA",2,50,99,149
https://kawalpemilu.org#77289,"TOBELOS, IBU SELATAN, HALMAHERA BARAT, MALUKU UTARA",2,132,13,145
https://kawalpemilu.org#77515,"SOAKONORA, GALELA SELATAN, HALMAHERA UTARA, MALUKU UTARA",3,56,96,152
https://kawalpemilu.org#76391,"TUHAHA, SAPARUA TIMUR, MALUKU TENGAH, MALUKU",6,174,4,178
https://kawalpemilu.org#76787,"URAUR, KAIRATU, SERAM BAGIAN BARAT, MALUKU",1,217,10,227
https://kawalpemilu.org#77035,"HUNUTH/DURIAN PATAH, TELUK AMBON, KOTA AMBON, MALUKU",7,37,203,240
https://kawalpemilu.org#76257,"PASIR PUTIH, KEPALA MADAN, BURU SELATAN, MALUKU",7,103,42,145
https://kawalpemilu.org#77040,"HATIVE BESAR, TELUK AMBON, KOTA AMBON, MALUKU",7,168,4,172
https://kawalpemilu.org#76287,"TAMILOUW, AMAHAI, MALUKU TENGAH, MALUKU",19,156,52,208
https://kawalpemilu.org#76644,"LORWEMBUN, KORMOMOLIN, MALUKU TENGGARA BARAT, MALUKU",1,140,2,142
https://kawalpemilu.org#54213,"SEPAKEK, PRINGGARATA, LOMBOK TENGAH, NUSA TENGGARA BARAT",7,51,90,141
https://kawalpemilu.org#54960,"TANJUNG KARANG, SEKARBELA, KOTA MATARAM, NUSA TENGGARA BARAT",9,59,114,173
https://kawalpemilu.org#54424,"MOTONG, UTAN, SUMBAWA, NUSA TENGGARA BARAT",1,62,166,228
https://kawalpemilu.org#54717,"ROKA, BELO, BIMA, NUSA TENGGARA BARAT",5,14,173,187
https://kawalpemilu.org#85057,"LENEK RAMBAN BIAK, AIKMEL, LOMBOK TIMUR, NUSA TENGGARA BARAT",2,119,35,154
https://kawalpemilu.org#54249,"PANDAN INDAH, PRAYA BARAT DAYA, LOMBOK TENGAH, NUSA TENGGARA BARAT",16,65,78,143
https://kawalpemilu.org#54197,"GANTI, PRAYA TIMUR, LOMBOK TENGAH, NUSA TENGGARA BARAT",26,193,34,227
https://kawalpemilu.org#54959,"KARANG PULE, SEKARBELA, KOTA MATARAM, NUSA TENGGARA BARAT",40,102,101,203
https://kawalpemilu.org#54295,"LENDANG NANGKA, MASBAGIK, LOMBOK TIMUR, NUSA TENGGARA BARAT",30,54,109,163
https://kawalpemilu.org#54290,"PAOK MOTONG, MASBAGIK, LOMBOK TIMUR, NUSA TENGGARA BARAT",39,33,129,162
https://kawalpemilu.org#54083,"SESELA, GUNUNGSARI, LOMBOK BARAT, NUSA TENGGARA BARAT",32,42,147,189
https://kawalpemilu.org#54182,"MANGKUNG, PRAYA BARAT, LOMBOK TENGAH, NUSA TENGGARA BARAT",7,61,128,185
https://kawalpemilu.org#55000,"JATIWANGI, ASAKOTA, KOTA BIMA, NUSA TENGGARA BARAT",3,53,167,220
https://kawalpemilu.org#54719,"TARLAWI, WAWO, BIMA, NUSA TENGGARA BARAT",4,49,184,233
https://kawalpemilu.org#85077,"PRINGGASELA TIMUR, PRINGGASELA, LOMBOK TIMUR, NUSA TENGGARA BARAT",6,129,60,189
https://kawalpemilu.org#54147,"PUYUNG, JONGGAT, LOMBOK TENGAH, NUSA TENGGARA BARAT",34,30,122,152
https://kawalpemilu.org#54602,"DORE BARA, DOMPU, DOMPU, NUSA TENGGARA BARAT",7,48,147,195
https://kawalpemilu.org#54330,"KALIJAGA TIMUR, AIKMEL, LOMBOK TIMUR, NUSA TENGGARA BARAT",4,32,142,174
https://kawalpemilu.org#85010,"BATU PUTIK, KERUAK, LOMBOK TIMUR, NUSA TENGGARA BARAT",3,75,104,179
https://kawalpemilu.org#55062,"PEMENANG BARAT, PEMENANG, LOMBOK UTARA, NUSA TENGGARA BARAT",12,74,124,198
https://kawalpemilu.org#57151,"LIANG BUA, RAHONG UTARA, MANGGARAI, NUSA TENGGARA TIMUR",1,83,3,86
https://kawalpemilu.org#55123,"KEL. OESAO, KUPANG TIMUR, KUPANG, NUSA TENGGARA TIMUR",4,235,8,243
https://kawalpemilu.org#58058,"NAIMATA, MAULAFA, KOTA KUPANG, NUSA TENGGARA TIMUR",8,195,5,200
https://kawalpemilu.org#55554,"KIUFATU, KUALIN, TIMOR TENGAH SELATAN, NUSA TENGGARA TIMUR",6,193,9,202
https://kawalpemilu.org#56808,"MAUSAMBI, MAUROLE, ENDE, NUSA TENGGARA TIMUR",4,159,13,172
https://kawalpemilu.org#55533,"SE'I, KOLBANO, TIMOR TENGAH SELATAN, NUSA TENGGARA TIMUR",3,225,11,236
https://kawalpemilu.org#55688,"MOTADIK, BIBOKI ANLEU, TIMOR TENGAH UTARA, NUSA TENGGARA TIMUR",1,232,9,241
https://kawalpemilu.org#55136,"MANUSAK, KUPANG TIMUR, KUPANG, NUSA TENGGARA TIMUR",3,139,56,195
https://kawalpemilu.org#56767,"MAUTENDA, WEWARIA, ENDE, NUSA TENGGARA TIMUR",9,111,0,111
https://kawalpemilu.org#90894,"WAITARU, KODI UTARA, SUMBA BARAT DAYA, NUSA TENGGARA TIMUR",5,160,13,173
https://kawalpemilu.org#56743,"WOLOTOLO TENGAH, DETUSOKO, ENDE, NUSA TENGGARA TIMUR",1,193,2,195
https://kawalpemilu.org#58086,"FONTEIN, KOTA RAJA, KOTA KUPANG, NUSA TENGGARA TIMUR",6,221,6,227
https://kawalpemilu.org#57488,"PADA, NUBATUKAN, LEMBATA, NUSA TENGGARA TIMUR",1,192,37,229
https://kawalpemilu.org#56831,"DETUPERA, LIO TIMUR, ENDE, NUSA TENGGARA TIMUR",1,171,7,178
https://kawalpemilu.org#55889,"UMAKATAHAN, MALAKA TENGAH, MALAKA, NUSA TENGGARA TIMUR",8,123,1,124
https://kawalpemilu.org#91332,"TANA METE, KODI BANGEDO, SUMBA BARAT DAYA, NUSA TENGGARA TIMUR",1,219,9,228
https://kawalpemilu.org#55676,"MAUBELI, KOTA KEFAMENANU, TIMOR TENGAH UTARA, NUSA TENGGARA TIMUR",4,236,45,281
https://kawalpemilu.org#56612,"WURING, ALOK BARAT, SIKKA, NUSA TENGGARA TIMUR",5,153,54,207
https://kawalpemilu.org#57715,"GOLO NDARING, SANO NGGOANG, MANGGARAI BARAT, NUSA TENGGARA TIMUR",2,100,33,133
https://kawalpemilu.org#927830,"SRUMAKIT, AIFAT TIMUR SELATAN, MAYBRAT, PAPUA BARAT",1,50,0,50
https://kawalpemilu.org#82096,"MAKBUSUN, MAYAMUK, SORONG, PAPUA BARAT",15,74,86,160
https://kawalpemilu.org#82097,"MAKBALIM, MAYAMUK, SORONG, PAPUA BARAT",5,51,134,185
https://kawalpemilu.org#83126,"AISANDAMI, TELUK DUAIRI, TELUK WONDAMA, PAPUA BARAT",1,105,3,108
https://kawalpemilu.org#927665,"KOCUAS UTARA, AIFAT, MAYBRAT, PAPUA BARAT",1,210,0,210
https://kawalpemilu.org#79498,"PELANME, KELILA, MAMBERAMO TENGAH, PAPUA",1,300,0,300
https://kawalpemilu.org#79008,"ASIKI I, JAIR, BOVEN DIGOEL, PAPUA",55,53,15,68
https://kawalpemilu.org#79835,"SERINGGU JAYA, MERAUKE, MERAUKE, PAPUA",9,165,40,205
https://kawalpemilu.org#78572,"ALOPUR, KUARI, TOLIKARA, PAPUA",2,220,0,220
https://kawalpemilu.org#81354,"KAMEME, BIME, PEGUNUNGAN BINTANG, PAPUA",2,216,0,216
https://kawalpemilu.org#79835,"SERINGGU JAYA, MERAUKE, MERAUKE, PAPUA",12,75,13,88
https://kawalpemilu.org#81106,"MARARENA, SARMI, SARMI, PAPUA",9,80,40,120
https://kawalpemilu.org#930786,"KENEGI, EKADIDE, PANIAI, PAPUA",1,0,400,400
https://kawalpemilu.org#79832,"KELAPA LIMA, MERAUKE, MERAUKE, PAPUA",24,107,19,126
https://kawalpemilu.org#80010,"KOA, ANIMHA, MERAUKE, PAPUA",2,123,2,125
https://kawalpemilu.org#86794,"JUTA, GELOK BEAM, LANNY JAYA, PAPUA",2,210,0,210
https://kawalpemilu.org#79474,"LUARIMA, KOBAGMA, MAMBERAMO TENGAH, PAPUA",2,262,0,262
https://kawalpemilu.org#930635,"UTIKINI DUA, KUALA KENCANA, MIMIKA, PAPUA",1,300,0,300
https://kawalpemilu.org#86486,"LULIS WII, ABOY, PEGUNUNGAN BINTANG, PAPUA",1,202,0,202
https://kawalpemilu.org#86549,"OKBUMUL, OKLIP, PEGUNUNGAN BINTANG, PAPUA",1,114,0,114
https://kawalpemilu.org#79337,"RAYORI, KEPULAUAN ARURI, SUPIORI, PAPUA",6,193,4,197
https://kawalpemilu.org#79401,"BARAPASI, WAROPEN ATAS, MAMBERAMO RAYA, PAPUA",1,225,11,236
https://kawalpemilu.org#81028,"POUMAKO, MIMIKA TIMUR, MIMIKA, PAPUA",3,119,51,170
https://kawalpemilu.org#930777,"DIMIYA, YATAMO, PANIAI, PAPUA",1,291,0,291
https://kawalpemilu.org#14957,"UKUI I, UKUI, PELALAWAN, RIAU",8,133,92,225
https://kawalpemilu.org#15851,"BUKIT DATUK, DUMAI SELATAN, KOTA DUMAI, RIAU",11,106,48,154
https://kawalpemilu.org#15063,"SERAPUNG, KUALA KAMPAR, PELALAWAN, RIAU",7,55,73,128
https://kawalpemilu.org#15209,"BANGUN PURBA BARAT, BANGUN PURBA, ROKAN HULU, RIAU",1,70,167,237
https://kawalpemilu.org#14834,"Sencalang, Keritang, INDRAGIRI HILIR, RIAU",1,145,86,231
https://kawalpemilu.org#14095,"ALAH AIR TIMUR, TEBING TINGGI, KEPULAUAN MERANTI, RIAU",1,66,144,210
https://kawalpemilu.org#15493,"BUANTAN LESTARI, BUNGA RAYA, SIAK, RIAU",1,136,104,240
https://kawalpemilu.org#14504,"PANGKALAN KASAI, SIBERIDA, INDRAGIRI HULU, RIAU",11,72,90,162
https://kawalpemilu.org#15659,"SIKAKAK, CERENTI, KUANTAN SINGINGI, RIAU",4,24,171,195
https://kawalpemilu.org#14876,"SELENSEN, Kemuning, INDRAGIRI HILIR, RIAU",12,40,69,109
https://kawalpemilu.org#14170,"KUMANTAN, BANGKINANG KOTA, KAMPAR, RIAU",2,13,244,257
https://kawalpemilu.org#15511,"SIMPANG BELUTU, KANDIS, SIAK, RIAU",3,67,156,223
https://kawalpemilu.org#14992,"HARAPAN JAYA, PANGKALAN KURAS, PELALAWAN, RIAU",4,128,76,204
https://kawalpemilu.org#15854,"RATU SIMA, DUMAI SELATAN, KOTA DUMAI, RIAU",13,152,14,166
https://kawalpemilu.org#14970,"PANGKALAN KERINCI KOTA, PANGKALAN KERINCI, PELALAWAN, RIAU",81,29,134,163
https://kawalpemilu.org#15186,"RAMBAH, RAMBAH HILIR, ROKAN HULU, RIAU",19,90,41,131
https://kawalpemilu.org#931199,"TIRTASIAK, PAYUNG SEKAKI, KOTA PEKANBARU, RIAU",22,81,181,262
https://kawalpemilu.org#15214,"BONO TAPUNG, TANDUN, ROKAN HULU, RIAU",7,84,47,131
https://kawalpemilu.org#931187,"TOBEKGODANG, TAMPAN, KOTA PEKANBARU, RIAU",38,22,144,166
https://kawalpemilu.org#15872,"BAGAN BESAR, BUKIT KAPUR, KOTA DUMAI, RIAU",20,88,129,217
https://kawalpemilu.org#14769,"TANJUNGLAJAU, Kuala Indragiri, INDRAGIRI HILIR, RIAU",1,74,110,184
https://kawalpemilu.org#14763,"Suhada, Enok, INDRAGIRI HILIR, RIAU",4,78,142,220
https://kawalpemilu.org#76018,"PAPANDANGAN, ANREAPI, POLEWALI MANDAR, SULAWESI BARAT",2,154,68,222
https://kawalpemilu.org#76091,"BAURUNG, BANGGAE TIMUR, MAJENE, SULAWESI BARAT",4,134,97,231
https://kawalpemilu.org#75510,"TADUI, MAMUJU, MAMUJU, SULAWESI BARAT",7,180,79,259
https://kawalpemilu.org#76050,"BARU, BANGGAE, MAJENE, SULAWESI BARAT",3,114,106,220
https://kawalpemilu.org#75719,"OSANGO, MAMASA, MAMASA, SULAWESI BARAT",5,195,36,231
https://kawalpemilu.org#70848,"BONTO LANGKASA, MINASA TENE, PANGKAJENE DAN KEPULAUAN, SULAWESI SELATAN",7,64,141,205
https://kawalpemilu.org#72294,"MARGOMULYO, TOMONI TIMUR, LUWU TIMUR, SULAWESI SELATAN",6,146,84,230
https://kawalpemilu.org#71382,"LAMPA, DUAMPANUA, PINRANG, SULAWESI SELATAN",3,62,130,192
https://kawalpemilu.org#69667,"ANRANG, RILAUALE, BULUKUMBA, SULAWESI SELATAN",2,41,165,206
https://kawalpemilu.org#72081,"SALAMA, SABBANG, LUWU UTARA, SULAWESI SELATAN",2,104,84,188
https://kawalpemilu.org#90174,"WANASARI, ANGKONA, LUWU TIMUR, SULAWESI SELATAN",2,184,27,211
https://kawalpemilu.org#70611,"SADAR, TELLULIMPOE, BONE, SULAWESI SELATAN",2,220,22,242
https://kawalpemilu.org#69971,"BONTOBIRAENG UTARA, BONTONOMPO, GOWA, SULAWESI SELATAN",3,120,127,247
https://kawalpemilu.org#72039,"BUNGAPATI, TANA LILI, LUWU UTARA, SULAWESI SELATAN",4,92,94,186
https://kawalpemilu.org#69542,"BONTO NYELENG, GANTARANG, BULUKUMBA, SULAWESI SELATAN",6,83,103,186
https://kawalpemilu.org#71376,"SIPATUO, PATAMPANUA, PINRANG, SULAWESI SELATAN",6,33,170,203
https://kawalpemilu.org#70981,"UMPUNGENG, LALABATA, SOPPENG, SULAWESI SELATAN",2,72,32,104
https://kawalpemilu.org#72426,"JONGAYA, TAMALATE, KOTA MAKASSAR, SULAWESI SELATAN",2,40,58,98
https://kawalpemilu.org#70849,"KABBA, MINASA TENE, PANGKAJENE DAN KEPULAUAN, SULAWESI SELATAN",6,93,154,247
https://kawalpemilu.org#70753,"TURIKALE, TURIKALE, MAROS, SULAWESI SELATAN",11,62,163,225
https://kawalpemilu.org#70717,"SAMANGKI, SIMBANG, MAROS, SULAWESI SELATAN",7,116,96,212
https://kawalpemilu.org#71001,"TOTTONG, DONRI DONRI, SOPPENG, SULAWESI SELATAN",5,124,57,181
https://kawalpemilu.org#71036,"KAMPIRI, PAMMANA, WAJO, SULAWESI SELATAN",3,128,116,244
https://kawalpemilu.org#70645,"BONTO MATENE, MANDAI, MAROS, SULAWESI SELATAN",6,81,153,234
https://kawalpemilu.org#72009,"PATTIMANG, MALANGKE, LUWU UTARA, SULAWESI SELATAN",7,78,86,164
https://kawalpemilu.org#70918,"NEPO, MALLUSETASI, BARRU, SULAWESI SELATAN",1,146,96,242
https://kawalpemilu.org#72391,"WALA-WALAYA, TALLO, KOTA MAKASSAR, SULAWESI SELATAN",4,57,134,191
https://kawalpemilu.org#70196,"BONTO, SINJAI TENGAH, SINJAI, SULAWESI SELATAN",4,49,105,154
https://kawalpemilu.org#70944,"MARIORITENGNGA, MARIORIWAWO, SOPPENG, SULAWESI SELATAN",2,109,103,212
https://kawalpemilu.org#71418,"PAMMASE, TIROANG, PINRANG, SULAWESI SELATAN",13,21,125,146
https://kawalpemilu.org#71306,"BULUCENRANA, PITU RIAWA, SIDENRENG RAPPANG, SULAWESI SELATAN",6,123,106,229
https://kawalpemilu.org#72393,"BULOA, TALLO, KOTA MAKASSAR, SULAWESI SELATAN",22,51,116,167
https://kawalpemilu.org#71530,"TAULAN, CENDANA, ENREKANG, SULAWESI SELATAN",3,37,150,187
https://kawalpemilu.org#69714,"PAJUKUKANG, PAJUKUKANG, BANTAENG, SULAWESI SELATAN",9,85,144,229
https://kawalpemilu.org#70827,"MARANG, MARANG, PANGKAJENE DAN KEPULAUAN, SULAWESI SELATAN",8,50,84,134
https://kawalpemilu.org#71899,"RANDANAN, MENGKENDEK, TANA TORAJA, SULAWESI SELATAN",1,202,19,221
https://kawalpemilu.org#72136,"ARUSU, MALANGKE BARAT, LUWU UTARA, SULAWESI SELATAN",6,107,92,199
https://kawalpemilu.org#72178,"SASSA, BAEBUNTA, LUWU UTARA, SULAWESI SELATAN",3,53,182,235
https://kawalpemilu.org#85634,"MALIK MAKMUR, BUALEMO, BANGGAI, SULAWESI TENGAH",2,193,35,228
https://kawalpemilu.org#69250,"KAWATUNA, MANTIKULORE, KOTA PALU, SULAWESI TENGAH",5,29,68,97
https://kawalpemilu.org#928618,"PANGKUNG, DONDO, TOLITOLI, SULAWESI TENGAH",2,82,99,181
https://kawalpemilu.org#928636,"KASIMBAR UTARA, KASIMBAR, PARIGI MOUTONG, SULAWESI TENGAH",1,54,106,160
https://kawalpemilu.org#68932,"LOBU, MOUTONG, PARIGI MOUTONG, SULAWESI TENGAH",7,102,84,186
https://kawalpemilu.org#89771,"TINOMBALA JAYA, ONGKA MALINO, PARIGI MOUTONG, SULAWESI TENGAH",5,96,71,167
https://kawalpemilu.org#69049,"BALINGGI JATI, BALINGGI, PARIGI MOUTONG, SULAWESI TENGAH",4,163,34,197
https://kawalpemilu.org#68313,"PUJIMULYO, MOMUNU, BUOL, SULAWESI TENGAH",1,121,110,231
https://kawalpemilu.org#68883,"LALONG, TINANGKUNG UTARA, BANGGAI KEPULAUAN, SULAWESI TENGAH",1,105,108,213
https://kawalpemilu.org#68865,"MONTOP, BULAGI UTARA, BANGGAI KEPULAUAN, SULAWESI TENGAH",4,80,90,170
https://kawalpemilu.org#69252,"LOLU UTARA, PALU TIMUR, KOTA PALU, SULAWESI TENGAH",29,115,38,153
https://kawalpemilu.org#67870,"KAYAMANYA, POSO KOTA, POSO, SULAWESI TENGAH",10,32,92,124
https://kawalpemilu.org#72952,"LALOWATA, LATOMA, KONAWE, SULAWESI TENGGARA",1,74,65,139
https://kawalpemilu.org#74663,"PADALEU, KAMBU, KOTA KENDARI, SULAWESI TENGGARA",11,29,125,154
https://kawalpemilu.org#74601,"KAMPUNG SALO, KENDARI, KOTA KENDARI, SULAWESI TENGGARA",8,59,127,186
https://kawalpemilu.org#73813,"RODA, KOLONO, KONAWE SELATAN, SULAWESI TENGGARA",3,51,91,142
https://kawalpemilu.org#89783,"GAYA BARU, LAPANDEWA, BUTON SELATAN, SULAWESI TENGGARA",2,102,77,179
https://kawalpemilu.org#74154,"LEBO EA, POLEANG TENGAH, BOMBANA, SULAWESI TENGGARA",1,32,162,194
https://kawalpemilu.org#74225,"PATUA, TOMIA, WAKATOBI, SULAWESI TENGGARA",2,91,31,122
https://kawalpemilu.org#73395,"LAHAJI, NAPANO KUSAMBI, MUNA BARAT, SULAWESI TENGGARA",3,84,70,154
https://kawalpemilu.org#73520,"KOKOE, TELAGA RAYA, BUTON TENGAH, SULAWESI TENGGARA",1,147,51,198
https://kawalpemilu.org#74207,"SAMABAHARI, KALEDUPA, WAKATOBI, SULAWESI TENGGARA",1,114,65,9
https://kawalpemilu.org#65770,"TOLONDADU, BOLAANG UKI, BOLAANG MONGONDOW SELATAN, SULAWESI UTARA",3,120,154,274
https://kawalpemilu.org#67333,"KAKASKASEN SATU, TOMOHON UTARA, KOTA TOMOHON, SULAWESI UTARA",2,229,9,238
https://kawalpemilu.org#67290,"BITUNG TIMUR, MAESA, KOTA BITUNG, SULAWESI UTARA",23,109,58,167
https://kawalpemilu.org#66012,"KOLONGAN, KOMBI, MINAHASA, SULAWESI UTARA",1,171,25,196
https://kawalpemilu.org#66175,"TATAARAN I, TONDANO SELATAN, MINAHASA, SULAWESI UTARA",10,125,2,127
https://kawalpemilu.org#66731,"KAUDITAN I, KAUDITAN, MINAHASA UTARA, SULAWESI UTARA",6,114,47,161
https://kawalpemilu.org#67137,"TONGKAINA, BUNAKEN, KOTA MANADO, SULAWESI UTARA",5,231,23,254
https://kawalpemilu.org#65786,"MILANGODAA, TOMINI, BOLAANG MONGONDOW SELATAN, SULAWESI UTARA",1,78,171,249
https://kawalpemilu.org#67206,"PANIKI BAWAH, MAPANGET, KOTA MANADO, SULAWESI UTARA",6,155,15,170
https://kawalpemilu.org#66000,"ERIS, ERIS, MINAHASA, SULAWESI UTARA",2,226,49,275
https://kawalpemilu.org#13178,"BATIPUAH BARUAH, BATIPUH, TANAH DATAR, SUMATERA BARAT",13,12,126,138
https://kawalpemilu.org#13804,"KURANJI, KURANJI, KOTA PADANG, SUMATERA BARAT",26,5,154,159
https://kawalpemilu.org#13021,"SIRUKAM, PAYUNG SEKAKI, SOLOK, SUMATERA BARAT",11,21,131,152
https://kawalpemilu.org#13378,"GADUIK, TILATANG KAMANG, AGAM, SUMATERA BARAT",49,19,131,150
https://kawalpemilu.org#13465,"LUBUAK ALAI, KAPUR IX, LIMA PULUH KOTA, SUMATERA BARAT",2,33,192,225
https://kawalpemilu.org#13074,"SULIT AIR, X KOTO DIATAS, SOLOK, SUMATERA BARAT",13,15,83,98
https://kawalpemilu.org#13658,"LUBUK MALAKO, SANGIR JUJUAN, SOLOK SELATAN, SUMATERA BARAT",19,4,129,133
https://kawalpemilu.org#13741,"PURUS, PADANG BARAT, KOTA PADANG, SUMATERA BARAT",17,13,121,134
https://kawalpemilu.org#13882,"SIJANTANG KOTO, TALAWI, KOTA SAWAHLUNTO, SUMATERA BARAT",1,32,152,184
https://kawalpemilu.org#13534,"BINJAI, TIGO NAGARI, PASAMAN, SUMATERA BARAT",6,24,98,122
https://kawalpemilu.org#13246,"LUBUK JANTAN, LINTAU BUO UTARA, TANAH DATAR, SUMATERA BARAT",27,24,154,178
https://kawalpemilu.org#13084,"PANINGGAHAN, JUNJUNG SIRI, SOLOK, SUMATERA BARAT",22,6,101,107
https://kawalpemilu.org#13384,"NAN TUJUAH, PALUPUH, AGAM, SUMATERA BARAT",1,8,125,133
https://kawalpemilu.org#13132,"PADANG TAROK, KAMANG BARU, SIJUNJUNG, SUMATERA BARAT",3,18,166,184
https://kawalpemilu.org#13739,"RIMBO KALUANG, PADANG BARAT, KOTA PADANG, SUMATERA BARAT",9,19,207,226
https://kawalpemilu.org#13907,"TAROK DIPO, GUGUAK PANJANG, KOTA BUKITTINGGI, SUMATERA BARAT",12,28,194,222
https://kawalpemilu.org#13404,"CANDUANG KOTO LAWEH, CANDUNG, AGAM, SUMATERA BARAT",9,20,158,178
https://kawalpemilu.org#13120,"KOTO BARU, IV NAGARI, SIJUNJUNG, SUMATERA BARAT",2,7,197,204
https://kawalpemilu.org#13930,"PAKAN LABUH, AUR BIRUGO TIGO BALEH, KOTA BUKITTINGGI, SUMATERA BARAT",9,4,85,89
https://kawalpemilu.org#12970,"AMPANG PULAI, KOTO XI TARUSAN, PESISIR SELATAN, SUMATERA BARAT",2,19,153,172
https://kawalpemilu.org#13685,"UJUNG GADIANG, LEMBAH MELINTANG, PASAMAN BARAT, SUMATERA BARAT",71,18,146,164
https://kawalpemilu.org#20451,"BATU RAJA LAMA, TEBING TINGGI, EMPAT LAWANG, SUMATERA SELATAN",2,46,173,219
https://kawalpemilu.org#90218,"TEGAL BESAR, BELITANG II, OGAN KOMERING ULU TIMUR, SUMATERA SELATAN",1,203,21,224
https://kawalpemilu.org#19111,"SUKAJAYA, BAYUNG LENCIR, MUSI BANYUASIN, SUMATERA SELATAN",14,129,62,191
https://kawalpemilu.org#18739,"PULAU KIDAK, ULU RAWAS, MUSI RAWAS UTARA, SUMATERA SELATAN",1,86,152,238
https://kawalpemilu.org#19239,"GALANG TINGGI, BANYUASIN III, BANYUASIN, SUMATERA SELATAN",6,57,174,231
https://kawalpemilu.org#20722,"DEMPO, LUBUK LINGGAU TIMUR II, KOTA LUBUKLINGGAU, SUMATERA SELATAN",4,71,158,229
https://kawalpemilu.org#18705,"PAUH, RAWAS ILIR, MUSI RAWAS UTARA, SUMATERA SELATAN",7,63,82,145
https://kawalpemilu.org#19162,"KARANG SARI, LALAN, MUSI BANYUASIN, SUMATERA SELATAN",1,148,32,180
https://kawalpemilu.org#19269,"WANA MUKTI, PULAU RIMAU, BANYUASIN, SUMATERA SELATAN",3,140,68,208
https://kawalpemilu.org#17759,"TALANG MAKMUR, SUNGAI MENANG, OGAN KOMERING ILIR, SUMATERA SELATAN",4,92,100,192
https://kawalpemilu.org#20014,"KOTA BATU, WARKUK RANAU SELATAN, OGAN KOMERING ULU SELATAN, SUMATERA SELATAN",2,61,118,179
https://kawalpemilu.org#19641,"SUMBER HARAPAN, BELITANG II, OGAN KOMERING ULU TIMUR, SUMATERA SELATAN",3,73,98,171
https://kawalpemilu.org#17529,"KARTA MULYA, LUBUK BATANG, OGAN KOMERING ULU, SUMATERA SELATAN",2,18,154,172
https://kawalpemilu.org#20015,"PAGAR DEWA, WARKUK RANAU SELATAN, OGAN KOMERING ULU SELATAN, SUMATERA SELATAN",1,12,152,164
https://kawalpemilu.org#20516,"30 ILIR, ILIR BARAT II, KOTA PALEMBANG, SUMATERA SELATAN",7,57,144,201
https://kawalpemilu.org#20471,"LUBUK CIK, LINTANG KANAN, EMPAT LAWANG, SUMATERA SELATAN",3,53,65,118
https://kawalpemilu.org#19517,"TANJUNG BULAN, BUAY MADANG, OGAN KOMERING ULU TIMUR, SUMATERA SELATAN",7,23,105,128
https://kawalpemilu.org#18951,"MUARA TELADAN, SEKAYU, MUSI BANYUASIN, SUMATERA SELATAN",12,64,153,217
https://kawalpemilu.org#18710,"MANDI ANGIN, RAWAS ILIR, MUSI RAWAS UTARA, SUMATERA SELATAN",1,18,122,140
https://kawalpemilu.org#20429,"JAYA LOKA, TEBING TINGGI, EMPAT LAWANG, SUMATERA SELATAN",27,20,103,123
https://kawalpemilu.org#18742,"MUARA RUPIT, RUPIT, MUSI RAWAS UTARA, SUMATERA SELATAN",3,111,125,236
https://kawalpemilu.org#17729,"TUGU AGUNG, LEMPUING, OGAN KOMERING ILIR, SUMATERA SELATAN",9,81,126,207
https://kawalpemilu.org#20651,"TEBAT GIRI INDAH, PAGAR ALAM SELATAN, KOTA PAGAR ALAM, SUMATERA SELATAN",13,88,100,188
https://kawalpemilu.org#19677,"TULANG BAWANG, BUNGA MAYANG, OGAN KOMERING ULU TIMUR, SUMATERA SELATAN",3,147,84,231
https://kawalpemilu.org#18224,"PERAMBATAN, ABAB, PENUKAL ABAB LEMATANG ILIR, SUMATERA SELATAN",4,24,179,203
https://kawalpemilu.org#20569,"KUTO BATU, ILIR TIMUR III, KOTA PALEMBANG, SUMATERA SELATAN",6,67,117,184
https://kawalpemilu.org#19226,"KEDONDONG RAYE, BANYUASIN III, BANYUASIN, SUMATERA SELATAN",2,19,71,90
https://kawalpemilu.org#20773,"PRABU JAYA, PRABUMULIH TIMUR, KOTA PRABUMULIH, SUMATERA SELATAN",3,39,100,139
https://kawalpemilu.org#18889,"SUMBER SARI, NIBUNG, MUSI RAWAS UTARA, SUMATERA SELATAN",1,81,96,177
https://kawalpemilu.org#20213,"SUNGAI RAMBUTAN, INDRALAYA UTARA, OGAN ILIR, SUMATERA SELATAN",1,111,90,201
https://kawalpemilu.org#20401,"AIR KELINCAR, ULU MUSI, EMPAT LAWANG, SUMATERA SELATAN",5,92,53,145
https://kawalpemilu.org#18121,"LECAH, LUBAI ULU, MUARA ENIM, SUMATERA SELATAN",1,67,172,239
https://kawalpemilu.org#9590,"SILAU JAWA, BANDAR PASIR MANDOGE, ASAHAN, SUMATERA UTARA",6,117,70,187
https://kawalpemilu.org#6845,"BULUNGIHIT, MARBAU, LABUHANBATU UTARA, SUMATERA UTARA",7,36,178,214
https://kawalpemilu.org#7435,"SARUDIK, SARUDIK, TAPANULI TENGAH, SUMATERA UTARA",2,136,102,238
https://kawalpemilu.org#8193,"KWALA BINGAI, STABAT, LANGKAT, SUMATERA UTARA",29,23,77,100
https://kawalpemilu.org#9522,"SEI APUNG JAYA, TANJUNG BALAI, ASAHAN, SUMATERA UTARA",17,12,78,90
https://kawalpemilu.org#9019,"KENANGAN, PERCUT SEI TUAN, DELI SERDANG, SUMATERA UTARA",11,61,116,177
https://kawalpemilu.org#11835,"PANGKALAN MANSUR, MEDAN JOHOR, KOTA MEDAN, SUMATERA UTARA",63,77,68,145
https://kawalpemilu.org#6787,"RINTIS, SILANGKITANG, LABUHANBATU SELATAN, SUMATERA UTARA",8,58,150,208
https://kawalpemilu.org#12024,"KAPIAS PULAU BUAYA, TELUK NIBUNG, KOTA TANJUNG BALAI, SUMATERA UTARA",25,23,147,170
https://kawalpemilu.org#9138,"MARGO MULYO, GUNUNG MALELA, SIMALUNGUN, SUMATERA UTARA",1,119,113,232
https://kawalpemilu.org#7119,"HILIUSO, LOLOFITU MOI, NIAS BARAT, SUMATERA UTARA",4,108,7,115
https://kawalpemilu.org#7332,"UNTE BOANG, SOSOR GADONG, TAPANULI TENGAH, SUMATERA UTARA",3,218,3,221
https://kawalpemilu.org#8786,"NAMO SIMPUR, PANCUR BATU, DELI SERDANG, SUMATERA UTARA",3,149,12,161
https://kawalpemilu.org#87807,"BANDAR SONO, TANJUNG TIRAM, BATU BARA, SUMATERA UTARA",11,22,114,136
https://kawalpemilu.org#8230,"SECANGGANG, SECANGGANG, LANGKAT, SUMATERA UTARA",16,59,116,175
https://kawalpemilu.org#9513,"SUBUR, AIR JOMAN, ASAHAN, SUMATERA UTARA",7,82,88,170
https://kawalpemilu.org#11667,"LIMAU SUNDAI, AIR PUTIH, BATU BARA, SUMATERA UTARA",3,134,4,138
https://kawalpemilu.org#8502,"KUTAMBARU, MUNTE, KARO, SUMATERA UTARA",5,168,2,170
https://kawalpemilu.org#928353,"BAH LIRAN SIBORNA, PANEI, SIMALUNGUN, SUMATERA UTARA",2,135,73,208
https://kawalpemilu.org#11015,"BOTOHILITANO, LUAHAGUNDRE MANIAMOLO, NIAS SELATAN, SUMATERA UTARA",2,205,22,227
https://kawalpemilu.org#9418,"MARIAH DOLOK, DOLOK SILAU, SIMALUNGUN, SUMATERA UTARA",1,158,15,173
https://kawalpemilu.org#6988,"HILIZUKHU, LAHEWA, NIAS UTARA, SUMATERA UTARA",1,130,13,143
https://kawalpemilu.org#7811,"PARDOMUAN, ANGKOLA SELATAN, TAPANULI SELATAN, SUMATERA UTARA",3,120,41,161
https://kawalpemilu.org#9005,"TANDEM HILIR II, HAMPARAN PERAK, DELI SERDANG, SUMATERA UTARA",3,41,146,187
https://kawalpemilu.org#9677,"PIASA ULU, TINGGI RAJA, ASAHAN, SUMATERA UTARA",8,92,73,165
https://kawalpemilu.org#12347,"RONDAMAN SIBUREGAR, HALONGONAN, PADANG LAWAS UTARA, SUMATERA UTARA",1,83,110,193
https://kawalpemilu.org#8201,"BANYUMAS, STABAT, LANGKAT, SUMATERA UTARA",16,77,72,149
https://kawalpemilu.org#928362,"SORDANG BARU, UJUNG PADANG, SIMALUNGUN, SUMATERA UTARA",2,42,85,127
https://kawalpemilu.org#11808,"BELAWAN SICANANG, MEDAN BELAWAN, KOTA MEDAN, SUMATERA UTARA",7,51,112,163
https://kawalpemilu.org#84231,"DANAU BALE, RANTAU SELATAN, LABUHANBATU, SUMATERA UTARA",10,58,196,254
https://kawalpemilu.org#12781,"UJUNG BATU II, HUTA RAJA TINGGI, PADANG LAWAS, SUMATERA UTARA",4,151,49,200
https://kawalpemilu.org#12101,"TEBING TINGGI, PADANG HILIR, KOTA TEBING TINGGI, SUMATERA UTARA",20,131,64,195
https://kawalpemilu.org#11421,"PEMATANG SETRAK, TELUK MENGKUDU, SERDANG BEDAGAI, SUMATERA UTARA",4,53,112,165
https://kawalpemilu.org#9968,"LINGGA RAJA II, PEGAGAN HILIR, DAIRI, SUMATERA UTARA",4,279,2,281
https://kawalpemilu.org#12422,"NAGA SARIBU, PADANG BOLAK TENGGARA, PADANG LAWAS UTARA, SUMATERA UTARA",6,25,120,145
https://kawalpemilu.org#11915,"SEMPAKATA, MEDAN SELAYANG, KOTA MEDAN, SUMATERA UTARA",26,0,0,0
https://kawalpemilu.org#8967,"DELI TUA, DELI TUA, DELI SERDANG, SUMATERA UTARA",29,78,111,189
https://kawalpemilu.org#12126,"WEK III, PADANG SIDEMPUAN UTARA, KOTA PADANG SIDEMPUAN, SUMATERA UTARA",6,21,144,165
https://kawalpemilu.org#10689,"ORSEDES, BORONADU, NIAS SELATAN, SUMATERA UTARA",2,63,4,67
https://kawalpemilu.org#8646,"CINTA RAYAT, MERDEKA, KARO, SUMATERA UTARA",3,207,11,218
https://kawalpemilu.org#11407,"MELATI II, PERBAUNGAN, SERDANG BEDAGAI, SUMATERA UTARA",3,138,62,200
https://kawalpemilu.org#11387,"NAGA KISAR, PANTAI CERMIN, SERDANG BEDAGAI, SUMATERA UTARA",1,66,88,154
https://kawalpemilu.org#10111,"PINTU POHAN DOLOK, PINTU POHAN MERANTI, TOBA SAMOSIR, SUMATERA UTARA",1,111,3,114
https://kawalpemilu.org#10246,"GUNUNG TUA TONGA, PANYABUNGAN KOTA, MANDAILING NATAL, SUMATERA UTARA",1,19,224,243
https://kawalpemilu.org#12087,"TUALANG, PADANG HULU, KOTA TEBING TINGGI, SUMATERA UTARA",15,80,145,225
https://kawalpemilu.org#11834,"KEDAI DURIAN, MEDAN JOHOR, KOTA MEDAN, SUMATERA UTARA",12,89,101,190
https://kawalpemilu.org#10012,"SILALAHI II, SILAHISABUNGAN, DAIRI, SUMATERA UTARA",1,245,8,253
https://kawalpemilu.org#6787,"RINTIS, SILANGKITANG, LABUHANBATU SELATAN, SUMATERA UTARA",14,34,110,144
https://kawalpemilu.org#9616,"TEBING KISARAN, KOTA KISARAN BARAT, ASAHAN, SUMATERA UTARA",7,89,63,152
https://kawalpemilu.org#90156,"TALUN REJO, PEMATANG BANDAR, SIMALUNGUN, SUMATERA UTARA",4,198,12,210
https://kawalpemilu.org#11981,"ANGIN NAULI, SIBOLGA UTARA, KOTA SIBOLGA, SUMATERA UTARA",9,176,6,182
https://kawalpemilu.org#87326,"CINTA DAMAI, NASSAU, TOBA SAMOSIR, SUMATERA UTARA",3,161,7,168
https://kawalpemilu.org#11762,"TANJUNG REJO, MEDAN SUNGGAL, KOTA MEDAN, SUMATERA UTARA",65,35,86,121
