Link KawalPemilu,Nama Kelurahan,Nomor TPS,Suara 01,Suara 02,Suara Sah
https://kawalpemilu.org#941,"TEUPIN MAMPLAM, SIMPANG ULIM, ACEH TIMUR, ACEH",2,9,134,143
https://kawalpemilu.org#4922,"PANTE KARYA, PEUSANGAN SIBLAH KRUENG, BIREUEN, ACEH",1,21,111,132
https://kawalpemilu.org#2380,"LAMKUNYET, DARUL KAMAL, ACEH BESAR, ACEH",2,3,138,141
https://kawalpemilu.org#3209,"PUCOK ALUE, BAKTIYA, ACEH UTARA, ACEH",39,2,184,186
https://kawalpemilu.org#6468,"LAMLAGANG, BANDA RAYA, KOTA BANDA ACEH, ACEH",5,30,169,199
https://kawalpemilu.org#1513,"LEUHAN, JOHAN PAHWALAN, ACEH BARAT, ACEH",1,19,209,228
https://kawalpemilu.org#3262,"BABUSSALAM, BAKTIYA, ACEH UTARA, ACEH",1,0,0,0
https://kawalpemilu.org#1956,"BAYU, SEULIMEUM, ACEH BESAR, ACEH",1,18,241,259
https://kawalpemilu.org#944,"PUCOK ALUE BARAT, SIMPANG ULIM, ACEH TIMUR, ACEH",2,14,129,143
https://kawalpemilu.org#2393,"KAJHU, BAITUSSALAM, ACEH BESAR, ACEH",5,30,223,253
https://kawalpemilu.org#6067,"PONDOK BARU, BANDAR, BENER MERIAH, ACEH",1,45,150,195
https://kawalpemilu.org#1500,"DRIEN RAMPAK, JOHAN PAHWALAN, ACEH BARAT, ACEH",11,30,182,212
https://kawalpemilu.org#6348,"MNS PARU KEUDE, BANDAR BARU, PIDIE JAYA, ACEH",1,17,187,204
https://kawalpemilu.org#5943,"LAMPAHAN TIMUR, TIMANG GAJAH, BENER MERIAH, ACEH",3,29,128,157
https://kawalpemilu.org#6489,"LAMTEH, ULEE KARENG, KOTA BANDA ACEH, ACEH",1,25,179,204
https://kawalpemilu.org#6321,"MNS. BEURANDEH, BANDAR BARU, PIDIE JAYA, ACEH",1,3,159,162
https://kawalpemilu.org#6224,"BLANG RHEUE, ULIM, PIDIE JAYA, ACEH",1,2,95,97
https://kawalpemilu.org#3429,"SIREN, MATANGKULI, ACEH UTARA, ACEH",1,0,0,0
https://kawalpemilu.org#1373,"KUALA I, BINTANG, ACEH TENGAH, ACEH",1,77,93,170
https://kawalpemilu.org#147,"AIR PINANG, TAPAKTUAN, ACEH SELATAN, ACEH",3,20,208,228
https://kawalpemilu.org#3146,"JIEM, MUTIARA TIMUR, PIDIE, ACEH",1,10,161,171
https://kawalpemilu.org#5238,"CINTA MAJU, BLANGPEGAYON, GAYO LUES, ACEH",2,18,149,167
https://kawalpemilu.org#53779,"CULIK, ABANG, KARANGASEM, BALI",9,153,5,158
https://kawalpemilu.org#53820,"BANYUPOH, GEROKGAK, BULELENG, BALI",8,233,10,243
https://kawalpemilu.org#54009,"TONJA, DENPASAR UTARA, KOTA DENPASAR, BALI",4,243,8,251
https://kawalpemilu.org#53706,"BATUR UTARA, KINTAMANI, BANGLI, BALI",6,187,12,199
https://kawalpemilu.org#53642,"GUNAKSA, DAWAN, KLUNGKUNG, BALI",11,197,18,215
https://kawalpemilu.org#53635,"TEGAK, KLUNGKUNG, KLUNGKUNG, BALI",11,192,20,212
https://kawalpemilu.org#53992,"KESIMAN KERTALANGU, DENPASAR TIMUR, KOTA DENPASAR, BALI",10,196,10,206
https://kawalpemilu.org#54017,"PEMECUTAN KAJA, DENPASAR UTARA, KOTA DENPASAR, BALI",71,212,4,216
https://kawalpemilu.org#53975,"PEDUNGAN, DENPASAR SELATAN, KOTA DENPASAR, BALI",31,218,14,232
https://kawalpemilu.org#53983,"SANUR KAUH, DENPASAR SELATAN, KOTA DENPASAR, BALI",20,230,13,243
https://kawalpemilu.org#53504,"KEROBOKAN KAJA, KUTA UTARA, BADUNG, BALI",38,252,24,276
https://kawalpemilu.org#53287,"MANISTUTU, MELAYA, JEMBRANA, BALI",5,227,26,253
https://kawalpemilu.org#53380,"PEKEN BELAYU, MARGA, TABANAN, BALI",2,230,0,230
https://kawalpemilu.org#84993,"BENGKEL SARI, SELEMADEG BARAT, TABANAN, BALI",3,141,7,148
https://kawalpemilu.org#53260,"PERGUNG, MENDOYO, JEMBRANA, BALI",14,148,7,155
https://kawalpemilu.org#53420,"CANDIKUNING, BATURITI, TABANAN, BALI",5,262,1,263
https://kawalpemilu.org#52474,"CURUG WETAN, CURUG, TANGERANG, BANTEN",13,60,165,225
https://kawalpemilu.org#53158,"CIPOCOK JAYA, CIPOCOK JAYA, KOTA SERANG, BANTEN",32,44,131,175
https://kawalpemilu.org#53022,"MEKARSARI, NEGLASARI, KOTA TANGERANG, BANTEN",18,231,4,235
https://kawalpemilu.org#53020,"SELAPAJANG JAYA, NEGLASARI, KOTA TANGERANG, BANTEN",32,192,39,231
https://kawalpemilu.org#52050,"BANJARSARI, CILELES, LEBAK, BANTEN",2,76,91,167
https://kawalpemilu.org#53097,"PABEAN, PURWAKARTA, KOTA CILEGON, BANTEN",4,36,169,205
https://kawalpemilu.org#53181,"CIATER, SERPONG, KOTA TANGERANG SELATAN, BANTEN",25,142,108,250
https://kawalpemilu.org#53046,"LARANGAN UTARA, LARANGAN, KOTA TANGERANG, BANTEN",35,83,119,202
https://kawalpemilu.org#52554,"SINDANGPANON, SINDANG JAYA, TANGERANG, BANTEN",16,63,184,247
https://kawalpemilu.org#53162,"BANJAR SARI, CIPOCOK JAYA, KOTA SERANG, BANTEN",1,65,158,223
https://kawalpemilu.org#52014,"BOJONGKONENG, GUNUNGKENCANA, LEBAK, BANTEN",1,52,134,186
https://kawalpemilu.org#53219,"CEMPAKA PUTIH, CIPUTAT TIMUR, KOTA TANGERANG SELATAN, BANTEN",66,139,112,251
https://kawalpemilu.org#52218,"KARANGPAMINDANGAN, WANASALAM, LEBAK, BANTEN",2,79,92,171
https://kawalpemilu.org#53215,"SERUA INDAH, CIPUTAT, KOTA TANGERANG SELATAN, BANTEN",16,99,126,225
https://kawalpemilu.org#53197,"LENGKONG KARYA, SERPONG UTARA, KOTA TANGERANG SELATAN, BANTEN",13,111,132,243
https://kawalpemilu.org#53076,"KUBANGSARI, CIWANDAN, KOTA CILEGON, BANTEN",13,24,215,239
https://kawalpemilu.org#52962,"BELENDUNG, BENDA, KOTA TANGERANG, BANTEN",27,59,121,180
https://kawalpemilu.org#52950,"GANDASARI, JATIUWUNG, KOTA TANGERANG, BANTEN",7,88,127,215
https://kawalpemilu.org#51810,"BABAKAN KALANGANYAR, PANDEGLANG, PANDEGLANG, BANTEN",12,91,54,145
https://kawalpemilu.org#52994,"PABUARAN, KARAWACI, KOTA TANGERANG, BANTEN",7,94,131,225
https://kawalpemilu.org#52611,"WARINGINKURUNG, WARINGINKURUNG, SERANG, BANTEN",4,70,147,217
https://kawalpemilu.org#52168,"MEKAR AGUNG, CIBADAK, LEBAK, BANTEN",8,51,123,174
https://kawalpemilu.org#89647,"GROGOL INDAH, ANYAR, SERANG, BANTEN",2,86,180,266
https://kawalpemilu.org#52985,"SUDIMARA SELATAN, CILEDUG, KOTA TANGERANG, BANTEN",46,198,76,274
https://kawalpemilu.org#52448,"PAKU ALAM, PAKUHAJI, TANGERANG, BANTEN",6,44,100,144
https://kawalpemilu.org#52914,"WARINGIN, MANCAK, SERANG, BANTEN",1,36,108,144
https://kawalpemilu.org#52972,"KENANGA, CIPONDOH, KOTA TANGERANG, BANTEN",9,62,118,180
https://kawalpemilu.org#52248,"CIKATAPIS, KALANGANYAR, LEBAK, BANTEN",2,41,171,212
https://kawalpemilu.org#52468,"MEKAR JAYA, SEPATAN, TANGERANG, BANTEN",6,41,153,194
https://kawalpemilu.org#53026,"PINANG, PINANG, KOTA TANGERANG, BANTEN",29,79,107,186
https://kawalpemilu.org#53185,"LENGKONG WETAN, SERPONG, KOTA TANGERANG SELATAN, BANTEN",26,70,154,224
https://kawalpemilu.org#52893,"BANTAR WARU, CINANGKA, SERANG, BANTEN",14,15,55,70
https://kawalpemilu.org#52295,"SUKAMURNI, BALARAJA, TANGERANG, BANTEN",5,61,156,217
https://kawalpemilu.org#51641,"CITEUREUP, PANIMBANG, PANDEGLANG, BANTEN",12,94,90,184
https://kawalpemilu.org#52094,"SINDANGMULYA, MAJA, LEBAK, BANTEN",13,64,149,213
https://kawalpemilu.org#51759,"CIKONENG, MANDALAWANGI, PANDEGLANG, BANTEN",7,76,97,173
https://kawalpemilu.org#52546,"PAKULONAN BARAT, KELAPA DUA, TANGERANG, BANTEN",37,203,5,208
https://kawalpemilu.org#52668,"SENTUL, KRAGILAN, SERANG, BANTEN",12,63,163,226
https://kawalpemilu.org#52684,"KUBANG PUJI, PONTANG, SERANG, BANTEN",1,59,158,217
https://kawalpemilu.org#52410,"MEKARSARI, RAJEG, TANGERANG, BANTEN",1,86,112,198
https://kawalpemilu.org#53236,"SETU, SETU, KOTA TANGERANG SELATAN, BANTEN",21,126,171,297
https://kawalpemilu.org#52056,"CIMARGA, CIMARGA, LEBAK, BANTEN",12,48,75,123
https://kawalpemilu.org#21770,"PADANG PERI, SEMIDANG ALAS MARAS, SELUMA, BENGKULU",3,125,67,192
https://kawalpemilu.org#22191,"DUSUN KEPAHIANG, KEPAHIANG, KEPAHIANG, BENGKULU",8,93,109,202
https://kawalpemilu.org#21195,"KAMPUNG DELIMA, CURUP TIMUR, REJANG LEBONG, BENGKULU",4,107,115,222
https://kawalpemilu.org#20909,"RINDU HATI, TABA PENANJUNG, BENGKULU TENGAH, BENGKULU",1,87,101,188
https://kawalpemilu.org#21460,"LUBUK BALAM, AIR BESI, BENGKULU UTARA, BENGKULU",4,28,126,154
https://kawalpemilu.org#22137,"KEBAN AGUNG, BERMANI ILIR, KEPAHIANG, BENGKULU",2,48,72,120
https://kawalpemilu.org#84724,"TANJUNG DALAM, ULOK KUPAI, BENGKULU UTARA, BENGKULU",6,169,55,224
https://kawalpemilu.org#22299,"SUMBER JAYA, KAMPUNG MELAYU, KOTA BENGKULU, BENGKULU",10,112,31,143
https://kawalpemilu.org#42066,"BALEHARJO, WONOSARI, GUNUNGKIDUL, DAERAH ISTIMEWA YOGYAKARTA",4,155,40,195
https://kawalpemilu.org#42140,"NGIPAK, KARANGMOJO, GUNUNGKIDUL, DAERAH ISTIMEWA YOGYAKARTA",6,150,75,225
https://kawalpemilu.org#42010,"SRIHARJO, IMOGIRI, BANTUL, DAERAH ISTIMEWA YOGYAKARTA",18,122,52,174
https://kawalpemilu.org#42297,"PANDOWOHARJO, SLEMAN, SLEMAN, DAERAH ISTIMEWA YOGYAKARTA",3,153,62,215
https://kawalpemilu.org#42125,"SUMBERWUNGU, TEPUS, GUNUNGKIDUL, DAERAH ISTIMEWA YOGYAKARTA",6,74,55,129
https://kawalpemilu.org#41981,"SELOHARJO, PUNDONG, BANTUL, DAERAH ISTIMEWA YOGYAKARTA",40,161,35,196
https://kawalpemilu.org#42227,"TRIHANGGO, GAMPING, SLEMAN, DAERAH ISTIMEWA YOGYAKARTA",11,118,71,189
https://kawalpemilu.org#42323,"KEPUHARJO, CANGKRINGAN, SLEMAN, DAERAH ISTIMEWA YOGYAKARTA",11,178,43,221
https://kawalpemilu.org#41942,"GIRIPURWO, GIRIMULYO, KULON PROGO, DAERAH ISTIMEWA YOGYAKARTA",19,158,56,214
https://kawalpemilu.org#42142,"GEDANGREJO, KARANGMOJO, GUNUNGKIDUL, DAERAH ISTIMEWA YOGYAKARTA",23,134,25,159
https://kawalpemilu.org#42321,"WUKIRSARI, CANGKRINGAN, SLEMAN, DAERAH ISTIMEWA YOGYAKARTA",34,113,59,172
https://kawalpemilu.org#42055,"ARGOREJO, SEDAYU, BANTUL, DAERAH ISTIMEWA YOGYAKARTA",31,151,90,241
https://kawalpemilu.org#41961,"BANJARARUM, KALIBAWANG, KULON PROGO, DAERAH ISTIMEWA YOGYAKARTA",10,0,0,0
https://kawalpemilu.org#41973,"MURTIGADING, SANDEN, BANTUL, DAERAH ISTIMEWA YOGYAKARTA",9,69,131,200
https://kawalpemilu.org#41972,"SRIGADING, SANDEN, BANTUL, DAERAH ISTIMEWA YOGYAKARTA",5,139,54,193
https://kawalpemilu.org#25970,"KALIDERES, KALIDERES, JAKARTA BARAT, DKI JAKARTA",90,104,92,196
https://kawalpemilu.org#26057,"TANJUNG BARAT, JAGAKARSA, JAKARTA SELATAN, DKI JAKARTA",133,60,131,191
https://kawalpemilu.org#25965,"KELAPA DUA, KEBON JERUK, JAKARTA BARAT, DKI JAKARTA",28,87,186,273
https://kawalpemilu.org#25899,"SUNTER AGUNG, TANJUNG PRIOK, JAKARTA UTARA, DKI JAKARTA",87,112,108,220
https://kawalpemilu.org#26109,"PULO GEBANG, CAKUNG, JAKARTA TIMUR, DKI JAKARTA",236,87,98,185
https://kawalpemilu.org#26054,"SRENGSENG SAWAH, JAGAKARSA, JAKARTA SELATAN, DKI JAKARTA",154,86,116,202
https://kawalpemilu.org#26115,"KLENDER, DUREN SAWIT, JAKARTA TIMUR, DKI JAKARTA",99,85,113,198
https://kawalpemilu.org#26129,"KELAPA DUA WETAN, CIRACAS, JAKARTA TIMUR, DKI JAKARTA",48,107,75,182
https://kawalpemilu.org#25912,"KALIBARU, CILINCING, JAKARTA UTARA, DKI JAKARTA",93,84,71,155
https://kawalpemilu.org#25918,"PADEMANGAN BARAT, PADEMANGAN, JAKARTA UTARA, DKI JAKARTA",203,120,98,218
https://kawalpemilu.org#26079,"KAYU PUTIH, PULOGADUNG, JAKARTA TIMUR, DKI JAKARTA",89,193,24,217
https://kawalpemilu.org#26087,"CIPINANG MUARA, JATINEGARA, JAKARTA TIMUR, DKI JAKARTA",35,53,126,179
https://kawalpemilu.org#25988,"KEMBANGAN SELATAN, KEMBANGAN, JAKARTA BARAT, DKI JAKARTA",46,178,10,188
https://kawalpemilu.org#26118,"MALAKA JAYA, DUREN SAWIT, JAKARTA TIMUR, DKI JAKARTA",12,102,161,263
https://kawalpemilu.org#25904,"LAGOA, KOJA, JAKARTA UTARA, DKI JAKARTA",39,134,94,228
https://kawalpemilu.org#26116,"PONDOK KELAPA, DUREN SAWIT, JAKARTA TIMUR, DKI JAKARTA",237,91,69,160
https://kawalpemilu.org#25907,"RAWA BADAK SELATAN, KOJA, JAKARTA UTARA, DKI JAKARTA",88,91,162,253
https://kawalpemilu.org#26128,"CIBUBUR, CIRACAS, JAKARTA TIMUR, DKI JAKARTA",72,127,113,240
https://kawalpemilu.org#26001,"KARET KUNINGAN, SETIABUDI, JAKARTA SELATAN, DKI JAKARTA",44,169,52,221
https://kawalpemilu.org#25930,"KAPUK, CENGKARENG, JAKARTA BARAT, DKI JAKARTA",58,123,98,221
https://kawalpemilu.org#25963,"SUKABUMI UTARA, KEBON JERUK, JAKARTA BARAT, DKI JAKARTA",86,41,183,224
https://kawalpemilu.org#25915,"SEMPER BARAT, CILINCING, JAKARTA UTARA, DKI JAKARTA",160,163,117,280
https://kawalpemilu.org#26099,"PEKAYON, PASAR REBO, JAKARTA TIMUR, DKI JAKARTA",39,84,138,222
https://kawalpemilu.org#26088,"CIPINANG BESAR SELATAN, JATINEGARA, JAKARTA TIMUR, DKI JAKARTA",63,87,107,194
https://kawalpemilu.org#26055,"CIGANJUR, JAGAKARSA, JAKARTA SELATAN, DKI JAKARTA",51,93,106,199
https://kawalpemilu.org#26114,"PONDOK BAMBU, DUREN SAWIT, JAKARTA TIMUR, DKI JAKARTA",77,111,126,237
https://kawalpemilu.org#25991,"TEBET TIMUR, TEBET, JAKARTA SELATAN, DKI JAKARTA",2,108,124,232
https://kawalpemilu.org#26023,"PONDOK PINANG, KEBAYORAN LAMA, JAKARTA SELATAN, DKI JAKARTA",116,134,89,223
https://kawalpemilu.org#25917,"PADEMANGAN TIMUR, PADEMANGAN, JAKARTA UTARA, DKI JAKARTA",32,169,85,254
https://kawalpemilu.org#25836,"CIDENG, GAMBIR, JAKARTA PUSAT, DKI JAKARTA",32,135,76,211
https://kawalpemilu.org#25915,"SEMPER BARAT, CILINCING, JAKARTA UTARA, DKI JAKARTA",188,131,105,236
https://kawalpemilu.org#26127,"CIRACAS, CIRACAS, JAKARTA TIMUR, DKI JAKARTA",76,158,99,257
https://kawalpemilu.org#26020,"KEBAGUSAN, PASAR MINGGU, JAKARTA SELATAN, DKI JAKARTA",46,116,155,271
https://kawalpemilu.org#25993,"MENTENG DALAM, TEBET, JAKARTA SELATAN, DKI JAKARTA",65,117,60,177
https://kawalpemilu.org#25935,"TOMANG, GROGOL PETAMBURAN, JAKARTA BARAT, DKI JAKARTA",100,108,119,227
https://kawalpemilu.org#26134,"CILANGKAP, CIPAYUNG, JAKARTA TIMUR, DKI JAKARTA",51,107,136,243
https://kawalpemilu.org#74961,"HULAWA, PAGUYAMAN, BOALEMO, GORONTALO",1,187,75,262
https://kawalpemilu.org#75367,"DEMBE I, KOTA BARAT, KOTA GORONTALO, GORONTALO",3,98,134,232
https://kawalpemilu.org#85886,"TINGKOHUBU TIMUR, SUWAWA, BONE BOLANGO, GORONTALO",2,54,157,211
https://kawalpemilu.org#85927,"HUIDU MELITO, TOMOLITO, GORONTALO UTARA, GORONTALO",1,83,123,206
https://kawalpemilu.org#85885,"BOTUBULOWE, DUNGALIYO, GORONTALO, GORONTALO",2,162,40,202
https://kawalpemilu.org#17381,"TANJUNG RADEN, DANAU TELUK, KOTA JAMBI, JAMBI",9,60,91,151
https://kawalpemilu.org#928998,"KAMPUNG PULAU, PEMAYUNG, BATANGHARI, JAMBI",1,47,152,199
https://kawalpemilu.org#16873,"TUNGKAL III, TUNGKAL ILIR, TANJUNG JABUNG BARAT, JAMBI",9,39,90,129
https://kawalpemilu.org#16682,"BAJUBANG, BAJUBANG, BATANGHARI, JAMBI",17,94,45,139
https://kawalpemilu.org#16244,"SELING, TABIR, MERANGIN, JAMBI",2,21,150,171
https://kawalpemilu.org#16217,"RANTAU PANJANG, MUARA SIAU, MERANGIN, JAMBI",2,47,188,235
https://kawalpemilu.org#16558,"SUNGAI BENTENG, SINGKUT, SAROLANGUN, JAMBI",8,77,102,179
https://kawalpemilu.org#16948,"MUARA SABAK ILIR, MUARA SABAK TIMUR, TANJUNG JABUNG TIMUR, JAMBI",3,83,152,235
https://kawalpemilu.org#17178,"SUNGAI BULUH, RIMBO TENGAH, BUNGO, JAMBI",5,116,97,213
https://kawalpemilu.org#17055,"TELUK KECIMBUNG, TANAH TUMBUH, BUNGO, JAMBI",4,20,241,261
https://kawalpemilu.org#17350,"THEHOK, JAMBI SELATAN, KOTA JAMBI, JAMBI",29,90,88,178
https://kawalpemilu.org#16962,"NIPAH PANJANG II, NIPAH PANJANG, TANJUNG JABUNG TIMUR, JAMBI",20,123,114,237
https://kawalpemilu.org#16394,"SIDO LEGO, TABIR LINTAS, MERANGIN, JAMBI",4,81,111,192
https://kawalpemilu.org#17288,"SUKA DAMAI, RIMBO ULU, TEBO, JAMBI",10,47,90,137
https://kawalpemilu.org#29426,"BABAKAN, BABAKAN, CIREBON, JAWA BARAT",9,108,95,203
https://kawalpemilu.org#26526,"SUKAJADI, TAMANSARI, BOGOR, JAWA BARAT",30,25,75,100
https://kawalpemilu.org#26580,"SASAKPANJANG, TAJURHALANG, BOGOR, JAWA BARAT",22,55,95,150
https://kawalpemilu.org#31016,"CIBALANDONG JAYA, CIBOGO, SUBANG, JAWA BARAT",4,179,63,242
https://kawalpemilu.org#32145,"KEDUNGWARINGIN, TANAH SAREAL, KOTA BOGOR, JAWA BARAT",3,75,123,198
https://kawalpemilu.org#32263,"GUMURUH, BATUNUNGGAL, KOTA BANDUNG, JAWA BARAT",24,114,149,263
https://kawalpemilu.org#32169,"GEDONGPANJANG, CITAMIANG, KOTA SUKABUMI, JAWA BARAT",3,42,228,270
https://kawalpemilu.org#29252,"TAJURBUNTU, PANCALANG, KUNINGAN, JAWA BARAT",2,47,93,140
https://kawalpemilu.org#26613,"PELABUHAN RATU, PELABUHAN RATU, SUKABUMI, JAWA BARAT",63,87,33,120
https://kawalpemilu.org#29134,"BABAKANMULYA, JALAKSANA, KUNINGAN, JAWA BARAT",15,98,49,147
https://kawalpemilu.org#29805,"GUMULUNG TONGGOH, GREGED, CIREBON, JAWA BARAT",21,147,57,204
https://kawalpemilu.org#27607,"MANGGAHANG, BALEENDAH, BANDUNG, JAWA BARAT",90,55,116,171
https://kawalpemilu.org#31789,"SERTAJAYA, CIKARANG TIMUR, BEKASI, JAWA BARAT",26,89,134,223
https://kawalpemilu.org#28366,"KARYAWANGI, SALOPA, TASIKMALAYA, JAWA BARAT",1,38,141,179
https://kawalpemilu.org#27979,"SIRNAGALIH, CISURUPAN, GARUT, JAWA BARAT",16,48,111,159
https://kawalpemilu.org#28596,"GEGEMPALAN, CIKONENG, CIAMIS, JAWA BARAT",12,54,55,109
https://kawalpemilu.org#26388,"GOROWONG, PARUNG PANJANG, BOGOR, JAWA BARAT",1,51,151,202
https://kawalpemilu.org#30473,"DARMAWANGI, TOMO, SUMEDANG, JAWA BARAT",3,115,85,200
https://kawalpemilu.org#29196,"DARMA, DARMA, KUNINGAN, JAWA BARAT",14,23,200,223
https://kawalpemilu.org#32431,"SEPANJANG JAYA, RAWA LUMBU, KOTA BEKASI, JAWA BARAT",34,107,111,218
https://kawalpemilu.org#29399,"PANGGANGSARI, LOSARI, CIREBON, JAWA BARAT",17,150,24,174
https://kawalpemilu.org#29489,"KANCI, ASTANAJAPURA, CIREBON, JAWA BARAT",4,168,94,262
https://kawalpemilu.org#26815,"MANDRAJAYA, CIEMAS, SUKABUMI, JAWA BARAT",4,85,105,190
https://kawalpemilu.org#26805,"CIPARAY, JAMPANG KULON, SUKABUMI, JAWA BARAT",14,32,152,184
https://kawalpemilu.org#30971,"JAYAMUKTI, BLANAKAN, SUBANG, JAWA BARAT",12,146,33,179
https://kawalpemilu.org#28015,"SINGAJAYA, SINGAJAYA, GARUT, JAWA BARAT",15,121,66,187
https://kawalpemilu.org#31996,"BATUJAJAR BARAT, BATUJAJAR, BANDUNG BARAT, JAWA BARAT",15,41,153,194
https://kawalpemilu.org#29595,"PASANGGRAHAN, PLUMBON, CIREBON, JAWA BARAT",12,129,49,178
https://kawalpemilu.org#27023,"WANGUNJAYA, CIAMBAR, SUKABUMI, JAWA BARAT",8,26,120,146
https://kawalpemilu.org#30889,"BANGGALAMULYA, KALIJATI, SUBANG, JAWA BARAT",5,96,82,178
https://kawalpemilu.org#27458,"PANGAUBAN, KATAPANG, BANDUNG, JAWA BARAT",38,66,82,148
https://kawalpemilu.org#32469,"JATIWARNA, PONDOK MELATI, KOTA BEKASI, JAWA BARAT",54,69,78,147
https://kawalpemilu.org#26716,"TENJOJAYA, CIBADAK, SUKABUMI, JAWA BARAT",7,78,133,211
https://kawalpemilu.org#32430,"PENGASINAN, RAWA LUMBU, KOTA BEKASI, JAWA BARAT",125,112,90,202
https://kawalpemilu.org#32047,"CIBEDUG, RONGGA, BANDUNG BARAT, JAWA BARAT",11,72,120,192
https://kawalpemilu.org#32447,"JATIBENING BARU, PONDOK GEDE, KOTA BEKASI, JAWA BARAT",78,71,91,162
https://kawalpemilu.org#30873,"KARANGANYAR, SUBANG, SUBANG, JAWA BARAT",73,135,88,223
https://kawalpemilu.org#28300,"PARUMASAN, SODONGHILIR, TASIKMALAYA, JAWA BARAT",12,26,139,165
https://kawalpemilu.org#26551,"PASIRGAOK, RANCA BUNGUR, BOGOR, JAWA BARAT",32,58,88,146
https://kawalpemilu.org#28258,"PARUNGPONTENG, PARUNGPONTENG, TASIKMALAYA, JAWA BARAT",8,16,86,102
https://kawalpemilu.org#30230,"KARANGPAKUAN, DARMARAJA, SUMEDANG, JAWA BARAT",8,80,145,225
https://kawalpemilu.org#28905,"MEKARMUKTI, CISAGA, CIAMIS, JAWA BARAT",22,41,122,163
https://kawalpemilu.org#32094,"CIPAKU, BOGOR SELATAN, KOTA BOGOR, JAWA BARAT",4,116,105,221
https://kawalpemilu.org#32164,"SUBANGJAYA, CIKOLE, KOTA SUKABUMI, JAWA BARAT",41,78,92,170
https://kawalpemilu.org#26715,"WARNAJATI, CIBADAK, SUKABUMI, JAWA BARAT",15,79,100,179
https://kawalpemilu.org#28407,"PASIRBATANG, MANONJAYA, TASIKMALAYA, JAWA BARAT",12,88,130,218
https://kawalpemilu.org#30628,"SLEMAN, SLIYEG, INDRAMAYU, JAWA BARAT",14,113,73,186
https://kawalpemilu.org#31899,"KAYUAMBON, LEMBANG, BANDUNG BARAT, JAWA BARAT",23,114,130,244
https://kawalpemilu.org#27976,"CIPAGANTI, CISURUPAN, GARUT, JAWA BARAT",12,25,188,213
https://kawalpemilu.org#30124,"BARIBIS, CIGASONG, MAJALENGKA, JAWA BARAT",5,85,136,221
https://kawalpemilu.org#28403,"CIBEBER, MANONJAYA, TASIKMALAYA, JAWA BARAT",1,62,170,232
https://kawalpemilu.org#30844,"MEKARSARI, PATROL, INDRAMAYU, JAWA BARAT",8,140,39,179
https://kawalpemilu.org#27271,"KERTAJAYA, TANGGEUNG, CIANJUR, JAWA BARAT",7,58,128,183
https://kawalpemilu.org#32084,"RANGGAMEKAR, BOGOR SELATAN, KOTA BOGOR, JAWA BARAT",34,95,78,173
https://kawalpemilu.org#27803,"SUKARASA, SAMARANG, GARUT, JAWA BARAT",5,31,173,204
https://kawalpemilu.org#32606,"KOTA BARU, CIBEUREUM, KOTA TASIKMALAYA, JAWA BARAT",39,96,157,253
https://kawalpemilu.org#27685,"PANYOCOKAN, CIWIDEY, BANDUNG, JAWA BARAT",38,77,33,110
https://kawalpemilu.org#29098,"CIHIRUP, CIAWIGEBANG, KUNINGAN, JAWA BARAT",7,84,64,148
https://kawalpemilu.org#31720,"SUKABAKTI, TAMBELANG, BEKASI, JAWA BARAT",2,73,98,171
https://kawalpemilu.org#32465,"MUSTIKASARI, MUSTIKA JAYA, KOTA BEKASI, JAWA BARAT",35,70,63,133
https://kawalpemilu.org#26729,"NAGRAK SELATAN, NAGRAK, SUKABUMI, JAWA BARAT",24,98,140,238
https://kawalpemilu.org#26195,"PASIR LAJA, SUKARAJA, BOGOR, JAWA BARAT",17,50,182,232
https://kawalpemilu.org#28120,"NYALINDUNG, CISEWU, GARUT, JAWA BARAT",12,103,105,208
https://kawalpemilu.org#26191,"PASIR JAMBU, SUKARAJA, BOGOR, JAWA BARAT",37,53,152,205
https://kawalpemilu.org#32121,"SEMPLAK, BOGOR BARAT, KOTA BOGOR, JAWA BARAT",23,104,74,178
https://kawalpemilu.org#32448,"JATICEMPAKA, PONDOK GEDE, KOTA BEKASI, JAWA BARAT",145,75,73,148
https://kawalpemilu.org#30567,"WIDASARI, WIDASARI, INDRAMAYU, JAWA BARAT",3,167,23,190
https://kawalpemilu.org#32130,"LOJI, BOGOR BARAT, KOTA BOGOR, JAWA BARAT",44,72,152,224
https://kawalpemilu.org#26994,"CIDOLOG, CIDOLOG, SUKABUMI, JAWA BARAT",11,68,71,139
https://kawalpemilu.org#26698,"MEKARJAYA, WARUNG KIARA, SUKABUMI, JAWA BARAT",2,41,159,200
https://kawalpemilu.org#26827,"JAGAMUKTI, SURADE, SUKABUMI, JAWA BARAT",2,25,143,168
https://kawalpemilu.org#30126,"KUTAMANGGU, CIGASONG, MAJALENGKA, JAWA BARAT",10,59,171,230
https://kawalpemilu.org#29147,"CARACAS, CILIMUS, KUNINGAN, JAWA BARAT",10,82,157,239
https://kawalpemilu.org#92017,"BATU TULIS, NANGGUNG, BOGOR, JAWA BARAT",9,58,159,217
https://kawalpemilu.org#26898,"CIJENGKOL, CARINGIN, SUKABUMI, JAWA BARAT",5,23,149,172
https://kawalpemilu.org#27964,"SUKAMURNI, CILAWU, GARUT, JAWA BARAT",11,61,145,206
https://kawalpemilu.org#27411,"CIMEKAR, CILEUNYI, BANDUNG, JAWA BARAT",70,58,116,174
https://kawalpemilu.org#30911,"SUMBERSARI, PAGADEN, SUBANG, JAWA BARAT",7,134,37,171
https://kawalpemilu.org#27469,"BANJARAN WETAN, BANJARAN, BANDUNG, JAWA BARAT",5,89,156,245
https://kawalpemilu.org#31196,"CIBODAS, SUKATANI, PURWAKARTA, JAWA BARAT",5,9,157,166
https://kawalpemilu.org#32072,"CILANGARI, GUNUNGHALU, BANDUNG BARAT, JAWA BARAT",6,89,116,205
https://kawalpemilu.org#89330,"NAGARAWANGI, PANAWANGAN, CIAMIS, JAWA BARAT",3,50,87,137
https://kawalpemilu.org#32468,"JATIRAHAYU, PONDOK MELATI, KOTA BEKASI, JAWA BARAT",110,90,135,225
https://kawalpemilu.org#27363,"BATULAWANG, CIPANAS, CIANJUR, JAWA BARAT",5,39,115,154
https://kawalpemilu.org#31062,"KAWUNGANTEN, CIKAUM, SUBANG, JAWA BARAT",5,130,108,238
https://kawalpemilu.org#27631,"LANGENSARI, SOLOKANJERUK, BANDUNG, JAWA BARAT",16,112,114,226
https://kawalpemilu.org#30950,"PAMANUKAN, PAMANUKAN, SUBANG, JAWA BARAT",2,138,52,190
https://kawalpemilu.org#31939,"MANDALAMUKTI, CIKALONGWETAN, BANDUNG BARAT, JAWA BARAT",22,72,82,154
https://kawalpemilu.org#31352,"KARANGPAWITAN, KARAWANG BARAT, KARAWANG, JAWA BARAT",28,77,129,206
https://kawalpemilu.org#26859,"CIBOLANG, GUNUNG GURUH, SUKABUMI, JAWA BARAT",17,35,117,152
https://kawalpemilu.org#32135,"CIPARIGI, BOGOR UTARA, KOTA BOGOR, JAWA BARAT",46,98,124,222
https://kawalpemilu.org#32330,"SEKEJATI, BUAHBATU, KOTA BANDUNG, JAWA BARAT",64,94,173,267
https://kawalpemilu.org#27485,"LANGONSARI, PAMEUNGPEUK, BANDUNG, JAWA BARAT",35,43,158,201
https://kawalpemilu.org#32614,"TAMANSARI, TAMANSARI, KOTA TASIKMALAYA, JAWA BARAT",19,48,106,154
https://kawalpemilu.org#32363,"CIPADUNG KIDUL, PANYILEUKAN, KOTA BANDUNG, JAWA BARAT",37,114,149,263
https://kawalpemilu.org#30158,"WANGKELANG, CINGAMBUL, MAJALENGKA, JAWA BARAT",1,66,131,197
https://kawalpemilu.org#27067,"CIBADAK, CIBEBER, CIANJUR, JAWA BARAT",5,23,163,186
https://kawalpemilu.org#26194,"CADASNGAMPAR, SUKARAJA, BOGOR, JAWA BARAT",7,30,210,240
https://kawalpemilu.org#32108,"SEMPUR, BOGOR TENGAH, KOTA BOGOR, JAWA BARAT",10,70,140,210
https://kawalpemilu.org#28216,"KALAPAGENEP, CIKALONG, TASIKMALAYA, JAWA BARAT",3,38,134,172
https://kawalpemilu.org#32602,"GUNUNG GEDE, KAWALU, KOTA TASIKMALAYA, JAWA BARAT",26,48,116,164
https://kawalpemilu.org#27777,"JAYARAGA, TAROGONG KIDUL, GARUT, JAWA BARAT",6,38,118,156
https://kawalpemilu.org#26846,"CIKANGKUNG, CIRACAP, SUKABUMI, JAWA BARAT",25,93,91,184
https://kawalpemilu.org#32425,"JAKA MULYA, BEKASI SELATAN, KOTA BEKASI, JAWA BARAT",93,106,88,194
https://kawalpemilu.org#26291,"RAGAJAYA, BOJONG GEDE, BOGOR, JAWA BARAT",8,83,88,171
https://kawalpemilu.org#28555,"PAGERAGEUNG, PAGERAGEUNG, TASIKMALAYA, JAWA BARAT",15,14,204,218
https://kawalpemilu.org#29847,"SUKAJADI, LEMAHSUGIH, MAJALENGKA, JAWA BARAT",10,19,110,129
https://kawalpemilu.org#27524,"CICALENGKA WETAN, CICALENGKA, BANDUNG, JAWA BARAT",46,36,116,152
https://kawalpemilu.org#31739,"MANGUNJAYA, TAMBUN SELATAN, BEKASI, JAWA BARAT",82,87,113,200
https://kawalpemilu.org#32447,"JATIBENING BARU, PONDOK GEDE, KOTA BEKASI, JAWA BARAT",19,100,90,190
https://kawalpemilu.org#27847,"KARANGMULYA, KADUNGORA, GARUT, JAWA BARAT",15,71,172,243
https://kawalpemilu.org#29796,"PALIMANAN BARAT, GEMPOL, CIREBON, JAWA BARAT",37,164,29,193
https://kawalpemilu.org#28309,"RAKSAJAYA, SODONGHILIR, TASIKMALAYA, JAWA BARAT",1,37,100,137
https://kawalpemilu.org#29701,"GEGESIK KULON, GEGESIK, CIREBON, JAWA BARAT",7,120,80,200
https://kawalpemilu.org#30201,"CILENGKRANG, WADO, SUMEDANG, JAWA BARAT",2,76,170,246
https://kawalpemilu.org#31740,"SUMBERJAYA, TAMBUN SELATAN, BEKASI, JAWA BARAT",18,88,123,211
https://kawalpemilu.org#27436,"CIPAGALO, BOJONGSOANG, BANDUNG, JAWA BARAT",40,67,140,207
https://kawalpemilu.org#27964,"SUKAMURNI, CILAWU, GARUT, JAWA BARAT",20,4,246,250
https://kawalpemilu.org#26882,"SUKARESMI, CISAAT, SUKABUMI, JAWA BARAT",8,27,101,128
https://kawalpemilu.org#29796,"PALIMANAN BARAT, GEMPOL, CIREBON, JAWA BARAT",33,150,48,198
https://kawalpemilu.org#28205,"CIKUKULU, KARANGNUNGGAL, TASIKMALAYA, JAWA BARAT",4,55,144,199
https://kawalpemilu.org#32446,"JATIMAKMUR, PONDOK GEDE, KOTA BEKASI, JAWA BARAT",136,125,81,206
https://kawalpemilu.org#31161,"JATILUHUR, JATILUHUR, PURWAKARTA, JAWA BARAT",8,76,131,207
https://kawalpemilu.org#27604,"BALEENDAH, BALEENDAH, BANDUNG, JAWA BARAT",160,72,152,224
https://kawalpemilu.org#26153,"CIRIUNG, CIBINONG, BOGOR, JAWA BARAT",16,105,126,231
https://kawalpemilu.org#30510,"KERTANEGARA, HAURGEULIS, INDRAMAYU, JAWA BARAT",24,123,24,147
https://kawalpemilu.org#32156,"SRIWIDARI, GUNUNG PUYUH, KOTA SUKABUMI, JAWA BARAT",5,67,131,198
https://kawalpemilu.org#27861,"SINDANGSARI, LEUWIGOONG, GARUT, JAWA BARAT",9,55,138,193
https://kawalpemilu.org#32448,"JATICEMPAKA, PONDOK GEDE, KOTA BEKASI, JAWA BARAT",101,132,82,214
https://kawalpemilu.org#27967,"CIDATAR, CISURUPAN, GARUT, JAWA BARAT",7,65,111,176
https://kawalpemilu.org#28031,"TOBLONG, PEUNDEUY, GARUT, JAWA BARAT",12,93,74,167
https://kawalpemilu.org#27476,"MARGAHURIP, BANJARAN, BANDUNG, JAWA BARAT",23,75,98,173
https://kawalpemilu.org#29822,"SURANENGGALA LOR, SURANENGGALA, CIREBON, JAWA BARAT",7,133,70,203
https://kawalpemilu.org#27873,"KERESEK, CIBATU, GARUT, JAWA BARAT",15,61,173,234
https://kawalpemilu.org#32327,"MENGGER, BANDUNG KIDUL, KOTA BANDUNG, JAWA BARAT",8,116,110,226
https://kawalpemilu.org#30855,"SAGALAHERANG KALER, SAGALAHERANG, SUBANG, JAWA BARAT",2,113,135,248
https://kawalpemilu.org#32521,"SUKAMAJU, CILODONG, KOTA DEPOK, JAWA BARAT",149,52,126,178
https://kawalpemilu.org#28231,"TONJONG, PANCATENGAH, TASIKMALAYA, JAWA BARAT",5,5,171,176
https://kawalpemilu.org#28695,"MUKTISARI, CIPAKU, CIAMIS, JAWA BARAT",2,23,133,156
https://kawalpemilu.org#32035,"CIJENUK, CIPONGKOR, BANDUNG BARAT, JAWA BARAT",11,11,125,136
https://kawalpemilu.org#29730,"GEBANG, GEBANG, CIREBON, JAWA BARAT",2,160,28,188
https://kawalpemilu.org#32133,"TEGALGUNDIL, BOGOR UTARA, KOTA BOGOR, JAWA BARAT",4,64,125,189
https://kawalpemilu.org#32242,"LEDENG, CIDADAP, KOTA BANDUNG, JAWA BARAT",13,59,185,244
https://kawalpemilu.org#26430,"TENJO, TENJO, BOGOR, JAWA BARAT",6,92,140,232
https://kawalpemilu.org#28575,"CIAMIS, CIAMIS, CIAMIS, JAWA BARAT",57,54,172,226
https://kawalpemilu.org#30993,"SUKADANA, COMPRENG, SUBANG, JAWA BARAT",3,145,54,199
https://kawalpemilu.org#32384,"KESEPUHAN, LEMAH WUNGKUK, KOTA CIREBON, JAWA BARAT",36,148,43,191
https://kawalpemilu.org#28422,"SINGAPARNA, SINGAPARNA, TASIKMALAYA, JAWA BARAT",21,81,131,212
https://kawalpemilu.org#31976,"KERTAMUKTI, CIPATAT, BANDUNG BARAT, JAWA BARAT",20,92,149,241
https://kawalpemilu.org#31039,"CIMAYASARI, CIPEUNDEUY, SUBANG, JAWA BARAT",15,53,152,205
https://kawalpemilu.org#32311,"SUKALUYU, CIBEUNYING KALER, KOTA BANDUNG, JAWA BARAT",26,101,85,186
https://kawalpemilu.org#31744,"KERTAMUKTI, CIBITUNG, BEKASI, JAWA BARAT",36,46,87,133
https://kawalpemilu.org#32028,"MUKAPAYUNG, CILILIN, BANDUNG BARAT, JAWA BARAT",17,46,143,189
https://kawalpemilu.org#26291,"RAGAJAYA, BOJONG GEDE, BOGOR, JAWA BARAT",24,32,168,200
https://kawalpemilu.org#29604,"SETU KULON, WERU, CIREBON, JAWA BARAT",23,114,108,222
https://kawalpemilu.org#32446,"JATIMAKMUR, PONDOK GEDE, KOTA BEKASI, JAWA BARAT",49,97,117,214
https://kawalpemilu.org#32310,"CIHAUR GEULIS, CIBEUNYING KALER, KOTA BANDUNG, JAWA BARAT",29,103,125,228
https://kawalpemilu.org#30247,"SITUMEKAR, CISITU, SUMEDANG, JAWA BARAT",8,83,82,165
https://kawalpemilu.org#32534,"SUKATANI, TAPOS, KOTA DEPOK, JAWA BARAT",123,104,72,176
https://kawalpemilu.org#30919,"GUNUNGSEMBUNG, PAGADEN, SUBANG, JAWA BARAT",6,70,111,181
https://kawalpemilu.org#27657,"KARYALAKSANA, IBUN, BANDUNG, JAWA BARAT",15,60,89,149
https://kawalpemilu.org#26394,"CIBUNAR, PARUNG PANJANG, BOGOR, JAWA BARAT",7,89,114,203
https://kawalpemilu.org#26157,"WANAHERANG, GUNUNG PUTRI, BOGOR, JAWA BARAT",67,43,203,246
https://kawalpemilu.org#28612,"WERASARI, SADANANYA, CIAMIS, JAWA BARAT",8,21,161,182
https://kawalpemilu.org#31005,"TANJUNGRASA, PATOKBEUSI, SUBANG, JAWA BARAT",11,47,213,260
https://kawalpemilu.org#32063,"PUNCAKSARI, SINDANGKERTA, BANDUNG BARAT, JAWA BARAT",17,73,106,179
https://kawalpemilu.org#32552,"LEUWIGAJAH, CIMAHI SELATAN, KOTA CIMAHI, JAWA BARAT",31,40,142,182
https://kawalpemilu.org#29871,"SINDANG, CIKIJING, MAJALENGKA, JAWA BARAT",2,23,141,164
https://kawalpemilu.org#29987,"HEULEUT, LEUWIMUNDING, MAJALENGKA, JAWA BARAT",13,99,78,177
https://kawalpemilu.org#28874,"BUNISARI, CIGUGUR, PANGANDARAN, JAWA BARAT",12,44,154,198
https://kawalpemilu.org#39201,"TENGARAN, TENGARAN, SEMARANG, JAWA TENGAH",5,143,104,247
https://kawalpemilu.org#37706,"SEMBONGIN, BANJAREJO, BLORA, JAWA TENGAH",3,175,37,212
https://kawalpemilu.org#34858,"BANYUASIN SEPARE, LOANO, PURWOREJO, JAWA TENGAH",2,110,64,174
https://kawalpemilu.org#33754,"LEMAHJAYA, WANADADI, BANJARNEGARA, JAWA TENGAH",15,100,24,124
https://kawalpemilu.org#40715,"KECEPIT, RANDUDONGKAL, PEMALANG, JAWA TENGAH",2,91,52,143
https://kawalpemilu.org#38697,"PIJI, DAWE, KUDUS, JAWA TENGAH",13,154,34,188
https://kawalpemilu.org#37199,"KATELAN, TANGEN, SRAGEN, JAWA TENGAH",18,197,20,217
https://kawalpemilu.org#33932,"SIKAYU, BUAYAN, KEBUMEN, JAWA TENGAH",18,84,18,102
https://kawalpemilu.org#33192,"KARANGKEMIRI, PEKUNCEN, BANYUMAS, JAWA TENGAH",9,145,29,174
https://kawalpemilu.org#34380,"PLUMBON, KARANGSAMBUNG, KEBUMEN, JAWA TENGAH",14,108,31,139
https://kawalpemilu.org#36211,"BENGKING, JATINOM, KLATEN, JAWA TENGAH",5,118,37,155
https://kawalpemilu.org#39739,"NGADISEPI, GEMAWANG, TEMANGGUNG, JAWA TENGAH",2,183,13,196
https://kawalpemilu.org#40006,"GEBANGANOM WETAN, KANGKUNG, KENDAL, JAWA TENGAH",4,164,16,180
https://kawalpemilu.org#36628,"KASIHAN, NGADIROJO, WONOGIRI, JAWA TENGAH",13,128,11,139
https://kawalpemilu.org#41139,"SURADADI, SURADADI, TEGAL, JAWA TENGAH",11,144,31,175
https://kawalpemilu.org#37740,"KUNDURAN, KUNDURAN, BLORA, JAWA TENGAH",9,183,49,232
https://kawalpemilu.org#36476,"GAMBIRMANIS, PRACIMANTORO, WONOGIRI, JAWA TENGAH",19,206,14,220
https://kawalpemilu.org#40786,"PESUCEN, PETARUKAN, PEMALANG, JAWA TENGAH",6,132,43,175
https://kawalpemilu.org#37494,"TEGOWANU WETAN, TEGOWANU, GROBOGAN, JAWA TENGAH",5,210,29,239
https://kawalpemilu.org#35471,"PANDEAN, NGABLAK, MAGELANG, JAWA TENGAH",7,182,15,197
https://kawalpemilu.org#37397,"DANYANG, PURWODADI, GROBOGAN, JAWA TENGAH",10,151,53,204
https://kawalpemilu.org#33201,"PAGERAJI, CILONGOK, BANYUMAS, JAWA TENGAH",18,183,18,201
https://kawalpemilu.org#40208,"KALIMANGGIS, SUBAH, BATANG, JAWA TENGAH",1,189,27,216
https://kawalpemilu.org#37436,"WERDOYO, GODONG, GROBOGAN, JAWA TENGAH",5,163,45,208
https://kawalpemilu.org#32843,"CIDADAP, KARANGPUCUNG, CILACAP, JAWA TENGAH",11,49,9,58
https://kawalpemilu.org#36643,"TEMPURSARI, SIDOHARJO, WONOGIRI, JAWA TENGAH",13,155,15,170
https://kawalpemilu.org#35002,"KRASAK, SELOMERTO, WONOSOBO, JAWA TENGAH",7,188,23,211
https://kawalpemilu.org#35413,"TONOBOYO, BANDONGAN, MAGELANG, JAWA TENGAH",9,111,52,163
https://kawalpemilu.org#41308,"WANASARI, WANASARI, BREBES, JAWA TENGAH",14,139,41,180
https://kawalpemilu.org#38441,"BUMIAYU, WEDARIJAKSA, PATI, JAWA TENGAH",4,183,20,203
https://kawalpemilu.org#41716,"NONGKOSAWIT, GUNUNGPATI, KOTA SEMARANG, JAWA TENGAH",4,180,71,251
https://kawalpemilu.org#38478,"TUNJUNGREJO, MARGOYOSO, PATI, JAWA TENGAH",11,164,116,180
https://kawalpemilu.org#35529,"GIRIREJO, TEGALREJO, MAGELANG, JAWA TENGAH",3,145,71,216
https://kawalpemilu.org#37392,"LEBAK, GROBOGAN, GROBOGAN, JAWA TENGAH",16,150,33,183
https://kawalpemilu.org#41546,"NUSUKAN, BANJARSARI, KOTA SURAKARTA, JAWA TENGAH",50,119,35,154
https://kawalpemilu.org#39514,"TLOGOWUNGU, KALORAN, TEMANGGUNG, JAWA TENGAH",7,180,8,188
https://kawalpemilu.org#40625,"MANDIRAJA, MOGA, PEMALANG, JAWA TENGAH",12,123,45,168
https://kawalpemilu.org#39679,"BANSARI, BANSARI, TEMANGGUNG, JAWA TENGAH",10,198,10,208
https://kawalpemilu.org#33026,"BANJARPARAKAN, RAWALO, BANYUMAS, JAWA TENGAH",14,155,28,183
https://kawalpemilu.org#37682,"TUNJUNGAN, TUNJUNGAN, BLORA, JAWA TENGAH",8,183,36,219
https://kawalpemilu.org#40793,"LONING, PETARUKAN, PEMALANG, JAWA TENGAH",5,179,25,204
https://kawalpemilu.org#40850,"MOJO, ULUJAMI, PEMALANG, JAWA TENGAH",22,157,7,164
https://kawalpemilu.org#33619,"KARANGJATI, SUSUKAN, BANJARNEGARA, JAWA TENGAH",6,132,53,185
https://kawalpemilu.org#40749,"WANAMULYA, PEMALANG, PEMALANG, JAWA TENGAH",11,94,65,159
https://kawalpemilu.org#35834,"KARANGJATI, WONOSEGORO, BOYOLALI, JAWA TENGAH",16,185,17,202
https://kawalpemilu.org#37282,"TAMBIREJO, TOROH, GROBOGAN, JAWA TENGAH",17,163,44,207
https://kawalpemilu.org#36838,"NGADILUWIH, MATESIH, KARANGANYAR, JAWA TENGAH",5,62,154,216
https://kawalpemilu.org#37585,"CABEAN, CEPU, BLORA, JAWA TENGAH",12,169,18,187
https://kawalpemilu.org#33162,"AJIBARANG KULON, AJIBARANG, BANYUMAS, JAWA TENGAH",11,178,44,222
https://kawalpemilu.org#36436,"MENURAN, BAKI, SUKOHARJO, JAWA TENGAH",15,212,60,272
https://kawalpemilu.org#41817,"BANDENGAN, PEKALONGAN UTARA, KOTA PEKALONGAN, JAWA TENGAH",7,159,53,212
https://kawalpemilu.org#40993,"PENER, PANGKAH, TEGAL, JAWA TENGAH",15,131,77,208
https://kawalpemilu.org#41231,"PANDANSARI, PAGUYANGAN, BREBES, JAWA TENGAH",8,169,84,253
https://kawalpemilu.org#36287,"KARANGLO, KLATEN SELATAN, KLATEN, JAWA TENGAH",5,165,9,174
https://kawalpemilu.org#41421,"KAMAL, LARANGAN, BREBES, JAWA TENGAH",20,74,38,112
https://kawalpemilu.org#33651,"PETIR, PURWONEGORO, BANJARNEGARA, JAWA TENGAH",2,88,23,111
https://kawalpemilu.org#33596,"KARANGASEM, KERTANEGARA, PURBALINGGA, JAWA TENGAH",12,154,22,176
https://kawalpemilu.org#41113,"KEMANTRAN, KRAMAT, TEGAL, JAWA TENGAH",5,135,119,254
https://kawalpemilu.org#39025,"KERANGKULON, WONOSALAM, DEMAK, JAWA TENGAH",14,176,26,202
https://kawalpemilu.org#41843,"PANGGUNG, TEGAL TIMUR, KOTA TEGAL, JAWA TENGAH",5,129,108,237
https://kawalpemilu.org#87512,"MULYADADI, CIPARI, CILACAP, JAWA TENGAH",1,134,54,188
https://kawalpemilu.org#41304,"SISALAM, WANASARI, BREBES, JAWA TENGAH",5,137,62,199
https://kawalpemilu.org#40869,"KARANGDAWA, MARGASARI, TEGAL, JAWA TENGAH",23,119,42,161
https://kawalpemilu.org#32830,"KERTAJAYA, GANDRUNGMANGU, CILACAP, JAWA TENGAH",16,120,26,146
https://kawalpemilu.org#40771,"KABUNAN, TAMAN, PEMALANG, JAWA TENGAH",6,112,39,151
https://kawalpemilu.org#37202,"GALEH, TANGEN, SRAGEN, JAWA TENGAH",7,159,20,179
https://kawalpemilu.org#41810,"KRAPYAK, PEKALONGAN UTARA, KOTA PEKALONGAN, JAWA TENGAH",12,149,75,224
https://kawalpemilu.org#37566,"WADO, KEDUNGTUBAN, BLORA, JAWA TENGAH",4,191,22,213
https://kawalpemilu.org#37304,"JATIHARJO, PULOKULON, GROBOGAN, JAWA TENGAH",12,178,37,215
https://kawalpemilu.org#33316,"TELUK, PURWOKERTO SELATAN, BANYUMAS, JAWA TENGAH",18,175,55,230
https://kawalpemilu.org#37163,"MOJOPURO, SUMBERLAWANG, SRAGEN, JAWA TENGAH",6,79,36,115
https://kawalpemilu.org#36362,"KEPUH, NGUTER, SUKOHARJO, JAWA TENGAH",14,70,17,87
https://kawalpemilu.org#36784,"GIRIHARJO, PUHPELEM, WONOGIRI, JAWA TENGAH",7,126,37,163
https://kawalpemilu.org#41730,"MANYARAN, SEMARANG BARAT, KOTA SEMARANG, JAWA TENGAH",10,210,43,253
https://kawalpemilu.org#36607,"JATEN, SELOGIRI, WONOGIRI, JAWA TENGAH",17,156,33,189
https://kawalpemilu.org#39755,"JURANGAGUNG, PLANTUNGAN, KENDAL, JAWA TENGAH",7,79,12,91
https://kawalpemilu.org#36883,"JANTIHARJO, KARANGANYAR, KARANGANYAR, JAWA TENGAH",7,180,14,194
https://kawalpemilu.org#33558,"BUMISARI, BOJONGSARI, PURBALINGGA, JAWA TENGAH",16,162,62,224
https://kawalpemilu.org#37193,"BLANGU, GESI, SRAGEN, JAWA TENGAH",1,163,22,185
https://kawalpemilu.org#38276,"KUNIRAN, BATANGAN, PATI, JAWA TENGAH",10,171,20,191
https://kawalpemilu.org#33448,"MUNJUL, KUTASARI, PURBALINGGA, JAWA TENGAH",11,142,47,189
https://kawalpemilu.org#38579,"KALIWUNGU, KALIWUNGU, KUDUS, JAWA TENGAH",25,159,24,183
https://kawalpemilu.org#37325,"KALISARI, KRADENAN, GROBOGAN, JAWA TENGAH",8,163,21,184
https://kawalpemilu.org#91445,"SIDANEGARA, CILACAP TENGAH, CILACAP, JAWA TENGAH",4,90,56,146
https://kawalpemilu.org#32861,"CIMANGGU, CIMANGGU, CILACAP, JAWA TENGAH",12,32,59,91
https://kawalpemilu.org#37618,"JEPON, JEPON, BLORA, JAWA TENGAH",9,146,19,165
https://kawalpemilu.org#37103,"BENTAK, SIDOHARJO, SRAGEN, JAWA TENGAH",6,140,43,183
https://kawalpemilu.org#34707,"KALIWATUKRANGGAN, BUTUH, PURWOREJO, JAWA TENGAH",3,101,26,127
https://kawalpemilu.org#41652,"GEMAH, PEDURUNGAN, KOTA SEMARANG, JAWA TENGAH",43,216,22,238
https://kawalpemilu.org#37443,"TUNGU, GODONG, GROBOGAN, JAWA TENGAH",6,140,32,172
https://kawalpemilu.org#36049,"CETAN, CEPER, KLATEN, JAWA TENGAH",3,95,65,160
https://kawalpemilu.org#37442,"LATAK, GODONG, GROBOGAN, JAWA TENGAH",8,153,34,187
https://kawalpemilu.org#34584,"WONOTULUS, PURWOREJO, PURWOREJO, JAWA TENGAH",1,68,45,113
https://kawalpemilu.org#41261,"PURWODADI, TONJONG, BREBES, JAWA TENGAH",11,48,81,129
https://kawalpemilu.org#33340,"SUMAMPIR, PURWOKERTO UTARA, BANYUMAS, JAWA TENGAH",14,121,75,196
https://kawalpemilu.org#39875,"SIDOREJO, BRANGSONG, KENDAL, JAWA TENGAH",1,184,14,198
https://kawalpemilu.org#36132,"BANARAN, DELANGGU, KLATEN, JAWA TENGAH",6,118,17,135
https://kawalpemilu.org#36827,"KEBAK, JUMANTONO, KARANGANYAR, JAWA TENGAH",5,143,20,163
https://kawalpemilu.org#91440,"CILACAP, CILACAP SELATAN, CILACAP, JAWA TENGAH",32,151,33,184
https://kawalpemilu.org#37250,"SEDADI, PENAWANGAN, GROBOGAN, JAWA TENGAH",1,146,7,153
https://kawalpemilu.org#36891,"DELINGAN, KARANGANYAR, KARANGANYAR, JAWA TENGAH",18,186,19,205
https://kawalpemilu.org#38925,"BATURSARI, MRANGGEN, DEMAK, JAWA TENGAH",19,123,49,172
https://kawalpemilu.org#84916,"JAMBUSARI, JERUKLEGI, CILACAP, JAWA TENGAH",9,151,51,202
https://kawalpemilu.org#33158,"PANCURENDANG, AJIBARANG, BANYUMAS, JAWA TENGAH",10,171,70,241
https://kawalpemilu.org#37701,"SENDANGWUNGU, BANJAREJO, BLORA, JAWA TENGAH",5,134,56,190
https://kawalpemilu.org#33206,"PERNASIDI, CILONGOK, BANYUMAS, JAWA TENGAH",7,132,65,197
https://kawalpemilu.org#38950,"PUNDENARUM, KARANGAWEN, DEMAK, JAWA TENGAH",1,197,15,212
https://kawalpemilu.org#35390,"NGAWONGGO, KALIANGKRIK, MAGELANG, JAWA TENGAH",14,186,27,213
https://kawalpemilu.org#36510,"SEJATI, GIRIWOYO, WONOGIRI, JAWA TENGAH",9,127,24,151
https://kawalpemilu.org#36756,"WALENG, GIRIMARTO, WONOGIRI, JAWA TENGAH",7,156,16,172
https://kawalpemilu.org#33027,"RAWALO, RAWALO, BANYUMAS, JAWA TENGAH",15,192,37,229
https://kawalpemilu.org#35812,"PAKANG, ANDONG, BOYOLALI, JAWA TENGAH",6,233,10,243
https://kawalpemilu.org#36005,"BARUKAN, MANISRENGGO, KLATEN, JAWA TENGAH",11,131,28,159
https://kawalpemilu.org#37521,"JATI, JATI, BLORA, JAWA TENGAH",14,161,52,213
https://kawalpemilu.org#33641,"KERTAYASA, MANDIRAJA, BANJARNEGARA, JAWA TENGAH",16,132,68,200
https://kawalpemilu.org#35287,"BANYUROTO, SAWANGAN, MAGELANG, JAWA TENGAH",12,194,19,213
https://kawalpemilu.org#41556,"SUMBER, BANJARSARI, KOTA SURAKARTA, JAWA TENGAH",1,206,39,245
https://kawalpemilu.org#36196,"SUDIMORO, TULUNG, KLATEN, JAWA TENGAH",9,178,52,230
https://kawalpemilu.org#38098,"SUMURTAWANG, KRAGAN, REMBANG, JAWA TENGAH",10,138,34,172
https://kawalpemilu.org#35341,"MERTOYUDAN, MERTOYUDAN, MAGELANG, JAWA TENGAH",33,83,110,193
https://kawalpemilu.org#33778,"TRIBUANA, PUNGGELAN, BANJARNEGARA, JAWA TENGAH",5,139,67,206
https://kawalpemilu.org#33413,"SIDAREJA, KALIGONDANG, PURBALINGGA, JAWA TENGAH",7,143,28,171
https://kawalpemilu.org#38648,"MEJOBO, MEJOBO, KUDUS, JAWA TENGAH",29,142,44,186
https://kawalpemilu.org#34350,"BONJOK LOR, BONOROWO, KEBUMEN, JAWA TENGAH",7,109,54,163
https://kawalpemilu.org#41853,"DEBONG TENGAH, TEGAL SELATAN, KOTA TEGAL, JAWA TENGAH",28,130,107,237
https://kawalpemilu.org#38712,"SOWAN LOR, KEDUNG, JEPARA, JAWA TENGAH",22,183,39,222
https://kawalpemilu.org#38164,"ROGOMULYO, KAYEN, PATI, JAWA TENGAH",4,157,15,172
https://kawalpemilu.org#36052,"KLEPU, CEPER, KLATEN, JAWA TENGAH",11,153,47,200
https://kawalpemilu.org#32721,"KALIKUDI, ADIPALA, CILACAP, JAWA TENGAH",4,149,33,182
https://kawalpemilu.org#40907,"KAJENENGAN, BOJONG, TEGAL, JAWA TENGAH",9,69,57,126
https://kawalpemilu.org#41268,"JANEGARA, JATIBARANG, BREBES, JAWA TENGAH",2,124,55,179
https://kawalpemilu.org#37522,"SINGGET, JATI, BLORA, JAWA TENGAH",4,183,4,187
https://kawalpemilu.org#37296,"GEYER, GEYER, GROBOGAN, JAWA TENGAH",6,150,20,170
https://kawalpemilu.org#39920,"NAWANGSARI, WELERI, KENDAL, JAWA TENGAH",5,140,53,193
https://kawalpemilu.org#41139,"SURADADI, SURADADI, TEGAL, JAWA TENGAH",18,162,41,203
https://kawalpemilu.org#41109,"DAMPYAK, KRAMAT, TEGAL, JAWA TENGAH",13,177,55,232
https://kawalpemilu.org#36873,"KARANG, KARANGPANDAN, KARANGANYAR, JAWA TENGAH",13,129,54,183
https://kawalpemilu.org#36540,"KEDUNGREJO, NGUNTORONADI, WONOGIRI, JAWA TENGAH",6,134,24,158
https://kawalpemilu.org#40511,"ROWOKEMBU, WONOPRINGGO, PEKALONGAN, JAWA TENGAH",6,193,15,208
https://kawalpemilu.org#34565,"TAMBAKREJO, PURWOREJO, PURWOREJO, JAWA TENGAH",15,94,55,149
https://kawalpemilu.org#37065,"KARANGANYAR, SAMBUNGMACAN, SRAGEN, JAWA TENGAH",6,127,62,189
https://kawalpemilu.org#36426,"CEMANI, GROGOL, SUKOHARJO, JAWA TENGAH",2,232,34,266
https://kawalpemilu.org#47472,"WAUNG, BARON, NGANJUK, JAWA TIMUR",6,128,25,153
https://kawalpemilu.org#45879,"SUMBERKARE, WONOMERTO, PROBOLINGGO, JAWA TIMUR",1,0,0,0
https://kawalpemilu.org#43594,"PAGERWOJO, KESAMBEN, BLITAR, JAWA TIMUR",23,155,32,187
https://kawalpemilu.org#43830,"PAPAR, PAPAR, KEDIRI, JAWA TIMUR",9,79,41,120
https://kawalpemilu.org#44148,"JATIGUWI, SUMBERPUCUNG, MALANG, JAWA TIMUR",6,68,79,147
https://kawalpemilu.org#44146,"SAMBIGEDE, SUMBERPUCUNG, MALANG, JAWA TIMUR",8,114,21,135
https://kawalpemilu.org#43057,"KAMULAN, DURENAN, TRENGGALEK, JAWA TIMUR",10,146,47,193
https://kawalpemilu.org#44501,"SUMBERANYAR, ROWOKANGKUNG, LUMAJANG, JAWA TIMUR",10,111,78,189
https://kawalpemilu.org#46599,"CANGKRINGSARI, SUKODONO, SIDOARJO, JAWA TIMUR",2,162,69,231
https://kawalpemilu.org#43232,"SELOREJO, NGUNUT, TULUNGAGUNG, JAWA TIMUR",7,155,20,175
https://kawalpemilu.org#46451,"SIDOKARE, SIDOARJO, SIDOARJO, JAWA TIMUR",25,127,64,191
https://kawalpemilu.org#47843,"KAJANG, SAWAHAN, MADIUN, JAWA TIMUR",5,42,46,88
https://kawalpemilu.org#50661,"BLUMBUNGAN, LARANGAN, PAMEKASAN, JAWA TIMUR",13,42,117,159
https://kawalpemilu.org#43626,"TEGALREJO, SELOPURO, BLITAR, JAWA TIMUR",16,143,15,158
https://kawalpemilu.org#45024,"CANTUK, SINGOJURUH, BANYUWANGI, JAWA TIMUR",4,88,102,190
https://kawalpemilu.org#49023,"KAPU, MERAKURAK, TUBAN, JAWA TIMUR",10,103,67,170
https://kawalpemilu.org#47301,"JANTI, JOGOROTO, JOMBANG, JAWA TIMUR",9,140,49,189
https://kawalpemilu.org#51409,"PUCANG SEWU, GUBENG, KOTA SURABAYA, JAWA TIMUR",18,162,42,204
https://kawalpemilu.org#44662,"YOSORATI, SUMBERBARU, JEMBER, JAWA TIMUR",39,50,110,160
https://kawalpemilu.org#43323,"SEBALOR, BANDUNG, TULUNGAGUNG, JAWA TIMUR",1,156,19,175
https://kawalpemilu.org#48866,"SEMBUNGIN, BANCAR, TUBAN, JAWA TIMUR",1,159,49,208
https://kawalpemilu.org#45607,"TIGASAN KULON, LECES, PROBOLINGGO, JAWA TIMUR",8,148,63,211
https://kawalpemilu.org#50544,"LARANGAN TOKOL, TLANAKAN, PAMEKASAN, JAWA TIMUR",20,62,125,187
https://kawalpemilu.org#46031,"MARTOPURO, PURWOSARI, PASURUAN, JAWA TIMUR",10,129,83,212
https://kawalpemilu.org#46670,"WADUNGASRI, WARU, SIDOARJO, JAWA TIMUR",17,201,80,281
https://kawalpemilu.org#44057,"TAMANASRI, AMPELGADING, MALANG, JAWA TIMUR",13,121,34,155
https://kawalpemilu.org#46273,"BRANANG, LEKOK, PASURUAN, JAWA TIMUR",5,165,65,230
https://kawalpemilu.org#50272,"PANJALINAN, BLEGA, BANGKALAN, JAWA TIMUR",4,39,114,153
https://kawalpemilu.org#44535,"PANDANSARI, SENDURO, LUMAJANG, JAWA TIMUR",2,98,56,154
https://kawalpemilu.org#42787,"TULUNG, SAMPUNG, PONOROGO, JAWA TIMUR",12,146,19,165
https://kawalpemilu.org#46038,"KAYOMAN, PURWOSARI, PASURUAN, JAWA TIMUR",2,154,94,248
https://kawalpemilu.org#51562,"TULUNGREJO, BUMIAJI, KOTA BATU, JAWA TIMUR",31,93,49,142
https://kawalpemilu.org#44035,"HARJOKUNCARAN, SUMBERMANJING WETAN, MALANG, JAWA TIMUR",25,81,64,145
https://kawalpemilu.org#43937,"BANYAKAN, BANYAKAN, KEDIRI, JAWA TIMUR",10,128,69,197
https://kawalpemilu.org#50097,"KARANG PAO, AROSBAYA, BANGKALAN, JAWA TIMUR",1,109,104,213
https://kawalpemilu.org#51301,"BUGUL KIDUL, BUGUL KIDUL, KOTA PASURUAN, JAWA TIMUR",7,118,89,207
https://kawalpemilu.org#50594,"KOWEL, PAMEKASAN, PAMEKASAN, JAWA TIMUR",22,35,122,157
https://kawalpemilu.org#48073,"BAYEM WETAN, KARTOHARJO, MAGETAN, JAWA TIMUR",6,190,41,231
https://kawalpemilu.org#50709,"BATU BINTANG, BATUMARMAR, PAMEKASAN, JAWA TIMUR",30,7,214,221
https://kawalpemilu.org#43773,"SUMBERCANGKRING, GURAH, KEDIRI, JAWA TIMUR",10,124,68,192
https://kawalpemilu.org#43196,"KIPING, GONDANG, TULUNGAGUNG, JAWA TIMUR",5,146,29,175
https://kawalpemilu.org#46692,"KUMITIR, JATIREJO, MOJOKERTO, JAWA TIMUR",2,171,44,215
https://kawalpemilu.org#51555,"TEMAS, BATU, KOTA BATU, JAWA TIMUR",39,90,49,139
https://kawalpemilu.org#48997,"SOCOREJO, JENU, TUBAN, JAWA TIMUR",6,132,95,227
https://kawalpemilu.org#48254,"JEBLOGAN, PARON, NGAWI, JAWA TIMUR",1,180,58,238
https://kawalpemilu.org#44953,"WRINGINPITU, TEGALDLIMO, BANYUWANGI, JAWA TIMUR",2,158,21,179
https://kawalpemilu.org#49334,"SIDOKUMPUL, SAMBENG, LAMONGAN, JAWA TIMUR",8,154,58,212
https://kawalpemilu.org#44857,"SUGERKIDUL, JELBUK, JEMBER, JAWA TIMUR",4,82,92,174
https://kawalpemilu.org#42870,"WAGIR LOR, NGEBEL, PONOROGO, JAWA TIMUR",10,139,14,153
https://kawalpemilu.org#46859,"TINGGARBUNTUT, BANGSAL, MOJOKERTO, JAWA TIMUR",6,145,56,201
https://kawalpemilu.org#46079,"PETUNGASRI, PANDAAN, PASURUAN, JAWA TIMUR",18,153,42,195
https://kawalpemilu.org#46318,"BANJARWUNGU, TARIK, SIDOARJO, JAWA TIMUR",7,177,64,241
https://kawalpemilu.org#47052,"PAKEL, BARENG, JOMBANG, JAWA TIMUR",8,143,25,168
https://kawalpemilu.org#44413,"PAGELARAN, PAGELARAN, MALANG, JAWA TIMUR",14,114,85,199
https://kawalpemilu.org#47487,"GETAS, TANJUNGANOM, NGANJUK, JAWA TIMUR",3,134,19,153
https://kawalpemilu.org#48406,"BARENG, NGASEM, BOJONEGORO, JAWA TIMUR",16,107,33,140
https://kawalpemilu.org#51177,"PANDANWANGI, BLIMBING, KOTA MALANG, JAWA TIMUR",65,189,67,256
https://kawalpemilu.org#44045,"SRIMULYO, DAMPIT, MALANG, JAWA TIMUR",10,176,48,224
https://kawalpemilu.org#45103,"BANGSRING, WONGSOREJO, BANYUWANGI, JAWA TIMUR",5,74,22,96
https://kawalpemilu.org#47440,"KLURAHAN, NGRONGGOT, NGANJUK, JAWA TIMUR",23,180,31,211
https://kawalpemilu.org#43593,"JUGO, KESAMBEN, BLITAR, JAWA TIMUR",7,175,30,205
https://kawalpemilu.org#44060,"SIDORENGGO, AMPELGADING, MALANG, JAWA TIMUR",6,78,40,118
https://kawalpemilu.org#47199,"POJOKREJO, KESAMBEN, JOMBANG, JAWA TIMUR",8,142,32,174
https://kawalpemilu.org#51556,"PESANGGRAHAN, BATU, KOTA BATU, JAWA TIMUR",40,85,59,144
https://kawalpemilu.org#50021,"PEKALONGAN, TAMBAK, GRESIK, JAWA TIMUR",1,53,90,143
https://kawalpemilu.org#44684,"TANJUNGSARI, UMBULSARI, JEMBER, JAWA TIMUR",16,114,81,195
https://kawalpemilu.org#51525,"SIMOMULYO, SUKOMANUNGGAL, KOTA SURABAYA, JAWA TIMUR",61,172,40,212
https://kawalpemilu.org#48334,"WIDODAREN, GERIH, NGAWI, JAWA TIMUR",9,118,43,161
https://kawalpemilu.org#50942,"BASOKA, RUBARU, SUMENEP, JAWA TIMUR",11,18,152,170
https://kawalpemilu.org#45016,"KEBONREJO, KALIBARU, BANYUWANGI, JAWA TIMUR",6,116,106,222
https://kawalpemilu.org#44240,"MANGLIAWAN, PAKIS, MALANG, JAWA TIMUR",18,155,59,214
https://kawalpemilu.org#50117,"BULUKAGUNG, KLAMPIS, BANGKALAN, JAWA TIMUR",1,39,167,206
https://kawalpemilu.org#43015,"GANDUSARI, GANDUSARI, TRENGGALEK, JAWA TIMUR",17,192,38,230
https://kawalpemilu.org#51467,"BULAK BANTENG, KENJERAN, KOTA SURABAYA, JAWA TIMUR",14,123,70,196
https://kawalpemilu.org#42949,"PRINGAPUS, DONGKO, TRENGGALEK, JAWA TIMUR",10,178,13,191
https://kawalpemilu.org#44120,"GONDANGLEGI KULON, GONDANGLEGI, MALANG, JAWA TIMUR",19,120,72,192
https://kawalpemilu.org#51386,"DR. SOETOMO, TEGALSARI, KOTA SURABAYA, JAWA TIMUR",44,151,14,165
https://kawalpemilu.org#44212,"BENJOR, TUMPANG, MALANG, JAWA TIMUR",4,146,69,215
https://kawalpemilu.org#51471,"JERUK, LAKARSANTRI, KOTA SURABAYA, JAWA TIMUR",1,142,82,224
https://kawalpemilu.org#50476,"BANYUATES, BANYUATES, SAMPANG, JAWA TIMUR",5,32,190,222
https://kawalpemilu.org#44807,"KALIWATES, KALIWATES, JEMBER, JAWA TIMUR",18,105,55,160
https://kawalpemilu.org#45504,"KEDUNGDOWO, ARJASA, SITUBONDO, JAWA TIMUR",6,29,178,207
https://kawalpemilu.org#48247,"KEDUNG PUTRI, PARON, NGAWI, JAWA TIMUR",25,134,12,146
https://kawalpemilu.org#44758,"KALIWINING, RAMBIPUJI, JEMBER, JAWA TIMUR",49,126,92,218
https://kawalpemilu.org#44414,"BANJAREJO, PAGELARAN, MALANG, JAWA TIMUR",14,94,81,175
https://kawalpemilu.org#44037,"RINGINSARI, SUMBERMANJING WETAN, MALANG, JAWA TIMUR",8,111,12,123
https://kawalpemilu.org#46439,"KEDUNGKENDO, CANDI, SIDOARJO, JAWA TIMUR",3,170,61,231
https://kawalpemilu.org#44672,"MENAMPU, GUMUKMAS, JEMBER, JAWA TIMUR",35,116,23,139
https://kawalpemilu.org#45636,"TIRIS, TIRIS, PROBOLINGGO, JAWA TIMUR",1,130,106,236
https://kawalpemilu.org#49047,"BANJARARUM, RENGEL, TUBAN, JAWA TIMUR",7,150,37,187
https://kawalpemilu.org#51381,"NGAGEL REJO, WONOKROMO, KOTA SURABAYA, JAWA TIMUR",93,127,36,163
https://kawalpemilu.org#47867,"PARANG, PARANG, MAGETAN, JAWA TIMUR",5,119,67,186
https://kawalpemilu.org#50949,"BATANGBATANG LAOK, BATANG BATANG, SUMENEP, JAWA TIMUR",2,124,27,151
https://kawalpemilu.org#49930,"KEPATIHAN, MENGANTI, GRESIK, JAWA TIMUR",2,162,75,237
https://kawalpemilu.org#43491,"SAWENTAR, KANIGORO, BLITAR, JAWA TIMUR",21,130,23,153
https://kawalpemilu.org#51285,"PURUTREJO, PURWOREJO, KOTA PASURUAN, JAWA TIMUR",23,108,58,166
https://kawalpemilu.org#51499,"KARAH, JAMBANGAN, KOTA SURABAYA, JAWA TIMUR",36,91,148,239
https://kawalpemilu.org#43366,"WONODADI, WONODADI, BLITAR, JAWA TIMUR",12,127,27,154
https://kawalpemilu.org#43694,"REMBANGKEPUH, NGADILUWIH, KEDIRI, JAWA TIMUR",3,104,70,174
https://kawalpemilu.org#51100,"POJOK, MOJOROTO, KOTA KEDIRI, JAWA TIMUR",26,104,51,155
https://kawalpemilu.org#45016,"KEBONREJO, KALIBARU, BANYUWANGI, JAWA TIMUR",9,168,54,222
https://kawalpemilu.org#50621,"BANYUBULU, PROPPO, PAMEKASAN, JAWA TIMUR",5,82,164,246
https://kawalpemilu.org#51204,"MADYOPURO, KEDUNGKANDANG, KOTA MALANG, JAWA TIMUR",57,104,75,179
https://kawalpemilu.org#44975,"TAMANAGUNG, CLURING, BANYUWANGI, JAWA TIMUR",3,117,69,186
https://kawalpemilu.org#51039,"BRAKAS, RA'AS, SUMENEP, JAWA TIMUR",10,30,70,100
https://kawalpemilu.org#46125,"BEJI, BEJI, PASURUAN, JAWA TIMUR",13,82,126,208
https://kawalpemilu.org#48553,"BUNGUR, KANOR, BOJONEGORO, JAWA TIMUR",10,105,51,156
https://kawalpemilu.org#44762,"RAMBIGUNDAM, RAMBIPUJI, JEMBER, JAWA TIMUR",4,98,74,172
https://kawalpemilu.org#51305,"MANDARANREJO, PANGGUNGREJO, KOTA PASURUAN, JAWA TIMUR",2,97,92,189
https://kawalpemilu.org#51217,"KARANG BESUKI, SUKUN, KOTA MALANG, JAWA TIMUR",41,161,73,234
https://kawalpemilu.org#44715,"GRENDEN, PUGER, JEMBER, JAWA TIMUR",20,143,33,176
https://kawalpemilu.org#43307,"GAMPING, CAMPURDARAT, TULUNGAGUNG, JAWA TIMUR",5,164,21,185
https://kawalpemilu.org#51164,"PLOSOKEREP, SANANWETAN, KOTA BLITAR, JAWA TIMUR",7,163,75,238
https://kawalpemilu.org#42885,"BLEMBEM, JAMBON, PONOROGO, JAWA TIMUR",14,136,62,198
https://kawalpemilu.org#49311,"BULUTENGGER, SEKARAN, LAMONGAN, JAWA TIMUR",10,133,30,163
https://kawalpemilu.org#51212,"BANDUNGREJOSARI, SUKUN, KOTA MALANG, JAWA TIMUR",44,163,62,225
https://kawalpemilu.org#51515,"MANYAR SABRANGAN, MULYOREJO, KOTA SURABAYA, JAWA TIMUR",53,136,60,196
https://kawalpemilu.org#46667,"TAMBAKREJO, WARU, SIDOARJO, JAWA TIMUR",8,113,73,186
https://kawalpemilu.org#44219,"SUKOPURO, JABUNG, MALANG, JAWA TIMUR",6,150,29,179
https://kawalpemilu.org#50507,"KARANG ANYAR, KETAPANG, SAMPANG, JAWA TIMUR",4,5,261,266
https://kawalpemilu.org#44500,"DAWUHAN WETAN, ROWOKANGKUNG, LUMAJANG, JAWA TIMUR",3,132,67,199
https://kawalpemilu.org#45308,"TANGGULANGIN, TEGALAMPEL, BONDOWOSO, JAWA TIMUR",3,94,82,176
https://kawalpemilu.org#50503,"PAOPALELAOK, KETAPANG, SAMPANG, JAWA TIMUR",17,81,99,180
https://kawalpemilu.org#45792,"SELOGUDIG WETAN, PAJARAKAN, PROBOLINGGO, JAWA TIMUR",1,133,64,197
https://kawalpemilu.org#51380,"NGAGEL, WONOKROMO, KOTA SURABAYA, JAWA TIMUR",14,114,60,174
https://kawalpemilu.org#46423,"GANGGANGPANJANG, TANGGULANGIN, SIDOARJO, JAWA TIMUR",8,209,50,259
https://kawalpemilu.org#45447,"KENDIT, KENDIT, SITUBONDO, JAWA TIMUR",19,98,93,191
https://kawalpemilu.org#44757,"ROWOTAMTU, RAMBIPUJI, JEMBER, JAWA TIMUR",6,111,116,227
https://kawalpemilu.org#45173,"SUMBER PAKEM, MAESAN, BONDOWOSO, JAWA TIMUR",9,52,65,117
https://kawalpemilu.org#45366,"KALISAT, SEMPOL, BONDOWOSO, JAWA TIMUR",4,119,80,199
https://kawalpemilu.org#49472,"KALANGANYAR, KARANGGENENG, LAMONGAN, JAWA TIMUR",7,136,39,175
https://kawalpemilu.org#47922,"KARANGREJO, KAWEDANAN, MAGETAN, JAWA TIMUR",8,167,43,210
https://kawalpemilu.org#42495,"SEMPU, NAWANGAN, PACITAN, JAWA TIMUR",3,125,59,184
https://kawalpemilu.org#43711,"NGRECO, KANDAT, KEDIRI, JAWA TIMUR",1,151,70,221
https://kawalpemilu.org#43702,"KARANGREJO, KANDAT, KEDIRI, JAWA TIMUR",1,190,32,222
https://kawalpemilu.org#48401,"NGANTRU, NGASEM, BOJONEGORO, JAWA TIMUR",6,121,47,168
https://kawalpemilu.org#46453,"SEKARDANGAN, SIDOARJO, SIDOARJO, JAWA TIMUR",2,103,80,183
https://kawalpemilu.org#44997,"KEMBIRITAN, GENTENG, BANYUWANGI, JAWA TIMUR",46,158,39,197
https://kawalpemilu.org#42596,"SENDANG, NGRAYUN, PONOROGO, JAWA TIMUR",1,167,49,216
https://kawalpemilu.org#89596,"GEDANGSEWU, PARE, KEDIRI, JAWA TIMUR",29,146,36,182
https://kawalpemilu.org#51062,"KALINGANYAR, ARJASA, SUMENEP, JAWA TIMUR",5,96,118,214
https://kawalpemilu.org#50641,"KACOK, PALENGAAN, PAMEKASAN, JAWA TIMUR",9,58,228,286
https://kawalpemilu.org#43926,"KAPAS, KUNJANG, KEDIRI, JAWA TIMUR",1,121,32,153
https://kawalpemilu.org#46608,"MASANGANKULON, SUKODONO, SIDOARJO, JAWA TIMUR",17,133,47,180
https://kawalpemilu.org#47207,"MOJOKRAPAK, TEMBELANG, JOMBANG, JAWA TIMUR",9,135,36,171
https://kawalpemilu.org#47143,"TUNGGORONO, JOMBANG, JOMBANG, JAWA TIMUR",8,138,33,171
https://kawalpemilu.org#45171,"GAMBANGAN, MAESAN, BONDOWOSO, JAWA TIMUR",8,96,72,168
https://kawalpemilu.org#50657,"PASANGGAR, PEGANTENAN, PAMEKASAN, JAWA TIMUR",46,1,158,159
https://kawalpemilu.org#44613,"SUMBERWRINGIN, KLAKAH, LUMAJANG, JAWA TIMUR",6,72,114,186
https://kawalpemilu.org#45223,"WONOSARI, GRUJUGAN, BONDOWOSO, JAWA TIMUR",12,41,138,179
https://kawalpemilu.org#50746,"PARSANGA, KOTA SUMENEP, SUMENEP, JAWA TIMUR",6,47,153,200
https://kawalpemilu.org#47823,"BULU, PILANGKENCENG, MADIUN, JAWA TIMUR",9,86,64,150
https://kawalpemilu.org#44908,"PACE, SILO, JEMBER, JAWA TIMUR",24,181,10,191
https://kawalpemilu.org#46176,"CURAH DUKUH, KRATON, PASURUAN, JAWA TIMUR",9,110,64,174
https://kawalpemilu.org#44869,"PATEMPURAN, KALISAT, JEMBER, JAWA TIMUR",3,135,43,178
https://kawalpemilu.org#43389,"DANDONG, SRENGAT, BLITAR, JAWA TIMUR",5,118,59,177
https://kawalpemilu.org#47791,"KALIGUNTING, MEJAYAN, MADIUN, JAWA TIMUR",5,115,23,138
https://kawalpemilu.org#51200,"BURING, KEDUNGKANDANG, KOTA MALANG, JAWA TIMUR",13,172,84,256
https://kawalpemilu.org#51479,"SEMEMI, BENOWO, KOTA SURABAYA, JAWA TIMUR",15,199,38,237
https://kawalpemilu.org#43141,"BATANGSAREN, KAUMAN, TULUNGAGUNG, JAWA TIMUR",4,145,36,181
https://kawalpemilu.org#58877,"PEMATANG GADUNG, MATAN HILIR SELATAN, KETAPANG, KALIMANTAN BARAT",4,118,85,203
https://kawalpemilu.org#60204,"SIANTAN HULU, PONTIANAK UTARA, KOTA PONTIANAK, KALIMANTAN BARAT",62,125,83,208
https://kawalpemilu.org#60284,"DURIAN, SUNGAI AMBAWANG, KUBU RAYA, KALIMANTAN BARAT",10,130,145,275
https://kawalpemilu.org#58501,"TOHO ILIR, TOHO, MEMPAWAH, KALIMANTAN BARAT",6,120,6,126
https://kawalpemilu.org#58309,"TRI MANDAYAN, TELUK KERAMAT, SAMBAS, KALIMANTAN BARAT",3,109,93,202
https://kawalpemilu.org#58440,"SEMPADIAN, TEKARANG, SAMBAS, KALIMANTAN BARAT",6,108,66,174
https://kawalpemilu.org#59446,"LANJAK DERAS, BATANG LUPAR, KAPUAS HULU, KALIMANTAN BARAT",5,28,0,28
https://kawalpemilu.org#60232,"PASIRAN, SINGKAWANG BARAT, KOTA SINGKAWANG, KALIMANTAN BARAT",33,99,2,101
https://kawalpemilu.org#59729,"TIANG TANJUNG, MEMPAWAH HULU, LANDAK, KALIMANTAN BARAT",1,153,3,156
https://kawalpemilu.org#59810,"KERANJI PAIDANG, SENGAH TEMILA, LANDAK, KALIMANTAN BARAT",17,159,0,159
https://kawalpemilu.org#60249,"SEMELAGI KECIL, SINGKAWANG UTARA, KOTA SINGKAWANG, KALIMANTAN BARAT",11,56,160,216
https://kawalpemilu.org#58424,"SAGU, GALING, SAMBAS, KALIMANTAN BARAT",3,105,62,167
https://kawalpemilu.org#60251,"SEDAU, SINGKAWANG SELATAN, KOTA SINGKAWANG, KALIMANTAN BARAT",89,72,120,192
https://kawalpemilu.org#60206,"SIANTAN HILIR, PONTIANAK UTARA, KOTA PONTIANAK, KALIMANTAN BARAT",45,86,38,124
https://kawalpemilu.org#58341,"SENTEBANG, JAWAI, SAMBAS, KALIMANTAN BARAT",7,92,86,178
https://kawalpemilu.org#59026,"BANING KOTA, SINTANG, SINTANG, KALIMANTAN BARAT",8,86,133,219
https://kawalpemilu.org#60359,"SUNGAI KAKAP, SUNGAI KAKAP, KUBU RAYA, KALIMANTAN BARAT",9,144,78,222
https://kawalpemilu.org#58523,"WAJOK HULU, SIANTAN, MEMPAWAH, KALIMANTAN BARAT",8,39,122,161
https://kawalpemilu.org#58510,"SUNGAI PINYUH, SUNGAI PINYUH, MEMPAWAH, KALIMANTAN BARAT",27,117,65,182
https://kawalpemilu.org#58771,"AIR DEKAKAH, MANIS MATA, KETAPANG, KALIMANTAN BARAT",6,53,49,102
https://kawalpemilu.org#59974,"PAAL, NANGA PINOH, MELAWI, KALIMANTAN BARAT",21,261,18,279
https://kawalpemilu.org#63222,"KASARANGAN, LABUAN AMAS UTARA, HULU SUNGAI TENGAH, KALIMANTAN SELATAN",6,26,84,110
https://kawalpemilu.org#64102,"LOKTABAT UTARA, BANJARBARU UTARA, KOTA BANJARBARU, KALIMANTAN SELATAN",17,77,161,238
https://kawalpemilu.org#63655,"BELIMBING, MURUNG PUDAK, TABALONG, KALIMANTAN SELATAN",7,50,108,158
https://kawalpemilu.org#62409,"MURUNG KERATON, MARTAPURA, BANJAR, KALIMANTAN SELATAN",3,22,97,119
https://kawalpemilu.org#62412,"SEKUMPUL, MARTAPURA, BANJAR, KALIMANTAN SELATAN",39,50,99,149
https://kawalpemilu.org#63247,"SETIAP, PANDAWAN, HULU SUNGAI TENGAH, KALIMANTAN SELATAN",5,28,123,151
https://kawalpemilu.org#62881,"CEMPAKA, TAPIN SELATAN, TAPIN, KALIMANTAN SELATAN",2,18,190,208
https://kawalpemilu.org#62369,"GAMBUT, GAMBUT, BANJAR, KALIMANTAN SELATAN",33,18,76,94
https://kawalpemilu.org#64075,"MAWAR, BANJARMASIN TENGAH, KOTA BANJARMASIN, KALIMANTAN SELATAN",11,96,120,216
https://kawalpemilu.org#62092,"SUNGAI BAKAR, BAJUIN, TANAH LAUT, KALIMANTAN SELATAN",4,64,129,193
https://kawalpemilu.org#62440,"LIHUNG, KARANG INTAN, BANJAR, KALIMANTAN SELATAN",2,62,180,242
https://kawalpemilu.org#63706,"SOLAN, JARO, TABALONG, KALIMANTAN SELATAN",1,62,22,84
https://kawalpemilu.org#63193,"PAYA BESAR, BATU BENAWA, HULU SUNGAI TENGAH, KALIMANTAN SELATAN",2,20,167,187
https://kawalpemilu.org#62068,"MARTADAH, TAMBANG ULANG, TANAH LAUT, KALIMANTAN SELATAN",2,51,146,197
https://kawalpemilu.org#62025,"BENUA RAYA, BATI BATI, TANAH LAUT, KALIMANTAN SELATAN",1,68,155,223
https://kawalpemilu.org#61994,"PELAIHARI, PELAIHARI, TANAH LAUT, KALIMANTAN SELATAN",29,53,115,168
https://kawalpemilu.org#62202,"SUNGAIKUPANG JAYA, KELUMPANG SELATAN, KOTABARU, KALIMANTAN SELATAN",2,117,136,253
https://kawalpemilu.org#61729,"SARIPOI, TANAH SIANG, MURUNG RAYA, KALIMANTAN TENGAH",4,45,41,86
https://kawalpemilu.org#61932,"PANARUNG, PAHANDUT, KOTA PALANGKARAYA, KALIMANTAN TENGAH",33,90,45,135
https://kawalpemilu.org#60461,"AMIN JAYA, PANGKALAN BANTENG, KOTAWARINGIN BARAT, KALIMANTAN TENGAH",1,189,56,245
https://kawalpemilu.org#60384,"SUNGAI KAPITAN, KUMAI, KOTAWARINGIN BARAT, KALIMANTAN TENGAH",14,38,156,194
https://kawalpemilu.org#61144,"TUMBANG MANGGO, SANAMAN MANTIKEI, KATINGAN, KALIMANTAN TENGAH",2,228,14,242
https://kawalpemilu.org#60840,"KABURAN, PASAK TALAWANG, KAPUAS, KALIMANTAN TENGAH",1,119,27,146
https://kawalpemilu.org#60689,"ANJIR MAMBULAU BARAT, KAPUAS TIMUR, KAPUAS, KALIMANTAN TENGAH",8,47,88,135
https://kawalpemilu.org#61946,"PALANGKA, JEKAN RAYA, KOTA PALANGKARAYA, KALIMANTAN TENGAH",114,49,108,157
https://kawalpemilu.org#61262,"SUNGAI UNDANG, SERUYAN HILIR, SERUYAN, KALIMANTAN TENGAH",8,88,14,102
https://kawalpemilu.org#60796,"TUMBANG MUROI, MANTANGAI, KAPUAS, KALIMANTAN TENGAH",4,78,18,96
https://kawalpemilu.org#65604,"TELUK LERONG ULU, SUNGAI KUNJANG, KOTA SAMARINDA, KALIMANTAN TIMUR",5,62,145,207
https://kawalpemilu.org#65245,"LINGGANG BIGUNG, LINGGANG BIGUNG, KUTAI BARAT, KALIMANTAN TIMUR",6,172,39,211
https://kawalpemilu.org#64321,"LOA IPUH DARAT, TENGGARONG, KUTAI KARTANEGARA, KALIMANTAN TIMUR",13,109,37,146
https://kawalpemilu.org#64552,"BUGIS, TANJUNG REDEB, BERAU, KALIMANTAN TIMUR",29,78,61,139
https://kawalpemilu.org#65547,"GUNUNGSARI ULU, BALIKPAPAN TENGAH, KOTA BALIKPAPAN, KALIMANTAN TIMUR",48,148,43,191
https://kawalpemilu.org#65618,"BANDARA, SUNGAI PINANG, KOTA SAMARINDA, KALIMANTAN TIMUR",8,83,119,202
https://kawalpemilu.org#64179,"KAYUNGO, LONG IKIS, PASER, KALIMANTAN TIMUR",2,73,79,152
https://kawalpemilu.org#65490,"GIRI MUKTI, PENAJAM, PENAJAM PASER UTARA, KALIMANTAN TIMUR",9,130,88,218
https://kawalpemilu.org#64279,"LOA JANAN ULU, LOA JANAN, KUTAI KARTANEGARA, KALIMANTAN TIMUR",7,111,34,145
https://kawalpemilu.org#87245,"SEPINGGAN RAYA, BALIKPAPAN SELATAN, KOTA BALIKPAPAN, KALIMANTAN TIMUR",33,107,113,220
https://kawalpemilu.org#65535,"BARU ILIR, BALIKPAPAN BARAT, KOTA BALIKPAPAN, KALIMANTAN TIMUR",59,120,97,217
https://kawalpemilu.org#65490,"GIRI MUKTI, PENAJAM, PENAJAM PASER UTARA, KALIMANTAN TIMUR",16,117,70,187
https://kawalpemilu.org#65540,"MARGA SARI, BALIKPAPAN BARAT, KOTA BALIKPAPAN, KALIMANTAN TIMUR",10,68,76,144
https://kawalpemilu.org#64161,"SANDELEY, KUARO, PASER, KALIMANTAN TIMUR",5,107,53,160
https://kawalpemilu.org#65643,"SELUMIT PANTAI, TARAKAN TENGAH, KOTA TARAKAN, KALIMANTAN UTARA",31,122,82,204
https://kawalpemilu.org#64940,"SETABU, SEBATIK BARAT, NUNUKAN, KALIMANTAN UTARA",5,183,35,218
https://kawalpemilu.org#65637,"KARANG HARAPAN, TARAKAN BARAT, KOTA TARAKAN, KALIMANTAN UTARA",24,148,13,161
https://kawalpemilu.org#25239,"LUBUK BESAR, LUBUK BESAR, BANGKA TENGAH, KEPULAUAN BANGKA BELITUNG",6,133,47,180
https://kawalpemilu.org#25155,"RAJIK, SIMPANG RIMBA, BANGKA SELATAN, KEPULAUAN BANGKA BELITUNG",4,206,65,271
https://kawalpemilu.org#25389,"PINTU AIR, RANGKUI, KOTA PANGKALPINANG, KEPULAUAN BANGKA BELITUNG",4,110,109,219
https://kawalpemilu.org#84855,"AIR KEPALA TUJUH, GERUNGGANG, KOTA PANGKALPINANG, KEPULAUAN BANGKA BELITUNG",2,109,116,225
https://kawalpemilu.org#25378,"SELINDUNG BARU, GABEK, KOTA PANGKALPINANG, KEPULAUAN BANGKA BELITUNG",6,0,0,121
https://kawalpemilu.org#87377,"SUNGAI PASIR, MERAL, KARIMUN, KEPULAUAN RIAU",17,85,137,222
https://kawalpemilu.org#25760,"TANJUNG RIAU, SEKUPANG, KOTA BATAM, KEPULAUAN RIAU",48,49,178,227
https://kawalpemilu.org#25768,"KABIL, NONGSA, KOTA BATAM, KEPULAUAN RIAU",22,41,93,134
https://kawalpemilu.org#25413,"MELAYU KOTA PIRING, TANJUNG PINANG TIMUR, KOTA TANJUNGPINANG, KEPULAUAN RIAU",6,87,123,210
https://kawalpemilu.org#25594,"SANGLAR, DURAI, KARIMUN, KEPULAUAN RIAU",3,50,65,115
https://kawalpemilu.org#25816,"SUNGAI LANGKAI, SAGULUNG, KOTA BATAM, KEPULAUAN RIAU",47,47,63,110
https://kawalpemilu.org#25414,"KAMPUNG BULANG, TANJUNG PINANG TIMUR, KOTA TANJUNGPINANG, KEPULAUAN RIAU",2,160,104,264
https://kawalpemilu.org#22940,"SIMBAR WARINGIN, TRIMURJO, LAMPUNG TENGAH, LAMPUNG",5,91,67,158
https://kawalpemilu.org#22763,"SINAR REJEKI, JATI AGUNG, LAMPUNG SELATAN, LAMPUNG",9,135,56,191
https://kawalpemilu.org#22859,"KERTOSARI, TANJUNG SARI, LAMPUNG SELATAN, LAMPUNG",9,141,38,179
https://kawalpemilu.org#24229,"SUKORAHAYU, LABUHAN MARINGGAI, LAMPUNG TIMUR, LAMPUNG",7,153,25,178
https://kawalpemilu.org#24932,"HANURA, TELUK PANDAN, PESAWARAN, LAMPUNG",16,109,72,181
https://kawalpemilu.org#22964,"BANDAR JAYA BARAT, TERBANGGI BESAR, LAMPUNG TENGAH, LAMPUNG",28,139,129,268
https://kawalpemilu.org#22607,"HAJIMENA, NATAR, LAMPUNG SELATAN, LAMPUNG",22,72,85,157
https://kawalpemilu.org#24862,"KURUNGAN NYAWA, GEDONG TATAAN, PESAWARAN, LAMPUNG",1,94,112,206
https://kawalpemilu.org#23209,"TALANG BOJONG, KOTABUMI, LAMPUNG UTARA, LAMPUNG",41,30,49,79
https://kawalpemilu.org#23768,"TRI MUKTI JAYA, BANJAR AGUNG, TULANG BAWANG, LAMPUNG",1,68,88,156
https://kawalpemilu.org#23710,"SIDOMULYO, PAGAR DEWA, LAMPUNG BARAT, LAMPUNG",7,103,26,129
https://kawalpemilu.org#23614,"KOTA BATU, NGARAS, PESISIR BARAT, LAMPUNG",1,72,113,185
https://kawalpemilu.org#24361,"MENGANDUNG SARI, SEKAMPUNG UDIK, LAMPUNG TIMUR, LAMPUNG",13,118,85,203
https://kawalpemilu.org#23566,"PEKON BALAK, BATU BRAK, LAMPUNG BARAT, LAMPUNG",4,52,94,146
https://kawalpemilu.org#24721,"WAY HALIM PERMAI, WAY HALIM, KOTA BANDAR LAMPUNG, LAMPUNG",10,126,119,245
https://kawalpemilu.org#23206,"SINDANG SARI, KOTABUMI, LAMPUNG UTARA, LAMPUNG",58,55,70,125
https://kawalpemilu.org#23032,"MATARAM ILIR, SEPUTIH SURABAYA, LAMPUNG TENGAH, LAMPUNG",8,158,35,195
https://kawalpemilu.org#24781,"BAKUNG, TELUKBETUNG BARAT, KOTA BANDAR LAMPUNG, LAMPUNG",7,112,114,226
https://kawalpemilu.org#24558,"SUKOSARI, BARADATU, WAY KANAN, LAMPUNG",4,46,103,149
https://kawalpemilu.org#24878,"HALANGAN RATU, NEGERI KATON, PESAWARAN, LAMPUNG",5,56,139,195
https://kawalpemilu.org#24802,"TANJUNG SENANG, TANJUNG SENANG, KOTA BANDAR LAMPUNG, LAMPUNG",20,72,134,206
https://kawalpemilu.org#24542,"REBANG TINGGI, BANJIT, WAY KANAN, LAMPUNG",5,86,193,279
https://kawalpemilu.org#24417,"ITIK RENDAY, MELINTING, LAMPUNG TIMUR, LAMPUNG",4,127,27,154
https://kawalpemilu.org#24440,"TANJUNG WANGI, WAWAY KARYA, LAMPUNG TIMUR, LAMPUNG",5,148,14,162
https://kawalpemilu.org#24362,"TOBA, SEKAMPUNG UDIK, LAMPUNG TIMUR, LAMPUNG",4,138,48,186
https://kawalpemilu.org#22990,"REKSO BINANGUN, RUMBIA, LAMPUNG TENGAH, LAMPUNG",6,162,28,190
https://kawalpemilu.org#24992,"PESAWARAN, KEDONDONG, PESAWARAN, LAMPUNG",1,103,32,135
https://kawalpemilu.org#24841,"TEJOSARI, METRO TIMUR, KOTA METRO, LAMPUNG",8,107,137,242
https://kawalpemilu.org#24402,"BANDAR AGUNG, BANDAR SRIBHAWONO, LAMPUNG TIMUR, LAMPUNG",41,145,9,154
https://kawalpemilu.org#22614,"TANJUNG SARI, NATAR, LAMPUNG SELATAN, LAMPUNG",26,138,31,169
https://kawalpemilu.org#23040,"GUNUNG AGUNG, TERUSAN NUNYAI, LAMPUNG TENGAH, LAMPUNG",22,53,111,164
https://kawalpemilu.org#23799,"SIDOHARJO, PENAWAR TAMA, TULANG BAWANG, LAMPUNG",15,145,53,198
https://kawalpemilu.org#24720,"SUKARAME BARU, SUKARAME, KOTA BANDAR LAMPUNG, LAMPUNG",15,69,130,199
https://kawalpemilu.org#23279,"CANDI MAS, ABUNG SELATAN, LAMPUNG UTARA, LAMPUNG",48,65,111,176
https://kawalpemilu.org#24958,"KUNYAIAN, MARGA PUNDUH, PESAWARAN, LAMPUNG",1,105,141,246
https://kawalpemilu.org#-990524,"Manama, Manama, Bahrain, Luar Negeri",1,103,123,226
https://kawalpemilu.org#-991104,"Kota Kinabalu, Kota Kinabalu, Malaysia, Luar Negeri",2156,161,23,184
https://kawalpemilu.org#-991084,"Johor Bahru, Johor Bahru, Malaysia, Luar Negeri",2223,122,77,199
https://kawalpemilu.org#-991304,"Taipei, Taipei, Taiwan, Luar Negeri",1014,933,122,1055
https://kawalpemilu.org#78083,"SANGADJI, KOTA TERNATE UTARA, KOTA TERNATE, MALUKU UTARA",13,33,127,160
https://kawalpemilu.org#928257,"BARINGIN JAYA, OBA TENGAH, KOTA TIDORE KEPULAUAN, MALUKU UTARA",1,57,73,130
https://kawalpemilu.org#77614,"FOYA TOBARU, GANE TIMUR, HALMAHERA SELATAN, MALUKU UTARA",2,109,44,153
https://kawalpemilu.org#77580,"RABUTDAIYO, PULAU MAKIAN, HALMAHERA SELATAN, MALUKU UTARA",2,36,177,213
https://kawalpemilu.org#77361,"BILIFITU, PATANI UTARA, HALMAHERA TENGAH, MALUKU UTARA",2,171,41,212
https://kawalpemilu.org#77005,"LATUHALAT, NUSANIWE, KOTA AMBON, MALUKU",9,201,11,212
https://kawalpemilu.org#76291,"AMAHAI, AMAHAI, MALUKU TENGAH, MALUKU",12,143,7,150
https://kawalpemilu.org#77023,"BATU MERAH, SIRIMAU, KOTA AMBON, MALUKU",146,28,160,188
https://kawalpemilu.org#76290,"SOAHUKU, AMAHAI, MALUKU TENGAH, MALUKU",6,173,7,180
https://kawalpemilu.org#76782,"KAIRATU, KAIRATU, SERAM BAGIAN BARAT, MALUKU",13,55,87,142
https://kawalpemilu.org#76812,"LUHU, HUAMUAL, SERAM BAGIAN BARAT, MALUKU",71,20,221,241
https://kawalpemilu.org#87601,"YAINUELO, AMAHAI, MALUKU TENGAH, MALUKU",1,66,160,226
https://kawalpemilu.org#54750,"TAWALI, WERA, BIMA, NUSA TENGGARA BARAT",16,5,155,160
https://kawalpemilu.org#54224,"KOPANG REMBIGA, KOPANG, LOMBOK TENGAH, NUSA TENGGARA BARAT",39,45,150,195
https://kawalpemilu.org#54151,"BONJERUK, JONGGAT, LOMBOK TENGAH, NUSA TENGGARA BARAT",5,47,110,157
https://kawalpemilu.org#54726,"KOMBO, WAWO, BIMA, NUSA TENGGARA BARAT",2,47,149,196
https://kawalpemilu.org#54978,"SELAGALAS, SANDUBAYA, KOTA MATARAM, NUSA TENGGARA BARAT",27,61,101,162
https://kawalpemilu.org#54068,"BATU PUTIH, SEKOTONG, LOMBOK BARAT, NUSA TENGGARA BARAT",4,102,90,192
https://kawalpemilu.org#54350,"ANJANI, SURALAGA, LOMBOK TIMUR, NUSA TENGGARA BARAT",14,84,92,176
https://kawalpemilu.org#55055,"AKAR-AKAR, BAYAN, LOMBOK UTARA, NUSA TENGGARA BARAT",11,66,116,182
https://kawalpemilu.org#54381,"TEROS, LABUHAN HAJI, LOMBOK TIMUR, NUSA TENGGARA BARAT",12,27,129,156
https://kawalpemilu.org#54569,"BERORA, LOPOK, SUMBAWA, NUSA TENGGARA BARAT",8,60,149,209
https://kawalpemilu.org#54246,"RANGGAGATA, PRAYA BARAT DAYA, LOMBOK TENGAH, NUSA TENGGARA BARAT",16,14,88,102
https://kawalpemilu.org#54961,"JEMPONG BARU, SEKARBELA, KOTA MATARAM, NUSA TENGGARA BARAT",41,75,141,216
https://kawalpemilu.org#54768,"PIONG, SANGGAR, BIMA, NUSA TENGGARA BARAT",1,69,124,193
https://kawalpemilu.org#54365,"SEMBALUN LAWANG, SEMBALUN, LOMBOK TIMUR, NUSA TENGGARA BARAT",3,47,144,191
https://kawalpemilu.org#54061,"GERIMAX INDAH, NARMADA, LOMBOK BARAT, NUSA TENGGARA BARAT",1,88,50,138
https://kawalpemilu.org#54095,"LINGSAR, LINGSAR, LOMBOK BARAT, NUSA TENGGARA BARAT",14,89,117,206
https://kawalpemilu.org#54488,"SELANTEH, PLAMPANG, SUMBAWA, NUSA TENGGARA BARAT",4,24,133,157
https://kawalpemilu.org#54688,"SONDOSIA, BOLO, BIMA, NUSA TENGGARA BARAT",1,24,187,211
https://kawalpemilu.org#54407,"PERUNG, LUNYUK, SUMBAWA, NUSA TENGGARA BARAT",4,116,81,197
https://kawalpemilu.org#54425,"TENGAH, UTAN, SUMBAWA, NUSA TENGGARA BARAT",4,42,185,227
https://kawalpemilu.org#57713,"WATU WAJA, LEMBOR SELATAN, MANGGARAI BARAT, NUSA TENGGARA TIMUR",3,156,9,165
https://kawalpemilu.org#56689,"JEGHARANGGA, NANGAPANDA, ENDE, NUSA TENGGARA TIMUR",1,150,2,152
https://kawalpemilu.org#57712,"WAE MOSE, LEMBOR SELATAN, MANGGARAI BARAT, NUSA TENGGARA TIMUR",1,216,11,227
https://kawalpemilu.org#57006,"MAINAI, WOLOMEZE, NGADA, NUSA TENGGARA TIMUR",1,131,23,154
https://kawalpemilu.org#56929,"RATOGESA, GOLEWA, NGADA, NUSA TENGGARA TIMUR",3,171,9,180
https://kawalpemilu.org#55377,"TUNUA, MOLLO UTARA, TIMOR TENGAH SELATAN, NUSA TENGGARA TIMUR",3,195,2,197
https://kawalpemilu.org#58198,"RANA GAPANG, ELAR, MANGGARAI TIMUR, NUSA TENGGARA TIMUR",1,260,11,271
https://kawalpemilu.org#56785,"MBULILOO, WOLOWARU, ENDE, NUSA TENGGARA TIMUR",4,163,8,171
https://kawalpemilu.org#55664,"POPNAM, NOEMUTI, TIMOR TENGAH UTARA, NUSA TENGGARA TIMUR",4,180,30,210
https://kawalpemilu.org#55164,"KOTABES, AMARASI, KUPANG, NUSA TENGGARA TIMUR",3,240,7,247
https://kawalpemilu.org#55869,"KUSA, MALAKA TIMUR, MALAKA, NUSA TENGGARA TIMUR",5,167,14,181
https://kawalpemilu.org#57707,"BENTENG DEWA, LEMBOR SELATAN, MANGGARAI BARAT, NUSA TENGGARA TIMUR",1,47,75,122
https://kawalpemilu.org#57387,"LABOYA DETE, LAMBOYA, SUMBA BARAT, NUSA TENGGARA TIMUR",2,170,18,188
https://kawalpemilu.org#56606,"TUA BAO, WAIBLAMA, SIKKA, NUSA TENGGARA TIMUR",3,126,5,131
https://kawalpemilu.org#55157,"MATA AIR, KUPANG TENGAH, KUPANG, NUSA TENGGARA TIMUR",10,215,8,223
https://kawalpemilu.org#57957,"KALEMBU NDARA MANE, WEWEWA TIMUR, SUMBA BARAT DAYA, NUSA TENGGARA TIMUR",4,0,0,0
https://kawalpemilu.org#55260,"BURAEN, AMARASI SELATAN, KUPANG, NUSA TENGGARA TIMUR",7,209,3,212
https://kawalpemilu.org#58228,"LEDEANA, SABU BARAT, SABU RAIJUA, NUSA TENGGARA TIMUR",1,184,8,192
https://kawalpemilu.org#55520,"PENE UTARA, OENINO, TIMOR TENGAH SELATAN, NUSA TENGGARA TIMUR",5,147,3,150
https://kawalpemilu.org#83109,"WASIOR I, WASIOR, TELUK WONDAMA, PAPUA BARAT",10,101,36,137
https://kawalpemilu.org#927685,"SOROAN, AYAMARU BARAT, MAYBRAT, PAPUA BARAT",1,211,2,213
https://kawalpemilu.org#81950,"ISIR, AITINYO RAYA, MAYBRAT, PAPUA BARAT",1,189,0,189
https://kawalpemilu.org#927763,"KAMBUSABO, AITINYO RAYA, MAYBRAT, PAPUA BARAT",1,118,0,118
https://kawalpemilu.org#929278,"PUNCAK CENDRAWASIH, SORONG BARAT, KOTA SORONG, PAPUA BARAT",8,165,12,177
https://kawalpemilu.org#79916,"TORAY, SOTA, MERAUKE, PAPUA",2,123,14,137
https://kawalpemilu.org#78323,"KAPIRAYA-KOMAUTO, KAPIRAYA, DEIYAI, PAPUA",6,283,0,283
https://kawalpemilu.org#86808,"MAGEGOBAK, DIMBA, LANNY JAYA, PAPUA",1,260,0,260
https://kawalpemilu.org#80317,"KARANG MULIA, NABIRE, NABIRE, PAPUA",35,206,59,265
https://kawalpemilu.org#86570,"KARYE, BATANI, PEGUNUNGAN BINTANG, PAPUA",3,214,0,214
https://kawalpemilu.org#81758,"LANGDA, LANGDA, YAHUKIMO, PAPUA",2,300,0,300
https://kawalpemilu.org#78598,"BOLLY, BOKONERI, TOLIKARA, PAPUA",2,162,0,162
https://kawalpemilu.org#79011,"BOMAKIA II, BOMAKIA, BOVEN DIGOEL, PAPUA",2,78,10,88
https://kawalpemilu.org#78943,"MINDIPTANA, MINDIPTANA, BOVEN DIGOEL, PAPUA",2,104,26,130
https://kawalpemilu.org#929627,"UWOME, KUYAWAGE, LANNY JAYA, PAPUA",2,152,0,152
https://kawalpemilu.org#81810,"BAHABOLMA, KABIANGGAMA, YAHUKIMO, PAPUA",1,227,0,227
https://kawalpemilu.org#929633,"MUGIME, POGA, LANNY JAYA, PAPUA",1,204,0,204
https://kawalpemilu.org#79337,"RAYORI, KEPULAUAN ARURI, SUPIORI, PAPUA",4,232,6,238
https://kawalpemilu.org#80238,"AMBORA, DEMTA, JAYAPURA, PAPUA",2,199,1,200
https://kawalpemilu.org#79504,"WINIMA, ERAGAYAM, MAMBERAMO TENGAH, PAPUA",2,165,0,165
https://kawalpemilu.org#81300,"OKTEM, OKLIP, PEGUNUNGAN BINTANG, PAPUA",1,214,0,214
https://kawalpemilu.org#81696,"DIRWEMNA, DIRWEMNA, YAHUKIMO, PAPUA",3,216,0,216
https://kawalpemilu.org#79882,"WANINGGAP KAY, SEMANGGA, MERAUKE, PAPUA",7,50,62,112
https://kawalpemilu.org#79884,"YASA MULYA, TANAH MIRING, MERAUKE, PAPUA",9,86,65,151
https://kawalpemilu.org#14228,"TANAH MERAH, SIAK HULU, KAMPAR, RIAU",14,47,132,179
https://kawalpemilu.org#15824,"TANGKERANG  BARAT, MARPOYAN DAMAI, KOTA PEKANBARU, RIAU",39,34,159,193
https://kawalpemilu.org#89381,"MAKMUR JAYA, Kateman, INDRAGIRI HILIR, RIAU",4,27,88,115
https://kawalpemilu.org#14849,"SUNGAIDUSUN, Batang Tuaka, INDRAGIRI HILIR, RIAU",4,21,146,167
https://kawalpemilu.org#14174,"BATU BELAH, KAMPAR, KAMPAR, RIAU",14,7,211,218
https://kawalpemilu.org#15826,"SIDOMULYO TIMUR, MARPOYAN DAMAI, KOTA PEKANBARU, RIAU",42,58,162,220
https://kawalpemilu.org#84490,"SEBERANG TEMBILAHAN BARAT, Tembilahan, INDRAGIRI HILIR, RIAU",6,64,23,87
https://kawalpemilu.org#14469,"SUNGAI KUNING BENIO, KELAYANG, INDRAGIRI HULU, RIAU",5,43,113,156
https://kawalpemilu.org#14309,"KARYA INDAH, TAPUNG, KAMPAR, RIAU",12,45,37,82
https://kawalpemilu.org#14857,"Tasik Raya, Batang Tuaka, INDRAGIRI HILIR, RIAU",5,75,45,120
https://kawalpemilu.org#15792,"CINTA RAJA, SAIL, KOTA PEKANBARU, RIAU",5,31,113,144
https://kawalpemilu.org#14825,"Nusantara Jaya, Keritang, INDRAGIRI HILIR, RIAU",10,112,40,152
https://kawalpemilu.org#931185,"TUAHMADANI, TAMPAN, KOTA PEKANBARU, RIAU",4,11,222,233
https://kawalpemilu.org#15593,"PULAU BARU, KUANTAN TENGAH, KUANTAN SINGINGI, RIAU",2,97,145,242
https://kawalpemilu.org#15817,"TANGKERANG LABUAI, BUKIT RAYA, KOTA PEKANBARU, RIAU",34,31,194,225
https://kawalpemilu.org#15446,"TUALANG, TUALANG, SIAK, RIAU",53,25,102,127
https://kawalpemilu.org#15793,"SUKAMULYA, SAIL, KOTA PEKANBARU, RIAU",20,56,153,209
https://kawalpemilu.org#15746,"SUKARAJA, LOGAS TANAH DARAT, KUANTAN SINGINGI, RIAU",5,114,108,222
https://kawalpemilu.org#931187,"TOBEKGODANG, TAMPAN, KOTA PEKANBARU, RIAU",27,25,238,263
https://kawalpemilu.org#14635,"KELAPAPATI, BENGKALIS, BENGKALIS, RIAU",1,79,168,247
https://kawalpemilu.org#14777,"Tembilahan Hilir, Tembilahan, INDRAGIRI HILIR, RIAU",38,50,119,169
https://kawalpemilu.org#14811,"Bolak Raya, Mandah, INDRAGIRI HILIR, RIAU",3,25,70,95
https://kawalpemilu.org#75857,"BUANGIN, RANTEBULAHAN TIMUR, MAMASA, SULAWESI BARAT",2,160,3,163
https://kawalpemilu.org#76094,"LABUANG, BANGGAE TIMUR, MAJENE, SULAWESI BARAT",15,115,102,217
https://kawalpemilu.org#75476,"LARIANG, TIKKE RAYA, MAMUJU UTARA, SULAWESI BARAT",2,158,91,249
https://kawalpemilu.org#75455,"DAPURANG, DAPURANG, MAMUJU UTARA, SULAWESI BARAT",9,173,78,251
https://kawalpemilu.org#75526,"SONDOANG, KALUKKU, MAMUJU, SULAWESI BARAT",2,162,37,199
https://kawalpemilu.org#71115,"LIMPORILAU, BELAWA, WAJO, SULAWESI SELATAN",8,175,32,207
https://kawalpemilu.org#70668,"BAJU BODOA, MAROS BARU, MAROS, SULAWESI SELATAN",12,55,187,242
https://kawalpemilu.org#71381,"TATAE, DUAMPANUA, PINRANG, SULAWESI SELATAN",11,72,141,213
https://kawalpemilu.org#70527,"PATTIRO, DUA BOCCOE, BONE, SULAWESI SELATAN",2,99,75,174
https://kawalpemilu.org#70494,"TAJONG, TELLU SIATTINGE, BONE, SULAWESI SELATAN",5,108,52,160
https://kawalpemilu.org#70238,"PULAU PERSATUAN, PULAU SEMBILAN, SINJAI, SULAWESI SELATAN",4,59,88,147
https://kawalpemilu.org#69882,"LAIKANG, MANGARABOMBANG, TAKALAR, SULAWESI SELATAN",8,158,26,184
https://kawalpemilu.org#69612,"PANTAMA, KAJANG, BULUKUMBA, SULAWESI SELATAN",4,54,126,180
https://kawalpemilu.org#69441,"LONDONGBIANG, AWAN RANTE KARUA, TORAJA UTARA, SULAWESI SELATAN",5,89,5,94
https://kawalpemilu.org#72538,"PURANGI, SENDANA, KOTA PALOPO, SULAWESI SELATAN",3,66,145,211
https://kawalpemilu.org#69958,"KALENNA BONTONGAPE, GALESONG, TAKALAR, SULAWESI SELATAN",5,38,193,231
https://kawalpemilu.org#70855,"MANDALLE, MANDALLE, PANGKAJENE DAN KEPULAUAN, SULAWESI SELATAN",8,133,36,169
https://kawalpemilu.org#72092,"LIMBONG, RONGKONG, LUWU UTARA, SULAWESI SELATAN",1,25,83,108
https://kawalpemilu.org#69696,"PABENTENGANG, EREMERASA, BANTAENG, SULAWESI SELATAN",1,41,116,157
https://kawalpemilu.org#71362,"MACCORAWALIE, WATANG SAWITO, PINRANG, SULAWESI SELATAN",35,48,80,128
https://kawalpemilu.org#70176,"PANAIKANG, SINJAI TIMUR, SINJAI, SULAWESI SELATAN",6,39,104,143
https://kawalpemilu.org#71335,"SAMAENRE, MATIRRO SOMPE, PINRANG, SULAWESI SELATAN",8,42,117,159
https://kawalpemilu.org#70134,"JIPANG, BONTONOMPO SELATAN, GOWA, SULAWESI SELATAN",9,69,150,219
https://kawalpemilu.org#69636,"TAMAONA, KINDANG, BULUKUMBA, SULAWESI SELATAN",3,45,176,221
https://kawalpemilu.org#72387,"RAPPOKALLING, TALLO, KOTA MAKASSAR, SULAWESI SELATAN",29,69,134,203
https://kawalpemilu.org#71889,"MADANDAN, RANTETAYO, TANA TORAJA, SULAWESI SELATAN",3,201,50,251
https://kawalpemilu.org#70037,"PANAKKUKANG, PALLANGGA, GOWA, SULAWESI SELATAN",1,45,159,204
https://kawalpemilu.org#71421,"TIROANG, TIROANG, PINRANG, SULAWESI SELATAN",11,72,149,221
https://kawalpemilu.org#70055,"ROMANGPOLONG, SOMBA OPU, GOWA, SULAWESI SELATAN",13,57,176,233
https://kawalpemilu.org#71398,"RAJANG, LEMBANG, PINRANG, SULAWESI SELATAN",6,77,128,205
https://kawalpemilu.org#71213,"LAJONGA, PANCA LAUTANG, SIDENRENG RAPPANG, SULAWESI SELATAN",4,62,118,180
https://kawalpemilu.org#69842,"PALAJAU, ARUNGKEKE, JENEPONTO, SULAWESI SELATAN",10,20,178,198
https://kawalpemilu.org#69813,"PAPPALLUANG, BANGKALA BARAT, JENEPONTO, SULAWESI SELATAN",3,103,65,168
https://kawalpemilu.org#72004,"LIPUNGAN TANETE, KURRA, TANA TORAJA, SULAWESI SELATAN",2,158,3,161
https://kawalpemilu.org#71479,"ROSOAN, ENREKANG, ENREKANG, SULAWESI SELATAN",5,48,128,176
https://kawalpemilu.org#88279,"BAKARU, LEMBANG, PINRANG, SULAWESI SELATAN",4,26,64,90
https://kawalpemilu.org#70626,"BULU ALLAPORENGE, BENGO, BONE, SULAWESI SELATAN",6,120,54,174
https://kawalpemilu.org#70354,"MAROANGING, SIBULUE, BONE, SULAWESI SELATAN",4,90,71,161
https://kawalpemilu.org#927515,"PEURA, PAMONA PUSELEMBA, POSO, SULAWESI TENGAH",4,182,12,194
https://kawalpemilu.org#67622,"LUMPOKNYO, LUWUK, BANGGAI, SULAWESI TENGAH",4,83,107,190
https://kawalpemilu.org#67403,"JONO OGE, SIGI BIROMARU, SIGI, SULAWESI TENGAH",9,121,20,141
https://kawalpemilu.org#68611,"LAROBENU, BUNGKU BARAT, MOROWALI, SULAWESI TENGAH",2,100,138,238
https://kawalpemilu.org#68251,"MUARA BESAR, OGODEIDE, TOLITOLI, SULAWESI TENGAH",2,164,44,208
https://kawalpemilu.org#67687,"TOIPAN, PAGIMANA, BANGGAI, SULAWESI TENGAH",1,173,81,254
https://kawalpemilu.org#67424,"BAKUBAKULU, PALOLO, SIGI, SULAWESI TENGAH",6,121,75,196
https://kawalpemilu.org#68415,"BUOL, BIAU, BUOL, SULAWESI TENGAH",14,96,122,218
https://kawalpemilu.org#69134,"PUSUNGI, AMPANA TETE, TOJO UNA-UNA, SULAWESI TENGAH",9,132,78,210
https://kawalpemilu.org#68261,"OYOM, LAMPASIO, TOLITOLI, SULAWESI TENGAH",9,51,5,56
https://kawalpemilu.org#85714,"TUMPAPA INDAH, BALINGGI, PARIGI MOUTONG, SULAWESI TENGAH",2,97,57,154
https://kawalpemilu.org#85747,"PANTOLOAN BOYA, TAWAELI, KOTA PALU, SULAWESI TENGAH",2,104,78,182
https://kawalpemilu.org#74695,"WARURUMA, KOKALUKUNA, KOTA BAU BAU, SULAWESI TENGGARA",8,112,87,199
https://kawalpemilu.org#73601,"WATORUMBE BATA, MAWASANGKA TENGAH, BUTON TENGAH, SULAWESI TENGGARA",3,50,80,130
https://kawalpemilu.org#89819,"RANTE GOLA, BONEGUNU, BUTON UTARA, SULAWESI TENGGARA",2,74,115,189
https://kawalpemilu.org#73159,"KEMBAR MAMINASA, MAGINTI, MUNA BARAT, SULAWESI TENGGARA",1,69,112,181
https://kawalpemilu.org#72805,"TUOY, UNAAHA, KONAWE, SULAWESI TENGGARA",2,63,148,211
https://kawalpemilu.org#74667,"KATOBENGKE, BETOAMBARI, KOTA BAU BAU, SULAWESI TENGGARA",20,49,136,185
https://kawalpemilu.org#73241,"LAENDE, KATOBU, MUNA, SULAWESI TENGGARA",5,65,125,188
https://kawalpemilu.org#74594,"LABIBIA, MANDONGA, KOTA KENDARI, SULAWESI TENGGARA",10,9,145,154
https://kawalpemilu.org#74369,"LAMBAI, LAMBAI, KOLAKA UTARA, SULAWESI TENGGARA",3,64,127,191
https://kawalpemilu.org#72931,"MEKAR SARI, TONGAUNA, KONAWE, SULAWESI TENGGARA",2,186,30,216
https://kawalpemilu.org#85582,"MOLOMPAR DUA, TOMBATU TIMUR, MINAHASA TENGGARA, SULAWESI UTARA",2,188,13,201
https://kawalpemilu.org#66855,"TOSURAYA, RATAHAN, MINAHASA TENGGARA, SULAWESI UTARA",4,211,18,229
https://kawalpemilu.org#67214,"KAIRAGI DUA, MAPANGET, KOTA MANADO, SULAWESI UTARA",6,151,17,168
https://kawalpemilu.org#65824,"AYONG, SANG TOMBOLANG, BOLAANG MONGONDOW, SULAWESI UTARA",1,76,92,168
https://kawalpemilu.org#66267,"MANUMPITAENG, MANGANITU, KEPULAUAN SANGIHE, SULAWESI UTARA",2,187,17,204
https://kawalpemilu.org#67233,"PANCURAN, LEMBEH SELATAN, KOTA BITUNG, SULAWESI UTARA",2,97,9,106
https://kawalpemilu.org#67286,"BITUNG BARAT SATU, MAESA, KOTA BITUNG, SULAWESI UTARA",5,137,69,206
https://kawalpemilu.org#66973,"BIONTONG I, BOLANGITANG TIMUR, BOLAANG MONGONDOW UTARA, SULAWESI UTARA",3,117,106,223
https://kawalpemilu.org#66377,"MUSI, LIRUNG, KEPULAUAN TALAUD, SULAWESI UTARA",1,208,7,215
https://kawalpemilu.org#65979,"TUUTU, TONDANO BARAT, MINAHASA, SULAWESI UTARA",3,195,5,200
https://kawalpemilu.org#13824,"BATANG KABUNG GANTING, KOTO TANGAH, KOTA PADANG, SUMATERA BARAT",3,32,138,170
https://kawalpemilu.org#13674,"LUAK KAPAU ALAM PAUH DUO, PAUH DUO, SOLOK SELATAN, SUMATERA BARAT",1,19,189,198
https://kawalpemilu.org#12994,"LUNANG SELATAN, LUNANG, PESISIR SELATAN, SUMATERA BARAT",7,164,59,223
https://kawalpemilu.org#13137,"LUBUAK TAROK, LUBUAK TAROK, SIJUNJUNG, SUMATERA BARAT",15,27,123,150
https://kawalpemilu.org#13800,"LUBUK LINTAH, KURANJI, KOTA PADANG, SUMATERA BARAT",19,14,210,224
https://kawalpemilu.org#13333,"KOTO KACIAK, TANJUNG RAYA, AGAM, SUMATERA BARAT",1,17,180,197
https://kawalpemilu.org#13395,"BATAGAK, SUNGAI PUA, AGAM, SUMATERA BARAT",12,2,156,158
https://kawalpemilu.org#13101,"TIMBULUN, TANJUNG GADANG, SIJUNJUNG, SUMATERA BARAT",4,16,162,178
https://kawalpemilu.org#13197,"SARUASO, TANJUNG EMAS, TANAH DATAR, SUMATERA BARAT",12,12,131,143
https://kawalpemilu.org#13148,"TANJUNG, KOTO VII, SIJUNJUNG, SUMATERA BARAT",18,24,189,213
https://kawalpemilu.org#13365,"PANAMPUANG, IV ANGKAT CANDUNG, AGAM, SUMATERA BARAT",9,6,158,164
https://kawalpemilu.org#13809,"KAMPUNG OLO, NANGGALO, KOTA PADANG, SUMATERA BARAT",4,10,119,129
https://kawalpemilu.org#84396,"PULUIK-PULUIK SELATAN, IV NAGARI BAYANG UTARA, PESISIR SELATAN, SUMATERA BARAT",2,12,80,92
https://kawalpemilu.org#13391,"SALAREH AIA, PELEMBAYAN, AGAM, SUMATERA BARAT",5,19,192,211
https://kawalpemilu.org#13695,"KINALI, KINALI, PASAMAN BARAT, SUMATERA BARAT",104,25,187,212
https://kawalpemilu.org#13809,"KAMPUNG OLO, NANGGALO, KOTA PADANG, SUMATERA BARAT",9,12,102,114
https://kawalpemilu.org#13362,"BATU TABA, IV ANGKAT CANDUNG, AGAM, SUMATERA BARAT",10,13,110,123
https://kawalpemilu.org#13444,"TARAM, HARAU, LIMA PULUH KOTA, SUMATERA BARAT",8,33,137,170
https://kawalpemilu.org#84435,"KOTO NAN EMPAT DIBAWUH, SEMBILAN KOTO, DHARMASRAYA, SUMATERA BARAT",6,24,130,154
https://kawalpemilu.org#13127,"MUARO TAKUANG, KAMANG BARU, SIJUNJUNG, SUMATERA BARAT",2,24,164,188
https://kawalpemilu.org#13951,"PARAK BATUANG, PAYAKUMBUH BARAT, KOTA PAYAKUMBUH, SUMATERA BARAT",1,40,167,207
https://kawalpemilu.org#19972,"GUNUNG MEGANG, KISAM TINGGI, OGAN KOMERING ULU SELATAN, SUMATERA SELATAN",1,120,106,226
https://kawalpemilu.org#20583,"SIALANG, SAKO, KOTA PALEMBANG, SUMATERA SELATAN",49,58,133,191
https://kawalpemilu.org#20628,"SRIJAYA, ALANG-ALANG LEBAR, KOTA PALEMBANG, SUMATERA SELATAN",8,49,125,174
https://kawalpemilu.org#17725,"BUMIARJO, LEMPUING, OGAN KOMERING ILIR, SUMATERA SELATAN",2,149,106,255
https://kawalpemilu.org#17489,"TERUSAN, BATURAJA TIMUR, OGAN KOMERING ULU, SUMATERA SELATAN",4,85,127,212
https://kawalpemilu.org#20544,"SIRING AGUNG, ILIR BARAT I, KOTA PALEMBANG, SUMATERA SELATAN",54,35,119,154
https://kawalpemilu.org#20525,"3 / 4 ULU, SEBERANG ULU I, KOTA PALEMBANG, SUMATERA SELATAN",73,108,69,177
https://kawalpemilu.org#20634,"LEBUNG GAJAH, SEMATANG BORANG, KOTA PALEMBANG, SUMATERA SELATAN",1,35,63,98
https://kawalpemilu.org#19392,"SUKOMORO, TALANG KELAPA, BANYUASIN, SUMATERA SELATAN",41,66,147,213
https://kawalpemilu.org#18715,"PAUH I, RAWAS ILIR, MUSI RAWAS UTARA, SUMATERA SELATAN",3,44,166,210
https://kawalpemilu.org#19638,"MARGO MULYO, BELITANG II, OGAN KOMERING ULU TIMUR, SUMATERA SELATAN",5,122,75,197
https://kawalpemilu.org#20595,"SEI SELAYUR, KALIDONI, KOTA PALEMBANG, SUMATERA SELATAN",32,55,139,194
https://kawalpemilu.org#19131,"SIDO MUKTI, PLAKAT TINGGI, MUSI BANYUASIN, SUMATERA SELATAN",1,37,125,162
https://kawalpemilu.org#19469,"MARGA RUKUN, MUARA SUGIHAN, BANYUASIN, SUMATERA SELATAN",6,111,127,238
https://kawalpemilu.org#17633,"KOTARAYA, KAYU AGUNG, OGAN KOMERING ILIR, SUMATERA SELATAN",7,74,172,246
https://kawalpemilu.org#20586,"20 ILIR II, KEMUNING, KOTA PALEMBANG, SUMATERA SELATAN",2,81,170,251
https://kawalpemilu.org#20081,"BUMI JAYA, BUAY RAWAN, OGAN KOMERING ULU SELATAN, SUMATERA SELATAN",3,91,81,172
https://kawalpemilu.org#91968,"AGUNG LAWANGAN, DEMPO UTARA, KOTA PAGAR ALAM, SUMATERA SELATAN",10,63,98,161
https://kawalpemilu.org#19431,"TANJUNGLAGO, TANJUNG LAGO, BANYUASIN, SUMATERA SELATAN",15,75,81,156
https://kawalpemilu.org#928923,"KARANG BINANGUN II, BELITANG MADANG RAYA, OGAN KOMERING ULU TIMUR, SUMATERA SELATAN",6,90,63,153
https://kawalpemilu.org#20310,"LUBUK TUNGGAL, RAMBANG KUANG, OGAN ILIR, SUMATERA SELATAN",3,62,124,186
https://kawalpemilu.org#18542,"BATAY, GUMAY TALANG, LAHAT, SUMATERA SELATAN",2,31,132,163
https://kawalpemilu.org#20545,"DEMANG LEBAR DAUN, ILIR BARAT I, KOTA PALEMBANG, SUMATERA SELATAN",25,30,49,79
https://kawalpemilu.org#20756,"PONOROGO, LUBUK LINGGAU UTARA II, KOTA LUBUKLINGGAU, SUMATERA SELATAN",10,115,127,242
https://kawalpemilu.org#20219,"SUKA MULIA, INDRALAYA UTARA, OGAN ILIR, SUMATERA SELATAN",2,103,81,184
https://kawalpemilu.org#17566,"BATU MARTA II, LUBUK RAJA, OGAN KOMERING ULU, SUMATERA SELATAN",5,81,111,192
https://kawalpemilu.org#18038,"PASAR TANJUNG ENIM, LAWANG KIDUL, MUARA ENIM, SUMATERA SELATAN",20,149,89,238
https://kawalpemilu.org#19235,"MULYA AGUNG, BANYUASIN III, BANYUASIN, SUMATERA SELATAN",3,54,158,212
https://kawalpemilu.org#18719,"KERTA DEWA, RAWAS ULU, MUSI RAWAS UTARA, SUMATERA SELATAN",4,30,125,155
https://kawalpemilu.org#17832,"GADING SARI, MESUJI MAKMUR, OGAN KOMERING ILIR, SUMATERA SELATAN",2,66,205,271
https://kawalpemilu.org#18591,"PENANDINGAN, TANJUNG SAKTI PUMI, LAHAT, SUMATERA SELATAN",2,101,114,215
https://kawalpemilu.org#19619,"SUKA MULYA, SEMENDAWAI SUKU III, OGAN KOMERING ULU TIMUR, SUMATERA SELATAN",3,62,141,203
https://kawalpemilu.org#11458,"BANDAR TENGAH, BANDAR KHALIFAH, SERDANG BEDAGAI, SUMATERA UTARA",6,129,43,172
https://kawalpemilu.org#7477,"ENDA PORTIBI, SIATAS BARITA, TAPANULI UTARA, SUMATERA UTARA",3,177,10,187
https://kawalpemilu.org#9593,"HUTA PADANG, BANDAR PASIR MANDOGE, ASAHAN, SUMATERA UTARA",6,154,47,201
https://kawalpemilu.org#9858,"PAGAGAN JULU II, SUMBUL, DAIRI, SUMATERA UTARA",1,202,4,206
https://kawalpemilu.org#11911,"TANJUNG SARI, MEDAN SELAYANG, KOTA MEDAN, SUMATERA UTARA",106,95,70,165
https://kawalpemilu.org#8793,"TUNTUNGAN II, PANCUR BATU, DELI SERDANG, SUMATERA UTARA",13,133,49,182
https://kawalpemilu.org#11805,"BELAWAN II, MEDAN BELAWAN, KOTA MEDAN, SUMATERA UTARA",34,44,106,150
https://kawalpemilu.org#8935,"BATU LOKONG, GALANG, DELI SERDANG, SUMATERA UTARA",1,77,163,240
https://kawalpemilu.org#11566,"NAGA KESIANGAN, TEBING TINGGI, SERDANG BEDAGAI, SUMATERA UTARA",6,64,106,170
https://kawalpemilu.org#9020,"KENANGAN BARU, PERCUT SEI TUAN, DELI SERDANG, SUMATERA UTARA",28,75,107,182
https://kawalpemilu.org#12728,"PULO BARIANG, HURISTAK, PADANG LAWAS, SUMATERA UTARA",1,32,87,119
https://kawalpemilu.org#6743,"PERK. TELUK PANJI, KAMPUNG RAKYAT, LABUHANBATU SELATAN, SUMATERA UTARA",16,87,50,137
https://kawalpemilu.org#10559,"LUBUK KAPUNDUNG, MUARA BATANG GADIS, MANDAILING NATAL, SUMATERA UTARA",1,10,147,157
https://kawalpemilu.org#11493,"RIMBUN, SIPISPIS, SERDANG BEDAGAI, SUMATERA UTARA",5,133,29,162
https://kawalpemilu.org#12183,"PALOPAT PK, PADANG SIDEMPUAN TENGGARA, KOTA PADANG SIDEMPUAN, SUMATERA UTARA",7,35,135,170
https://kawalpemilu.org#10634,"SINUNUKAN I CENTRAL, SINUNUKAN, MANDAILING NATAL, SUMATERA UTARA",2,140,103,243
https://kawalpemilu.org#11595,"SEI BAMBAN, SEI BAMBAN, SERDANG BEDAGAI, SUMATERA UTARA",43,54,64,118
https://kawalpemilu.org#8786,"NAMO SIMPUR, PANCUR BATU, DELI SERDANG, SUMATERA UTARA",5,140,12,152
https://kawalpemilu.org#87776,"PELANGGIRAN LAUT TADOR, SEI SUKA, BATU BARA, SUMATERA UTARA",8,78,121,199
https://kawalpemilu.org#11365,"GAROGA, SIMANINDO, SAMOSIR, SUMATERA UTARA",3,189,3,192
https://kawalpemilu.org#8717,"TANJUNG MORAWA A, TANJUNG MORAWA, DELI SERDANG, SUMATERA UTARA",36,42,95,137
https://kawalpemilu.org#11582,"BINGKAT, PEGAJAHAN, SERDANG BEDAGAI, SUMATERA UTARA",15,90,20,110
https://kawalpemilu.org#9526,"SEI PAHAM, SEI KEPAYANG, ASAHAN, SUMATERA UTARA",9,12,209,221
https://kawalpemilu.org#8369,"SAWIT SEBERANG, SAWIT SEBERANG, LANGKAT, SUMATERA UTARA",1,147,81,228
https://kawalpemilu.org#11765,"HELVETIA, MEDAN HELVETIA, KOTA MEDAN, SUMATERA UTARA",29,116,122,238
https://kawalpemilu.org#11774,"TEGAL S MANDALA II, MEDAN DENAI, KOTA MEDAN, SUMATERA UTARA",6,73,144,217
https://kawalpemilu.org#12107,"DURIAN, BAJENIS, KOTA TEBING TINGGI, SUMATERA UTARA",8,33,148,181
https://kawalpemilu.org#8751,"SAYUM SABAH, SIBOLANGIT, DELI SERDANG, SUMATERA UTARA",2,157,20,177
https://kawalpemilu.org#8416,"KABAN, KABANJAHE, KARO, SUMATERA UTARA",3,228,8,236
https://kawalpemilu.org#11855,"BANTAN, MEDAN TEMBUNG, KOTA MEDAN, SUMATERA UTARA",40,83,155,238
https://kawalpemilu.org#9024,"PERCUT, PERCUT SEI TUAN, DELI SERDANG, SUMATERA UTARA",13,36,146,182
https://kawalpemilu.org#7051,"GUNUNG CAHAYA, SIROMBU, NIAS BARAT, SUMATERA UTARA",1,180,9,189
https://kawalpemilu.org#8405,"SERANG JAYA HILIR, PEMATANG JAYA, LANGKAT, SUMATERA UTARA",2,41,144,185
https://kawalpemilu.org#11325,"SABUNGAN NIHUTA, RONGGUR NIHUTA, SAMOSIR, SUMATERA UTARA",1,215,10,225
https://kawalpemilu.org#12037,"SELAT TANJUNG MEDAN, DATUK BANDAR TIMUR, KOTA TANJUNG BALAI, SUMATERA UTARA",7,20,122,142
https://kawalpemilu.org#11814,"HARJOSARI I, MEDAN AMPLAS, KOTA MEDAN, SUMATERA UTARA",22,83,63,146
https://kawalpemilu.org#12112,"PINANG MANCUNG, BAJENIS, KOTA TEBING TINGGI, SUMATERA UTARA",5,83,92,175
https://kawalpemilu.org#8968,"DELI TUA TIMUR, DELI TUA, DELI SERDANG, SUMATERA UTARA",6,121,77,198
https://kawalpemilu.org#8123,"UJUNG TERAN, SALAPIAN, LANGKAT, SUMATERA UTARA",1,120,46,166
https://kawalpemilu.org#7434,"PONDOK BATU, SARUDIK, TAPANULI TENGAH, SUMATERA UTARA",3,146,46,192
https://kawalpemilu.org#8797,"SEI GLUGUR, PANCUR BATU, DELI SERDANG, SUMATERA UTARA",2,113,116,229
https://kawalpemilu.org#7315,"TAPIAN NAULI III, TAPIAN NAULI, TAPANULI TENGAH, SUMATERA UTARA",1,211,19,230
https://kawalpemilu.org#9035,"MEDAN ESTATE, PERCUT SEI TUAN, DELI SERDANG, SUMATERA UTARA",17,117,43,160
https://kawalpemilu.org#11669,"SUKARAJA, AIR PUTIH, BATU BARA, SUMATERA UTARA",12,110,24,134
https://kawalpemilu.org#90001,"SEPAKAT, HIBALA, NIAS SELATAN, SUMATERA UTARA",2,43,5,48
https://kawalpemilu.org#7522,"LUMBAN TONGA, PAHAE JULU, TAPANULI UTARA, SUMATERA UTARA",2,154,9,163
https://kawalpemilu.org#929235,"SORKAM TENGAH, SORKAM, TAPANULI TENGAH, SUMATERA UTARA",1,72,185,257
https://kawalpemilu.org#9030,"SAMPALI, PERCUT SEI TUAN, DELI SERDANG, SUMATERA UTARA",34,27,184,211
https://kawalpemilu.org#8283,"TEBING TANJUNG SELAMAT, PADANG TUALANG, LANGKAT, SUMATERA UTARA",17,95,62,157
https://kawalpemilu.org#11286,"ONAN RUNGGU, ONAN RUNGGU, SAMOSIR, SUMATERA UTARA",4,127,6,133
https://kawalpemilu.org#11756,"SITIREJO I, MEDAN KOTA, KOTA MEDAN, SUMATERA UTARA",21,179,5,184
https://kawalpemilu.org#9839,"BATANG BERUH, SIDIKALANG, DAIRI, SUMATERA UTARA",29,252,12,264
https://kawalpemilu.org#8044,"LEWA LEWA, MA'U, NIAS, SUMATERA UTARA",1,150,17,167
