Link KawalPemilu,Nama Kelurahan,Nomor TPS,Suara 01,Suara 02,Suara Sah
https://kawalpemilu.org#3279,"LANCANG BARAT, DEWANTARA, ACEH UTARA, ACEH",38,10,225,235
https://kawalpemilu.org#3829,"SAWANG, SAWANG, ACEH UTARA, ACEH",91,4,90,94
https://kawalpemilu.org#3809,"LHOK KUYUN, SAWANG, ACEH UTARA, ACEH",31,3,117,120
https://kawalpemilu.org#3273,"BANGKA JAYA, DEWANTARA, ACEH UTARA, ACEH",9,11,184,195
https://kawalpemilu.org#2204,"ARON, KUTA BARO, ACEH BESAR, ACEH",1,8,111,119
https://kawalpemilu.org#5026,"IE LHOP, TANGAN-TANGAN, ACEH BARAT DAYA, ACEH",1,13,181,194
https://kawalpemilu.org#935,"ALUE MULIENG, SIMPANG ULIM, ACEH TIMUR, ACEH",2,9,117,126
https://kawalpemilu.org#2285,"LON ASAN, LEMBAH SEULAWAH, ACEH BESAR, ACEH",2,23,137,160
https://kawalpemilu.org#5214,"EKAN, PINING, GAYO LUES, ACEH",2,32,52,84
https://kawalpemilu.org#5069,"LAMPOH DRIEN, SUSOH, ACEH BARAT DAYA, ACEH",2,23,144,167
https://kawalpemilu.org#2104,"MEUNASAH TUHA, PEUKAN BADA, ACEH BESAR, ACEH",2,19,153,172
https://kawalpemilu.org#6639,"PAYA BUJOK SEULEUMAK, LANGSA BARO, KOTA LANGSA, ACEH",4,25,186,211
https://kawalpemilu.org#5791,"PAYA META, KARANG BARU, ACEH TAMIANG, ACEH",1,23,222,245
https://kawalpemilu.org#2838,"TEUNGOH BAROH, PEUKAN BARO, PIDIE, ACEH",1,25,197,222
https://kawalpemilu.org#1511,"SUAK RAYA, JOHAN PAHWALAN, ACEH BARAT, ACEH",2,18,228,246
https://kawalpemilu.org#84152,"SITAL, TEUPAH BARAT, SIMEULUE, ACEH",1,101,81,182
https://kawalpemilu.org#730,"JULOK TUNONG, JULOK, ACEH TIMUR, ACEH",1,17,198,215
https://kawalpemilu.org#3546,"PUUK, SAMUDERA, ACEH UTARA, ACEH",73,5,188,193
https://kawalpemilu.org#746,"SEUMATANG, JULOK, ACEH TIMUR, ACEH",2,7,93,100
https://kawalpemilu.org#3829,"SAWANG, SAWANG, ACEH UTARA, ACEH",85,16,170,186
https://kawalpemilu.org#158,"RAKET, TRUMON, ACEH SELATAN, ACEH",1,34,106,140
https://kawalpemilu.org#6540,"SIMPANG EMPAT, BANDA SAKTI, KOTA LHOKSEUMAWE, ACEH",6,14,170,184
https://kawalpemilu.org#2526,"METAREUM, DELIMA, PIDIE, ACEH",1,10,169,179
https://kawalpemilu.org#6437,"PUNGE UJONG, MEURAXA, KOTA BANDA ACEH, ACEH",3,22,206,228
https://kawalpemilu.org#6394,"KUTA PANGWA, TRIENGGADENG, PIDIE JAYA, ACEH",2,13,176,189
https://kawalpemilu.org#1838,"TEUNGOH GEUNTEUT, LHOONG, ACEH BESAR, ACEH",1,51,179,230
https://kawalpemilu.org#2675,"GAMPONG ASAN, KOTA SIGLI, PIDIE, ACEH",1,11,174,185
https://kawalpemilu.org#5098,"BLANG DALAM, BABAH ROT, ACEH BARAT DAYA, ACEH",2,18,208,226
https://kawalpemilu.org#967,"ALUE GEUNTENG, RANTAU PEUREULAK, ACEH TIMUR, ACEH",4,10,168,178
https://kawalpemilu.org#6401,"SUKARAMAI, BAITURRAHMAN, KOTA BANDA ACEH, ACEH",2,61,170,231
https://kawalpemilu.org#766,"BANTAYAN TIMU, IDI RAYEUK, ACEH TIMUR, ACEH",1,10,138,148
https://kawalpemilu.org#11,"KRUENG BATEE, KLUET UTARA, ACEH SELATAN, ACEH",1,8,184,192
https://kawalpemilu.org#1739,"MEUREUBO, MEUREUBO, ACEH BARAT, ACEH",3,46,196,242
https://kawalpemilu.org#3455,"MANE TUNONG, MUARA BATU, ACEH UTARA, ACEH",7,5,119,124
https://kawalpemilu.org#2807,"COT KEUTAPANG TANJONG, PADANG TIJI, PIDIE, ACEH",1,15,220,235
https://kawalpemilu.org#4568,"TANJONG NIE, PEUSANGAN, BIREUEN, ACEH",1,8,185,193
https://kawalpemilu.org#874,"LEUGE, PEUREULAK, ACEH TIMUR, ACEH",3,11,172,183
https://kawalpemilu.org#4367,"MEULIEK, SAMALANGA, BIREUEN, ACEH",2,15,183,198
https://kawalpemilu.org#131,"SAWANG BA'U, SAWANG, ACEH SELATAN, ACEH",1,11,195,206
https://kawalpemilu.org#5674,"SARAH MANTOK, TADU RAYA, NAGAN RAYA, ACEH",1,9,84,93
https://kawalpemilu.org#6432,"GAMPONG PIE, MEURAXA, KOTA BANDA ACEH, ACEH",2,14,112,126
https://kawalpemilu.org#5283,"KUALA JERNIH, TERIPE JAYA, GAYO LUES, ACEH",1,89,56,145
https://kawalpemilu.org#6634,"BARO, LANGSA LAMA, KOTA LANGSA, ACEH",3,16,214,230
https://kawalpemilu.org#53344,"SEMBUNG GEDE, KERAMBITAN, TABANAN, BALI",6,172,16,188
https://kawalpemilu.org#53594,"SUANA, NUSA PENIDA, KLUNGKUNG, BALI",9,148,18,166
https://kawalpemilu.org#53894,"PEGADUNGAN, SUKASADA, BULELENG, BALI",10,155,1,156
https://kawalpemilu.org#53310,"BAJERA UTARA, SELEMADEG, TABANAN, BALI",3,241,4,245
https://kawalpemilu.org#53456,"SEMBUNG, MENGWI, BADUNG, BALI",17,207,2,209
https://kawalpemilu.org#53628,"KAMPUNG GELGEL, KLUNGKUNG, KLUNGKUNG, BALI",1,67,185,252
https://kawalpemilu.org#53352,"DELOD PEKEN, TABANAN, TABANAN, BALI",25,221,34,255
https://kawalpemilu.org#53475,"ABIANSEMAL, ABIANSEMAL, BADUNG, BALI",14,274,3,277
https://kawalpemilu.org#53930,"JINENG DALEM, BULELENG, BULELENG, BALI",2,170,6,176
https://kawalpemilu.org#53987,"DANGIN PURI, DENPASAR TIMUR, KOTA DENPASAR, BALI",2,221,8,229
https://kawalpemilu.org#53817,"PEJARAKAN, GEROKGAK, BULELENG, BALI",29,210,10,220
https://kawalpemilu.org#53775,"TISTA, ABANG, KARANGASEM, BALI",9,120,5,125
https://kawalpemilu.org#54005,"TEGAL KERTHA, DENPASAR BARAT, KOTA DENPASAR, BALI",16,145,53,198
https://kawalpemilu.org#53285,"TUWED, MELAYA, JEMBRANA, BALI",7,150,66,216
https://kawalpemilu.org#53364,"BELALANG, KEDIRI, TABANAN, BALI",8,194,3,197
https://kawalpemilu.org#53931,"PENGELATAN, BULELENG, BULELENG, BALI",6,219,20,239
https://kawalpemilu.org#53791,"JUNGUTAN, BEBANDEM, KARANGASEM, BALI",27,183,5,188
https://kawalpemilu.org#53530,"MEDAHAN, BLAHBATUH, GIANYAR, BALI",5,220,15,235
https://kawalpemilu.org#53975,"PEDUNGAN, DENPASAR SELATAN, KOTA DENPASAR, BALI",21,203,24,227
https://kawalpemilu.org#53930,"JINENG DALEM, BULELENG, BULELENG, BALI",13,218,14,232
https://kawalpemilu.org#53807,"KUBU, KUBU, KARANGASEM, BALI",12,213,9,222
https://kawalpemilu.org#54000,"DAUH PURI KELOD, DENPASAR BARAT, KOTA DENPASAR, BALI",8,154,31,185
https://kawalpemilu.org#53250,"BANYUBIRU, NEGARA, JEMBRANA, BALI",13,54,178,232
https://kawalpemilu.org#53926,"NAGA SEPAHA, BULELENG, BULELENG, BALI",4,214,27,241
https://kawalpemilu.org#53944,"SANGSIT, SAWAN, BULELENG, BALI",1,109,72,181
https://kawalpemilu.org#53916,"KAMPUNG  ANYAR, BULELENG, BULELENG, BALI",13,176,26,202
https://kawalpemilu.org#53676,"BANGBANG, TEMBUKU, BANGLI, BALI",1,148,2,150
https://kawalpemilu.org#53937,"SUDAJI, SAWAN, BULELENG, BALI",10,142,3,145
https://kawalpemilu.org#53853,"SEPANG, BUSUNG BIU, BULELENG, BALI",3,142,22,238
https://kawalpemilu.org#53617,"TOHPATI, BANJARANGKAN, KLUNGKUNG, BALI",4,194,9,203
https://kawalpemilu.org#53739,"SANGKAN GUNUNG, SIDEMEN, KARANGASEM, BALI",18,202,7,209
https://kawalpemilu.org#53074,"BANJAR NEGARA, CIWANDAN, KOTA CILEGON, BANTEN",17,58,165,223
https://kawalpemilu.org#52950,"GANDASARI, JATIUWUNG, KOTA TANGERANG, BANTEN",47,125,132,257
https://kawalpemilu.org#53213,"CIPUTAT, CIPUTAT, KOTA TANGERANG SELATAN, BANTEN",12,99,117,216
https://kawalpemilu.org#52888,"BANJARSARI, ANYAR, SERANG, BANTEN",9,101,111,212
https://kawalpemilu.org#52105,"MUARA CIUJUNG TIMUR, RANGKASBITUNG, LEBAK, BANTEN",30,64,202,266
https://kawalpemilu.org#53144,"PIPITAN, WALANTAKA, KOTA SERANG, BANTEN",19,52,178,230
https://kawalpemilu.org#53000,"GERENDENG, KARAWACI, KOTA TANGERANG, BANTEN",12,66,111,177
https://kawalpemilu.org#53193,"PAKU JAYA, SERPONG UTARA, KOTA TANGERANG SELATAN, BANTEN",57,108,88,196
https://kawalpemilu.org#51764,"SIRNAGALIH, MANDALAWANGI, PANDEGLANG, BANTEN",8,39,137,176
https://kawalpemilu.org#52248,"CIKATAPIS, KALANGANYAR, LEBAK, BANTEN",4,72,176,248
https://kawalpemilu.org#53163,"TEMBONG, CIPOCOK JAYA, KOTA SERANG, BANTEN",15,51,129,180
https://kawalpemilu.org#52012,"BULAKAN, GUNUNGKENCANA, LEBAK, BANTEN",10,129,80,209
https://kawalpemilu.org#53231,"KEDAUNG, PAMULANG, KOTA TANGERANG SELATAN, BANTEN",104,108,77,185
https://kawalpemilu.org#51782,"GUNUNGDATAR, CIMANUK, PANDEGLANG, BANTEN",3,80,131,211
https://kawalpemilu.org#53133,"CIGOONG, WALANTAKA, KOTA SERANG, BANTEN",1,55,184,239
https://kawalpemilu.org#53116,"LONTAR BARU, SERANG, KOTA SERANG, BANTEN",16,88,179,267
https://kawalpemilu.org#52372,"SASAK, MAUK, TANGERANG, BANTEN",16,74,126,200
https://kawalpemilu.org#52404,"SUKAMANAH, RAJEG, TANGERANG, BANTEN",1,86,112,198
https://kawalpemilu.org#52895,"BULAKAN, CINANGKA, SERANG, BANTEN",9,53,102,155
https://kawalpemilu.org#53036,"PANUNGGANGAN TIMUR, PINANG, KOTA TANGERANG, BANTEN",5,64,115,179
https://kawalpemilu.org#53215,"SERUA INDAH, CIPUTAT, KOTA TANGERANG SELATAN, BANTEN",34,56,79,135
https://kawalpemilu.org#52649,"GOSARA, CIRUAS, SERANG, BANTEN",4,55,124,179
https://kawalpemilu.org#52394,"KOSAMBI, SUKADIRI, TANGERANG, BANTEN",8,29,153,182
https://kawalpemilu.org#53226,"PAMULANG BARAT, PAMULANG, KOTA TANGERANG SELATAN, BANTEN",152,132,46,178
https://kawalpemilu.org#53125,"BENDUNG, KASEMEN, KOTA SERANG, BANTEN",17,36,147,183
https://kawalpemilu.org#52490,"PASIR JAYA, CIKUPA, TANGERANG, BANTEN",34,61,68,129
https://kawalpemilu.org#52536,"KALIASIN, SUKAMULYA, TANGERANG, BANTEN",23,86,130,216
https://kawalpemilu.org#53027,"SUDIMARA PINANG, PINANG, KOTA TANGERANG, BANTEN",9,36,101,137
https://kawalpemilu.org#52560,"JATI MULYA, SEPATAN TIMUR, TANGERANG, BANTEN",6,54,132,186
https://kawalpemilu.org#53110,"SUMUR PECUNG, SERANG, KOTA SERANG, BANTEN",46,69,152,221
https://kawalpemilu.org#52844,"JUNTI, JAWILAN, SERANG, BANTEN",11,60,190,250
https://kawalpemilu.org#51917,"SUKARAJA, MALINGPING, LEBAK, BANTEN",7,145,72,217
https://kawalpemilu.org#51810,"BABAKAN KALANGANYAR, PANDEGLANG, PANDEGLANG, BANTEN",15,69,124,193
https://kawalpemilu.org#52543,"KELAPA DUA, KELAPA DUA, TANGERANG, BANTEN",23,70,143,213
https://kawalpemilu.org#53226,"PAMULANG BARAT, PAMULANG, KOTA TANGERANG SELATAN, BANTEN",72,120,127,247
https://kawalpemilu.org#53023,"KARANG ANYAR, NEGLASARI, KOTA TANGERANG, BANTEN",31,61,169,230
https://kawalpemilu.org#53226,"PAMULANG BARAT, PAMULANG, KOTA TANGERANG SELATAN, BANTEN",44,85,96,181
https://kawalpemilu.org#52552,"SUKAHARJA, SINDANG JAYA, TANGERANG, BANTEN",18,39,121,160
https://kawalpemilu.org#52998,"PABUARAN TUMPENG, KARAWACI, KOTA TANGERANG, BANTEN",22,70,134,204
https://kawalpemilu.org#52127,"SELARAJA, WARUNGGUNUNG, LEBAK, BANTEN",6,61,162,223
https://kawalpemilu.org#52788,"SUKACAI, BAROS, SERANG, BANTEN",11,37,94,131
https://kawalpemilu.org#53038,"KARANG TENGAH, KARANG TENGAH, KOTA TANGERANG, BANTEN",46,118,109,227
https://kawalpemilu.org#53078,"KEPUH, CIWANDAN, KOTA CILEGON, BANTEN",5,33,215,248
https://kawalpemilu.org#53014,"PANUNGGANGAN BARAT, CIBODAS, KOTA TANGERANG, BANTEN",36,94,162,256
https://kawalpemilu.org#52958,"KEBON BESAR, BATUCEPER, KOTA TANGERANG, BANTEN",34,107,107,214
https://kawalpemilu.org#52398,"SUKATANI, RAJEG, TANGERANG, BANTEN",24,70,105,175
https://kawalpemilu.org#53078,"KEPUH, CIWANDAN, KOTA CILEGON, BANTEN",7,34,233,267
https://kawalpemilu.org#52548,"CURUG SANGERENG, KELAPA DUA, TANGERANG, BANTEN",2,75,121,196
https://kawalpemilu.org#53133,"CIGOONG, WALANTAKA, KOTA SERANG, BANTEN",8,47,186,233
https://kawalpemilu.org#52341,"CEMPAKA, CISOKA, TANGERANG, BANTEN",7,93,89,182
https://kawalpemilu.org#53124,"WARUNG JAUD, KASEMEN, KOTA SERANG, BANTEN",10,96,98,194
https://kawalpemilu.org#53204,"PONDOK KACANG BARAT, PONDOK AREN, KOTA TANGERANG SELATAN, BANTEN",49,97,77,174
https://kawalpemilu.org#89640,"CIKANDE PERMAI, CIKANDE, SERANG, BANTEN",12,57,141,198
https://kawalpemilu.org#51848,"PAGADUNGAN, KARANG TANJUNG, PANDEGLANG, BANTEN",19,26,165,191
https://kawalpemilu.org#52738,"TAMBAK, KIBIN, SERANG, BANTEN",21,50,29,79
https://kawalpemilu.org#53216,"JOMBANG, CIPUTAT, KOTA TANGERANG SELATAN, BANTEN",12,94,87,181
https://kawalpemilu.org#52546,"PAKULONAN BARAT, KELAPA DUA, TANGERANG, BANTEN",49,242,5,247
https://kawalpemilu.org#53102,"TAMAN BARU, CITANGKIL, KOTA CILEGON, BANTEN",1,64,137,201
https://kawalpemilu.org#52968,"CIPONDOH, CIPONDOH, KOTA TANGERANG, BANTEN",25,51,203,254
https://kawalpemilu.org#52969,"CIPONDOH MAKMUR, CIPONDOH, KOTA TANGERANG, BANTEN",49,99,115,214
https://kawalpemilu.org#52357,"KRONJO, KRONJO, TANGERANG, BANTEN",23,59,134,193
https://kawalpemilu.org#52509,"PALASARI, LEGOK, TANGERANG, BANTEN",32,109,123,232
https://kawalpemilu.org#52413,"KUTABUMI, PASAR KEMIS, TANGERANG, BANTEN",53,77,96,173
https://kawalpemilu.org#51660,"CIBITUNG, MUNJUL, PANDEGLANG, BANTEN",7,85,78,163
https://kawalpemilu.org#52670,"TERAS BENDUNG, LEBAK WANGI, SERANG, BANTEN",8,92,97,189
https://kawalpemilu.org#53026,"PINANG, PINANG, KOTA TANGERANG, BANTEN",2,50,106,156
https://kawalpemilu.org#53014,"PANUNGGANGAN BARAT, CIBODAS, KOTA TANGERANG, BANTEN",9,70,107,177
https://kawalpemilu.org#52520,"SITU GADUNG, PAGEDANGAN, TANGERANG, BANTEN",22,225,33,258
https://kawalpemilu.org#52611,"WARINGINKURUNG, WARINGINKURUNG, SERANG, BANTEN",1,28,203,231
https://kawalpemilu.org#52778,"KEMUNING, TUNJUNG TEJA, SERANG, BANTEN",5,55,169,224
https://kawalpemilu.org#53064,"CIWEDUS, CILEGON, KOTA CILEGON, BANTEN",25,78,115,193
https://kawalpemilu.org#52398,"SUKATANI, RAJEG, TANGERANG, BANTEN",3,103,113,216
https://kawalpemilu.org#52452,"BUARAN BAMBU, PAKUHAJI, TANGERANG, BANTEN",5,67,138,205
https://kawalpemilu.org#52877,"CIPAYUNG, PADARINCANG, SERANG, BANTEN",4,42,148,190
https://kawalpemilu.org#89644,"CILAYANG GUHA, CIKEUSAL, SERANG, BANTEN",6,32,176,208
https://kawalpemilu.org#52985,"SUDIMARA SELATAN, CILEDUG, KOTA TANGERANG, BANTEN",2,67,138,205
https://kawalpemilu.org#52494,"MEKAR BAKTI, PANONGAN, TANGERANG, BANTEN",15,98,93,191
https://kawalpemilu.org#52458,"KIARA PAYUNG, PAKUHAJI, TANGERANG, BANTEN",16,84,144,228
https://kawalpemilu.org#52290,"CANGKUDU, BALARAJA, TANGERANG, BANTEN",35,70,92,162
https://kawalpemilu.org#53052,"CIPADU JAYA, LARANGAN, KOTA TANGERANG, BANTEN",32,89,151,240
https://kawalpemilu.org#52968,"CIPONDOH, CIPONDOH, KOTA TANGERANG, BANTEN",49,146,115,261
https://kawalpemilu.org#52983,"PARUNG SERAB, CILEDUG, KOTA TANGERANG, BANTEN",16,75,131,206
https://kawalpemilu.org#51851,"KARYASARI, CIKEDAL, PANDEGLANG, BANTEN",3,51,96,147
https://kawalpemilu.org#21057,"PINO BARU, AIR NIPIS, BENGKULU SELATAN, BENGKULU",5,116,30,146
https://kawalpemilu.org#21469,"TANJUNG KARET, AIR BESI, BENGKULU UTARA, BENGKULU",1,41,125,166
https://kawalpemilu.org#21845,"PADANG GENTING, SELUMA SELATAN, SELUMA, BENGKULU",2,76,78,154
https://kawalpemilu.org#21853,"PERING BARU, TALO KECIL, SELUMA, BENGKULU",1,115,76,191
https://kawalpemilu.org#22209,"TABA MULAN, MERIGI, KEPAHIANG, BENGKULU",1,69,83,152
https://kawalpemilu.org#22210,"LUBUK PENYAMUN, MERIGI, KEPAHIANG, BENGKULU",2,79,84,163
https://kawalpemilu.org#22309,"LEMPUING, RATU AGUNG, KOTA BENGKULU, BENGKULU",3,102,107,209
https://kawalpemilu.org#21510,"TANJUNG AUR, TANJUNG KEMUNING, KAUR, BENGKULU",1,102,70,172
https://kawalpemilu.org#21182,"PAHLAWAN, CURUP UTARA, REJANG LEBONG, BENGKULU",3,73,99,172
https://kawalpemilu.org#21643,"UMBUL, LUAS, KAUR, BENGKULU",2,56,61,117
https://kawalpemilu.org#22130,"AIR KOPRAS, PINANG BELAPIS, LEBONG, BENGKULU",4,84,105,189
https://kawalpemilu.org#21802,"PADANG CAPO ILIR, LUBUK SANDI, SELUMA, BENGKULU",1,90,61,151
https://kawalpemilu.org#21108,"GURU AGUNG, PADANG ULAK TANDING, REJANG LEBONG, BENGKULU",4,31,98,129
https://kawalpemilu.org#21522,"PADANG KEDONDONG, TANJUNG KEMUNING, KAUR, BENGKULU",1,85,83,168
https://kawalpemilu.org#21174,"TUNAS HARAPAN, CURUP UTARA, REJANG LEBONG, BENGKULU",5,64,124,188
https://kawalpemilu.org#21448,"AIR PUTIH, MARGA SAKTI SEBELAT, BENGKULU UTARA, BENGKULU",3,151,59,210
https://kawalpemilu.org#42352,"PAKUNCEN, WIROBRAJAN, KOTA YOGYAKARTA, DAERAH ISTIMEWA YOGYAKARTA",24,111,87,198
https://kawalpemilu.org#42011,"WUKIRSARI, IMOGIRI, BANTUL, DAERAH ISTIMEWA YOGYAKARTA",21,167,60,227
https://kawalpemilu.org#42148,"TAMBAKROMO, PONJONG, GUNUNGKIDUL, DAERAH ISTIMEWA YOGYAKARTA",2,95,32,127
https://kawalpemilu.org#42284,"WEDOMARTANI, NGEMPLAK, SLEMAN, DAERAH ISTIMEWA YOGYAKARTA",26,181,64,245
https://kawalpemilu.org#42167,"KALITEKUK, SEMIN, GUNUNGKIDUL, DAERAH ISTIMEWA YOGYAKARTA",2,119,45,164
https://kawalpemilu.org#42150,"SUMBERGIRI, PONJONG, GUNUNGKIDUL, DAERAH ISTIMEWA YOGYAKARTA",11,133,37,170
https://kawalpemilu.org#42012,"KEBONAGUNG, IMOGIRI, BANTUL, DAERAH ISTIMEWA YOGYAKARTA",5,147,64,211
https://kawalpemilu.org#42238,"SUMBERSARI, MOYUDAN, SLEMAN, DAERAH ISTIMEWA YOGYAKARTA",3,46,182,228
https://kawalpemilu.org#42294,"CATURHARJO, SLEMAN, SLEMAN, DAERAH ISTIMEWA YOGYAKARTA",24,131,55,186
https://kawalpemilu.org#42229,"SIDOREJO, GODEAN, SLEMAN, DAERAH ISTIMEWA YOGYAKARTA",3,140,64,204
https://kawalpemilu.org#42021,"TEMUWUH, DLINGO, BANTUL, DAERAH ISTIMEWA YOGYAKARTA",18,196,30,226
https://kawalpemilu.org#41958,"NGARGOSARI, SAMIGALUH, KULON PROGO, DAERAH ISTIMEWA YOGYAKARTA",5,182,46,228
https://kawalpemilu.org#42327,"KRICAK, TEGALREJO, KOTA YOGYAKARTA, DAERAH ISTIMEWA YOGYAKARTA",39,186,60,246
https://kawalpemilu.org#41968,"TRIMURTI, SRANDAKAN, BANTUL, DAERAH ISTIMEWA YOGYAKARTA",17,133,44,177
https://kawalpemilu.org#42343,"TEGALPANGGUNG, DANUREJAN, KOTA YOGYAKARTA, DAERAH ISTIMEWA YOGYAKARTA",7,173,60,233
https://kawalpemilu.org#42175,"PUNDUNGSARI, SEMIN, GUNUNGKIDUL, DAERAH ISTIMEWA YOGYAKARTA",8,202,12,214
https://kawalpemilu.org#42195,"JETIS, SAPTOSARI, GUNUNGKIDUL, DAERAH ISTIMEWA YOGYAKARTA",18,105,24,129
https://kawalpemilu.org#42339,"BACIRO, GONDOKUSUMAN, KOTA YOGYAKARTA, DAERAH ISTIMEWA YOGYAKARTA",7,126,78,204
https://kawalpemilu.org#41985,"SIDOMULYO, BAMBANGLIPURO, BANTUL, DAERAH ISTIMEWA YOGYAKARTA",43,188,30,218
https://kawalpemilu.org#42283,"WIDODOMARTANI, NGEMPLAK, SLEMAN, DAERAH ISTIMEWA YOGYAKARTA",6,132,89,221
https://kawalpemilu.org#42305,"MARGOREJO, TEMPEL, SLEMAN, DAERAH ISTIMEWA YOGYAKARTA",5,97,51,148
https://kawalpemilu.org#42084,"PLEMBUTAN, PLAYEN, GUNUNGKIDUL, DAERAH ISTIMEWA YOGYAKARTA",11,160,49,209
https://kawalpemilu.org#42044,"PENDOWOHARJO, SEWON, BANTUL, DAERAH ISTIMEWA YOGYAKARTA",29,155,51,206
https://kawalpemilu.org#42155,"SIDOREJO, PONJONG, GUNUNGKIDUL, DAERAH ISTIMEWA YOGYAKARTA",22,153,20,173
https://kawalpemilu.org#42073,"KARANGREJEK, WONOSARI, GUNUNGKIDUL, DAERAH ISTIMEWA YOGYAKARTA",11,178,31,209
https://kawalpemilu.org#42383,"PRENGGAN, KOTAGEDE, KOTA YOGYAKARTA, DAERAH ISTIMEWA YOGYAKARTA",6,143,95,238
https://kawalpemilu.org#42109,"SODO, PALIYAN, GUNUNGKIDUL, DAERAH ISTIMEWA YOGYAKARTA",14,167,77,244
https://kawalpemilu.org#42134,"DADAPAYU, SEMANU, GUNUNGKIDUL, DAERAH ISTIMEWA YOGYAKARTA",5,167,55,222
https://kawalpemilu.org#42281,"SINDUMARTANI, NGEMPLAK, SLEMAN, DAERAH ISTIMEWA YOGYAKARTA",3,127,121,248
https://kawalpemilu.org#25900,"WARAKAS, TANJUNG PRIOK, JAKARTA UTARA, DKI JAKARTA",80,90,110,200
https://kawalpemilu.org#26119,"PONDOK KOPI, DUREN SAWIT, JAKARTA TIMUR, DKI JAKARTA",54,104,139,243
https://kawalpemilu.org#26033,"CIPETE SELATAN, CILANDAK, JAKARTA SELATAN, DKI JAKARTA",100,76,118,194
https://kawalpemilu.org#26089,"CIPINANG BESAR UTARA, JATINEGARA, JAKARTA TIMUR, DKI JAKARTA",47,103,118,221
https://kawalpemilu.org#25892,"PLUIT, PENJARINGAN, JAKARTA UTARA, DKI JAKARTA",36,188,8,196
https://kawalpemilu.org#25888,"PENJARINGAN, PENJARINGAN, JAKARTA UTARA, DKI JAKARTA",74,144,102,246
https://kawalpemilu.org#25992,"TEBET BARAT, TEBET, JAKARTA SELATAN, DKI JAKARTA",75,118,128,246
https://kawalpemilu.org#25927,"DURI KOSAMBI, CENGKARENG, JAKARTA BARAT, DKI JAKARTA",108,150,145,295
https://kawalpemilu.org#25978,"KOTA BAMBU UTARA, PALMERAH, JAKARTA BARAT, DKI JAKARTA",44,75,147,222
https://kawalpemilu.org#26129,"KELAPA DUA WETAN, CIRACAS, JAKARTA TIMUR, DKI JAKARTA",126,110,147,4
https://kawalpemilu.org#25988,"KEMBANGAN SELATAN, KEMBANGAN, JAKARTA BARAT, DKI JAKARTA",54,84,92,176
https://kawalpemilu.org#25890,"KAPUK MUARA, PENJARINGAN, JAKARTA UTARA, DKI JAKARTA",105,162,47,209
https://kawalpemilu.org#26016,"CILANDAK TIMUR, PASAR MINGGU, JAKARTA SELATAN, DKI JAKARTA",25,100,84,184
https://kawalpemilu.org#25948,"PINANGSIA, TAMAN SARI, JAKARTA BARAT, DKI JAKARTA",2,206,15,221
https://kawalpemilu.org#25930,"KAPUK, CENGKARENG, JAKARTA BARAT, DKI JAKARTA",237,136,75,211
https://kawalpemilu.org#25980,"KEMANGGISAN, PALMERAH, JAKARTA BARAT, DKI JAKARTA",50,67,147,214
https://kawalpemilu.org#25906,"TUGU SELATAN, KOJA, JAKARTA UTARA, DKI JAKARTA",50,136,133,269
https://kawalpemilu.org#26058,"CIPEDAK, JAGAKARSA, JAKARTA SELATAN, DKI JAKARTA",39,136,116,252
https://kawalpemilu.org#25985,"MERUYA SELATAN, KEMBANGAN, JAKARTA BARAT, DKI JAKARTA",60,99,173,272
https://kawalpemilu.org#25984,"MERUYA UTARA, KEMBANGAN, JAKARTA BARAT, DKI JAKARTA",138,62,121,183
https://kawalpemilu.org#26094,"BATU AMPAR, KRAMATJATI, JAKARTA TIMUR, DKI JAKARTA",95,95,141,236
https://kawalpemilu.org#26053,"JAGAKARSA, JAGAKARSA, JAKARTA SELATAN, DKI JAKARTA",76,99,75,174
https://kawalpemilu.org#25962,"KEBON JERUK, KEBON JERUK, JAKARTA BARAT, DKI JAKARTA",98,106,113,219
https://kawalpemilu.org#26108,"PENGGILINGAN, CAKUNG, JAKARTA TIMUR, DKI JAKARTA",228,95,151,246
https://kawalpemilu.org#26008,"MAMPANG PRAPATAN, MAMPANG PRAPATAN, JAKARTA SELATAN, DKI JAKARTA",48,45,131,176
https://kawalpemilu.org#26106,"JATINEGARA, CAKUNG, JAKARTA TIMUR, DKI JAKARTA",169,109,103,212
https://kawalpemilu.org#26026,"GROGOL SELATAN, KEBAYORAN LAMA, JAKARTA SELATAN, DKI JAKARTA",95,122,97,219
https://kawalpemilu.org#25991,"TEBET TIMUR, TEBET, JAKARTA SELATAN, DKI JAKARTA",52,87,153,240
https://kawalpemilu.org#25891,"PEJAGALAN, PENJARINGAN, JAKARTA UTARA, DKI JAKARTA",148,205,36,241
https://kawalpemilu.org#26092,"TENGAH, KRAMATJATI, JAKARTA TIMUR, DKI JAKARTA",16,160,85,245
https://kawalpemilu.org#25918,"PADEMANGAN BARAT, PADEMANGAN, JAKARTA UTARA, DKI JAKARTA",26,163,63,226
https://kawalpemilu.org#26020,"KEBAGUSAN, PASAR MINGGU, JAKARTA SELATAN, DKI JAKARTA",85,92,121,213
https://kawalpemilu.org#26029,"CILANDAK BARAT, CILANDAK, JAKARTA SELATAN, DKI JAKARTA",99,87,51,138
https://kawalpemilu.org#26002,"KARET, SETIABUDI, JAKARTA SELATAN, DKI JAKARTA",8,158,52,210
https://kawalpemilu.org#25890,"KAPUK MUARA, PENJARINGAN, JAKARTA UTARA, DKI JAKARTA",21,164,18,182
https://kawalpemilu.org#25984,"MERUYA UTARA, KEMBANGAN, JAKARTA BARAT, DKI JAKARTA",65,127,123,250
https://kawalpemilu.org#25899,"SUNTER AGUNG, TANJUNG PRIOK, JAKARTA UTARA, DKI JAKARTA",31,152,75,227
https://kawalpemilu.org#26008,"MAMPANG PRAPATAN, MAMPANG PRAPATAN, JAKARTA SELATAN, DKI JAKARTA",24,90,155,245
https://kawalpemilu.org#26002,"KARET, SETIABUDI, JAKARTA SELATAN, DKI JAKARTA",28,108,107,215
https://kawalpemilu.org#25904,"LAGOA, KOJA, JAKARTA UTARA, DKI JAKARTA",56,104,120,224
https://kawalpemilu.org#26099,"PEKAYON, PASAR REBO, JAKARTA TIMUR, DKI JAKARTA",117,92,150,242
https://kawalpemilu.org#25912,"KALIBARU, CILINCING, JAKARTA UTARA, DKI JAKARTA",163,85,142,227
https://kawalpemilu.org#26094,"BATU AMPAR, KRAMATJATI, JAKARTA TIMUR, DKI JAKARTA",103,86,148,234
https://kawalpemilu.org#25927,"DURI KOSAMBI, CENGKARENG, JAKARTA BARAT, DKI JAKARTA",46,87,141,228
https://kawalpemilu.org#26134,"CILANGKAP, CIPAYUNG, JAKARTA TIMUR, DKI JAKARTA",46,108,131,239
https://kawalpemilu.org#25911,"MARUNDA, CILINCING, JAKARTA UTARA, DKI JAKARTA",12,108,138,246
https://kawalpemilu.org#25931,"CENGKARENG TIMUR, CENGKARENG, JAKARTA BARAT, DKI JAKARTA",128,108,108,216
https://kawalpemilu.org#26054,"SRENGSENG SAWAH, JAGAKARSA, JAKARTA SELATAN, DKI JAKARTA",106,101,151,252
https://kawalpemilu.org#25976,"PALMERAH, PALMERAH, JAKARTA BARAT, DKI JAKARTA",199,88,166,254
https://kawalpemilu.org#26115,"KLENDER, DUREN SAWIT, JAKARTA TIMUR, DKI JAKARTA",127,116,148,264
https://kawalpemilu.org#26023,"PONDOK PINANG, KEBAYORAN LAMA, JAKARTA SELATAN, DKI JAKARTA",170,183,51,234
https://kawalpemilu.org#25910,"SUKAPURA, CILINCING, JAKARTA UTARA, DKI JAKARTA",67,61,147,208
https://kawalpemilu.org#26123,"KEBON PALA, MAKASAR, JAKARTA TIMUR, DKI JAKARTA",96,123,68,191
https://kawalpemilu.org#26105,"CAKUNG TIMUR, CAKUNG, JAKARTA TIMUR, DKI JAKARTA",39,82,174,256
https://kawalpemilu.org#25891,"PEJAGALAN, PENJARINGAN, JAKARTA UTARA, DKI JAKARTA",118,222,26,248
https://kawalpemilu.org#25929,"KEDAUNG KALI ANGKE, CENGKARENG, JAKARTA BARAT, DKI JAKARTA",56,128,143,271
https://kawalpemilu.org#26026,"GROGOL SELATAN, KEBAYORAN LAMA, JAKARTA SELATAN, DKI JAKARTA",26,168,24,192
https://kawalpemilu.org#25950,"TAMBORA, TAMBORA, JAKARTA BARAT, DKI JAKARTA",39,76,111,187
https://kawalpemilu.org#25962,"KEBON JERUK, KEBON JERUK, JAKARTA BARAT, DKI JAKARTA",156,65,151,216
https://kawalpemilu.org#25970,"KALIDERES, KALIDERES, JAKARTA BARAT, DKI JAKARTA",9,117,166,283
https://kawalpemilu.org#26084,"BALIMESTER, JATINEGARA, JAKARTA TIMUR, DKI JAKARTA",22,155,82,237
https://kawalpemilu.org#25878,"KEBON MELATI, TANAH ABANG, JAKARTA PUSAT, DKI JAKARTA",37,35,197,232
https://kawalpemilu.org#25882,"JOHAR BARU, JOHAR BARU, JAKARTA PUSAT, DKI JAKARTA",53,110,124,234
https://kawalpemilu.org#25877,"PETAMBURAN, TANAH ABANG, JAKARTA PUSAT, DKI JAKARTA",28,31,196,227
https://kawalpemilu.org#25926,"CENGKARENG BARAT, CENGKARENG, JAKARTA BARAT, DKI JAKARTA",110,95,54,149
https://kawalpemilu.org#25846,"MANGGA DUA SELATAN, SAWAH BESAR, JAKARTA PUSAT, DKI JAKARTA",34,54,168,222
https://kawalpemilu.org#25864,"CEMPAKA PUTIH TIMUR, CEMPAKA PUTIH, JAKARTA PUSAT, DKI JAKARTA",35,111,102,213
https://kawalpemilu.org#26133,"CIPAYUNG, CIPAYUNG, JAKARTA TIMUR, DKI JAKARTA",74,130,103,233
https://kawalpemilu.org#25910,"SUKAPURA, CILINCING, JAKARTA UTARA, DKI JAKARTA",8,77,118,195
https://kawalpemilu.org#25915,"SEMPER BARAT, CILINCING, JAKARTA UTARA, DKI JAKARTA",69,77,93,170
https://kawalpemilu.org#25851,"SERDANG, KEMAYORAN, JAKARTA PUSAT, DKI JAKARTA",71,77,139,216
https://kawalpemilu.org#25923,"KELAPA GADING BARAT, KELAPA GADING, JAKARTA UTARA, DKI JAKARTA",105,112,112,224
https://kawalpemilu.org#75423,"DONGGALA, HULONTHALANGI, KOTA GORONTALO, GORONTALO",4,91,91,182
https://kawalpemilu.org#74878,"DAENAA, LIMBOTO BARAT, GORONTALO, GORONTALO",8,182,76,258
https://kawalpemilu.org#75410,"BULOTADAA BARAT, SIPATANA, KOTA GORONTALO, GORONTALO",8,70,132,202
https://kawalpemilu.org#75334,"DUNU, MONANO, GORONTALO UTARA, GORONTALO",2,77,25,102
https://kawalpemilu.org#74945,"MOLOMBULAHE, PAGUYAMAN, BOALEMO, GORONTALO",5,129,106,235
https://kawalpemilu.org#75180,"KAIDUNDU, BULAWA, BONE BOLANGO, GORONTALO",2,32,176,208
https://kawalpemilu.org#74852,"PARIS, MOOTILANGO, GORONTALO, GORONTALO",5,127,120,247
https://kawalpemilu.org#74735,"MONGOLATO, TELAGA, GORONTALO, GORONTALO",7,49,110,159
https://kawalpemilu.org#74847,"GANDARIA, TOLANGOHULA, GORONTALO, GORONTALO",6,77,106,183
https://kawalpemilu.org#16126,"KEMANTAN AGUNG, AIR HANGAT TIMUR, KERINCI, JAMBI",2,49,141,190
https://kawalpemilu.org#16607,"PELAYANGAN, MUARA TEMBESI, BATANGHARI, JAMBI",1,34,107,141
https://kawalpemilu.org#16814,"KEBON IX, SUNGAI GELAM, MUARO JAMBI, JAMBI",5,176,50,226
https://kawalpemilu.org#16663,"AWIN, PEMAYUNG, BATANGHARI, JAMBI",4,41,120,161
https://kawalpemilu.org#16254,"KARANG BERAHI, PAMENANG, MERANGIN, JAMBI",2,43,122,165
https://kawalpemilu.org#17309,"LUBUK MANDARSAH, TENGAH ILIR, TEBO, JAMBI",17,178,32,210
https://kawalpemilu.org#89528,"MEKAR TANJUNG, BRAM ITAM, TANJUNG JABUNG BARAT, JAMBI",3,26,152,178
https://kawalpemilu.org#16501,"PEMATANG KOLIM, PELAWAN, SAROLANGUN, JAMBI",1,95,136,231
https://kawalpemilu.org#15920,"DUJUNG SAKTI, KOTO BARU, KOTA SUNGAI PENUH, JAMBI",3,14,188,202
https://kawalpemilu.org#17338,"TELANAIPURA, TELANAIPURA, KOTA JAMBI, JAMBI",2,41,86,127
https://kawalpemilu.org#17131,"BEDARO, MUKO-MUKO BATHIN VII, BUNGO, JAMBI",10,42,126,168
https://kawalpemilu.org#16073,"DSN. BARU P. TENGAH, KELILING DANAU, KERINCI, JAMBI",2,27,117,144
https://kawalpemilu.org#84562,"SERUMPUN PAUH, KELILING DANAU, KERINCI, JAMBI",3,15,125,140
https://kawalpemilu.org#16145,"SIULAK PANJANG, SIULAK, KERINCI, JAMBI",1,46,165,211
https://kawalpemilu.org#17336,"BULURAN KENALI, TELANAIPURA, KOTA JAMBI, JAMBI",12,55,186,241
https://kawalpemilu.org#16488,"LAMBAN SIGATAL, PAUH, SAROLANGUN, JAMBI",3,67,63,130
https://kawalpemilu.org#16237,"KAMPUNG BARUH, TABIR, MERANGIN, JAMBI",6,54,208,262
https://kawalpemilu.org#89522,"KARYA MAJU, PENGABUAN, TANJUNG JABUNG BARAT, JAMBI",2,27,128,155
https://kawalpemilu.org#16951,"LAMBUR, MUARA SABAK TIMUR, TANJUNG JABUNG TIMUR, JAMBI",11,63,75,138
https://kawalpemilu.org#84621,"TELUKSIALANG, TUNGKAL ILIR, TANJUNG JABUNG BARAT, JAMBI",3,75,123,198
https://kawalpemilu.org#16785,"MUARA KUMPEH, KUMPEH ULU, MUARO JAMBI, JAMBI",5,42,157,199
https://kawalpemilu.org#17343,"LEGOK, DANAU SIPIN, KOTA JAMBI, JAMBI",17,47,110,157
https://kawalpemilu.org#17336,"BULURAN KENALI, TELANAIPURA, KOTA JAMBI, JAMBI",22,36,149,185
https://kawalpemilu.org#16792,"TARIKAN, KUMPEH ULU, MUARO JAMBI, JAMBI",8,33,112,145
https://kawalpemilu.org#17257,"RIMBO MULYO, RIMBO BUJANG, TEBO, JAMBI",1,107,65,172
https://kawalpemilu.org#17341,"SOLOK SIPIN, DANAU SIPIN, KOTA JAMBI, JAMBI",24,63,105,177
https://kawalpemilu.org#17348,"PASIR PUTIH, JAMBI SELATAN, KOTA JAMBI, JAMBI",3,64,76,140
https://kawalpemilu.org#16751,"MEKAR SARI, KUMPEH, MUARO JAMBI, JAMBI",2,190,60,250
https://kawalpemilu.org#28088,"WANGUNJAYA, BUNGBULANG, GARUT, JAWA BARAT",5,47,113,160
https://kawalpemilu.org#27610,"RANCAMANYAR, BALEENDAH, BANDUNG, JAWA BARAT",93,60,119,179
https://kawalpemilu.org#29614,"KERTAWINANGUN, KEDAWUNG, CIREBON, JAWA BARAT",21,105,43,148
https://kawalpemilu.org#30219,"CIMANINTIN, JATINUNGGAL, SUMEDANG, JAWA BARAT",2,34,170,204
https://kawalpemilu.org#27605,"ANDIR, BALEENDAH, BANDUNG, JAWA BARAT",44,57,136,193
https://kawalpemilu.org#31753,"DANAU INDAH, CIKARANG BARAT, BEKASI, JAWA BARAT",2,95,102,197
https://kawalpemilu.org#32181,"SUDAJAYAHILIR, BAROS, KOTA SUKABUMI, JAWA BARAT",10,66,101,167
https://kawalpemilu.org#27105,"BOJONG, KARANGTENGAH, CIANJUR, JAWA BARAT",15,67,210,277
https://kawalpemilu.org#27716,"KOTA KULON, GARUT KOTA, GARUT, JAWA BARAT",1,43,158,201
https://kawalpemilu.org#30959,"BUNIHAYU, JALANCAGAK, SUBANG, JAWA BARAT",10,115,65,180
https://kawalpemilu.org#29672,"LEMAHTAMBA, PANGURAGAN, CIREBON, JAWA BARAT",8,135,50,185
https://kawalpemilu.org#31494,"JATIRAGAS, JATISARI, KARAWANG, JAWA BARAT",6,94,141,235
https://kawalpemilu.org#30785,"SUMURADEM, SUKRA, INDRAMAYU, JAWA BARAT",13,142,63,205
https://kawalpemilu.org#32336,"DERWATI, RANCASARI, KOTA BANDUNG, JAWA BARAT",32,96,149,245
https://kawalpemilu.org#32288,"CIBUNTU, BANDUNG KULON, KOTA BANDUNG, JAWA BARAT",23,65,151,216
https://kawalpemilu.org#26363,"CIPINANG, RUMPIN, BOGOR, JAWA BARAT",33,79,107,186
https://kawalpemilu.org#28509,"BANYURASA, SUKAHENING, TASIKMALAYA, JAWA BARAT",3,56,139,195
https://kawalpemilu.org#30022,"KADIPATEN, KADIPATEN, MAJALENGKA, JAWA BARAT",8,88,99,187
https://kawalpemilu.org#30817,"KEDOKAN BUNDER, KEDOKAN BUNDER, INDRAMAYU, JAWA BARAT",24,165,49,214
https://kawalpemilu.org#30471,"TOMO, TOMO, SUMEDANG, JAWA BARAT",7,115,103,218
https://kawalpemilu.org#32414,"JAKA SAMPURNA, BEKASI BARAT, KOTA BEKASI, JAWA BARAT",146,122,126,248
https://kawalpemilu.org#30160,"CINGAMBUL, CINGAMBUL, MAJALENGKA, JAWA BARAT",9,80,119,199
https://kawalpemilu.org#27186,"MEKARSARI, CIKALONGKULON, CIANJUR, JAWA BARAT",13,65,105,170
https://kawalpemilu.org#84887,"CIASEMGIRANG, CIASEM, SUBANG, JAWA BARAT",11,140,78,218
https://kawalpemilu.org#29637,"DUKUH, KAPETAKAN, CIREBON, JAWA BARAT",1,126,91,217
https://kawalpemilu.org#31743,"WANAJAYA, CIBITUNG, BEKASI, JAWA BARAT",39,87,115,202
https://kawalpemilu.org#28319,"RAKSASARI, TARAJU, TASIKMALAYA, JAWA BARAT",3,53,150,203
https://kawalpemilu.org#32100,"SINDANGRASA, BOGOR TIMUR, KOTA BOGOR, JAWA BARAT",13,82,122,204
https://kawalpemilu.org#26458,"TUGU SELATAN, CISARUA, BOGOR, JAWA BARAT",38,24,220,244
https://kawalpemilu.org#32292,"GEMPOLSARI, BANDUNG KULON, KOTA BANDUNG, JAWA BARAT",26,126,113,239
https://kawalpemilu.org#26631,"RIDOGALIH, CIKAKAK, SUKABUMI, JAWA BARAT",11,30,107,137
https://kawalpemilu.org#28585,"IMBANAGARA RAYA, CIAMIS, CIAMIS, JAWA BARAT",1,88,87,175
https://kawalpemilu.org#32123,"CILENDEK TIMUR, BOGOR BARAT, KOTA BOGOR, JAWA BARAT",25,26,138,164
https://kawalpemilu.org#30643,"SUKALILA, JATIBARANG, INDRAMAYU, JAWA BARAT",1,138,19,157
https://kawalpemilu.org#32330,"SEKEJATI, BUAHBATU, KOTA BANDUNG, JAWA BARAT",10,77,154,231
https://kawalpemilu.org#28389,"RAJADATU, CINEAM, TASIKMALAYA, JAWA BARAT",13,111,110,221
https://kawalpemilu.org#32026,"KARYAMUKTI, CILILIN, BANDUNG BARAT, JAWA BARAT",2,158,80,238
https://kawalpemilu.org#27958,"DANGIANG, CILAWU, GARUT, JAWA BARAT",5,56,143,199
https://kawalpemilu.org#27502,"LEBAKWANGI, ARJASARI, BANDUNG, JAWA BARAT",9,66,125,191
https://kawalpemilu.org#29578,"LUNGBENDA, PALIMANAN, CIREBON, JAWA BARAT",5,118,68,186
https://kawalpemilu.org#27718,"MARGAWATI, GARUT KOTA, GARUT, JAWA BARAT",15,65,138,203
https://kawalpemilu.org#27442,"MARGAHAYU SELATAN, MARGAHAYU, BANDUNG, JAWA BARAT",85,145,62,207
https://kawalpemilu.org#27999,"MARGAMULYA, CIKAJANG, GARUT, JAWA BARAT",18,91,115,206
https://kawalpemilu.org#31765,"WALUYA, CIKARANG UTARA, BEKASI, JAWA BARAT",37,91,180,271
https://kawalpemilu.org#26359,"GOBANG, RUMPIN, BOGOR, JAWA BARAT",7,46,114,160
https://kawalpemilu.org#32098,"KATULAMPA, BOGOR TIMUR, KOTA BOGOR, JAWA BARAT",88,62,150,212
https://kawalpemilu.org#29836,"CIPASUNG, LEMAHSUGIH, MAJALENGKA, JAWA BARAT",5,105,70,175
https://kawalpemilu.org#27901,"BARU DUA, MALANGBONG, GARUT, JAWA BARAT",11,14,200,214
https://kawalpemilu.org#30520,"TEMIYANG, KROYA, INDRAMAYU, JAWA BARAT",23,144,46,190
https://kawalpemilu.org#29141,"BOJONG, CILIMUS, KUNINGAN, JAWA BARAT",1,34,148,182
https://kawalpemilu.org#31373,"PINAYUNGAN, TELUKJAMBE TIMUR, KARAWANG, JAWA BARAT",29,71,85,156
https://kawalpemilu.org#32650,"BALOKANG, BANJAR, KOTA BANJAR, JAWA BARAT",26,61,131,192
https://kawalpemilu.org#32455,"JATISARI, JATIASIH, KOTA BEKASI, JAWA BARAT",21,86,146,232
https://kawalpemilu.org#31360,"CINTAASIH, PANGKALAN, KARAWANG, JAWA BARAT",6,21,196,217
https://kawalpemilu.org#31750,"TELAGAMURNI, CIKARANG BARAT, BEKASI, JAWA BARAT",21,46,115,161
https://kawalpemilu.org#29091,"PANGKALAN, CIAWIGEBANG, KUNINGAN, JAWA BARAT",3,55,134,189
https://kawalpemilu.org#32347,"PALASARI, CIBIRU, KOTA BANDUNG, JAWA BARAT",54,79,86,165
https://kawalpemilu.org#31652,"WANAKERTA, TELUKJAMBE BARAT, KARAWANG, JAWA BARAT",15,102,125,227
https://kawalpemilu.org#29931,"MAJA SELATAN, MAJA, MAJALENGKA, JAWA BARAT",7,18,165,183
https://kawalpemilu.org#30088,"PANJALIN KIDUL, SUMBERJAYA, MAJALENGKA, JAWA BARAT",31,111,78,189
https://kawalpemilu.org#30375,"CILELES, JATINANGOR, SUMEDANG, JAWA BARAT",2,74,146,220
https://kawalpemilu.org#32020,"CILILIN, CILILIN, BANDUNG BARAT, JAWA BARAT",9,68,168,236
https://kawalpemilu.org#27685,"PANYOCOKAN, CIWIDEY, BANDUNG, JAWA BARAT",28,68,77,145
https://kawalpemilu.org#32015,"SITUWANGI, CIHAMPELAS, BANDUNG BARAT, JAWA BARAT",11,53,196,249
https://kawalpemilu.org#27073,"SIRNAGALIH, CILAKU, CIANJUR, JAWA BARAT",54,64,127,191
https://kawalpemilu.org#29987,"HEULEUT, LEUWIMUNDING, MAJALENGKA, JAWA BARAT",13,99,78,177
https://kawalpemilu.org#28469,"LINGGAMULYA, LEUWISARI, TASIKMALAYA, JAWA BARAT",11,42,180,222
https://kawalpemilu.org#27115,"SUKATARIS, KARANGTENGAH, CIANJUR, JAWA BARAT",27,61,127,188
https://kawalpemilu.org#31849,"CILEDUG, SETU, BEKASI, JAWA BARAT",30,107,131,238
https://kawalpemilu.org#29487,"BUNTET, ASTANAJAPURA, CIREBON, JAWA BARAT",14,189,29,218
https://kawalpemilu.org#30787,"KARANG LAYUNG, SUKRA, INDRAMAYU, JAWA BARAT",11,178,25,203
https://kawalpemilu.org#27934,"BANJARSARI, BAYONGBONG, GARUT, JAWA BARAT",9,42,156,198
https://kawalpemilu.org#26515,"BABAKAN, DRAMAGA, BOGOR, JAWA BARAT",3,39,135,174
https://kawalpemilu.org#32338,"MEKARJAYA, RANCASARI, KOTA BANDUNG, JAWA BARAT",43,58,133,191
https://kawalpemilu.org#30320,"GUDANG, TANJUNGSARI, SUMEDANG, JAWA BARAT",3,62,122,184
https://kawalpemilu.org#31272,"CIKERIS, BOJONG, PURWAKARTA, JAWA BARAT",2,108,147,255
https://kawalpemilu.org#30404,"KOTAKALER, SUMEDANG UTARA, SUMEDANG, JAWA BARAT",36,107,135,242
https://kawalpemilu.org#26149,"CIBINONG, CIBINONG, BOGOR, JAWA BARAT",24,23,207,230
https://kawalpemilu.org#31435,"TAMBAKSUMUR, TIRTAJAYA, KARAWANG, JAWA BARAT",15,138,39,177
https://kawalpemilu.org#28070,"KERTAMUKTI, CIKELET, GARUT, JAWA BARAT",5,57,171,228
https://kawalpemilu.org#27033,"MUKA, CIANJUR, CIANJUR, JAWA BARAT",4,75,136,211
https://kawalpemilu.org#27033,"MUKA, CIANJUR, CIANJUR, JAWA BARAT",50,73,145,218
https://kawalpemilu.org#32517,"RATU JAYA, CIPAYUNG, KOTA DEPOK, JAWA BARAT",118,92,99,191
https://kawalpemilu.org#27228,"SUKAGALIH, TAKOKAK, CIANJUR, JAWA BARAT",6,35,107,142
https://kawalpemilu.org#28208,"SARIMANGGU, KARANGNUNGGAL, TASIKMALAYA, JAWA BARAT",11,131,77,208
https://kawalpemilu.org#31023,"TANJUNG, CIPUNAGARA, SUBANG, JAWA BARAT",1,166,37,203
https://kawalpemilu.org#31980,"MANDALASARI, CIPATAT, BANDUNG BARAT, JAWA BARAT",1,104,99,203
https://kawalpemilu.org#32436,"PEJUANG, MEDAN SATRIA, KOTA BEKASI, JAWA BARAT",89,122,96,218
https://kawalpemilu.org#32468,"JATIRAHAYU, PONDOK MELATI, KOTA BEKASI, JAWA BARAT",116,80,124,14
https://kawalpemilu.org#31110,"BENDUNGAN, PAGADEN BARAT, SUBANG, JAWA BARAT",3,142,91,233
https://kawalpemilu.org#32658,"MULYASARI, PATARUMAN, KOTA BANJAR, JAWA BARAT",4,86,83,169
https://kawalpemilu.org#28204,"KARANGMEKAR, KARANGNUNGGAL, TASIKMALAYA, JAWA BARAT",18,43,127,170
https://kawalpemilu.org#26857,"SIRNARESMI, GUNUNG GURUH, SUKABUMI, JAWA BARAT",21,47,186,233
https://kawalpemilu.org#27737,"GODOG, KARANGPAWITAN, GARUT, JAWA BARAT",17,42,94,136
https://kawalpemilu.org#32024,"KARANGANYAR, CILILIN, BANDUNG BARAT, JAWA BARAT",11,82,79,161
https://kawalpemilu.org#84887,"CIASEMGIRANG, CIASEM, SUBANG, JAWA BARAT",1,133,34,167
https://kawalpemilu.org#30253,"CILOPANG, CISITU, SUMEDANG, JAWA BARAT",3,108,85,193
https://kawalpemilu.org#32535,"SUKAMAJU BARU, TAPOS, KOTA DEPOK, JAWA BARAT",46,73,67,140
https://kawalpemilu.org#32214,"KOPO, BOJONGLOA KALER, KOTA BANDUNG, JAWA BARAT",63,118,126,244
https://kawalpemilu.org#27895,"CITERAS, MALANGBONG, GARUT, JAWA BARAT",10,58,159,217
https://kawalpemilu.org#32482,"CURUG, CIMANGGIS, KOTA DEPOK, JAWA BARAT",39,104,110,214
https://kawalpemilu.org#27900,"CIHAURKUNING, MALANGBONG, GARUT, JAWA BARAT",19,0,0,0
https://kawalpemilu.org#28768,"BANJARSARI, BANJARSARI, CIAMIS, JAWA BARAT",5,91,100,191
https://kawalpemilu.org#32553,"CIBEBER, CIMAHI SELATAN, KOTA CIMAHI, JAWA BARAT",8,64,188,252
https://kawalpemilu.org#26300,"KARYASARI, LEUWILIANG, BOGOR, JAWA BARAT",28,15,129,144
https://kawalpemilu.org#26629,"CIKAKAK, CIKAKAK, SUKABUMI, JAWA BARAT",9,50,149,199
https://kawalpemilu.org#30686,"PABEAN UDIK, INDRAMAYU, INDRAMAYU, JAWA BARAT",23,91,83,174
https://kawalpemilu.org#32535,"SUKAMAJU BARU, TAPOS, KOTA DEPOK, JAWA BARAT",56,82,94,176
https://kawalpemilu.org#32298,"BABAKAN SURABAYA, KIARACONDONG, KOTA BANDUNG, JAWA BARAT",11,90,89,179
https://kawalpemilu.org#31750,"TELAGAMURNI, CIKARANG BARAT, BEKASI, JAWA BARAT",58,11,218,229
https://kawalpemilu.org#27514,"JAGABAYA, CIMAUNG, BANDUNG, JAWA BARAT",36,103,91,194
https://kawalpemilu.org#27146,"CIBODAS, PACET, CIANJUR, JAWA BARAT",9,120,116,236
https://kawalpemilu.org#27606,"JELEKONG, BALEENDAH, BANDUNG, JAWA BARAT",50,70,131,201
https://kawalpemilu.org#30672,"KARANGMALANG, INDRAMAYU, INDRAMAYU, JAWA BARAT",1,148,98,246
https://kawalpemilu.org#32043,"NEGLASARI, CIPONGKOR, BANDUNG BARAT, JAWA BARAT",10,99,32,131
https://kawalpemilu.org#31812,"BANTARJAYA, PEBAYURAN, BEKASI, JAWA BARAT",29,87,95,182
https://kawalpemilu.org#27096,"SUKAJAYA, BOJONGPICUNG, CIANJUR, JAWA BARAT",6,96,103,199
https://kawalpemilu.org#31095,"KASOMALANG WETAN, KASOMALANG, SUBANG, JAWA BARAT",14,49,163,212
https://kawalpemilu.org#31137,"NAGRIKIDUL, PURWAKARTA, PURWAKARTA, JAWA BARAT",6,35,171,206
https://kawalpemilu.org#30833,"CANGKO, TUKDANA, INDRAMAYU, JAWA BARAT",1,73,61,134
https://kawalpemilu.org#32115,"MENTENG, BOGOR BARAT, KOTA BOGOR, JAWA BARAT",46,71,90,161
https://kawalpemilu.org#32405,"BEKASI JAYA, BEKASI TIMUR, KOTA BEKASI, JAWA BARAT",126,102,136,238
https://kawalpemilu.org#26174,"SANJA, CITEUREUP, BOGOR, JAWA BARAT",5,47,213,260
https://kawalpemilu.org#27514,"JAGABAYA, CIMAUNG, BANDUNG, JAWA BARAT",39,114,123,237
https://kawalpemilu.org#26905,"SUDAJAYA GIRANG, SUKABUMI, SUKABUMI, JAWA BARAT",23,70,126,196
https://kawalpemilu.org#28180,"LINGGAMUKTI, SUCINARAJA, GARUT, JAWA BARAT",13,46,175,221
https://kawalpemilu.org#32098,"KATULAMPA, BOGOR TIMUR, KOTA BOGOR, JAWA BARAT",51,64,147,211
https://kawalpemilu.org#31758,"KALIJAYA, CIKARANG BARAT, BEKASI, JAWA BARAT",58,71,133,204
https://kawalpemilu.org#26994,"CIDOLOG, CIDOLOG, SUKABUMI, JAWA BARAT",7,74,54,128
https://kawalpemilu.org#29625,"WANAKAYA, GUNUNG JATI, CIREBON, JAWA BARAT",12,93,119,112
https://kawalpemilu.org#32460,"JATIRANGGA, JATISAMPURNA, KOTA BEKASI, JAWA BARAT",39,143,57,200
https://kawalpemilu.org#31924,"PADAASIH, CISARUA, BANDUNG BARAT, JAWA BARAT",17,98,146,244
https://kawalpemilu.org#27361,"CIMACAN, CIPANAS, CIANJUR, JAWA BARAT",44,37,181,218
https://kawalpemilu.org#31750,"TELAGAMURNI, CIKARANG BARAT, BEKASI, JAWA BARAT",59,19,187,206
https://kawalpemilu.org#32444,"JATIWARINGIN, PONDOK GEDE, KOTA BEKASI, JAWA BARAT",38,85,142,227
https://kawalpemilu.org#30817,"KEDOKAN BUNDER, KEDOKAN BUNDER, INDRAMAYU, JAWA BARAT",8,131,59,190
https://kawalpemilu.org#30249,"CIGINTUNG, CISITU, SUMEDANG, JAWA BARAT",7,78,53,131
https://kawalpemilu.org#32616,"TAMANJAYA, TAMANSARI, KOTA TASIKMALAYA, JAWA BARAT",12,15,119,134
https://kawalpemilu.org#32371,"JATIHANDAP, MANDALAJATI, KOTA BANDUNG, JAWA BARAT",14,90,134,224
https://kawalpemilu.org#32653,"SITUBATU, BANJAR, KOTA BANJAR, JAWA BARAT",4,155,37,192
https://kawalpemilu.org#26682,"TANJUNGSARI, JAMPANG TENGAH, SUKABUMI, JAWA BARAT",15,21,185,206
https://kawalpemilu.org#32486,"CISALAK PASAR, CIMANGGIS, KOTA DEPOK, JAWA BARAT",85,117,69,186
https://kawalpemilu.org#30408,"MULYASARI, SUMEDANG UTARA, SUMEDANG, JAWA BARAT",5,43,162,205
https://kawalpemilu.org#27363,"BATULAWANG, CIPANAS, CIANJUR, JAWA BARAT",43,67,61,128
https://kawalpemilu.org#32483,"TUGU, CIMANGGIS, KOTA DEPOK, JAWA BARAT",18,69,106,175
https://kawalpemilu.org#30790,"SANCA, GANTAR, INDRAMAYU, JAWA BARAT",1,168,57,225
https://kawalpemilu.org#26857,"SIRNARESMI, GUNUNG GURUH, SUKABUMI, JAWA BARAT",1,45,128,173
https://kawalpemilu.org#32234,"PASTEUR, SUKAJADI, KOTA BANDUNG, JAWA BARAT",2,122,91,213
https://kawalpemilu.org#31864,"PASIRSARI, CIKARANG SELATAN, BEKASI, JAWA BARAT",22,97,205,302
https://kawalpemilu.org#32284,"SUKAPADA, CIBEUNYING KIDUL, KOTA BANDUNG, JAWA BARAT",11,102,137,239
https://kawalpemilu.org#28479,"JAYARATU, SARIWANGI, TASIKMALAYA, JAWA BARAT",6,75,119,194
https://kawalpemilu.org#89419,"GANJAR SABAR, NAGREG, BANDUNG, JAWA BARAT",9,70,116,186
https://kawalpemilu.org#32410,"BINTARA, BEKASI BARAT, KOTA BEKASI, JAWA BARAT",95,124,96,220
https://kawalpemilu.org#26629,"CIKAKAK, CIKAKAK, SUKABUMI, JAWA BARAT",12,54,114,168
https://kawalpemilu.org#28801,"PALEDAH, PADAHERANG, PANGANDARAN, JAWA BARAT",19,164,26,190
https://kawalpemilu.org#32322,"ANTAPANI TENGAH, ANTAPANI, KOTA BANDUNG, JAWA BARAT",34,98,138,236
https://kawalpemilu.org#26231,"CIPENJO, CILEUNGSI, BOGOR, JAWA BARAT",22,41,196,237
https://kawalpemilu.org#30909,"WANAKERTA, PURWADADI, SUBANG, JAWA BARAT",19,94,128,222
https://kawalpemilu.org#28735,"PATAKAHARJA, RANCAH, CIAMIS, JAWA BARAT",6,28,144,172
https://kawalpemilu.org#32371,"JATIHANDAP, MANDALAJATI, KOTA BANDUNG, JAWA BARAT",48,100,139,239
https://kawalpemilu.org#29970,"RAJAGALUH KIDUL, RAJAGALUH, MAJALENGKA, JAWA BARAT",13,95,103,198
https://kawalpemilu.org#32208,"BABAKAN, BABAKAN CIPARAY, KOTA BANDUNG, JAWA BARAT",17,73,161,234
https://kawalpemilu.org#32332,"CIJAWURA, BUAHBATU, KOTA BANDUNG, JAWA BARAT",21,92,92,184
https://kawalpemilu.org#28030,"PEUNDEUY, PEUNDEUY, GARUT, JAWA BARAT",16,26,90,116
https://kawalpemilu.org#29119,"BUNDER, CIDAHU, KUNINGAN, JAWA BARAT",3,100,73,173
https://kawalpemilu.org#29998,"SUKARAJA WETAN, JATIWANGI, MAJALENGKA, JAWA BARAT",3,109,114,223
https://kawalpemilu.org#30187,"SUKADANA, MALAUSMA, MAJALENGKA, JAWA BARAT",11,60,91,151
https://kawalpemilu.org#26858,"KEBONMANGGU, GUNUNG GURUH, SUKABUMI, JAWA BARAT",6,69,132,201
https://kawalpemilu.org#32134,"KEDUNGHALANG, BOGOR UTARA, KOTA BOGOR, JAWA BARAT",17,141,47,188
https://kawalpemilu.org#27776,"SUKAJAYA, TAROGONG KIDUL, GARUT, JAWA BARAT",29,37,129,166
https://kawalpemilu.org#32092,"GENTENG, BOGOR SELATAN, KOTA BOGOR, JAWA BARAT",16,52,175,227
https://kawalpemilu.org#26839,"CIBITUNG, CIBITUNG, SUKABUMI, JAWA BARAT",12,49,90,139
https://kawalpemilu.org#28786,"SUKAMUKTI, PAMARICAN, CIAMIS, JAWA BARAT",7,74,41,115
https://kawalpemilu.org#89539,"BOROS, TANJUNGKERTA, SUMEDANG, JAWA BARAT",4,186,24,210
https://kawalpemilu.org#27509,"PATROLSARI, ARJASARI, BANDUNG, JAWA BARAT",19,112,59,171
https://kawalpemilu.org#26957,"NEGLASARI, NYALINDUNG, SUKABUMI, JAWA BARAT",3,86,80,166
https://kawalpemilu.org#32232,"SUKARAJA, CICENDO, KOTA BANDUNG, JAWA BARAT",47,83,103,186
https://kawalpemilu.org#31766,"KARANGRAHARJA, CIKARANG UTARA, BEKASI, JAWA BARAT",63,74,150,224
https://kawalpemilu.org#28402,"PASIRPANJANG, MANONJAYA, TASIKMALAYA, JAWA BARAT",13,27,166,193
https://kawalpemilu.org#28456,"PUSPAMUKTI, CIGALONTANG, TASIKMALAYA, JAWA BARAT",4,91,98,189
https://kawalpemilu.org#32602,"GUNUNG GEDE, KAWALU, KOTA TASIKMALAYA, JAWA BARAT",24,14,130,144
https://kawalpemilu.org#27910,"SUDALARANG, SUKAWENING, GARUT, JAWA BARAT",12,47,104,151
https://kawalpemilu.org#32411,"KRANJI, BEKASI BARAT, KOTA BEKASI, JAWA BARAT",85,79,138,217
https://kawalpemilu.org#32518,"BOJONG PONDOK TERONG, CIPAYUNG, KOTA DEPOK, JAWA BARAT",82,72,109,181
https://kawalpemilu.org#27550,"TANJUNGLAYA, CIKANCUNG, BANDUNG, JAWA BARAT",9,19,188,207
https://kawalpemilu.org#30580,"MANGUNTARA, KERTASEMAYA, INDRAMAYU, JAWA BARAT",2,132,29,161
https://kawalpemilu.org#32030,"RANCAPANGGUNG, CILILIN, BANDUNG BARAT, JAWA BARAT",33,73,125,198
https://kawalpemilu.org#28433,"SALEBU, MANGUNREJA, TASIKMALAYA, JAWA BARAT",10,96,154,250
https://kawalpemilu.org#32069,"GUNUNGHALU, GUNUNGHALU, BANDUNG BARAT, JAWA BARAT",19,54,190,244
https://kawalpemilu.org#26395,"JAGABITA, PARUNG PANJANG, BOGOR, JAWA BARAT",7,67,132,199
https://kawalpemilu.org#27421,"CIBURIAL, CIMENYAN, BANDUNG, JAWA BARAT",6,81,68,149
https://kawalpemilu.org#27072,"SUKASARI, CILAKU, CIANJUR, JAWA BARAT",12,87,144,231
https://kawalpemilu.org#27861,"SINDANGSARI, LEUWIGOONG, GARUT, JAWA BARAT",22,62,71,133
https://kawalpemilu.org#29106,"CIJAGAMULYA, CIAWIGEBANG, KUNINGAN, JAWA BARAT",1,93,111,204
https://kawalpemilu.org#27191,"CIWALEN, SUKARESMI, CIANJUR, JAWA BARAT",15,66,141,207
https://kawalpemilu.org#32001,"SELACAU, BATUJAJAR, BANDUNG BARAT, JAWA BARAT",3,37,105,142
https://kawalpemilu.org#31480,"DAWUAN TENGAH, CIKAMPEK, KARAWANG, JAWA BARAT",47,114,118,232
https://kawalpemilu.org#30874,"CIGADUNG, SUBANG, SUBANG, JAWA BARAT",43,101,127,228
https://kawalpemilu.org#32411,"KRANJI, BEKASI BARAT, KOTA BEKASI, JAWA BARAT",95,96,120,216
https://kawalpemilu.org#26846,"CIKANGKUNG, CIRACAP, SUKABUMI, JAWA BARAT",15,77,140,217
https://kawalpemilu.org#32345,"CIPADUNG, CIBIRU, KOTA BANDUNG, JAWA BARAT",42,86,131,217
https://kawalpemilu.org#31205,"NANGEWER, DARANGDAN, PURWAKARTA, JAWA BARAT",10,29,164,193
https://kawalpemilu.org#30255,"CINANGSI, CISITU, SUMEDANG, JAWA BARAT",11,134,33,167
https://kawalpemilu.org#26897,"SEUSEUPAN, CARINGIN, SUKABUMI, JAWA BARAT",1,23,88,111
https://kawalpemilu.org#32296,"SUKAPURA, KIARACONDONG, KOTA BANDUNG, JAWA BARAT",14,73,159,232
https://kawalpemilu.org#32447,"JATIBENING BARU, PONDOK GEDE, KOTA BEKASI, JAWA BARAT",75,87,43,130
https://kawalpemilu.org#29967,"SINDANGPANO, RAJAGALUH, MAJALENGKA, JAWA BARAT",6,82,82,164
https://kawalpemilu.org#30977,"GANDASOLI, TANJUNGSIANG, SUBANG, JAWA BARAT",7,145,103,248
https://kawalpemilu.org#32395,"PULASAREN, PEKALIPAN, KOTA CIREBON, JAWA BARAT",15,130,102,232
https://kawalpemilu.org#28828,"PANANJUNG, PANGANDARAN, PANGANDARAN, JAWA BARAT",17,183,57,240
https://kawalpemilu.org#31684,"TANJUNGSARI, CILEBAR, KARAWANG, JAWA BARAT",5,72,153,225
https://kawalpemilu.org#27444,"SAYATI, MARGAHAYU, BANDUNG, JAWA BARAT",77,127,108,235
https://kawalpemilu.org#29143,"SETIANEGARA, CILIMUS, KUNINGAN, JAWA BARAT",13,97,84,181
https://kawalpemilu.org#31852,"TAMAN RAHAYU, SETU, BEKASI, JAWA BARAT",21,57,131,188
https://kawalpemilu.org#32430,"PENGASINAN, RAWA LUMBU, KOTA BEKASI, JAWA BARAT",67,114,104,218
https://kawalpemilu.org#32406,"MARGAHAYU, BEKASI TIMUR, KOTA BEKASI, JAWA BARAT",8,88,105,193
https://kawalpemilu.org#27611,"MALAKASARI, BALEENDAH, BANDUNG, JAWA BARAT",23,36,144,180
https://kawalpemilu.org#27226,"SINDANGHAYU, TAKOKAK, CIANJUR, JAWA BARAT",8,59,123,182
https://kawalpemilu.org#32425,"JAKA MULYA, BEKASI SELATAN, KOTA BEKASI, JAWA BARAT",7,79,88,167
https://kawalpemilu.org#26828,"CITANGLAR, SURADE, SUKABUMI, JAWA BARAT",14,50,151,201
https://kawalpemilu.org#32157,"KARANGTENGAH, GUNUNG PUYUH, KOTA SUKABUMI, JAWA BARAT",39,34,88,122
https://kawalpemilu.org#26439,"JAMBULUWUK, CIAWI, BOGOR, JAWA BARAT",8,48,130,178
https://kawalpemilu.org#32129,"GUNUNG BATU, BOGOR BARAT, KOTA BOGOR, JAWA BARAT",25,68,101,169
https://kawalpemilu.org#31647,"KARANGLIGAR, TELUKJAMBE BARAT, KARAWANG, JAWA BARAT",12,55,161,216
https://kawalpemilu.org#32551,"UTAMA, CIMAHI SELATAN, KOTA CIMAHI, JAWA BARAT",8,45,182,227
https://kawalpemilu.org#31974,"RAJAMANDALAKULON, CIPATAT, BANDUNG BARAT, JAWA BARAT",6,48,106,154
https://kawalpemilu.org#26230,"SITUSARI, CILEUNGSI, BOGOR, JAWA BARAT",5,46,195,241
https://kawalpemilu.org#32301,"KEBON KANGKUNG, KIARACONDONG, KOTA BANDUNG, JAWA BARAT",34,100,55,155
https://kawalpemilu.org#27529,"NARAWITA, CICALENGKA, BANDUNG, JAWA BARAT",1,41,139,180
https://kawalpemilu.org#32612,"SETIAJAYA, CIBEUREUM, KOTA TASIKMALAYA, JAWA BARAT",13,48,201,249
https://kawalpemilu.org#28040,"MANDALAKASIH, PAMEUNGPEUK, GARUT, JAWA BARAT",11,35,169,204
https://kawalpemilu.org#27872,"GIRIMUKTI, CIBATU, GARUT, JAWA BARAT",9,69,149,218
https://kawalpemilu.org#28404,"KAMULYAN, MANONJAYA, TASIKMALAYA, JAWA BARAT",11,84,138,222
https://kawalpemilu.org#28716,"SUKAJAYA, RAJADESA, CIAMIS, JAWA BARAT",11,69,64,133
https://kawalpemilu.org#30820,"JAYALAKSANA, KEDOKAN BUNDER, INDRAMAYU, JAWA BARAT",19,147,35,182
https://kawalpemilu.org#26752,"LEBAKSARI, PARAKAN SALAK, SUKABUMI, JAWA BARAT",20,21,126,147
https://kawalpemilu.org#32270,"BINONG, BATUNUNGGAL, KOTA BANDUNG, JAWA BARAT",26,73,157,230
https://kawalpemilu.org#31860,"CIANTRA, CIKARANG SELATAN, BEKASI, JAWA BARAT",36,72,107,179
https://kawalpemilu.org#28101,"PASIRLANGU, PAKENJENG, GARUT, JAWA BARAT",8,25,154,179
https://kawalpemilu.org#26779,"PULOSARI, KALAPA NUNGGAL, SUKABUMI, JAWA BARAT",30,21,123,144
https://kawalpemilu.org#28614,"TANJUNGSARI, SADANANYA, CIAMIS, JAWA BARAT",9,6,133,139
https://kawalpemilu.org#26917,"SUKAMEKAR, SUKARAJA, SUKABUMI, JAWA BARAT",22,72,169,241
https://kawalpemilu.org#30875,"SUKAMELANG, SUBANG, SUBANG, JAWA BARAT",11,26,116,142
https://kawalpemilu.org#29348,"SINDANGAGUNG, SINDANG AGUNG, KUNINGAN, JAWA BARAT",2,35,142,177
https://kawalpemilu.org#27548,"HEGARMANAH, CIKANCUNG, BANDUNG, JAWA BARAT",33,61,115,176
https://kawalpemilu.org#27631,"LANGENSARI, SOLOKANJERUK, BANDUNG, JAWA BARAT",10,116,117,233
https://kawalpemilu.org#31727,"SRIJAYA, TAMBUN UTARA, BEKASI, JAWA BARAT",15,24,185,209
https://kawalpemilu.org#32578,"SUKAMANAH, CIPEDES, KOTA TASIKMALAYA, JAWA BARAT",83,52,211,263
https://kawalpemilu.org#26329,"LEUWEUNGKOLOT, CIBUNGBULANG, BOGOR, JAWA BARAT",2,115,114,229
https://kawalpemilu.org#32444,"JATIWARINGIN, PONDOK GEDE, KOTA BEKASI, JAWA BARAT",138,62,141,203
https://kawalpemilu.org#31092,"SUKAMELANG, KASOMALANG, SUBANG, JAWA BARAT",7,63,169,232
https://kawalpemilu.org#32405,"BEKASI JAYA, BEKASI TIMUR, KOTA BEKASI, JAWA BARAT",174,40,28,68
https://kawalpemilu.org#31969,"PAKUHAJI, NGAMPRAH, BANDUNG BARAT, JAWA BARAT",12,75,150,225
https://kawalpemilu.org#32407,"DUREN JAYA, BEKASI TIMUR, KOTA BEKASI, JAWA BARAT",155,98,152,250
https://kawalpemilu.org#28302,"SODONGHILIR, SODONGHILIR, TASIKMALAYA, JAWA BARAT",17,26,111,137
https://kawalpemilu.org#26147,"NANGGEWER, CIBINONG, BOGOR, JAWA BARAT",25,80,165,245
https://kawalpemilu.org#29019,"WILANAGARA, LURAGUNG, KUNINGAN, JAWA BARAT",4,89,72,161
https://kawalpemilu.org#32474,"DEPOK, PANCORAN MAS, KOTA DEPOK, JAWA BARAT",19,38,65,103
https://kawalpemilu.org#28212,"SARIMUKTI, KARANGNUNGGAL, TASIKMALAYA, JAWA BARAT",20,12,135,147
https://kawalpemilu.org#26371,"PANGRADIN, JASINGA, BOGOR, JAWA BARAT",2,103,150,253
https://kawalpemilu.org#28905,"MEKARMUKTI, CISAGA, CIAMIS, JAWA BARAT",21,66,88,154
https://kawalpemilu.org#28560,"NANGGEWER, PAGERAGEUNG, TASIKMALAYA, JAWA BARAT",2,39,159,198
https://kawalpemilu.org#29955,"NANGGEWER, SUKAHAJI, MAJALENGKA, JAWA BARAT",2,134,37,171
https://kawalpemilu.org#31162,"CILEGONG, JATILUHUR, PURWAKARTA, JAWA BARAT",8,87,170,257
https://kawalpemilu.org#27410,"CILEUNYI WETAN, CILEUNYI, BANDUNG, JAWA BARAT",52,101,112,213
https://kawalpemilu.org#26874,"NAGRAK, CISAAT, SUKABUMI, JAWA BARAT",22,52,166,218
https://kawalpemilu.org#27290,"MUARACIKADU, SINDANGBARANG, CIANJUR, JAWA BARAT",5,39,180,219
https://kawalpemilu.org#29812,"GREGED, GREGED, CIREBON, JAWA BARAT",8,131,45,176
https://kawalpemilu.org#27082,"CIRANJANG, CIRANJANG, CIANJUR, JAWA BARAT",50,90,59,149
https://kawalpemilu.org#30508,"WANAKAYA, HAURGEULIS, INDRAMAYU, JAWA BARAT",10,111,39,150
https://kawalpemilu.org#30505,"HAURKOLOT, HAURGEULIS, INDRAMAYU, JAWA BARAT",5,79,151,230
https://kawalpemilu.org#30351,"CITALI, PAMULIHAN, SUMEDANG, JAWA BARAT",1,63,92,155
https://kawalpemilu.org#32450,"JATIMEKAR, JATIASIH, KOTA BEKASI, JAWA BARAT",108,27,58,85
https://kawalpemilu.org#30523,"SUKA SLAMET, KROYA, INDRAMAYU, JAWA BARAT",11,143,44,187
https://kawalpemilu.org#27697,"PANANJUNG, CANGKUANG, BANDUNG, JAWA BARAT",28,67,146,213
https://kawalpemilu.org#30608,"KARANGAMPEL KIDUL, KARANGAMPEL, INDRAMAYU, JAWA BARAT",19,143,68,211
https://kawalpemilu.org#30955,"MULYASARI, PAMANUKAN, SUBANG, JAWA BARAT",9,128,43,171
https://kawalpemilu.org#27176,"WARUDOYONG, CIKALONGKULON, CIANJUR, JAWA BARAT",9,40,94,134
https://kawalpemilu.org#28452,"SUKAMANAH, CIGALONTANG, TASIKMALAYA, JAWA BARAT",12,50,152,202
https://kawalpemilu.org#27426,"JATIENDAH, CILENGKRANG, BANDUNG, JAWA BARAT",4,66,105,171
https://kawalpemilu.org#27434,"BOJONGSOANG, BOJONGSOANG, BANDUNG, JAWA BARAT",2,56,119,175
https://kawalpemilu.org#26243,"TEGALPANJANG, CARIU, BOGOR, JAWA BARAT",12,51,142,193
https://kawalpemilu.org#31172,"CIBOGOHILIR, PLERED, PURWAKARTA, JAWA BARAT",17,37,196,233
https://kawalpemilu.org#28434,"MANGUNREJA, MANGUNREJA, TASIKMALAYA, JAWA BARAT",10,90,129,219
https://kawalpemilu.org#29309,"CIMARA, CIBEUREUM, KUNINGAN, JAWA BARAT",5,56,125,181
https://kawalpemilu.org#29067,"KUNINGAN, KUNINGAN, KUNINGAN, JAWA BARAT",30,31,126,157
https://kawalpemilu.org#32249,"NYENGSERET, ASTANA ANYAR, KOTA BANDUNG, JAWA BARAT",8,108,120,228
https://kawalpemilu.org#27663,"PAMEKARAN, SOREANG, BANDUNG, JAWA BARAT",1,57,151,208
https://kawalpemilu.org#32429,"BOJONG RAWALUMBU, RAWA LUMBU, KOTA BEKASI, JAWA BARAT",54,124,123,247
https://kawalpemilu.org#28304,"CIPAINGEUN, SODONGHILIR, TASIKMALAYA, JAWA BARAT",7,35,160,195
https://kawalpemilu.org#31689,"PUSAKA RAKYAT, TARUMAJAYA, BEKASI, JAWA BARAT",46,168,28,196
https://kawalpemilu.org#27109,"SUKAMANTRI, KARANGTENGAH, CIANJUR, JAWA BARAT",14,79,140,219
https://kawalpemilu.org#26172,"LEUWINUTUG, CITEUREUP, BOGOR, JAWA BARAT",38,58,158,216
https://kawalpemilu.org#31627,"PANGULAH SELATAN, KOTA BARU, KARAWANG, JAWA BARAT",35,58,109,167
https://kawalpemilu.org#29386,"DAMARGUNA, CILEDUG, CIREBON, JAWA BARAT",10,73,63,136
https://kawalpemilu.org#32628,"SAMBONGPARI, MANGKUBUMI, KOTA TASIKMALAYA, JAWA BARAT",26,44,198,242
https://kawalpemilu.org#27662,"SUKAJADI, SOREANG, BANDUNG, JAWA BARAT",20,97,78,178
https://kawalpemilu.org#31688,"SEGARA JAYA, TARUMAJAYA, BEKASI, JAWA BARAT",27,118,114,232
https://kawalpemilu.org#27499,"MARGAMEKAR, PANGALENGAN, BANDUNG, JAWA BARAT",1,100,100,200
https://kawalpemilu.org#29687,"BOJONG KULON, SUSUKAN, CIREBON, JAWA BARAT",2,85,41,126
https://kawalpemilu.org#26290,"SUSUKAN, BOJONG GEDE, BOGOR, JAWA BARAT",17,49,123,172
https://kawalpemilu.org#28169,"SUKAHURIP, PANGATIKAN, GARUT, JAWA BARAT",17,17,162,179
https://kawalpemilu.org#28085,"SINARJAYA, BUNGBULANG, GARUT, JAWA BARAT",2,90,59,149
https://kawalpemilu.org#27457,"CILAMPENI, KATAPANG, BANDUNG, JAWA BARAT",30,67,125,192
https://kawalpemilu.org#32359,"RANCABOLANG, GEDEBAGE, KOTA BANDUNG, JAWA BARAT",10,43,107,150
https://kawalpemilu.org#31826,"SUKARUKUN, SUKATANI, BEKASI, JAWA BARAT",26,68,142,210
https://kawalpemilu.org#27811,"SIRNASARI, SAMARANG, GARUT, JAWA BARAT",14,17,181,198
https://kawalpemilu.org#27943,"SUKAHURIP, CIGEDUG, GARUT, JAWA BARAT",11,46,210,256
https://kawalpemilu.org#26145,"KARADENAN, CIBINONG, BOGOR, JAWA BARAT",26,32,115,147
https://kawalpemilu.org#31999,"CANGKORAH, BATUJAJAR, BANDUNG BARAT, JAWA BARAT",19,107,171,278
https://kawalpemilu.org#27638,"SINDANGSARI, PASEH, BANDUNG, JAWA BARAT",25,137,79,216
https://kawalpemilu.org#29591,"KARANGASEM, PLUMBON, CIREBON, JAWA BARAT",13,148,42,190
https://kawalpemilu.org#28243,"PAKEMITAN, CIKATOMAS, TASIKMALAYA, JAWA BARAT",2,135,107,242
https://kawalpemilu.org#31939,"MANDALAMUKTI, CIKALONGWETAN, BANDUNG BARAT, JAWA BARAT",16,56,186,242
https://kawalpemilu.org#26442,"BANJAR WARU, CIAWI, BOGOR, JAWA BARAT",9,80,156,236
https://kawalpemilu.org#26864,"CIJALINGAN, CICANTAYAN, SUKABUMI, JAWA BARAT",14,31,115,146
https://kawalpemilu.org#30872,"PASIRKAREUMBI, SUBANG, SUBANG, JAWA BARAT",62,93,71,164
https://kawalpemilu.org#32557,"KARANGMEKAR, CIMAHI TENGAH, KOTA CIMAHI, JAWA BARAT",11,84,116,200
https://kawalpemilu.org#31151,"CIRENDE, CAMPAKA, PURWAKARTA, JAWA BARAT",7,48,134,182
https://kawalpemilu.org#30915,"KAMARUNG, PAGADEN, SUBANG, JAWA BARAT",18,121,90,211
https://kawalpemilu.org#32340,"SUKAMISKIN, ARCAMANIK, KOTA BANDUNG, JAWA BARAT",70,14,44,58
https://kawalpemilu.org#31698,"KEDUNG PENGAWAS, BABELAN, BEKASI, JAWA BARAT",48,55,94,149
https://kawalpemilu.org#28105,"TEGALGEDE, PAKENJENG, GARUT, JAWA BARAT",3,67,172,239
https://kawalpemilu.org#29840,"LEMAHPUTIH, LEMAHSUGIH, MAJALENGKA, JAWA BARAT",6,67,168,235
https://kawalpemilu.org#28816,"KALIPUCANG, KALIPUCANG, PANGANDARAN, JAWA BARAT",3,100,82,182
https://kawalpemilu.org#32604,"SETIARATU, CIBEUREUM, KOTA TASIKMALAYA, JAWA BARAT",16,22,175,197
https://kawalpemilu.org#32563,"CIBABAT, CIMAHI UTARA, KOTA CIMAHI, JAWA BARAT",21,64,153,217
https://kawalpemilu.org#30916,"SUKAMULYA, PAGADEN, SUBANG, JAWA BARAT",25,69,65,134
https://kawalpemilu.org#30675,"LEMAH ABANG, INDRAMAYU, INDRAMAYU, JAWA BARAT",2,149,50,199
https://kawalpemilu.org#26529,"BOJONG, KLAPANUNGGAL, BOGOR, JAWA BARAT",21,23,191,214
https://kawalpemilu.org#32481,"HARJAMUKTI, CIMANGGIS, KOTA DEPOK, JAWA BARAT",76,137,71,208
https://kawalpemilu.org#30481,"UJUNGJAYA, UJUNGJAYA, SUMEDANG, JAWA BARAT",4,106,67,173
https://kawalpemilu.org#28842,"BOJONG, PARIGI, PANGANDARAN, JAWA BARAT",3,136,57,193
https://kawalpemilu.org#32378,"SUKAPURA, KEJAKSAN, KOTA CIREBON, JAWA BARAT",43,63,107,170
https://kawalpemilu.org#31068,"TALAGASARI, SERANGPANJANG, SUBANG, JAWA BARAT",11,131,55,186
https://kawalpemilu.org#32626,"LINGGAJAYA, MANGKUBUMI, KOTA TASIKMALAYA, JAWA BARAT",14,25,188,213
https://kawalpemilu.org#27034,"BABAKANKARET, CIANJUR, CIANJUR, JAWA BARAT",18,26,166,192
https://kawalpemilu.org#28189,"DARAWATI, CIPATUJAH, TASIKMALAYA, JAWA BARAT",5,21,158,179
https://kawalpemilu.org#31701,"BAHAGIA, BABELAN, BEKASI, JAWA BARAT",83,18,173,191
https://kawalpemilu.org#28620,"JANGGALA, CIDOLOG, CIAMIS, JAWA BARAT",15,49,128,177
https://kawalpemilu.org#41248,"PLOMPONG, SIRAMPOG, BREBES, JAWA TENGAH",7,64,92,156
https://kawalpemilu.org#38578,"MIJEN, KALIWUNGU, KUDUS, JAWA TENGAH",34,132,68,200
https://kawalpemilu.org#37334,"SULURSARI, GABUS, GROBOGAN, JAWA TENGAH",5,172,54,226
https://kawalpemilu.org#35499,"TLOGOREJO, GRABAG, MAGELANG, JAWA TENGAH",7,124,53,177
https://kawalpemilu.org#41545,"KADIPIRO, BANJARSARI, KOTA SURAKARTA, JAWA TENGAH",177,117,18,135
https://kawalpemilu.org#37623,"PALON, JEPON, BLORA, JAWA TENGAH",9,193,21,214
https://kawalpemilu.org#39885,"PESAWAHAN, PEGANDON, KENDAL, JAWA TENGAH",1,141,25,166
https://kawalpemilu.org#40773,"KEDUNGBANJAR, TAMAN, PEMALANG, JAWA TENGAH",16,122,45,167
https://kawalpemilu.org#36978,"JENAWI, JENAWI, KARANGANYAR, JAWA TENGAH",4,189,13,202
https://kawalpemilu.org#36064,"SOBAYAN, PEDAN, KLATEN, JAWA TENGAH",4,181,28,209
https://kawalpemilu.org#37355,"TANJUNGHARJO, NGARINGAN, GROBOGAN, JAWA TENGAH",15,173,26,199
https://kawalpemilu.org#39876,"TOSARI, BRANGSONG, KENDAL, JAWA TENGAH",5,128,51,179
https://kawalpemilu.org#36340,"KRIWEN, SUKOHARJO, SUKOHARJO, JAWA TENGAH",3,199,23,222
https://kawalpemilu.org#38541,"BANYUTOWO, DUKUHSETI, PATI, JAWA TENGAH",6,143,12,155
https://kawalpemilu.org#37632,"BALONG, JEPON, BLORA, JAWA TENGAH",1,126,35,161
https://kawalpemilu.org#41542,"JEBRES, JEBRES, KOTA SURAKARTA, JAWA TENGAH",46,161,46,207
https://kawalpemilu.org#39861,"SARIREJO, KALIWUNGU, KENDAL, JAWA TENGAH",4,140,69,209
https://kawalpemilu.org#36441,"PURBAYAN, BAKI, SUKOHARJO, JAWA TENGAH",5,207,29,236
https://kawalpemilu.org#39102,"GEMPOLSONGO, MIJEN, DEMAK, JAWA TENGAH",1,179,25,204
https://kawalpemilu.org#37256,"WATUPAWON, PENAWANGAN, GROBOGAN, JAWA TENGAH",2,139,34,173
https://kawalpemilu.org#32991,"BESUKI, LUMBIR, BANYUMAS, JAWA TENGAH",4,120,49,169
https://kawalpemilu.org#36337,"JOHO, SUKOHARJO, SUKOHARJO, JAWA TENGAH",16,153,87,240
https://kawalpemilu.org#41552,"KETELAN, BANJARSARI, KOTA SURAKARTA, JAWA TENGAH",2,192,48,240
https://kawalpemilu.org#38673,"PURWOREJO, BAE, KUDUS, JAWA TENGAH",6,111,54,165
https://kawalpemilu.org#41584,"KALICACING, SIDOMUKTI, KOTA SALATIGA, JAWA TENGAH",3,117,59,176
https://kawalpemilu.org#38662,"HONGGOSOCO, JEKULO, KUDUS, JAWA TENGAH",36,108,82,190
https://kawalpemilu.org#38465,"KERTOMULYO, MARGOYOSO, PATI, JAWA TENGAH",7,142,3,145
https://kawalpemilu.org#37477,"GUBUG, GUBUG, GROBOGAN, JAWA TENGAH",2,115,45,160
https://kawalpemilu.org#38448,"SUWADUK, WEDARIJAKSA, PATI, JAWA TENGAH",8,147,33,180
https://kawalpemilu.org#38737,"PECANGAAN WETAN, PECANGAAN, JEPARA, JAWA TENGAH",9,195,35,230
https://kawalpemilu.org#40900,"BOJONG, BOJONG, TEGAL, JAWA TENGAH",1,116,99,215
https://kawalpemilu.org#33325,"REJASARI, PURWOKERTO BARAT, BANYUMAS, JAWA TENGAH",11,158,39,197
https://kawalpemilu.org#33214,"GUNUNGLURAH, CILONGOK, BANYUMAS, JAWA TENGAH",6,140,78,218
https://kawalpemilu.org#36076,"DEMANGAN, KARANGDOWO, KLATEN, JAWA TENGAH",4,149,39,188
https://kawalpemilu.org#37520,"JEGONG, JATI, BLORA, JAWA TENGAH",8,162,42,204
https://kawalpemilu.org#33120,"KEDUNGUTER, BANYUMAS, BANYUMAS, JAWA TENGAH",9,105,93,198
https://kawalpemilu.org#37358,"WIROSARI, WIROSARI, GROBOGAN, JAWA TENGAH",9,149,39,188
https://kawalpemilu.org#35682,"KRASAK, TERAS, BOYOLALI, JAWA TENGAH",4,167,26,193
https://kawalpemilu.org#37413,"PUTAT, PURWODADI, GROBOGAN, JAWA TENGAH",8,205,49,254
https://kawalpemilu.org#40464,"SRAGI, SRAGI, PEKALONGAN, JAWA TENGAH",10,147,71,218
https://kawalpemilu.org#33274,"KARANGGINTUNG, SUMBANG, BANYUMAS, JAWA TENGAH",5,158,42,200
https://kawalpemilu.org#39266,"SRATEN, TUNTANG, SEMARANG, JAWA TENGAH",8,176,45,221
https://kawalpemilu.org#41314,"PASARBATANG, BREBES, BREBES, JAWA TENGAH",60,105,79,184
https://kawalpemilu.org#34816,"KEMRANGGEN, BRUNO, PURWOREJO, JAWA TENGAH",2,102,51,153
https://kawalpemilu.org#40096,"BESANI, BLADO, BATANG, JAWA TENGAH",3,134,13,147
https://kawalpemilu.org#39217,"KETAPANG, SUSUKAN, SEMARANG, JAWA TENGAH",7,144,31,175
https://kawalpemilu.org#40924,"KALIWUNGU, BALAPULANG, TEGAL, JAWA TENGAH",10,142,57,199
https://kawalpemilu.org#39357,"NGEMPON, BERGAS, SEMARANG, JAWA TENGAH",4,214,30,244
https://kawalpemilu.org#38514,"KEDUNGSARI, TAYU, PATI, JAWA TENGAH",12,168,36,204
https://kawalpemilu.org#40653,"GUNUNGJAYA, BELIK, PEMALANG, JAWA TENGAH",16,128,21,149
https://kawalpemilu.org#40159,"PUJUT, TERSONO, BATANG, JAWA TENGAH",8,133,24,157
https://kawalpemilu.org#37347,"KALANGDOSARI, NGARINGAN, GROBOGAN, JAWA TENGAH",9,145,24,169
https://kawalpemilu.org#38184,"TAMBAHAGUNG, TAMBAKROMO, PATI, JAWA TENGAH",10,132,27,159
https://kawalpemilu.org#40500,"BABALANLOR, BOJONG, PEKALONGAN, JAWA TENGAH",3,179,20,199
https://kawalpemilu.org#36545,"SEMIN, NGUNTORONADI, WONOGIRI, JAWA TENGAH",5,121,24,145
https://kawalpemilu.org#38606,"RENDENG, KUDUS, KUDUS, JAWA TENGAH",9,126,55,181
https://kawalpemilu.org#33041,"CINDAGA, KEBASEN, BANYUMAS, JAWA TENGAH",3,97,28,125
https://kawalpemilu.org#34878,"KALI URIP, BENER, PURWOREJO, JAWA TENGAH",8,133,44,177
https://kawalpemilu.org#38995,"GROGOL, KARANGTENGAH, DEMAK, JAWA TENGAH",7,124,30,154
https://kawalpemilu.org#40945,"PESAREAN, PAGERBARANG, TEGAL, JAWA TENGAH",5,109,100,209
https://kawalpemilu.org#35993,"SUMYANG, JOGONALAN, KLATEN, JAWA TENGAH",3,180,21,201
https://kawalpemilu.org#41622,"KARANGTEMPEL, SEMARANG TIMUR, KOTA SEMARANG, JAWA TENGAH",7,207,16,223
https://kawalpemilu.org#38750,"GIDANGLO, WELAHAN, JEPARA, JAWA TENGAH",3,208,31,239
https://kawalpemilu.org#36353,"GUPIT, NGUTER, SUKOHARJO, JAWA TENGAH",2,154,64,218
https://kawalpemilu.org#36602,"KEPATIHAN, SELOGIRI, WONOGIRI, JAWA TENGAH",10,108,21,129
https://kawalpemilu.org#33768,"BADAMITA, RAKIT, BANJARNEGARA, JAWA TENGAH",8,88,47,135
https://kawalpemilu.org#36146,"GLAGAHWANGI, POLANHARJO, KLATEN, JAWA TENGAH",11,97,25,122
https://kawalpemilu.org#40670,"MAJALANGU, WATUKUMPUL, PEMALANG, JAWA TENGAH",16,144,11,155
https://kawalpemilu.org#38655,"SIDOMULYO, JEKULO, KUDUS, JAWA TENGAH",2,126,43,169
https://kawalpemilu.org#38572,"BLIMBING KIDUL, KALIWUNGU, KUDUS, JAWA TENGAH",4,145,19,164
https://kawalpemilu.org#38893,"JINGGOTAN, KEMBANG, JEPARA, JAWA TENGAH",5,182,62,244
https://kawalpemilu.org#33663,"MAJALENGKA, BAWANG, BANJARNEGARA, JAWA TENGAH",3,138,40,178
https://kawalpemilu.org#91445,"SIDANEGARA, CILACAP TENGAH, CILACAP, JAWA TENGAH",109,91,48,139
https://kawalpemilu.org#33837,"CONDONGCAMPUR, PEJAWARAN, BANJARNEGARA, JAWA TENGAH",3,208,13,221
https://kawalpemilu.org#33419,"BANCAR, PURBALINGGA, PURBALINGGA, JAWA TENGAH",1,138,70,208
https://kawalpemilu.org#32827,"BULUSARI, GANDRUNGMANGU, CILACAP, JAWA TENGAH",19,134,32,166
https://kawalpemilu.org#38924,"MRANGGEN, MRANGGEN, DEMAK, JAWA TENGAH",6,112,106,218
https://kawalpemilu.org#33586,"SIRANDU, KARANGJAMBU, PURBALINGGA, JAWA TENGAH",3,147,13,160
https://kawalpemilu.org#35824,"KENDEL, KEMUSU, BOYOLALI, JAWA TENGAH",8,98,26,124
https://kawalpemilu.org#41697,"SENDANGMULYO, TEMBALANG, KOTA SEMARANG, JAWA TENGAH",12,164,74,238
https://kawalpemilu.org#41139,"SURADADI, SURADADI, TEGAL, JAWA TENGAH",15,120,24,144
https://kawalpemilu.org#39855,"BOJA, BOJA, KENDAL, JAWA TENGAH",16,142,59,201
https://kawalpemilu.org#39095,"NGEGOT, MIJEN, DEMAK, JAWA TENGAH",5,131,47,178
https://kawalpemilu.org#39372,"KLEPU, PRINGAPUS, SEMARANG, JAWA TENGAH",11,192,54,246
https://kawalpemilu.org#40928,"PAMIRITAN, BALAPULANG, TEGAL, JAWA TENGAH",7,95,90,185
https://kawalpemilu.org#37210,"DAWUNG, JENAR, SRAGEN, JAWA TENGAH",7,138,19,157
https://kawalpemilu.org#37275,"GENENGADAL, TOROH, GROBOGAN, JAWA TENGAH",8,156,12,168
https://kawalpemilu.org#40144,"GETAS, BAWANG, BATANG, JAWA TENGAH",6,133,14,147
https://kawalpemilu.org#33816,"PAGENTAN, PAGENTAN, BANJARNEGARA, JAWA TENGAH",12,90,92,182
https://kawalpemilu.org#36034,"NGEMPLAK, KARANGNONGKO, KLATEN, JAWA TENGAH",6,151,9,160
https://kawalpemilu.org#34876,"SENDANGSARI, BENER, PURWOREJO, JAWA TENGAH",9,120,10,130
https://kawalpemilu.org#38677,"KLUMPIT, GEBOG, KUDUS, JAWA TENGAH",24,130,46,176
https://kawalpemilu.org#40555,"SILIREJO, TIRTO, PEKALONGAN, JAWA TENGAH",4,211,14,225
https://kawalpemilu.org#36257,"GEMBLEGAN, KALIKOTES, KLATEN, JAWA TENGAH",9,183,31,214
https://kawalpemilu.org#33592,"KRANGEAN, KERTANEGARA, PURBALINGGA, JAWA TENGAH",12,116,71,187
https://kawalpemilu.org#41202,"SINDANGWANGI, BANTARKAWUNG, BREBES, JAWA TENGAH",29,116,43,159
https://kawalpemilu.org#38907,"KAWAK, PAKIS AJI, JEPARA, JAWA TENGAH",8,188,35,223
https://kawalpemilu.org#87455,"LIMBANGAN, WANAREJA, CILACAP, JAWA TENGAH",17,151,54,205
https://kawalpemilu.org#40565,"JERUKSARI, TIRTO, PEKALONGAN, JAWA TENGAH",12,152,14,166
https://kawalpemilu.org#39981,"KARANGSARI, KENDAL, KENDAL, JAWA TENGAH",5,106,76,182
https://kawalpemilu.org#36114,"JELOBO, WONOSARI, KLATEN, JAWA TENGAH",7,125,55,180
https://kawalpemilu.org#35973,"MANDONG, TRUCUK, KLATEN, JAWA TENGAH",5,165,29,194
https://kawalpemilu.org#40973,"LEBAKWANGI, JATINEGARA, TEGAL, JAWA TENGAH",10,147,20,167
https://kawalpemilu.org#41049,"PEGIRIKAN, TALANG, TEGAL, JAWA TENGAH",3,158,65,223
https://kawalpemilu.org#40794,"KLAREYAN, PETARUKAN, PEMALANG, JAWA TENGAH",16,0,0,0
https://kawalpemilu.org#39763,"PARAKANSEBARAN, PAGERUYUNG, KENDAL, JAWA TENGAH",7,91,43,134
https://kawalpemilu.org#37071,"BANARAN, SAMBUNGMACAN, SRAGEN, JAWA TENGAH",29,0,0,0
https://kawalpemilu.org#40225,"KALIBOYO, TULIS, BATANG, JAWA TENGAH",4,89,74,163
https://kawalpemilu.org#41656,"PALEBON, PEDURUNGAN, KOTA SEMARANG, JAWA TENGAH",22,135,51,186
https://kawalpemilu.org#35466,"NGABLAK, NGABLAK, MAGELANG, JAWA TENGAH",7,132,27,159
https://kawalpemilu.org#36838,"NGADILUWIH, MATESIH, KARANGANYAR, JAWA TENGAH",18,86,40,126
https://kawalpemilu.org#37107,"JETAK, SIDOHARJO, SRAGEN, JAWA TENGAH",13,179,44,223
https://kawalpemilu.org#34770,"ROWOBAYEM, KEMIRI, PURWOREJO, JAWA TENGAH",7,120,51,171
https://kawalpemilu.org#35318,"PABELAN, MUNGKID, MAGELANG, JAWA TENGAH",7,148,98,246
https://kawalpemilu.org#33651,"PETIR, PURWONEGORO, BANJARNEGARA, JAWA TENGAH",4,140,9,149
https://kawalpemilu.org#34993,"PACARMULYO, LEKSONO, WONOSOBO, JAWA TENGAH",8,116,67,183
https://kawalpemilu.org#37537,"SUMBEREJO, RANDUBLATUNG, BLORA, JAWA TENGAH",12,119,38,157
https://kawalpemilu.org#34380,"PLUMBON, KARANGSAMBUNG, KEBUMEN, JAWA TENGAH",8,90,32,122
https://kawalpemilu.org#40813,"TEGALSARI BARAT, AMPELGADING, PEMALANG, JAWA TENGAH",13,99,42,141
https://kawalpemilu.org#33680,"SOKANANDI, BANJARNEGARA, BANJARNEGARA, JAWA TENGAH",16,119,102,221
https://kawalpemilu.org#38817,"TENGGULI, BANGSRI, JEPARA, JAWA TENGAH",21,184,29,213
https://kawalpemilu.org#33304,"KARANGNANGKA, KEDUNG BANTENG, BANYUMAS, JAWA TENGAH",13,170,31,201
https://kawalpemilu.org#35174,"KALIKARUNG, KALIBAWANG, WONOSOBO, JAWA TENGAH",17,147,12,159
https://kawalpemilu.org#37610,"BLEBOH, JIKEN, BLORA, JAWA TENGAH",6,128,29,157
https://kawalpemilu.org#39860,"KARANGTENGAH, KALIWUNGU, KENDAL, JAWA TENGAH",1,133,72,205
https://kawalpemilu.org#39785,"MULYOSARI, SUKOREJO, KENDAL, JAWA TENGAH",5,135,54,189
https://kawalpemilu.org#33689,"SOKAYASA, BANJARNEGARA, BANJARNEGARA, JAWA TENGAH",9,138,55,193
https://kawalpemilu.org#37439,"KETANGIREJO, GODONG, GROBOGAN, JAWA TENGAH",1,128,38,166
https://kawalpemilu.org#38785,"MINDAHAN KIDUL, BATEALIT, JEPARA, JAWA TENGAH",4,192,20,9
https://kawalpemilu.org#34780,"GIRIMULYO, KEMIRI, PURWOREJO, JAWA TENGAH",4,120,10,130
https://kawalpemilu.org#34894,"KALIJAMBE, BENER, PURWOREJO, JAWA TENGAH",5,110,37,147
https://kawalpemilu.org#33312,"KUTALIMAN, KEDUNG BANTENG, BANYUMAS, JAWA TENGAH",4,167,44,211
https://kawalpemilu.org#40740,"WIDURI, PEMALANG, PEMALANG, JAWA TENGAH",13,129,39,168
https://kawalpemilu.org#41626,"SAWAH BESAR, GAYAM SARI, KOTA SEMARANG, JAWA TENGAH",19,205,31,236
https://kawalpemilu.org#35230,"JAMUSKAUMAN, NGLUWAR, MAGELANG, JAWA TENGAH",10,170,59,229
https://kawalpemilu.org#37750,"BAKAH, KUNDURAN, BLORA, JAWA TENGAH",6,137,19,156
https://kawalpemilu.org#33763,"GELANG, RAKIT, BANJARNEGARA, JAWA TENGAH",3,175,41,216
https://kawalpemilu.org#32852,"BABAKAN, KARANGPUCUNG, CILACAP, JAWA TENGAH",4,78,109,187
https://kawalpemilu.org#37656,"JEPANGREJO, BLORA, BLORA, JAWA TENGAH",17,95,34,129
https://kawalpemilu.org#34089,"NGABEAN, MIRIT, KEBUMEN, JAWA TENGAH",4,95,57,152
https://kawalpemilu.org#35697,"DUKUH, BANYUDONO, BOYOLALI, JAWA TENGAH",5,201,49,250
https://kawalpemilu.org#37410,"NGEMBAK, PURWODADI, GROBOGAN, JAWA TENGAH",13,165,29,194
https://kawalpemilu.org#36899,"PANDEYAN, TASIKMADU, KARANGANYAR, JAWA TENGAH",2,153,50,203
https://kawalpemilu.org#40907,"KAJENENGAN, BOJONG, TEGAL, JAWA TENGAH",10,86,72,158
https://kawalpemilu.org#37429,"KLAMBU, KLAMBU, GROBOGAN, JAWA TENGAH",5,153,30,183
https://kawalpemilu.org#33763,"GELANG, RAKIT, BANJARNEGARA, JAWA TENGAH",10,165,35,200
https://kawalpemilu.org#34615,"CONDONGSARI, BANYUURIP, PURWOREJO, JAWA TENGAH",5,97,55,152
https://kawalpemilu.org#36912,"BRUJUL, JATEN, KARANGANYAR, JAWA TENGAH",16,162,38,200
https://kawalpemilu.org#36995,"BANARAN, KALIJAMBE, SRAGEN, JAWA TENGAH",12,148,57,205
https://kawalpemilu.org#37108,"SIDOHARJO, SIDOHARJO, SRAGEN, JAWA TENGAH",12,163,58,221
https://kawalpemilu.org#39040,"BRAKAS, DEMPET, DEMAK, JAWA TENGAH",1,139,26,165
https://kawalpemilu.org#38629,"KUTUK, UNDAAN, KUDUS, JAWA TENGAH",19,167,7,174
https://kawalpemilu.org#34925,"BENER, KEPIL, WONOSOBO, JAWA TENGAH",7,130,8,138
https://kawalpemilu.org#36637,"JATIMARTO, NGADIROJO, WONOGIRI, JAWA TENGAH",12,89,2,91
https://kawalpemilu.org#33814,"KAREKAN, PAGENTAN, BANJARNEGARA, JAWA TENGAH",1,125,47,172
https://kawalpemilu.org#35133,"MLANDI, GARUNG, WONOSOBO, JAWA TENGAH",3,104,112,216
https://kawalpemilu.org#33628,"KALIWINASUH, PURWOREJO KLAMPOK, BANJARNEGARA, JAWA TENGAH",14,137,43,180
https://kawalpemilu.org#40747,"SEWAKA, PEMALANG, PEMALANG, JAWA TENGAH",18,156,45,201
https://kawalpemilu.org#37550,"GETAS, KRADENAN, BLORA, JAWA TENGAH",14,138,17,155
https://kawalpemilu.org#39389,"BOTO, BANCAK, SEMARANG, JAWA TENGAH",7,189,39,228
https://kawalpemilu.org#38249,"RONGGO, JAKEN, PATI, JAWA TENGAH",9,164,47,211
https://kawalpemilu.org#38399,"NGAWEN, MARGOREJO, PATI, JAWA TENGAH",1,167,33,200
https://kawalpemilu.org#41564,"KAUMAN KIDUL, SIDOREJO, KOTA SALATIGA, JAWA TENGAH",1,89,48,137
https://kawalpemilu.org#36792,"NGEPUNGSARI, JATIPURO, KARANGANYAR, JAWA TENGAH",13,81,7,88
https://kawalpemilu.org#38177,"KEBEN, TAMBAKROMO, PATI, JAWA TENGAH",12,157,0,157
https://kawalpemilu.org#87431,"TAMBAKSARI, KEDUNGREJA, CILACAP, JAWA TENGAH",14,109,98,207
https://kawalpemilu.org#40892,"CAWITALI, BUMIJAWA, TEGAL, JAWA TENGAH",1,63,93,156
https://kawalpemilu.org#41238,"BENDA, SIRAMPOG, BREBES, JAWA TENGAH",23,117,27,144
https://kawalpemilu.org#38146,"SUKOLILO, SUKOLILO, PATI, JAWA TENGAH",9,184,40,224
https://kawalpemilu.org#37304,"JATIHARJO, PULOKULON, GROBOGAN, JAWA TENGAH",3,176,14,190
https://kawalpemilu.org#38663,"TANJUNGREJO, JEKULO, KUDUS, JAWA TENGAH",13,179,63,242
https://kawalpemilu.org#41606,"PURWOSARI, SEMARANG UTARA, KOTA SEMARANG, JAWA TENGAH",14,162,42,204
https://kawalpemilu.org#38124,"SODITAN, LASEM, REMBANG, JAWA TENGAH",12,136,48,184
https://kawalpemilu.org#32877,"JENANG, MAJENANG, CILACAP, JAWA TENGAH",20,157,83,240
https://kawalpemilu.org#38696,"LAU, DAWE, KUDUS, JAWA TENGAH",4,157,19,176
https://kawalpemilu.org#32866,"KARANGSARI, CIMANGGU, CILACAP, JAWA TENGAH",19,109,8,117
https://kawalpemilu.org#87510,"TAMBAKSARI, WANAREJA, CILACAP, JAWA TENGAH",8,73,122,195
https://kawalpemilu.org#33551,"BOJONGSARI, BOJONGSARI, PURBALINGGA, JAWA TENGAH",2,170,59,229
https://kawalpemilu.org#40884,"BEGAWAT, BUMIJAWA, TEGAL, JAWA TENGAH",2,125,29,154
https://kawalpemilu.org#39236,"KEDUNGRINGIN, SURUH, SEMARANG, JAWA TENGAH",13,98,46,144
https://kawalpemilu.org#40869,"KARANGDAWA, MARGASARI, TEGAL, JAWA TENGAH",20,130,49,179
https://kawalpemilu.org#39378,"CANDIREJO, PRINGAPUS, SEMARANG, JAWA TENGAH",2,181,69,250
https://kawalpemilu.org#38896,"TUBANAN, KEMBANG, JEPARA, JAWA TENGAH",16,214,20,234
https://kawalpemilu.org#33386,"KRENCENG, KEJOBONG, PURBALINGGA, JAWA TENGAH",6,180,29,209
https://kawalpemilu.org#35178,"MERGOLANGU, KALIBAWANG, WONOSOBO, JAWA TENGAH",7,172,41,213
https://kawalpemilu.org#38665,"DERSALAM, BAE, KUDUS, JAWA TENGAH",21,143,49,192
https://kawalpemilu.org#40301,"SELOKARTO, PECALUNGAN, BATANG, JAWA TENGAH",2,187,19,206
https://kawalpemilu.org#33600,"KARANGTENGAH, KERTANEGARA, PURBALINGGA, JAWA TENGAH",7,119,46,165
https://kawalpemilu.org#40051,"SUKOMULYO, KALIWUNGU SELATAN, KENDAL, JAWA TENGAH",10,172,55,227
https://kawalpemilu.org#34618,"JONO, BAYAN, PURWOREJO, JAWA TENGAH",2,152,37,189
https://kawalpemilu.org#33106,"KARANGDADAP, KALIBAGOR, BANYUMAS, JAWA TENGAH",4,156,38,194
https://kawalpemilu.org#39808,"SIDODADI, PATEAN, KENDAL, JAWA TENGAH",12,154,12,166
https://kawalpemilu.org#38046,"KABONGAN KIDUL, REMBANG, REMBANG, JAWA TENGAH",5,103,69,172
https://kawalpemilu.org#33749,"KASILIB, WANADADI, BANJARNEGARA, JAWA TENGAH",3,136,70,206
https://kawalpemilu.org#33614,"KARANGSALAM, SUSUKAN, BANJARNEGARA, JAWA TENGAH",4,157,32,189
https://kawalpemilu.org#35548,"SIDOMULYO, SECANG, MAGELANG, JAWA TENGAH",12,129,40,169
https://kawalpemilu.org#40464,"SRAGI, SRAGI, PEKALONGAN, JAWA TENGAH",14,139,85,224
https://kawalpemilu.org#41837,"KRATON, TEGAL BARAT, KOTA TEGAL, JAWA TENGAH",26,143,104,247
https://kawalpemilu.org#38644,"TEMULUS, MEJOBO, KUDUS, JAWA TENGAH",22,133,47,180
https://kawalpemilu.org#40838,"PAGERGUNUNG, ULUJAMI, PEMALANG, JAWA TENGAH",16,162,31,193
https://kawalpemilu.org#32880,"BENER, MAJENANG, CILACAP, JAWA TENGAH",2,72,84,156
https://kawalpemilu.org#36064,"SOBAYAN, PEDAN, KLATEN, JAWA TENGAH",12,157,51,208
https://kawalpemilu.org#40871,"JATILABA, MARGASARI, TEGAL, JAWA TENGAH",21,122,46,168
https://kawalpemilu.org#41727,"KANDRI, GUNUNGPATI, KOTA SEMARANG, JAWA TENGAH",4,151,59,210
https://kawalpemilu.org#38881,"MARGOYOSO, KALINYAMATAN, JEPARA, JAWA TENGAH",2,159,89,248
https://kawalpemilu.org#39741,"SUCEN, GEMAWANG, TEMANGGUNG, JAWA TENGAH",2,204,19,223
https://kawalpemilu.org#40718,"PENUSUPAN, RANDUDONGKAL, PEMALANG, JAWA TENGAH",5,78,73,151
https://kawalpemilu.org#36446,"KRAJAN, GATAK, SUKOHARJO, JAWA TENGAH",1,228,23,251
https://kawalpemilu.org#37486,"KEBONAGUNG, TEGOWANU, GROBOGAN, JAWA TENGAH",9,186,33,219
https://kawalpemilu.org#39787,"TRIMULYO, SUKOREJO, KENDAL, JAWA TENGAH",4,108,69,177
https://kawalpemilu.org#32989,"CANDUK, LUMBIR, BANYUMAS, JAWA TENGAH",8,105,102,207
https://kawalpemilu.org#37307,"PANUNGGALAN, PULOKULON, GROBOGAN, JAWA TENGAH",6,131,58,189
https://kawalpemilu.org#32874,"PAHONJEAN, MAJENANG, CILACAP, JAWA TENGAH",30,141,59,200
https://kawalpemilu.org#35557,"CANDISARI, WINDUSARI, MAGELANG, JAWA TENGAH",13,191,29,220
https://kawalpemilu.org#33608,"GUMELEM KULON, SUSUKAN, BANJARNEGARA, JAWA TENGAH",12,133,61,194
https://kawalpemilu.org#39117,"CABEAN, DEMAK, DEMAK, JAWA TENGAH",6,167,51,218
https://kawalpemilu.org#41683,"LEMPONGSARI, GAJAH MUNGKUR, KOTA SEMARANG, JAWA TENGAH",2,138,63,201
https://kawalpemilu.org#37342,"KARANGREJO, GABUS, GROBOGAN, JAWA TENGAH",9,161,17,178
https://kawalpemilu.org#33919,"DEMANGSARI, AYAH, KEBUMEN, JAWA TENGAH",16,101,67,168
https://kawalpemilu.org#32855,"TAYEM TIMUR, KARANGPUCUNG, CILACAP, JAWA TENGAH",14,63,54,117
https://kawalpemilu.org#35810,"ANDONG, ANDONG, BOYOLALI, JAWA TENGAH",5,150,33,183
https://kawalpemilu.org#32865,"CIBALUNG, CIMANGGU, CILACAP, JAWA TENGAH",12,47,112,159
https://kawalpemilu.org#36423,"SANGGRAHAN, GROGOL, SUKOHARJO, JAWA TENGAH",11,199,76,275
https://kawalpemilu.org#40528,"PROTO, KEDUNGWUNI, PEKALONGAN, JAWA TENGAH",7,195,16,211
https://kawalpemilu.org#41539,"JAGALAN, JEBRES, KOTA SURAKARTA, JAWA TENGAH",13,217,12,229
https://kawalpemilu.org#33955,"BANJAREJO, PURING, KEBUMEN, JAWA TENGAH",9,127,31,158
https://kawalpemilu.org#33737,"SIJERUK, BANJARMANGU, BANJARNEGARA, JAWA TENGAH",7,167,47,214
https://kawalpemilu.org#33252,"PURWODADI, KEMBARAN, BANYUMAS, JAWA TENGAH",3,107,97,204
https://kawalpemilu.org#38613,"PLOSO, JATI, KUDUS, JAWA TENGAH",18,121,57,178
https://kawalpemilu.org#33028,"TAMBAKNEGARA, RAWALO, BANYUMAS, JAWA TENGAH",25,139,43,182
https://kawalpemilu.org#40329,"LAMBUR, KANDANGSERANG, PEKALONGAN, JAWA TENGAH",12,104,66,170
https://kawalpemilu.org#34947,"TALUNOMBO, SAPURAN, WONOSOBO, JAWA TENGAH",2,137,30,167
https://kawalpemilu.org#34128,"SUROTRUNAN, ALIAN, KEBUMEN, JAWA TENGAH",6,73,29,102
https://kawalpemilu.org#38844,"LANGON, TAHUNAN, JEPARA, JAWA TENGAH",14,196,18,214
https://kawalpemilu.org#39552,"KUTOANYAR, KEDU, TEMANGGUNG, JAWA TENGAH",2,220,38,258
https://kawalpemilu.org#38620,"NGEMBAL KULON, JATI, KUDUS, JAWA TENGAH",7,95,98,193
https://kawalpemilu.org#37725,"TREMBULREJO, NGAWEN, BLORA, JAWA TENGAH",8,168,20,188
https://kawalpemilu.org#40013,"JUNGSEMI, KANGKUNG, KENDAL, JAWA TENGAH",1,147,15,162
https://kawalpemilu.org#33205,"CILONGOK, CILONGOK, BANYUMAS, JAWA TENGAH",2,113,68,181
https://kawalpemilu.org#38629,"KUTUK, UNDAAN, KUDUS, JAWA TENGAH",1,120,45,165
https://kawalpemilu.org#33924,"JLADRI, BUAYAN, KEBUMEN, JAWA TENGAH",3,160,59,219
https://kawalpemilu.org#39333,"ASINAN, BAWEN, SEMARANG, JAWA TENGAH",3,163,31,194
https://kawalpemilu.org#40894,"REMBUL, BOJONG, TEGAL, JAWA TENGAH",7,123,46,169
https://kawalpemilu.org#34150,"MURTIREJO, KEBUMEN, KEBUMEN, JAWA TENGAH",2,103,47,150
https://kawalpemilu.org#91441,"TAMBAKREJA, CILACAP SELATAN, CILACAP, JAWA TENGAH",33,148,70,218
https://kawalpemilu.org#36756,"WALENG, GIRIMARTO, WONOGIRI, JAWA TENGAH",1,157,19,176
https://kawalpemilu.org#37064,"PLUMBON, SAMBUNGMACAN, SRAGEN, JAWA TENGAH",1,115,22,137
https://kawalpemilu.org#40057,"GRINGGINGSARI, WONOTUNGGAL, BATANG, JAWA TENGAH",3,141,28,169
https://kawalpemilu.org#34199,"KARANGPULE, SRUWENG, KEBUMEN, JAWA TENGAH",1,100,47,147
https://kawalpemilu.org#39786,"KALIPAKIS, SUKOREJO, KENDAL, JAWA TENGAH",1,115,40,155
https://kawalpemilu.org#32870,"KARANGREJA, CIMANGGU, CILACAP, JAWA TENGAH",15,99,44,143
https://kawalpemilu.org#41529,"KEDUNGLUMBU, PASAR KLIWON, KOTA SURAKARTA, JAWA TENGAH",4,105,135,240
https://kawalpemilu.org#41428,"SITANGGAL, LARANGAN, BREBES, JAWA TENGAH",10,87,48,135
https://kawalpemilu.org#35042,"WRINGINANOM, KERTEK, WONOSOBO, JAWA TENGAH",8,143,48,191
https://kawalpemilu.org#33761,"PINGIT, RAKIT, BANJARNEGARA, JAWA TENGAH",17,139,35,174
https://kawalpemilu.org#35745,"SEMBUNGAN, NOGOSARI, BOYOLALI, JAWA TENGAH",15,164,15,179
https://kawalpemilu.org#39974,"JETIS, KENDAL, KENDAL, JAWA TENGAH",1,167,70,237
https://kawalpemilu.org#38965,"BAKALREJO, GUNTUR, DEMAK, JAWA TENGAH",16,178,26,204
https://kawalpemilu.org#40153,"SIDALANG, TERSONO, BATANG, JAWA TENGAH",2,142,27,169
https://kawalpemilu.org#41774,"KARANGANYAR, TUGU, KOTA SEMARANG, JAWA TENGAH",11,147,48,195
https://kawalpemilu.org#36297,"KARANGANYAR, WERU, SUKOHARJO, JAWA TENGAH",5,155,42,197
https://kawalpemilu.org#37094,"SINE, SRAGEN, SRAGEN, JAWA TENGAH",19,116,26,142
https://kawalpemilu.org#34175,"KUWAYUHAN, PEJAGOAN, KEBUMEN, JAWA TENGAH",6,120,28,148
https://kawalpemilu.org#41200,"PANGEBATAN, BANTARKAWUNG, BREBES, JAWA TENGAH",37,38,88,126
https://kawalpemilu.org#34957,"NGADIKERSO, SAPURAN, WONOSOBO, JAWA TENGAH",5,123,15,138
https://kawalpemilu.org#39269,"KESONGO, TUNTANG, SEMARANG, JAWA TENGAH",6,210,42,252
https://kawalpemilu.org#39330,"BAWEN, BAWEN, SEMARANG, JAWA TENGAH",29,210,49,259
https://kawalpemilu.org#39916,"MANGGUNGSARI, WELERI, KENDAL, JAWA TENGAH",1,120,6,126
https://kawalpemilu.org#37273,"BANDUNGHARJO, TOROH, GROBOGAN, JAWA TENGAH",21,160,4,164
https://kawalpemilu.org#37040,"WONOKERSO, KEDAWUNG, SRAGEN, JAWA TENGAH",14,125,34,159
https://kawalpemilu.org#34427,"PAGAK, NGOMBOL, PURWOREJO, JAWA TENGAH",2,146,18,164
https://kawalpemilu.org#41438,"CIKEUSAL LOR, KETANGGUNGAN, BREBES, JAWA TENGAH",9,201,41,242
https://kawalpemilu.org#41102,"BUMIHARJA, TARUB, TEGAL, JAWA TENGAH",2,139,79,218
https://kawalpemilu.org#36869,"BANGSRI, KARANGPANDAN, KARANGANYAR, JAWA TENGAH",4,144,72,216
https://kawalpemilu.org#35291,"BUTUH, SAWANGAN, MAGELANG, JAWA TENGAH",6,154,46,200
https://kawalpemilu.org#35035,"TEGALOMBO, KALIKAJAR, WONOSOBO, JAWA TENGAH",1,224,30,254
https://kawalpemilu.org#32833,"SIDAREJA, SIDAREJA, CILACAP, JAWA TENGAH",2,176,32,208
https://kawalpemilu.org#35450,"KAPONAN, PAKIS, MAGELANG, JAWA TENGAH",10,203,16,219
https://kawalpemilu.org#37005,"SOMOMORODUKUH, PLUPUH, SRAGEN, JAWA TENGAH",10,126,9,135
https://kawalpemilu.org#34908,"WADASLINTANG, WADASLINTANG, WONOSOBO, JAWA TENGAH",1,164,32,196
https://kawalpemilu.org#33424,"PURBALINGGA KULON, PURBALINGGA, PURBALINGGA, JAWA TENGAH",5,151,75,226
https://kawalpemilu.org#38728,"KARANGRANDU, PECANGAAN, JEPARA, JAWA TENGAH",14,149,81,230
https://kawalpemilu.org#35180,"KALIALANG, KALIBAWANG, WONOSOBO, JAWA TENGAH",1,90,30,120
https://kawalpemilu.org#36888,"BEJEN, KARANGANYAR, KARANGANYAR, JAWA TENGAH",39,213,27,240
https://kawalpemilu.org#51140,"TEMPUREJO, PESANTREN, KOTA KEDIRI, JAWA TIMUR",12,135,41,176
https://kawalpemilu.org#49124,"KETAMBUL, PALANG, TUBAN, JAWA TIMUR",9,127,44,171
https://kawalpemilu.org#48161,"KENDAL, KENDAL, NGAWI, JAWA TIMUR",6,119,60,179
https://kawalpemilu.org#46577,"KEDUNGTURI, TAMAN, SIDOARJO, JAWA TIMUR",10,165,54,219
https://kawalpemilu.org#51287,"PURWOREJO, PURWOREJO, KOTA PASURUAN, JAWA TIMUR",10,138,71,209
https://kawalpemilu.org#45305,"SEKARPUTIH, TEGALAMPEL, BONDOWOSO, JAWA TIMUR",14,65,81,146
https://kawalpemilu.org#42472,"KETEPUNG, KEBONAGUNG, PACITAN, JAWA TIMUR",7,43,124,167
https://kawalpemilu.org#43549,"BUTUN, GANDUSARI, BLITAR, JAWA TIMUR",3,122,42,164
https://kawalpemilu.org#44533,"PURWOREJO, SENDURO, LUMAJANG, JAWA TIMUR",15,157,53,210
https://kawalpemilu.org#45874,"BANJARSARI, SUMBERASIH, PROBOLINGGO, JAWA TIMUR",19,187,64,251
https://kawalpemilu.org#48024,"TEBON, BARAT, MAGETAN, JAWA TIMUR",2,137,67,204
https://kawalpemilu.org#51438,"PERAK UTARA, PABEAN CANTIKAN, KOTA SURABAYA, JAWA TIMUR",51,53,91,144
https://kawalpemilu.org#43645,"JUGO, MOJO, KEDIRI, JAWA TIMUR",6,107,25,132
https://kawalpemilu.org#47684,"KETANDAN, DAGANGAN, MADIUN, JAWA TIMUR",1,152,14,166
https://kawalpemilu.org#51211,"KEBONSARI, SUKUN, KOTA MALANG, JAWA TIMUR",16,134,118,252
https://kawalpemilu.org#43546,"GONDANG, GANDUSARI, BLITAR, JAWA TIMUR",3,115,29,144
https://kawalpemilu.org#44927,"SUMBERAGUNG, PESANGGARAN, BANYUWANGI, JAWA TIMUR",13,156,26,182
https://kawalpemilu.org#47595,"GONDANGKULON, GONDANG, NGANJUK, JAWA TIMUR",7,163,16,179
https://kawalpemilu.org#44750,"AMBULU, AMBULU, JEMBER, JAWA TIMUR",16,106,96,202
https://kawalpemilu.org#51466,"SIDOTOPO WETAN, KENJERAN, KOTA SURABAYA, JAWA TIMUR",100,123,83,206
https://kawalpemilu.org#50405,"TAMBAK, OMBEN, SAMPANG, JAWA TIMUR",16,39,156,195
https://kawalpemilu.org#43271,"ARIYOJEDING, REJOTANGAN, TULUNGAGUNG, JAWA TIMUR",8,137,41,178
https://kawalpemilu.org#43944,"NGABLAK, BANYAKAN, KEDIRI, JAWA TIMUR",8,125,46,171
https://kawalpemilu.org#44461,"TEMPEH TENGAH, TEMPEH, LUMAJANG, JAWA TIMUR",23,158,47,205
https://kawalpemilu.org#51013,"PANCOR, GAYAM, SUMENEP, JAWA TIMUR",20,40,128,168
https://kawalpemilu.org#51504,"KENDANGSARI, TENGGILIS MEJOYO, KOTA SURABAYA, JAWA TIMUR",13,162,64,226
https://kawalpemilu.org#43880,"SIDOREJO, PARE, KEDIRI, JAWA TIMUR",15,221,13,234
https://kawalpemilu.org#50715,"PAMAROH, KADUR, PAMEKASAN, JAWA TIMUR",2,32,139,171
https://kawalpemilu.org#44343,"MADIREDO, PUJON, MALANG, JAWA TIMUR",13,114,11,125
https://kawalpemilu.org#43058,"MALASAN, DURENAN, TRENGGALEK, JAWA TIMUR",8,153,41,194
https://kawalpemilu.org#43688,"DUKUH, NGADILUWIH, KEDIRI, JAWA TIMUR",24,137,33,170
https://kawalpemilu.org#44526,"JAMBEKUMBU, PASRUJAMBE, LUMAJANG, JAWA TIMUR",16,116,38,154
https://kawalpemilu.org#47574,"MUSIR KIDUL, REJOSO, NGANJUK, JAWA TIMUR",8,149,26,175
https://kawalpemilu.org#44664,"GELANG, SUMBERBARU, JEMBER, JAWA TIMUR",18,28,113,141
https://kawalpemilu.org#44306,"CANDIRENGGO, SINGOSARI, MALANG, JAWA TIMUR",16,133,96,229
https://kawalpemilu.org#43115,"KETANON, KEDUNGWARU, TULUNGAGUNG, JAWA TIMUR",32,108,40,148
https://kawalpemilu.org#44567,"KEBONAGUNG, SUKODONO, LUMAJANG, JAWA TIMUR",2,103,113,216
https://kawalpemilu.org#45282,"DABASAH, BONDOWOSO, BONDOWOSO, JAWA TIMUR",22,117,72,189
https://kawalpemilu.org#51394,"PUTAT JAYA, SAWAHAN, KOTA SURABAYA, JAWA TIMUR",86,145,52,197
https://kawalpemilu.org#50944,"RUBARU, RUBARU, SUMENEP, JAWA TIMUR",7,24,188,212
https://kawalpemilu.org#51061,"ARJASA, ARJASA, SUMENEP, JAWA TIMUR",12,32,122,154
https://kawalpemilu.org#50491,"TOBAI TENGAH, SOKOBANAH, SAMPANG, JAWA TIMUR",9,35,228,263
https://kawalpemilu.org#43472,"KEMLOKO, NGLEGOK, BLITAR, JAWA TIMUR",17,167,21,188
https://kawalpemilu.org#51354,"KEJURON, TAMAN, KOTA MADIUN, JAWA TIMUR",25,130,58,188
https://kawalpemilu.org#44627,"ALUN ALUN, RANUYOSO, LUMAJANG, JAWA TIMUR",5,116,64,180
https://kawalpemilu.org#49355,"KRETERANGGON, SAMBENG, LAMONGAN, JAWA TIMUR",2,186,45,231
https://kawalpemilu.org#43396,"WONOREJO, SRENGAT, BLITAR, JAWA TIMUR",3,146,48,194
https://kawalpemilu.org#45439,"SUMBERANYAR, MLANDINGAN, SITUBONDO, JAWA TIMUR",11,48,46,94
https://kawalpemilu.org#42784,"POHIJO, SAMPUNG, PONOROGO, JAWA TIMUR",4,153,15,168
https://kawalpemilu.org#49560,"MADE, LAMONGAN, LAMONGAN, JAWA TIMUR",17,84,123,207
https://kawalpemilu.org#43106,"RINGINPITU, KEDUNGWARU, TULUNGAGUNG, JAWA TIMUR",25,144,9,153
https://kawalpemilu.org#51050,"PASERAMAN, ARJASA, SUMENEP, JAWA TIMUR",12,14,107,121
https://kawalpemilu.org#51549,"LONTAR, SAMBIKEREP, KOTA SURABAYA, JAWA TIMUR",61,162,31,193
https://kawalpemilu.org#49991,"KROMAN, GRESIK, GRESIK, JAWA TIMUR",3,182,61,243
https://kawalpemilu.org#89596,"GEDANGSEWU, PARE, KEDIRI, JAWA TIMUR",2,192,23,215
https://kawalpemilu.org#47744,"TIRON, MADIUN, MADIUN, JAWA TIMUR",1,111,63,174
https://kawalpemilu.org#42955,"NGEPEH, TUGU, TRENGGALEK, JAWA TIMUR",12,179,22,201
https://kawalpemilu.org#45126,"SEMPU, SEMPU, BANYUWANGI, JAWA TIMUR",11,170,21,191
https://kawalpemilu.org#45995,"WRATI, KEJAYAN, PASURUAN, JAWA TIMUR",12,115,108,223
https://kawalpemilu.org#48536,"KABALAN, KANOR, BOJONEGORO, JAWA TIMUR",7,138,31,169
https://kawalpemilu.org#47020,"BLIMBING, GUDO, JOMBANG, JAWA TIMUR",12,144,44,188
https://kawalpemilu.org#48431,"SUMBERAGUNG, DANDER, BOJONEGORO, JAWA TIMUR",8,95,47,142
https://kawalpemilu.org#45727,"PETUNJUNGAN, PAITON, PROBOLINGGO, JAWA TIMUR",6,111,68,179
https://kawalpemilu.org#50986,"DUNGKEK, DUNGKEK, SUMENEP, JAWA TIMUR",5,55,101,156
https://kawalpemilu.org#45799,"PAJARAKAN KULON, PAJARAKAN, PROBOLINGGO, JAWA TIMUR",4,125,75,200
https://kawalpemilu.org#44267,"BALESARI, NGAJUM, MALANG, JAWA TIMUR",3,98,41,139
https://kawalpemilu.org#47953,"DADI, PLAOSAN, MAGETAN, JAWA TIMUR",13,182,24,206
https://kawalpemilu.org#48683,"SUMBEREJO, MALO, BOJONEGORO, JAWA TIMUR",5,72,36,108
https://kawalpemilu.org#51216,"BANDULAN, SUKUN, KOTA MALANG, JAWA TIMUR",19,189,47,236
https://kawalpemilu.org#44231,"KEDUNGREJO, PAKIS, MALANG, JAWA TIMUR",6,125,47,172
https://kawalpemilu.org#48286,"MANTINGAN, MANTINGAN, NGAWI, JAWA TIMUR",20,152,12,164
https://kawalpemilu.org#44267,"BALESARI, NGAJUM, MALANG, JAWA TIMUR",15,155,44,199
https://kawalpemilu.org#45424,"PESISIR, BESUKI, SITUBONDO, JAWA TIMUR",15,84,49,133
https://kawalpemilu.org#46376,"KEBONAGUNG, PORONG, SIDOARJO, JAWA TIMUR",1,117,36,153
https://kawalpemilu.org#46520,"KARANGPURI, WONOAYU, SIDOARJO, JAWA TIMUR",6,153,65,218
https://kawalpemilu.org#42735,"BULU KIDUL, BALONG, PONOROGO, JAWA TIMUR",3,99,58,157
https://kawalpemilu.org#50005,"LEBAK, SANGKAPURA, GRESIK, JAWA TIMUR",8,42,95,137
https://kawalpemilu.org#43910,"MLANCU, KANDANGAN, KEDIRI, JAWA TIMUR",11,168,31,199
https://kawalpemilu.org#927586,"BENOWO, PAKAL, KOTA SURABAYA, JAWA TIMUR",21,164,97,261
https://kawalpemilu.org#45490,"KANDANG, KAPONGAN, SITUBONDO, JAWA TIMUR",2,112,78,190
https://kawalpemilu.org#48084,"NGARIBOYO, NGARIBOYO, MAGETAN, JAWA TIMUR",7,103,60,163
https://kawalpemilu.org#45442,"SUMBER PINANG, MLANDINGAN, SITUBONDO, JAWA TIMUR",2,66,86,152
https://kawalpemilu.org#51271,"GENTONG, GADINGREJO, KOTA PASURUAN, JAWA TIMUR",14,89,81,170
https://kawalpemilu.org#47125,"KEDAWONG, DIWEK, JOMBANG, JAWA TIMUR",2,106,83,189
https://kawalpemilu.org#46650,"CEMANDI, SEDATI, SIDOARJO, JAWA TIMUR",8,123,84,207
https://kawalpemilu.org#51205,"CEMOROKANDANG, KEDUNGKANDANG, KOTA MALANG, JAWA TIMUR",21,145,119,264
https://kawalpemilu.org#44684,"TANJUNGSARI, UMBULSARI, JEMBER, JAWA TIMUR",4,142,50,192
https://kawalpemilu.org#44311,"BANJARARUM, SINGOSARI, MALANG, JAWA TIMUR",39,62,34,96
https://kawalpemilu.org#49998,"SIDO RUKUN, GRESIK, GRESIK, JAWA TIMUR",1,137,139,276
https://kawalpemilu.org#45196,"PAKISAN, TLOGOSARI, BONDOWOSO, JAWA TIMUR",15,118,59,177
https://kawalpemilu.org#42461,"SIDOMULYO, KEBONAGUNG, PACITAN, JAWA TIMUR",11,16,151,167
https://kawalpemilu.org#47670,"SUMBEREJO, GEGER, MADIUN, JAWA TIMUR",1,168,30,198
https://kawalpemilu.org#47344,"NGETOS, NGETOS, NGANJUK, JAWA TIMUR",19,117,40,157
https://kawalpemilu.org#44266,"BABADAN, NGAJUM, MALANG, JAWA TIMUR",17,120,18,138
https://kawalpemilu.org#49148,"GESIKAN, GRABAGAN, TUBAN, JAWA TIMUR",15,177,20,197
https://kawalpemilu.org#48914,"MULYOAGUNG, SINGGAHAN, TUBAN, JAWA TIMUR",19,95,65,160
https://kawalpemilu.org#48441,"PANUNGGALAN, SUGIHWARAS, BOJONEGORO, JAWA TIMUR",4,88,50,138
https://kawalpemilu.org#45142,"BULUSARI, KALIPURO, BANYUWANGI, JAWA TIMUR",3,146,32,178
https://kawalpemilu.org#43438,"KAWEDUSAN, PONGGOK, BLITAR, JAWA TIMUR",16,140,30,170
https://kawalpemilu.org#49432,"KEDUNGSOKO, MANTUP, LAMONGAN, JAWA TIMUR",2,154,48,202
https://kawalpemilu.org#48072,"JERUK, KARTOHARJO, MAGETAN, JAWA TIMUR",1,149,71,220
https://kawalpemilu.org#47799,"SUGIHWARAS, SARADAN, MADIUN, JAWA TIMUR",27,84,42,126
https://kawalpemilu.org#45717,"JABUNG WETAN, PAITON, PROBOLINGGO, JAWA TIMUR",9,122,114,236
https://kawalpemilu.org#43566,"NGADRI, BINANGUN, BLITAR, JAWA TIMUR",7,128,16,144
https://kawalpemilu.org#46084,"WEDORO, PANDAAN, PASURUAN, JAWA TIMUR",11,160,34,194
https://kawalpemilu.org#44521,"DENOK, LUMAJANG, LUMAJANG, JAWA TIMUR",6,164,58,222
https://kawalpemilu.org#51430,"SIDODADI, SIMOKERTO, KOTA SURABAYA, JAWA TIMUR",46,70,86,156
https://kawalpemilu.org#49874,"GEDANGKULUT, CERME, GRESIK, JAWA TIMUR",12,151,55,206
https://kawalpemilu.org#49035,"RENGEL, RENGEL, TUBAN, JAWA TIMUR",8,107,88,195
https://kawalpemilu.org#42965,"PRAMBON, TUGU, TRENGGALEK, JAWA TIMUR",9,124,64,188
https://kawalpemilu.org#51250,"MANGUNHARJO, MAYANGAN, KOTA PROBOLINGGO, JAWA TIMUR",36,142,115,257
https://kawalpemilu.org#46486,"KAJEKSAN, TULANGAN, SIDOARJO, JAWA TIMUR",6,174,56,230
https://kawalpemilu.org#45303,"SUMBER CANTING, WRINGIN, BONDOWOSO, JAWA TIMUR",5,116,43,159
https://kawalpemilu.org#48924,"WOLUTENGAH, KEREK, TUBAN, JAWA TIMUR",1,132,49,181
https://kawalpemilu.org#44241,"TIRTOMOYO, PAKIS, MALANG, JAWA TIMUR",20,163,49,212
https://kawalpemilu.org#50511,"KETAPANG DAYA, KETAPANG, SAMPANG, JAWA TIMUR",27,168,50,218
https://kawalpemilu.org#46459,"SIDOKUMPUL, SIDOARJO, SIDOARJO, JAWA TIMUR",1,150,61,211
https://kawalpemilu.org#42445,"PURWOREJO, PACITAN, PACITAN, JAWA TIMUR",4,36,184,220
https://kawalpemilu.org#43372,"KOLOMAYAN, WONODADI, BLITAR, JAWA TIMUR",8,165,9,174
https://kawalpemilu.org#44142,"KALIASRI, KALIPARE, MALANG, JAWA TIMUR",8,161,16,177
https://kawalpemilu.org#44690,"TANGGULWETAN, TANGGUL, JEMBER, JAWA TIMUR",38,96,102,198
https://kawalpemilu.org#42425,"GONDOSARI, PUNUNG, PACITAN, JAWA TIMUR",10,72,97,169
https://kawalpemilu.org#42919,"NGULUNGWETAN, MUNJUNGAN, TRENGGALEK, JAWA TIMUR",10,158,21,179
https://kawalpemilu.org#45145,"BARUREJO, SILIRAGUNG, BANYUWANGI, JAWA TIMUR",35,159,14,173
https://kawalpemilu.org#45022,"SINGOJURUH, SINGOJURUH, BANYUWANGI, JAWA TIMUR",12,126,55,181
https://kawalpemilu.org#49931,"GEMPOL KURUNG, MENGANTI, GRESIK, JAWA TIMUR",3,127,60,187
https://kawalpemilu.org#45488,"TREBUNGAN, MANGARAN, SITUBONDO, JAWA TIMUR",10,115,64,179
https://kawalpemilu.org#43841,"WONOTENGAH, PURWOASRI, KEDIRI, JAWA TIMUR",7,148,28,176
https://kawalpemilu.org#48714,"CENDONO, PADANGAN, BOJONEGORO, JAWA TIMUR",4,140,49,189
https://kawalpemilu.org#44836,"LENGKONG, MUMBULSARI, JEMBER, JAWA TIMUR",19,123,45,168
https://kawalpemilu.org#48846,"NGROJO, BANGILAN, TUBAN, JAWA TIMUR",3,146,77,223
https://kawalpemilu.org#49161,"KEDUNGREJO, SUKORAME, LAMONGAN, JAWA TIMUR",1,132,56,188
https://kawalpemilu.org#43113,"KEDUNGWARU, KEDUNGWARU, TULUNGAGUNG, JAWA TIMUR",11,120,25,145
https://kawalpemilu.org#45554,"PATEMON, BUNGATAN, SITUBONDO, JAWA TIMUR",7,45,89,134
https://kawalpemilu.org#43362,"JATEN, WONODADI, BLITAR, JAWA TIMUR",4,101,18,119
https://kawalpemilu.org#46934,"KEDUNGSARI, KEMLAGI, MOJOKERTO, JAWA TIMUR",12,195,51,246
https://kawalpemilu.org#51222,"MERJOSARI, LOWOKWARU, KOTA MALANG, JAWA TIMUR",40,137,69,206
https://kawalpemilu.org#47039,"KAUMAN, NGORO, JOMBANG, JAWA TIMUR",6,126,44,170
https://kawalpemilu.org#44623,"JENGGRONG, RANUYOSO, LUMAJANG, JAWA TIMUR",6,53,87,140
https://kawalpemilu.org#43433,"GEMBONGAN, PONGGOK, BLITAR, JAWA TIMUR",37,140,17,157
https://kawalpemilu.org#46861,"SALEN, BANGSAL, MOJOKERTO, JAWA TIMUR",10,171,53,224
https://kawalpemilu.org#43940,"TIRON, BANYAKAN, KEDIRI, JAWA TIMUR",33,92,39,131
https://kawalpemilu.org#44498,"ROWOKANGKUNG, ROWOKANGKUNG, LUMAJANG, JAWA TIMUR",6,179,64,243
https://kawalpemilu.org#44080,"WONOMULYO, PONCOKUSUMO, MALANG, JAWA TIMUR",13,162,27,189
https://kawalpemilu.org#48616,"WEDI, KAPAS, BOJONEGORO, JAWA TIMUR",14,129,52,181
https://kawalpemilu.org#42644,"PANGKAL, SAWOO, PONOROGO, JAWA TIMUR",16,134,48,182
https://kawalpemilu.org#45471,"MIMBAAN, PANJI, SITUBONDO, JAWA TIMUR",85,58,93,151
https://kawalpemilu.org#50422,"BANJAR, KEDUNGDUNG, SAMPANG, JAWA TIMUR",18,10,204,214
https://kawalpemilu.org#49134,"WIDANG, WIDANG, TUBAN, JAWA TIMUR",3,134,43,177
https://kawalpemilu.org#51449,"MANUKAN KULON, TANDES, KOTA SURABAYA, JAWA TIMUR",29,141,79,220
https://kawalpemilu.org#44442,"KLOPOSAWIT, CANDIPURO, LUMAJANG, JAWA TIMUR",12,135,48,183
https://kawalpemilu.org#51385,"TEGALSARI, TEGALSARI, KOTA SURABAYA, JAWA TIMUR",49,156,61,217
https://kawalpemilu.org#49913,"WATU AGUNG, BUNGAH, GRESIK, JAWA TIMUR",3,155,43,198
https://kawalpemilu.org#42921,"MASARAN, MUNJUNGAN, TRENGGALEK, JAWA TIMUR",30,130,40,170
https://kawalpemilu.org#43441,"SIDOREJO, PONGGOK, BLITAR, JAWA TIMUR",46,209,12,221
https://kawalpemilu.org#43355,"NGREJO, TANGGUNGGUNUNG, TULUNGAGUNG, JAWA TIMUR",2,178,17,195
https://kawalpemilu.org#50719,"KERTAGENAH LAOK, KADUR, PAMEKASAN, JAWA TIMUR",1,121,94,215
https://kawalpemilu.org#45391,"PUCANGANOM, JAMBESARI DARUS SHOLAH, BONDOWOSO, JAWA TIMUR",8,47,72,119
https://kawalpemilu.org#50893,"AMBUNTEN TENGAH, AMBUNTEN, SUMENEP, JAWA TIMUR",14,73,78,151
https://kawalpemilu.org#46961,"KUPANG, JETIS, MOJOKERTO, JAWA TIMUR",15,214,25,239
https://kawalpemilu.org#46725,"CEMPOKOLIMO, PACET, MOJOKERTO, JAWA TIMUR",11,133,41,174
https://kawalpemilu.org#50756,"MARENGAN LAO, KALIANGET, SUMENEP, JAWA TIMUR",5,87,77,164
https://kawalpemilu.org#51098,"BANDAR KIDUL, MOJOROTO, KOTA KEDIRI, JAWA TIMUR",22,150,59,209
https://kawalpemilu.org#46332,"WIROBITING, PRAMBON, SIDOARJO, JAWA TIMUR",2,165,46,211
https://kawalpemilu.org#43887,"PELEM, PARE, KEDIRI, JAWA TIMUR",10,141,32,173
https://kawalpemilu.org#48792,"JARI, GONDANG, BOJONEGORO, JAWA TIMUR",3,154,59,213
https://kawalpemilu.org#46046,"KARANGSONO, SUKOREJO, PASURUAN, JAWA TIMUR",10,139,46,185
https://kawalpemilu.org#48149,"MACANAN, JOGOROGO, NGAWI, JAWA TIMUR",10,129,30,159
https://kawalpemilu.org#51231,"LOWOKWARU, LOWOKWARU, KOTA MALANG, JAWA TIMUR",31,153,43,196
https://kawalpemilu.org#46582,"SIDODADI, TAMAN, SIDOARJO, JAWA TIMUR",20,148,50,198
https://kawalpemilu.org#44950,"KEDUNGASRI, TEGALDLIMO, BANYUWANGI, JAWA TIMUR",24,153,62,215
https://kawalpemilu.org#45087,"TEMENGGUNGAN, BANYUWANGI, BANYUWANGI, JAWA TIMUR",1,124,71,195
https://kawalpemilu.org#44023,"REJOYOSO, BANTUR, MALANG, JAWA TIMUR",12,139,68,207
https://kawalpemilu.org#50997,"ANDULANG, GAPURA, SUMENEP, JAWA TIMUR",3,99,30,129
https://kawalpemilu.org#44160,"KEDUNGPEDARINGAN, KEPANJEN, MALANG, JAWA TIMUR",11,107,76,183
https://kawalpemilu.org#47280,"BANDARKEDUNGMULYO, BANDARKEDUNGMULYO, JOMBANG, JAWA TIMUR",2,130,31,161
https://kawalpemilu.org#44736,"CURAHLELE, BALUNG, JEMBER, JAWA TIMUR",12,58,54,112
https://kawalpemilu.org#44982,"YOSOMULYO, GAMBIRAN, BANYUWANGI, JAWA TIMUR",1,175,22,197
https://kawalpemilu.org#47616,"KETANDAN, LENGKONG, NGANJUK, JAWA TIMUR",2,165,33,198
https://kawalpemilu.org#45051,"GOMBOLIRANG, KABAT, BANYUWANGI, JAWA TIMUR",2,125,67,192
https://kawalpemilu.org#44416,"SIDOREJO, PAGELARAN, MALANG, JAWA TIMUR",29,123,29,152
https://kawalpemilu.org#50741,"KOLOR, KOTA SUMENEP, SUMENEP, JAWA TIMUR",9,67,144,211
https://kawalpemilu.org#44768,"SUCI, PANTI, JEMBER, JAWA TIMUR",1,129,90,219
https://kawalpemilu.org#42486,"JETIS KIDUL, ARJOSARI, PACITAN, JAWA TIMUR",4,23,94,117
https://kawalpemilu.org#44153,"CEPOKOMULYO, KEPANJEN, MALANG, JAWA TIMUR",16,134,80,214
https://kawalpemilu.org#47054,"NGAMPUNGAN, BARENG, JOMBANG, JAWA TIMUR",4,169,15,184
https://kawalpemilu.org#44943,"PURWOHARJO, PURWOHARJO, BANYUWANGI, JAWA TIMUR",11,177,40,217
https://kawalpemilu.org#49148,"GESIKAN, GRABAGAN, TUBAN, JAWA TIMUR",5,161,7,168
https://kawalpemilu.org#49814,"MENUNGGAL, KEDAMEAN, GRESIK, JAWA TIMUR",13,214,17,231
https://kawalpemilu.org#51465,"TANAH KALI KEDINDING, KENJERAN, KOTA SURABAYA, JAWA TIMUR",67,108,44,152
https://kawalpemilu.org#45648,"SUMBERDUREN, KRUCIL, PROBOLINGGO, JAWA TIMUR",11,79,86,165
https://kawalpemilu.org#44556,"BARAT, PADANG, LUMAJANG, JAWA TIMUR",6,160,59,219
https://kawalpemilu.org#46458,"LEMAHPUTRO, SIDOARJO, SIDOARJO, JAWA TIMUR",23,175,64,239
https://kawalpemilu.org#46304,"SEDAENG, TOSARI, PASURUAN, JAWA TIMUR",5,124,91,215
https://kawalpemilu.org#44714,"JAMBEARUM, PUGER, JEMBER, JAWA TIMUR",11,124,56,180
https://kawalpemilu.org#50269,"LOMBANG DAJAH, BLEGA, BANGKALAN, JAWA TIMUR",8,131,72,203
https://kawalpemilu.org#49345,"KEDUNGWANGI, SAMBENG, LAMONGAN, JAWA TIMUR",13,145,59,204
https://kawalpemilu.org#44929,"SUMBERMULYO, PESANGGARAN, BANYUWANGI, JAWA TIMUR",9,129,43,172
https://kawalpemilu.org#43978,"NGASEM, NGASEM, KEDIRI, JAWA TIMUR",7,160,24,184
https://kawalpemilu.org#49564,"SOKO, TIKUNG, LAMONGAN, JAWA TIMUR",3,133,81,214
https://kawalpemilu.org#43757,"SUMBERAGUNG, PLOSOKLATEN, KEDIRI, JAWA TIMUR",28,47,79,126
https://kawalpemilu.org#43812,"WONOASRI, GROGOL, KEDIRI, JAWA TIMUR",5,209,16,225
https://kawalpemilu.org#43963,"MUKUH, KAYEN KIDUL, KEDIRI, JAWA TIMUR",9,142,45,187
https://kawalpemilu.org#51574,"JUNREJO, JUNREJO, KOTA BATU, JAWA TIMUR",29,129,37,166
https://kawalpemilu.org#43158,"PAGERWOJO, PAGERWOJO, TULUNGAGUNG, JAWA TIMUR",3,143,16,159
https://kawalpemilu.org#46199,"BRAMBANG, GONDANGWETAN, PASURUAN, JAWA TIMUR",5,159,81,240
https://kawalpemilu.org#43955,"NAMBAKAN, RINGINREJO, KEDIRI, JAWA TIMUR",3,178,37,215
https://kawalpemilu.org#45449,"TAMBAK UKIR, KENDIT, SITUBONDO, JAWA TIMUR",5,91,118,209
https://kawalpemilu.org#44960,"TEMBOKREJO, MUNCAR, BANYUWANGI, JAWA TIMUR",31,112,53,165
https://kawalpemilu.org#42588,"CRABAK, SLAHUNG, PONOROGO, JAWA TIMUR",1,154,65,219
https://kawalpemilu.org#44823,"KRANJINGAN, SUMBERSARI, JEMBER, JAWA TIMUR",29,110,72,182
https://kawalpemilu.org#43552,"SLUMBUNG, GANDUSARI, BLITAR, JAWA TIMUR",10,143,8,151
https://kawalpemilu.org#47491,"SIDOHARJO, TANJUNGANOM, NGANJUK, JAWA TIMUR",5,157,23,180
https://kawalpemilu.org#49262,"BRONDONG, BRONDONG, LAMONGAN, JAWA TIMUR",9,116,72,188
https://kawalpemilu.org#46725,"CEMPOKOLIMO, PACET, MOJOKERTO, JAWA TIMUR",7,144,30,174
https://kawalpemilu.org#51175,"PURWODADI, BLIMBING, KOTA MALANG, JAWA TIMUR",43,170,55,225
https://kawalpemilu.org#45084,"KEPATIHAN, BANYUWANGI, BANYUWANGI, JAWA TIMUR",9,104,38,142
https://kawalpemilu.org#44768,"SUCI, PANTI, JEMBER, JAWA TIMUR",9,74,74,148
https://kawalpemilu.org#44416,"SIDOREJO, PAGELARAN, MALANG, JAWA TIMUR",9,173,45,218
https://kawalpemilu.org#49886,"CERME KIDUL, CERME, GRESIK, JAWA TIMUR",5,131,102,233
https://kawalpemilu.org#44413,"PAGELARAN, PAGELARAN, MALANG, JAWA TIMUR",17,129,42,171
https://kawalpemilu.org#46406,"KALISAMPURNO, TANGGULANGIN, SIDOARJO, JAWA TIMUR",18,100,66,166
https://kawalpemilu.org#49397,"BLIMBING, PACIRAN, LAMONGAN, JAWA TIMUR",25,52,112,164
https://kawalpemilu.org#42648,"TEMON, SAWOO, PONOROGO, JAWA TIMUR",3,63,100,163
https://kawalpemilu.org#48613,"BANGILAN, KAPAS, BOJONEGORO, JAWA TIMUR",2,151,66,217
https://kawalpemilu.org#45964,"KARANG JATI, LUMBANG, PASURUAN, JAWA TIMUR",4,180,61,241
https://kawalpemilu.org#48270,"KAWU, KEDUNGGALAR, NGAWI, JAWA TIMUR",10,149,48,197
https://kawalpemilu.org#48900,"TAMBAKBOYO, TAMBAKBOYO, TUBAN, JAWA TIMUR",11,161,35,196
https://kawalpemilu.org#43390,"KAUMAN, SRENGAT, BLITAR, JAWA TIMUR",8,173,31,204
https://kawalpemilu.org#45782,"KARANGREN, KREJENGAN, PROBOLINGGO, JAWA TIMUR",2,146,80,226
https://kawalpemilu.org#48610,"BENDO, KAPAS, BOJONEGORO, JAWA TIMUR",13,86,75,161
https://kawalpemilu.org#49520,"TUNJUNGMEKAR, KALITENGAH, LAMONGAN, JAWA TIMUR",1,133,58,191
https://kawalpemilu.org#45400,"GAYAM, BOTOLINGGO, BONDOWOSO, JAWA TIMUR",7,64,81,145
https://kawalpemilu.org#51415,"NGINDEN JANGKUNGAN, SUKOLILO, KOTA SURABAYA, JAWA TIMUR",18,108,70,178
https://kawalpemilu.org#51375,"WONOREJO, RUNGKUT, KOTA SURABAYA, JAWA TIMUR",40,207,41,248
https://kawalpemilu.org#45491,"CURAHCOTTOK, KAPONGAN, SITUBONDO, JAWA TIMUR",3,76,84,160
https://kawalpemilu.org#51391,"PETEMON, SAWAHAN, KOTA SURABAYA, JAWA TIMUR",37,117,37,154
https://kawalpemilu.org#42432,"PUCANGSEWU, PACITAN, PACITAN, JAWA TIMUR",7,20,155,175
https://kawalpemilu.org#43140,"BALEREJO, KAUMAN, TULUNGAGUNG, JAWA TIMUR",12,126,27,153
https://kawalpemilu.org#44310,"WATUGEDE, SINGOSARI, MALANG, JAWA TIMUR",23,125,110,235
https://kawalpemilu.org#44908,"PACE, SILO, JEMBER, JAWA TIMUR",55,99,25,124
https://kawalpemilu.org#46131,"BENDO MUNGAL, BANGIL, PASURUAN, JAWA TIMUR",11,83,160,243
https://kawalpemilu.org#42521,"TAHUNAN, TEGALOMBO, PACITAN, JAWA TIMUR",5,150,45,195
https://kawalpemilu.org#45988,"COBAN JOYO, KEJAYAN, PASURUAN, JAWA TIMUR",5,135,96,231
https://kawalpemilu.org#43651,"NGADI, MOJO, KEDIRI, JAWA TIMUR",16,125,21,146
https://kawalpemilu.org#43853,"MERJOYO, PURWOASRI, KEDIRI, JAWA TIMUR",3,117,45,162
https://kawalpemilu.org#45036,"BUBUK, ROGOJAMPI, BANYUWANGI, JAWA TIMUR",3,137,42,179
https://kawalpemilu.org#47245,"PURISEMANDING, PLANDAAN, JOMBANG, JAWA TIMUR",7,151,23,174
https://kawalpemilu.org#43020,"SUKORAME, GANDUSARI, TRENGGALEK, JAWA TIMUR",12,143,87,230
https://kawalpemilu.org#47418,"BALETURI, PRAMBON, NGANJUK, JAWA TIMUR",19,189,13,202
https://kawalpemilu.org#50710,"BLABAN, BATUMARMAR, PAMEKASAN, JAWA TIMUR",9,66,215,261
https://kawalpemilu.org#44519,"BANJARWARU, LUMAJANG, LUMAJANG, JAWA TIMUR",6,95,65,160
https://kawalpemilu.org#44705,"MLOKOREJO, PUGER, JEMBER, JAWA TIMUR",28,80,110,190
https://kawalpemilu.org#51459,"AMPEL, SEMAMPIR, KOTA SURABAYA, JAWA TIMUR",51,39,142,181
https://kawalpemilu.org#51396,"PAKIS, SAWAHAN, KOTA SURABAYA, JAWA TIMUR",13,168,46,214
https://kawalpemilu.org#44720,"BANGSALSARI, BANGSALSARI, JEMBER, JAWA TIMUR",36,119,94,213
https://kawalpemilu.org#47037,"GENUKWATU, NGORO, JOMBANG, JAWA TIMUR",6,147,39,186
https://kawalpemilu.org#45426,"BESUKI, BESUKI, SITUBONDO, JAWA TIMUR",43,46,125,171
https://kawalpemilu.org#49247,"TLANAK, KEDUNGPRING, LAMONGAN, JAWA TIMUR",6,141,59,200
https://kawalpemilu.org#42756,"NONGKODONO, KAUMAN, PONOROGO, JAWA TIMUR",1,141,90,231
https://kawalpemilu.org#43979,"KARANGREJO, NGASEM, KEDIRI, JAWA TIMUR",8,151,33,184
https://kawalpemilu.org#44783,"JATISARI, JENGGAWAH, JEMBER, JAWA TIMUR",17,62,88,150
https://kawalpemilu.org#49126,"PATIHAN, WIDANG, TUBAN, JAWA TIMUR",12,154,27,181
https://kawalpemilu.org#43495,"TAWANGSARI, GARUM, BLITAR, JAWA TIMUR",12,158,47,205
https://kawalpemilu.org#51564,"BULUKERTO, BUMIAJI, KOTA BATU, JAWA TIMUR",19,123,10,133
https://kawalpemilu.org#51177,"PANDANWANGI, BLIMBING, KOTA MALANG, JAWA TIMUR",65,189,67,256
https://kawalpemilu.org#45341,"BANDILAN, PRAJEKAN, BONDOWOSO, JAWA TIMUR",17,43,96,139
https://kawalpemilu.org#46923,"KEMANTREN, GEDEG, MOJOKERTO, JAWA TIMUR",7,184,40,224
https://kawalpemilu.org#46379,"KEBAKALAN, PORONG, SIDOARJO, JAWA TIMUR",1,195,33,228
https://kawalpemilu.org#51331,"KLEGEN, KARTOHARJO, KOTA MADIUN, JAWA TIMUR",19,139,46,185
https://kawalpemilu.org#50038,"PEJAGAN, BANGKALAN, BANGKALAN, JAWA TIMUR",32,73,161,234
https://kawalpemilu.org#43469,"NGLEGOK, NGLEGOK, BLITAR, JAWA TIMUR",29,133,44,177
https://kawalpemilu.org#44098,"WAJAK, WAJAK, MALANG, JAWA TIMUR",7,131,21,152
https://kawalpemilu.org#50069,"PERRENG, BURNEH, BANGKALAN, JAWA TIMUR",3,23,92,115
https://kawalpemilu.org#46052,"CANDI BINANGUN, SUKOREJO, PASURUAN, JAWA TIMUR",8,61,130,191
https://kawalpemilu.org#47411,"KEPANJEN, PACE, NGANJUK, JAWA TIMUR",5,143,34,177
https://kawalpemilu.org#49885,"CAGAK AGUNG, CERME, GRESIK, JAWA TIMUR",5,86,93,179
https://kawalpemilu.org#44424,"PUNDUNGSARI, TEMPURSARI, LUMAJANG, JAWA TIMUR",8,202,19,221
https://kawalpemilu.org#51554,"SISIR, BATU, KOTA BATU, JAWA TIMUR",45,73,50,123
https://kawalpemilu.org#49246,"KEDUNGPRING, KEDUNGPRING, LAMONGAN, JAWA TIMUR",3,136,96,232
https://kawalpemilu.org#46593,"KEBONAGUNG, SUKODONO, SIDOARJO, JAWA TIMUR",9,138,95,233
https://kawalpemilu.org#46567,"TAMAN, TAMAN, SIDOARJO, JAWA TIMUR",10,118,58,176
https://kawalpemilu.org#47143,"TUNGGORONO, JOMBANG, JOMBANG, JAWA TIMUR",4,119,59,178
https://kawalpemilu.org#45847,"KALISALAM, DRINGU, PROBOLINGGO, JAWA TIMUR",3,159,62,221
https://kawalpemilu.org#42750,"PURWOREJO, BALONG, PONOROGO, JAWA TIMUR",6,167,25,192
https://kawalpemilu.org#51371,"KALIRUNGKUT, RUNGKUT, KOTA SURABAYA, JAWA TIMUR",14,208,29,237
https://kawalpemilu.org#51228,"TUNJUNGSEKAR, LOWOKWARU, KOTA MALANG, JAWA TIMUR",28,147,77,224
https://kawalpemilu.org#51350,"PANDEAN, TAMAN, KOTA MADIUN, JAWA TIMUR",30,107,109,216
https://kawalpemilu.org#51500,"KEBONSARI, JAMBANGAN, KOTA SURABAYA, JAWA TIMUR",28,109,65,174
https://kawalpemilu.org#46194,"SUNGI KULON, POHJENTREK, PASURUAN, JAWA TIMUR",1,47,199,246
https://kawalpemilu.org#42501,"NGROMO, NAWANGAN, PACITAN, JAWA TIMUR",14,24,111,135
https://kawalpemilu.org#44023,"REJOYOSO, BANTUR, MALANG, JAWA TIMUR",15,102,40,142
https://kawalpemilu.org#43157,"PENJOR, PAGERWOJO, TULUNGAGUNG, JAWA TIMUR",2,110,41,151
https://kawalpemilu.org#46707,"KARANGKUTEN, GONDANG, MOJOKERTO, JAWA TIMUR",6,132,41,173
https://kawalpemilu.org#46853,"NGASTEMI, BANGSAL, MOJOKERTO, JAWA TIMUR",11,144,21,165
https://kawalpemilu.org#43028,"KARANGSOKO, TRENGGALEK, TRENGGALEK, JAWA TIMUR",21,128,88,216
https://kawalpemilu.org#42902,"WONOCOYO, PANGGUL, TRENGGALEK, JAWA TIMUR",17,154,49,203
https://kawalpemilu.org#47123,"DIWEK, DIWEK, JOMBANG, JAWA TIMUR",12,143,69,212
https://kawalpemilu.org#45669,"DUREN, GADING, PROBOLINGGO, JAWA TIMUR",5,220,36,256
https://kawalpemilu.org#51380,"NGAGEL, WONOKROMO, KOTA SURABAYA, JAWA TIMUR",34,121,69,190
https://kawalpemilu.org#48989,"SUMURCINDE, SOKO, TUBAN, JAWA TIMUR",7,114,75,189
https://kawalpemilu.org#45248,"SUMBER SALAM, TENGGARANG, BONDOWOSO, JAWA TIMUR",3,54,88,142
https://kawalpemilu.org#45001,"KALIGONDO, GENTENG, BANYUWANGI, JAWA TIMUR",33,97,59,156
https://kawalpemilu.org#84962,"SAUBI, KANGAYAN, SUMENEP, JAWA TIMUR",5,59,65,124
https://kawalpemilu.org#50887,"PRAGAAN DAYA, PRAGAAN, SUMENEP, JAWA TIMUR",2,137,60,197
https://kawalpemilu.org#50176,"AMPARAAN, KOKOP, BANGKALAN, JAWA TIMUR",2,46,183,229
https://kawalpemilu.org#50743,"MARENGAN DAYA, KOTA SUMENEP, SUMENEP, JAWA TIMUR",5,69,106,175
https://kawalpemilu.org#44294,"TEGALGONDO, KARANGPLOSO, MALANG, JAWA TIMUR",8,134,91,225
https://kawalpemilu.org#42431,"BALEHARJO, PACITAN, PACITAN, JAWA TIMUR",9,38,199,237
https://kawalpemilu.org#47129,"PANDANWANGI, DIWEK, JOMBANG, JAWA TIMUR",6,189,38,227
https://kawalpemilu.org#51386,"DR. SOETOMO, TEGALSARI, KOTA SURABAYA, JAWA TIMUR",13,127,39,166
https://kawalpemilu.org#50464,"TLAGAH, BANYUATES, SAMPANG, JAWA TIMUR",7,2,209,211
https://kawalpemilu.org#44099,"NGEMBAL, WAJAK, MALANG, JAWA TIMUR",12,151,28,179
https://kawalpemilu.org#50347,"PATARONGAN, TORJUN, SAMPANG, JAWA TIMUR",6,93,111,204
https://kawalpemilu.org#42564,"KETANGGUNG, SUDIMORO, PACITAN, JAWA TIMUR",2,52,135,187
https://kawalpemilu.org#48474,"JAMBEREJO, KEDUNGADEM, BOJONEGORO, JAWA TIMUR",17,92,62,154
https://kawalpemilu.org#43039,"POGALAN, POGALAN, TRENGGALEK, JAWA TIMUR",11,154,49,203
https://kawalpemilu.org#44999,"GENTENGKULON, GENTENG, BANYUWANGI, JAWA TIMUR",3,115,100,215
https://kawalpemilu.org#46664,"NGINGAS, WARU, SIDOARJO, JAWA TIMUR",37,129,31,160
https://kawalpemilu.org#44117,"TUMPUKRENTENG, TUREN, MALANG, JAWA TIMUR",8,165,23,188
https://kawalpemilu.org#59717,"AMBOYO SELATAN, NGABANG, LANDAK, KALIMANTAN BARAT",26,133,5,138
https://kawalpemilu.org#60217,"BANGKA BELITUNG LAUT, PONTIANAK TENGGARA, KOTA PONTIANAK, KALIMANTAN BARAT",34,174,37,211
https://kawalpemilu.org#58633,"BERENG BERKAWAT, BEDUAI, SANGGAU, KALIMANTAN BARAT",7,118,82,200
https://kawalpemilu.org#58946,"MULIA BARU, DELTA PAWAN, KETAPANG, KALIMANTAN BARAT",27,61,151,212
https://kawalpemilu.org#58443,"SINGARAYA, SEMPARUK, SAMBAS, KALIMANTAN BARAT",19,80,130,210
https://kawalpemilu.org#60225,"ROBAN, SINGKAWANG TENGAH, KOTA SINGKAWANG, KALIMANTAN BARAT",20,33,153,186
https://kawalpemilu.org#58345,"TEBAS SUNGAI, TEBAS, SAMBAS, KALIMANTAN BARAT",16,81,120,201
https://kawalpemilu.org#60202,"SUNGAI BELIUNG, PONTIANAK BARAT, KOTA PONTIANAK, KALIMANTAN BARAT",21,50,112,162
https://kawalpemilu.org#60160,"MAS BANGUN, TELUK BATANG, KAYONG UTARA, KALIMANTAN BARAT",10,77,108,185
https://kawalpemilu.org#59763,"KAYU TANAM, MANDOR, LANDAK, KALIMANTAN BARAT",7,198,2,200
https://kawalpemilu.org#59759,"SELUTUNG, MANDOR, LANDAK, KALIMANTAN BARAT",1,140,16,156
https://kawalpemilu.org#60218,"BANGKA BELITUNG DARAT, PONTIANAK TENGGARA, KOTA PONTIANAK, KALIMANTAN BARAT",27,127,106,233
https://kawalpemilu.org#60171,"DUSUN BESAR, PULAU MAYA, KAYONG UTARA, KALIMANTAN BARAT",7,89,101,190
https://kawalpemilu.org#59871,"SUNGAI RINGIN, SEKADAU HILIR, SEKADAU, KALIMANTAN BARAT",23,60,21,81
https://kawalpemilu.org#60168,"TANJUNG SATAI, PULAU MAYA, KAYONG UTARA, KALIMANTAN BARAT",6,115,65,180
https://kawalpemilu.org#58349,"SEJIRAM, TEBAS, SAMBAS, KALIMANTAN BARAT",3,126,66,192
https://kawalpemilu.org#60196,"DALAM BUGIS, PONTIANAK TIMUR, KOTA PONTIANAK, KALIMANTAN BARAT",57,14,138,670
https://kawalpemilu.org#59955,"PEMUAR, BELIMBING, MELAWI, KALIMANTAN BARAT",4,158,30,188
https://kawalpemilu.org#58683,"ENGKASAN, TAYAN HULU, SANGGAU, KALIMANTAN BARAT",2,144,6,150
https://kawalpemilu.org#60367,"PUNGGUR KECIL, SUNGAI KAKAP, KUBU RAYA, KALIMANTAN BARAT",41,17,181,198
https://kawalpemilu.org#59270,"NANGA LEBANG, KELAM PERMAI, SINTANG, KALIMANTAN BARAT",4,53,151,204
https://kawalpemilu.org#58847,"SEMANDANG KIRI, SIMPANG HULU, KETAPANG, KALIMANTAN BARAT",6,151,27,178
https://kawalpemilu.org#58921,"TEBING BERSERI, JELAI HULU, KETAPANG, KALIMANTAN BARAT",1,159,8,167
https://kawalpemilu.org#930887,"MUARA SEMAYOK, PEMAHAN, KETAPANG, KALIMANTAN BARAT",1,45,186,231
https://kawalpemilu.org#58639,"PENGADANG, SEKAYAM, SANGGAU, KALIMANTAN BARAT",4,61,111,172
https://kawalpemilu.org#60202,"SUNGAI BELIUNG, PONTIANAK BARAT, KOTA PONTIANAK, KALIMANTAN BARAT",118,37,82,119
https://kawalpemilu.org#58526,"SUNGAI DURI I, SUNGAI KUNYIT, MEMPAWAH, KALIMANTAN BARAT",4,83,100,183
https://kawalpemilu.org#58956,"TEMPURUKAN, MUARA PAWAN, KETAPANG, KALIMANTAN BARAT",1,62,198,260
https://kawalpemilu.org#59270,"NANGA LEBANG, KELAM PERMAI, SINTANG, KALIMANTAN BARAT",1,52,143,197
https://kawalpemilu.org#59761,"SIMPANG KASTURI, MANDOR, LANDAK, KALIMANTAN BARAT",3,195,5,200
https://kawalpemilu.org#59406,"NIBUNG, SELIMBAU, KAPUAS HULU, KALIMANTAN BARAT",1,161,57,218
https://kawalpemilu.org#59906,"TAPANG TINGANG, NANGA TAMAN, SEKADAU, KALIMANTAN BARAT",13,140,0,140
https://kawalpemilu.org#58627,"EMPODIS, BONTI, SANGGAU, KALIMANTAN BARAT",7,100,9,109
https://kawalpemilu.org#59349,"NANGA LAUK, EMBALOH HILIR, KAPUAS HULU, KALIMANTAN BARAT",1,116,21,137
https://kawalpemilu.org#60237,"PAJINTAN, SINGKAWANG TIMUR, KOTA SINGKAWANG, KALIMANTAN BARAT",17,156,0,156
https://kawalpemilu.org#58409,"SENATAB, SAJINGAN BESAR, SAMBAS, KALIMANTAN BARAT",6,120,5,125
https://kawalpemilu.org#60320,"SUNGAI BEMBAN, KUBU, KUBU RAYA, KALIMANTAN BARAT",9,25,138,163
https://kawalpemilu.org#59433,"EMPERIANG, SEBERUANG, KAPUAS HULU, KALIMANTAN BARAT",2,67,7,74
https://kawalpemilu.org#60202,"SUNGAI BELIUNG, PONTIANAK BARAT, KOTA PONTIANAK, KALIMANTAN BARAT",155,21,111,132
https://kawalpemilu.org#60185,"BENUA MELAYU LAUT, PONTIANAK SELATAN, KOTA PONTIANAK, KALIMANTAN BARAT",22,131,101,232
https://kawalpemilu.org#58832,"SUNGAI DAKA, SUNGAI LAUR, KETAPANG, KALIMANTAN BARAT",5,76,4,80
https://kawalpemilu.org#62666,"JELAPAT I, TAMBAN, BARITO KUALA, KALIMANTAN SELATAN",4,37,88,125
https://kawalpemilu.org#62726,"TATAH MESJID, ALALAK, BARITO KUALA, KALIMANTAN SELATAN",7,100,75,175
https://kawalpemilu.org#63800,"TELUK KEPAYANG, KUSAN HULU, TANAH BUMBU, KALIMANTAN SELATAN",1,37,148,185
https://kawalpemilu.org#85452,"MAKMUR MULIA, SATUI, TANAH BUMBU, KALIMANTAN SELATAN",11,103,105,208
https://kawalpemilu.org#63586,"HABAU, BANUA LAWAS, TABALONG, KALIMANTAN SELATAN",3,61,150,211
https://kawalpemilu.org#62580,"KELILING BENTENG ULU, MARTAPURA BARAT, BANJAR, KALIMANTAN SELATAN",6,140,98,238
https://kawalpemilu.org#63739,"BATUAH, KUSAN HILIR, TANAH BUMBU, KALIMANTAN SELATAN",7,62,159,221
https://kawalpemilu.org#62913,"PERINTIS RAYA, TAPIN UTARA, TAPIN, KALIMANTAN SELATAN",3,60,184,244
https://kawalpemilu.org#64048,"PENGAMBANGAN, BANJARMASIN TIMUR, KOTA BANJARMASIN, KALIMANTAN SELATAN",15,64,98,162
https://kawalpemilu.org#63354,"BITIN, DANAU PANGGANG, HULU SUNGAI UTARA, KALIMANTAN SELATAN",2,31,156,187
https://kawalpemilu.org#63824,"GIRI MULYA, KURANJI, TANAH BUMBU, KALIMANTAN SELATAN",6,123,72,195
https://kawalpemilu.org#62294,"BUNGKUKAN, KELUMPANG BARAT, KOTABARU, KALIMANTAN SELATAN",5,90,92,182
https://kawalpemilu.org#63670,"LUMBANG, MUARA UYA, TABALONG, KALIMANTAN SELATAN",12,108,53,161
https://kawalpemilu.org#62377,"KAYU BAWANG, GAMBUT, BANJAR, KALIMANTAN SELATAN",3,59,164,223
https://kawalpemilu.org#63074,"GAMBAH LUAR, KANDANGAN, HULU SUNGAI SELATAN, KALIMANTAN SELATAN",4,17,128,145
https://kawalpemilu.org#62477,"KELAMPAIAN, ASTAMBUL, BANJAR, KALIMANTAN SELATAN",1,44,129,173
https://kawalpemilu.org#62318,"SERONGGA, KELUMPANG HILIR, KOTABARU, KALIMANTAN SELATAN",5,76,35,111
https://kawalpemilu.org#64057,"TELUK TIRAM, BANJARMASIN BARAT, KOTA BANJARMASIN, KALIMANTAN SELATAN",31,109,121,230
https://kawalpemilu.org#62209,"SUNGAIKUPANG, KELUMPANG HULU, KOTABARU, KALIMANTAN SELATAN",7,61,111,172
https://kawalpemilu.org#64039,"PEMURUS BARU, BANJARMASIN SELATAN, KOTA BANJARMASIN, KALIMANTAN SELATAN",12,60,125,185
https://kawalpemilu.org#62831,"ULU BENTENG, MARABAHAN, BARITO KUALA, KALIMANTAN SELATAN",2,20,82,102
https://kawalpemilu.org#64029,"MANTUIL, BANJARMASIN SELATAN, KOTA BANJARMASIN, KALIMANTAN SELATAN",29,57,77,134
https://kawalpemilu.org#92654,"TANJUNG REMA DARAT, MARTAPURA, BANJAR, KALIMANTAN SELATAN",15,64,135,199
https://kawalpemilu.org#62446,"AWANG BANGKAL BARAT, KARANG INTAN, BANJAR, KALIMANTAN SELATAN",2,62,81,143
https://kawalpemilu.org#63850,"BAROKAH, SIMPANG EMPAT, TANAH BUMBU, KALIMANTAN SELATAN",33,59,158,217
https://kawalpemilu.org#63344,"KARATUNGAN, LIMPASU, HULU SUNGAI TENGAH, KALIMANTAN SELATAN",4,20,194,214
https://kawalpemilu.org#62041,"PANYIPATAN, PANYIPATAN, TANAH LAUT, KALIMANTAN SELATAN",6,86,147,233
https://kawalpemilu.org#62699,"ANJIR MUARA LAMA, ANJIR MUARA, BARITO KUALA, KALIMANTAN SELATAN",7,27,96,123
https://kawalpemilu.org#64056,"TELAWANG, BANJARMASIN BARAT, KOTA BANJARMASIN, KALIMANTAN SELATAN",11,74,61,135
https://kawalpemilu.org#63781,"SUNGAICUKA, SATUI, TANAH BUMBU, KALIMANTAN SELATAN",5,115,107,222
https://kawalpemilu.org#64048,"PENGAMBANGAN, BANJARMASIN TIMUR, KOTA BANJARMASIN, KALIMANTAN SELATAN",9,50,99,149
https://kawalpemilu.org#63685,"MANTUIL, MUARA HARUS, TABALONG, KALIMANTAN SELATAN",1,39,178,217
https://kawalpemilu.org#64105,"SUNGAI ULIN, BANJARBARU UTARA, KOTA BANJARBARU, KALIMANTAN SELATAN",36,95,50,145
https://kawalpemilu.org#60817,"ARUK, TIMPAH, KAPUAS, KALIMANTAN TENGAH",2,226,8,234
https://kawalpemilu.org#85395,"HUJUNG PATA, RUNGAN BARAT, GUNUNG MAS, KALIMANTAN TENGAH",3,125,30,155
https://kawalpemilu.org#61714,"BERIWIT, MURUNG, MURUNG RAYA, KALIMANTAN TENGAH",27,73,198,271
https://kawalpemilu.org#61012,"BENANGIN III, TEWEH TIMUR, BARITO UTARA, KALIMANTAN TENGAH",1,76,41,117
https://kawalpemilu.org#60534,"BAAMANG TENGAH, BAAMANG, KOTAWARINGIN TIMUR, KALIMANTAN TENGAH",60,80,90,170
https://kawalpemilu.org#60534,"BAAMANG TENGAH, BAAMANG, KOTAWARINGIN TIMUR, KALIMANTAN TENGAH",80,61,138,199
https://kawalpemilu.org#60534,"BAAMANG TENGAH, BAAMANG, KOTAWARINGIN TIMUR, KALIMANTAN TENGAH",69,76,146,222
https://kawalpemilu.org#928324,"SARI MAKMUR, MANTANGAI, KAPUAS, KALIMANTAN TENGAH",1,116,64,180
https://kawalpemilu.org#61958,"PETUK BUKIT, RAKUMPIT, KOTA PALANGKARAYA, KALIMANTAN TENGAH",4,139,25,164
https://kawalpemilu.org#60966,"DANAU MASURA, DUSUN SELATAN, BARITO SELATAN, KALIMANTAN TENGAH",1,114,11,125
https://kawalpemilu.org#61947,"MENTENG, JEKAN RAYA, KOTA PALANGKARAYA, KALIMANTAN TENGAH",142,159,66,225
https://kawalpemilu.org#928280,"SELAT BARAT, SELAT, KAPUAS, KALIMANTAN TENGAH",11,178,85,263
https://kawalpemilu.org#61327,"PEMATANG PANJANG, SERUYAN HILIR TIMUR, SERUYAN, KALIMANTAN TENGAH",6,91,116,207
https://kawalpemilu.org#61095,"TALANGKAH, KATINGAN HILIR, KATINGAN, KALIMANTAN TENGAH",7,124,24,148
https://kawalpemilu.org#61946,"PALANGKA, JEKAN RAYA, KOTA PALANGKARAYA, KALIMANTAN TENGAH",80,101,37,138
https://kawalpemilu.org#61496,"PETAK BAHANDANG, KURUN, GUNUNG MAS, KALIMANTAN TENGAH",1,215,8,223
https://kawalpemilu.org#61953,"KERENG BANGKIRAI, SABANGAU, KOTA PALANGKARAYA, KALIMANTAN TENGAH",17,136,48,184
https://kawalpemilu.org#61903,"TELANG BARU, PAJU EPAT, BARITO TIMUR, KALIMANTAN TENGAH",2,98,100,198
https://kawalpemilu.org#61760,"BATU TUHUP, LAUNG TUHUP, MURUNG RAYA, KALIMANTAN TENGAH",1,44,121,165
https://kawalpemilu.org#61330,"TERAWAN, SERUYAN RAYA, SERUYAN, KALIMANTAN TENGAH",10,170,30,201
https://kawalpemilu.org#64280,"PURWAJAYA, LOA JANAN, KUTAI KARTANEGARA, KALIMANTAN TIMUR",3,39,63,102
https://kawalpemilu.org#64551,"TANJUNG REDEB, TANJUNG REDEB, BERAU, KALIMANTAN TIMUR",15,123,116,239
https://kawalpemilu.org#65616,"GUNUNG LINGAI, SUNGAI PINANG, KOTA SAMARINDA, KALIMANTAN TIMUR",6,88,98,186
https://kawalpemilu.org#64346,"KOTA BANGUN I, KOTA BANGUN, KUTAI KARTANEGARA, KALIMANTAN TIMUR",2,119,54,173
https://kawalpemilu.org#64450,"MUARA JAWA PESISIR, MUARA JAWA, KUTAI KARTANEGARA, KALIMANTAN TIMUR",1,66,105,171
https://kawalpemilu.org#64459,"BUKIT RAYA, TENGGARONG SEBERANG, KUTAI KARTANEGARA, KALIMANTAN TIMUR",11,125,35,160
https://kawalpemilu.org#65629,"HARAPAN BARU, LOA JANAN ILIR, KOTA SAMARINDA, KALIMANTAN TIMUR",26,70,51,121
https://kawalpemilu.org#65431,"MUKTI JAYA, RANTAU PULUNG, KUTAI TIMUR, KALIMANTAN TIMUR",4,154,37,191
https://kawalpemilu.org#65583,"AIR HITAM, SAMARINDA ULU, KOTA SAMARINDA, KALIMANTAN TIMUR",48,61,118,179
https://kawalpemilu.org#65240,"MELAPEH BARU, LINGGANG BIGUNG, KUTAI BARAT, KALIMANTAN TIMUR",3,192,11,203
https://kawalpemilu.org#64607,"SUMBER AGUNG, BATU PUTIH, BERAU, KALIMANTAN TIMUR",1,163,39,202
https://kawalpemilu.org#65600,"LOA BAKUNG, SUNGAI KUNJANG, KOTA SAMARINDA, KALIMANTAN TIMUR",54,29,68,97
https://kawalpemilu.org#65569,"RAWA MAKMUR, PALARAN, KOTA SAMARINDA, KALIMANTAN TIMUR",60,94,41,135
https://kawalpemilu.org#65544,"KARANG JOANG, BALIKPAPAN UTARA, KOTA BALIKPAPAN, KALIMANTAN TIMUR",66,140,88,228
https://kawalpemilu.org#65555,"DAMAI, BALIKPAPAN KOTA, KOTA BALIKPAPAN, KALIMANTAN TIMUR",5,145,68,213
https://kawalpemilu.org#64500,"MERAPUN, KELAY, BERAU, KALIMANTAN TIMUR",1,161,19,180
https://kawalpemilu.org#65588,"SELILI, SAMARINDA ILIR, KOTA SAMARINDA, KALIMANTAN TIMUR",30,80,102,182
https://kawalpemilu.org#64133,"DAMIT, PASIR BALENGKONG, PASER, KALIMANTAN TIMUR",12,31,176,207
https://kawalpemilu.org#65125,"SUKOMULYO, LONG IRAM, KUTAI BARAT, KALIMANTAN TIMUR",1,113,53,186
https://kawalpemilu.org#64210,"SEBAKUNG, LONG KALI, PASER, KALIMANTAN TIMUR",3,57,35,92
https://kawalpemilu.org#64304,"GAS ALAM BADAK I, MUARA BADAK, KUTAI KARTANEGARA, KALIMANTAN TIMUR",10,49,182,231
https://kawalpemilu.org#64278,"LOA DURI ULU, LOA JANAN, KUTAI KARTANEGARA, KALIMANTAN TIMUR",11,134,53,187
https://kawalpemilu.org#65542,"BATU AMPAR, BALIKPAPAN UTARA, KOTA BALIKPAPAN, KALIMANTAN TIMUR",23,85,73,158
https://kawalpemilu.org#64144,"TANAH GROGOT, TANAH GROGOT, PASER, KALIMANTAN TIMUR",79,57,147,204
https://kawalpemilu.org#64395,"BUKIT JERING, MUARA KAMAN, KUTAI KARTANEGARA, KALIMANTAN TIMUR",2,123,35,158
https://kawalpemilu.org#87249,"DAMAI BARU, BALIKPAPAN SELATAN, KOTA BALIKPAPAN, KALIMANTAN TIMUR",6,78,46,124
https://kawalpemilu.org#64380,"RANTAU HEMPANG, MUARA KAMAN, KUTAI KARTANEGARA, KALIMANTAN TIMUR",3,190,31,221
https://kawalpemilu.org#64271,"MARGA RAHAYU, LOA KULU, KUTAI KARTANEGARA, KALIMANTAN TIMUR",11,41,17,58
https://kawalpemilu.org#64658,"APUNG, TANJUNG SELOR, BULUNGAN, KALIMANTAN UTARA",1,201,58,259
https://kawalpemilu.org#65655,"JUATA KERIKIL, TARAKAN UTARA, KOTA TARAKAN, KALIMANTAN UTARA",14,22,134,156
https://kawalpemilu.org#85505,"MENDUPO, BETAYAU, TANA TIDUNG, KALIMANTAN UTARA",1,118,7,125
https://kawalpemilu.org#64966,"MALINAU KOTA, MALINAU KOTA, MALINAU, KALIMANTAN UTARA",30,78,33,111
https://kawalpemilu.org#64654,"JELARAI SELOR, TANJUNG SELOR, BULUNGAN, KALIMANTAN UTARA",10,136,51,187
https://kawalpemilu.org#65643,"SELUMIT PANTAI, TARAKAN TENGAH, KOTA TARAKAN, KALIMANTAN UTARA",22,94,80,174
https://kawalpemilu.org#25323,"BARU, MANGGAR, BELITUNG TIMUR, KEPULAUAN BANGKA BELITUNG",5,215,21,236
https://kawalpemilu.org#25252,"BELO LAUT, MUNTOK, BANGKA BARAT, KEPULAUAN BANGKA BELITUNG",23,167,71,238
https://kawalpemilu.org#25160,"PAYUNG, PAYUNG, BANGKA SELATAN, KEPULAUAN BANGKA BELITUNG",10,94,102,196
https://kawalpemilu.org#25328,"GANTUNG, GANTUNG, BELITUNG TIMUR, KEPULAUAN BANGKA BELITUNG",1,187,51,238
https://kawalpemilu.org#25110,"AIR SELUMAR, SIJUK, BELITUNG, KEPULAUAN BANGKA BELITUNG",7,164,38,202
https://kawalpemilu.org#25079,"PANGKAL LALANG, TANJUNG PANDAN, BELITUNG, KEPULAUAN BANGKA BELITUNG",10,132,95,227
https://kawalpemilu.org#25042,"PEMALI, PEMALI, BANGKA, KEPULAUAN BANGKA BELITUNG",13,110,99,209
https://kawalpemilu.org#25223,"TERU, SIMPANG KATIS, BANGKA TENGAH, KEPULAUAN BANGKA BELITUNG",2,97,131,228
https://kawalpemilu.org#25139,"CELAGEN, KEPULAUAN PONGOK, BANGKA SELATAN, KEPULAUAN BANGKA BELITUNG",3,216,43,259
https://kawalpemilu.org#25375,"BATIN TIKAL, TAMAN SARI, KOTA PANGKALPINANG, KEPULAUAN BANGKA BELITUNG",12,62,67,129
https://kawalpemilu.org#25561,"SEI RAYA, MERAL, KARIMUN, KEPULAUAN RIAU",11,83,112,195
https://kawalpemilu.org#928225,"SUNGAILUMPUR, SINGKEP, LINGGA, KEPULAUAN RIAU",9,97,86,183
https://kawalpemilu.org#25803,"TANJUNG BUNTUNG, BENGKONG, KOTA BATAM, KEPULAUAN RIAU",52,163,79,242
https://kawalpemilu.org#25496,"TELUK SEKUNI, TAMBELAN, BINTAN, KEPULAUAN RIAU",1,105,49,154
https://kawalpemilu.org#25803,"TANJUNG BUNTUNG, BENGKONG, KOTA BATAM, KEPULAUAN RIAU",3,83,142,225
https://kawalpemilu.org#25575,"TANJUNG HUTAN, BURU, KARIMUN, KEPULAUAN RIAU",3,110,101,211
https://kawalpemilu.org#25808,"BELIAN, BATAM KOTA, KOTA BATAM, KEPULAUAN RIAU",144,82,150,232
https://kawalpemilu.org#25408,"TANJUNG PINANG BARAT, TANJUNG PINANG BARAT, KOTA TANJUNGPINANG, KEPULAUAN RIAU",35,129,53,182
https://kawalpemilu.org#25694,"BATU KACANG, SINGKEP, LINGGA, KEPULAUAN RIAU",5,109,62,171
https://kawalpemilu.org#25755,"TANJUNG SENGKUANG, BATU AMPAR, KOTA BATAM, KEPULAUAN RIAU",36,64,122,186
https://kawalpemilu.org#25737,"RAYA, SINGKEP BARAT, LINGGA, KEPULAUAN RIAU",2,80,69,149
https://kawalpemilu.org#25565,"TEBING, TEBING, KARIMUN, KEPULAUAN RIAU",13,137,86,223
https://kawalpemilu.org#25762,"PATAM LESTARI, SEKUPANG, KOTA BATAM, KEPULAUAN RIAU",36,107,145,252
https://kawalpemilu.org#25712,"SEI PINANG, LINGGA TIMUR, LINGGA, KEPULAUAN RIAU",4,104,42,146
https://kawalpemilu.org#23218,"LABUHAN RATU KAMPUNG, SUNGKAI SELATAN, LAMPUNG UTARA, LAMPUNG",52,25,156,181
https://kawalpemilu.org#24804,"LABUHAN DALAM, TANJUNG SENANG, KOTA BANDAR LAMPUNG, LAMPUNG",22,49,196,245
https://kawalpemilu.org#24591,"TANJUNG AGUNG, PAKUAN RATU, WAY KANAN, LAMPUNG",5,181,19,200
https://kawalpemilu.org#24497,"UMPU BHAKTI, BLAMBANGAN UMPU, WAY KANAN, LAMPUNG",10,110,52,162
https://kawalpemilu.org#23473,"BANGUN NEGARA, PESISIR SELATAN, PESISIR BARAT, LAMPUNG",5,187,47,234
https://kawalpemilu.org#23292,"CIAMIS, SUNGKAI UTARA, LAMPUNG UTARA, LAMPUNG",5,13,192,205
https://kawalpemilu.org#24284,"TELOGO REJO, BATANGHARI, LAMPUNG TIMUR, LAMPUNG",4,130,112,242
https://kawalpemilu.org#23834,"RAWA RAGIL, RAWA PITU, TULANG BAWANG, LAMPUNG",4,241,9,250
https://kawalpemilu.org#24779,"KOTA KARANG, TELUKBETUNG TIMUR, KOTA BANDAR LAMPUNG, LAMPUNG",19,89,89,178
https://kawalpemilu.org#87226,"KORPRI RAYA, SUKARAME, KOTA BANDAR LAMPUNG, LAMPUNG",6,45,144,189
https://kawalpemilu.org#22772,"BANGUN REJO, KETAPANG, LAMPUNG SELATAN, LAMPUNG",9,128,74,202
https://kawalpemilu.org#24280,"BUANA SAKTI, BATANGHARI, LAMPUNG TIMUR, LAMPUNG",8,193,65,258
https://kawalpemilu.org#24360,"PUGUNG RAHARJO, SEKAMPUNG UDIK, LAMPUNG TIMUR, LAMPUNG",25,144,57,201
https://kawalpemilu.org#24068,"PAGAR ALAM ULU BELU, ULU BELU, TANGGAMUS, LAMPUNG",6,121,40,161
https://kawalpemilu.org#22954,"BADRAN SARI, PUNGGUR, LAMPUNG TENGAH, LAMPUNG",1,90,73,163
https://kawalpemilu.org#24727,"SUKAJAWA, TANJUNGKARANG BARAT, KOTA BANDAR LAMPUNG, LAMPUNG",23,97,106,203
https://kawalpemilu.org#22986,"RAMA KLANDUNGAN, SEPUTIH RAMAN, LAMPUNG TENGAH, LAMPUNG",1,162,60,222
https://kawalpemilu.org#84829,"KUTA WARINGIN, ADILUWIH, PRINGSEWU, LAMPUNG",4,154,59,213
https://kawalpemilu.org#24293,"SRI BASUKI, BATANGHARI, LAMPUNG TIMUR, LAMPUNG",6,151,44,195
https://kawalpemilu.org#24718,"SEPANG JAYA, LABUHAN RATU, KOTA BANDAR LAMPUNG, LAMPUNG",26,131,113,244
https://kawalpemilu.org#24503,"UMPU KENCANA, BLAMBANGAN UMPU, WAY KANAN, LAMPUNG",1,121,57,178
https://kawalpemilu.org#22565,"GUNUNG SARI, LAMBU KIBANG, TULANG BAWANG BARAT, LAMPUNG",5,122,48,170
https://kawalpemilu.org#24327,"RAMAN AJI, RAMAN UTARA, LAMPUNG TIMUR, LAMPUNG",18,181,65,246
https://kawalpemilu.org#24676,"GEDUNG JAYA, NEGARA BATIN, WAY KANAN, LAMPUNG",7,139,18,157
https://kawalpemilu.org#22363,"KRESNO MULYO, AMBARAWA, PRINGSEWU, LAMPUNG",18,66,89,155
https://kawalpemilu.org#23017,"WIRATA AGUNG, SEPUTIH MATARAM, LAMPUNG TENGAH, LAMPUNG",6,190,22,212
https://kawalpemilu.org#87269,"LANGKAPURA BARU, LANGKAPURA, KOTA BANDAR LAMPUNG, LAMPUNG",14,55,104,159
https://kawalpemilu.org#24479,"GUNUNG RAYA, MARGA SEKAMPUNG, LAMPUNG TIMUR, LAMPUNG",2,32,111,143
https://kawalpemilu.org#23343,"ULAK RENGAS, ABUNG TINGGI, LAMPUNG UTARA, LAMPUNG",2,0,0,0
https://kawalpemilu.org#24310,"SUMBER MARGA, WAY JEPARA, LAMPUNG TIMUR, LAMPUNG",6,100,14,114
https://kawalpemilu.org#23203,"KOTABUMI TENGAH, KOTABUMI, LAMPUNG UTARA, LAMPUNG",81,1,71,72
https://kawalpemilu.org#24768,"BUMI WARAS, BUMI WARAS, KOTA BANDAR LAMPUNG, LAMPUNG",32,64,109,173
https://kawalpemilu.org#92001,"PANARAGAN JAYA, TULANG BAWANG TENGAH, TULANG BAWANG BARAT, LAMPUNG",11,82,161,243
https://kawalpemilu.org#24462,"BRAJA YEKTI, BRAJA SELEBAH, LAMPUNG TIMUR, LAMPUNG",9,113,38,151
https://kawalpemilu.org#88007,"SIDODADI, PAGELARAN, PRINGSEWU, LAMPUNG",3,150,67,217
https://kawalpemilu.org#23899,"TRI MAKMUR JAYA, MENGGALA TIMUR, TULANG BAWANG, LAMPUNG",2,106,110,216
https://kawalpemilu.org#24403,"MEKAR JAYA, BANDAR SRIBHAWONO, LAMPUNG TIMUR, LAMPUNG",3,0,0,0
https://kawalpemilu.org#90014,"LESUNG BHAKTI JAYA, LAMBU KIBANG, TULANG BAWANG BARAT, LAMPUNG",5,136,88,224
https://kawalpemilu.org#24331,"RANTAU FAJAR, RAMAN UTARA, LAMPUNG TIMUR, LAMPUNG",2,110,23,133
https://kawalpemilu.org#929400,"CANDRA JAYA, TULANG BAWANG TENGAH, TULANG BAWANG BARAT, LAMPUNG",5,136,59,195
https://kawalpemilu.org#24893,"BUMI AGUNG, TEGINENENG, PESAWARAN, LAMPUNG",1,59,126,185
https://kawalpemilu.org#23564,"KEGERINGAN, BATU BRAK, LAMPUNG BARAT, LAMPUNG",5,48,142,190
https://kawalpemilu.org#24668,"PURWA NEGARA, NEGARA BATIN, WAY KANAN, LAMPUNG",11,179,15,194
https://kawalpemilu.org#24136,"PURWODADI, GISTING, TANGGAMUS, LAMPUNG",3,64,103,167
https://kawalpemilu.org#929398,"TIRTA MAKMUR, TULANG BAWANG TENGAH, TULANG BAWANG BARAT, LAMPUNG",10,121,63,184
https://kawalpemilu.org#22667,"MUNJUK SEMPURNA, KALIANDA, LAMPUNG SELATAN, LAMPUNG",1,66,151,217
https://kawalpemilu.org#24765,"PESAWAHAN, TELUKBETUNG SELATAN, KOTA BANDAR LAMPUNG, LAMPUNG",35,131,110,241
https://kawalpemilu.org#24847,"MARGOREJO, METRO SELATAN, KOTA METRO, LAMPUNG",9,77,121,198
https://kawalpemilu.org#24118,"KALI MIRING, KOTA AGUNG BARAT, TANGGAMUS, LAMPUNG",4,66,90,156
https://kawalpemilu.org#24269,"GIRIKLOPOMULYO, SEKAMPUNG, LAMPUNG TIMUR, LAMPUNG",16,129,31,160
https://kawalpemilu.org#22422,"WARINGIN SARI TIMUR, ADILUWIH, PRINGSEWU, LAMPUNG",9,145,74,219
https://kawalpemilu.org#23435,"NEGERI BATIN JAYA, SUNGKAI BARAT, LAMPUNG UTARA, LAMPUNG",1,43,98,141
https://kawalpemilu.org#23000,"SETIA BUMI, SEPUTIH BANYAK, LAMPUNG TENGAH, LAMPUNG",2,86,23,109
https://kawalpemilu.org#24888,"BANGUN SARI, NEGERI KATON, PESAWARAN, LAMPUNG",7,120,35,155
https://kawalpemilu.org#24004,"TIUH MEMON, PUGUNG, TANGGAMUS, LAMPUNG",15,16,99,115
https://kawalpemilu.org#23930,"TALANG PADANG, TALANG PADANG, TANGGAMUS, LAMPUNG",8,71,161,232
https://kawalpemilu.org#22884,"KALIDADI, KALIREJO, LAMPUNG TENGAH, LAMPUNG",9,121,80,201
https://kawalpemilu.org#22694,"SUKAJAYA, KATIBUNG, LAMPUNG SELATAN, LAMPUNG",5,57,161,218
https://kawalpemilu.org#24393,"LEHAN, BUMI AGUNG, LAMPUNG TIMUR, LAMPUNG",11,141,33,174
https://kawalpemilu.org#24327,"RAMAN AJI, RAMAN UTARA, LAMPUNG TIMUR, LAMPUNG",15,115,83,198
https://kawalpemilu.org#24546,"MENANGA SIAMANG, BANJIT, WAY KANAN, LAMPUNG",1,30,134,164
https://kawalpemilu.org#22333,"PRINGSEWU SELATAN, PRINGSEWU, PRINGSEWU, LAMPUNG",21,113,67,180
https://kawalpemilu.org#23090,"KOTA BATU, PUBIAN, LAMPUNG TENGAH, LAMPUNG",5,153,30,183
https://kawalpemilu.org#24297,"BRAJA SAKTI, WAY JEPARA, LAMPUNG TIMUR, LAMPUNG",17,119,66,185
https://kawalpemilu.org#24700,"PISANG BARU, BUMI AGUNG, WAY KANAN, LAMPUNG",4,24,202,226
https://kawalpemilu.org#24777,"SUKAMAJU, TELUKBETUNG TIMUR, KOTA BANDAR LAMPUNG, LAMPUNG",9,55,146,201
https://kawalpemilu.org#22593,"MULYA JAYA, TULANG BAWANG TENGAH, TULANG BAWANG BARAT, LAMPUNG",1,173,63,236
https://kawalpemilu.org#22482,"GEDUNG BOGA, WAY SERDANG, MESUJI, LAMPUNG",5,156,65,221
https://kawalpemilu.org#23047,"SUKAJADI, BUMI RATU NUBAN, LAMPUNG TENGAH, LAMPUNG",6,136,36,172
https://kawalpemilu.org#-990294,"Dakar, Dakar, Senegal, Luar Negeri",1,19,10,29
https://kawalpemilu.org#-991084,"Johor Bahru, Johor Bahru, Malaysia, Luar Negeri",2218,64,85,149
https://kawalpemilu.org#-991084,"Johor Bahru, Johor Bahru, Malaysia, Luar Negeri",2073,140,51,191
https://kawalpemilu.org#-990124,"Bandar Seri Begawan, Bandar Seri Begawan, Brunei Darussalam, Luar Negeri",23,221,108,329
https://kawalpemilu.org#-990904,"Washington D.C., Washington D.C., Amerika Serikat, Luar Negeri",1001,430,116,546
https://kawalpemilu.org#-991304,"Taipei, Taipei, Taiwan, Luar Negeri",33,255,43,298
https://kawalpemilu.org#-990724,"Riyadh, Riyadh, Arab Saudi, Luar Negeri",1,360,499,859
https://kawalpemilu.org#-990164,"Beograd, Beograd, Serbia, Luar Negeri",1001,4,0,4
https://kawalpemilu.org#77764,"LELE, MANDIOLI SELATAN, HALMAHERA SELATAN, MALUKU UTARA",1,59,45,104
https://kawalpemilu.org#77492,"DUMA, GALELA BARAT, HALMAHERA UTARA, MALUKU UTARA",1,92,1,93
https://kawalpemilu.org#77896,"WAIBOGA, SULABESI TENGAH, KEPULAUAN SULA, MALUKU UTARA",3,18,141,159
https://kawalpemilu.org#77980,"NUSA JAYA, WASILE SELATAN, HALMAHERA TIMUR, MALUKU UTARA",1,21,145,166
https://kawalpemilu.org#78162,"TOMALOU, TIDORE SELATAN, KOTA TIDORE KEPULAUAN, MALUKU UTARA",5,61,129,190
https://kawalpemilu.org#78058,"DORPEDU, PULAU TERNATE, KOTA TERNATE, MALUKU UTARA",1,84,106,190
https://kawalpemilu.org#77665,"LABUHA, BACAN, HALMAHERA SELATAN, MALUKU UTARA",8,102,95,197
https://kawalpemilu.org#77954,"TODOLI, LEDE, PULAU TALIABU, MALUKU UTARA",2,27,138,165
https://kawalpemilu.org#77745,"MANDAWONG, BACAN SELATAN, HALMAHERA SELATAN, MALUKU UTARA",1,41,130,171
https://kawalpemilu.org#78120,"MAKASSAR TIMUR, KOTA TERNATE TENGAH, KOTA TERNATE, MALUKU UTARA",14,57,108,165
https://kawalpemilu.org#77013,"AMANTELU, SIRIMAU, KOTA AMBON, MALUKU",14,150,11,161
https://kawalpemilu.org#76411,"LIANG, SALAHUTU, MALUKU TENGAH, MALUKU",22,9,129,138
https://kawalpemilu.org#77023,"BATU MERAH, SIRIMAU, KOTA AMBON, MALUKU",154,16,208,224
https://kawalpemilu.org#76352,"KAMPUNG BARU, BANDA, MALUKU TENGAH, MALUKU",9,31,82,113
https://kawalpemilu.org#76416,"SULI, SALAHUTU, MALUKU TENGAH, MALUKU",20,145,7,152
https://kawalpemilu.org#77023,"BATU MERAH, SIRIMAU, KOTA AMBON, MALUKU",113,22,146,168
https://kawalpemilu.org#86018,"WAEKOSE, FENA LEISELA, BURU, MALUKU",2,193,18,211
https://kawalpemilu.org#76500,"ELAT, KEI BESAR, MALUKU TENGGARA, MALUKU",4,55,148,203
https://kawalpemilu.org#76307,"WOTAY, TEON NILA SERUA, MALUKU TENGAH, MALUKU",1,158,13,171
https://kawalpemilu.org#930416,"DENWET, KEI KECIL TIMUR, MALUKU TENGGARA, MALUKU",1,24,104,128
https://kawalpemilu.org#77014,"KARANG PANJANG, SIRIMAU, KOTA AMBON, MALUKU",5,243,8,251
https://kawalpemilu.org#76373,"HATUMETE, TEHORU, MALUKU TENGAH, MALUKU",3,200,15,215
https://kawalpemilu.org#76424,"WAKAL, LEIHITU, MALUKU TENGAH, MALUKU",1,12,159,171
https://kawalpemilu.org#76423,"HILA, LEIHITU, MALUKU TENGAH, MALUKU",23,81,112,193
https://kawalpemilu.org#54439,"SEKETENG, SUMBAWA, SUMBAWA, NUSA TENGGARA BARAT",32,18,79,97
https://kawalpemilu.org#54690,"SANOLO, BOLO, BIMA, NUSA TENGGARA BARAT",9,7,164,171
https://kawalpemilu.org#54088,"PENIMBUNG, GUNUNGSARI, LOMBOK BARAT, NUSA TENGGARA BARAT",11,66,79,145
https://kawalpemilu.org#54193,"MUJUR, PRAYA TIMUR, LOMBOK TENGAH, NUSA TENGGARA BARAT",4,50,72,122
https://kawalpemilu.org#54924,"PASIR PUTIH, MALUK, SUMBAWA BARAT, NUSA TENGGARA BARAT",2,91,126,217
https://kawalpemilu.org#85074,"PRINGGASELA SELATAN, PRINGGASELA, LOMBOK TIMUR, NUSA TENGGARA BARAT",10,65,121,186
https://kawalpemilu.org#55031,"TEGAL MAJA, TANJUNG, LOMBOK UTARA, NUSA TENGGARA BARAT",2,91,131,222
https://kawalpemilu.org#54875,"MERARAN, SETELUK, SUMBAWA BARAT, NUSA TENGGARA BARAT",6,94,86,180
https://kawalpemilu.org#54325,"KALIJAGA, AIKMEL, LOMBOK TIMUR, NUSA TENGGARA BARAT",11,32,177,209
https://kawalpemilu.org#54712,"NGALI, BELO, BIMA, NUSA TENGGARA BARAT",12,3,193,196
https://kawalpemilu.org#54063,"SEKOTONG TENGAH, SEKOTONG, LOMBOK BARAT, NUSA TENGGARA BARAT",27,135,109,244
https://kawalpemilu.org#85114,"GERISAK SEMANGGELENG, SAKRA BARAT, LOMBOK TIMUR, NUSA TENGGARA BARAT",3,47,111,158
https://kawalpemilu.org#54876,"AIR SUNING, SETELUK, SUMBAWA BARAT, NUSA TENGGARA BARAT",4,75,118,193
https://kawalpemilu.org#55031,"TEGAL MAJA, TANJUNG, LOMBOK UTARA, NUSA TENGGARA BARAT",1,125,95,220
https://kawalpemilu.org#54729,"SARI, SAPE, BIMA, NUSA TENGGARA BARAT",5,73,102,175
https://kawalpemilu.org#54142,"JELANTIK, JONGGAT, LOMBOK TENGAH, NUSA TENGGARA BARAT",20,34,148,182
https://kawalpemilu.org#87723,"WAKAN, JEROWARU, LOMBOK TIMUR, NUSA TENGGARA BARAT",13,52,157,209
https://kawalpemilu.org#54224,"KOPANG REMBIGA, KOPANG, LOMBOK TENGAH, NUSA TENGGARA BARAT",43,28,132,160
https://kawalpemilu.org#54202,"LANGKO, JANAPRIA, LOMBOK TENGAH, NUSA TENGGARA BARAT",13,36,72,108
https://kawalpemilu.org#55012,"RITE, RABA, KOTA BIMA, NUSA TENGGARA BARAT",5,39,159,198
https://kawalpemilu.org#54210,"KEREMBONG, JANAPRIA, LOMBOK TENGAH, NUSA TENGGARA BARAT",2,83,102,185
https://kawalpemilu.org#55010,"RABANGODU SELATAN, RABA, KOTA BIMA, NUSA TENGGARA BARAT",2,45,159,204
https://kawalpemilu.org#54876,"AIR SUNING, SETELUK, SUMBAWA BARAT, NUSA TENGGARA BARAT",2,49,148,197
https://kawalpemilu.org#54594,"POTU, DOMPU, DOMPU, NUSA TENGGARA BARAT",2,41,203,244
https://kawalpemilu.org#54198,"MARONG, PRAYA TIMUR, LOMBOK TENGAH, NUSA TENGGARA BARAT",22,85,88,173
https://kawalpemilu.org#85029,"EMBUNG KANDONG, TERARA, LOMBOK TIMUR, NUSA TENGGARA BARAT",3,41,131,172
https://kawalpemilu.org#54320,"PRINGGABAYA, PRINGGABAYA, LOMBOK TIMUR, NUSA TENGGARA BARAT",19,121,80,201
https://kawalpemilu.org#54290,"PAOK MOTONG, MASBAGIK, LOMBOK TIMUR, NUSA TENGGARA BARAT",26,41,170,211
https://kawalpemilu.org#54436,"SAMAPUIN, SUMBAWA, SUMBAWA, NUSA TENGGARA BARAT",7,35,133,168
https://kawalpemilu.org#55038,"GENGGELANG, GANGGA, LOMBOK UTARA, NUSA TENGGARA BARAT",6,17,141,158
https://kawalpemilu.org#54372,"SUELA, SUWELA, LOMBOK TIMUR, NUSA TENGGARA BARAT",6,51,124,175
https://kawalpemilu.org#54991,"KUMBE, RASANAE TIMUR, KOTA BIMA, NUSA TENGGARA BARAT",10,27,187,214
https://kawalpemilu.org#54439,"SEKETENG, SUMBAWA, SUMBAWA, NUSA TENGGARA BARAT",35,40,162,202
https://kawalpemilu.org#54677,"WILAMACI, MONTA, BIMA, NUSA TENGGARA BARAT",4,69,139,208
https://kawalpemilu.org#54913,"MURA, BRANG ENE, SUMBAWA BARAT, NUSA TENGGARA BARAT",4,57,148,205
https://kawalpemilu.org#54201,"LEKOR, JANAPRIA, LOMBOK TENGAH, NUSA TENGGARA BARAT",9,36,124,160
https://kawalpemilu.org#55045,"SESAIT, KAYANGAN, LOMBOK UTARA, NUSA TENGGARA BARAT",5,62,85,147
https://kawalpemilu.org#54226,"MONTONG GAMANG, KOPANG, LOMBOK TENGAH, NUSA TENGGARA BARAT",33,56,109,165
https://kawalpemilu.org#54318,"POHGADING, PRINGGABAYA, LOMBOK TIMUR, NUSA TENGGARA BARAT",26,48,184,232
https://kawalpemilu.org#54798,"LANTA, LAMBU, BIMA, NUSA TENGGARA BARAT",10,16,160,176
https://kawalpemilu.org#57799,"NANGARORO, NANGARORO, NAGEKEO, NUSA TENGGARA TIMUR",7,208,2,210
https://kawalpemilu.org#55247,"OBEN, NEKAMESE, KUPANG, NUSA TENGGARA TIMUR",2,189,11,200
https://kawalpemilu.org#57753,"BATU CERMIN, KOMODO, MANGGARAI BARAT, NUSA TENGGARA TIMUR",3,174,3,177
https://kawalpemilu.org#56514,"KOLIDETUNG, LELA, SIKKA, NUSA TENGGARA TIMUR",4,142,8,150
https://kawalpemilu.org#58174,"GOLO NGAWAN, SAMBI RAMPAS, MANGGARAI TIMUR, NUSA TENGGARA TIMUR",4,109,88,197
https://kawalpemilu.org#58049,"ALAK, ALAK, KOTA KUPANG, NUSA TENGGARA TIMUR",23,159,3,162
https://kawalpemilu.org#57022,"GOLO WUA, WAE RII, MANGGARAI, NUSA TENGGARA TIMUR",2,140,9,149
https://kawalpemilu.org#56043,"NANAET, NANAET DUABESI, BELU, NUSA TENGGARA TIMUR",3,78,5,83
https://kawalpemilu.org#927908,"WAJUR, KUWUS BARAT, MANGGARAI BARAT, NUSA TENGGARA TIMUR",2,146,8,154
https://kawalpemilu.org#57921,"WELUK PRAI MEMANG, UMBU RATU NGGAY, SUMBA TENGAH, NUSA TENGGARA TIMUR",2,128,18,146
https://kawalpemilu.org#56721,"PAUPANDA, ENDE SELATAN, ENDE, NUSA TENGGARA TIMUR",11,47,137,184
https://kawalpemilu.org#57304,"MALUMBI, KAMBERA, SUMBA TIMUR, NUSA TENGGARA TIMUR",2,167,1,168
https://kawalpemilu.org#56617,"WAIOTI, ALOK TIMUR, SIKKA, NUSA TENGGARA TIMUR",5,210,27,237
https://kawalpemilu.org#58205,"LEMBUR, KOTA KOMBA, MANGGARAI TIMUR, NUSA TENGGARA TIMUR",8,169,25,194
https://kawalpemilu.org#56720,"RUKUN LIMA, ENDE SELATAN, ENDE, NUSA TENGGARA TIMUR",21,36,131,167
https://kawalpemilu.org#85173,"LIBUNIO, SOA, NGADA, NUSA TENGGARA TIMUR",2,145,10,155
https://kawalpemilu.org#57222,"WATUMBAKA, PANDAWAI, SUMBA TIMUR, NUSA TENGGARA TIMUR",4,157,5,162
https://kawalpemilu.org#55392,"OE'EKAM, AMANUBAN TIMUR, TIMOR TENGAH SELATAN, NUSA TENGGARA TIMUR",2,217,47,264
https://kawalpemilu.org#91236,"RANGGATALO, LIO TIMUR, ENDE, NUSA TENGGARA TIMUR",1,145,3,148
https://kawalpemilu.org#56058,"NUSA KENARI, TELUK MUTIARA, ALOR, NUSA TENGGARA TIMUR",9,173,46,219
https://kawalpemilu.org#57774,"REHAK, WELAK, MANGGARAI BARAT, NUSA TENGGARA TIMUR",5,125,6,131
https://kawalpemilu.org#56598,"DONE, MAGEPANDA, SIKKA, NUSA TENGGARA TIMUR",5,139,11,150
https://kawalpemilu.org#56446,"NOBO, ILE BOLENG, FLORES TIMUR, NUSA TENGGARA TIMUR",1,151,19,170
https://kawalpemilu.org#58283,"KOLORAE, RAIJUA, SABU RAIJUA, NUSA TENGGARA TIMUR",3,179,3,182
https://kawalpemilu.org#55879,"LAKEKUN UTARA, KOBALIMA, MALAKA, NUSA TENGGARA TIMUR",2,87,42,129
https://kawalpemilu.org#57095,"WANGKUNG, REOK, MANGGARAI, NUSA TENGGARA TIMUR",2,216,6,222
https://kawalpemilu.org#56999,"WOLOLIKA, BAJAWA UTARA, NGADA, NUSA TENGGARA TIMUR",1,250,23,273
https://kawalpemilu.org#58061,"KOLHUA, MAULAFA, KOTA KUPANG, NUSA TENGGARA TIMUR",13,183,25,208
https://kawalpemilu.org#58171,"NANGA MBAUR, SAMBI RAMPAS, MANGGARAI TIMUR, NUSA TENGGARA TIMUR",4,36,152,188
https://kawalpemilu.org#58212,"GOLO MENI, KOTA KOMBA, MANGGARAI TIMUR, NUSA TENGGARA TIMUR",4,172,19,191
https://kawalpemilu.org#56983,"NARUWOLO, JEREBUU, NGADA, NUSA TENGGARA TIMUR",1,190,0,190
https://kawalpemilu.org#58062,"SIKUMANA, MAULAFA, KOTA KUPANG, NUSA TENGGARA TIMUR",15,162,15,177
https://kawalpemilu.org#57485,"WAIJARANG, NUBATUKAN, LEMBATA, NUSA TENGGARA TIMUR",2,132,28,160
https://kawalpemilu.org#58028,"HOHA WUNGO, KODI UTARA, SUMBA BARAT DAYA, NUSA TENGGARA TIMUR",1,160,13,173
https://kawalpemilu.org#55919,"MAKTIHAN, MALAKA BARAT, MALAKA, NUSA TENGGARA TIMUR",1,131,9,140
https://kawalpemilu.org#85130,"DULI JAYA, TITEHENA, FLORES TIMUR, NUSA TENGGARA TIMUR",1,178,19,197
https://kawalpemilu.org#57155,"MANONG, RAHONG UTARA, MANGGARAI, NUSA TENGGARA TIMUR",3,133,6,139
https://kawalpemilu.org#83293,"KLASUUR, SORONG KOTA, KOTA SORONG, PAPUA BARAT",6,98,63,161
https://kawalpemilu.org#82951,"PAAM, WAIGEO BARAT KEPULAUAN, RAJA AMPAT, PAPUA BARAT",2,171,4,175
https://kawalpemilu.org#83301,"KLAMANA, SORONG TIMUR, KOTA SORONG, PAPUA BARAT",9,117,36,153
https://kawalpemilu.org#81914,"IMSUN, AIFAT SELATAN, MAYBRAT, PAPUA BARAT",1,120,8,128
https://kawalpemilu.org#81953,"SEMBARO, AYAMARU SELATAN, MAYBRAT, PAPUA BARAT",1,228,0,228
https://kawalpemilu.org#82887,"RENI, KEPULAUAN AYAU, RAJA AMPAT, PAPUA BARAT",1,175,0,175
https://kawalpemilu.org#83267,"JAWERA, TELUK ARGUNI BAWAH, KAIMANA, PAPUA BARAT",1,118,0,118
https://kawalpemilu.org#83322,"MALAWEI, SORONG MANOI, KOTA SORONG, PAPUA BARAT",7,128,45,173
https://kawalpemilu.org#83120,"WAMESA TENGAH, WINDESI, TELUK WONDAMA, PAPUA BARAT",2,115,11,126
https://kawalpemilu.org#929885,"KLAWON, SAYOSA TIMUR, SORONG, PAPUA BARAT",1,50,0,50
https://kawalpemilu.org#81702,"HOLUWON, HOLUON, YAHUKIMO, PAPUA",3,271,0,271
https://kawalpemilu.org#81487,"AMUMA, AMUMA, YAHUKIMO, PAPUA",1,299,0,299
https://kawalpemilu.org#79932,"TANAS, ELIKOBAL, MERAUKE, PAPUA",1,108,2,110
https://kawalpemilu.org#930531,"IDAIYO, MUYE, PANIAI, PAPUA",1,0,310,310
https://kawalpemilu.org#81050,"SUMAPRO, JITA, MIMIKA, PAPUA",1,170,0,170
https://kawalpemilu.org#930558,"WOYOUTU, YAGAI, PANIAI, PAPUA",2,180,0,180
https://kawalpemilu.org#79895,"TAMBAT, TANAH MIRING, MERAUKE, PAPUA",1,119,5,124
https://kawalpemilu.org#79828,"KARANG INDAH, MERAUKE, MERAUKE, PAPUA",16,78,15,93
https://kawalpemilu.org#930595,"DEBAKEBOUDA, TOPIYAI, PANIAI, PAPUA",1,200,0,200
https://kawalpemilu.org#78460,"MINO, UMAGI, TOLIKARA, PAPUA",1,225,0,225
https://kawalpemilu.org#81832,"MOMENGGAMA, KWIKMA, YAHUKIMO, PAPUA",3,227,0,227
https://kawalpemilu.org#80719,"YAFDAS, SAMOFA, BIAK NUMFOR, PAPUA",5,146,8,154
https://kawalpemilu.org#90641,"RIMBARAYA, NUMFOR BARAT, BIAK NUMFOR, PAPUA",1,64,2,66
https://kawalpemilu.org#929752,"YILOKDU, KARU, LANNY JAYA, PAPUA",1,254,0,254
https://kawalpemilu.org#90773,"TAPASIK, ALEMSOM, PEGUNUNGAN BINTANG, PAPUA",1,139,0,139
https://kawalpemilu.org#930782,"OGEIDA, EKADIDE, PANIAI, PAPUA",1,0,402,402
https://kawalpemilu.org#86495,"LIMIRI, BIME, PEGUNUNGAN BINTANG, PAPUA",1,270,0,270
https://kawalpemilu.org#81685,"ENDOMEN, ENDOMEN, YAHUKIMO, PAPUA",4,250,0,250
https://kawalpemilu.org#81382,"YAHOLIKMA, ANGGRUK, YAHUKIMO, PAPUA",2,157,0,157
https://kawalpemilu.org#81306,"ABMISIBIL, OKBIBAB, PEGUNUNGAN BINTANG, PAPUA",2,284,0,284
https://kawalpemilu.org#81587,"PUE, HEREAPINI, YAHUKIMO, PAPUA",3,214,0,214
https://kawalpemilu.org#80221,"BENYOM JAYA I, NIMBOKRANG, JAYAPURA, PAPUA",4,77,212,289
https://kawalpemilu.org#79839,"BOHA, MUTING, MERAUKE, PAPUA",1,156,3,159
https://kawalpemilu.org#81197,"YUWAINDA, WARIS, KEEROM, PAPUA",3,213,9,222
https://kawalpemilu.org#79887,"AMUN KAY, TANAH MIRING, MERAUKE, PAPUA",3,100,66,166
https://kawalpemilu.org#81303,"OKBIFISIL, OKBIBAB, PEGUNUNGAN BINTANG, PAPUA",1,284,0,284
https://kawalpemilu.org#80870,"AWABUTU, PANIAI TIMUR, PANIAI, PAPUA",5,214,0,214
https://kawalpemilu.org#79835,"SERINGGU JAYA, MERAUKE, MERAUKE, PAPUA",8,129,45,174
https://kawalpemilu.org#78587,"GUBAGI, KUARI, TOLIKARA, PAPUA",1,250,0,250
https://kawalpemilu.org#930771,"KEDEGE, KEBO, PANIAI, PAPUA",2,200,0,200
https://kawalpemilu.org#929792,"NUMBOKAWI, MELAGI, LANNY JAYA, PAPUA",6,267,0,267
https://kawalpemilu.org#81178,"DABE, PANTAI TIMUR BAGIAN BARAT, SARMI, PAPUA",2,70,7,77
https://kawalpemilu.org#89128,"NILEME, GOLLO, LANNY JAYA, PAPUA",2,229,0,229
https://kawalpemilu.org#929620,"YUMANERI, BALINGGA, LANNY JAYA, PAPUA",5,261,0,261
https://kawalpemilu.org#81165,"KASUKWE, SARMI SELATAN, SARMI, PAPUA",3,93,10,103
https://kawalpemilu.org#81710,"WANIM, LOLAT, YAHUKIMO, PAPUA",1,300,0,300
https://kawalpemilu.org#79924,"MANDEKMAN, ULILIN, MERAUKE, PAPUA",1,141,23,164
https://kawalpemilu.org#81214,"DUKWIA, ARSO BARAT, KEEROM, PAPUA",4,108,150,258
https://kawalpemilu.org#14917,"PULAUBURUNG, PULAU BURUNG, INDRAGIRI HILIR, RIAU",7,82,45,127
https://kawalpemilu.org#15833,"REJO SARI, TENAYAN RAYA, KOTA PEKANBARU, RIAU",30,52,128,180
https://kawalpemilu.org#15065,"SOKOI, KUALA KAMPAR, PELALAWAN, RIAU",6,70,61,131
https://kawalpemilu.org#90461,"SINTONG PUSAKA, TANAH PUTIH, ROKAN HILIR, RIAU",1,14,221,235
https://kawalpemilu.org#931177,"MUARAFAJAR BARAT, RUMBAI, KOTA PEKANBARU, RIAU",3,104,118,222
https://kawalpemilu.org#15361,"PONDOK KRESEK, PUJUD, ROKAN HILIR, RIAU",2,108,67,175
https://kawalpemilu.org#14850,"SUNGAIJUNJANGAN, Batang Tuaka, INDRAGIRI HILIR, RIAU",8,95,83,178
https://kawalpemilu.org#15393,"SEI SIALANG HULU, BATU HAMPAR, ROKAN HILIR, RIAU",2,93,145,238
https://kawalpemilu.org#15820,"SIDOMULYA BARAT, TAMPAN, KOTA PEKANBARU, RIAU",57,32,100,132
https://kawalpemilu.org#15449,"PINANG SEBATANG TIMUR, TUALANG, SIAK, RIAU",14,178,60,238
https://kawalpemilu.org#15218,"SEI KUNING, TANDUN, ROKAN HULU, RIAU",2,133,57,190
https://kawalpemilu.org#14328,"KIJANG JAYA, TAPUNG HILIR, KAMPAR, RIAU",14,91,49,140
https://kawalpemilu.org#14218,"PULAU JAMBU, KUOK, KAMPAR, RIAU",1,7,192,199
https://kawalpemilu.org#14643,"SEI ALAM, BENGKALIS, BENGKALIS, RIAU",1,72,162,234
https://kawalpemilu.org#15836,"LABUH BARU TIMUR, PAYUNG SEKAKI, KOTA PEKANBARU, RIAU",23,95,172,267
https://kawalpemilu.org#15835,"TAMPAN, PAYUNG SEKAKI, KOTA PEKANBARU, RIAU",19,88,49,137
https://kawalpemilu.org#84520,"SUNGAIPANJI-PANJI, KUBU BABUSSALAM, ROKAN HILIR, RIAU",5,92,52,144
https://kawalpemilu.org#15395,"BANTAIAN BARU, BATU HAMPAR, ROKAN HILIR, RIAU",6,58,109,167
https://kawalpemilu.org#14864,"KUALA LAHANG, Gaung, INDRAGIRI HILIR, RIAU",1,126,85,211
https://kawalpemilu.org#14442,"TALANG JERINJING, RENGAT BARAT, INDRAGIRI HULU, RIAU",2,123,141,264
https://kawalpemilu.org#14747,"SUNGAIUNDAN, Reteh, INDRAGIRI HILIR, RIAU",2,63,19,82
https://kawalpemilu.org#15322,"GELORA, BAGAN SINEMBAH, ROKAN HILIR, RIAU",8,69,76,145
https://kawalpemilu.org#15181,"PASIR UTAMA, RAMBAH HILIR, ROKAN HULU, RIAU",8,120,96,216
https://kawalpemilu.org#14176,"RANAH, KAMPAR, KAMPAR, RIAU",6,12,148,160
https://kawalpemilu.org#14754,"Enok, Enok, INDRAGIRI HILIR, RIAU",13,113,102,215
https://kawalpemilu.org#14580,"PASIR BATU MANDI, SUNGAI LALA, INDRAGIRI HULU, RIAU",2,32,125,157
https://kawalpemilu.org#14376,"KAMPAR, KAMPA, KAMPAR, RIAU",4,30,224,254
https://kawalpemilu.org#15298,"MENGGALA SAKTI, TANAH PUTIH, ROKAN HILIR, RIAU",14,93,119,212
https://kawalpemilu.org#14315,"SEKIJANG, TAPUNG HILIR, KAMPAR, RIAU",25,63,57,120
https://kawalpemilu.org#15838,"AIR HITAM, PAYUNG SEKAKI, KOTA PEKANBARU, RIAU",6,157,31,188
https://kawalpemilu.org#931201,"SUNGAISIBAM, PAYUNG SEKAKI, KOTA PEKANBARU, RIAU",5,65,49,114
https://kawalpemilu.org#15373,"BANGKO BAKTI, BANGKO PUSAKO, ROKAN HILIR, RIAU",9,130,80,210
https://kawalpemilu.org#15859,"SUKAJADI, DUMAI KOTA, KOTA DUMAI, RIAU",18,30,166,196
https://kawalpemilu.org#14143,"BATANG MALAS, TEBING TINGGI BARAT, KEPULAUAN MERANTI, RIAU",3,82,83,165
https://kawalpemilu.org#14542,"TALANG LAKAT, BATANG GANGSAL, INDRAGIRI HULU, RIAU",7,211,10,221
https://kawalpemilu.org#14416,"KAMPUNG DAGANG, RENGAT, INDRAGIRI HULU, RIAU",1,34,220,254
https://kawalpemilu.org#14970,"PANGKALAN KERINCI KOTA, PANGKALAN KERINCI, PELALAWAN, RIAU",74,172,24,196
https://kawalpemilu.org#14147,"LUKIT, MERBAU, KEPULAUAN MERANTI, RIAU",1,117,56,173
https://kawalpemilu.org#15132,"BATANG KUMU, TAMBUSAI, ROKAN HULU, RIAU",24,201,2,203
https://kawalpemilu.org#15384,"SIMPANG KANAN, SIMPANG KANAN, ROKAN HILIR, RIAU",7,80,59,139
https://kawalpemilu.org#15825,"TANGKERANG TENGAH, MARPOYAN DAMAI, KOTA PEKANBARU, RIAU",49,68,210,278
https://kawalpemilu.org#15223,"ALIANTAN, KABUN, ROKAN HULU, RIAU",5,37,128,165
https://kawalpemilu.org#14659,"KEMBUNG LUAR, BANTAN, BENGKALIS, RIAU",7,126,57,183
https://kawalpemilu.org#15278,"BAGAN PUNAK, BANGKO, ROKAN HILIR, RIAU",18,9,139,148
https://kawalpemilu.org#76049,"BANGGAE, BANGGAE, MAJENE, SULAWESI BARAT",7,71,127,198
https://kawalpemilu.org#75865,"TINAMBUNG, TINAMBUNG, POLEWALI MANDAR, SULAWESI BARAT",8,95,127,222
https://kawalpemilu.org#75626,"LELING, TOMMO, MAMUJU, SULAWESI BARAT",2,73,23,96
https://kawalpemilu.org#75906,"GALESO, WONOMULYO, POLEWALI MANDAR, SULAWESI BARAT",8,100,43,143
https://kawalpemilu.org#75608,"LARA, KAROSSA, MAMUJU TENGAH, SULAWESI BARAT",5,115,29,144
https://kawalpemilu.org#75437,"PAKAVA, PASANGKAYU, MAMUJU UTARA, SULAWESI BARAT",3,98,6,104
https://kawalpemilu.org#75517,"BELA, TAPALANG, MAMUJU, SULAWESI BARAT",1,117,24,141
https://kawalpemilu.org#75447,"KASANO, BARAS, MAMUJU UTARA, SULAWESI BARAT",2,118,82,200
https://kawalpemilu.org#75866,"KARAMA, TINAMBUNG, POLEWALI MANDAR, SULAWESI BARAT",3,207,48,255
https://kawalpemilu.org#76030,"PETOOSANG, ALLU, POLEWALI MANDAR, SULAWESI BARAT",4,83,110,193
https://kawalpemilu.org#69627,"TIBONA, BULUKUMPA, BULUKUMBA, SULAWESI SELATAN",3,77,84,161
https://kawalpemilu.org#71007,"LOMPULLE, GANRA, SOPPENG, SULAWESI SELATAN",6,89,86,175
https://kawalpemilu.org#70737,"ALLEPOLEA, LAU, MAROS, SULAWESI SELATAN",7,35,192,227
https://kawalpemilu.org#71364,"SALO, WATANG SAWITO, PINRANG, SULAWESI SELATAN",10,49,155,204
https://kawalpemilu.org#71414,"TADANGPALIE, CEMPA, PINRANG, SULAWESI SELATAN",10,56,149,205
https://kawalpemilu.org#69857,"LEBANG MANAI UTARA, RUMBIA, JENEPONTO, SULAWESI SELATAN",2,30,107,137
https://kawalpemilu.org#69947,"PADDINGING, SANROBONE, TAKALAR, SULAWESI SELATAN",1,63,149,212
https://kawalpemilu.org#72510,"SONGKA, WARA SELATAN, KOTA PALOPO, SULAWESI SELATAN",11,71,167,238
https://kawalpemilu.org#72475,"UJUNG BULU, UJUNG, KOTA PARE PARE, SULAWESI SELATAN",5,79,141,220
https://kawalpemilu.org#71126,"PAKKANA, TANASITOLO, WAJO, SULAWESI SELATAN",6,117,67,184
https://kawalpemilu.org#70397,"LOMPU, CINA, BONE, SULAWESI SELATAN",6,147,62,209
https://kawalpemilu.org#70434,"MASSENRENG PULU, LAMURU, BONE, SULAWESI SELATAN",3,112,47,159
https://kawalpemilu.org#72455,"RAPPOCINI, RAPPOCINI, KOTA MAKASSAR, SULAWESI SELATAN",7,79,133,212
https://kawalpemilu.org#69441,"LONDONGBIANG, AWAN RANTE KARUA, TORAJA UTARA, SULAWESI SELATAN",4,101,4,105
https://kawalpemilu.org#69675,"BONTO LANGKASA, BISSAPPU, BANTAENG, SULAWESI SELATAN",8,5,101,106
https://kawalpemilu.org#70754,"TAROADA, TURIKALE, MAROS, SULAWESI SELATAN",17,52,113,165
https://kawalpemilu.org#69550,"BONTO MASILA, GANTARANG, BULUKUMBA, SULAWESI SELATAN",2,12,100,112
https://kawalpemilu.org#72412,"KARUWISI, PANAKUKKANG, KOTA MAKASSAR, SULAWESI SELATAN",27,53,89,142
https://kawalpemilu.org#71068,"SALOBULO, SAJOANGING, WAJO, SULAWESI SELATAN",7,110,62,172
https://kawalpemilu.org#70031,"PARANGBANOA, PALLANGGA, GOWA, SULAWESI SELATAN",6,93,135,228
https://kawalpemilu.org#71593,"MAPPE TAJANG, BASSE SANGTEMPE, LUWU, SULAWESI SELATAN",2,18,50,68
https://kawalpemilu.org#72482,"KAMPUNG PISANG, SOREANG, KOTA PARE PARE, SULAWESI SELATAN",4,105,81,186
https://kawalpemilu.org#69688,"KARATUANG, BANTAENG, BANTAENG, SULAWESI SELATAN",8,22,111,133
https://kawalpemilu.org#71072,"PARIA, MAJAULENG, WAJO, SULAWESI SELATAN",3,73,93,166
https://kawalpemilu.org#69761,"BONTOTANGNGA, TAMALATEA, JENEPONTO, SULAWESI SELATAN",15,29,168,197
https://kawalpemilu.org#72137,"BAKU BAKU, MALANGKE BARAT, LUWU UTARA, SULAWESI SELATAN",10,36,33,69
https://kawalpemilu.org#72427,"MANGASA, TAMALATE, KOTA MAKASSAR, SULAWESI SELATAN",51,41,89,130
https://kawalpemilu.org#72114,"MULYASARI, SUKAMAJU, LUWU UTARA, SULAWESI SELATAN",5,102,74,176
https://kawalpemilu.org#70037,"PANAKKUKANG, PALLANGGA, GOWA, SULAWESI SELATAN",12,42,169,211
https://kawalpemilu.org#70667,"PALLANTIKANG, MAROS BARU, MAROS, SULAWESI SELATAN",1,78,134,212
https://kawalpemilu.org#72308,"BALAMBANO, WASUPONDA, LUWU TIMUR, SULAWESI SELATAN",6,55,99,154
https://kawalpemilu.org#70370,"LETTA TANAH, SIBULUE, BONE, SULAWESI SELATAN",4,127,49,176
https://kawalpemilu.org#71583,"DAMPAN, BASSE SANGTEMPE UTARA, LUWU, SULAWESI SELATAN",1,112,29,141
https://kawalpemilu.org#69888,"PUNAGA, MANGARABOMBANG, TAKALAR, SULAWESI SELATAN",4,87,30,117
https://kawalpemilu.org#71818,"OLANG, PONRANG SELATAN, LUWU, SULAWESI SELATAN",2,23,150,173
https://kawalpemilu.org#69309,"AMPANG BATU, RINDINGALLO, TORAJA UTARA, SULAWESI SELATAN",1,117,15,132
https://kawalpemilu.org#70528,"CABBENG, DUA BOCCOE, BONE, SULAWESI SELATAN",2,83,131,214
https://kawalpemilu.org#69711,"BALUMBUNG, TOMPO BULU, BANTAENG, SULAWESI SELATAN",5,32,86,118
https://kawalpemilu.org#70566,"WATAMPONE, TANETE RIATTANG, BONE, SULAWESI SELATAN",17,86,108,194
https://kawalpemilu.org#71067,"BARANGMAMASE, SAJOANGING, WAJO, SULAWESI SELATAN",7,91,50,141
https://kawalpemilu.org#70025,"SOKKOLIA, BONTOMARANNU, GOWA, SULAWESI SELATAN",9,88,139,227
https://kawalpemilu.org#72375,"LAYANG, BONTOALA, KOTA MAKASSAR, SULAWESI SELATAN",8,125,89,214
https://kawalpemilu.org#71067,"BARANGMAMASE, SAJOANGING, WAJO, SULAWESI SELATAN",8,93,73,166
https://kawalpemilu.org#69403,"ANGIN-ANGIN, KESU', TORAJA UTARA, SULAWESI SELATAN",4,123,25,148
https://kawalpemilu.org#85807,"GALUNG MALOANG, BACUKIKI, KOTA PARE PARE, SULAWESI SELATAN",13,109,122,231
https://kawalpemilu.org#71641,"SUMABU, BAJO, LUWU, SULAWESI SELATAN",1,84,74,158
https://kawalpemilu.org#71475,"KALUPPINI, ENREKANG, ENREKANG, SULAWESI SELATAN",4,94,45,139
https://kawalpemilu.org#72546,"TEMMALEBBA, BARA, KOTA PALOPO, SULAWESI SELATAN",7,91,135,226
https://kawalpemilu.org#72142,"KALITATA, MALANGKE BARAT, LUWU UTARA, SULAWESI SELATAN",4,104,96,200
https://kawalpemilu.org#70799,"KASSI, BALOCCI, PANGKAJENE DAN KEPULAUAN, SULAWESI SELATAN",6,79,101,180
https://kawalpemilu.org#71196,"POLEWALIE, GILIRENG, WAJO, SULAWESI SELATAN",3,82,80,162
https://kawalpemilu.org#72458,"KARUNRUNG, RAPPOCINI, KOTA MAKASSAR, SULAWESI SELATAN",19,59,122,181
https://kawalpemilu.org#71142,"MATTIROWALIE, MANIANGPAJO, WAJO, SULAWESI SELATAN",5,93,107,200
https://kawalpemilu.org#70937,"LABESSI, MARIORIWAWO, SOPPENG, SULAWESI SELATAN",10,85,69,154
https://kawalpemilu.org#70981,"UMPUNGENG, LALABATA, SOPPENG, SULAWESI SELATAN",13,205,11,216
https://kawalpemilu.org#72496,"BOTING, WARA, KOTA PALOPO, SULAWESI SELATAN",9,83,120,203
https://kawalpemilu.org#69727,"BONTO RANNU, ULUERE, BANTAENG, SULAWESI SELATAN",5,32,76,108
https://kawalpemilu.org#70910,"SIDDO, SOPPENG RIAJA, BARRU, SULAWESI SELATAN",11,66,74,140
https://kawalpemilu.org#70933,"MADELLO, BALUSU, BARRU, SULAWESI SELATAN",1,147,104,251
https://kawalpemilu.org#72182,"PALANDAN, BAEBUNTA, LUWU UTARA, SULAWESI SELATAN",2,83,157,240
https://kawalpemilu.org#69734,"BAJIMINASA, GANTARANG KEKE, BANTAENG, SULAWESI SELATAN",7,73,128,201
https://kawalpemilu.org#69704,"CAMPAGA, TOMPO BULU, BANTAENG, SULAWESI SELATAN",2,34,119,153
https://kawalpemilu.org#70154,"ARABIKA, SINJAI BARAT, SINJAI, SULAWESI SELATAN",2,32,182,214
https://kawalpemilu.org#70823,"BARA BATU, LABAKKANG, PANGKAJENE DAN KEPULAUAN, SULAWESI SELATAN",9,48,153,201
https://kawalpemilu.org#69920,"BENTANG, GALESONG SELATAN, TAKALAR, SULAWESI SELATAN",3,0,0,0
https://kawalpemilu.org#67455,"SALUA, KULAWI, SIGI, SULAWESI TENGAH",4,96,123,219
https://kawalpemilu.org#68892,"BANTAYA, PARIGI, PARIGI MOUTONG, SULAWESI TENGAH",17,19,30,49
https://kawalpemilu.org#93013,"PETIRODONGI, PAMONA UTARA, POSO, SULAWESI TENGAH",4,198,13,211
https://kawalpemilu.org#67789,"TOMEANG, NUHON, BANGGAI, SULAWESI TENGAH",1,128,95,223
https://kawalpemilu.org#68699,"DANGKALAN, BANGGAI, BANGGAI LAUT, SULAWESI TENGAH",1,81,165,246
https://kawalpemilu.org#69075,"PEBOUNANG, PALASA, PARIGI MOUTONG, SULAWESI TENGAH",6,95,51,146
https://kawalpemilu.org#67525,"POTOYA, DOLO, SIGI, SULAWESI TENGAH",1,60,192,252
https://kawalpemilu.org#68878,"LABANGUN, BUKO SELATAN, BANGGAI KEPULAUAN, SULAWESI TENGAH",1,104,39,143
https://kawalpemilu.org#69255,"PENGAWU, TATANGA, KOTA PALU, SULAWESI TENGAH",16,58,162,220
https://kawalpemilu.org#68213,"MIMBALA, DAMPAL SELATAN, TOLITOLI, SULAWESI TENGAH",2,96,105,201
https://kawalpemilu.org#69153,"BAILO, AMPANA KOTA, TOJO UNA-UNA, SULAWESI TENGAH",2,31,64,95
https://kawalpemilu.org#68322,"PAJEKO, MOMUNU, BUOL, SULAWESI TENGAH",4,66,158,224
https://kawalpemilu.org#69251,"TANAMODINDI, MANTIKULORE, KOTA PALU, SULAWESI TENGAH",12,60,179,239
https://kawalpemilu.org#67942,"UELENE, PAMONA SELATAN, POSO, SULAWESI TENGAH",2,191,14,205
https://kawalpemilu.org#68002,"BUKIT BAMBU, POSO KOTA SELATAN, POSO, SULAWESI TENGAH",1,154,22,176
https://kawalpemilu.org#67509,"RARAMPADENDE, DOLO BARAT, SIGI, SULAWESI TENGAH",5,43,100,143
https://kawalpemilu.org#67932,"POLEGANYARA, PAMONA TIMUR, POSO, SULAWESI TENGAH",3,142,6,148
https://kawalpemilu.org#68069,"KARYA MUKTI, DAMPELAS, DONGGALA, SULAWESI TENGAH",9,130,71,201
https://kawalpemilu.org#67736,"TANAH ABANG, TOILI, BANGGAI, SULAWESI TENGAH",2,100,138,238
https://kawalpemilu.org#69232,"UJUNA, PALU BARAT, KOTA PALU, SULAWESI TENGAH",11,67,73,140
https://kawalpemilu.org#87588,"POMOLULU, BALAESANG TANJUNG, DONGGALA, SULAWESI TENGAH",3,148,13,160
https://kawalpemilu.org#67398,"BORA, SIGI BIROMARU, SIGI, SULAWESI TENGAH",7,53,164,217
https://kawalpemilu.org#68577,"BULELENG, BUNGKU PESISIR, MOROWALI, SULAWESI TENGAH",3,115,45,160
https://kawalpemilu.org#73209,"LANGKORONI, MALIGANO, MUNA, SULAWESI TENGGARA",2,89,70,159
https://kawalpemilu.org#73341,"LAKOLOGOU, TONGKUNO, MUNA, SULAWESI TENGGARA",2,52,102,154
https://kawalpemilu.org#87957,"WATIGINANDA, SAMPOLAWA, BUTON SELATAN, SULAWESI TENGGARA",2,92,67,159
https://kawalpemilu.org#72804,"WAWONGGOLE, UNAAHA, KONAWE, SULAWESI TENGGARA",2,54,180,234
https://kawalpemilu.org#73983,"ANDUNA, LAEYA, KONAWE SELATAN, SULAWESI TENGGARA",1,36,174,210
https://kawalpemilu.org#85864,"MUARA TINOBU, LASOLO, KONAWE UTARA, SULAWESI TENGGARA",2,79,89,168
https://kawalpemilu.org#74630,"LAPULU, ABELI, KOTA KENDARI, SULAWESI TENGGARA",2,77,115,192
https://kawalpemilu.org#72559,"19 NOPEMBER, WUNDULAKO, KOLAKA, SULAWESI TENGGARA",9,132,45,177
https://kawalpemilu.org#73343,"LAPADINDI, TONGKUNO, MUNA, SULAWESI TENGGARA",2,103,46,149
https://kawalpemilu.org#74679,"BUKIT WOLIO INDAH, WOLIO, KOTA BAU BAU, SULAWESI TENGGARA",10,57,137,194
https://kawalpemilu.org#929445,"TAHI ITE, RAROWATU, BOMBANA, SULAWESI TENGGARA",1,44,83,127
https://kawalpemilu.org#73488,"TODOMBULU, SAMPOLAWA, BUTON SELATAN, SULAWESI TENGGARA",3,181,25,206
https://kawalpemilu.org#74219,"WAHA, TOMIA, WAKATOBI, SULAWESI TENGGARA",2,114,52,166
https://kawalpemilu.org#73879,"PUUNANGGA, LALEMBUU, KONAWE SELATAN, SULAWESI TENGGARA",1,36,147,183
https://kawalpemilu.org#72849,"ANGGALOMOARE, ANGGALOMOARE, KONAWE, SULAWESI TENGGARA",2,18,122,140
https://kawalpemilu.org#73204,"NAPALAKURA, NAPABALANO, MUNA, SULAWESI TENGGARA",2,70,66,136
https://kawalpemilu.org#73453,"LOLIBU, LAKUDO, BUTON TENGAH, SULAWESI TENGGARA",9,89,104,193
https://kawalpemilu.org#72683,"SEA, LATAMBAGA, KOLAKA, SULAWESI TENGGARA",1,85,144,229
https://kawalpemilu.org#74627,"LAHUNDAPE, KENDARI BARAT, KOTA KENDARI, SULAWESI TENGGARA",5,53,132,185
https://kawalpemilu.org#74668,"WABOROBO, BETOAMBARI, KOTA BAU BAU, SULAWESI TENGGARA",3,108,83,191
https://kawalpemilu.org#66202,"PETTA, TABUKAN UTARA, KEPULAUAN SANGIHE, SULAWESI UTARA",2,165,55,220
https://kawalpemilu.org#67232,"PAPUSUNGAN, LEMBEH SELATAN, KOTA BITUNG, SULAWESI UTARA",11,140,13,153
https://kawalpemilu.org#66406,"LALUE TENGAH, ESSANG, KEPULAUAN TALAUD, SULAWESI UTARA",2,131,6,137
https://kawalpemilu.org#66488,"BALANG, SALIBABU, KEPULAUAN TALAUD, SULAWESI UTARA",2,173,15,188
https://kawalpemilu.org#88966,"TONSEWER SELATAN, TOMPASO BARAT, MINAHASA, SULAWESI UTARA",2,197,37,234
https://kawalpemilu.org#88807,"KOLONGAN ATAS DUA, SONDER, MINAHASA, SULAWESI UTARA",3,211,17,228
https://kawalpemilu.org#66054,"TOMPASO DUA, TOMPASO BARAT, MINAHASA, SULAWESI UTARA",2,189,19,208
https://kawalpemilu.org#65969,"BILALANG III, BILALANG, BOLAANG MONGONDOW, SULAWESI UTARA",2,51,163,214
https://kawalpemilu.org#67167,"WENANG SELATAN, WENANG, KOTA MANADO, SULAWESI UTARA",5,159,14,173
https://kawalpemilu.org#65889,"LALOW, LOLAK, BOLAANG MONGONDOW, SULAWESI UTARA",3,198,27,225
https://kawalpemilu.org#67121,"BEONG, SIAU TENGAH, KEP. SIAU TAGULANDANG BIARO, SULAWESI UTARA",2,171,16,187
https://kawalpemilu.org#67150,"MAHAWU, TUMINITING, KOTA MANADO, SULAWESI UTARA",3,125,89,214
https://kawalpemilu.org#67211,"BENGKOL, MAPANGET, KOTA MANADO, SULAWESI UTARA",2,206,14,220
https://kawalpemilu.org#67149,"SUMOMPO, TUMINITING, KOTA MANADO, SULAWESI UTARA",12,188,14,202
https://kawalpemilu.org#88401,"PAAL DUA, PAAL DUA, KOTA MANADO, SULAWESI UTARA",23,153,32,185
https://kawalpemilu.org#927846,"WIAU LAPI BARAT, TARERAN, MINAHASA SELATAN, SULAWESI UTARA",2,200,18,218
https://kawalpemilu.org#66409,"KAKOROTAN, NANUSA, KEPULAUAN TALAUD, SULAWESI UTARA",1,235,1,236
https://kawalpemilu.org#66030,"RINONDOR, KAKAS, MINAHASA, SULAWESI UTARA",1,129,10,139
https://kawalpemilu.org#67201,"TELING ATAS, WANEA, KOTA MANADO, SULAWESI UTARA",13,193,11,204
https://kawalpemilu.org#67208,"MAPANGET BARAT, MAPANGET, KOTA MANADO, SULAWESI UTARA",14,176,20,196
https://kawalpemilu.org#13683,"AIA BANGIH, SUNGAI BEREMAS, PASAMAN BARAT, SUMATERA BARAT",22,7,176,183
https://kawalpemilu.org#13207,"ANDALEH BARUH BUKIK, SUNGAYANG, TANAH DATAR, SUMATERA BARAT",16,8,121,129
https://kawalpemilu.org#13432,"TAEH BUKIK, PAYAKUMBUH, LIMA PULUH KOTA, SUMATERA BARAT",2,25,219,244
https://kawalpemilu.org#13303,"GUNUNG PADANG ALAI, V KOTO TIMUR, PADANG PARIAMAN, SUMATERA BARAT",6,7,198,205
https://kawalpemilu.org#13642,"KOTO BARU, SUNGAI PAGU, SOLOK SELATAN, SUMATERA BARAT",2,16,138,154
https://kawalpemilu.org#13543,"SIMPANG, SIMPANG ALAHAN MATI, PASAMAN, SUMATERA BARAT",10,10,182,192
https://kawalpemilu.org#13744,"KAMPUNG JAWA, PADANG BARAT, KOTA PADANG, SUMATERA BARAT",7,62,151,213
https://kawalpemilu.org#13736,"GANTING PARAK GADANG, PADANG TIMUR, KOTA PADANG, SUMATERA BARAT",4,73,89,162
https://kawalpemilu.org#13709,"KAPA, LUHAK NAN DUO, PASAMAN BARAT, SUMATERA BARAT",9,8,201,209
https://kawalpemilu.org#13425,"GUGUAK VIII KOTO, GUGUAK, LIMA PULUH KOTA, SUMATERA BARAT",9,24,146,170
https://kawalpemilu.org#13429,"SIMPANG SUGIRAN, GUGUAK, LIMA PULUH KOTA, SUMATERA BARAT",8,28,92,120
https://kawalpemilu.org#13638,"LUBUK GADANG SELATAN, SANGIR, SOLOK SELATAN, SUMATERA BARAT",34,44,107,151
https://kawalpemilu.org#84429,"SIKABAU, PULAU PUNJUNG, DHARMASRAYA, SUMATERA BARAT",24,76,116,192
https://kawalpemilu.org#84334,"TALUK TIGO SAKATO, BATANG KAPAS, PESISIR SELATAN, SUMATERA BARAT",2,29,207,236
https://kawalpemilu.org#13755,"GUNUNG PANGILUN, PADANG UTARA, KOTA PADANG, SUMATERA BARAT",6,23,137,160
https://kawalpemilu.org#13577,"MUARA SIKABALUAN, SIBERUT UTARA, KEPULAUAN MENTAWAI, SUMATERA BARAT",3,81,11,92
https://kawalpemilu.org#13213,"SUNGAI TARAB, SUNGAI TARAB, TANAH DATAR, SUMATERA BARAT",30,19,141,160
https://kawalpemilu.org#13081,"SIBARAMBANG, X KOTO DIATAS, SOLOK, SUMATERA BARAT",8,26,148,174
https://kawalpemilu.org#13678,"TALAO SUNGAI KUNYIT, SANGIR BALAI JANGGO, SOLOK SELATAN, SUMATERA BARAT",15,12,52,64
https://kawalpemilu.org#12943,"LAKITAN SELATAN, LENGAYANG, PESISIR SELATAN, SUMATERA BARAT",6,41,146,187
https://kawalpemilu.org#13521,"SUNDATA, LUBUK SIKAPING, PASAMAN, SUMATERA BARAT",8,1,206,207
https://kawalpemilu.org#931238,"Sungai Gimba Ulakan, ULAKAN TAPAKIH, PADANG PARIAMAN, SUMATERA BARAT",2,12,141,153
https://kawalpemilu.org#13234,"SALIMPAUNG, SALIMPAUANG, TANAH DATAR, SUMATERA BARAT",13,21,162,183
https://kawalpemilu.org#13637,"LUBUK GADANG TIMUR, SANGIR, SOLOK SELATAN, SUMATERA BARAT",3,13,101,114
https://kawalpemilu.org#13754,"ALAI PARAK KOPI, PADANG UTARA, KOTA PADANG, SUMATERA BARAT",5,38,207,245
https://kawalpemilu.org#13769,"GURUN LAWEH NAN XX, LUBUK BEGALUNG, KOTA PADANG, SUMATERA BARAT",3,84,155,239
https://kawalpemilu.org#13247,"TEPI SELO, LINTAU BUO UTARA, TANAH DATAR, SUMATERA BARAT",10,9,95,104
https://kawalpemilu.org#13044,"DILAM, BUKIT SUNDI, SOLOK, SUMATERA BARAT",3,9,73,82
https://kawalpemilu.org#13178,"BATIPUAH BARUAH, BATIPUH, TANAH DATAR, SUMATERA BARAT",26,15,137,152
https://kawalpemilu.org#13394,"SUNGAI PUA, SUNGAI PUA, AGAM, SUMATERA BARAT",3,21,160,181
https://kawalpemilu.org#13937,"KUBU GADANG, PAYAKUMBUH BARAT, KOTA PAYAKUMBUH, SUMATERA BARAT",3,27,178,205
https://kawalpemilu.org#13327,"MANGGOPOH, LUBUK BASUNG, AGAM, SUMATERA BARAT",19,13,116,129
https://kawalpemilu.org#13678,"TALAO SUNGAI KUNYIT, SANGIR BALAI JANGGO, SOLOK SELATAN, SUMATERA BARAT",3,9,120,129
https://kawalpemilu.org#13612,"SIALANG GAUNG, KOTO BARU, DHARMASRAYA, SUMATERA BARAT",16,24,193,217
https://kawalpemilu.org#13803,"KORONG GADANG, KURANJI, KOTA PADANG, SUMATERA BARAT",32,12,183,195
https://kawalpemilu.org#13439,"TJ. HARO SIKABU-KABU PD. PANJANG, LUAK, LIMA PULUH KOTA, SUMATERA BARAT",6,26,188,214
https://kawalpemilu.org#13820,"KOTO PULAI, KOTO TANGAH, KOTA PADANG, SUMATERA BARAT",8,16,178,194
https://kawalpemilu.org#13798,"PASAR AMBACANG, KURANJI, KOTA PADANG, SUMATERA BARAT",2,14,177,191
https://kawalpemilu.org#13688,"AUA KUNIANG, PASAMAN, PASAMAN BARAT, SUMATERA BARAT",12,16,143,159
https://kawalpemilu.org#13581,"SIMATALU, SIBERUT BARAT, KEPULAUAN MENTAWAI, SUMATERA BARAT",10,156,3,159
https://kawalpemilu.org#13798,"PASAR AMBACANG, KURANJI, KOTA PADANG, SUMATERA BARAT",23,16,230,246
https://kawalpemilu.org#13323,"LUBUK BASUNG, LUBUK BASUNG, AGAM, SUMATERA BARAT",15,27,204,231
https://kawalpemilu.org#19653,"KARANG JAYA, BELITANG II, OGAN KOMERING ULU TIMUR, SUMATERA SELATAN",3,82,65,147
https://kawalpemilu.org#20620,"PLAJU DARAT, PLAJU, KOTA PALEMBANG, SUMATERA SELATAN",25,98,116,214
https://kawalpemilu.org#19502,"KOTA BARU, MARTAPURA, OGAN KOMERING ULU TIMUR, SUMATERA SELATAN",11,37,163,200
https://kawalpemilu.org#19207,"KARANG SARI, BANYUASIN II, BANYUASIN, SUMATERA SELATAN",2,150,60,210
https://kawalpemilu.org#20593,"BUKIT SANGKAL, KALIDONI, KOTA PALEMBANG, SUMATERA SELATAN",51,54,129,183
https://kawalpemilu.org#19014,"JUD II, SANGA DESA, MUSI BANYUASIN, SUMATERA SELATAN",3,104,74,178
https://kawalpemilu.org#20576,"KEBUN BUNGA, SUKARAMI, KOTA PALEMBANG, SUMATERA SELATAN",44,59,126,185
https://kawalpemilu.org#17929,"AIR LINTANG, MUARA ENIM, MUARA ENIM, SUMATERA SELATAN",5,39,208,247
https://kawalpemilu.org#19863,"BAYUR TENGAH, MUARA DUA KISAM, OGAN KOMERING ULU SELATAN, SUMATERA SELATAN",1,53,83,136
https://kawalpemilu.org#18684,"MUARA KELINGI, MUARA KELINGI, MUSI RAWAS, SUMATERA SELATAN",9,31,154,185
https://kawalpemilu.org#18663,"TRI ANGGUN JAYA, MUARA LAKITAN, MUSI RAWAS, SUMATERA SELATAN",3,132,123,255
https://kawalpemilu.org#19414,"SEMUNTUL, RANTAU BAYUR, BANYUASIN, SUMATERA SELATAN",2,31,196,227
https://kawalpemilu.org#19589,"RASUAN BARU, MADANG SUKU II, OGAN KOMERING ULU TIMUR, SUMATERA SELATAN",3,64,90,154
https://kawalpemilu.org#20761,"PATIH GALUNG, PRABUMULIH BARAT, KOTA PRABUMULIH, SUMATERA SELATAN",33,58,63,121
https://kawalpemilu.org#18222,"TANJUNG KURUNG, ABAB, PENUKAL ABAB LEMATANG ILIR, SUMATERA SELATAN",6,116,96,212
https://kawalpemilu.org#19761,"SIDOREJO, BELITANG JAYA, OGAN KOMERING ULU TIMUR, SUMATERA SELATAN",4,96,90,186
https://kawalpemilu.org#20445,"MUARA SALING, SALING, EMPAT LAWANG, SUMATERA SELATAN",4,16,97,113
https://kawalpemilu.org#20613,"KEMANG AGUNG, KERTAPATI, KOTA PALEMBANG, SUMATERA SELATAN",19,50,145,195
https://kawalpemilu.org#19554,"GUNUNG JATI, CEMPAKA, OGAN KOMERING ULU TIMUR, SUMATERA SELATAN",6,97,32,129
https://kawalpemilu.org#20577,"SUKA BANGUN, SUKARAMI, KOTA PALEMBANG, SUMATERA SELATAN",24,65,138,203
https://kawalpemilu.org#19206,"SUNGSANG IV, BANYUASIN II, BANYUASIN, SUMATERA SELATAN",8,125,56,181
https://kawalpemilu.org#19539,"BEDILAN, BELITANG, OGAN KOMERING ULU TIMUR, SUMATERA SELATAN",7,125,90,215
https://kawalpemilu.org#20565,"3 ILIR, ILIR TIMUR II, KOTA PALEMBANG, SUMATERA SELATAN",24,74,119,193
https://kawalpemilu.org#18069,"TANJUNG TIGA, SEMENDE DARAT ULU, MUARA ENIM, SUMATERA SELATAN",4,5,189,194
https://kawalpemilu.org#18636,"MUARA PAYANG, MUARA PAYANG, LAHAT, SUMATERA SELATAN",2,68,123,191
https://kawalpemilu.org#19928,"SUKARAJA, MEKAKAU ILIR, OGAN KOMERING ULU SELATAN, SUMATERA SELATAN",1,87,124,211
https://kawalpemilu.org#19908,"PADANG BINDU, BUAY RUNJUNG, OGAN KOMERING ULU SELATAN, SUMATERA SELATAN",4,63,110,173
https://kawalpemilu.org#18987,"KERAMAT JAYA, SUNGAI KERUH, MUSI BANYUASIN, SUMATERA SELATAN",1,21,158,179
https://kawalpemilu.org#17918,"PENYANDINGAN, TANJUNG AGUNG, MUARA ENIM, SUMATERA SELATAN",1,52,163,215
https://kawalpemilu.org#17524,"BANU AYU, LUBUK BATANG, OGAN KOMERING ULU, SUMATERA SELATAN",12,45,155,200
https://kawalpemilu.org#20578,"TALANG JAMBE, SUKARAMI, KOTA PALEMBANG, SUMATERA SELATAN",9,78,62,140
https://kawalpemilu.org#20627,"ALANG-ALANG LEBAR, ALANG-ALANG LEBAR, KOTA PALEMBANG, SUMATERA SELATAN",6,90,106,196
https://kawalpemilu.org#20544,"SIRING AGUNG, ILIR BARAT I, KOTA PALEMBANG, SUMATERA SELATAN",64,35,102,137
https://kawalpemilu.org#20502,"BANDAR AGUNG, PASEMAH AIR KERUH, EMPAT LAWANG, SUMATERA SELATAN",2,6,187,193
https://kawalpemilu.org#18779,"TANAH PERIUK I, MUARA BELITI, MUSI RAWAS, SUMATERA SELATAN",5,33,147,180
https://kawalpemilu.org#19632,"SUMBER JAYA, BELITANG II, OGAN KOMERING ULU TIMUR, SUMATERA SELATAN",6,84,103,187
https://kawalpemilu.org#20602,"24 ILIR, BUKIT KECIL, KOTA PALEMBANG, SUMATERA SELATAN",47,28,72,100
https://kawalpemilu.org#18040,"TEGAL REJO, LAWANG KIDUL, MUARA ENIM, SUMATERA SELATAN",3,89,163,252
https://kawalpemilu.org#19787,"MARGA CINTA, BELITANG MADANG RAYA, OGAN KOMERING ULU TIMUR, SUMATERA SELATAN",5,79,87,166
https://kawalpemilu.org#20563,"8 ILIR, ILIR TIMUR III, KOTA PALEMBANG, SUMATERA SELATAN",34,74,104,178
https://kawalpemilu.org#18907,"MUARA KATI LAMA, TIANG PUMPUNG KEPUNGUT, MUSI RAWAS, SUMATERA SELATAN",3,29,124,153
https://kawalpemilu.org#20681,"TABA JEMEKEH, LUBUK LINGGAU TIMUR I, KOTA LUBUKLINGGAU, SUMATERA SELATAN",20,99,154,253
https://kawalpemilu.org#19667,"SUKA NEGARA, BELITANG III, OGAN KOMERING ULU TIMUR, SUMATERA SELATAN",5,149,87,236
https://kawalpemilu.org#17892,"PANCAWARNA, PEDAMARAN TIMUR, OGAN KOMERING ILIR, SUMATERA SELATAN",7,76,137,213
https://kawalpemilu.org#20188,"SUNGAI BUAYA, PEMULUTAN, OGAN ILIR, SUMATERA SELATAN",2,131,78,209
https://kawalpemilu.org#18505,"SUKA RAME, KIKIM BARAT, LAHAT, SUMATERA SELATAN",1,51,201,252
https://kawalpemilu.org#17481,"KEMALARAJA, BATURAJA TIMUR, OGAN KOMERING ULU, SUMATERA SELATAN",24,28,121,149
https://kawalpemilu.org#18784,"AIR LESING, MUARA BELITI, MUSI RAWAS, SUMATERA SELATAN",1,60,114,174
https://kawalpemilu.org#19226,"KEDONDONG RAYE, BANYUASIN III, BANYUASIN, SUMATERA SELATAN",18,66,108,174
https://kawalpemilu.org#18894,"BIARO BARU, KARANG DAPO, MUSI RAWAS UTARA, SUMATERA SELATAN",8,52,87,139
https://kawalpemilu.org#17615,"JAYA BAKTI, MESUJI, OGAN KOMERING ILIR, SUMATERA SELATAN",2,72,123,195
https://kawalpemilu.org#17612,"SURYA ADI, MESUJI, OGAN KOMERING ILIR, SUMATERA SELATAN",10,39,94,133
https://kawalpemilu.org#18349,"BANDAR AGUNG, LAHAT, LAHAT, SUMATERA SELATAN",14,28,201,229
https://kawalpemilu.org#20546,"BUKIT BARU, ILIR BARAT I, KOTA PALEMBANG, SUMATERA SELATAN",9,32,117,149
https://kawalpemilu.org#19084,"TANJUNG DALAM, KELUANG, MUSI BANYUASIN, SUMATERA SELATAN",2,51,139,190
https://kawalpemilu.org#20409,"LB. PUDING BARU, ULU MUSI, EMPAT LAWANG, SUMATERA SELATAN",2,26,89,115
https://kawalpemilu.org#19546,"GEDUNG REJO, BELITANG, OGAN KOMERING ULU TIMUR, SUMATERA SELATAN",2,101,127,228
https://kawalpemilu.org#17728,"TUGU JAYA, LEMPUING, OGAN KOMERING ILIR, SUMATERA SELATAN",4,167,94,261
https://kawalpemilu.org#20799,"TANJUNG RAMAN, PRABUMULIH SELATAN, KOTA PRABUMULIH, SUMATERA SELATAN",2,50,124,174
https://kawalpemilu.org#19251,"TERENTANG, BANYUASIN III, BANYUASIN, SUMATERA SELATAN",1,69,152,221
https://kawalpemilu.org#19570,"PULAU NEGARA, BUAY PEMUKA PELIUNG, OGAN KOMERING ULU TIMUR, SUMATERA SELATAN",7,107,132,239
https://kawalpemilu.org#18091,"TANAH ABANG UTARA, TANAH ABANG, PENUKAL ABAB LEMATANG ILIR, SUMATERA SELATAN",3,31,131,162
https://kawalpemilu.org#20602,"24 ILIR, BUKIT KECIL, KOTA PALEMBANG, SUMATERA SELATAN",48,28,52,80
https://kawalpemilu.org#9968,"LINGGA RAJA II, PEGAGAN HILIR, DAIRI, SUMATERA UTARA",4,279,2,281
https://kawalpemilu.org#12028,"SIRANTAU, DATUK BANDAR, KOTA TANJUNG BALAI, SUMATERA UTARA",15,43,83,126
https://kawalpemilu.org#12782,"UJUNG BATU III, HUTA RAJA TINGGI, PADANG LAWAS, SUMATERA UTARA",6,141,77,218
https://kawalpemilu.org#11927,"PROKLAMASI, SIANTAR BARAT, KOTA PEMATANGSIANTAR, SUMATERA UTARA",1,182,35,217
https://kawalpemilu.org#12360,"BORGOT TOPONG JULU, HALONGONAN, PADANG LAWAS UTARA, SUMATERA UTARA",2,26,122,148
https://kawalpemilu.org#9589,"SEI NADORAS, BANDAR PASIR MANDOGE, ASAHAN, SUMATERA UTARA",8,84,12,96
https://kawalpemilu.org#9679,"TELADAN, TINGGI RAJA, ASAHAN, SUMATERA UTARA",5,82,78,160
https://kawalpemilu.org#7796,"PASAR SIPAGIMBAR, SAIPAR DOLOK HOLE, TAPANULI SELATAN, SUMATERA UTARA",1,54,105,159
https://kawalpemilu.org#6750,"KAMPUNG PERLABIAN, KAMPUNG RAKYAT, LABUHANBATU SELATAN, SUMATERA UTARA",24,54,86,140
https://kawalpemilu.org#8231,"SELOTONG, SECANGGANG, LANGKAT, SUMATERA UTARA",11,37,159,196
https://kawalpemilu.org#9740,"BAKARAN BATU, RANTAU SELATAN, LABUHANBATU, SUMATERA UTARA",3,33,205,238
https://kawalpemilu.org#11620,"UJUNG NEGERI KAHAN, BINTANG BAYU, SERDANG BEDAGAI, SUMATERA UTARA",3,75,75,150
https://kawalpemilu.org#11991,"AEK HABIL, SIBOLGA SELATAN, KOTA SIBOLGA, SUMATERA UTARA",4,40,174,214
https://kawalpemilu.org#9986,"KENTARA, LAE PARIRA, DAIRI, SUMATERA UTARA",5,150,7,157
https://kawalpemilu.org#12591,"UJUNG GADING JULU, SIMANGAMBAT, PADANG LAWAS UTARA, SUMATERA UTARA",3,122,100,222
https://kawalpemilu.org#11736,"SEI BALAI, SEI BALAI, BATU BARA, SUMATERA UTARA",5,79,133,212
https://kawalpemilu.org#6830,"MARBAU, MARBAU, LABUHANBATU UTARA, SUMATERA UTARA",4,53,101,154
https://kawalpemilu.org#10459,"AEK NANGALI, BATANG NATAL, MANDAILING NATAL, SUMATERA UTARA",4,15,160,175
https://kawalpemilu.org#11572,"PAYA BAGAS, TEBING TINGGI, SERDANG BEDAGAI, SUMATERA UTARA",6,97,36,133
https://kawalpemilu.org#8965,"PATUMBAK KAMPUNG, PATUMBAK, DELI SERDANG, SUMATERA UTARA",41,54,80,134
https://kawalpemilu.org#6732,"SIMATAHARI, KOTAPINANG, LABUHANBATU SELATAN, SUMATERA UTARA",9,36,87,123
https://kawalpemilu.org#10648,"AMOROSA, ULUNOYO, NIAS SELATAN, SUMATERA UTARA",1,219,0,219
https://kawalpemilu.org#11362,"DOSROHA, SIMANINDO, SAMOSIR, SUMATERA UTARA",3,193,1,194
https://kawalpemilu.org#8170,"SAMBI REJO, BINJAI, LANGKAT, SUMATERA UTARA",13,71,144,215
https://kawalpemilu.org#8448,"SEMANGAT, BARUSJAHE, KARO, SUMATERA UTARA",2,172,7,179
https://kawalpemilu.org#10842,"HILISALO'O, AMANDRAYA, NIAS SELATAN, SUMATERA UTARA",1,133,11,144
https://kawalpemilu.org#11854,"SIDOREJO, MEDAN TEMBUNG, KOTA MEDAN, SUMATERA UTARA",14,131,86,217
https://kawalpemilu.org#10388,"TAMBANG BUSTAK, KOTANOPAN, MANDAILING NATAL, SUMATERA UTARA",2,39,137,176
https://kawalpemilu.org#9849,"PAGAGAN JULU I, SUMBUL, DAIRI, SUMATERA UTARA",8,163,5,168
https://kawalpemilu.org#8967,"DELI TUA, DELI TUA, DELI SERDANG, SUMATERA UTARA",8,50,94,144
https://kawalpemilu.org#9731,"SIRANDORUNG, RANTAU UTARA, LABUHANBATU, SUMATERA UTARA",20,50,127,177
https://kawalpemilu.org#7147,"MUDIK, GUNUNGSITOLI, KOTA GUNUNGSITOLI, SUMATERA UTARA",4,83,132,215
https://kawalpemilu.org#90109,"MOMBAWA OLADANO, HURUNA, NIAS SELATAN, SUMATERA UTARA",1,178,4,182
https://kawalpemilu.org#7756,"BUNGA BONDAR, SIPIROK, TAPANULI SELATAN, SUMATERA UTARA",1,69,116,185
https://kawalpemilu.org#11273,"TAMBA DOLOK, SITIO-TIO, SAMOSIR, SUMATERA UTARA",2,235,6,241
https://kawalpemilu.org#11596,"BAKARAN BATU, SEI BAMBAN, SERDANG BEDAGAI, SUMATERA UTARA",2,126,2,128
https://kawalpemilu.org#11396,"CITAMAN JERNIH, PERBAUNGAN, SERDANG BEDAGAI, SUMATERA UTARA",10,63,126,189
https://kawalpemilu.org#10691,"SINAR HELAOWO, BORONADU, NIAS SELATAN, SUMATERA UTARA",2,160,4,164
https://kawalpemilu.org#12261,"BINTAIS JULU, DOLOK, PADANG LAWAS UTARA, SUMATERA UTARA",1,20,164,184
https://kawalpemilu.org#8319,"SEI MERAN, PANGKALAN SUSU, LANGKAT, SUMATERA UTARA",5,67,80,147
https://kawalpemilu.org#11966,"BAH KAPUL, SIANTAR SITALASARI, KOTA PEMATANGSIANTAR, SUMATERA UTARA",6,123,94,217
https://kawalpemilu.org#8782,"HULU, PANCUR BATU, DELI SERDANG, SUMATERA UTARA",9,207,18,225
https://kawalpemilu.org#11376,"PANTAI CERMIN KANAN, PANTAI CERMIN, SERDANG BEDAGAI, SUMATERA UTARA",4,70,88,158
https://kawalpemilu.org#9022,"SAMBIREJO TIMUR, PERCUT SEI TUAN, DELI SERDANG, SUMATERA UTARA",60,65,109,174
https://kawalpemilu.org#12837,"PAGUR SATIO, BARUMUN SELATAN, PADANG LAWAS, SUMATERA UTARA",1,32,140,172
https://kawalpemilu.org#11163,"PASAR DOLOKSANGGUL, DOLOK SANGGUL, HUMBANG HASUNDUTAN, SUMATERA UTARA",9,130,7,137
https://kawalpemilu.org#12575,"AEK RARU, SIMANGAMBAT, PADANG LAWAS UTARA, SUMATERA UTARA",17,240,0,240
https://kawalpemilu.org#6878,"SIAMPORIK, KUALUH SELATAN, LABUHANBATU UTARA, SUMATERA UTARA",10,39,88,127
https://kawalpemilu.org#8309,"PELAWI SELATAN, BABALAN, LANGKAT, SUMATERA UTARA",22,12,85,97
https://kawalpemilu.org#6763,"AEK BATU, TORGAMBA, LABUHANBATU SELATAN, SUMATERA UTARA",28,184,66,250
https://kawalpemilu.org#7084,"LAKHENE, MANDREHE, NIAS BARAT, SUMATERA UTARA",3,109,8,117
https://kawalpemilu.org#11738,"PERKEBUNAN SEI BALAI, SEI BALAI, BATU BARA, SUMATERA UTARA",3,115,52,167
https://kawalpemilu.org#11573,"PAYA MABAR, TEBING TINGGI, SERDANG BEDAGAI, SUMATERA UTARA",5,137,40,177
https://kawalpemilu.org#8598,"BATU KARANG, PAYUNG, KARO, SUMATERA UTARA",5,203,7,210
https://kawalpemilu.org#12068,"MENCIRIM, BINJAI TIMUR, KOTA BINJAI, SUMATERA UTARA",15,93,158,251
https://kawalpemilu.org#8827,"SUDI REJO, NAMORAMBE, DELI SERDANG, SUMATERA UTARA",1,66,94,160
https://kawalpemilu.org#6865,"ROMBISAN, AEK NATAS, LABUHANBATU UTARA, SUMATERA UTARA",4,60,141,201
https://kawalpemilu.org#11939,"KAHEAN, SIANTAR UTARA, KOTA PEMATANGSIANTAR, SUMATERA UTARA",5,191,6,197
https://kawalpemilu.org#9111,"KARANG ANYAR, BERINGIN, DELI SERDANG, SUMATERA UTARA",20,91,130,221
https://kawalpemilu.org#9636,"MARJANJI ACEH, AEK SONGSONGAN, ASAHAN, SUMATERA UTARA",8,93,52,145
https://kawalpemilu.org#8441,"BARUSJAHE, BARUSJAHE, KARO, SUMATERA UTARA",4,146,2,148
https://kawalpemilu.org#11807,"BELAWAN BAHARI, MEDAN BELAWAN, KOTA MEDAN, SUMATERA UTARA",22,132,50,3
https://kawalpemilu.org#10014,"PAROPO I, SILAHISABUNGAN, DAIRI, SUMATERA UTARA",1,184,4,188
https://kawalpemilu.org#90380,"SITAMPA, BATANG ANGKOLA, TAPANULI SELATAN, SUMATERA UTARA",2,10,182,192
https://kawalpemilu.org#11396,"CITAMAN JERNIH, PERBAUNGAN, SERDANG BEDAGAI, SUMATERA UTARA",16,72,68,140
https://kawalpemilu.org#8275,"TANJUNG SELAMAT, PADANG TUALANG, LANGKAT, SUMATERA UTARA",6,62,169,231
https://kawalpemilu.org#9209,"SEI MANGKEI, BOSAR MALIGAS, SIMALUNGUN, SUMATERA UTARA",4,147,103,250
https://kawalpemilu.org#12782,"UJUNG BATU III, HUTA RAJA TINGGI, PADANG LAWAS, SUMATERA UTARA",5,161,54,215
https://kawalpemilu.org#9008,"KOTA RANTANG, HAMPARAN PERAK, DELI SERDANG, SUMATERA UTARA",17,96,121,217
https://kawalpemilu.org#11752,"TELADAN TIMUR, MEDAN KOTA, KOTA MEDAN, SUMATERA UTARA",8,85,82,167
https://kawalpemilu.org#929262,"BINJOHARA URUK, MANDUAMAS, TAPANULI TENGAH, SUMATERA UTARA",2,107,31,138
https://kawalpemilu.org#7852,"HURASE, BATANG ANGKOLA, TAPANULI SELATAN, SUMATERA UTARA",1,191,18,209
https://kawalpemilu.org#8221,"HINAI KIRI, SECANGGANG, LANGKAT, SUMATERA UTARA",2,66,142,208
https://kawalpemilu.org#11802,"MANGGA, MEDAN TUNTUNGAN, KOTA MEDAN, SUMATERA UTARA",1,167,2,169
https://kawalpemilu.org#8724,"PERDAMEAN, TANJUNG MORAWA, DELI SERDANG, SUMATERA UTARA",2,192,4,196
https://kawalpemilu.org#9521,"SEI APUNG, TANJUNG BALAI, ASAHAN, SUMATERA UTARA",1,25,152,177
https://kawalpemilu.org#7273,"AEK TOLANG, PANDAN, TAPANULI TENGAH, SUMATERA UTARA",1,167,34,201
https://kawalpemilu.org#10416,"PASTAP JULU, TAMBANGAN, MANDAILING NATAL, SUMATERA UTARA",2,30,107,137
https://kawalpemilu.org#9775,"LINGGA TIGA, BILAH HULU, LABUHANBATU, SUMATERA UTARA",10,29,126,155
https://kawalpemilu.org#9696,"RAWANG PASAR IV, RAWANG PANCA ARGA, ASAHAN, SUMATERA UTARA",5,82,116,198
https://kawalpemilu.org#7083,"LOLOZIRUGI, MANDREHE, NIAS BARAT, SUMATERA UTARA",5,74,2,76
https://kawalpemilu.org#9055,"CEMARA, LUBUK PAKAM, DELI SERDANG, SUMATERA UTARA",15,234,2,236
https://kawalpemilu.org#11833,"TITI KUNING, MEDAN JOHOR, KOTA MEDAN, SUMATERA UTARA",74,99,62,161
https://kawalpemilu.org#10030,"HINALANG BAGASAN, BALIGE, TOBA SAMOSIR, SUMATERA UTARA",6,222,3,225
https://kawalpemilu.org#7745,"HUTA GINJANG, ANGKOLA TIMUR, TAPANULI SELATAN, SUMATERA UTARA",1,54,190,244
https://kawalpemilu.org#7708,"SITARATOIT, ANGKOLA BARAT, TAPANULI SELATAN, SUMATERA UTARA",1,31,184,215
https://kawalpemilu.org#9560,"PERSATUAN, PULAU RAKYAT, ASAHAN, SUMATERA UTARA",2,54,70,124
https://kawalpemilu.org#11900,"DURIAN, MEDAN TIMUR, KOTA MEDAN, SUMATERA UTARA",22,166,23,189
https://kawalpemilu.org#9816,"TELAGA SUKA, PANAI TENGAH, LABUHANBATU, SUMATERA UTARA",3,24,129,153
https://kawalpemilu.org#11251,"HASINGGAAN, SIANJUR MULA MULA, SAMOSIR, SUMATERA UTARA",2,101,4,105
https://kawalpemilu.org#12019,"SEI RAJA, SEI TUALANG RASO, KOTA TANJUNG BALAI, SUMATERA UTARA",2,51,98,149
https://kawalpemilu.org#9732,"RANTAUPRAPAT, RANTAU UTARA, LABUHANBATU, SUMATERA UTARA",9,221,23,244
https://kawalpemilu.org#9037,"BANDAR SETIA, PERCUT SEI TUAN, DELI SERDANG, SUMATERA UTARA",43,50,85,135
https://kawalpemilu.org#11788,"TANJUNG MULIA HILIR, MEDAN DELI, KOTA MEDAN, SUMATERA UTARA",2,55,28,83
https://kawalpemilu.org#9748,"SIDOREJO, RANTAU SELATAN, LABUHANBATU, SUMATERA UTARA",3,81,155,236
https://kawalpemilu.org#11569,"PERTAPAAN, TEBING TINGGI, SERDANG BEDAGAI, SUMATERA UTARA",3,158,20,178
https://kawalpemilu.org#11802,"MANGGA, MEDAN TUNTUNGAN, KOTA MEDAN, SUMATERA UTARA",67,115,45,160
https://kawalpemilu.org#9019,"KENANGAN, PERCUT SEI TUAN, DELI SERDANG, SUMATERA UTARA",8,76,117,193
https://kawalpemilu.org#11785,"KARANG BEROMBAK, MEDAN BARAT, KOTA MEDAN, SUMATERA UTARA",48,69,132,201
https://kawalpemilu.org#12430,"PURBA SINOMBA, PADANG BOLAK, PADANG LAWAS UTARA, SUMATERA UTARA",3,11,159,170
https://kawalpemilu.org#9001,"SIALANG MUDA, HAMPARAN PERAK, DELI SERDANG, SUMATERA UTARA",3,42,186,228
https://kawalpemilu.org#8144,"NAMO MBELIN, KUALA, LANGKAT, SUMATERA UTARA",3,188,73,261
https://kawalpemilu.org#7351,"BINASI, SORKAM BARAT, TAPANULI TENGAH, SUMATERA UTARA",2,61,106,167
https://kawalpemilu.org#6801,"SONOMARTANI, KUALUH HULU, LABUHANBATU UTARA, SUMATERA UTARA",14,82,62,144
https://kawalpemilu.org#7460,"SIMAMORA, TARUTUNG, TAPANULI UTARA, SUMATERA UTARA",5,149,7,156
