Link KawalPemilu,Nama Kelurahan,Nomor TPS,Suara 01,Suara 02,Suara Sah
https://kawalpemilu.org#5890,"PERUPUK, BANDAR PUSAKA, ACEH TAMIANG, ACEH",2,11,131,142
https://kawalpemilu.org#6418,"LAMDINGIN, KUTA ALAM, KOTA BANDA ACEH, ACEH",5,20,166,186
https://kawalpemilu.org#5747,"BALAI, BENDAHARA, ACEH TAMIANG, ACEH",3,5,146,151
https://kawalpemilu.org#4996,"COT JEURAT, BLANG PIDIE, ACEH BARAT DAYA, ACEH",1,3,174,177
https://kawalpemilu.org#1001,"ULEE ATEUNG, MADAT, ACEH TIMUR, ACEH",2,12,149,161
https://kawalpemilu.org#725,"SEUNEUBOK BARO, JULOK, ACEH TIMUR, ACEH",2,2,66,68
https://kawalpemilu.org#1210,"GELAMPANG GADING, LINGE, ACEH TENGAH, ACEH",1,77,121,198
https://kawalpemilu.org#4621,"LEUBU ME, MAKMUR, BIREUEN, ACEH",1,18,192,210
https://kawalpemilu.org#4869,"LHOK AWE TEUNGOH, KOTA JUANG, BIREUEN, ACEH",2,6,193,199
https://kawalpemilu.org#1514,"SUAK SIGADENG, JOHAN PAHWALAN, ACEH BARAT, ACEH",2,23,132,155
https://kawalpemilu.org#5885,"BLANG KANDIS, BANDAR PUSAKA, ACEH TAMIANG, ACEH",2,20,111,131
https://kawalpemilu.org#6644,"KARANG ANYAR, LANGSA BARO, KOTA LANGSA, ACEH",8,36,215,251
https://kawalpemilu.org#3772,"MATANG SANTOT, TANAH JAMBO AYE, ACEH UTARA, ACEH",106,14,146,160
https://kawalpemilu.org#88088,"LENGKONG, LANGSA BARO, KOTA LANGSA, ACEH",5,13,250,263
https://kawalpemilu.org#5462,"PANTON KABU, PANGA, ACEH JAYA, ACEH",1,15,49,64
https://kawalpemilu.org#88077,"MEURANDEH DAYAH, LANGSA LAMA, KOTA LANGSA, ACEH",1,26,231,257
https://kawalpemilu.org#3911,"RUMOH RAYEUK, LANGKAHAN, ACEH UTARA, ACEH",48,30,154,184
https://kawalpemilu.org#6551,"ULEE JALAN, BANDA SAKTI, KOTA LHOKSEUMAWE, ACEH",4,35,174,209
https://kawalpemilu.org#307,"SUKA DAMAI, LAWE SIGALA-GALA, ACEH TENGGARA, ACEH",1,18,171,189
https://kawalpemilu.org#5192,"BUKUT, TERANGUN, GAYO LUES, ACEH",2,31,71,102
https://kawalpemilu.org#2721,"MESJID YAMAN, MUTIARA, PIDIE, ACEH",1,6,210,216
https://kawalpemilu.org#6242,"REULUI MANGAT, JANGKA BUYA, PIDIE JAYA, ACEH",1,6,175,181
https://kawalpemilu.org#1360,"PANANGAN MATA, PEGASING, ACEH TENGAH, ACEH",1,86,55,141
https://kawalpemilu.org#6401,"SUKARAMAI, BAITURRAHMAN, KOTA BANDA ACEH, ACEH",10,75,167,242
https://kawalpemilu.org#2875,"TUMPOK LAWEUNG, PIDIE, PIDIE, ACEH",1,13,184,197
https://kawalpemilu.org#6245,"JURONG TEUNGOH, JANGKA BUYA, PIDIE JAYA, ACEH",3,25,190,215
https://kawalpemilu.org#1032,"JAMBO LUBOK, INDRA MAKMU, ACEH TIMUR, ACEH",1,10,135,145
https://kawalpemilu.org#4121,"TAMON JAYA, SALANG, SIMEULUE, ACEH",2,42,95,137
https://kawalpemilu.org#3809,"LHOK KUYUN, SAWANG, ACEH UTARA, ACEH",30,1,135,136
https://kawalpemilu.org#1009,"PAYA DEMAM PEUT, MADAT, ACEH TIMUR, ACEH",1,28,120,148
https://kawalpemilu.org#4487,"KARIENG, PEUDADA, BIREUEN, ACEH",1,19,160,179
https://kawalpemilu.org#6665,"PENANGGALAN, PENANGGALAN, KOTA SUBULUSSALAM, ACEH",1,30,143,173
https://kawalpemilu.org#6428,"LAMPASEH ACEH, MEURAXA, KOTA BANDA ACEH, ACEH",2,35,209,244
https://kawalpemilu.org#5057,"PADANG BARU, SUSOH, ACEH BARAT DAYA, ACEH",6,23,183,206
https://kawalpemilu.org#88080,"ALUE PINEUNG TIMUE, LANGSA TIMUR, KOTA LANGSA, ACEH",1,21,163,184
https://kawalpemilu.org#4416,"DAYAH BARO, JEUNIEB, BIREUEN, ACEH",1,9,171,180
https://kawalpemilu.org#1090,"PAYA DUA, PEUDAWA, ACEH TIMUR, ACEH",1,31,170,201
https://kawalpemilu.org#84186,"BUKET KEUMUNENG, PASIE RAYA, ACEH JAYA, ACEH",1,24,63,87
https://kawalpemilu.org#2890,"KAMPONG BARAT, PIDIE, PIDIE, ACEH",1,8,145,153
https://kawalpemilu.org#1339,"KUNG, PEGASING, ACEH TENGAH, ACEH",1,91,150,241
https://kawalpemilu.org#260,"LADANG RIMBA, TRUMON TENGAH, ACEH SELATAN, ACEH",4,44,188,232
https://kawalpemilu.org#4934,"PULO PANYANG, PEUSANGAN SELATAN, BIREUEN, ACEH",1,12,168,180
https://kawalpemilu.org#902,"PAYA MEULIGOU, PEUREULAK, ACEH TIMUR, ACEH",1,18,139,157
https://kawalpemilu.org#53431,"PUJUNGAN, PUPUAN, TABANAN, BALI",3,208,4,212
https://kawalpemilu.org#53871,"KAYUPUTIH, BANJAR, BULELENG, BALI",9,208,17,225
https://kawalpemilu.org#53792,"BUNGAYA KANGIN, BEBANDEM, KARANGASEM, BALI",19,32,140,172
https://kawalpemilu.org#53812,"BATURINGGIT, KUBU, KARANGASEM, BALI",15,246,6,252
https://kawalpemilu.org#53997,"PADANGSAMBIAN KELOD, DENPASAR BARAT, KOTA DENPASAR, BALI",4,163,22,185
https://kawalpemilu.org#53603,"BUNGA MEKAR, NUSA PENIDA, KLUNGKUNG, BALI",11,168,3,171
https://kawalpemilu.org#53588,"SAKTI, NUSA PENIDA, KLUNGKUNG, BALI",6,141,21,135
https://kawalpemilu.org#53475,"ABIANSEMAL, ABIANSEMAL, BADUNG, BALI",4,265,6,271
https://kawalpemilu.org#53632,"AKAH, KLUNGKUNG, KLUNGKUNG, BALI",6,186,9,195
https://kawalpemilu.org#53316,"MEGATI, SELEMADEG TIMUR, TABANAN, BALI",5,237,1,238
https://kawalpemilu.org#53456,"SEMBUNG, MENGWI, BADUNG, BALI",7,193,5,198
https://kawalpemilu.org#53558,"PEJENG KELOD, TAMPAKSIRING, GIANYAR, BALI",8,128,4,132
https://kawalpemilu.org#53749,"ULAKAN, MANGGIS, KARANGASEM, BALI",3,185,5,190
https://kawalpemilu.org#53861,"KEDIS, BUSUNG BIU, BULELENG, BALI",7,175,12,187
https://kawalpemilu.org#53669,"PENGOTAN, BANGLI, BANGLI, BALI",15,133,10,143
https://kawalpemilu.org#53554,"MANUKAYA, TAMPAKSIRING, GIANYAR, BALI",29,211,3,214
https://kawalpemilu.org#53915,"KALIUNTU, BULELENG, BULELENG, BALI",7,144,4,148
https://kawalpemilu.org#53998,"PEMECUTAN KELOD, DENPASAR BARAT, KOTA DENPASAR, BALI",17,204,37,241
https://kawalpemilu.org#54017,"PEMECUTAN KAJA, DENPASAR UTARA, KOTA DENPASAR, BALI",68,238,3,241
https://kawalpemilu.org#53368,"KABA KABA, KEDIRI, TABANAN, BALI",10,190,0,190
https://kawalpemilu.org#53664,"CEMPAGA, BANGLI, BANGLI, BALI",15,160,8,168
https://kawalpemilu.org#53282,"NUSASARI, MELAYA, JEMBRANA, BALI",5,207,14,221
https://kawalpemilu.org#53468,"DARMASABA, ABIANSEMAL, BADUNG, BALI",2,282,2,284
https://kawalpemilu.org#54004,"TEGAL HARUM, DENPASAR BARAT, KOTA DENPASAR, BALI",32,191,36,227
https://kawalpemilu.org#53291,"DAUHWARU, JEMBRANA, JEMBRANA, BALI",2,242,2,244
https://kawalpemilu.org#53323,"MUNDEH, SELEMADEG BARAT, TABANAN, BALI",10,130,4,134
https://kawalpemilu.org#53434,"PADANGAN, PUPUAN, TABANAN, BALI",8,226,0,226
https://kawalpemilu.org#53992,"KESIMAN KERTALANGU, DENPASAR TIMUR, KOTA DENPASAR, BALI",18,187,7,194
https://kawalpemilu.org#53647,"PIKAT, DAWAN, KLUNGKUNG, BALI",11,175,5,180
https://kawalpemilu.org#53910,"BANYUNING, BULELENG, BULELENG, BALI",6,166,10,176
https://kawalpemilu.org#53898,"PANJI ANOM, SUKASADA, BULELENG, BALI",5,190,7,197
https://kawalpemilu.org#52965,"PAJANG, BENDA, KOTA TANGERANG, BANTEN",27,51,97,148
https://kawalpemilu.org#51608,"CIBALIUNG, CIBALIUNG, PANDEGLANG, BANTEN",9,87,84,171
https://kawalpemilu.org#53181,"CIATER, SERPONG, KOTA TANGERANG SELATAN, BANTEN",42,60,84,144
https://kawalpemilu.org#52284,"CIKARET, CIGEMLONG, LEBAK, BANTEN",4,47,143,190
https://kawalpemilu.org#52983,"PARUNG SERAB, CILEDUG, KOTA TANGERANG, BANTEN",33,83,144,227
https://kawalpemilu.org#52567,"SOLEAR, SOLEAR, TANGERANG, BANTEN",20,63,127,190
https://kawalpemilu.org#53232,"BAMBU APUS, PAMULANG, KOTA TANGERANG SELATAN, BANTEN",68,59,136,195
https://kawalpemilu.org#52950,"GANDASARI, JATIUWUNG, KOTA TANGERANG, BANTEN",40,63,129,192
https://kawalpemilu.org#53223,"REMPOA, CIPUTAT TIMUR, KOTA TANGERANG SELATAN, BANTEN",64,114,72,186
https://kawalpemilu.org#53228,"PONDOK BENDA, PAMULANG, KOTA TANGERANG SELATAN, BANTEN",104,123,106,229
https://kawalpemilu.org#51745,"JIPUT, JIPUT, PANDEGLANG, BANTEN",14,140,112,252
https://kawalpemilu.org#53172,"CILOWONG, TAKTAKAN, KOTA SERANG, BANTEN",11,28,86,114
https://kawalpemilu.org#52390,"BUARAN JATI, SUKADIRI, TANGERANG, BANTEN",13,63,166,229
https://kawalpemilu.org#52998,"PABUARAN TUMPENG, KARAWACI, KOTA TANGERANG, BANTEN",22,70,134,204
https://kawalpemilu.org#53049,"KREO, LARANGAN, KOTA TANGERANG, BANTEN",12,118,118,236
https://kawalpemilu.org#53195,"PONDOK JAGUNG TIMUR, SERPONG UTARA, KOTA TANGERANG SELATAN, BANTEN",37,126,83,209
https://kawalpemilu.org#52761,"CIRANGKONG, PETIR, SERANG, BANTEN",11,111,103,214
https://kawalpemilu.org#52567,"SOLEAR, SOLEAR, TANGERANG, BANTEN",21,72,124,196
https://kawalpemilu.org#53051,"GAGA, LARANGAN, KOTA TANGERANG, BANTEN",20,79,121,200
https://kawalpemilu.org#52917,"LABUAN, MANCAK, SERANG, BANTEN",7,18,183,201
https://kawalpemilu.org#52981,"SUDIMARA TIMUR, CILEDUG, KOTA TANGERANG, BANTEN",33,66,88,154
https://kawalpemilu.org#52657,"RANJENG, CIRUAS, SERANG, BANTEN",10,68,123,191
https://kawalpemilu.org#52612,"TALAGA LUHUR, WARINGINKURUNG, SERANG, BANTEN",4,56,114,170
https://kawalpemilu.org#53221,"PISANGAN, CIPUTAT TIMUR, KOTA TANGERANG SELATAN, BANTEN",57,99,135,234
https://kawalpemilu.org#52837,"BOJOT, JAWILAN, SERANG, BANTEN",12,43,181,224
https://kawalpemilu.org#53216,"JOMBANG, CIPUTAT, KOTA TANGERANG SELATAN, BANTEN",34,146,120,266
https://kawalpemilu.org#51765,"CIKUMBUEN, MANDALAWANGI, PANDEGLANG, BANTEN",7,45,81,126
https://kawalpemilu.org#53167,"TAKTAKAN, TAKTAKAN, KOTA SERANG, BANTEN",13,42,188,230
https://kawalpemilu.org#53116,"LONTAR BARU, SERANG, KOTA SERANG, BANTEN",8,103,145,248
https://kawalpemilu.org#52968,"CIPONDOH, CIPONDOH, KOTA TANGERANG, BANTEN",34,87,90,177
https://kawalpemilu.org#51760,"NEMBOL, MANDALAWANGI, PANDEGLANG, BANTEN",12,44,91,135
https://kawalpemilu.org#52962,"BELENDUNG, BENDA, KOTA TANGERANG, BANTEN",18,25,136,161
https://kawalpemilu.org#84976,"KARANGSETRA, KORONCONG, PANDEGLANG, BANTEN",4,22,148,170
https://kawalpemilu.org#53093,"KOTABUMI, PURWAKARTA, KOTA CILEGON, BANTEN",19,53,178,231
https://kawalpemilu.org#51828,"KADURONYOK, CISATA, PANDEGLANG, BANTEN",3,24,198,222
https://kawalpemilu.org#52962,"BELENDUNG, BENDA, KOTA TANGERANG, BANTEN",79,179,34,213
https://kawalpemilu.org#53227,"BENDA BARU, PAMULANG, KOTA TANGERANG SELATAN, BANTEN",27,97,119,216
https://kawalpemilu.org#52467,"PISANGAN JAYA, SEPATAN, TANGERANG, BANTEN",5,119,136,255
https://kawalpemilu.org#53066,"KETILENG, CILEGON, KOTA CILEGON, BANTEN",5,103,103,206
https://kawalpemilu.org#51812,"PANDEGLANG, PANDEGLANG, PANDEGLANG, BANTEN",22,52,152,204
https://kawalpemilu.org#53015,"UWUNG JAYA, CIBODAS, KOTA TANGERANG, BANTEN",50,37,91,128
https://kawalpemilu.org#52055,"TAMBAK, CIMARGA, LEBAK, BANTEN",1,47,132,179
https://kawalpemilu.org#52396,"GINTUNG, SUKADIRI, TANGERANG, BANTEN",2,36,141,177
https://kawalpemilu.org#52270,"KADUDAMAS, CIRINTEN, LEBAK, BANTEN",2,53,120,173
https://kawalpemilu.org#52827,"NANGGUNG, KOPO, SERANG, BANTEN",14,41,182,223
https://kawalpemilu.org#53156,"SUKAJAYA, CURUG, KOTA SERANG, BANTEN",11,24,138,162
https://kawalpemilu.org#52282,"CIGEMBLONG, CIGEMLONG, LEBAK, BANTEN",6,68,137,205
https://kawalpemilu.org#52945,"BABAKAN, TANGERANG, KOTA TANGERANG, BANTEN",21,113,90,203
https://kawalpemilu.org#52866,"PADARINCANG, PADARINCANG, SERANG, BANTEN",4,73,137,210
https://kawalpemilu.org#51797,"CITALAHAB, BANJAR, PANDEGLANG, BANTEN",8,76,113,189
https://kawalpemilu.org#53088,"GROGOL, GEROGOL, KOTA CILEGON, BANTEN",4,41,176,217
https://kawalpemilu.org#52757,"SUKAMAMPIR, BINUANG, SERANG, BANTEN",10,63,171,234
https://kawalpemilu.org#53236,"SETU, SETU, KOTA TANGERANG SELATAN, BANTEN",25,74,126,200
https://kawalpemilu.org#52479,"SUKAMULYA, CIKUPA, TANGERANG, BANTEN",48,112,128,240
https://kawalpemilu.org#51676,"MARGAGIRI, PAGELARAN, PANDEGLANG, BANTEN",11,61,95,156
https://kawalpemilu.org#52146,"CIGOONG UTARA, CIKULUR, LEBAK, BANTEN",2,49,197,246
https://kawalpemilu.org#51655,"SUKASABA, MUNJUL, PANDEGLANG, BANTEN",4,33,181,214
https://kawalpemilu.org#52544,"BENCONGAN, KELAPA DUA, TANGERANG, BANTEN",89,76,101,177
https://kawalpemilu.org#53220,"PONDOK RANJI, CIPUTAT TIMUR, KOTA TANGERANG SELATAN, BANTEN",44,96,90,186
https://kawalpemilu.org#53204,"PONDOK KACANG BARAT, PONDOK AREN, KOTA TANGERANG SELATAN, BANTEN",7,91,105,196
https://kawalpemilu.org#52500,"CIAKAR, PANONGAN, TANGERANG, BANTEN",8,124,118,242
https://kawalpemilu.org#53023,"KARANG ANYAR, NEGLASARI, KOTA TANGERANG, BANTEN",25,85,145,230
https://kawalpemilu.org#53162,"BANJAR SARI, CIPOCOK JAYA, KOTA SERANG, BANTEN",56,63,140,203
https://kawalpemilu.org#53194,"PONDOK JAGUNG, SERPONG UTARA, KOTA TANGERANG SELATAN, BANTEN",37,162,20,182
https://kawalpemilu.org#52468,"MEKAR JAYA, SEPATAN, TANGERANG, BANTEN",7,46,187,233
https://kawalpemilu.org#51581,"SUMBERJAYA, SUMUR, PANDEGLANG, BANTEN",1,27,131,158
https://kawalpemilu.org#52030,"GUNUNGSARI, BANJARSARI, LEBAK, BANTEN",6,54,110,164
https://kawalpemilu.org#52940,"TANAH TINGGI, TANGERANG, KOTA TANGERANG, BANTEN",3,88,88,176
https://kawalpemilu.org#53002,"PASAR BARU, KARAWACI, KOTA TANGERANG, BANTEN",14,41,109,150
https://kawalpemilu.org#52544,"BENCONGAN, KELAPA DUA, TANGERANG, BANTEN",59,93,100,193
https://kawalpemilu.org#52455,"KRAMAT, PAKUHAJI, TANGERANG, BANTEN",1,49,97,146
https://kawalpemilu.org#52868,"CIBOJONG, PADARINCANG, SERANG, BANTEN",11,43,129,172
https://kawalpemilu.org#52611,"WARINGINKURUNG, WARINGINKURUNG, SERANG, BANTEN",4,70,147,217
https://kawalpemilu.org#84977,"BANGKONOL, KORONCONG, PANDEGLANG, BANTEN",5,45,129,174
https://kawalpemilu.org#52418,"PANGADEGAN, PASAR KEMIS, TANGERANG, BANTEN",45,29,129,158
https://kawalpemilu.org#53070,"LEBAKGEDE, PULOMERAK, KOTA CILEGON, BANTEN",43,19,179,198
https://kawalpemilu.org#52746,"RAGASMASIGIT, CARENANG, SERANG, BANTEN",15,32,154,186
https://kawalpemilu.org#51811,"KABAYAN, PANDEGLANG, PANDEGLANG, BANTEN",13,52,195,247
https://kawalpemilu.org#52368,"MAUK TIMUR, MAUK, TANGERANG, BANTEN",20,79,34,113
https://kawalpemilu.org#52103,"MUARA CIUJUNG BARAT, RANGKASBITUNG, LEBAK, BANTEN",19,77,115,192
https://kawalpemilu.org#53213,"CIPUTAT, CIPUTAT, KOTA TANGERANG SELATAN, BANTEN",66,130,54,184
https://kawalpemilu.org#52596,"MARGASANA, KRAMATWATU, SERANG, BANTEN",10,72,117,189
https://kawalpemilu.org#52339,"BOJONG LOA, CISOKA, TANGERANG, BANTEN",17,55,117,172
https://kawalpemilu.org#927485,"SUNGAI IPUH DUA, SELAGAN RAYA, MUKOMUKO, BENGKULU",2,52,106,158
https://kawalpemilu.org#21142,"TALANG BENIH, CURUP, REJANG LEBONG, BENGKULU",12,100,158,258
https://kawalpemilu.org#21019,"TANGGO RASO, PINO RAYA, BENGKULU SELATAN, BENGKULU",1,103,87,190
https://kawalpemilu.org#20843,"PEKIK NYARING, PONDOK KELAPA, BENGKULU TENGAH, BENGKULU",4,66,72,138
https://kawalpemilu.org#22064,"SUKA SARI, LEBONG SELATAN, LEBONG, BENGKULU",1,158,53,211
https://kawalpemilu.org#22169,"MERANTI JAYA, UJAN MAS, KEPAHIANG, BENGKULU",3,59,160,219
https://kawalpemilu.org#21224,"TABA PADANG, BINDURIANG, REJANG LEBONG, BENGKULU",1,101,90,191
https://kawalpemilu.org#83973,"ATURAN MUMPO II, PEMATANG TIGA, BENGKULU TENGAH, BENGKULU",1,40,218,258
https://kawalpemilu.org#22207,"DURIAN DEPUN, MERIGI, KEPAHIANG, BENGKULU",3,56,135,191
https://kawalpemilu.org#21361,"KEMBANG MANIS, AIR PADANG, BENGKULU UTARA, BENGKULU",3,103,64,167
https://kawalpemilu.org#22263,"JEMBATAN KECIL, SINGARAN PATI, KOTA BENGKULU, BENGKULU",9,56,52,108
https://kawalpemilu.org#21616,"CAHAYA BATIN, SEMIDANG GUMAY, KAUR, BENGKULU",1,61,188,249
https://kawalpemilu.org#20956,"KOTA BUMI BARU, SEGINIM, BENGKULU SELATAN, BENGKULU",1,121,45,166
https://kawalpemilu.org#22304,"NUSA INDAH, RATU AGUNG, KOTA BENGKULU, BENGKULU",14,78,126,204
https://kawalpemilu.org#21397,"URAI, KETAHUN, BENGKULU UTARA, BENGKULU",21,73,17,90
https://kawalpemilu.org#21262,"BABAKAN BARU, BERMANI ULU RAYA, REJANG LEBONG, BENGKULU",3,145,103,248
https://kawalpemilu.org#42276,"PURWOMARTANI, KALASAN, SLEMAN, DAERAH ISTIMEWA YOGYAKARTA",70,119,60,179
https://kawalpemilu.org#42288,"MINOMARTANI, NGAGLIK, SLEMAN, DAERAH ISTIMEWA YOGYAKARTA",14,134,47,181
https://kawalpemilu.org#41991,"GILANGHARJO, PANDAK, BANTUL, DAERAH ISTIMEWA YOGYAKARTA",22,140,69,209
https://kawalpemilu.org#42279,"SELOMARTANI, KALASAN, SLEMAN, DAERAH ISTIMEWA YOGYAKARTA",16,135,80,215
https://kawalpemilu.org#42232,"SIDOAGUNG, GODEAN, SLEMAN, DAERAH ISTIMEWA YOGYAKARTA",24,198,70,268
https://kawalpemilu.org#42068,"PULUTAN, WONOSARI, GUNUNGKIDUL, DAERAH ISTIMEWA YOGYAKARTA",12,146,100,246
https://kawalpemilu.org#41871,"PLUMBON, TEMON, KULON PROGO, DAERAH ISTIMEWA YOGYAKARTA",4,116,93,209
https://kawalpemilu.org#42254,"SINDUADI, MLATI, SLEMAN, DAERAH ISTIMEWA YOGYAKARTA",37,175,73,248
https://kawalpemilu.org#42148,"TAMBAKROMO, PONJONG, GUNUNGKIDUL, DAERAH ISTIMEWA YOGYAKARTA",1,173,36,209
https://kawalpemilu.org#41933,"SIDOMULYO, PENGASIH, KULON PROGO, DAERAH ISTIMEWA YOGYAKARTA",8,168,54,222
https://kawalpemilu.org#42260,"CATURTUNGGAL, DEPOK, SLEMAN, DAERAH ISTIMEWA YOGYAKARTA",123,137,81,218
https://kawalpemilu.org#42372,"BRONTOKUSUMAN, MERGANGSAN, KOTA YOGYAKARTA, DAERAH ISTIMEWA YOGYAKARTA",28,58,156,214
https://kawalpemilu.org#42258,"SUMBERADI, MLATI, SLEMAN, DAERAH ISTIMEWA YOGYAKARTA",42,156,74,230
https://kawalpemilu.org#41990,"TRIHARJO, PANDAK, BANTUL, DAERAH ISTIMEWA YOGYAKARTA",22,91,29,120
https://kawalpemilu.org#41982,"PANJANGREJO, PUNDONG, BANTUL, DAERAH ISTIMEWA YOGYAKARTA",29,151,43,194
https://kawalpemilu.org#42119,"GIRIMULYO, PANGGANG, GUNUNGKIDUL, DAERAH ISTIMEWA YOGYAKARTA",18,170,12,182
https://kawalpemilu.org#42011,"WUKIRSARI, IMOGIRI, BANTUL, DAERAH ISTIMEWA YOGYAKARTA",32,131,46,177
https://kawalpemilu.org#42288,"MINOMARTANI, NGAGLIK, SLEMAN, DAERAH ISTIMEWA YOGYAKARTA",30,145,79,224
https://kawalpemilu.org#42001,"TRIRENGGO, BANTUL, BANTUL, DAERAH ISTIMEWA YOGYAKARTA",41,178,48,224
https://kawalpemilu.org#42012,"KEBONAGUNG, IMOGIRI, BANTUL, DAERAH ISTIMEWA YOGYAKARTA",1,140,67,207
https://kawalpemilu.org#42011,"WUKIRSARI, IMOGIRI, BANTUL, DAERAH ISTIMEWA YOGYAKARTA",28,160,45,205
https://kawalpemilu.org#42277,"TIRTOMARTANI, KALASAN, SLEMAN, DAERAH ISTIMEWA YOGYAKARTA",27,89,131,220
https://kawalpemilu.org#42045,"TIMBULHARJO, SEWON, BANTUL, DAERAH ISTIMEWA YOGYAKARTA",53,123,40,163
https://kawalpemilu.org#41935,"HARGOMULYO, KOKAP, KULON PROGO, DAERAH ISTIMEWA YOGYAKARTA",18,194,35,229
https://kawalpemilu.org#42179,"SAMBIREJO, NGAWEN, GUNUNGKIDUL, DAERAH ISTIMEWA YOGYAKARTA",12,127,81,208
https://kawalpemilu.org#42197,"KANIGORO, SAPTOSARI, GUNUNGKIDUL, DAERAH ISTIMEWA YOGYAKARTA",24,125,19,144
https://kawalpemilu.org#42368,"GUNUNGKETUR, PAKUALAMAN, KOTA YOGYAKARTA, DAERAH ISTIMEWA YOGYAKARTA",3,141,38,179
https://kawalpemilu.org#42256,"TLOGOADI, MLATI, SLEMAN, DAERAH ISTIMEWA YOGYAKARTA",13,178,32,210
https://kawalpemilu.org#42126,"SIDOHARJO, TEPUS, GUNUNGKIDUL, DAERAH ISTIMEWA YOGYAKARTA",10,98,66,164
https://kawalpemilu.org#26035,"MELAWAI, KEBAYORAN BARU, JAKARTA SELATAN, DKI JAKARTA",10,87,44,131
https://kawalpemilu.org#25922,"PEGANGSAAN DUA, KELAPA GADING, JAKARTA UTARA, DKI JAKARTA",28,235,28,263
https://kawalpemilu.org#25905,"RAWA BADAK UTARA, KOJA, JAKARTA UTARA, DKI JAKARTA",17,71,161,232
https://kawalpemilu.org#26097,"CAWANG, KRAMATJATI, JAKARTA TIMUR, DKI JAKARTA",75,110,114,224
https://kawalpemilu.org#26061,"BINTARO, PESANGGRAHAN, JAKARTA SELATAN, DKI JAKARTA",114,96,100,196
https://kawalpemilu.org#25911,"MARUNDA, CILINCING, JAKARTA UTARA, DKI JAKARTA",52,96,158,254
https://kawalpemilu.org#26108,"PENGGILINGAN, CAKUNG, JAKARTA TIMUR, DKI JAKARTA",201,83,113,196
https://kawalpemilu.org#25967,"KEDOYA UTARA, KEBON JERUK, JAKARTA BARAT, DKI JAKARTA",70,119,125,244
https://kawalpemilu.org#25935,"TOMANG, GROGOL PETAMBURAN, JAKARTA BARAT, DKI JAKARTA",32,137,86,223
https://kawalpemilu.org#26089,"CIPINANG BESAR UTARA, JATINEGARA, JAKARTA TIMUR, DKI JAKARTA",67,90,136,226
https://kawalpemilu.org#26114,"PONDOK BAMBU, DUREN SAWIT, JAKARTA TIMUR, DKI JAKARTA",97,114,113,227
https://kawalpemilu.org#25879,"KEBON KACANG, TANAH ABANG, JAKARTA PUSAT, DKI JAKARTA",44,91,66,157
https://kawalpemilu.org#25979,"JATIPULO, PALMERAH, JAKARTA BARAT, DKI JAKARTA",27,150,35,185
https://kawalpemilu.org#25984,"MERUYA UTARA, KEMBANGAN, JAKARTA BARAT, DKI JAKARTA",122,124,107,231
https://kawalpemilu.org#26082,"KAMPUNG MELAYU, JATINEGARA, JAKARTA TIMUR, DKI JAKARTA",79,123,35,158
https://kawalpemilu.org#25930,"KAPUK, CENGKARENG, JAKARTA BARAT, DKI JAKARTA",241,114,95,209
https://kawalpemilu.org#25936,"JELAMBAR, GROGOL PETAMBURAN, JAKARTA BARAT, DKI JAKARTA",61,169,35,204
https://kawalpemilu.org#25858,"KENARI, SENEN, JAKARTA PUSAT, DKI JAKARTA",17,104,146,250
https://kawalpemilu.org#26110,"UJUNG MENTENG, CAKUNG, JAKARTA TIMUR, DKI JAKARTA",15,45,206,251
https://kawalpemilu.org#26069,"KAYU MANIS, MATRAMAN, JAKARTA TIMUR, DKI JAKARTA",1,106,122,228
https://kawalpemilu.org#26011,"TEGAL PARANG, MAMPANG PRAPATAN, JAKARTA SELATAN, DKI JAKARTA",37,102,139,241
https://kawalpemilu.org#26116,"PONDOK KELAPA, DUREN SAWIT, JAKARTA TIMUR, DKI JAKARTA",148,75,165,240
https://kawalpemilu.org#25895,"SUNTER JAYA, TANJUNG PRIOK, JAKARTA UTARA, DKI JAKARTA",120,134,107,241
https://kawalpemilu.org#26123,"KEBON PALA, MAKASAR, JAKARTA TIMUR, DKI JAKARTA",124,125,109,234
https://kawalpemilu.org#26031,"PONDOK LABU, CILANDAK, JAKARTA SELATAN, DKI JAKARTA",25,163,93,256
https://kawalpemilu.org#26109,"PULO GEBANG, CAKUNG, JAKARTA TIMUR, DKI JAKARTA",14,76,156,232
https://kawalpemilu.org#25955,"JEMBATAN BESI, TAMBORA, JAKARTA BARAT, DKI JAKARTA",4,83,149,232
https://kawalpemilu.org#26023,"PONDOK PINANG, KEBAYORAN LAMA, JAKARTA SELATAN, DKI JAKARTA",176,196,37,233
https://kawalpemilu.org#25900,"WARAKAS, TANJUNG PRIOK, JAKARTA UTARA, DKI JAKARTA",84,175,62,237
https://kawalpemilu.org#25979,"JATIPULO, PALMERAH, JAKARTA BARAT, DKI JAKARTA",70,96,110,206
https://kawalpemilu.org#26002,"KARET, SETIABUDI, JAKARTA SELATAN, DKI JAKARTA",29,124,91,215
https://kawalpemilu.org#26015,"JATI PADANG, PASAR MINGGU, JAKARTA SELATAN, DKI JAKARTA",32,133,123,256
https://kawalpemilu.org#25891,"PEJAGALAN, PENJARINGAN, JAKARTA UTARA, DKI JAKARTA",87,191,23,214
https://kawalpemilu.org#25853,"CEMPAKA BARU, KEMAYORAN, JAKARTA PUSAT, DKI JAKARTA",92,90,138,228
https://kawalpemilu.org#26063,"PETUKANGAN SELATAN, PESANGGRAHAN, JAKARTA SELATAN, DKI JAKARTA",82,154,47,201
https://kawalpemilu.org#26088,"CIPINANG BESAR SELATAN, JATINEGARA, JAKARTA TIMUR, DKI JAKARTA",81,58,194,252
https://kawalpemilu.org#26019,"PEJATEN BARAT, PASAR MINGGU, JAKARTA SELATAN, DKI JAKARTA",22,139,66,205
https://kawalpemilu.org#25957,"JEMBATAN LIMA, TAMBORA, JAKARTA BARAT, DKI JAKARTA",1,181,33,214
https://kawalpemilu.org#26029,"CILANDAK BARAT, CILANDAK, JAKARTA SELATAN, DKI JAKARTA",121,130,115,245
https://kawalpemilu.org#25896,"PAPANGGO, TANJUNG PRIOK, JAKARTA UTARA, DKI JAKARTA",32,76,76,152
https://kawalpemilu.org#25995,"BUKIT DURI, TEBET, JAKARTA SELATAN, DKI JAKARTA",49,98,118,216
https://kawalpemilu.org#26063,"PETUKANGAN SELATAN, PESANGGRAHAN, JAKARTA SELATAN, DKI JAKARTA",100,86,134,220
https://kawalpemilu.org#26079,"KAYU PUTIH, PULOGADUNG, JAKARTA TIMUR, DKI JAKARTA",10,109,62,171
https://kawalpemilu.org#26094,"BATU AMPAR, KRAMATJATI, JAKARTA TIMUR, DKI JAKARTA",84,90,176,266
https://kawalpemilu.org#25970,"KALIDERES, KALIDERES, JAKARTA BARAT, DKI JAKARTA",105,142,76,218
https://kawalpemilu.org#26089,"CIPINANG BESAR UTARA, JATINEGARA, JAKARTA TIMUR, DKI JAKARTA",39,110,113,223
https://kawalpemilu.org#26133,"CIPAYUNG, CIPAYUNG, JAKARTA TIMUR, DKI JAKARTA",77,65,38,103
https://kawalpemilu.org#25891,"PEJAGALAN, PENJARINGAN, JAKARTA UTARA, DKI JAKARTA",6,141,82,223
https://kawalpemilu.org#25842,"PASAR BARU, SAWAH BESAR, JAKARTA PUSAT, DKI JAKARTA",39,135,40,175
https://kawalpemilu.org#26088,"CIPINANG BESAR SELATAN, JATINEGARA, JAKARTA TIMUR, DKI JAKARTA",50,120,124,244
https://kawalpemilu.org#26134,"CILANGKAP, CIPAYUNG, JAKARTA TIMUR, DKI JAKARTA",67,115,91,206
https://kawalpemilu.org#25877,"PETAMBURAN, TANAH ABANG, JAKARTA PUSAT, DKI JAKARTA",93,66,208,274
https://kawalpemilu.org#25922,"PEGANGSAAN DUA, KELAPA GADING, JAKARTA UTARA, DKI JAKARTA",115,204,8,212
https://kawalpemilu.org#25896,"PAPANGGO, TANJUNG PRIOK, JAKARTA UTARA, DKI JAKARTA",5,110,146,256
https://kawalpemilu.org#26080,"JATI, PULOGADUNG, JAKARTA TIMUR, DKI JAKARTA",12,151,87,238
https://kawalpemilu.org#25930,"KAPUK, CENGKARENG, JAKARTA BARAT, DKI JAKARTA",354,136,68,204
https://kawalpemilu.org#25945,"MANGGA BESAR, TAMAN SARI, JAKARTA BARAT, DKI JAKARTA",12,139,69,208
https://kawalpemilu.org#26121,"MAKASAR, MAKASAR, JAKARTA TIMUR, DKI JAKARTA",101,97,87,184
https://kawalpemilu.org#25850,"HARAPAN MULIA, KEMAYORAN, JAKARTA PUSAT, DKI JAKARTA",43,83,85,168
https://kawalpemilu.org#25894,"TANJUNG PRIOK, TANJUNG PRIOK, JAKARTA UTARA, DKI JAKARTA",94,133,78,211
https://kawalpemilu.org#25977,"SLIPI, PALMERAH, JAKARTA BARAT, DKI JAKARTA",8,73,103,176
https://kawalpemilu.org#25836,"CIDENG, GAMBIR, JAKARTA PUSAT, DKI JAKARTA",30,128,80,208
https://kawalpemilu.org#25926,"CENGKARENG BARAT, CENGKARENG, JAKARTA BARAT, DKI JAKARTA",52,94,81,175
https://kawalpemilu.org#26108,"PENGGILINGAN, CAKUNG, JAKARTA TIMUR, DKI JAKARTA",240,80,95,175
https://kawalpemilu.org#25849,"KEBON KOSONG, KEMAYORAN, JAKARTA PUSAT, DKI JAKARTA",72,107,128,235
https://kawalpemilu.org#26029,"CILANDAK BARAT, CILANDAK, JAKARTA SELATAN, DKI JAKARTA",76,156,58,214
https://kawalpemilu.org#25983,"KEMBANGAN UTARA, KEMBANGAN, JAKARTA BARAT, DKI JAKARTA",34,71,95,166
https://kawalpemilu.org#26019,"PEJATEN BARAT, PASAR MINGGU, JAKARTA SELATAN, DKI JAKARTA",107,62,139,201
https://kawalpemilu.org#26003,"MENTENG ATAS, SETIABUDI, JAKARTA SELATAN, DKI JAKARTA",89,144,52,196
https://kawalpemilu.org#25948,"PINANGSIA, TAMAN SARI, JAKARTA BARAT, DKI JAKARTA",22,194,6,200
https://kawalpemilu.org#26108,"PENGGILINGAN, CAKUNG, JAKARTA TIMUR, DKI JAKARTA",234,126,90,216
https://kawalpemilu.org#26020,"KEBAGUSAN, PASAR MINGGU, JAKARTA SELATAN, DKI JAKARTA",106,105,113,218
https://kawalpemilu.org#75389,"LIBUO, DUNGINGI, KOTA GORONTALO, GORONTALO",6,61,162,223
https://kawalpemilu.org#75198,"LOMULI, LEMITO, PAHUWATO, GORONTALO",4,96,115,211
https://kawalpemilu.org#74897,"LIMEHE BARAT, TABONGO, GORONTALO, GORONTALO",2,106,83,189
https://kawalpemilu.org#75331,"ILANGATA, ANGGREK, GORONTALO UTARA, GORONTALO",5,115,109,224
https://kawalpemilu.org#74806,"TIMUATO, TELAGA BIRU, GORONTALO, GORONTALO",4,108,83,191
https://kawalpemilu.org#74806,"TIMUATO, TELAGA BIRU, GORONTALO, GORONTALO",2,97,126,223
https://kawalpemilu.org#75233,"SOGINTI, PAGUAT, PAHUWATO, GORONTALO",2,92,171,263
https://kawalpemilu.org#90191,"PANGGULO BARAT, BOTUPINGGE, BONE BOLANGO, GORONTALO",1,87,66,2
https://kawalpemilu.org#74728,"BONGOHULAWA, LIMBOTO, GORONTALO, GORONTALO",4,55,180,235
https://kawalpemilu.org#16962,"NIPAH PANJANG II, NIPAH PANJANG, TANJUNG JABUNG TIMUR, JAMBI",10,58,146,204
https://kawalpemilu.org#16919,"DUSUN MUDO, MUARA PAPALIK, TANJUNG JABUNG BARAT, JAMBI",2,37,54,91
https://kawalpemilu.org#17366,"TANJUNG PINANG, JAMBI TIMUR, KOTA JAMBI, JAMBI",18,139,70,209
https://kawalpemilu.org#17212,"BUKIT SARI, JUJUHAN ILIR, BUNGO, JAMBI",2,101,92,193
https://kawalpemilu.org#17344,"PENYENGAT RENDAH, TELANAIPURA, KOTA JAMBI, JAMBI",20,79,60,139
https://kawalpemilu.org#16658,"SELAT, PEMAYUNG, BATANGHARI, JAMBI",11,61,60,121
https://kawalpemilu.org#16291,"SUNGAI LALANG, LEMBAH MASURAI, MERANGIN, JAMBI",5,115,41,156
https://kawalpemilu.org#16035,"SUNGAI BETUNG HILIR, GUNUNG KERINCI, KERINCI, JAMBI",1,62,98,160
https://kawalpemilu.org#16462,"SUKASARI, SAROLANGUN, SAROLANGUN, JAMBI",19,85,134,219
https://kawalpemilu.org#84625,"SUNGAIJERING, PENGABUAN, TANJUNG JABUNG BARAT, JAMBI",4,71,59,130
https://kawalpemilu.org#16961,"NIPAH PANJANG I, NIPAH PANJANG, TANJUNG JABUNG TIMUR, JAMBI",6,85,140,225
https://kawalpemilu.org#17335,"SIMPANG IV SIPIN, TELANAIPURA, KOTA JAMBI, JAMBI",19,62,140,202
https://kawalpemilu.org#16271,"MUARA DELANG, TABIR SELATAN, MERANGIN, JAMBI",6,119,71,190
https://kawalpemilu.org#17220,"MANGUN JAYO, TEBO TENGAH, TEBO, JAMBI",9,5,169,174
https://kawalpemilu.org#17400,"LEBAK BANDUNG, JELUTUNG, KOTA JAMBI, JAMBI",18,60,180,240
https://kawalpemilu.org#16609,"MUARA BULIAN, MUARA BULIAN, BATANGHARI, JAMBI",28,48,94,142
https://kawalpemilu.org#17151,"KARYA HARAPAN MUKTI, PELEPAT ILIR, BUNGO, JAMBI",1,223,31,254
https://kawalpemilu.org#17087,"TELUK PANDAK, TANAH SEPENGGAL, BUNGO, JAMBI",8,7,219,226
https://kawalpemilu.org#17132,"TEBING TINGGI, MUKO-MUKO BATHIN VII, BUNGO, JAMBI",2,12,204,216
https://kawalpemilu.org#16994,"SUNGAI LOKAN, S A D U, TANJUNG JABUNG TIMUR, JAMBI",5,84,62,146
https://kawalpemilu.org#16817,"LADANG PANJANG, SUNGAI GELAM, MUARO JAMBI, JAMBI",12,134,79,213
https://kawalpemilu.org#17384,"ULU GEDONG, DANAU TELUK, KOTA JAMBI, JAMBI",2,36,155,191
https://kawalpemilu.org#15943,"KOTO TUO, TANAH KAMPUNG, KOTA SUNGAI PENUH, JAMBI",3,34,117,151
https://kawalpemilu.org#16860,"RUKAM, TAMAN RAJO, MUARO JAMBI, JAMBI",2,63,125,188
https://kawalpemilu.org#16899,"PURWODADI, TEBING TINGGI, TANJUNG JABUNG BARAT, JAMBI",3,127,71,198
https://kawalpemilu.org#929213,"TANJUNG PUTRA, MERSAM, BATANGHARI, JAMBI",3,111,96,207
https://kawalpemilu.org#16764,"DANAU KEDAP, MARO SEBO, MUARO JAMBI, JAMBI",1,32,114,146
https://kawalpemilu.org#16153,"KOTO BERINGIN, SIULAK, KERINCI, JAMBI",1,25,179,204
https://kawalpemilu.org#27361,"CIMACAN, CIPANAS, CIANJUR, JAWA BARAT",2,69,185,254
https://kawalpemilu.org#26754,"CICURUG, CICURUG, SUKABUMI, JAWA BARAT",7,56,86,142
https://kawalpemilu.org#28925,"KARANGAMPEL, BAREGBEG, CIAMIS, JAWA BARAT",7,86,118,204
https://kawalpemilu.org#27365,"SINDANGJAYA, CIPANAS, CIANJUR, JAWA BARAT",34,33,68,101
https://kawalpemilu.org#29519,"SINDANGKASIH, BEBER, CIREBON, JAWA BARAT",11,113,83,196
https://kawalpemilu.org#32297,"KEBON JAYANTI, KIARACONDONG, KOTA BANDUNG, JAWA BARAT",12,105,97,202
https://kawalpemilu.org#28145,"SIMPEN KIDUL, BL. LIMBANGAN, GARUT, JAWA BARAT",1,78,134,212
https://kawalpemilu.org#32122,"CILENDEK BARAT, BOGOR BARAT, KOTA BOGOR, JAWA BARAT",45,36,104,140
https://kawalpemilu.org#27576,"SARIMAHI, CIPARAY, BANDUNG, JAWA BARAT",22,76,100,176
https://kawalpemilu.org#27099,"SUKARAMA, BOJONGPICUNG, CIANJUR, JAWA BARAT",7,77,121,198
https://kawalpemilu.org#27862,"KARANGSARI, LEUWIGOONG, GARUT, JAWA BARAT",5,23,166,189
https://kawalpemilu.org#31764,"KARANGASIH, CIKARANG UTARA, BEKASI, JAWA BARAT",76,98,110,208
https://kawalpemilu.org#32300,"BABAKAN SARI, KIARACONDONG, KOTA BANDUNG, JAWA BARAT",29,67,139,206
https://kawalpemilu.org#27206,"GUNUNGSARI, SUKANAGARA, CIANJUR, JAWA BARAT",4,101,57,158
https://kawalpemilu.org#28715,"SUKAHARJA, RAJADESA, CIAMIS, JAWA BARAT",14,29,114,143
https://kawalpemilu.org#31638,"PALUMBONSARI, KARAWANG TIMUR, KARAWANG, JAWA BARAT",14,113,91,204
https://kawalpemilu.org#31094,"KASOMALANG KULON, KASOMALANG, SUBANG, JAWA BARAT",20,71,104,175
https://kawalpemilu.org#28287,"MEKARLAKSANA, CULAMEGA, TASIKMALAYA, JAWA BARAT",5,25,138,163
https://kawalpemilu.org#31324,"PONDOKBUNGUR, PONDOKSALAM, PURWAKARTA, JAWA BARAT",7,7,149,156
https://kawalpemilu.org#26708,"SUKAMULYA, CIKEMBAR, SUKABUMI, JAWA BARAT",22,77,103,180
https://kawalpemilu.org#30404,"KOTAKALER, SUMEDANG UTARA, SUMEDANG, JAWA BARAT",19,69,93,162
https://kawalpemilu.org#32414,"JAKA SAMPURNA, BEKASI BARAT, KOTA BEKASI, JAWA BARAT",60,91,110,201
https://kawalpemilu.org#27681,"LEBAKMUNCANG, CIWIDEY, BANDUNG, JAWA BARAT",9,36,116,152
https://kawalpemilu.org#28902,"SUKAHURIP, CISAGA, CIAMIS, JAWA BARAT",6,119,77,196
https://kawalpemilu.org#32250,"KARANGANYAR, ASTANA ANYAR, KOTA BANDUNG, JAWA BARAT",11,155,47,202
https://kawalpemilu.org#32436,"PEJUANG, MEDAN SATRIA, KOTA BEKASI, JAWA BARAT",53,66,167,233
https://kawalpemilu.org#27311,"CIBULUH, CIDAUN, CIANJUR, JAWA BARAT",8,137,33,170
https://kawalpemilu.org#28975,"PINARA, CINIRU, KUNINGAN, JAWA BARAT",3,40,134,174
https://kawalpemilu.org#31087,"BOJONEGARA, TAMBAKDAHAN, SUBANG, JAWA BARAT",15,165,24,189
https://kawalpemilu.org#30692,"KENANGA, SINDANG, INDRAMAYU, JAWA BARAT",4,155,67,222
https://kawalpemilu.org#27038,"LIMBANGANSARI, CIANJUR, CIANJUR, JAWA BARAT",30,42,109,151
https://kawalpemilu.org#32510,"TANAH BARU, BEJI, KOTA DEPOK, JAWA BARAT",34,120,137,257
https://kawalpemilu.org#27076,"RAHONG, CILAKU, CIANJUR, JAWA BARAT",13,62,89,151
https://kawalpemilu.org#28641,"GOLAT, PANUMBANGAN, CIAMIS, JAWA BARAT",9,92,132,224
https://kawalpemilu.org#32468,"JATIRAHAYU, PONDOK MELATI, KOTA BEKASI, JAWA BARAT",101,50,53,103
https://kawalpemilu.org#27616,"PADAMULYA, MAJALAYA, BANDUNG, JAWA BARAT",18,73,128,201
https://kawalpemilu.org#27496,"TRIBAKTIMULYA, PANGALENGAN, BANDUNG, JAWA BARAT",5,86,171,257
https://kawalpemilu.org#28576,"KERTASARI, CIAMIS, CIAMIS, JAWA BARAT",7,43,138,181
https://kawalpemilu.org#29747,"GETASAN, DEPOK, CIREBON, JAWA BARAT",5,126,32,158
https://kawalpemilu.org#31744,"KERTAMUKTI, CIBITUNG, BEKASI, JAWA BARAT",23,50,130,180
https://kawalpemilu.org#32296,"SUKAPURA, KIARACONDONG, KOTA BANDUNG, JAWA BARAT",12,82,104,186
https://kawalpemilu.org#31507,"SUKATANI, CILAMAYA WETAN, KARAWANG, JAWA BARAT",18,128,55,183
https://kawalpemilu.org#32325,"BATUNUNGGAL, BANDUNG KIDUL, KOTA BANDUNG, JAWA BARAT",30,63,114,177
https://kawalpemilu.org#26764,"MEKARSARI, CICURUG, SUKABUMI, JAWA BARAT",27,45,153,198
https://kawalpemilu.org#28566,"SUKAMENAK, SUKARESIK, TASIKMALAYA, JAWA BARAT",9,62,148,210
https://kawalpemilu.org#27057,"PEUTEUYCONDONG, CIBEBER, CIANJUR, JAWA BARAT",30,38,149,187
https://kawalpemilu.org#32281,"CIKUTRA, CIBEUNYING KIDUL, KOTA BANDUNG, JAWA BARAT",10,42,155,197
https://kawalpemilu.org#27791,"DANGDEUR, BANYURESMI, GARUT, JAWA BARAT",12,13,209,222
https://kawalpemilu.org#28841,"CILIANG, PARIGI, PANGANDARAN, JAWA BARAT",2,138,62,200
https://kawalpemilu.org#27908,"MEKARLUYU, SUKAWENING, GARUT, JAWA BARAT",11,39,152,191
https://kawalpemilu.org#32215,"BABAKAN TAROGONG, BOJONGLOA KALER, KOTA BANDUNG, JAWA BARAT",35,65,143,208
https://kawalpemilu.org#31192,"CIANTINGUTARA, SUKATANI, PURWAKARTA, JAWA BARAT",3,34,176,210
https://kawalpemilu.org#27945,"CINTANAGARA, CIGEDUG, GARUT, JAWA BARAT",10,38,168,206
https://kawalpemilu.org#31929,"TUGUMUKTI, CISARUA, BANDUNG BARAT, JAWA BARAT",14,96,73,169
https://kawalpemilu.org#28173,"KARANGSARI, PANGATIKAN, GARUT, JAWA BARAT",3,35,171,206
https://kawalpemilu.org#30006,"LOJI, JATIWANGI, MAJALENGKA, JAWA BARAT",11,91,120,211
https://kawalpemilu.org#32555,"BAROS, CIMAHI TENGAH, KOTA CIMAHI, JAWA BARAT",65,6,84,90
https://kawalpemilu.org#31862,"SUKARESMI, CIKARANG SELATAN, BEKASI, JAWA BARAT",12,37,183,220
https://kawalpemilu.org#26805,"CIPARAY, JAMPANG KULON, SUKABUMI, JAWA BARAT",3,20,162,182
https://kawalpemilu.org#27466,"CITEUREUP, DAYEUHKOLOT, BANDUNG, JAWA BARAT",21,77,153,230
https://kawalpemilu.org#27061,"SELAGEDANG, CIBEBER, CIANJUR, JAWA BARAT",13,38,116,154
https://kawalpemilu.org#27703,"JELEGONG, KUTAWARINGIN, BANDUNG, JAWA BARAT",42,113,101,214
https://kawalpemilu.org#32406,"MARGAHAYU, BEKASI TIMUR, KOTA BEKASI, JAWA BARAT",164,93,33,126
https://kawalpemilu.org#32430,"PENGASINAN, RAWA LUMBU, KOTA BEKASI, JAWA BARAT",81,93,95,188
https://kawalpemilu.org#31729,"KARANGSATRIA, TAMBUN UTARA, BEKASI, JAWA BARAT",102,82,130,212
https://kawalpemilu.org#28930,"SUKAMANTRI, SUKAMANTRI, CIAMIS, JAWA BARAT",10,58,95,153
https://kawalpemilu.org#32269,"SAMOJA, BATUNUNGGAL, KOTA BANDUNG, JAWA BARAT",32,77,138,215
https://kawalpemilu.org#29783,"ASTAPADA, TENGAH TANI, CIREBON, JAWA BARAT",13,77,158,235
https://kawalpemilu.org#27885,"CIKARANG, MALANGBONG, GARUT, JAWA BARAT",16,46,159,205
https://kawalpemilu.org#30276,"JAMBU, CONGGEANG, SUMEDANG, JAWA BARAT",3,77,151,228
https://kawalpemilu.org#31736,"SETIAMEKAR, TAMBUN SELATAN, BEKASI, JAWA BARAT",99,53,173,226
https://kawalpemilu.org#26374,"JASINGA, JASINGA, BOGOR, JAWA BARAT",8,79,176,255
https://kawalpemilu.org#28287,"MEKARLAKSANA, CULAMEGA, TASIKMALAYA, JAWA BARAT",4,36,141,177
https://kawalpemilu.org#89227,"JAYANTI, PELABUHAN RATU, SUKABUMI, JAWA BARAT",19,115,27,142
https://kawalpemilu.org#32405,"BEKASI JAYA, BEKASI TIMUR, KOTA BEKASI, JAWA BARAT",143,88,97,185
https://kawalpemilu.org#32148,"MEKARWANGI, TANAH SAREAL, KOTA BOGOR, JAWA BARAT",65,71,112,183
https://kawalpemilu.org#32411,"KRANJI, BEKASI BARAT, KOTA BEKASI, JAWA BARAT",75,48,116,164
https://kawalpemilu.org#31969,"PAKUHAJI, NGAMPRAH, BANDUNG BARAT, JAWA BARAT",11,88,111,199
https://kawalpemilu.org#28826,"WONOHARJO, PANGANDARAN, PANGANDARAN, JAWA BARAT",12,167,62,229
https://kawalpemilu.org#32351,"PASANGGRAHAN, UJUNG BERUNG, KOTA BANDUNG, JAWA BARAT",4,90,110,200
https://kawalpemilu.org#32196,"GEGERKALONG, SUKASARI, KOTA BANDUNG, JAWA BARAT",29,65,151,216
https://kawalpemilu.org#32033,"BARANANGSIANG, CIPONGKOR, BANDUNG BARAT, JAWA BARAT",16,32,129,161
https://kawalpemilu.org#30780,"BOGOR, SUKRA, INDRAMAYU, JAWA BARAT",8,196,44,240
https://kawalpemilu.org#30082,"GARAWANGI, SUMBERJAYA, MAJALENGKA, JAWA BARAT",1,155,73,228
https://kawalpemilu.org#32427,"KAYURINGIN JAYA, BEKASI SELATAN, KOTA BEKASI, JAWA BARAT",127,98,88,186
https://kawalpemilu.org#27697,"PANANJUNG, CANGKUANG, BANDUNG, JAWA BARAT",33,142,81,223
https://kawalpemilu.org#27870,"PADASUKA, CIBATU, GARUT, JAWA BARAT",6,79,148,227
https://kawalpemilu.org#31687,"SEGARAMAKMUR, TARUMAJAYA, BEKASI, JAWA BARAT",35,47,127,174
https://kawalpemilu.org#28163,"MAJASARI, CIBIUK, GARUT, JAWA BARAT",11,56,123,179
https://kawalpemilu.org#27418,"CIMENYAN, CIMENYAN, BANDUNG, JAWA BARAT",26,48,136,184
https://kawalpemilu.org#27411,"CIMEKAR, CILEUNYI, BANDUNG, JAWA BARAT",1,44,177,221
https://kawalpemilu.org#29701,"GEGESIK KULON, GEGESIK, CIREBON, JAWA BARAT",4,112,88,200
https://kawalpemilu.org#32323,"ANTAPANI KIDUL, ANTAPANI, KOTA BANDUNG, JAWA BARAT",17,82,147,229
https://kawalpemilu.org#28186,"SINDANGKERTA, CIPATUJAH, TASIKMALAYA, JAWA BARAT",11,59,106,165
https://kawalpemilu.org#27462,"DAYEUHKOLOT, DAYEUHKOLOT, BANDUNG, JAWA BARAT",5,54,99,153
https://kawalpemilu.org#26296,"BOJONGGEDE, BOJONG GEDE, BOGOR, JAWA BARAT",91,67,127,194
https://kawalpemilu.org#27960,"SUKAMAJU, CILAWU, GARUT, JAWA BARAT",24,73,89,162
https://kawalpemilu.org#32298,"BABAKAN SURABAYA, KIARACONDONG, KOTA BANDUNG, JAWA BARAT",15,94,139,233
https://kawalpemilu.org#31556,"KARYAMUKTI, LEMAHABANG, KARAWANG, JAWA BARAT",21,125,113,238
https://kawalpemilu.org#31604,"BAYUR KIDUL, CILAMAYA KULON, KARAWANG, JAWA BARAT",7,112,77,189
https://kawalpemilu.org#31789,"SERTAJAYA, CIKARANG TIMUR, BEKASI, JAWA BARAT",25,89,67,156
https://kawalpemilu.org#26874,"NAGRAK, CISAAT, SUKABUMI, JAWA BARAT",13,29,197,226
https://kawalpemilu.org#26294,"PABUARAN, BOJONG GEDE, BOGOR, JAWA BARAT",83,76,163,239
https://kawalpemilu.org#27449,"MEKARRAHAYU, MARGAASIH, BANDUNG, JAWA BARAT",42,114,129,243
https://kawalpemilu.org#29371,"WALED DESA, WALED, CIREBON, JAWA BARAT",5,150,65,215
https://kawalpemilu.org#28034,"SUKANAGARA, PEUNDEUY, GARUT, JAWA BARAT",4,37,113,150
https://kawalpemilu.org#32518,"BOJONG PONDOK TERONG, CIPAYUNG, KOTA DEPOK, JAWA BARAT",88,67,158,225
https://kawalpemilu.org#28347,"SUKANAGARA, TANJUNGJAYA, TASIKMALAYA, JAWA BARAT",10,113,73,186
https://kawalpemilu.org#32118,"MARGAJAYA, BOGOR BARAT, KOTA BOGOR, JAWA BARAT",6,85,93,178
https://kawalpemilu.org#30649,"KEBULEN, JATIBARANG, INDRAMAYU, JAWA BARAT",11,121,92,213
https://kawalpemilu.org#32086,"CIKARET, BOGOR SELATAN, KOTA BOGOR, JAWA BARAT",58,85,117,202
https://kawalpemilu.org#32412,"KOTA BARU, BEKASI BARAT, KOTA BEKASI, JAWA BARAT",120,72,162,234
https://kawalpemilu.org#31439,"KUTAMAKMUR, TIRTAJAYA, KARAWANG, JAWA BARAT",13,97,98,195
https://kawalpemilu.org#30440,"JINGKANG, TANJUNGMEDAR, SUMEDANG, JAWA BARAT",9,125,98,223
https://kawalpemilu.org#29923,"MAJA UTARA, MAJA, MAJALENGKA, JAWA BARAT",8,22,158,180
https://kawalpemilu.org#27148,"CIPENDAWA, PACET, CIANJUR, JAWA BARAT",36,61,148,209
https://kawalpemilu.org#27903,"BUNISARI, MALANGBONG, GARUT, JAWA BARAT",3,64,146,210
https://kawalpemilu.org#28734,"KAWUNGLARANG, RANCAH, CIAMIS, JAWA BARAT",14,48,60,108
https://kawalpemilu.org#31482,"CIKAMPEK PUSAKA, CIKAMPEK, KARAWANG, JAWA BARAT",11,130,125,255
https://kawalpemilu.org#32117,"BUBULAK, BOGOR BARAT, KOTA BOGOR, JAWA BARAT",40,54,110,164
https://kawalpemilu.org#32466,"MUSTIKAJAYA, MUSTIKA JAYA, KOTA BEKASI, JAWA BARAT",82,93,122,215
https://kawalpemilu.org#32119,"BALUMBANG JAYA, BOGOR BARAT, KOTA BOGOR, JAWA BARAT",38,59,70,129
https://kawalpemilu.org#28317,"SINGASARI, TARAJU, TASIKMALAYA, JAWA BARAT",3,70,173,243
https://kawalpemilu.org#26528,"KLAPANUNGGAL, KLAPANUNGGAL, BOGOR, JAWA BARAT",15,25,187,212
https://kawalpemilu.org#28724,"MARGAHARJA, SUKADANA, CIAMIS, JAWA BARAT",14,44,128,172
https://kawalpemilu.org#32261,"PASIRLUYU, REGOL, KOTA BANDUNG, JAWA BARAT",27,75,134,209
https://kawalpemilu.org#32454,"JATILUHUR, JATIASIH, KOTA BEKASI, JAWA BARAT",68,97,96,193
https://kawalpemilu.org#32656,"HEGARSARI, PATARUMAN, KOTA BANJAR, JAWA BARAT",28,130,139,269
https://kawalpemilu.org#28544,"KURNIABAKTI, CIAWI, TASIKMALAYA, JAWA BARAT",2,43,174,217
https://kawalpemilu.org#27411,"CIMEKAR, CILEUNYI, BANDUNG, JAWA BARAT",24,62,102,164
https://kawalpemilu.org#89265,"RANCAEKEK KENCANA, RANCAEKEK, BANDUNG, JAWA BARAT",11,45,118,163
https://kawalpemilu.org#26506,"CIOMAS RAHAYU, CIOMAS, BOGOR, JAWA BARAT",19,68,135,203
https://kawalpemilu.org#28759,"PULOERANG, LAKBOK, CIAMIS, JAWA BARAT",17,94,90,184
https://kawalpemilu.org#31939,"MANDALAMUKTI, CIKALONGWETAN, BANDUNG BARAT, JAWA BARAT",34,74,101,175
https://kawalpemilu.org#26217,"SINGASARI, JONGGOL, BOGOR, JAWA BARAT",17,41,222,263
https://kawalpemilu.org#32186,"CIKUNDUL, LEMBURSITU, KOTA SUKABUMI, JAWA BARAT",15,73,140,213
https://kawalpemilu.org#32412,"KOTA BARU, BEKASI BARAT, KOTA BEKASI, JAWA BARAT",6,78,150,228
https://kawalpemilu.org#32416,"KALIABANG TENGAH, BEKASI UTARA, KOTA BEKASI, JAWA BARAT",208,131,140,272
https://kawalpemilu.org#32253,"PELINDUNG HEWAN, ASTANA ANYAR, KOTA BANDUNG, JAWA BARAT",20,49,160,209
https://kawalpemilu.org#29719,"WARGABINANGUN, KALIWEDI, CIREBON, JAWA BARAT",11,137,37,174
https://kawalpemilu.org#27533,"WALUYA, CICALENGKA, BANDUNG, JAWA BARAT",27,90,167,257
https://kawalpemilu.org#32615,"MUGARSARI, TAMANSARI, KOTA TASIKMALAYA, JAWA BARAT",3,83,105,188
https://kawalpemilu.org#32503,"MEKAR JAYA, SUKMAJAYA, KOTA DEPOK, JAWA BARAT",166,89,118,207
https://kawalpemilu.org#29380,"CISAAT, WALED, CIREBON, JAWA BARAT",11,117,35,152
https://kawalpemilu.org#27117,"HEGARMANAH, KARANGTENGAH, CIANJUR, JAWA BARAT",19,38,151,189
https://kawalpemilu.org#31630,"PUCUNG, KOTA BARU, KARAWANG, JAWA BARAT",48,116,136,252
https://kawalpemilu.org#28254,"CIBALONG, CIBALONG, TASIKMALAYA, JAWA BARAT",9,35,174,209
https://kawalpemilu.org#27927,"KARYAJAYA, BAYONGBONG, GARUT, JAWA BARAT",13,39,126,165
https://kawalpemilu.org#30289,"BONGKOK, PASEH, SUMEDANG, JAWA BARAT",12,63,168,231
https://kawalpemilu.org#32555,"BAROS, CIMAHI TENGAH, KOTA CIMAHI, JAWA BARAT",55,69,135,204
https://kawalpemilu.org#26173,"TAJUR, CITEUREUP, BOGOR, JAWA BARAT",30,30,149,179
https://kawalpemilu.org#30347,"CINANGGERANG, PAMULIHAN, SUMEDANG, JAWA BARAT",9,69,62,131
https://kawalpemilu.org#26751,"BOJONG ASIH, PARAKAN SALAK, SUKABUMI, JAWA BARAT",4,84,162,246
https://kawalpemilu.org#29484,"SIDAMULYA, ASTANAJAPURA, CIREBON, JAWA BARAT",14,150,32,182
https://kawalpemilu.org#31402,"KARYASARI, RENGASDENGKLOK, KARAWANG, JAWA BARAT",22,90,67,157
https://kawalpemilu.org#28117,"PAMALAYAN, CISEWU, GARUT, JAWA BARAT",3,73,176,249
https://kawalpemilu.org#26371,"PANGRADIN, JASINGA, BOGOR, JAWA BARAT",7,87,132,219
https://kawalpemilu.org#32434,"MEDAN SATRIA, MEDAN SATRIA, KOTA BEKASI, JAWA BARAT",61,48,167,215
https://kawalpemilu.org#28776,"CIULU, BANJARSARI, CIAMIS, JAWA BARAT",8,77,96,173
https://kawalpemilu.org#31905,"JAYAGIRI, LEMBANG, BANDUNG BARAT, JAWA BARAT",15,82,142,224
https://kawalpemilu.org#27146,"CIBODAS, PACET, CIANJUR, JAWA BARAT",10,91,143,234
https://kawalpemilu.org#29211,"CIPARI, CIGUGUR, KUNINGAN, JAWA BARAT",6,26,147,173
https://kawalpemilu.org#31926,"PASIRLANGU, CISARUA, BANDUNG BARAT, JAWA BARAT",15,55,57,112
https://kawalpemilu.org#32220,"MALEBER, ANDIR, KOTA BANDUNG, JAWA BARAT",45,77,148,225
https://kawalpemilu.org#32192,"LIMUSNUNGGAL, CIBEUREUM, KOTA SUKABUMI, JAWA BARAT",7,45,123,168
https://kawalpemilu.org#27477,"NEGLASARI, BANJARAN, BANDUNG, JAWA BARAT",25,74,94,168
https://kawalpemilu.org#927540,"CIBUNAR JAYA, CIAMBAR, SUKABUMI, JAWA BARAT",26,29,56,85
https://kawalpemilu.org#26644,"BOYONG SARI, BANTAR GADUNG, SUKABUMI, JAWA BARAT",4,32,124,156
https://kawalpemilu.org#27502,"LEBAKWANGI, ARJASARI, BANDUNG, JAWA BARAT",34,19,127,146
https://kawalpemilu.org#30659,"TEGAL SEMBADRA, BALONGAN, INDRAMAYU, JAWA BARAT",1,156,81,237
https://kawalpemilu.org#26308,"KAREHKEL, LEUWILIANG, BOGOR, JAWA BARAT",40,18,110,128
https://kawalpemilu.org#28594,"NASOL, CIKONENG, CIAMIS, JAWA BARAT",30,80,98,178
https://kawalpemilu.org#27037,"MEKARSARI, CIANJUR, CIANJUR, JAWA BARAT",3,77,133,210
https://kawalpemilu.org#27678,"SUGIHMUKTI, PASIRJAMBU, BANDUNG, JAWA BARAT",19,121,73,194
https://kawalpemilu.org#32303,"SITUSAEUR, BOJONGLOA KIDUL, KOTA BANDUNG, JAWA BARAT",7,61,114,175
https://kawalpemilu.org#28007,"TALAGASARI, BANJARWANGI, GARUT, JAWA BARAT",22,45,172,217
https://kawalpemilu.org#28291,"BOJONGGAMBIR, BOJONGGAMBIR, TASIKMALAYA, JAWA BARAT",3,42,201,243
https://kawalpemilu.org#32253,"PELINDUNG HEWAN, ASTANA ANYAR, KOTA BANDUNG, JAWA BARAT",21,75,137,212
https://kawalpemilu.org#31003,"JATIRAGAS HILIR, PATOKBEUSI, SUBANG, JAWA BARAT",18,143,109,252
https://kawalpemilu.org#27876,"KERSAMANAH, KERSAMANAH, GARUT, JAWA BARAT",20,44,175,219
https://kawalpemilu.org#27327,"MEKARSARI, NARINGGUL, CIANJUR, JAWA BARAT",4,54,109,163
https://kawalpemilu.org#27712,"GAJAH MEKAR, KUTAWARINGIN, BANDUNG, JAWA BARAT",24,81,116,197
https://kawalpemilu.org#27412,"CINUNUK, CILEUNYI, BANDUNG, JAWA BARAT",68,57,67,124
https://kawalpemilu.org#28261,"BARUMEKAR, PARUNGPONTENG, TASIKMALAYA, JAWA BARAT",1,57,115,172
https://kawalpemilu.org#31634,"CIKAMPEK UTARA, KOTA BARU, KARAWANG, JAWA BARAT",11,101,110,211
https://kawalpemilu.org#31905,"JAYAGIRI, LEMBANG, BANDUNG BARAT, JAWA BARAT",53,136,117,253
https://kawalpemilu.org#30270,"SUKATALI, SITURAJA, SUMEDANG, JAWA BARAT",5,80,138,218
https://kawalpemilu.org#32405,"BEKASI JAYA, BEKASI TIMUR, KOTA BEKASI, JAWA BARAT",179,103,64,167
https://kawalpemilu.org#31729,"KARANGSATRIA, TAMBUN UTARA, BEKASI, JAWA BARAT",98,67,129,196
https://kawalpemilu.org#32133,"TEGALGUNDIL, BOGOR UTARA, KOTA BOGOR, JAWA BARAT",93,107,132,239
https://kawalpemilu.org#26403,"HAMBARO, NANGGUNG, BOGOR, JAWA BARAT",16,26,142,168
https://kawalpemilu.org#27480,"SUKASARI, PAMEUNGPEUK, BANDUNG, JAWA BARAT",16,55,152,207
https://kawalpemilu.org#28351,"SUKASENANG, TANJUNGJAYA, TASIKMALAYA, JAWA BARAT",3,87,102,189
https://kawalpemilu.org#30554,"CEMPEH, LELEA, INDRAMAYU, JAWA BARAT",9,118,58,176
https://kawalpemilu.org#27604,"BALEENDAH, BALEENDAH, BANDUNG, JAWA BARAT",91,47,115,162
https://kawalpemilu.org#31727,"SRIJAYA, TAMBUN UTARA, BEKASI, JAWA BARAT",18,51,148,199
https://kawalpemilu.org#28441,"SUKAKARSA, SUKARAME, TASIKMALAYA, JAWA BARAT",4,31,129,160
https://kawalpemilu.org#29823,"SURANENGGALA KIDUL, SURANENGGALA, CIREBON, JAWA BARAT",14,117,59,176
https://kawalpemilu.org#27433,"LENGKONG, BOJONGSOANG, BANDUNG, JAWA BARAT",10,44,116,160
https://kawalpemilu.org#27588,"CIKAWAO, PACET, BANDUNG, JAWA BARAT",14,128,65,193
https://kawalpemilu.org#31675,"KERTAMUKTI, CILEBAR, KARAWANG, JAWA BARAT",5,108,102,210
https://kawalpemilu.org#30656,"LOBENER, JATIBARANG, INDRAMAYU, JAWA BARAT",8,114,83,197
https://kawalpemilu.org#31836,"LENGGAHJAYA, CABANGBUNGIN, BEKASI, JAWA BARAT",5,90,155,245
https://kawalpemilu.org#27634,"CIPEDES, PASEH, BANDUNG, JAWA BARAT",19,93,86,179
https://kawalpemilu.org#26482,"PASIR BUNCIR, CARINGIN, BOGOR, JAWA BARAT",7,59,170,229
https://kawalpemilu.org#27588,"CIKAWAO, PACET, BANDUNG, JAWA BARAT",9,104,144,248
https://kawalpemilu.org#27556,"BOJONGLOA, RANCAEKEK, BANDUNG, JAWA BARAT",15,48,148,196
https://kawalpemilu.org#28194,"KERTASARI, CIPATUJAH, TASIKMALAYA, JAWA BARAT",1,58,179,237
https://kawalpemilu.org#31140,"SINDANGKASIH, PURWAKARTA, PURWAKARTA, JAWA BARAT",45,32,136,168
https://kawalpemilu.org#26601,"KALONG II, LEUWISADENG, BOGOR, JAWA BARAT",2,28,131,159
https://kawalpemilu.org#26779,"PULOSARI, KALAPA NUNGGAL, SUKABUMI, JAWA BARAT",29,45,132,177
https://kawalpemilu.org#31762,"CIKARANGKOTA, CIKARANG UTARA, BEKASI, JAWA BARAT",11,51,125,176
https://kawalpemilu.org#30322,"JATISARI, TANJUNGSARI, SUMEDANG, JAWA BARAT",11,61,167,228
https://kawalpemilu.org#31940,"MEKARJAYA, CIKALONGWETAN, BANDUNG BARAT, JAWA BARAT",26,60,54,114
https://kawalpemilu.org#26365,"TAMANSARI, RUMPIN, BOGOR, JAWA BARAT",5,108,84,192
https://kawalpemilu.org#27453,"SANGKANHURIP, KATAPANG, BANDUNG, JAWA BARAT",25,79,119,198
https://kawalpemilu.org#28314,"CIKUBANG, TARAJU, TASIKMALAYA, JAWA BARAT",3,79,154,233
https://kawalpemilu.org#32454,"JATILUHUR, JATIASIH, KOTA BEKASI, JAWA BARAT",65,80,140,220
https://kawalpemilu.org#27605,"ANDIR, BALEENDAH, BANDUNG, JAWA BARAT",76,62,119,181
https://kawalpemilu.org#31729,"KARANGSATRIA, TAMBUN UTARA, BEKASI, JAWA BARAT",53,116,102,218
https://kawalpemilu.org#31145,"MUNJULJAYA, PURWAKARTA, PURWAKARTA, JAWA BARAT",41,54,139,193
https://kawalpemilu.org#28898,"CISAGA, CISAGA, CIAMIS, JAWA BARAT",4,112,95,207
https://kawalpemilu.org#31074,"MANDALAWANGI, SUKASARI, SUBANG, JAWA BARAT",8,134,90,224
https://kawalpemilu.org#29730,"GEBANG, GEBANG, CIREBON, JAWA BARAT",2,160,28,188
https://kawalpemilu.org#32504,"BAKTIJAYA, SUKMAJAYA, KOTA DEPOK, JAWA BARAT",123,131,64,195
https://kawalpemilu.org#30768,"BUGIS, ANJATAN, INDRAMAYU, JAWA BARAT",17,109,57,166
https://kawalpemilu.org#27379,"WALAHIR, LELES, CIANJUR, JAWA BARAT",5,106,70,176
https://kawalpemilu.org#29527,"KONDANGSARI, BEBER, CIREBON, JAWA BARAT",18,57,126,183
https://kawalpemilu.org#28130,"SUKAMULYA, TALEGONG, GARUT, JAWA BARAT",15,31,167,198
https://kawalpemilu.org#31557,"CIWARINGIN, LEMAHABANG, KARAWANG, JAWA BARAT",10,141,109,250
https://kawalpemilu.org#32290,"CARINGIN, BANDUNG KULON, KOTA BANDUNG, JAWA BARAT",5,108,136,244
https://kawalpemilu.org#27549,"MEKARLAKSANA, CIKANCUNG, BANDUNG, JAWA BARAT",13,88,126,214
https://kawalpemilu.org#28407,"PASIRBATANG, MANONJAYA, TASIKMALAYA, JAWA BARAT",1,61,174,235
https://kawalpemilu.org#30751,"ILIR, KANDANGHAUR, INDRAMAYU, JAWA BARAT",1,100,62,162
https://kawalpemilu.org#32240,"HEGARMANAH, CIDADAP, KOTA BANDUNG, JAWA BARAT",60,82,124,206
https://kawalpemilu.org#32538,"CIMPAEUN, TAPOS, KOTA DEPOK, JAWA BARAT",45,33,109,142
https://kawalpemilu.org#26512,"PETIR, DRAMAGA, BOGOR, JAWA BARAT",20,46,170,216
https://kawalpemilu.org#27713,"CILAME, KUTAWARINGIN, BANDUNG, JAWA BARAT",8,155,89,244
https://kawalpemilu.org#27705,"PAMEUNTASAN, KUTAWARINGIN, BANDUNG, JAWA BARAT",14,44,151,195
https://kawalpemilu.org#27530,"PANENJOAN, CICALENGKA, BANDUNG, JAWA BARAT",4,28,145,173
https://kawalpemilu.org#27706,"KOPO, KUTAWARINGIN, BANDUNG, JAWA BARAT",3,64,146,210
https://kawalpemilu.org#27538,"CIARO, NAGREG, BANDUNG, JAWA BARAT",18,37,126,163
https://kawalpemilu.org#26914,"SUKARAJA, SUKARAJA, SUKABUMI, JAWA BARAT",51,36,98,134
https://kawalpemilu.org#28032,"SARIBAKTI, PEUNDEUY, GARUT, JAWA BARAT",14,14,157,171
https://kawalpemilu.org#26293,"WARINGINJAYA, BOJONG GEDE, BOGOR, JAWA BARAT",35,46,99,145
https://kawalpemilu.org#31996,"BATUJAJAR BARAT, BATUJAJAR, BANDUNG BARAT, JAWA BARAT",39,72,149,221
https://kawalpemilu.org#26294,"PABUARAN, BOJONG GEDE, BOGOR, JAWA BARAT",76,96,113,209
https://kawalpemilu.org#27718,"MARGAWATI, GARUT KOTA, GARUT, JAWA BARAT",4,82,86,168
https://kawalpemilu.org#31584,"CIRANGGON, MAJALAYA, KARAWANG, JAWA BARAT",12,71,145,216
https://kawalpemilu.org#31870,"JAYAMUKTI, CIKARANG PUSAT, BEKASI, JAWA BARAT",6,45,185,230
https://kawalpemilu.org#32356,"CISARANTEUN KIDUL, GEDEBAGE, KOTA BANDUNG, JAWA BARAT",9,48,137,185
https://kawalpemilu.org#30595,"TEGALMULYA, KRANGKENG, INDRAMAYU, JAWA BARAT",7,127,26,153
https://kawalpemilu.org#31835,"SETIAJAYA, CABANGBUNGIN, BEKASI, JAWA BARAT",9,42,197,239
https://kawalpemilu.org#32504,"BAKTIJAYA, SUKMAJAYA, KOTA DEPOK, JAWA BARAT",45,83,75,158
https://kawalpemilu.org#28057,"KARYASARI, CIBALONG, GARUT, JAWA BARAT",10,23,89,112
https://kawalpemilu.org#29337,"MEKARSARI, MALEBER, KUNINGAN, JAWA BARAT",6,35,92,127
https://kawalpemilu.org#29774,"JATIPIRING, KARANGWARENG, CIREBON, JAWA BARAT",1,122,57,179
https://kawalpemilu.org#29558,"GIRINATA, DUKUPUNTANG, CIREBON, JAWA BARAT",16,70,78,148
https://kawalpemilu.org#26551,"PASIRGAOK, RANCA BUNGUR, BOGOR, JAWA BARAT",6,98,36,134
https://kawalpemilu.org#28514,"BANYURESMI, SUKAHENING, TASIKMALAYA, JAWA BARAT",8,19,196,215
https://kawalpemilu.org#26330,"CIMANGGU I, CIBUNGBULANG, BOGOR, JAWA BARAT",31,35,117,152
https://kawalpemilu.org#30376,"CILAYUNG, JATINANGOR, SUMEDANG, JAWA BARAT",19,50,81,131
https://kawalpemilu.org#32427,"KAYURINGIN JAYA, BEKASI SELATAN, KOTA BEKASI, JAWA BARAT",76,59,170,229
https://kawalpemilu.org#30567,"WIDASARI, WIDASARI, INDRAMAYU, JAWA BARAT",2,162,32,194
https://kawalpemilu.org#30545,"TUNGGUL PAYUNG, LELEA, INDRAMAYU, JAWA BARAT",11,109,60,169
https://kawalpemilu.org#26594,"CIADEG, CIGOMBONG, BOGOR, JAWA BARAT",24,41,187,228
https://kawalpemilu.org#31206,"MEKARSARI, DARANGDAN, PURWAKARTA, JAWA BARAT",10,37,172,209
https://kawalpemilu.org#31176,"LIUNGGUNUNG, PLERED, PURWAKARTA, JAWA BARAT",10,52,123,175
https://kawalpemilu.org#28757,"BAREGBEG, LAKBOK, CIAMIS, JAWA BARAT",1,109,49,158
https://kawalpemilu.org#28401,"CILANGKAP, MANONJAYA, TASIKMALAYA, JAWA BARAT",1,39,186,225
https://kawalpemilu.org#32405,"BEKASI JAYA, BEKASI TIMUR, KOTA BEKASI, JAWA BARAT",158,59,68,127
https://kawalpemilu.org#28657,"MAPARAH, PANJALU, CIAMIS, JAWA BARAT",1,27,208,235
https://kawalpemilu.org#32429,"BOJONG RAWALUMBU, RAWA LUMBU, KOTA BEKASI, JAWA BARAT",31,93,45,138
https://kawalpemilu.org#27807,"TANJUNG KARYA, SAMARANG, GARUT, JAWA BARAT",10,12,267,279
https://kawalpemilu.org#26276,"PABUARAN, GUNUNG SINDUR, BOGOR, JAWA BARAT",14,142,77,219
https://kawalpemilu.org#32497,"GROGOL, LIMO, KOTA DEPOK, JAWA BARAT",61,80,65,145
https://kawalpemilu.org#32311,"SUKALUYU, CIBEUNYING KALER, KOTA BANDUNG, JAWA BARAT",39,89,122,211
https://kawalpemilu.org#26347,"PAMIJAHAN, PAMIJAHAN, BOGOR, JAWA BARAT",5,41,187,228
https://kawalpemilu.org#30113,"PASIR, PALASAH, MAJALENGKA, JAWA BARAT",2,70,114,184
https://kawalpemilu.org#29011,"DUKUHBADAG, CIBINGBIN, KUNINGAN, JAWA BARAT",9,149,35,184
https://kawalpemilu.org#84887,"CIASEMGIRANG, CIASEM, SUBANG, JAWA BARAT",36,72,104,176
https://kawalpemilu.org#31913,"WANGUNSARI, LEMBANG, BANDUNG BARAT, JAWA BARAT",9,94,147,241
https://kawalpemilu.org#27115,"SUKATARIS, KARANGTENGAH, CIANJUR, JAWA BARAT",27,61,127,188
https://kawalpemilu.org#31431,"SABAJAYA, TIRTAJAYA, KARAWANG, JAWA BARAT",20,0,0,0
https://kawalpemilu.org#27990,"CIKAJANG, CIKAJANG, GARUT, JAWA BARAT",13,63,84,147
https://kawalpemilu.org#28280,"GIRIJAYA, BOJONGASIH, TASIKMALAYA, JAWA BARAT",7,32,172,204
https://kawalpemilu.org#27119,"SUKAMULYA, KARANGTENGAH, CIANJUR, JAWA BARAT",4,71,119,190
https://kawalpemilu.org#26357,"LEUWIBATU, RUMPIN, BOGOR, JAWA BARAT",14,25,106,131
https://kawalpemilu.org#31849,"CILEDUG, SETU, BEKASI, JAWA BARAT",5,39,165,9
https://kawalpemilu.org#26308,"KAREHKEL, LEUWILIANG, BOGOR, JAWA BARAT",11,38,136,174
https://kawalpemilu.org#26531,"LULUT, KLAPANUNGGAL, BOGOR, JAWA BARAT",11,36,100,136
https://kawalpemilu.org#30927,"CICADAS, BINONG, SUBANG, JAWA BARAT",11,63,69,132
https://kawalpemilu.org#26964,"BOJONGSARI, NYALINDUNG, SUKABUMI, JAWA BARAT",10,39,164,203
https://kawalpemilu.org#27230,"CISUJEN, TAKOKAK, CIANJUR, JAWA BARAT",9,117,73,190
https://kawalpemilu.org#32527,"CINERE, CINERE, KOTA DEPOK, JAWA BARAT",35,90,106,196
https://kawalpemilu.org#26580,"SASAKPANJANG, TAJURHALANG, BOGOR, JAWA BARAT",18,68,146,214
https://kawalpemilu.org#26410,"SUKAMAJU, CIGUDEG, BOGOR, JAWA BARAT",7,58,140,198
https://kawalpemilu.org#26158,"BOJONG KULUR, GUNUNG PUTRI, BOGOR, JAWA BARAT",53,54,88,142
https://kawalpemilu.org#27443,"SUKAMENAK, MARGAHAYU, BANDUNG, JAWA BARAT",6,102,65,167
https://kawalpemilu.org#27202,"SUKAJEMBAR, SUKANAGARA, CIANJUR, JAWA BARAT",8,74,53,127
https://kawalpemilu.org#26470,"SUKAMAHI, MEGAMENDUNG, BOGOR, JAWA BARAT",20,40,216,256
https://kawalpemilu.org#26353,"GUNUNGSARI, PAMIJAHAN, BOGOR, JAWA BARAT",12,41,168,209
https://kawalpemilu.org#27642,"KARANGTUNGGAL, PASEH, BANDUNG, JAWA BARAT",7,70,158,228
https://kawalpemilu.org#31080,"WANAJAYA, TAMBAKDAHAN, SUBANG, JAWA BARAT",12,174,16,190
https://kawalpemilu.org#29746,"KEJUDEN, DEPOK, CIREBON, JAWA BARAT",3,113,76,189
https://kawalpemilu.org#31519,"PARAKAN, TIRTAMULYA, KARAWANG, JAWA BARAT",16,124,118,242
https://kawalpemilu.org#27782,"MEKARGALIH, TAROGONG KIDUL, GARUT, JAWA BARAT",21,16,201,217
https://kawalpemilu.org#28715,"SUKAHARJA, RAJADESA, CIAMIS, JAWA BARAT",19,32,137,169
https://kawalpemilu.org#30625,"LOMBANG, JUNTINYUAT, INDRAMAYU, JAWA BARAT",11,120,47,167
https://kawalpemilu.org#26267,"CIDOKOM, GUNUNG SINDUR, BOGOR, JAWA BARAT",20,102,142,244
https://kawalpemilu.org#27681,"LEBAKMUNCANG, CIWIDEY, BANDUNG, JAWA BARAT",13,102,109,211
https://kawalpemilu.org#26782,"WALANG SARI, KALAPA NUNGGAL, SUKABUMI, JAWA BARAT",6,29,118,147
https://kawalpemilu.org#27868,"KERTAJAYA, CIBATU, GARUT, JAWA BARAT",19,30,126,156
https://kawalpemilu.org#27135,"SUKAMULYA, SUKALUYU, CIANJUR, JAWA BARAT",21,53,116,169
https://kawalpemilu.org#26654,"SIRNARESMI, CISOLOK, SUKABUMI, JAWA BARAT",4,56,135,191
https://kawalpemilu.org#30751,"ILIR, KANDANGHAUR, INDRAMAYU, JAWA BARAT",26,89,53,142
https://kawalpemilu.org#32482,"CURUG, CIMANGGIS, KOTA DEPOK, JAWA BARAT",62,72,83,155
https://kawalpemilu.org#28706,"DAYEUHLUHUR, JATINAGARA, CIAMIS, JAWA BARAT",7,36,110,146
https://kawalpemilu.org#30507,"SUKAJATI, HAURGEULIS, INDRAMAYU, JAWA BARAT",15,143,97,240
https://kawalpemilu.org#27155,"CIJEDIL, CUGENANG, CIANJUR, JAWA BARAT",13,69,150,219
https://kawalpemilu.org#29698,"GEGESIK WETAN, GEGESIK, CIREBON, JAWA BARAT",9,94,128,222
https://kawalpemilu.org#31742,"WANASARI, CIBITUNG, BEKASI, JAWA BARAT",36,110,135,245
https://kawalpemilu.org#29785,"KALIWULU, PLERED, CIREBON, JAWA BARAT",12,151,66,217
https://kawalpemilu.org#32109,"TEGALLEGA, BOGOR TENGAH, KOTA BOGOR, JAWA BARAT",50,82,124,206
https://kawalpemilu.org#32416,"KALIABANG TENGAH, BEKASI UTARA, KOTA BEKASI, JAWA BARAT",35,61,166,227
https://kawalpemilu.org#31084,"TAMBAKDAHAN, TAMBAKDAHAN, SUBANG, JAWA BARAT",6,129,29,158
https://kawalpemilu.org#32642,"PURBARATU, PURBARATU, KOTA TASIKMALAYA, JAWA BARAT",9,33,185,218
https://kawalpemilu.org#32384,"KESEPUHAN, LEMAH WUNGKUK, KOTA CIREBON, JAWA BARAT",4,124,93,217
https://kawalpemilu.org#32143,"KEDUNGBADAK, TANAH SAREAL, KOTA BOGOR, JAWA BARAT",4,40,97,137
https://kawalpemilu.org#28333,"KARANGMUKTI, SALAWU, TASIKMALAYA, JAWA BARAT",14,42,119,161
https://kawalpemilu.org#26370,"CURUG, JASINGA, BOGOR, JAWA BARAT",7,13,157,170
https://kawalpemilu.org#32436,"PEJUANG, MEDAN SATRIA, KOTA BEKASI, JAWA BARAT",123,185,6,191
https://kawalpemilu.org#29381,"CIKULAK, WALED, CIREBON, JAWA BARAT",3,80,40,120
https://kawalpemilu.org#27231,"HEGARMANAH, TAKOKAK, CIANJUR, JAWA BARAT",11,62,146,208
https://kawalpemilu.org#29007,"SINDANGJAWA, CIBINGBIN, KUNINGAN, JAWA BARAT",6,98,62,160
https://kawalpemilu.org#29424,"GEMBONGAN, BABAKAN, CIREBON, JAWA BARAT",7,97,40,137
https://kawalpemilu.org#32411,"KRANJI, BEKASI BARAT, KOTA BEKASI, JAWA BARAT",43,88,136,224
https://kawalpemilu.org#28068,"CIKELET, CIKELET, GARUT, JAWA BARAT",6,31,122,153
https://kawalpemilu.org#32558,"SETIAMANAH, CIMAHI TENGAH, KOTA CIMAHI, JAWA BARAT",61,64,130,194
https://kawalpemilu.org#28785,"KERTAHAYU, PAMARICAN, CIAMIS, JAWA BARAT",14,29,94,123
https://kawalpemilu.org#34135,"KARANGKEMBANG, ALIAN, KEBUMEN, JAWA TENGAH",7,120,28,148
https://kawalpemilu.org#41021,"KALISAPU, SLAWI, TEGAL, JAWA TENGAH",19,154,99,253
https://kawalpemilu.org#40721,"KARANGMONCOL, RANDUDONGKAL, PEMALANG, JAWA TENGAH",25,152,53,205
https://kawalpemilu.org#36863,"KEMUNING, NGARGOYOSO, KARANGANYAR, JAWA TENGAH",8,104,74,178
https://kawalpemilu.org#38626,"MEDINI, UNDAAN, KUDUS, JAWA TENGAH",24,141,26,167
https://kawalpemilu.org#35174,"KALIKARUNG, KALIBAWANG, WONOSOBO, JAWA TENGAH",19,133,23,156
https://kawalpemilu.org#41380,"RUNGKANG, LOSARI, BREBES, JAWA TENGAH",20,181,35,216
https://kawalpemilu.org#34642,"PUCANG AGUNG, BAYAN, PURWOREJO, JAWA TENGAH",2,142,35,177
https://kawalpemilu.org#34120,"LUMBU, KUTOWINANGUN, KEBUMEN, JAWA TENGAH",5,132,32,164
https://kawalpemilu.org#36314,"PURON, BULU, SUKOHARJO, JAWA TENGAH",6,163,31,194
https://kawalpemilu.org#36706,"BULUSARI, SLOGOHIMO, WONOGIRI, JAWA TENGAH",13,0,0,0
https://kawalpemilu.org#36592,"PUNDUHSARI, MANYARAN, WONOGIRI, JAWA TENGAH",17,63,27,90
https://kawalpemilu.org#39533,"NGEMPLAK, KANDANGAN, TEMANGGUNG, JAWA TENGAH",4,78,125,203
https://kawalpemilu.org#41067,"WANGANDAWA, TALANG, TEGAL, JAWA TENGAH",1,151,95,246
https://kawalpemilu.org#40789,"KENDALDOYONG, PETARUKAN, PEMALANG, JAWA TENGAH",15,146,9,155
https://kawalpemilu.org#33990,"JOGOSIMO, KLIRONG, KEBUMEN, JAWA TENGAH",2,130,25,155
https://kawalpemilu.org#39371,"PRINGAPUS, PRINGAPUS, SEMARANG, JAWA TENGAH",20,118,15,133
https://kawalpemilu.org#41031,"PENARUKAN, ADIWERNA, TEGAL, JAWA TENGAH",16,135,44,179
https://kawalpemilu.org#38937,"CANDISARI, MRANGGEN, DEMAK, JAWA TENGAH",1,145,61,206
https://kawalpemilu.org#41206,"WARU, BANTARKAWUNG, BREBES, JAWA TENGAH",3,148,48,196
https://kawalpemilu.org#33377,"KEDUNGJATI, BUKATEJA, PURBALINGGA, JAWA TENGAH",16,158,84,242
https://kawalpemilu.org#37323,"CREWEK, KRADENAN, GROBOGAN, JAWA TENGAH",7,198,21,219
https://kawalpemilu.org#38794,"BULU, JEPARA, JEPARA, JAWA TENGAH",8,199,32,231
https://kawalpemilu.org#36971,"KWADUNGAN, KERJO, KARANGANYAR, JAWA TENGAH",7,101,50,151
https://kawalpemilu.org#41402,"BANJARATMA, BULAKAMBA, BREBES, JAWA TENGAH",21,142,38,180
https://kawalpemilu.org#38270,"BUMIMULYO, BATANGAN, PATI, JAWA TENGAH",7,137,34,171
https://kawalpemilu.org#41347,"CIKANDANG, KERSANA, BREBES, JAWA TENGAH",11,127,67,194
https://kawalpemilu.org#37484,"TLOGOMULYO, GUBUG, GROBOGAN, JAWA TENGAH",3,128,46,174
https://kawalpemilu.org#32825,"GINTUNGREJA, GANDRUNGMANGU, CILACAP, JAWA TENGAH",22,105,16,121
https://kawalpemilu.org#41603,"BANDARHARJO, SEMARANG UTARA, KOTA SEMARANG, JAWA TENGAH",11,234,28,262
https://kawalpemilu.org#33189,"TUMIYANG, PEKUNCEN, BANYUMAS, JAWA TENGAH",13,168,43,211
https://kawalpemilu.org#40956,"PENDAWA, LEBAKSIU, TEGAL, JAWA TENGAH",8,135,44,179
https://kawalpemilu.org#40029,"PURWOREJO, RINGINARUM, KENDAL, JAWA TENGAH",4,147,21,168
https://kawalpemilu.org#33058,"ALASMALANG, KEMRANJEN, BANYUMAS, JAWA TENGAH",5,120,50,170
https://kawalpemilu.org#38493,"GUNUNGWUNGKAL, GUNUNGWUNGKAL, PATI, JAWA TENGAH",1,164,19,183
https://kawalpemilu.org#41526,"GAJAHAN, PASAR KLIWON, KOTA SURAKARTA, JAWA TENGAH",10,192,21,213
https://kawalpemilu.org#34159,"KEMBARAN, KEBUMEN, KEBUMEN, JAWA TENGAH",1,114,82,196
https://kawalpemilu.org#39377,"WONOYOSO, PRINGAPUS, SEMARANG, JAWA TENGAH",13,187,56,243
https://kawalpemilu.org#35319,"BOJONG, MUNGKID, MAGELANG, JAWA TENGAH",19,158,66,224
https://kawalpemilu.org#36908,"DAGEN, JATEN, KARANGANYAR, JAWA TENGAH",3,195,43,238
https://kawalpemilu.org#37096,"SRAGEN TENGAH, SRAGEN, SRAGEN, JAWA TENGAH",2,174,51,225
https://kawalpemilu.org#33392,"NANGKOD, KEJOBONG, PURBALINGGA, JAWA TENGAH",5,154,46,200
https://kawalpemilu.org#38480,"MARGOTUHU KIDUL, MARGOYOSO, PATI, JAWA TENGAH",5,111,36,147
https://kawalpemilu.org#40737,"MULYOHARJO, PEMALANG, PEMALANG, JAWA TENGAH",24,151,53,204
https://kawalpemilu.org#34043,"SUMBERJATI, AMBAL, KEBUMEN, JAWA TENGAH",2,184,22,206
https://kawalpemilu.org#38078,"MOJOKERTO, KRAGAN, REMBANG, JAWA TENGAH",1,89,101,190
https://kawalpemilu.org#40922,"HARJOWINANGUN, BALAPULANG, TEGAL, JAWA TENGAH",3,94,81,175
https://kawalpemilu.org#37711,"NGAWEN, NGAWEN, BLORA, JAWA TENGAH",18,138,28,166
https://kawalpemilu.org#36400,"BEKONANG, MOJOLABAN, SUKOHARJO, JAWA TENGAH",7,178,80,258
https://kawalpemilu.org#38660,"JEKULO, JEKULO, KUDUS, JAWA TENGAH",33,135,51,186
https://kawalpemilu.org#41653,"PEDURUNGAN KIDUL, PEDURUNGAN, KOTA SEMARANG, JAWA TENGAH",9,133,101,234
https://kawalpemilu.org#37090,"PURO, KARANGMALANG, SRAGEN, JAWA TENGAH",11,195,45,240
https://kawalpemilu.org#37327,"GRABAGAN, KRADENAN, GROBOGAN, JAWA TENGAH",6,177,37,214
https://kawalpemilu.org#37713,"GEDEBEG, NGAWEN, BLORA, JAWA TENGAH",2,182,16,198
https://kawalpemilu.org#35183,"NGARGORETNO, SALAMAN, MAGELANG, JAWA TENGAH",9,207,15,222
https://kawalpemilu.org#37476,"ROWOSARI, GUBUG, GROBOGAN, JAWA TENGAH",1,138,27,165
https://kawalpemilu.org#36915,"BOLON, COLOMADU, KARANGANYAR, JAWA TENGAH",21,109,139,248
https://kawalpemilu.org#41066,"PACUL, TALANG, TEGAL, JAWA TENGAH",17,108,99,207
https://kawalpemilu.org#36348,"JANGGLENGAN, NGUTER, SUKOHARJO, JAWA TENGAH",7,126,18,144
https://kawalpemilu.org#34177,"PEJAGOAN, PEJAGOAN, KEBUMEN, JAWA TENGAH",1,152,52,204
https://kawalpemilu.org#34155,"ARGOPENI, KEBUMEN, KEBUMEN, JAWA TENGAH",10,93,34,127
https://kawalpemilu.org#36623,"MANJUNG, WONOGIRI, WONOGIRI, JAWA TENGAH",1,92,39,131
https://kawalpemilu.org#40244,"KECEPAK, BATANG, BATANG, JAWA TENGAH",6,187,25,212
https://kawalpemilu.org#38434,"TAJUNGSARI, TLOGOWUNGU, PATI, JAWA TENGAH",5,215,13,228
https://kawalpemilu.org#36280,"GLODOGAN, KLATEN SELATAN, KLATEN, JAWA TENGAH",11,119,60,179
https://kawalpemilu.org#37361,"KROPAK, WIROSARI, GROBOGAN, JAWA TENGAH",5,153,19,172
https://kawalpemilu.org#40161,"TANJUNGSARI, TERSONO, BATANG, JAWA TENGAH",7,86,125,211
https://kawalpemilu.org#41703,"PEDALANGAN, BANYUMANIK, KOTA SEMARANG, JAWA TENGAH",8,178,89,267
https://kawalpemilu.org#40969,"GANTUNGAN, JATINEGARA, TEGAL, JAWA TENGAH",5,95,88,183
https://kawalpemilu.org#37130,"KALIKOBOK, TANON, SRAGEN, JAWA TENGAH",11,93,76,169
https://kawalpemilu.org#41483,"Magersari, MAGELANG SELATAN, KOTA MAGELANG, JAWA TENGAH",3,188,45,233
https://kawalpemilu.org#38521,"TENDAS, TAYU, PATI, JAWA TENGAH",9,192,17,209
https://kawalpemilu.org#38363,"TAMBAHARJO, PATI, PATI, JAWA TENGAH",10,148,66,214
https://kawalpemilu.org#33855,"KUBANG, WANAYASA, BANJARNEGARA, JAWA TENGAH",13,122,14,136
https://kawalpemilu.org#35319,"BOJONG, MUNGKID, MAGELANG, JAWA TENGAH",11,92,110,202
https://kawalpemilu.org#41741,"KROBOKAN, SEMARANG BARAT, KOTA SEMARANG, JAWA TENGAH",14,144,41,185
https://kawalpemilu.org#40405,"KARANGSARI, KARANGANYAR, PEKALONGAN, JAWA TENGAH",8,134,77,211
https://kawalpemilu.org#36946,"WARU, KEBAKKRAMAT, KARANGANYAR, JAWA TENGAH",6,144,50,194
https://kawalpemilu.org#33523,"PEKIRINGAN, KARANGMONCOL, PURBALINGGA, JAWA TENGAH",2,150,50,200
https://kawalpemilu.org#33467,"LAMBUR, MREBET, PURBALINGGA, JAWA TENGAH",8,160,58,218
https://kawalpemilu.org#41189,"BANGBAYANG, BANTARKAWUNG, BREBES, JAWA TENGAH",14,104,71,175
https://kawalpemilu.org#40527,"PAJOMBLANGAN, KEDUNGWUNI, PEKALONGAN, JAWA TENGAH",6,201,27,228
https://kawalpemilu.org#39608,"KARANGTEJO, JUMO, TEMANGGUNG, JAWA TENGAH",5,152,60,212
https://kawalpemilu.org#37161,"JATI, SUMBERLAWANG, SRAGEN, JAWA TENGAH",3,122,30,152
https://kawalpemilu.org#34321,"LOGANDU, KARANGGAYAM, KEBUMEN, JAWA TENGAH",2,139,19,158
https://kawalpemilu.org#36807,"TLOBO, JATIYOSO, KARANGANYAR, JAWA TENGAH",12,62,12,74
https://kawalpemilu.org#41545,"KADIPIRO, BANJARSARI, KOTA SURAKARTA, JAWA TENGAH",7,92,38,130
https://kawalpemilu.org#35561,"KEMBANGKUNING, WINDUSARI, MAGELANG, JAWA TENGAH",5,126,68,194
https://kawalpemilu.org#41386,"KRAKAHAN, TANJUNG, BREBES, JAWA TENGAH",4,172,31,203
https://kawalpemilu.org#87431,"TAMBAKSARI, KEDUNGREJA, CILACAP, JAWA TENGAH",3,113,45,158
https://kawalpemilu.org#39543,"BANJARSARI, KANDANGAN, TEMANGGUNG, JAWA TENGAH",5,140,37,177
https://kawalpemilu.org#36204,"BETENG, JATINOM, KLATEN, JAWA TENGAH",2,165,22,187
https://kawalpemilu.org#41578,"RANDUACIR, ARGOMULYO, KOTA SALATIGA, JAWA TENGAH",11,133,33,166
https://kawalpemilu.org#39251,"TUKANG, PABELAN, SEMARANG, JAWA TENGAH",6,165,36,201
https://kawalpemilu.org#35699,"JEMBUNGAN, BANYUDONO, BOYOLALI, JAWA TENGAH",7,159,42,201
https://kawalpemilu.org#35273,"SUMBER, DUKUN, MAGELANG, JAWA TENGAH",3,214,20,234
https://kawalpemilu.org#39133,"MORODEMAK, BONANG, DEMAK, JAWA TENGAH",4,173,21,194
https://kawalpemilu.org#41036,"TEMBOK LUWUNG, ADIWERNA, TEGAL, JAWA TENGAH",27,73,125,198
https://kawalpemilu.org#34706,"KALIWATUBUMI, BUTUH, PURWOREJO, JAWA TENGAH",7,84,59,143
https://kawalpemilu.org#33593,"DARMA, KERTANEGARA, PURBALINGGA, JAWA TENGAH",1,134,59,193
https://kawalpemilu.org#41179,"INDRAJAYA, SALEM, BREBES, JAWA TENGAH",7,104,79,183
https://kawalpemilu.org#40256,"KASEPUHAN, BATANG, BATANG, JAWA TENGAH",9,181,37,218
https://kawalpemilu.org#39358,"KARANGJATI, BERGAS, SEMARANG, JAWA TENGAH",11,187,42,229
https://kawalpemilu.org#38976,"KALISARI, SAYUNG, DEMAK, JAWA TENGAH",15,174,59,233
https://kawalpemilu.org#37326,"KUWU, KRADENAN, GROBOGAN, JAWA TENGAH",15,170,22,192
https://kawalpemilu.org#34380,"PLUMBON, KARANGSAMBUNG, KEBUMEN, JAWA TENGAH",9,98,13,111
https://kawalpemilu.org#33223,"PASIR LOR, KARANG LEWAS, BANYUMAS, JAWA TENGAH",7,189,68,257
https://kawalpemilu.org#33551,"BOJONGSARI, BOJONGSARI, PURBALINGGA, JAWA TENGAH",14,151,56,207
https://kawalpemilu.org#41185,"WANOJA, SALEM, BREBES, JAWA TENGAH",10,121,69,190
https://kawalpemilu.org#38041,"TASIKAGUNG, REMBANG, REMBANG, JAWA TENGAH",3,141,63,204
https://kawalpemilu.org#34382,"WADASMALANG, KARANGSAMBUNG, KEBUMEN, JAWA TENGAH",3,88,43,131
https://kawalpemilu.org#38922,"KALITENGAH, MRANGGEN, DEMAK, JAWA TENGAH",5,144,59,203
https://kawalpemilu.org#39239,"SURUH, SURUH, SEMARANG, JAWA TENGAH",13,157,87,244
https://kawalpemilu.org#41545,"KADIPIRO, BANJARSARI, KOTA SURAKARTA, JAWA TENGAH",106,125,52,177
https://kawalpemilu.org#36067,"KALIGAWE, PEDAN, KLATEN, JAWA TENGAH",1,180,28,208
https://kawalpemilu.org#39082,"KEDUNGWARU KIDUL, KARANGANYAR, DEMAK, JAWA TENGAH",19,154,30,184
https://kawalpemilu.org#34201,"PENGEMPON, SRUWENG, KEBUMEN, JAWA TENGAH",11,171,28,199
https://kawalpemilu.org#33445,"BABAKAN, KALIMANAH, PURBALINGGA, JAWA TENGAH",17,114,41,155
https://kawalpemilu.org#39305,"LANJAN, SUMOWONO, SEMARANG, JAWA TENGAH",11,189,71,260
https://kawalpemilu.org#33190,"GLEMPANG, PEKUNCEN, BANYUMAS, JAWA TENGAH",1,137,32,169
https://kawalpemilu.org#37521,"JATI, JATI, BLORA, JAWA TENGAH",6,148,29,177
https://kawalpemilu.org#35493,"KLEGEN, GRABAG, MAGELANG, JAWA TENGAH",5,183,13,196
https://kawalpemilu.org#34076,"ROWO, MIRIT, KEBUMEN, JAWA TENGAH",4,120,24,144
https://kawalpemilu.org#41226,"KEDUNGOLENG, PAGUYANGAN, BREBES, JAWA TENGAH",19,128,33,161
https://kawalpemilu.org#37006,"CANGKOL, PLUPUH, SRAGEN, JAWA TENGAH",1,156,35,191
https://kawalpemilu.org#37851,"PINGGAN, BULU, REMBANG, JAWA TENGAH",2,171,37,208
https://kawalpemilu.org#41546,"NUSUKAN, BANJARSARI, KOTA SURAKARTA, JAWA TENGAH",49,114,13,127
https://kawalpemilu.org#38903,"TANJUNG, PAKIS AJI, JEPARA, JAWA TENGAH",14,189,22,211
https://kawalpemilu.org#33238,"SOKARAJA WETAN, SOKARAJA, BANYUMAS, JAWA TENGAH",14,156,31,187
https://kawalpemilu.org#34999,"CANDI, SELOMERTO, WONOSOBO, JAWA TENGAH",3,148,14,162
https://kawalpemilu.org#40770,"KALIGELANG, TAMAN, PEMALANG, JAWA TENGAH",13,111,63,174
https://kawalpemilu.org#87480,"SIDAMUKTI, PATIMUAN, CILACAP, JAWA TENGAH",14,173,24,197
https://kawalpemilu.org#33304,"KARANGNANGKA, KEDUNG BANTENG, BANYUMAS, JAWA TENGAH",1,148,96,244
https://kawalpemilu.org#33578,"PENGADEGAN, PENGADEGAN, PURBALINGGA, JAWA TENGAH",19,183,31,214
https://kawalpemilu.org#40253,"PROYONANGGAN TENGAH, BATANG, BATANG, JAWA TENGAH",13,188,47,235
https://kawalpemilu.org#33920,"BULUREJO, AYAH, KEBUMEN, JAWA TENGAH",5,98,41,139
https://kawalpemilu.org#36509,"SELOMARTO, GIRIWOYO, WONOGIRI, JAWA TENGAH",8,128,39,167
https://kawalpemilu.org#41216,"KALIWADAS, BUMIAYU, BREBES, JAWA TENGAH",20,95,38,133
https://kawalpemilu.org#40533,"PEKAJANGAN, KEDUNGWUNI, PEKALONGAN, JAWA TENGAH",24,69,170,239
https://kawalpemilu.org#33321,"TANJUNG, PURWOKERTO SELATAN, BANYUMAS, JAWA TENGAH",8,98,147,245
https://kawalpemilu.org#36677,"GEDAWUNG, KISMANTORO, WONOGIRI, JAWA TENGAH",4,100,42,142
https://kawalpemilu.org#41843,"PANGGUNG, TEGAL TIMUR, KOTA TEGAL, JAWA TENGAH",77,186,76,262
https://kawalpemilu.org#41037,"ADIWERNA, ADIWERNA, TEGAL, JAWA TENGAH",36,148,32,180
https://kawalpemilu.org#34306,"CANDI, KARANGANYAR, KEBUMEN, JAWA TENGAH",5,151,49,200
https://kawalpemilu.org#35385,"SUKOREJO, KAJORAN, MAGELANG, JAWA TENGAH",1,154,51,205
https://kawalpemilu.org#40897,"SUNIARSIH, BOJONG, TEGAL, JAWA TENGAH",6,68,130,198
https://kawalpemilu.org#36810,"KARANGSARI, JATIYOSO, KARANGANYAR, JAWA TENGAH",3,173,14,187
https://kawalpemilu.org#38705,"COLO, DAWE, KUDUS, JAWA TENGAH",7,105,71,176
https://kawalpemilu.org#34249,"GUMAWANG, KUWARASAN, KEBUMEN, JAWA TENGAH",1,138,36,174
https://kawalpemilu.org#37280,"KRANGGANHARJO, TOROH, GROBOGAN, JAWA TENGAH",5,111,73,184
https://kawalpemilu.org#39880,"BRANGSONG, BRANGSONG, KENDAL, JAWA TENGAH",19,170,35,205
https://kawalpemilu.org#36903,"KALIJIRAK, TASIKMADU, KARANGANYAR, JAWA TENGAH",2,171,22,193
https://kawalpemilu.org#36333,"BANMATI, SUKOHARJO, SUKOHARJO, JAWA TENGAH",8,184,55,239
https://kawalpemilu.org#39648,"KEMLOKO, KRANGGAN, TEMANGGUNG, JAWA TENGAH",3,195,37,232
https://kawalpemilu.org#39720,"NGALIYAN, BEJEN, TEMANGGUNG, JAWA TENGAH",4,150,10,160
https://kawalpemilu.org#33791,"PAWEDEN, KARANGKOBAR, BANJARNEGARA, JAWA TENGAH",6,126,34,160
https://kawalpemilu.org#38861,"PRINGTULIS, NALUMSARI, JEPARA, JAWA TENGAH",2,114,67,181
https://kawalpemilu.org#37169,"NGARGOTIRTO, SUMBERLAWANG, SRAGEN, JAWA TENGAH",9,130,9,139
https://kawalpemilu.org#36932,"JERUKSAWIT, GONDANGREJO, KARANGANYAR, JAWA TENGAH",13,223,36,259
https://kawalpemilu.org#35841,"KEDUNGPILANG, WONOSEGORO, BOYOLALI, JAWA TENGAH",7,150,39,189
https://kawalpemilu.org#39128,"KEMBANGAN, BONANG, DEMAK, JAWA TENGAH",10,154,20,174
https://kawalpemilu.org#91437,"KARANGTALUN, CILACAP UTARA, CILACAP, JAWA TENGAH",31,110,107,217
https://kawalpemilu.org#38035,"NGADEM, REMBANG, REMBANG, JAWA TENGAH",3,107,38,145
https://kawalpemilu.org#41774,"KARANGANYAR, TUGU, KOTA SEMARANG, JAWA TENGAH",10,149,30,179
https://kawalpemilu.org#37387,"TANGGUNGHARJO, GROBOGAN, GROBOGAN, JAWA TENGAH",5,192,33,225
https://kawalpemilu.org#41331,"TERLANGU, BREBES, BREBES, JAWA TENGAH",6,120,49,169
https://kawalpemilu.org#39345,"SAMBIREJO, BRINGIN, SEMARANG, JAWA TENGAH",6,226,9,235
https://kawalpemilu.org#32710,"PEDASONG, ADIPALA, CILACAP, JAWA TENGAH",1,125,85,210
https://kawalpemilu.org#35790,"TANJUNG, KLEGO, BOYOLALI, JAWA TENGAH",8,168,33,201
https://kawalpemilu.org#39806,"KALICES, PATEAN, KENDAL, JAWA TENGAH",2,133,19,152
https://kawalpemilu.org#35961,"KALIKEBO, TRUCUK, KLATEN, JAWA TENGAH",20,173,40,213
https://kawalpemilu.org#41136,"JATIBOGOR, SURADADI, TEGAL, JAWA TENGAH",13,66,143,209
https://kawalpemilu.org#34621,"BANJAREJO, BAYAN, PURWOREJO, JAWA TENGAH",1,103,40,143
https://kawalpemilu.org#41737,"BOJONG SALAMAN, SEMARANG BARAT, KOTA SEMARANG, JAWA TENGAH",8,177,22,199
https://kawalpemilu.org#41386,"KRAKAHAN, TANJUNG, BREBES, JAWA TENGAH",7,143,28,171
https://kawalpemilu.org#39505,"NGIPIK, PRINGSURAT, TEMANGGUNG, JAWA TENGAH",6,180,41,221
https://kawalpemilu.org#36926,"WONOREJO, GONDANGREJO, KARANGANYAR, JAWA TENGAH",16,109,143,252
https://kawalpemilu.org#40067,"SIWATU, WONOTUNGGAL, BATANG, JAWA TENGAH",7,172,57,229
https://kawalpemilu.org#41625,"KALIGAWE, GAYAM SARI, KOTA SEMARANG, JAWA TENGAH",18,209,40,249
https://kawalpemilu.org#37495,"TEGOWANU KULON, TEGOWANU, GROBOGAN, JAWA TENGAH",8,140,42,182
https://kawalpemilu.org#41741,"KROBOKAN, SEMARANG BARAT, KOTA SEMARANG, JAWA TENGAH",30,210,26,236
https://kawalpemilu.org#34636,"KALIMIRU, BAYAN, PURWOREJO, JAWA TENGAH",2,132,70,202
https://kawalpemilu.org#36962,"MUNGGUR, MOJOGEDANG, KARANGANYAR, JAWA TENGAH",9,129,57,186
https://kawalpemilu.org#35162,"SUROYUDAN, SUKOHARJO, WONOSOBO, JAWA TENGAH",6,156,35,191
https://kawalpemilu.org#34928,"BERAN, KEPIL, WONOSOBO, JAWA TENGAH",1,118,79,197
https://kawalpemilu.org#38725,"SUKOSONO, KEDUNG, JEPARA, JAWA TENGAH",11,190,18,208
https://kawalpemilu.org#36652,"SANGGRONG, JATIROTO, WONOGIRI, JAWA TENGAH",5,93,6,99
https://kawalpemilu.org#35314,"PROGOWATI, MUNGKID, MAGELANG, JAWA TENGAH",8,159,35,194
https://kawalpemilu.org#37387,"TANGGUNGHARJO, GROBOGAN, GROBOGAN, JAWA TENGAH",7,145,18,163
https://kawalpemilu.org#37405,"NAMBUHAN, PURWODADI, GROBOGAN, JAWA TENGAH",4,207,19,226
https://kawalpemilu.org#41183,"SALEM, SALEM, BREBES, JAWA TENGAH",4,62,127,189
https://kawalpemilu.org#36393,"JATISOBO, POLOKARTO, SUKOHARJO, JAWA TENGAH",8,152,74,226
https://kawalpemilu.org#33212,"RANCAMAYA, CILONGOK, BANYUMAS, JAWA TENGAH",2,168,55,223
https://kawalpemilu.org#38207,"MINTORAHAYU, WINONG, PATI, JAWA TENGAH",1,166,31,197
https://kawalpemilu.org#41517,"SERENGAN, SERENGAN, KOTA SURAKARTA, JAWA TENGAH",9,153,54,207
https://kawalpemilu.org#33267,"SILADO, SUMBANG, BANYUMAS, JAWA TENGAH",6,116,52,168
https://kawalpemilu.org#40658,"SIKASUR, BELIK, PEMALANG, JAWA TENGAH",32,115,36,151
https://kawalpemilu.org#37889,"WONOKERTO, SALE, REMBANG, JAWA TENGAH",5,114,60,174
https://kawalpemilu.org#33169,"PANINGKABAN, GUMELAR, BANYUMAS, JAWA TENGAH",4,181,22,203
https://kawalpemilu.org#37171,"SONO, MONDOKAN, SRAGEN, JAWA TENGAH",7,143,5,148
https://kawalpemilu.org#35473,"BANDUNGREJO, NGABLAK, MAGELANG, JAWA TENGAH",3,248,8,256
https://kawalpemilu.org#84908,"MERNEK, MAOS, CILACAP, JAWA TENGAH",3,110,58,168
https://kawalpemilu.org#41338,"SONGGOM, SONGGOM, BREBES, JAWA TENGAH",35,117,16,133
https://kawalpemilu.org#36043,"JOMBOR, CEPER, KLATEN, JAWA TENGAH",8,139,47,186
https://kawalpemilu.org#38228,"MOJOAGUNG, PUCAKWANGI, PATI, JAWA TENGAH",7,137,10,147
https://kawalpemilu.org#36482,"JIMBAR, PRACIMANTORO, WONOGIRI, JAWA TENGAH",4,138,50,188
https://kawalpemilu.org#34349,"BONJOK KIDUL, BONOROWO, KEBUMEN, JAWA TENGAH",1,106,57,163
https://kawalpemilu.org#38834,"GELANG, KELING, JEPARA, JAWA TENGAH",1,174,35,209
https://kawalpemilu.org#37483,"RINGINHARJO, GUBUG, GROBOGAN, JAWA TENGAH",2,135,27,162
https://kawalpemilu.org#41407,"CIPELEM, BULAKAMBA, BREBES, JAWA TENGAH",11,124,49,173
https://kawalpemilu.org#33292,"KEBUMEN, BATURADEN, BANYUMAS, JAWA TENGAH",6,177,28,205
https://kawalpemilu.org#40894,"REMBUL, BOJONG, TEGAL, JAWA TENGAH",11,131,20,151
https://kawalpemilu.org#37021,"KREBET, MASARAN, SRAGEN, JAWA TENGAH",19,114,27,141
https://kawalpemilu.org#36494,"TLOGOSARI, GIRITONTRO, WONOGIRI, JAWA TENGAH",7,141,18,159
https://kawalpemilu.org#32691,"MENGANTI, KESUGIHAN, CILACAP, JAWA TENGAH",32,157,61,218
https://kawalpemilu.org#38657,"TERBAN, JEKULO, KUDUS, JAWA TENGAH",19,154,41,195
https://kawalpemilu.org#36055,"TEMUWANGI, PEDAN, KLATEN, JAWA TENGAH",1,186,27,213
https://kawalpemilu.org#37506,"NGAMBAKREJO, TANGGUNGHARJO, GROBOGAN, JAWA TENGAH",2,175,31,206
https://kawalpemilu.org#36609,"SENDANGIJO, SELOGIRI, WONOGIRI, JAWA TENGAH",11,92,6,98
https://kawalpemilu.org#39753,"TIRTOMULYO, PLANTUNGAN, KENDAL, JAWA TENGAH",3,131,47,178
https://kawalpemilu.org#41200,"PANGEBATAN, BANTARKAWUNG, BREBES, JAWA TENGAH",7,65,92,157
https://kawalpemilu.org#40819,"PURWOSARI, COMAL, PEMALANG, JAWA TENGAH",28,129,45,174
https://kawalpemilu.org#36387,"TEPISARI, POLOKARTO, SUKOHARJO, JAWA TENGAH",8,174,10,184
https://kawalpemilu.org#38092,"WORO, KRAGAN, REMBANG, JAWA TENGAH",11,134,25,159
https://kawalpemilu.org#34006,"TAMBAKAGUNG, KLIRONG, KEBUMEN, JAWA TENGAH",3,81,72,153
https://kawalpemilu.org#39411,"LEREP, UNGARAN BARAT, SEMARANG, JAWA TENGAH",8,188,70,258
https://kawalpemilu.org#37784,"KARANGANYAR, TODANAN, BLORA, JAWA TENGAH",2,202,15,217
https://kawalpemilu.org#35762,"WALEN, SIMO, BOYOLALI, JAWA TENGAH",3,175,52,227
https://kawalpemilu.org#41856,"KALIGANGSA, MARGADANA, KOTA TEGAL, JAWA TENGAH",32,82,66,148
https://kawalpemilu.org#37186,"MAJENANG, SUKODONO, SRAGEN, JAWA TENGAH",2,174,43,217
https://kawalpemilu.org#38162,"JATIROTO, KAYEN, PATI, JAWA TENGAH",17,157,34,191
https://kawalpemilu.org#41672,"KALIWIRU, CANDISARI, KOTA SEMARANG, JAWA TENGAH",7,192,54,246
https://kawalpemilu.org#40414,"TAMBAKROTO, KAJEN, PEKALONGAN, JAWA TENGAH",4,142,79,221
https://kawalpemilu.org#40655,"MENDELEM, BELIK, PEMALANG, JAWA TENGAH",42,104,25,129
https://kawalpemilu.org#35648,"BANARAN, BOYOLALI, BOYOLALI, JAWA TENGAH",22,220,37,257
https://kawalpemilu.org#35685,"MANJUNG, SAWIT, BOYOLALI, JAWA TENGAH",6,199,16,215
https://kawalpemilu.org#41657,"KALICARI, PEDURUNGAN, KOTA SEMARANG, JAWA TENGAH",22,188,33,221
https://kawalpemilu.org#35214,"BOROBUDUR, BOROBUDUR, MAGELANG, JAWA TENGAH",14,162,40,202
https://kawalpemilu.org#35680,"GUMUKREJO, TERAS, BOYOLALI, JAWA TENGAH",4,155,31,186
https://kawalpemilu.org#39293,"BEDONO, JAMBU, SEMARANG, JAWA TENGAH",8,188,30,218
https://kawalpemilu.org#34239,"PONDOKGEBANGSARI, KUWARASAN, KEBUMEN, JAWA TENGAH",5,82,66,148
https://kawalpemilu.org#40729,"MANGLI, RANDUDONGKAL, PEMALANG, JAWA TENGAH",4,113,54,167
https://kawalpemilu.org#33287,"PURWOSARI, BATURADEN, BANYUMAS, JAWA TENGAH",2,132,81,213
https://kawalpemilu.org#35248,"PANDANRETNO, SRUMBUNG, MAGELANG, JAWA TENGAH",4,104,62,166
https://kawalpemilu.org#32869,"CIJATI, CIMANGGU, CILACAP, JAWA TENGAH",3,89,105,194
https://kawalpemilu.org#39504,"REJOSARI, PRINGSURAT, TEMANGGUNG, JAWA TENGAH",2,107,140,247
https://kawalpemilu.org#34949,"SAPURAN, SAPURAN, WONOSOBO, JAWA TENGAH",18,160,48,208
https://kawalpemilu.org#41409,"GRINTING, BULAKAMBA, BREBES, JAWA TENGAH",8,119,48,167
https://kawalpemilu.org#34308,"KARANGKEMIRI, KARANGANYAR, KEBUMEN, JAWA TENGAH",4,173,36,209
https://kawalpemilu.org#39855,"BOJA, BOJA, KENDAL, JAWA TENGAH",27,135,57,192
https://kawalpemilu.org#40524,"ROWOCACING, KEDUNGWUNI, PEKALONGAN, JAWA TENGAH",6,203,18,221
https://kawalpemilu.org#38845,"SUKODONO, TAHUNAN, JEPARA, JAWA TENGAH",8,235,24,259
https://kawalpemilu.org#41729,"NGEMPLAK SIMONGAN, SEMARANG BARAT, KOTA SEMARANG, JAWA TENGAH",31,182,68,250
https://kawalpemilu.org#38448,"SUWADUK, WEDARIJAKSA, PATI, JAWA TENGAH",9,161,18,179
https://kawalpemilu.org#36861,"GIRIMULYO, NGARGOYOSO, KARANGANYAR, JAWA TENGAH",6,182,43,225
https://kawalpemilu.org#87405,"BANTARSARI, BANTARSARI, CILACAP, JAWA TENGAH",8,125,44,169
https://kawalpemilu.org#38934,"WRINGINJAJAR, MRANGGEN, DEMAK, JAWA TENGAH",9,143,71,214
https://kawalpemilu.org#38793,"KAUMAN, JEPARA, JEPARA, JAWA TENGAH",4,183,59,242
https://kawalpemilu.org#34386,"BANIORO, KARANGSAMBUNG, KEBUMEN, JAWA TENGAH",5,137,46,183
https://kawalpemilu.org#39232,"KETANGGI, SURUH, SEMARANG, JAWA TENGAH",7,159,22,181
https://kawalpemilu.org#34157,"KALIREJO, KEBUMEN, KEBUMEN, JAWA TENGAH",8,93,83,176
https://kawalpemilu.org#41472,"MALAHAYU, BANJARHARJO, BREBES, JAWA TENGAH",31,158,25,183
https://kawalpemilu.org#33241,"LEMBERANG, SOKARAJA, BANYUMAS, JAWA TENGAH",11,165,50,215
https://kawalpemilu.org#39157,"JUNGSEMI, WEDUNG, DEMAK, JAWA TENGAH",6,142,25,167
https://kawalpemilu.org#37268,"PENAWANGAN, PENAWANGAN, GROBOGAN, JAWA TENGAH",6,159,31,190
https://kawalpemilu.org#37192,"PILANGSARI, GESI, SRAGEN, JAWA TENGAH",7,169,9,178
https://kawalpemilu.org#84920,"PALUGON, WANAREJA, CILACAP, JAWA TENGAH",7,121,91,212
https://kawalpemilu.org#36850,"TAWANGMANGU, TAWANGMANGU, KARANGANYAR, JAWA TENGAH",22,173,28,201
https://kawalpemilu.org#41229,"PAGUYANGAN, PAGUYANGAN, BREBES, JAWA TENGAH",16,63,28,91
https://kawalpemilu.org#34160,"SUMBERADI, KEBUMEN, KEBUMEN, JAWA TENGAH",7,113,47,160
https://kawalpemilu.org#37876,"PANOHAN, GUNEM, REMBANG, JAWA TENGAH",4,127,17,144
https://kawalpemilu.org#37677,"TUTUP, TUNJUNGAN, BLORA, JAWA TENGAH",17,130,17,147
https://kawalpemilu.org#38609,"TANJUNGKARANG, JATI, KUDUS, JAWA TENGAH",20,185,33,218
https://kawalpemilu.org#33970,"TEGALRETNO, PETANAHAN, KEBUMEN, JAWA TENGAH",4,168,42,210
https://kawalpemilu.org#39898,"JENARSARI, GEMUH, KENDAL, JAWA TENGAH",5,138,41,179
https://kawalpemilu.org#41822,"BUARAN KRADENAN, PEKALONGAN SELATAN, KOTA PEKALONGAN, JAWA TENGAH",18,180,75,255
https://kawalpemilu.org#32833,"SIDAREJA, SIDAREJA, CILACAP, JAWA TENGAH",22,108,54,162
https://kawalpemilu.org#36464,"PABELAN, KARTASURA, SUKOHARJO, JAWA TENGAH",10,214,47,261
https://kawalpemilu.org#40924,"KALIWUNGU, BALAPULANG, TEGAL, JAWA TENGAH",11,124,37,161
https://kawalpemilu.org#41625,"KALIGAWE, GAYAM SARI, KOTA SEMARANG, JAWA TENGAH",27,162,12,174
https://kawalpemilu.org#36178,"JURANGJERO, KARANGANOM, KLATEN, JAWA TENGAH",2,125,27,152
https://kawalpemilu.org#35226,"PAKUNDEN, NGLUWAR, MAGELANG, JAWA TENGAH",6,113,35,148
https://kawalpemilu.org#37907,"GILIS, SARANG, REMBANG, JAWA TENGAH",1,60,92,152
https://kawalpemilu.org#36989,"KALIMACAN, KALIJAMBE, SRAGEN, JAWA TENGAH",5,166,43,209
https://kawalpemilu.org#46783,"KEMBANGRINGGIT, PUNGGING, MOJOKERTO, JAWA TIMUR",14,156,52,208
https://kawalpemilu.org#48066,"KLURAHAN, KARTOHARJO, MAGETAN, JAWA TIMUR",2,127,61,188
https://kawalpemilu.org#51556,"PESANGGRAHAN, BATU, KOTA BATU, JAWA TIMUR",31,172,76,248
https://kawalpemilu.org#45366,"KALISAT, SEMPOL, BONDOWOSO, JAWA TIMUR",2,118,79,197
https://kawalpemilu.org#47357,"BENDUNGREJO, BERBEK, NGANJUK, JAWA TIMUR",4,129,34,163
https://kawalpemilu.org#45136,"GOMBENGSARI, KALIPURO, BANYUWANGI, JAWA TIMUR",18,99,95,194
https://kawalpemilu.org#50634,"REK KERREK, PALENGAAN, PAMEKASAN, JAWA TIMUR",29,43,190,233
https://kawalpemilu.org#45785,"KEDUNGCALUK, KREJENGAN, PROBOLINGGO, JAWA TIMUR",2,123,113,236
https://kawalpemilu.org#44349,"PURWOREJO, NGANTANG, MALANG, JAWA TIMUR",13,200,30,230
https://kawalpemilu.org#48088,"BANJAREJO, NGARIBOYO, MAGETAN, JAWA TIMUR",4,116,99,215
https://kawalpemilu.org#50884,"PAKAMBAN LAOK, PRAGAAN, SUMENEP, JAWA TIMUR",7,75,84,159
https://kawalpemilu.org#51124,"KALIOMBO, KOTA, KOTA KEDIRI, JAWA TIMUR",16,146,45,191
https://kawalpemilu.org#44775,"KARANGPRING, SUKORAMBI, JEMBER, JAWA TIMUR",15,133,89,222
https://kawalpemilu.org#47283,"KAYEN, BANDARKEDUNGMULYO, JOMBANG, JAWA TIMUR",17,156,45,201
https://kawalpemilu.org#44081,"BELUNG, PONCOKUSUMO, MALANG, JAWA TIMUR",20,129,70,199
https://kawalpemilu.org#51453,"KREMBANGAN SELATAN, KREMBANGAN, KOTA SURABAYA, JAWA TIMUR",32,134,74,208
https://kawalpemilu.org#51273,"PETAHUNAN, GADINGREJO, KOTA PASURUAN, JAWA TIMUR",16,118,116,234
https://kawalpemilu.org#46242,"KALIPANG, GRATI, PASURUAN, JAWA TIMUR",17,156,58,214
https://kawalpemilu.org#46476,"JANTI, TULANGAN, SIDOARJO, JAWA TIMUR",6,157,44,201
https://kawalpemilu.org#48826,"WOTSOGO, JATIROGO, TUBAN, JAWA TIMUR",2,133,38,171
https://kawalpemilu.org#43498,"POJOK, GARUM, BLITAR, JAWA TIMUR",2,77,37,114
https://kawalpemilu.org#45073,"TAMAN SURUH, GLAGAH, BANYUWANGI, JAWA TIMUR",12,199,32,231
https://kawalpemilu.org#50890,"KARDULUK, PRAGAAN, SUMENEP, JAWA TIMUR",12,92,141,233
https://kawalpemilu.org#47559,"SUKOREJO, REJOSO, NGANJUK, JAWA TIMUR",3,118,81,199
https://kawalpemilu.org#43276,"REJOSARI, KALIDAWIR, TULUNGAGUNG, JAWA TIMUR",12,140,14,154
https://kawalpemilu.org#44354,"SUMBERAGUNG, NGANTANG, MALANG, JAWA TIMUR",8,164,42,206
https://kawalpemilu.org#42822,"NGUNUT, BABADAN, PONOROGO, JAWA TIMUR",2,120,110,230
https://kawalpemilu.org#45104,"BENGKAK, WONGSOREJO, BANYUWANGI, JAWA TIMUR",13,83,106,189
https://kawalpemilu.org#50523,"RAGUNG, PANGARENGAN, SAMPANG, JAWA TIMUR",5,32,211,243
https://kawalpemilu.org#42854,"NGLAYANG, JENANGAN, PONOROGO, JAWA TIMUR",4,142,72,214
https://kawalpemilu.org#49893,"SIDOMUKTI, BUNGAH, GRESIK, JAWA TIMUR",7,94,70,164
https://kawalpemilu.org#51152,"BENDO, KEPANJENKIDUL, KOTA BLITAR, JAWA TIMUR",5,123,57,180
https://kawalpemilu.org#44279,"JEDONG, WAGIR, MALANG, JAWA TIMUR",17,228,28,256
https://kawalpemilu.org#47821,"DUREN, PILANGKENCENG, MADIUN, JAWA TIMUR",9,96,51,147
https://kawalpemilu.org#43408,"BENDOSARI, KADEMANGAN, BLITAR, JAWA TIMUR",4,170,16,186
https://kawalpemilu.org#51489,"DUKUH KUPANG, DUKUHPAKIS, KOTA SURABAYA, JAWA TIMUR",36,166,34,200
https://kawalpemilu.org#42514,"NGRECO, TEGALOMBO, PACITAN, JAWA TIMUR",3,23,153,176
https://kawalpemilu.org#44572,"SUMBEREJO, SUKODONO, LUMAJANG, JAWA TIMUR",7,185,43,228
https://kawalpemilu.org#47821,"DUREN, PILANGKENCENG, MADIUN, JAWA TIMUR",12,107,28,135
https://kawalpemilu.org#46863,"NGROWO, BANGSAL, MOJOKERTO, JAWA TIMUR",9,171,67,238
https://kawalpemilu.org#45085,"PANDEREJO, BANYUWANGI, BANYUWANGI, JAWA TIMUR",8,112,38,150
https://kawalpemilu.org#47523,"BEGADUNG, NGANJUK, NGANJUK, JAWA TIMUR",13,168,18,186
https://kawalpemilu.org#43066,"GAMPING, SURUH, TRENGGALEK, JAWA TIMUR",8,122,59,181
https://kawalpemilu.org#48965,"SUMURGUNG, MONTONG, TUBAN, JAWA TIMUR",16,137,26,163
https://kawalpemilu.org#48992,"RAHAYU, SOKO, TUBAN, JAWA TIMUR",1,109,85,194
https://kawalpemilu.org#49961,"KARANG ANDONG, DRIYOREJO, GRESIK, JAWA TIMUR",7,153,28,181
https://kawalpemilu.org#51004,"PALOLOAN, GAPURA, SUMENEP, JAWA TIMUR",2,111,54,165
https://kawalpemilu.org#51045,"MASAKAMBING, MASALEMBU, SUMENEP, JAWA TIMUR",4,103,26,129
https://kawalpemilu.org#47802,"SUKOREJO, SARADAN, MADIUN, JAWA TIMUR",14,133,50,183
https://kawalpemilu.org#48537,"CANGAKAN, KANOR, BOJONEGORO, JAWA TIMUR",1,46,165,211
https://kawalpemilu.org#45766,"TAMANSARI, KRAKSAAN, PROBOLINGGO, JAWA TIMUR",4,112,78,190
https://kawalpemilu.org#42475,"MLATI, ARJOSARI, PACITAN, JAWA TIMUR",7,53,141,194
https://kawalpemilu.org#50996,"LONGOS, GAPURA, SUMENEP, JAWA TIMUR",12,79,50,129
https://kawalpemilu.org#46399,"DUKUHSARI, JABON, SIDOARJO, JAWA TIMUR",5,158,66,224
https://kawalpemilu.org#89586,"GADUNGAN, WATES, KEDIRI, JAWA TIMUR",6,171,22,193
https://kawalpemilu.org#45764,"ALASSUMUR KULON, KRAKSAAN, PROBOLINGGO, JAWA TIMUR",12,132,64,196
https://kawalpemilu.org#50441,"KALANGAN PRAO, JRENGIK, SAMPANG, JAWA TIMUR",7,57,118,175
https://kawalpemilu.org#87494,"KEBONSARI KULON, KANIGARAN, KOTA PROBOLINGGO, JAWA TIMUR",1,141,119,260
https://kawalpemilu.org#51335,"KANIGORO, KARTOHARJO, KOTA MADIUN, JAWA TIMUR",23,128,63,191
https://kawalpemilu.org#43990,"KRECEK, BADAS, KEDIRI, JAWA TIMUR",15,217,12,229
https://kawalpemilu.org#48262,"PELANG KIDUL, KEDUNGGALAR, NGAWI, JAWA TIMUR",6,156,37,193
https://kawalpemilu.org#50253,"PACANGAN, TRAGAH, BANGKALAN, JAWA TIMUR",3,160,14,174
https://kawalpemilu.org#50105,"DABUNG, GEGER, BANGKALAN, JAWA TIMUR",19,166,30,196
https://kawalpemilu.org#43266,"SUMBERAGUNG, REJOTANGAN, TULUNGAGUNG, JAWA TIMUR",20,107,10,117
https://kawalpemilu.org#51178,"PURWANTORO, BLIMBING, KOTA MALANG, JAWA TIMUR",16,154,76,230
https://kawalpemilu.org#51442,"GUNDIH, BUBUTAN, KOTA SURABAYA, JAWA TIMUR",44,158,76,234
https://kawalpemilu.org#51479,"SEMEMI, BENOWO, KOTA SURABAYA, JAWA TIMUR",57,176,62,238
https://kawalpemilu.org#49328,"NGAYUNG, MADURAN, LAMONGAN, JAWA TIMUR",1,85,32,117
https://kawalpemilu.org#46424,"RANDEGAN, TANGGULANGIN, SIDOARJO, JAWA TIMUR",8,109,56,165
https://kawalpemilu.org#48981,"MENTORO, SOKO, TUBAN, JAWA TIMUR",2,128,62,190
https://kawalpemilu.org#47180,"SEGODOREJO, SUMOBITO, JOMBANG, JAWA TIMUR",16,161,32,193
https://kawalpemilu.org#50832,"ELLAK LAOK, LENTENG, SUMENEP, JAWA TIMUR",1,25,140,165
https://kawalpemilu.org#48449,"BULU, SUGIHWARAS, BOJONEGORO, JAWA TIMUR",2,93,99,192
https://kawalpemilu.org#44422,"TEMPUREJO, TEMPURSARI, LUMAJANG, JAWA TIMUR",2,136,12,148
https://kawalpemilu.org#43605,"RINGINREJO, WATES, BLITAR, JAWA TIMUR",17,202,9,211
https://kawalpemilu.org#50416,"ROHAYU, KEDUNGDUNG, SAMPANG, JAWA TIMUR",14,110,76,186
https://kawalpemilu.org#51474,"LIDAH WETAN, LAKARSANTRI, KOTA SURABAYA, JAWA TIMUR",5,208,37,245
https://kawalpemilu.org#46930,"BERATWETAN, GEDEG, MOJOKERTO, JAWA TIMUR",15,169,21,190
https://kawalpemilu.org#51431,"SIMOLAWANG, SIMOKERTO, KOTA SURABAYA, JAWA TIMUR",29,125,84,209
https://kawalpemilu.org#44401,"KEBOBANG, WONOSARI, MALANG, JAWA TIMUR",25,147,44,191
https://kawalpemilu.org#49456,"BALUNGTAWUN, SUKODADI, LAMONGAN, JAWA TIMUR",2,77,43,120
https://kawalpemilu.org#48793,"SAMBONGREJO, GONDANG, BOJONEGORO, JAWA TIMUR",13,174,29,203
https://kawalpemilu.org#47006,"PAGERWOJO, PERAK, JOMBANG, JAWA TIMUR",12,129,35,164
https://kawalpemilu.org#42935,"TANGGARAN, PULE, TRENGGALEK, JAWA TIMUR",10,197,18,215
https://kawalpemilu.org#45124,"BANGUNSARI, SONGGON, BANYUWANGI, JAWA TIMUR",7,150,40,190
https://kawalpemilu.org#45435,"BUDUAN, SUBOH, SITUBONDO, JAWA TIMUR",13,50,118,168
https://kawalpemilu.org#51329,"ORO-ORO OMBO, KARTOHARJO, KOTA MADIUN, JAWA TIMUR",19,124,51,175
https://kawalpemilu.org#46688,"BAURENO, JATIREJO, MOJOKERTO, JAWA TIMUR",6,157,41,198
https://kawalpemilu.org#47573,"MUSIR LOR, REJOSO, NGANJUK, JAWA TIMUR",3,200,12,212
https://kawalpemilu.org#49920,"BOTENG, MENGANTI, GRESIK, JAWA TIMUR",18,148,53,201
https://kawalpemilu.org#51460,"PEGIRIAN, SEMAMPIR, KOTA SURABAYA, JAWA TIMUR",88,96,140,236
https://kawalpemilu.org#42990,"DUKUH, WATULIMO, TRENGGALEK, JAWA TIMUR",4,120,8,128
https://kawalpemilu.org#45449,"TAMBAK UKIR, KENDIT, SITUBONDO, JAWA TIMUR",1,72,140,212
https://kawalpemilu.org#48667,"PUNGPUNGAN, KALITIDU, BOJONEGORO, JAWA TIMUR",4,144,38,182
https://kawalpemilu.org#45447,"KENDIT, KENDIT, SITUBONDO, JAWA TIMUR",2,97,114,211
https://kawalpemilu.org#46641,"SAWOTRATAP, GEDANGAN, SIDOARJO, JAWA TIMUR",3,148,31,179
https://kawalpemilu.org#49216,"KARANGKEMBANG, BABAT, LAMONGAN, JAWA TIMUR",3,179,39,218
https://kawalpemilu.org#51522,"TANJUNGSARI, SUKOMANUNGGAL, KOTA SURABAYA, JAWA TIMUR",14,172,45,217
https://kawalpemilu.org#47134,"JOMBATAN, JOMBANG, JOMBANG, JAWA TIMUR",3,131,71,202
https://kawalpemilu.org#50633,"BANYUPELLE, PALENGAAN, PAMEKASAN, JAWA TIMUR",11,40,175,215
https://kawalpemilu.org#49881,"NGABETAN, CERME, GRESIK, JAWA TIMUR",6,139,79,218
https://kawalpemilu.org#43887,"PELEM, PARE, KEDIRI, JAWA TIMUR",18,102,57,159
https://kawalpemilu.org#51552,"SONGGOKERTO, BATU, KOTA BATU, JAWA TIMUR",2,166,9,175
https://kawalpemilu.org#45006,"TULUNGREJO, GLENMORE, BANYUWANGI, JAWA TIMUR",9,117,59,176
https://kawalpemilu.org#51553,"NGAGLIK, BATU, KOTA BATU, JAWA TIMUR",11,108,62,170
https://kawalpemilu.org#45131,"TEMUASRI, SEMPU, BANYUWANGI, JAWA TIMUR",29,171,56,227
https://kawalpemilu.org#47629,"DAWUHAN, JATIKALEN, NGANJUK, JAWA TIMUR",4,143,48,191
https://kawalpemilu.org#48546,"SUMBERWANGI, KANOR, BOJONEGORO, JAWA TIMUR",4,88,90,178
https://kawalpemilu.org#51466,"SIDOTOPO WETAN, KENJERAN, KOTA SURABAYA, JAWA TIMUR",29,119,84,203
https://kawalpemilu.org#50887,"PRAGAAN DAYA, PRAGAAN, SUMENEP, JAWA TIMUR",13,81,96,177
https://kawalpemilu.org#46240,"REBALAS, GRATI, PASURUAN, JAWA TIMUR",5,118,85,203
https://kawalpemilu.org#48443,"SIWALAN, SUGIHWARAS, BOJONEGORO, JAWA TIMUR",12,119,38,157
https://kawalpemilu.org#49132,"NGADIREJO, WIDANG, TUBAN, JAWA TIMUR",9,145,37,182
https://kawalpemilu.org#50051,"JADDIH, SOCAH, BANGKALAN, JAWA TIMUR",24,124,102,226
https://kawalpemilu.org#49918,"GADING WATU, MENGANTI, GRESIK, JAWA TIMUR",5,232,18,252
https://kawalpemilu.org#45554,"PATEMON, BUNGATAN, SITUBONDO, JAWA TIMUR",6,67,102,169
https://kawalpemilu.org#45823,"BRUMBUNGAN LOR, GENDING, PROBOLINGGO, JAWA TIMUR",5,124,95,219
https://kawalpemilu.org#48921,"GEMULUNG, KEREK, TUBAN, JAWA TIMUR",14,125,11,136
https://kawalpemilu.org#51429,"KAPASAN, SIMOKERTO, KOTA SURABAYA, JAWA TIMUR",20,189,13,202
https://kawalpemilu.org#47005,"SUMBERAGUNG, PERAK, JOMBANG, JAWA TIMUR",11,118,53,171
https://kawalpemilu.org#46965,"JETIS, JETIS, MOJOKERTO, JAWA TIMUR",9,178,69,247
https://kawalpemilu.org#49671,"BARON, DUKUN, GRESIK, JAWA TIMUR",3,102,86,188
https://kawalpemilu.org#51287,"PURWOREJO, PURWOREJO, KOTA PASURUAN, JAWA TIMUR",23,131,75,206
https://kawalpemilu.org#49185,"SIDODOWO, MODO, LAMONGAN, JAWA TIMUR",10,116,94,210
https://kawalpemilu.org#45384,"TREBUNGAN, TAMAN KROCOK, BONDOWOSO, JAWA TIMUR",4,118,64,182
https://kawalpemilu.org#45737,"KECIK, BESUK, PROBOLINGGO, JAWA TIMUR",9,114,105,219
https://kawalpemilu.org#48177,"KLITIK, GENENG, NGAWI, JAWA TIMUR",1,156,56,212
https://kawalpemilu.org#46691,"GADING, JATIREJO, MOJOKERTO, JAWA TIMUR",4,139,45,184
https://kawalpemilu.org#43484,"JATINOM, KANIGORO, BLITAR, JAWA TIMUR",7,128,38,166
https://kawalpemilu.org#45464,"DAWUHAN, SITUBONDO, SITUBONDO, JAWA TIMUR",29,72,111,183
https://kawalpemilu.org#51455,"PERAK BARAT, KREMBANGAN, KOTA SURABAYA, JAWA TIMUR",36,93,60,153
https://kawalpemilu.org#51537,"BULAK, BULAK, KOTA SURABAYA, JAWA TIMUR",28,170,56,226
https://kawalpemilu.org#48570,"PEKUWON, SUMBEREJO, BOJONEGORO, JAWA TIMUR",2,112,114,226
https://kawalpemilu.org#45650,"TAMBELANG, KRUCIL, PROBOLINGGO, JAWA TIMUR",19,15,79,94
https://kawalpemilu.org#51204,"MADYOPURO, KEDUNGKANDANG, KOTA MALANG, JAWA TIMUR",30,117,107,224
https://kawalpemilu.org#47515,"GANUNG KIDUL, NGANJUK, NGANJUK, JAWA TIMUR",9,149,50,199
https://kawalpemilu.org#49703,"BALONGPANGGANG, BALONGPANGGANG, GRESIK, JAWA TIMUR",8,193,54,247
https://kawalpemilu.org#49569,"JOTOSANUR, TIKUNG, LAMONGAN, JAWA TIMUR",4,113,97,204
https://kawalpemilu.org#51367,"MARGOREJO, WONOCOLO, KOTA SURABAYA, JAWA TIMUR",23,166,81,247
https://kawalpemilu.org#46316,"KALIMATI, TARIK, SIDOARJO, JAWA TIMUR",1,187,44,231
https://kawalpemilu.org#47148,"BANJARDOWO, JOMBANG, JOMBANG, JAWA TIMUR",14,145,23,168
https://kawalpemilu.org#51196,"KOTALAMA, KEDUNGKANDANG, KOTA MALANG, JAWA TIMUR",65,130,69,199
https://kawalpemilu.org#50530,"KARANG PENANG ONJUR, KARANGPENANG, SAMPANG, JAWA TIMUR",25,26,189,215
https://kawalpemilu.org#42603,"NGRAYUN, NGRAYUN, PONOROGO, JAWA TIMUR",22,141,61,202
https://kawalpemilu.org#43997,"KEDUNGSALAM, DONOMULYO, MALANG, JAWA TIMUR",13,118,50,168
https://kawalpemilu.org#46474,"SUMPUT, SIDOARJO, SIDOARJO, JAWA TIMUR",7,127,93,220
https://kawalpemilu.org#46006,"KETANGI REJO, KEJAYAN, PASURUAN, JAWA TIMUR",5,116,111,227
https://kawalpemilu.org#47116,"BULUREJO, DIWEK, JOMBANG, JAWA TIMUR",1,133,62,195
https://kawalpemilu.org#44952,"TEGALDLIMO, TEGALDLIMO, BANYUWANGI, JAWA TIMUR",13,143,47,190
https://kawalpemilu.org#47897,"KUWONHARJO, TAKERAN, MAGETAN, JAWA TIMUR",8,118,86,204
https://kawalpemilu.org#43771,"BANYUANYAR, GURAH, KEDIRI, JAWA TIMUR",3,164,23,187
https://kawalpemilu.org#47675,"JOGODAYUH, GEGER, MADIUN, JAWA TIMUR",2,109,66,175
https://kawalpemilu.org#49806,"GLINDAH, KEDAMEAN, GRESIK, JAWA TIMUR",4,180,68,248
https://kawalpemilu.org#50581,"PAGENDINGAN, GALIS, PAMEKASAN, JAWA TIMUR",10,57,129,186
https://kawalpemilu.org#45681,"RANUWURUNG, GADING, PROBOLINGGO, JAWA TIMUR",7,125,118,243
https://kawalpemilu.org#44614,"PAPRINGAN, KLAKAH, LUMAJANG, JAWA TIMUR",7,68,116,184
https://kawalpemilu.org#43259,"PANJEREJO, REJOTANGAN, TULUNGAGUNG, JAWA TIMUR",16,164,29,193
https://kawalpemilu.org#50751,"PANDIAN, KOTA SUMENEP, SUMENEP, JAWA TIMUR",10,74,98,172
https://kawalpemilu.org#51354,"KEJURON, TAMAN, KOTA MADIUN, JAWA TIMUR",28,163,38,201
https://kawalpemilu.org#42713,"WINONG, JETIS, PONOROGO, JAWA TIMUR",3,138,65,203
https://kawalpemilu.org#51522,"TANJUNGSARI, SUKOMANUNGGAL, KOTA SURABAYA, JAWA TIMUR",4,150,9,159
https://kawalpemilu.org#50567,"DASOK, PADEMAWU, PAMEKASAN, JAWA TIMUR",11,76,145,221
https://kawalpemilu.org#51282,"POHJENTREK, PURWOREJO, KOTA PASURUAN, JAWA TIMUR",9,129,78,207
https://kawalpemilu.org#51157,"TLUMPU, SUKOREJO, KOTA BLITAR, JAWA TIMUR",6,177,45,222
https://kawalpemilu.org#46293,"PATUGURAN, REJOSO, PASURUAN, JAWA TIMUR",4,131,99,230
https://kawalpemilu.org#51212,"BANDUNGREJOSARI, SUKUN, KOTA MALANG, JAWA TIMUR",41,129,90,219
https://kawalpemilu.org#48343,"KASREMAN, KASREMAN, NGAWI, JAWA TIMUR",9,103,18,121
https://kawalpemilu.org#47342,"KEPEL, NGETOS, NGANJUK, JAWA TIMUR",3,163,14,177
https://kawalpemilu.org#50271,"KAJJAN, BLEGA, BANGKALAN, JAWA TIMUR",7,239,41,280
https://kawalpemilu.org#43269,"PAKISREJO, REJOTANGAN, TULUNGAGUNG, JAWA TIMUR",7,134,32,166
https://kawalpemilu.org#44706,"MOJOMULYO, PUGER, JEMBER, JAWA TIMUR",17,169,24,193
https://kawalpemilu.org#48316,"DUMPLENGAN, PITU, NGAWI, JAWA TIMUR",2,102,74,176
https://kawalpemilu.org#43633,"SIDOMULYO, SEMEN, KEDIRI, JAWA TIMUR",9,134,41,175
https://kawalpemilu.org#43846,"PURWODADI, PURWOASRI, KEDIRI, JAWA TIMUR",3,136,34,170
https://kawalpemilu.org#44042,"DAMPIT, DAMPIT, MALANG, JAWA TIMUR",60,124,37,161
https://kawalpemilu.org#45476,"PANJI KIDUL, PANJI, SITUBONDO, JAWA TIMUR",2,92,111,203
https://kawalpemilu.org#49675,"IMA'AN, DUKUN, GRESIK, JAWA TIMUR",4,129,47,176
https://kawalpemilu.org#47652,"BANGUNSARI, DOLOPO, MADIUN, JAWA TIMUR",5,80,84,164
https://kawalpemilu.org#44480,"KABUARAN, KUNIR, LUMAJANG, JAWA TIMUR",8,146,39,185
https://kawalpemilu.org#47826,"GANDUL, PILANGKENCENG, MADIUN, JAWA TIMUR",4,164,52,216
https://kawalpemilu.org#43395,"PURWOKERTO, SRENGAT, BLITAR, JAWA TIMUR",20,108,72,180
https://kawalpemilu.org#50915,"PASONGSONGAN, PASONGSONGAN, SUMENEP, JAWA TIMUR",7,75,91,166
https://kawalpemilu.org#47056,"BARENG, BARENG, JOMBANG, JAWA TIMUR",4,149,14,163
https://kawalpemilu.org#47438,"TRAYANG, NGRONGGOT, NGANJUK, JAWA TIMUR",3,168,9,177
https://kawalpemilu.org#44613,"SUMBERWRINGIN, KLAKAH, LUMAJANG, JAWA TIMUR",10,42,140,182
https://kawalpemilu.org#48151,"JOGOROGO, JOGOROGO, NGAWI, JAWA TIMUR",21,155,38,193
https://kawalpemilu.org#45961,"KRONTO, LUMBANG, PASURUAN, JAWA TIMUR",7,159,46,205
https://kawalpemilu.org#49522,"GEGER, TURI, LAMONGAN, JAWA TIMUR",6,124,60,184
https://kawalpemilu.org#44608,"SALAK, RANDUAGUNG, LUMAJANG, JAWA TIMUR",7,51,155,206
https://kawalpemilu.org#48618,"KEDATON, KAPAS, BOJONEGORO, JAWA TIMUR",10,122,69,191
https://kawalpemilu.org#47768,"BULAKREJO, BALEREJO, MADIUN, JAWA TIMUR",7,120,29,149
https://kawalpemilu.org#51257,"KANIGARAN, KANIGARAN, KOTA PROBOLINGGO, JAWA TIMUR",43,127,149,276
https://kawalpemilu.org#43291,"PAGERSARI, KALIDAWIR, TULUNGAGUNG, JAWA TIMUR",9,109,49,158
https://kawalpemilu.org#47109,"GROBOGAN, MOJOWARNO, JOMBANG, JAWA TIMUR",8,97,22,119
https://kawalpemilu.org#43879,"PARE, PARE, KEDIRI, JAWA TIMUR",13,139,23,162
https://kawalpemilu.org#44848,"KERTOSARI, PAKUSARI, JEMBER, JAWA TIMUR",6,151,33,184
https://kawalpemilu.org#51188,"SUKOHARJO, KLOJEN, KOTA MALANG, JAWA TIMUR",14,101,77,178
https://kawalpemilu.org#48367,"JATIMULYO, TAMBAKREJO, BOJONEGORO, JAWA TIMUR",1,153,19,172
https://kawalpemilu.org#47972,"TURI, PANEKAN, MAGETAN, JAWA TIMUR",1,152,71,223
https://kawalpemilu.org#44992,"PARIJATAH KULON, SRONO, BANYUWANGI, JAWA TIMUR",13,161,59,220
https://kawalpemilu.org#44012,"GAMPINGAN, PAGAK, MALANG, JAWA TIMUR",14,131,27,158
https://kawalpemilu.org#49047,"BANJARARUM, RENGEL, TUBAN, JAWA TIMUR",10,124,57,181
https://kawalpemilu.org#47220,"PULOGEDANG, TEMBELANG, JOMBANG, JAWA TIMUR",6,139,50,189
https://kawalpemilu.org#44669,"KEPANJEN, GUMUKMAS, JEMBER, JAWA TIMUR",9,96,64,160
https://kawalpemilu.org#51489,"DUKUH KUPANG, DUKUHPAKIS, KOTA SURABAYA, JAWA TIMUR",26,156,29,185
https://kawalpemilu.org#46145,"PAJARAN, REMBANG, PASURUAN, JAWA TIMUR",8,81,166,247
https://kawalpemilu.org#50265,"KARANG GAYAM, BLEGA, BANGKALAN, JAWA TIMUR",1,31,185,216
https://kawalpemilu.org#50846,"BANBARU, GILI GINTING, SUMENEP, JAWA TIMUR",4,36,86,122
https://kawalpemilu.org#47651,"MLILIR, DOLOPO, MADIUN, JAWA TIMUR",2,148,67,215
https://kawalpemilu.org#44805,"SEMPUSARI, KALIWATES, JEMBER, JAWA TIMUR",27,122,67,189
https://kawalpemilu.org#47213,"TEMBELANG, TEMBELANG, JOMBANG, JAWA TIMUR",1,133,56,189
https://kawalpemilu.org#47395,"MLANDANGAN, PACE, NGANJUK, JAWA TIMUR",3,141,51,192
https://kawalpemilu.org#51203,"SAWOJAJAR, KEDUNGKANDANG, KOTA MALANG, JAWA TIMUR",71,85,80,165
https://kawalpemilu.org#51425,"KAPASMADYA BARU, TAMBAKSARI, KOTA SURABAYA, JAWA TIMUR",83,74,56,130
https://kawalpemilu.org#43479,"MODANGAN, NGLEGOK, BLITAR, JAWA TIMUR",24,108,28,136
https://kawalpemilu.org#44045,"SRIMULYO, DAMPIT, MALANG, JAWA TIMUR",24,140,8,148
https://kawalpemilu.org#43284,"JABON, KALIDAWIR, TULUNGAGUNG, JAWA TIMUR",5,141,20,161
https://kawalpemilu.org#46947,"MOJODADI, KEMLAGI, MOJOKERTO, JAWA TIMUR",4,211,43,254
https://kawalpemilu.org#51472,"LAKARSANTRI, LAKARSANTRI, KOTA SURABAYA, JAWA TIMUR",18,175,27,202
https://kawalpemilu.org#51211,"KEBONSARI, SUKUN, KOTA MALANG, JAWA TIMUR",5,167,87,254
https://kawalpemilu.org#42993,"NGEMBEL, WATULIMO, TRENGGALEK, JAWA TIMUR",4,121,20,141
https://kawalpemilu.org#44607,"RANUWURUNG, RANDUAGUNG, LUMAJANG, JAWA TIMUR",2,39,154,193
https://kawalpemilu.org#50453,"TAMBELANGAN, TAMBELANGAN, SAMPANG, JAWA TIMUR",10,26,98,124
https://kawalpemilu.org#46799,"WINDUREJO, KUTOREJO, MOJOKERTO, JAWA TIMUR",5,122,86,208
https://kawalpemilu.org#51325,"KEDUNDUNG, MAGERSARI, KOTA MOJOKERTO, JAWA TIMUR",16,144,53,197
https://kawalpemilu.org#44329,"SUMBERNGEPOH, LAWANG, MALANG, JAWA TIMUR",7,117,68,185
https://kawalpemilu.org#48625,"KALIANYAR, KAPAS, BOJONEGORO, JAWA TIMUR",2,136,55,191
https://kawalpemilu.org#48894,"COKROWATI, TAMBAKBOYO, TUBAN, JAWA TIMUR",2,132,57,189
https://kawalpemilu.org#44997,"KEMBIRITAN, GENTENG, BANYUWANGI, JAWA TIMUR",5,149,26,175
https://kawalpemilu.org#49574,"BOTOPUTIH, TIKUNG, LAMONGAN, JAWA TIMUR",4,109,24,133
https://kawalpemilu.org#51291,"NGEMPLAKREJO, PANGGUNGREJO, KOTA PASURUAN, JAWA TIMUR",20,127,56,183
https://kawalpemilu.org#46139,"RACI, BANGIL, PASURUAN, JAWA TIMUR",2,144,105,249
https://kawalpemilu.org#50403,"KAMONDUNG, OMBEN, SAMPANG, JAWA TIMUR",17,1,267,268
https://kawalpemilu.org#50188,"MOROMBUH, KWANYAR, BANGKALAN, JAWA TIMUR",1,103,80,183
https://kawalpemilu.org#47439,"KALIANYAR, NGRONGGOT, NGANJUK, JAWA TIMUR",3,163,29,192
https://kawalpemilu.org#44141,"ARJOWILANGUN, KALIPARE, MALANG, JAWA TIMUR",17,185,23,208
https://kawalpemilu.org#49600,"DLANGGU, DEKET, LAMONGAN, JAWA TIMUR",1,151,74,225
https://kawalpemilu.org#50594,"KOWEL, PAMEKASAN, PAMEKASAN, JAWA TIMUR",14,48,190,238
https://kawalpemilu.org#44523,"BORENG, LUMAJANG, LUMAJANG, JAWA TIMUR",15,40,52,92
https://kawalpemilu.org#51562,"TULUNGREJO, BUMIAJI, KOTA BATU, JAWA TIMUR",8,179,45,224
https://kawalpemilu.org#44135,"KALIPARE, KALIPARE, MALANG, JAWA TIMUR",41,91,42,133
https://kawalpemilu.org#43209,"WONOKROMO, GONDANG, TULUNGAGUNG, JAWA TIMUR",7,141,37,178
https://kawalpemilu.org#47307,"SUDIMORO, MEGALUH, JOMBANG, JAWA TIMUR",7,132,71,203
https://kawalpemilu.org#50107,"GEGER, GEGER, BANGKALAN, JAWA TIMUR",18,150,87,237
https://kawalpemilu.org#49956,"SEGOROMADU, KEBOMAS, GRESIK, JAWA TIMUR",1,153,85,238
https://kawalpemilu.org#50531,"GUNUNG KESAN, KARANGPENANG, SAMPANG, JAWA TIMUR",6,19,155,174
https://kawalpemilu.org#46428,"NGAMPELSARI, CANDI, SIDOARJO, JAWA TIMUR",17,103,105,208
https://kawalpemilu.org#44045,"SRIMULYO, DAMPIT, MALANG, JAWA TIMUR",27,131,42,173
https://kawalpemilu.org#43545,"SUKOSEWU, GANDUSARI, BLITAR, JAWA TIMUR",17,100,9,109
https://kawalpemilu.org#48775,"SITIAJI, SUKOSEWU, BOJONEGORO, JAWA TIMUR",3,134,66,200
https://kawalpemilu.org#44623,"JENGGRONG, RANUYOSO, LUMAJANG, JAWA TIMUR",21,28,73,101
https://kawalpemilu.org#42943,"PANDEAN, DONGKO, TRENGGALEK, JAWA TIMUR",7,149,10,159
https://kawalpemilu.org#44436,"CANDIPURO, CANDIPURO, LUMAJANG, JAWA TIMUR",14,119,46,165
https://kawalpemilu.org#50423,"OMBUL, KEDUNGDUNG, SAMPANG, JAWA TIMUR",3,183,83,236
https://kawalpemilu.org#50701,"BUJUR BARAT, BATUMARMAR, PAMEKASAN, JAWA TIMUR",39,0,164,164
https://kawalpemilu.org#50712,"BUJUR TENGAH, BATUMARMAR, PAMEKASAN, JAWA TIMUR",39,2,170,172
https://kawalpemilu.org#50925,"BRINGIN, DASUK, SUMENEP, JAWA TIMUR",15,49,76,125
https://kawalpemilu.org#44484,"KRATON, YOSOWILANGUN, LUMAJANG, JAWA TIMUR",3,96,100,196
https://kawalpemilu.org#44999,"GENTENGKULON, GENTENG, BANYUWANGI, JAWA TIMUR",9,136,37,173
https://kawalpemilu.org#46497,"GRABAGAN, TULANGAN, SIDOARJO, JAWA TIMUR",19,144,102,246
https://kawalpemilu.org#47922,"KARANGREJO, KAWEDANAN, MAGETAN, JAWA TIMUR",3,185,36,221
https://kawalpemilu.org#45285,"BLINDUNGAN, BONDOWOSO, BONDOWOSO, JAWA TIMUR",16,98,88,186
https://kawalpemilu.org#43763,"NGASEM, GURAH, KEDIRI, JAWA TIMUR",4,162,25,187
https://kawalpemilu.org#44498,"ROWOKANGKUNG, ROWOKANGKUNG, LUMAJANG, JAWA TIMUR",8,155,83,238
https://kawalpemilu.org#44187,"GUNUNGRONGGO, TAJINAN, MALANG, JAWA TIMUR",2,154,71,225
https://kawalpemilu.org#49172,"KUWUREJO, BLULUK, LAMONGAN, JAWA TIMUR",7,160,31,191
https://kawalpemilu.org#47094,"KARANGLO, MOJOWARNO, JOMBANG, JAWA TIMUR",14,147,47,194
https://kawalpemilu.org#43698,"WONOREJO, NGADILUWIH, KEDIRI, JAWA TIMUR",5,146,33,179
https://kawalpemilu.org#47298,"SUMBERMULYO, JOGOROTO, JOMBANG, JAWA TIMUR",24,184,25,209
https://kawalpemilu.org#51394,"PUTAT JAYA, SAWAHAN, KOTA SURABAYA, JAWA TIMUR",8,142,64,206
https://kawalpemilu.org#46112,"GLANGGANG, BEJI, PASURUAN, JAWA TIMUR",8,116,98,214
https://kawalpemilu.org#50003,"PUDAKIT BARAT, SANGKAPURA, GRESIK, JAWA TIMUR",3,63,90,153
https://kawalpemilu.org#42663,"JURUG, SOOKO, PONOROGO, JAWA TIMUR",20,137,39,176
https://kawalpemilu.org#44735,"BALUNGKIDUL, BALUNG, JEMBER, JAWA TIMUR",1,91,73,164
https://kawalpemilu.org#44883,"SUMBERANGET, LEDOKOMBO, JEMBER, JAWA TIMUR",8,88,80,168
https://kawalpemilu.org#50181,"MANDUNG, KOKOP, BANGKALAN, JAWA TIMUR",3,17,258,275
https://kawalpemilu.org#47549,"SUDIMOROHARJO, WILANGAN, NGANJUK, JAWA TIMUR",17,134,26,160
https://kawalpemilu.org#43404,"PANGGUNGDUWET, KADEMANGAN, BLITAR, JAWA TIMUR",1,185,16,201
https://kawalpemilu.org#47942,"SARANGAN, PLAOSAN, MAGETAN, JAWA TIMUR",9,90,101,191
https://kawalpemilu.org#50107,"GEGER, GEGER, BANGKALAN, JAWA TIMUR",23,110,104,214
https://kawalpemilu.org#42691,"GONTOR, MLARAK, PONOROGO, JAWA TIMUR",1,39,195,234
https://kawalpemilu.org#45466,"PATOKAN, SITUBONDO, SITUBONDO, JAWA TIMUR",18,121,88,209
https://kawalpemilu.org#51483,"WIYUNG, WIYUNG, KOTA SURABAYA, JAWA TIMUR",16,161,42,203
https://kawalpemilu.org#49208,"MUNUNGREJO, NGIMBANG, LAMONGAN, JAWA TIMUR",5,154,54,208
https://kawalpemilu.org#43095,"WAJAK LOR, BOYOLANGU, TULUNGAGUNG, JAWA TIMUR",2,163,33,196
https://kawalpemilu.org#44672,"MENAMPU, GUMUKMAS, JEMBER, JAWA TIMUR",30,146,16,162
https://kawalpemilu.org#50442,"KOTAH, JRENGIK, SAMPANG, JAWA TIMUR",14,25,217,242
https://kawalpemilu.org#51115,"NGADIREJO, KOTA, KOTA KEDIRI, JAWA TIMUR",3,147,40,187
https://kawalpemilu.org#44048,"AMADANOM, DAMPIT, MALANG, JAWA TIMUR",14,150,29,179
https://kawalpemilu.org#46805,"SAWO, KUTOREJO, MOJOKERTO, JAWA TIMUR",8,167,50,217
https://kawalpemilu.org#43905,"JERUKGULUNG, KANDANGAN, KEDIRI, JAWA TIMUR",8,182,33,215
https://kawalpemilu.org#42997,"WATUAGUNG, WATULIMO, TRENGGALEK, JAWA TIMUR",3,116,32,148
https://kawalpemilu.org#43471,"KEDAWUNG, NGLEGOK, BLITAR, JAWA TIMUR",3,144,33,177
https://kawalpemilu.org#49268,"SENDANGHARJO, BRONDONG, LAMONGAN, JAWA TIMUR",8,56,160,216
https://kawalpemilu.org#45007,"SUMBERGONDO, GLENMORE, BANYUWANGI, JAWA TIMUR",25,166,34,200
https://kawalpemilu.org#50539,"AMBAT, TLANAKAN, PAMEKASAN, JAWA TIMUR",8,46,149,195
https://kawalpemilu.org#49183,"SAMBANGREJO, MODO, LAMONGAN, JAWA TIMUR",5,94,109,203
https://kawalpemilu.org#50523,"RAGUNG, PANGARENGAN, SAMPANG, JAWA TIMUR",15,100,80,180
https://kawalpemilu.org#47113,"KAYANGAN, DIWEK, JOMBANG, JAWA TIMUR",17,175,26,201
https://kawalpemilu.org#46391,"TROMPOASRI, JABON, SIDOARJO, JAWA TIMUR",13,129,75,204
https://kawalpemilu.org#47592,"BALONGGEBANG, GONDANG, NGANJUK, JAWA TIMUR",23,131,17,148
https://kawalpemilu.org#43554,"TULUNGREJO, GANDUSARI, BLITAR, JAWA TIMUR",5,114,18,132
https://kawalpemilu.org#47957,"PANEKAN, PANEKAN, MAGETAN, JAWA TIMUR",9,164,17,181
https://kawalpemilu.org#49037,"BULUREJO, RENGEL, TUBAN, JAWA TIMUR",1,124,78,202
https://kawalpemilu.org#46757,"LOLAWANG, NGORO, MOJOKERTO, JAWA TIMUR",3,161,57,218
https://kawalpemilu.org#50821,"MONCEK TIMUR, LENTENG, SUMENEP, JAWA TIMUR",6,75,88,163
https://kawalpemilu.org#46057,"NGADIMULYO, SUKOREJO, PASURUAN, JAWA TIMUR",5,121,83,204
https://kawalpemilu.org#42655,"BONDRANG, SAWOO, PONOROGO, JAWA TIMUR",2,107,103,210
https://kawalpemilu.org#44035,"HARJOKUNCARAN, SUMBERMANJING WETAN, MALANG, JAWA TIMUR",7,100,53,153
https://kawalpemilu.org#44579,"KEDUNGJAJANG, KEDUNGJAJANG, LUMAJANG, JAWA TIMUR",6,107,139,246
https://kawalpemilu.org#51425,"KAPASMADYA BARU, TAMBAKSARI, KOTA SURABAYA, JAWA TIMUR",46,126,63,189
https://kawalpemilu.org#45634,"TLOGOSARI, TIRIS, PROBOLINGGO, JAWA TIMUR",9,138,37,175
https://kawalpemilu.org#43002,"SENGON, BENDUNGAN, TRENGGALEK, JAWA TIMUR",4,205,8,213
https://kawalpemilu.org#47160,"MOROSUNGGINGAN, PETERONGAN, JOMBANG, JAWA TIMUR",1,103,45,148
https://kawalpemilu.org#42752,"MUNENG, BALONG, PONOROGO, JAWA TIMUR",1,148,63,211
https://kawalpemilu.org#44733,"BALUNGKULON, BALUNG, JEMBER, JAWA TIMUR",25,140,55,195
https://kawalpemilu.org#44120,"GONDANGLEGI KULON, GONDANGLEGI, MALANG, JAWA TIMUR",25,47,71,118
https://kawalpemilu.org#44784,"JATIMULYO, JENGGAWAH, JEMBER, JAWA TIMUR",17,94,48,142
https://kawalpemilu.org#45391,"PUCANGANOM, JAMBESARI DARUS SHOLAH, BONDOWOSO, JAWA TIMUR",4,44,105,149
https://kawalpemilu.org#44887,"SUMBERSALAK, LEDOKOMBO, JEMBER, JAWA TIMUR",10,145,63,208
https://kawalpemilu.org#58569,"TANJUNG KAPUAS, KAPUAS, SANGGAU, KALIMANTAN BARAT",9,54,189,243
https://kawalpemilu.org#85340,"PEMAWAN, BOYAN TANJUNG, KAPUAS HULU, KALIMANTAN BARAT",2,73,72,145
https://kawalpemilu.org#59974,"PAAL, NANGA PINOH, MELAWI, KALIMANTAN BARAT",8,87,155,242
https://kawalpemilu.org#58798,"MEKAR UTAMA, KENDAWANGAN, KETAPANG, KALIMANTAN BARAT",4,88,87,175
https://kawalpemilu.org#59817,"MORO BETUNG, MERANTI, LANDAK, KALIMANTAN BARAT",2,138,47,185
https://kawalpemilu.org#58751,"KUALA TOLAK, MATAN HILIR UTARA, KETAPANG, KALIMANTAN BARAT",12,105,113,218
https://kawalpemilu.org#58759,"BELABAN, MARAU, KETAPANG, KALIMANTAN BARAT",5,213,10,223
https://kawalpemilu.org#58359,"BATU MAKJAGE, TEBAS, SAMBAS, KALIMANTAN BARAT",10,110,20,130
https://kawalpemilu.org#59772,"SEKENDAL, AIR BESAR, LANDAK, KALIMANTAN BARAT",2,171,28,199
https://kawalpemilu.org#59778,"PAREK, AIR BESAR, LANDAK, KALIMANTAN BARAT",7,186,28,215
https://kawalpemilu.org#59008,"JAIRAN JAYA, SUNGAI MELAYU RAYAK, KETAPANG, KALIMANTAN BARAT",3,174,24,198
https://kawalpemilu.org#58755,"SUNGAI PUTRI, MATAN HILIR UTARA, KETAPANG, KALIMANTAN BARAT",7,67,146,213
https://kawalpemilu.org#60052,"SUKA MAJU, TANAH PINOH, MELAWI, KALIMANTAN BARAT",6,55,87,142
https://kawalpemilu.org#60207,"BATU LAYANG, PONTIANAK UTARA, KOTA PONTIANAK, KALIMANTAN BARAT",67,38,195,233
https://kawalpemilu.org#60364,"PAL SEMBILAN, SUNGAI KAKAP, KUBU RAYA, KALIMANTAN BARAT",21,11,252,263
https://kawalpemilu.org#59639,"BENTENG, TERIAK, BENGKAYANG, KALIMANTAN BARAT",2,106,6,112
https://kawalpemilu.org#58874,"SUNGAI BESAR, MATAN HILIR SELATAN, KETAPANG, KALIMANTAN BARAT",9,21,168,189
https://kawalpemilu.org#60141,"HARAPAN MULIA, SUKADANA, KAYONG UTARA, KALIMANTAN BARAT",4,73,184,257
https://kawalpemilu.org#60229,"BUKIT BATU, SINGKAWANG TENGAH, KOTA SINGKAWANG, KALIMANTAN BARAT",11,65,186,251
https://kawalpemilu.org#59562,"SUNGAI PANGKALAN I, SUNGAI RAYA, BENGKAYANG, KALIMANTAN BARAT",2,54,106,160
https://kawalpemilu.org#60357,"SUNGAI NIPAH, TELUK PAKEDAI, KUBU RAYA, KALIMANTAN BARAT",1,78,103,181
https://kawalpemilu.org#60202,"SUNGAI BELIUNG, PONTIANAK BARAT, KOTA PONTIANAK, KALIMANTAN BARAT",14,27,105,132
https://kawalpemilu.org#59701,"HILIR KANTOR, NGABANG, LANDAK, KALIMANTAN BARAT",36,65,73,138
https://kawalpemilu.org#59811,"AUR SAMPUK, SENGAH TEMILA, LANDAK, KALIMANTAN BARAT",1,160,12,172
https://kawalpemilu.org#60194,"TANJUNG HULU, PONTIANAK TIMUR, KOTA PONTIANAK, KALIMANTAN BARAT",7,54,82,136
https://kawalpemilu.org#60260,"KUALA DUA, SUNGAI RAYA, KUBU RAYA, KALIMANTAN BARAT",70,41,97,138
https://kawalpemilu.org#58524,"JUNGKAT, SIANTAN, MEMPAWAH, KALIMANTAN BARAT",6,73,64,137
https://kawalpemilu.org#59431,"BELIKAI, SEBERUANG, KAPUAS HULU, KALIMANTAN BARAT",3,78,54,132
https://kawalpemilu.org#60252,"SAGATANI, SINGKAWANG SELATAN, KOTA SINGKAWANG, KALIMANTAN BARAT",12,49,2,51
https://kawalpemilu.org#60251,"SEDAU, SINGKAWANG SELATAN, KOTA SINGKAWANG, KALIMANTAN BARAT",13,110,17,127
https://kawalpemilu.org#60063,"NANGA SOKAN, SOKAN, MELAWI, KALIMANTAN BARAT",5,28,92,120
https://kawalpemilu.org#58978,"AIR UPAS, AIR UPAS, KETAPANG, KALIMANTAN BARAT",20,167,25,192
https://kawalpemilu.org#58828,"BAYUN SARI, SUNGAI LAUR, KETAPANG, KALIMANTAN BARAT",4,102,23,125
https://kawalpemilu.org#58630,"MAJEL, BONTI, SANGGAU, KALIMANTAN BARAT",11,127,29,156
https://kawalpemilu.org#58821,"RIAM BUNUT, SUNGAI LAUR, KETAPANG, KALIMANTAN BARAT",4,57,89,146
https://kawalpemilu.org#60202,"SUNGAI BELIUNG, PONTIANAK BARAT, KOTA PONTIANAK, KALIMANTAN BARAT",176,68,182,250
https://kawalpemilu.org#60202,"SUNGAI BELIUNG, PONTIANAK BARAT, KOTA PONTIANAK, KALIMANTAN BARAT",173,31,78,109
https://kawalpemilu.org#59346,"NANGA EMBALOH, EMBALOH HILIR, KAPUAS HULU, KALIMANTAN BARAT",1,79,81,160
https://kawalpemilu.org#59150,"BEKUAN LUYANG, KETUNGAU HULU, SINTANG, KALIMANTAN BARAT",3,208,6,214
https://kawalpemilu.org#85329,"SEMERANTAU, KALIS, KAPUAS HULU, KALIMANTAN BARAT",3,40,53,93
https://kawalpemilu.org#60251,"SEDAU, SINGKAWANG SELATAN, KOTA SINGKAWANG, KALIMANTAN BARAT",89,72,120,192
https://kawalpemilu.org#64110,"SUNGAI  BESAR, BANJARBARU SELATAN, KOTA BANJARBARU, KALIMANTAN SELATAN",37,80,115,195
https://kawalpemilu.org#62058,"KINTAP KECIL, KINTAP, TANAH LAUT, KALIMANTAN SELATAN",5,136,86,220
https://kawalpemilu.org#63515,"TELUK BULUH, BANJANG, HULU SUNGAI UTARA, KALIMANTAN SELATAN",2,35,189,224
https://kawalpemilu.org#63376,"KALUMPANG DALAM, BABIRIK, HULU SUNGAI UTARA, KALIMANTAN SELATAN",1,85,35,120
https://kawalpemilu.org#62304,"SALINO, PULAULAUT TENGAH, KOTABARU, KALIMANTAN SELATAN",2,86,101,187
https://kawalpemilu.org#62370,"GAMBUT BARAT, GAMBUT, BANJAR, KALIMANTAN SELATAN",3,57,149,206
https://kawalpemilu.org#64049,"PEKAPURAN RAYA, BANJARMASIN TIMUR, KOTA BANJARMASIN, KALIMANTAN SELATAN",28,64,130,194
https://kawalpemilu.org#63241,"BANUA BATUNG, PANDAWAN, HULU SUNGAI TENGAH, KALIMANTAN SELATAN",1,21,119,140
https://kawalpemilu.org#62058,"KINTAP KECIL, KINTAP, TANAH LAUT, KALIMANTAN SELATAN",6,100,58,158
https://kawalpemilu.org#63263,"BARABAI UTARA, BARABAI, HULU SUNGAI TENGAH, KALIMANTAN SELATAN",15,15,110,125
https://kawalpemilu.org#63225,"PEMANGKIH, LABUAN AMAS UTARA, HULU SUNGAI TENGAH, KALIMANTAN SELATAN",1,14,144,158
https://kawalpemilu.org#62131,"KAMPUNG BARU, PULAULAUT TANJUNG SELAYAR, KOTABARU, KALIMANTAN SELATAN",3,85,89,174
https://kawalpemilu.org#64089,"GUNTUNG MANGGIS, LANDASAN ULIN, KOTA BANJARBARU, KALIMANTAN SELATAN",3,64,46,110
https://kawalpemilu.org#63231,"SUNGAI BULUH, LABUAN AMAS UTARA, HULU SUNGAI TENGAH, KALIMANTAN SELATAN",9,50,160,210
https://kawalpemilu.org#63114,"TAMBANGAN, DAHA SELATAN, HULU SUNGAI SELATAN, KALIMANTAN SELATAN",19,81,52,133
https://kawalpemilu.org#64029,"MANTUIL, BANJARMASIN SELATAN, KOTA BANJARMASIN, KALIMANTAN SELATAN",25,71,78,149
https://kawalpemilu.org#63163,"BADAUN, DAHA BARAT, HULU SUNGAI SELATAN, KALIMANTAN SELATAN",2,67,91,158
https://kawalpemilu.org#63672,"SIMPUNG LAYUNG, MUARA UYA, TABALONG, KALIMANTAN SELATAN",6,75,71,146
https://kawalpemilu.org#63921,"TUNDI, AWAYAN, BALANGAN, KALIMANTAN SELATAN",1,19,181,200
https://kawalpemilu.org#62503,"PASAR LAMA, SIMPANG EMPAT, BANJAR, KALIMANTAN SELATAN",4,42,131,173
https://kawalpemilu.org#61992,"SARANG HALANG, PELAIHARI, TANAH LAUT, KALIMANTAN SELATAN",1,58,83,141
https://kawalpemilu.org#62666,"JELAPAT I, TAMBAN, BARITO KUALA, KALIMANTAN SELATAN",22,61,118,179
https://kawalpemilu.org#63870,"JUAI, JUAI, BALANGAN, KALIMANTAN SELATAN",1,22,223,245
https://kawalpemilu.org#62177,"KOTABARU HILIR, PULAULAUT UTARA, KOTABARU, KALIMANTAN SELATAN",2,70,136,206
https://kawalpemilu.org#63252,"MASIRAAN, PANDAWAN, HULU SUNGAI TENGAH, KALIMANTAN SELATAN",2,47,138,185
https://kawalpemilu.org#62386,"SUNGAI TANDIPAH, SUNGAI TABUK, BANJAR, KALIMANTAN SELATAN",2,52,133,185
https://kawalpemilu.org#62199,"PANTAI, KELUMPANG SELATAN, KOTABARU, KALIMANTAN SELATAN",2,50,168,218
https://kawalpemilu.org#62247,"PONDOK LABU, PAMUKAN SELATAN, KOTABARU, KALIMANTAN SELATAN",2,156,34,190
https://kawalpemilu.org#64058,"KUIN SELATAN, BANJARMASIN BARAT, KOTA BANJARMASIN, KALIMANTAN SELATAN",17,104,118,222
https://kawalpemilu.org#62308,"PULAUKERAYAAN, PULAULAUT KEPULAUAN, KOTABARU, KALIMANTAN SELATAN",4,168,31,199
https://kawalpemilu.org#62031,"BANYU IRANG, BATI BATI, TANAH LAUT, KALIMANTAN SELATAN",4,57,107,164
https://kawalpemilu.org#63626,"AGUNG, TANJUNG, TABALONG, KALIMANTAN SELATAN",9,39,136,175
https://kawalpemilu.org#63175,"HARUYAN SEBERANG, HARUYAN, HULU SUNGAI TENGAH, KALIMANTAN SELATAN",2,49,146,195
https://kawalpemilu.org#61947,"MENTENG, JEKAN RAYA, KOTA PALANGKARAYA, KALIMANTAN TENGAH",75,118,174,292
https://kawalpemilu.org#61549,"TUMBANG KAJUEI, RUNGAN, GUNUNG MAS, KALIMANTAN TENGAH",1,131,41,174
https://kawalpemilu.org#60675,"MAMBULAU, KAPUAS HILIR, KAPUAS, KALIMANTAN TENGAH",7,21,73,94
https://kawalpemilu.org#60659,"SELAT DALAM, SELAT, KAPUAS, KALIMANTAN TENGAH",31,41,126,167
https://kawalpemilu.org#61961,"MUNGKU BARU, RAKUMPIT, KOTA PALANGKARAYA, KALIMANTAN TENGAH",1,171,29,200
https://kawalpemilu.org#61462,"PURWAREJA, SEMATU JAYA, LAMANDAU, KALIMANTAN TENGAH",1,198,34,232
https://kawalpemilu.org#60537,"BAAMANG BARAT, BAAMANG, KOTAWARINGIN TIMUR, KALIMANTAN TENGAH",8,105,109,214
https://kawalpemilu.org#61931,"PAHANDUT, PAHANDUT, KOTA PALANGKARAYA, KALIMANTAN TENGAH",43,92,76,168
https://kawalpemilu.org#61676,"MINTIN, KAHAYAN HILIR, PULANG PISAU, KALIMANTAN TENGAH",8,64,128,192
https://kawalpemilu.org#60497,"PAHIRANGAN, MENTAYA HULU, KOTAWARINGIN TIMUR, KALIMANTAN TENGAH",1,150,14,164
https://kawalpemilu.org#60419,"DAWAK, KOTAWARINGIN LAMA, KOTAWARINGIN BARAT, KALIMANTAN TENGAH",1,128,59,187
https://kawalpemilu.org#61884,"AMPAH KOTA, DUSUN TENGAH, BARITO TIMUR, KALIMANTAN TENGAH",52,40,110,150
https://kawalpemilu.org#60463,"NATAI KERBAU, PANGKALAN BANTENG, KOTAWARINGIN BARAT, KALIMANTAN TENGAH",2,174,52,226
https://kawalpemilu.org#61933,"LANGKAI, PAHANDUT, KOTA PALANGKARAYA, KALIMANTAN TENGAH",13,123,38,161
https://kawalpemilu.org#61718,"MANGKAHUI, MURUNG, MURUNG RAYA, KALIMANTAN TENGAH",4,60,92,152
https://kawalpemilu.org#61946,"PALANGKA, JEKAN RAYA, KOTA PALANGKARAYA, KALIMANTAN TENGAH",122,36,79,115
https://kawalpemilu.org#60489,"SUNGAI PARING, CEMPAGA, KOTAWARINGIN TIMUR, KALIMANTAN TENGAH",5,100,101,201
https://kawalpemilu.org#61027,"LANJAS, TEWEH TENGAH, BARITO UTARA, KALIMANTAN TENGAH",22,113,36,149
https://kawalpemilu.org#61426,"GUCI, BULIK, LAMANDAU, KALIMANTAN TENGAH",1,93,103,196
https://kawalpemilu.org#60407,"NATAI RAYA, ARUT SELATAN, KOTAWARINGIN BARAT, KALIMANTAN TENGAH",2,157,48,205
https://kawalpemilu.org#65530,"MANGGAR, BALIKPAPAN TIMUR, KOTA BALIKPAPAN, KALIMANTAN TIMUR",100,61,74,135
https://kawalpemilu.org#65571,"BUKUAN, PALARAN, KOTA SAMARINDA, KALIMANTAN TIMUR",41,111,40,151
https://kawalpemilu.org#928241,"MANGKUPALAS, SAMARINDA SEBERANG, KOTA SAMARINDA, KALIMANTAN TIMUR",1,68,127,195
https://kawalpemilu.org#65614,"TEMINDUNG PERMAI, SUNGAI PINANG, KOTA SAMARINDA, KALIMANTAN TIMUR",56,61,68,129
https://kawalpemilu.org#64320,"RAMPAK LAMBUR, TENGGARONG, KUTAI KARTANEGARA, KALIMANTAN TIMUR",1,148,100,248
https://kawalpemilu.org#64490,"SEBEMBAN, MUARA WIS, KUTAI KARTANEGARA, KALIMANTAN TIMUR",2,100,81,181
https://kawalpemilu.org#64313,"MELAYU, TENGGARONG, KUTAI KARTANEGARA, KALIMANTAN TIMUR",24,46,83,129
https://kawalpemilu.org#64144,"TANAH GROGOT, TANAH GROGOT, PASER, KALIMANTAN TIMUR",11,63,145,208
https://kawalpemilu.org#65608,"SUNGAI KAPIH, SAMBUTAN, KOTA SAMARINDA, KALIMANTAN TIMUR",28,110,123,233
https://kawalpemilu.org#64315,"SUKARAME, TENGGARONG, KUTAI KARTANEGARA, KALIMANTAN TIMUR",5,63,154,217
https://kawalpemilu.org#64325,"BELORO, SEBULU, KUTAI KARTANEGARA, KALIMANTAN TIMUR",1,114,71,185
https://kawalpemilu.org#65495,"WARU, WARU, PENAJAM PASER UTARA, KALIMANTAN TIMUR",18,180,47,227
https://kawalpemilu.org#65591,"SIDODAMAI, SAMARINDA ILIR, KOTA SAMARINDA, KALIMANTAN TIMUR",5,75,93,168
https://kawalpemilu.org#65496,"API-API, WARU, PENAJAM PASER UTARA, KALIMANTAN TIMUR",6,103,80,183
https://kawalpemilu.org#65451,"MUKTI LESTARI, KARANGAN, KUTAI TIMUR, KALIMANTAN TIMUR",2,106,30,136
https://kawalpemilu.org#65544,"KARANG JOANG, BALIKPAPAN UTARA, KOTA BALIKPAPAN, KALIMANTAN TIMUR",17,85,68,153
https://kawalpemilu.org#64587,"LABANAN MAKARTI, TELUK BAYUR, BERAU, KALIMANTAN TIMUR",3,101,68,169
https://kawalpemilu.org#64116,"BATU KAJANG, BATU SOPANG, PASER, KALIMANTAN TIMUR",36,86,81,167
https://kawalpemilu.org#65135,"BARONG TONGKOK, BARONG TONGKOK, KUTAI BARAT, KALIMANTAN TIMUR",3,169,35,204
https://kawalpemilu.org#65569,"RAWA MAKMUR, PALARAN, KOTA SAMARINDA, KALIMANTAN TIMUR",41,114,67,181
https://kawalpemilu.org#65584,"DADI MULYA, SAMARINDA ULU, KOTA SAMARINDA, KALIMANTAN TIMUR",18,91,58,149
https://kawalpemilu.org#65605,"KARANG ASAM ILIR, SUNGAI KUNJANG, KOTA SAMARINDA, KALIMANTAN TIMUR",33,64,161,225
https://kawalpemilu.org#65542,"BATU AMPAR, BALIKPAPAN UTARA, KOTA BALIKPAPAN, KALIMANTAN TIMUR",29,154,92,246
https://kawalpemilu.org#65580,"JAWA, SAMARINDA ULU, KOTA SAMARINDA, KALIMANTAN TIMUR",31,142,96,238
https://kawalpemilu.org#65535,"BARU ILIR, BALIKPAPAN BARAT, KOTA BALIKPAPAN, KALIMANTAN TIMUR",1,52,80,132
https://kawalpemilu.org#65610,"MAKROMAN, SAMBUTAN, KOTA SAMARINDA, KALIMANTAN TIMUR",28,199,37,236
https://kawalpemilu.org#65606,"KARANG ANYAR, SUNGAI KUNJANG, KOTA SAMARINDA, KALIMANTAN TIMUR",14,145,64,209
https://kawalpemilu.org#65577,"MESJID, SAMARINDA SEBERANG, KOTA SAMARINDA, KALIMANTAN TIMUR",33,61,130,191
https://kawalpemilu.org#64727,"NUNUKAN TENGAH, NUNUKAN, NUNUKAN, KALIMANTAN UTARA",40,80,60,140
https://kawalpemilu.org#64882,"WA' YAGUNG, KRAYAN TIMUR, NUNUKAN, KALIMANTAN UTARA",1,126,0,126
https://kawalpemilu.org#64989,"LONG NAWANG, KAYAN HULU, MALINAU, KALIMANTAN UTARA",3,273,9,282
https://kawalpemilu.org#65639,"KAMPUNG I SKIP, TARAKAN TENGAH, KOTA TARAKAN, KALIMANTAN UTARA",23,149,77,226
https://kawalpemilu.org#65653,"JUATA LAUT, TARAKAN UTARA, KOTA TARAKAN, KALIMANTAN UTARA",5,147,134,281
https://kawalpemilu.org#64963,"MENTARANG BARU, MENTARANG, MALINAU, KALIMANTAN UTARA",3,154,13,167
https://kawalpemilu.org#25082,"TANJUNGPENDAM, TANJUNG PANDAN, BELITUNG, KEPULAUAN BANGKA BELITUNG",5,145,73,218
https://kawalpemilu.org#25170,"SADAI, TUKAK SADAI, BANGKA SELATAN, KEPULAUAN BANGKA BELITUNG",4,118,71,189
https://kawalpemilu.org#25349,"MEMPAYA, DAMAR, BELITUNG TIMUR, KEPULAUAN BANGKA BELITUNG",1,200,44,244
https://kawalpemilu.org#25087,"MEMBALONG, MEMBALONG, BELITUNG, KEPULAUAN BANGKA BELITUNG",6,131,9,140
https://kawalpemilu.org#25085,"AIR MERBAU, TANJUNG PANDAN, BELITUNG, KEPULAUAN BANGKA BELITUNG",11,155,126,281
https://kawalpemilu.org#25123,"TELADAN, TOBOALI, BANGKA SELATAN, KEPULAUAN BANGKA BELITUNG",28,182,89,271
https://kawalpemilu.org#25252,"BELO LAUT, MUNTOK, BANGKA BARAT, KEPULAUAN BANGKA BELITUNG",17,110,70,180
https://kawalpemilu.org#25376,"RAWA BANGUN, TAMAN SARI, KOTA PANGKALPINANG, KEPULAUAN BANGKA BELITUNG",6,91,117,208
https://kawalpemilu.org#25088,"PERPAT, MEMBALONG, BELITUNG, KEPULAUAN BANGKA BELITUNG",6,122,69,191
https://kawalpemilu.org#25369,"SRIWIJAYA, GIRIMAYA, KOTA PANGKALPINANG, KEPULAUAN BANGKA BELITUNG",7,54,61,115
https://kawalpemilu.org#25763,"TIBAN LAMA, SEKUPANG, KOTA BATAM, KEPULAUAN RIAU",12,107,177,284
https://kawalpemilu.org#25758,"KAMPUNG SERAYA, BATU AMPAR, KOTA BATAM, KEPULAUAN RIAU",27,71,117,188
https://kawalpemilu.org#25815,"SAGULUNG KOTA, SAGULUNG, KOTA BATAM, KEPULAUAN RIAU",34,34,80,114
https://kawalpemilu.org#25755,"TANJUNG SENGKUANG, BATU AMPAR, KOTA BATAM, KEPULAUAN RIAU",24,59,64,123
https://kawalpemilu.org#25743,"SUNGAIRAYA, SINGKEP BARAT, LINGGA, KEPULAUAN RIAU",1,88,45,133
https://kawalpemilu.org#25812,"TEMBESI, SAGULUNG, KOTA BATAM, KEPULAUAN RIAU",39,68,179,247
https://kawalpemilu.org#25552,"TANJUNGBALAI, KARIMUN, KARIMUN, KEPULAUAN RIAU",1,40,117,157
https://kawalpemilu.org#25812,"TEMBESI, SAGULUNG, KOTA BATAM, KEPULAUAN RIAU",80,113,85,198
https://kawalpemilu.org#25821,"KIBING, BATU AJI, KOTA BATAM, KEPULAUAN RIAU",62,166,14,180
https://kawalpemilu.org#25808,"BELIAN, BATAM KOTA, KOTA BATAM, KEPULAUAN RIAU",75,102,128,230
https://kawalpemilu.org#25810,"BALOI PERMAI, BATAM KOTA, KOTA BATAM, KEPULAUAN RIAU",25,72,99,171
https://kawalpemilu.org#25765,"TANJUNG PINGGIR, SEKUPANG, KOTA BATAM, KEPULAUAN RIAU",5,96,106,202
https://kawalpemilu.org#25473,"KAWAL, GUNUNG KIJANG, BINTAN, KEPULAUAN RIAU",8,153,62,215
https://kawalpemilu.org#25761,"TIBAN INDAH, SEKUPANG, KOTA BATAM, KEPULAUAN RIAU",28,62,89,151
https://kawalpemilu.org#24251,"ADI REJO, PEKALONGAN, LAMPUNG TIMUR, LAMPUNG",15,165,61,226
https://kawalpemilu.org#23326,"TANJUNG SENANG, KOTABUMI SELATAN, LAMPUNG UTARA, LAMPUNG",36,52,136,188
https://kawalpemilu.org#24652,"GUNUNG SARI, GUNUNG LABUHAN, WAY KANAN, LAMPUNG",2,27,95,122
https://kawalpemilu.org#23386,"SUKADANA ILIR, BUNGA MAYANG, LAMPUNG UTARA, LAMPUNG",81,109,59,168
https://kawalpemilu.org#23106,"SINAR NEGERI, PUBIAN, LAMPUNG TENGAH, LAMPUNG",1,63,107,170
https://kawalpemilu.org#23766,"DWI WARGA TUNGGAL JAYA, BANJAR AGUNG, TULANG BAWANG, LAMPUNG",17,74,77,151
https://kawalpemilu.org#24366,"SINDANG ANOM, SEKAMPUNG UDIK, LAMPUNG TIMUR, LAMPUNG",12,107,45,152
https://kawalpemilu.org#23826,"PENAWAR JAYA, BANJAR MARGO, TULANG BAWANG, LAMPUNG",9,116,65,181
https://kawalpemilu.org#22577,"SUMBER REJO, TUMIJAJAR, TULANG BAWANG BARAT, LAMPUNG",7,119,83,202
https://kawalpemilu.org#24982,"KEDONDONG, KEDONDONG, PESAWARAN, LAMPUNG",9,141,80,221
https://kawalpemilu.org#24340,"MARGO TOTO, METRO KIBANG, LAMPUNG TIMUR, LAMPUNG",14,183,44,227
https://kawalpemilu.org#24413,"WANA, MELINTING, LAMPUNG TIMUR, LAMPUNG",18,111,32,143
https://kawalpemilu.org#23084,"JATI DATAR MATARAM, BANDAR MATARAM, LAMPUNG TENGAH, LAMPUNG",17,153,46,199
https://kawalpemilu.org#87265,"TANJUNGGADING, KEDAMAIAN, KOTA BANDAR LAMPUNG, LAMPUNG",4,107,99,207
https://kawalpemilu.org#23293,"PADANG RATU, SUNGKAI UTARA, LAMPUNG UTARA, LAMPUNG",103,45,144,189
https://kawalpemilu.org#23915,"TERBAYA, KOTA AGUNG, TANGGAMUS, LAMPUNG",1,54,156,210
https://kawalpemilu.org#928927,"DEWA AGUNG, BAHUGA, WAY KANAN, LAMPUNG",1,33,77,110
https://kawalpemilu.org#24778,"KETEGUHAN, TELUKBETUNG TIMUR, KOTA BANDAR LAMPUNG, LAMPUNG",39,100,126,226
https://kawalpemilu.org#24872,"KAGUNGAN RATU, NEGERI KATON, PESAWARAN, LAMPUNG",5,110,61,171
https://kawalpemilu.org#24492,"NEGERI BARU, BLAMBANGAN UMPU, WAY KANAN, LAMPUNG",15,40,101,3
https://kawalpemilu.org#24489,"SIDOARJO, BLAMBANGAN UMPU, WAY KANAN, LAMPUNG",3,88,138,226
https://kawalpemilu.org#24427,"MULYO SARI, PASIR SAKTI, LAMPUNG TIMUR, LAMPUNG",2,155,40,195
https://kawalpemilu.org#23154,"BUMI NABUNG UTARA, BUMI NABUNG, LAMPUNG TENGAH, LAMPUNG",6,91,38,129
https://kawalpemilu.org#22686,"SIDODADI, SIDOMULYO, LAMPUNG SELATAN, LAMPUNG",10,74,88,162
https://kawalpemilu.org#24361,"MENGANDUNG SARI, SEKAMPUNG UDIK, LAMPUNG TIMUR, LAMPUNG",5,112,81,193
https://kawalpemilu.org#23455,"JAGANG, BLAMBANGAN PAGAR, LAMPUNG UTARA, LAMPUNG",23,123,129,252
https://kawalpemilu.org#23577,"TAPAK SIRING, SUKAU, LAMPUNG BARAT, LAMPUNG",6,41,130,171
https://kawalpemilu.org#23208,"KOTA GAPURA, KOTABUMI, LAMPUNG UTARA, LAMPUNG",122,17,122,139
https://kawalpemilu.org#22451,"TALANG BATU, MESUJI TIMUR, MESUJI, LAMPUNG",7,193,14,207
https://kawalpemilu.org#24448,"LABUHAN RATU III, LABUHAN RATU, LAMPUNG TIMUR, LAMPUNG",5,135,18,153
https://kawalpemilu.org#22689,"SIDOWALUYO, SIDOMULYO, LAMPUNG SELATAN, LAMPUNG",12,185,31,216
https://kawalpemilu.org#22702,"RANGAI TRI TUNGGAL, KATIBUNG, LAMPUNG SELATAN, LAMPUNG",6,93,70,163
https://kawalpemilu.org#24795,"BATU PUTUK, TELUKBETUNG BARAT, KOTA BANDAR LAMPUNG, LAMPUNG",12,177,28,205
https://kawalpemilu.org#24319,"TEGAL GONDO, PURBOLINGGO, LAMPUNG TIMUR, LAMPUNG",5,175,48,223
https://kawalpemilu.org#24614,"KALI PAPAN, NEGERI AGUNG, WAY KANAN, LAMPUNG",20,97,145,242
https://kawalpemilu.org#24636,"TANJUNG TIGA, REBANG TANGKAS, WAY KANAN, LAMPUNG",3,40,106,146
https://kawalpemilu.org#23207,"SRI BASUKI, KOTABUMI, LAMPUNG UTARA, LAMPUNG",163,62,169,231
https://kawalpemilu.org#22409,"SUKAMULYA, BANYUMAS, PRINGSEWU, LAMPUNG",4,107,66,173
https://kawalpemilu.org#24038,"KANOMAN, SEMAKA, TANGGAMUS, LAMPUNG",6,58,61,119
https://kawalpemilu.org#22607,"HAJIMENA, NATAR, LAMPUNG SELATAN, LAMPUNG",2,54,172,226
https://kawalpemilu.org#24808,"SUKABUMI, SUKABUMI, KOTA BANDAR LAMPUNG, LAMPUNG",14,52,106,158
https://kawalpemilu.org#87276,"KOTA KARANG RAYA, TELUKBETUNG TIMUR, KOTA BANDAR LAMPUNG, LAMPUNG",11,63,104,167
https://kawalpemilu.org#24073,"ULU SEMONG, ULU BELU, TANGGAMUS, LAMPUNG",8,136,20,156
https://kawalpemilu.org#88003,"TAMBAHREJO BARAT, GADING REJO, PRINGSEWU, LAMPUNG",2,95,64,159
https://kawalpemilu.org#22576,"MURNI JAYA, TUMIJAJAR, TULANG BAWANG BARAT, LAMPUNG",3,158,117,275
https://kawalpemilu.org#23194,"MUARA AMAN, BUKIT KEMUNING, LAMPUNG UTARA, LAMPUNG",8,0,0,0
https://kawalpemilu.org#24452,"RAJABASA LAMA, LABUHAN RATU, LAMPUNG TIMUR, LAMPUNG",18,81,37,118
https://kawalpemilu.org#23137,"SENDANG BARU, SENDANG AGUNG, LAMPUNG TENGAH, LAMPUNG",6,86,63,149
https://kawalpemilu.org#24955,"KOTA JAWA, PUNDUH PIDADA, PESAWARAN, LAMPUNG",1,87,89,176
https://kawalpemilu.org#22966,"ADI JAYA, TERBANGGI BESAR, LAMPUNG TENGAH, LAMPUNG",14,198,52,250
https://kawalpemilu.org#22912,"KOTA BARU, PADANG RATU, LAMPUNG TENGAH, LAMPUNG",8,121,37,158
https://kawalpemilu.org#24207,"RAJABASA BATANGHARI, SUKADANA, LAMPUNG TIMUR, LAMPUNG",5,125,43,168
https://kawalpemilu.org#22965,"YUKUM JAYA, TERBANGGI BESAR, LAMPUNG TENGAH, LAMPUNG",17,110,132,242
https://kawalpemilu.org#23328,"ALAM JAYA, KOTABUMI SELATAN, LAMPUNG UTARA, LAMPUNG",15,17,96,113
https://kawalpemilu.org#22334,"PRINGSEWU BARAT, PRINGSEWU, PRINGSEWU, LAMPUNG",18,54,79,133
https://kawalpemilu.org#22528,"PENUMANGAN, TULANG BAWANG TENGAH, TULANG BAWANG BARAT, LAMPUNG",2,63,86,149
https://kawalpemilu.org#22364,"SUMBER AGUNG, AMBARAWA, PRINGSEWU, LAMPUNG",22,74,88,162
https://kawalpemilu.org#84826,"TUNGGUL PAWENANG, ADILUWIH, PRINGSEWU, LAMPUNG",1,116,118,234
https://kawalpemilu.org#22641,"SINDANG SARI, TANJUNG BINTANG, LAMPUNG SELATAN, LAMPUNG",9,126,108,234
https://kawalpemilu.org#24350,"NEGERI JEMANTEN, MARGA TIGA, LAMPUNG TIMUR, LAMPUNG",8,96,63,159
https://kawalpemilu.org#24613,"TANJUNG REJO, NEGERI AGUNG, WAY KANAN, LAMPUNG",14,137,54,191
https://kawalpemilu.org#22615,"BUMI SARI, NATAR, LAMPUNG SELATAN, LAMPUNG",22,115,91,206
https://kawalpemilu.org#24899,"KRESNO WIDODO, TEGINENENG, PESAWARAN, LAMPUNG",12,208,36,244
https://kawalpemilu.org#88042,"MULYO ASRI, BUMI AGUNG, LAMPUNG TIMUR, LAMPUNG",7,120,94,214
https://kawalpemilu.org#24784,"SUKARAME II, TELUKBETUNG BARAT, KOTA BANDAR LAMPUNG, LAMPUNG",6,61,137,198
https://kawalpemilu.org#23353,"SEMULI RAYA, ABUNG SEMULI, LAMPUNG UTARA, LAMPUNG",50,102,33,135
https://kawalpemilu.org#24720,"SUKARAME BARU, SUKARAME, KOTA BANDAR LAMPUNG, LAMPUNG",15,69,130,199
https://kawalpemilu.org#24789,"KUPANG TEBA, TELUKBETUNG UTARA, KOTA BANDAR LAMPUNG, LAMPUNG",3,121,47,168
https://kawalpemilu.org#23846,"GEDUNG REJO SAKTI, PENAWAR AJI, TULANG BAWANG, LAMPUNG",1,135,24,159
https://kawalpemilu.org#-990724,"Riyadh, Riyadh, Arab Saudi, Luar Negeri",5,253,392,645
https://kawalpemilu.org#-990464,"Kuala Lumpur, Kuala Lumpur, Malaysia, Luar Negeri",2026,14,29,43
https://kawalpemilu.org#-991304,"Taipei, Taipei, Taiwan, Luar Negeri",18,218,79,297
https://kawalpemilu.org#-990784,"Singapura, Singapura, Singapura, Luar Negeri",40,562,80,642
https://kawalpemilu.org#-990484,"Lima, Lima, Peru, Luar Negeri",1001,21,2,23
https://kawalpemilu.org#-991084,"Johor Bahru, Johor Bahru, Malaysia, Luar Negeri",2235,110,26,136
https://kawalpemilu.org#-990604,"Oslo, Oslo, Norwegia, Luar Negeri",1,124,31,155
https://kawalpemilu.org#-990614,"Ottawa, Ottawa, Kanada, Luar Negeri",1,389,70,459
https://kawalpemilu.org#77090,"DARAME, MOROTAI SELATAN, PULAU MOROTAI, MALUKU UTARA",4,72,98,170
https://kawalpemilu.org#77573,"BOBANEIGO, KAO TELUK, HALMAHERA UTARA, MALUKU UTARA",4,41,90,131
https://kawalpemilu.org#78120,"MAKASSAR TIMUR, KOTA TERNATE TENGAH, KOTA TERNATE, MALUKU UTARA",9,47,86,133
https://kawalpemilu.org#90844,"PELITA, MANGOLI BARAT, KEPULAUAN SULA, MALUKU UTARA",2,91,133,224
https://kawalpemilu.org#77119,"LOU MADORO, MOROTAI SELATAN BARAT, PULAU MOROTAI, MALUKU UTARA",2,176,3,179
https://kawalpemilu.org#77491,"DOKULAMO, GALELA BARAT, HALMAHERA UTARA, MALUKU UTARA",6,80,132,212
https://kawalpemilu.org#78083,"SANGADJI, KOTA TERNATE UTARA, KOTA TERNATE, MALUKU UTARA",12,40,95,135
https://kawalpemilu.org#87934,"GORUGO, MOROTAI JAYA, PULAU MOROTAI, MALUKU UTARA",2,127,3,130
https://kawalpemilu.org#77437,"DORUME, LOLODA UTARA, HALMAHERA UTARA, MALUKU UTARA",1,195,0,195
https://kawalpemilu.org#78118,"SANTIONG, KOTA TERNATE TENGAH, KOTA TERNATE, MALUKU UTARA",3,65,112,177
https://kawalpemilu.org#76379,"HAYA, TEHORU, MALUKU TENGAH, MALUKU",10,44,88,132
https://kawalpemilu.org#76406,"KAILOLO, PULAU HARUKU, MALUKU TENGAH, MALUKU",1,29,196,225
https://kawalpemilu.org#76378,"TEHORU, TEHORU, MALUKU TENGAH, MALUKU",14,45,104,149
https://kawalpemilu.org#77023,"BATU MERAH, SIRIMAU, KOTA AMBON, MALUKU",162,30,102,132
https://kawalpemilu.org#76246,"MASAWOY, AMBALAU, BURU SELATAN, MALUKU",1,57,114,171
https://kawalpemilu.org#76250,"SELASI, AMBALAU, BURU SELATAN, MALUKU",2,15,105,120
https://kawalpemilu.org#76770,"GAH, TUTUK TOLU, SERAM BAGIAN TIMUR, MALUKU",2,95,57,152
https://kawalpemilu.org#76400,"WASSU, PULAU HARUKU, MALUKU TENGAH, MALUKU",1,181,7,188
https://kawalpemilu.org#77023,"BATU MERAH, SIRIMAU, KOTA AMBON, MALUKU",59,25,190,215
https://kawalpemilu.org#76391,"TUHAHA, SAPARUA TIMUR, MALUKU TENGAH, MALUKU",4,208,3,211
https://kawalpemilu.org#76813,"IHA, HUAMUAL, SERAM BAGIAN BARAT, MALUKU",1,53,241,294
https://kawalpemilu.org#76395,"ULLATH, SAPARUA TIMUR, MALUKU TENGAH, MALUKU",4,187,5,192
https://kawalpemilu.org#77023,"BATU MERAH, SIRIMAU, KOTA AMBON, MALUKU",20,26,102,128
https://kawalpemilu.org#76425,"HITULAMA, LEIHITU, MALUKU TENGAH, MALUKU",2,25,91,116
https://kawalpemilu.org#54323,"LENEK, AIKMEL, LOMBOK TIMUR, NUSA TENGGARA BARAT",6,114,47,161
https://kawalpemilu.org#55045,"SESAIT, KAYANGAN, LOMBOK UTARA, NUSA TENGGARA BARAT",10,81,55,136
https://kawalpemilu.org#54293,"MASBAGIK UTARA, MASBAGIK, LOMBOK TIMUR, NUSA TENGGARA BARAT",16,32,202,234
https://kawalpemilu.org#54544,"UMA BERINGIN, UNTER IWES, SUMBAWA, NUSA TENGGARA BARAT",6,42,153,195
https://kawalpemilu.org#54083,"SESELA, GUNUNGSARI, LOMBOK BARAT, NUSA TENGGARA BARAT",22,20,239,259
https://kawalpemilu.org#54644,"KADINDI, PEKAT, DOMPU, NUSA TENGGARA BARAT",4,57,104,161
https://kawalpemilu.org#54419,"STOWE BRANG, UTAN, SUMBAWA, NUSA TENGGARA BARAT",4,127,55,182
https://kawalpemilu.org#54371,"SUNTALANGU, SUWELA, LOMBOK TIMUR, NUSA TENGGARA BARAT",18,58,89,147
https://kawalpemilu.org#927556,"SORI SAKOLO, DOMPU, DOMPU, NUSA TENGGARA BARAT",7,23,169,192
https://kawalpemilu.org#54325,"KALIJAGA, AIKMEL, LOMBOK TIMUR, NUSA TENGGARA BARAT",21,72,119,191
https://kawalpemilu.org#85040,"SUKAMULIA TIMUR, SUKAMULIA, LOMBOK TIMUR, NUSA TENGGARA BARAT",14,73,149,222
https://kawalpemilu.org#54024,"KEBON AYU, GERUNG, LOMBOK BARAT, NUSA TENGGARA BARAT",17,68,79,147
https://kawalpemilu.org#54075,"BAJUR, LABUAPI, LOMBOK BARAT, NUSA TENGGARA BARAT",1,40,179,219
https://kawalpemilu.org#54713,"RENDA, BELO, BIMA, NUSA TENGGARA BARAT",17,15,178,193
https://kawalpemilu.org#54563,"MATA, TARANO, SUMBAWA, NUSA TENGGARA BARAT",7,65,64,129
https://kawalpemilu.org#54928,"AMPENAN TENGAH, AMPENAN, KOTA MATARAM, NUSA TENGGARA BARAT",21,64,202,266
https://kawalpemilu.org#85054,"LENEK PESIRAMAN, AIKMEL, LOMBOK TIMUR, NUSA TENGGARA BARAT",13,76,107,183
https://kawalpemilu.org#85053,"LENEK BARU, AIKMEL, LOMBOK TIMUR, NUSA TENGGARA BARAT",8,108,47,155
https://kawalpemilu.org#85084,"PAOK LOMBOK, SURALAGA, LOMBOK TIMUR, NUSA TENGGARA BARAT",2,74,127,201
https://kawalpemilu.org#55001,"JATIBARU, ASAKOTA, KOTA BIMA, NUSA TENGGARA BARAT",18,25,148,173
https://kawalpemilu.org#54931,"TAMAN SARI, AMPENAN, KOTA MATARAM, NUSA TENGGARA BARAT",8,76,127,203
https://kawalpemilu.org#54172,"KUTA, PUJUT, LOMBOK TENGAH, NUSA TENGGARA BARAT",24,112,111,223
https://kawalpemilu.org#87728,"PESANGGRAHAN, MONTONG GADING, LOMBOK TIMUR, NUSA TENGGARA BARAT",2,48,105,6
https://kawalpemilu.org#55032,"SIGAR PENJALIN, TANJUNG, LOMBOK UTARA, NUSA TENGGARA BARAT",6,78,65,143
https://kawalpemilu.org#54930,"AMPENAN UTARA, AMPENAN, KOTA MATARAM, NUSA TENGGARA BARAT",16,42,125,167
https://kawalpemilu.org#92048,"TANAK RARANG, PRAYA BARAT, LOMBOK TENGAH, NUSA TENGGARA BARAT",4,22,158,180
https://kawalpemilu.org#55030,"JENGGALA, TANJUNG, LOMBOK UTARA, NUSA TENGGARA BARAT",18,97,67,164
https://kawalpemilu.org#54663,"LEPADI, PAJO, DOMPU, NUSA TENGGARA BARAT",3,56,166,222
https://kawalpemilu.org#87690,"GEGELANG, LINGSAR, LOMBOK BARAT, NUSA TENGGARA BARAT",11,22,117,139
https://kawalpemilu.org#54513,"KARANG DIMA, LABUHAN BADAS, SUMBAWA, NUSA TENGGARA BARAT",14,108,94,202
https://kawalpemilu.org#85088,"MAMBEN BARU, WANASABA, LOMBOK TIMUR, NUSA TENGGARA BARAT",6,76,53,129
https://kawalpemilu.org#85000,"BAGIK POLAK BARAT, LABUAPI, LOMBOK BARAT, NUSA TENGGARA BARAT",3,19,155,174
https://kawalpemilu.org#54082,"MIDANG, GUNUNGSARI, LOMBOK BARAT, NUSA TENGGARA BARAT",8,65,132,197
https://kawalpemilu.org#85046,"TEKO, PRINGGABAYA, LOMBOK TIMUR, NUSA TENGGARA BARAT",10,63,121,184
https://kawalpemilu.org#54171,"REMBITAN, PUJUT, LOMBOK TENGAH, NUSA TENGGARA BARAT",24,15,134,149
https://kawalpemilu.org#54414,"JURAN ALAS, ALAS, SUMBAWA, NUSA TENGGARA BARAT",14,101,52,153
https://kawalpemilu.org#54318,"POHGADING, PRINGGABAYA, LOMBOK TIMUR, NUSA TENGGARA BARAT",16,31,162,193
https://kawalpemilu.org#54323,"LENEK, AIKMEL, LOMBOK TIMUR, NUSA TENGGARA BARAT",11,107,83,190
https://kawalpemilu.org#54392,"RENSING, SAKRA BARAT, LOMBOK TIMUR, NUSA TENGGARA BARAT",8,123,92,215
https://kawalpemilu.org#55039,"REMPEK, GANGGA, LOMBOK UTARA, NUSA TENGGARA BARAT",8,27,181,208
https://kawalpemilu.org#85255,"GOLO WONTONG, LAMBA LEDA, MANGGARAI TIMUR, NUSA TENGGARA TIMUR",2,158,14,172
https://kawalpemilu.org#57270,"PABERA MANERA, PABERIWAI, SUMBA TIMUR, NUSA TENGGARA TIMUR",3,97,8,105
https://kawalpemilu.org#58062,"SIKUMANA, MAULAFA, KOTA KUPANG, NUSA TENGGARA TIMUR",25,245,13,258
https://kawalpemilu.org#57628,"SERUBEBA, ROTE TIMUR, ROTE NDAO, NUSA TENGGARA TIMUR",2,180,7,187
https://kawalpemilu.org#57897,"MADERI, UMBU RATU NGGAY BARAT, SUMBA TENGAH, NUSA TENGGARA TIMUR",4,135,6,141
https://kawalpemilu.org#57563,"OEBOU, ROTE BARAT DAYA, ROTE NDAO, NUSA TENGGARA TIMUR",3,85,3,88
https://kawalpemilu.org#56029,"BABOTIN SELATAN, BOTIN LEO BELE, MALAKA, NUSA TENGGARA TIMUR",1,198,23,221
https://kawalpemilu.org#56679,"ZOZOZEA, NANGAPANDA, ENDE, NUSA TENGGARA TIMUR",2,147,12,159
https://kawalpemilu.org#55171,"CAMPLONG I, FATULEU, KUPANG, NUSA TENGGARA TIMUR",2,203,33,236
https://kawalpemilu.org#56725,"ONELAKO, NDONA, ENDE, NUSA TENGGARA TIMUR",5,142,21,163
https://kawalpemilu.org#58004,"WALLA NDIMU, KODI BANGEDO, SUMBA BARAT DAYA, NUSA TENGGARA TIMUR",1,159,12,171
https://kawalpemilu.org#56612,"WURING, ALOK BARAT, SIKKA, NUSA TENGGARA TIMUR",7,207,7,214
https://kawalpemilu.org#55865,"KABUNA, KAKULUK MESAK, BELU, NUSA TENGGARA TIMUR",12,75,33,108
https://kawalpemilu.org#57544,"WULANDONI, WULANDONI, LEMBATA, NUSA TENGGARA TIMUR",2,121,7,128
https://kawalpemilu.org#56157,"DAPITAU, ALOR TENGAH UTARA, ALOR, NUSA TENGGARA TIMUR",1,172,15,187
https://kawalpemilu.org#55606,"BINAUS, MOLLO TENGAH, TIMOR TENGAH SELATAN, NUSA TENGGARA TIMUR",3,165,8,173
https://kawalpemilu.org#55914,"LASAEN, MALAKA BARAT, MALAKA, NUSA TENGGARA TIMUR",1,126,10,136
https://kawalpemilu.org#58221,"MEBBA, SABU BARAT, SABU RAIJUA, NUSA TENGGARA TIMUR",1,163,17,180
https://kawalpemilu.org#85266,"MOKEL MORID, KOTA KOMBA, MANGGARAI TIMUR, NUSA TENGGARA TIMUR",2,168,26,194
https://kawalpemilu.org#930814,"SATAR TACIK, LANGKE REMBONG, MANGGARAI, NUSA TENGGARA TIMUR",6,289,14,303
https://kawalpemilu.org#57070,"WUDI, CIBAL, MANGGARAI, NUSA TENGGARA TIMUR",5,86,5,91
https://kawalpemilu.org#58077,"TUAK DAUN MERAH, OEBOBO, KOTA KUPANG, NUSA TENGGARA TIMUR",20,117,23,140
https://kawalpemilu.org#55569,"NOEBANA, NOEBANA, TIMOR TENGAH SELATAN, NUSA TENGGARA TIMUR",3,157,7,164
https://kawalpemilu.org#58062,"SIKUMANA, MAULAFA, KOTA KUPANG, NUSA TENGGARA TIMUR",8,182,1,183
https://kawalpemilu.org#55949,"TENUKIIK, KOTA ATAMBUA, BELU, NUSA TENGGARA TIMUR",7,171,19,190
https://kawalpemilu.org#931346,"LOLEOEN, LOBALAIN, ROTE NDAO, NUSA TENGGARA TIMUR",1,128,2,130
https://kawalpemilu.org#57414,"BABOKERONG, NAGA WUTUNG, LEMBATA, NUSA TENGGARA TIMUR",2,129,55,184
https://kawalpemilu.org#57096,"ROBEK, REOK, MANGGARAI, NUSA TENGGARA TIMUR",4,174,4,178
https://kawalpemilu.org#56527,"LUSITADA, NITA, SIKKA, NUSA TENGGARA TIMUR",5,176,3,179
https://kawalpemilu.org#87833,"LENTANG, LELAK, MANGGARAI, NUSA TENGGARA TIMUR",4,94,2,96
https://kawalpemilu.org#92254,"BEA PAWE, GOLEWA BARAT, NGADA, NUSA TENGGARA TIMUR",3,81,2,83
https://kawalpemilu.org#57161,"URANG, LELAK, MANGGARAI, NUSA TENGGARA TIMUR",1,90,3,93
https://kawalpemilu.org#56597,"REROROJA, MAGEPANDA, SIKKA, NUSA TENGGARA TIMUR",3,202,5,207
https://kawalpemilu.org#91062,"NIFUKANI, AMANUBAN BARAT, TIMOR TENGAH SELATAN, NUSA TENGGARA TIMUR",4,237,16,253
https://kawalpemilu.org#58069,"OESAPA SELATAN, KELAPA LIMA, KOTA KUPANG, NUSA TENGGARA TIMUR",11,115,1,116
https://kawalpemilu.org#57181,"NAPU, HAHARU, SUMBA TIMUR, NUSA TENGGARA TIMUR",1,164,9,173
https://kawalpemilu.org#57729,"GOLO NDOAL, MBELILING, MANGGARAI BARAT, NUSA TENGGARA TIMUR",3,101,3,104
https://kawalpemilu.org#927717,"FAITWOSUR, AYAMARU TIMUR SELATAN, MAYBRAT, PAPUA BARAT",1,183,0,183
https://kawalpemilu.org#82942,"DABATAN, MISOOL SELATAN, RAJA AMPAT, PAPUA BARAT",1,125,112,237
https://kawalpemilu.org#927814,"WAKOM, AIFAT TIMUR, MAYBRAT, PAPUA BARAT",1,67,50,117
https://kawalpemilu.org#87167,"WARIMAK, TIPLOL MAYALIBIT, RAJA AMPAT, PAPUA BARAT",1,80,1,81
https://kawalpemilu.org#82991,"ARANDAY, ARANDAY, TELUK BINTUNI, PAPUA BARAT",2,96,31,127
https://kawalpemilu.org#83324,"REMU SELATAN, SORONG MANOI, KOTA SORONG, PAPUA BARAT",8,45,156,201
https://kawalpemilu.org#83325,"KLASABI, SORONG MANOI, KOTA SORONG, PAPUA BARAT",13,105,91,196
https://kawalpemilu.org#87116,"KETAWAS, SUNOOK, SORONG, PAPUA BARAT",1,88,0,88
https://kawalpemilu.org#929818,"WARMON KOKODA, MAYAMUK, SORONG, PAPUA BARAT",1,66,73,139
https://kawalpemilu.org#83324,"REMU SELATAN, SORONG MANOI, KOTA SORONG, PAPUA BARAT",36,163,46,209
https://kawalpemilu.org#81704,"WENI, HOLUON, YAHUKIMO, PAPUA",1,200,0,200
https://kawalpemilu.org#78963,"TETOP, INIYANDIT, BOVEN DIGOEL, PAPUA",1,76,5,81
https://kawalpemilu.org#86822,"TIKOME, AYUMNATI, LANNY JAYA, PAPUA",1,257,0,257
https://kawalpemilu.org#930512,"TAMUGAUWO, WEGEE BINO, PANIAI, PAPUA",1,200,0,200
https://kawalpemilu.org#81657,"HEREAPINI, HEREAPINI, YAHUKIMO, PAPUA",5,256,0,256
https://kawalpemilu.org#80149,"SEREH, SENTANI, JAYAPURA, PAPUA",9,195,10,205
https://kawalpemilu.org#81710,"WANIM, LOLAT, YAHUKIMO, PAPUA",6,300,0,300
https://kawalpemilu.org#930563,"DOKONEIDA, YOUTADI, PANIAI, PAPUA",1,202,0,202
https://kawalpemilu.org#89103,"PIRIME, BUGUK GONA, LANNY JAYA, PAPUA",1,205,0,205
https://kawalpemilu.org#79947,"JAYA MAKMUR, KURIK, MERAUKE, PAPUA",3,148,83,231
https://kawalpemilu.org#930765,"UWOYUPI, SIRIWO, PANIAI, PAPUA",1,484,0,484
https://kawalpemilu.org#80666,"INSWAMBESI, WARSA, BIAK NUMFOR, PAPUA",1,204,8,212
https://kawalpemilu.org#88498,"TARAWI, DANIME, TOLIKARA, PAPUA",1,70,0,70
https://kawalpemilu.org#78323,"KAPIRAYA-KOMAUTO, KAPIRAYA, DEIYAI, PAPUA",7,283,0,283
https://kawalpemilu.org#79907,"JAGEBOB RAYA, JAGEBOB, MERAUKE, PAPUA",1,85,54,139
https://kawalpemilu.org#80853,"ENAROTALI, PANIAI TIMUR, PANIAI, PAPUA",5,295,0,295
https://kawalpemilu.org#86244,"MANDENDERI, SWANDIWE, BIAK NUMFOR, PAPUA",1,149,0,149
https://kawalpemilu.org#81491,"SILORIN, AMUMA, YAHUKIMO, PAPUA",2,299,0,299
https://kawalpemilu.org#930594,"EKAUWIYA, TOPIYAI, PANIAI, PAPUA",1,200,0,200
https://kawalpemilu.org#89111,"TEKUL, BUGUK GONA, LANNY JAYA, PAPUA",2,267,0,267
https://kawalpemilu.org#79993,"SIBENDA, WAAN, MERAUKE, PAPUA",1,79,2,81
https://kawalpemilu.org#80270,"KARYA BUMI, NAMBLUONG, JAYAPURA, PAPUA",1,78,152,230
https://kawalpemilu.org#79372,"PAPASENA II, MAMBERAMO HULU, MAMBERAMO RAYA, PAPUA",2,125,4,129
https://kawalpemilu.org#79904,"KAMNO SARI, JAGEBOB, MERAUKE, PAPUA",1,131,44,175
https://kawalpemilu.org#80855,"TIMIDA, PANIAI TIMUR, PANIAI, PAPUA",4,126,125,251
https://kawalpemilu.org#79830,"MANDALA, MERAUKE, MERAUKE, PAPUA",19,117,30,147
https://kawalpemilu.org#80555,"DERNAFI, BIAK UTARA, BIAK NUMFOR, PAPUA",2,106,10,116
https://kawalpemilu.org#80006,"KAIBURSE, MALIND, MERAUKE, PAPUA",2,100,9,109
https://kawalpemilu.org#80989,"IBUMAIDA, KEBO, PANIAI, PAPUA",2,263,0,263
https://kawalpemilu.org#929732,"WANGGU, GELOK BEAM, LANNY JAYA, PAPUA",2,253,0,253
https://kawalpemilu.org#86839,"WAMITU, GOA BALIM, LANNY JAYA, PAPUA",4,264,0,264
https://kawalpemilu.org#80561,"KOREM, BIAK UTARA, BIAK NUMFOR, PAPUA",1,236,6,241
https://kawalpemilu.org#79880,"MARGA MULYA, SEMANGGA, MERAUKE, PAPUA",6,85,51,136
https://kawalpemilu.org#929630,"YUGUNOMBA, KUYAWAGE, LANNY JAYA, PAPUA",1,158,0,158
https://kawalpemilu.org#81758,"LANGDA, LANGDA, YAHUKIMO, PAPUA",7,300,0,300
https://kawalpemilu.org#81839,"KINI, HILIPUK, YAHUKIMO, PAPUA",5,199,0,199
https://kawalpemilu.org#81827,"SOAMARIN, KWIKMA, YAHUKIMO, PAPUA",1,251,0,251
https://kawalpemilu.org#81373,"SOROH, KURIMA, YAHUKIMO, PAPUA",4,199,0,199
https://kawalpemilu.org#15797,"TANJUNG RHU, LIMA PULUH, KOTA PEKANBARU, RIAU",13,126,133,259
https://kawalpemilu.org#15089,"UJUNG BATU, UJUNG BATU, ROKAN HULU, RIAU",20,61,197,258
https://kawalpemilu.org#14537,"SIAMBUL, BATANG GANGSAL, INDRAGIRI HULU, RIAU",4,108,63,171
https://kawalpemilu.org#14679,"AIR JAMBAN, MANDAU, BENGKALIS, RIAU",16,34,138,172
https://kawalpemilu.org#15837,"LABUH BARU BARAT, PAYUNG SEKAKI, KOTA PEKANBARU, RIAU",39,139,3,142
https://kawalpemilu.org#15414,"KAMPUNG DALAM, SIAK, SIAK, RIAU",16,44,157,201
https://kawalpemilu.org#14229,"PANDAU JAYA, SIAK HULU, KAMPAR, RIAU",34,21,171,192
https://kawalpemilu.org#15446,"TUALANG, TUALANG, SIAK, RIAU",36,59,129,188
https://kawalpemilu.org#14169,"LANGGINI, BANGKINANG KOTA, KAMPAR, RIAU",38,18,155,173
https://kawalpemilu.org#14679,"AIR JAMBAN, MANDAU, BENGKALIS, RIAU",135,35,78,113
https://kawalpemilu.org#14679,"AIR JAMBAN, MANDAU, BENGKALIS, RIAU",6,104,80,184
https://kawalpemilu.org#14891,"TANJUNGSIMPANG, Pelangiran, INDRAGIRI HILIR, RIAU",31,25,58,83
https://kawalpemilu.org#15821,"TUAH KARYA, TAMPAN, KOTA PEKANBARU, RIAU",23,29,202,231
https://kawalpemilu.org#15726,"PULAU TONGAH, PANGEAN, KUANTAN SINGINGI, RIAU",1,20,164,184
https://kawalpemilu.org#14879,"Air Balui, Kemuning, INDRAGIRI HILIR, RIAU",2,101,157,258
https://kawalpemilu.org#15796,"RINTIS, LIMA PULUH, KOTA PEKANBARU, RIAU",8,113,74,187
https://kawalpemilu.org#15168,"KARYA MULYA, RAMBAH SAMO, ROKAN HULU, RIAU",7,34,159,193
https://kawalpemilu.org#931198,"BAMBUKUNING, TENAYAN RAYA, KOTA PEKANBARU, RIAU",12,99,102,201
https://kawalpemilu.org#931188,"PERHENTIANMARPOYAN, MARPOYAN DAMAI, KOTA PEKANBARU, RIAU",17,39,212,251
https://kawalpemilu.org#931191,"MENTANGOR, TENAYAN RAYA, KOTA PEKANBARU, RIAU",34,41,126,167
https://kawalpemilu.org#15397,"RANTAU KOPAR, RANTAU KOPAR, ROKAN HILIR, RIAU",7,83,58,141
https://kawalpemilu.org#14345,"SALO, SALO, KAMPAR, RIAU",12,12,121,133
https://kawalpemilu.org#931177,"MUARAFAJAR BARAT, RUMBAI, KOTA PEKANBARU, RIAU",7,30,149,179
https://kawalpemilu.org#89372,"SIDODADI, LOGAS TANAH DARAT, KUANTAN SINGINGI, RIAU",2,130,33,163
https://kawalpemilu.org#14450,"SUNGAI BAUNG, RENGAT BARAT, INDRAGIRI HULU, RIAU",6,39,118,157
https://kawalpemilu.org#14394,"PENGHIDUPAN, KAMPAR KIRI TENGAH, KAMPAR, RIAU",12,60,89,149
https://kawalpemilu.org#15820,"SIDOMULYA BARAT, TAMPAN, KOTA PEKANBARU, RIAU",31,40,128,168
https://kawalpemilu.org#15848,"LAKSAMANA, DUMAI KOTA, KOTA DUMAI, RIAU",9,52,91,143
https://kawalpemilu.org#15732,"PEMBATANG, PANGEAN, KUANTAN SINGINGI, RIAU",2,13,204,217
https://kawalpemilu.org#89470,"WONOSARI, RANGSANG, KEPULAUAN MERANTI, RIAU",2,80,27,107
https://kawalpemilu.org#15871,"GURUN PANJANG, BUKIT KAPUR, KOTA DUMAI, RIAU",15,94,49,143
https://kawalpemilu.org#14808,"Bekawan, Mandah, INDRAGIRI HILIR, RIAU",6,17,139,156
https://kawalpemilu.org#14869,"TELUKKABUNG, Gaung, INDRAGIRI HILIR, RIAU",5,25,131,156
https://kawalpemilu.org#15347,"SUNGAI BAKAU, SINABOI, ROKAN HILIR, RIAU",10,131,61,192
https://kawalpemilu.org#84519,"SUNGAIMAJO, KUBU BABUSSALAM, ROKAN HILIR, RIAU",2,56,144,200
https://kawalpemilu.org#15827,"WONOREJO, MARPOYAN DAMAI, KOTA PEKANBARU, RIAU",2,37,128,165
https://kawalpemilu.org#15149,"KOTA LAMA, KUNTO DARUSSALAM, ROKAN HULU, RIAU",43,122,73,195
https://kawalpemilu.org#15058,"TELUK DALAM, KUALA KAMPAR, PELALAWAN, RIAU",14,87,58,145
https://kawalpemilu.org#15821,"TUAH KARYA, TAMPAN, KOTA PEKANBARU, RIAU",31,24,138,162
https://kawalpemilu.org#15214,"BONO TAPUNG, TANDUN, ROKAN HULU, RIAU",6,90,62,152
https://kawalpemilu.org#15307,"LENGGADAI HILIR, RIMBA MELINTANG, ROKAN HILIR, RIAU",5,77,89,166
https://kawalpemilu.org#14889,"PELANGIRAN, Pelangiran, INDRAGIRI HILIR, RIAU",13,21,138,159
https://kawalpemilu.org#14945,"SUNGAIGANTANG, Kempas, INDRAGIRI HILIR, RIAU",10,33,156,189
https://kawalpemilu.org#14325,"TAPUNG MAKMUR, TAPUNG HILIR, KAMPAR, RIAU",2,119,66,185
https://kawalpemilu.org#75450,"BULU MARIO, SARUDU, MAMUJU UTARA, SULAWESI BARAT",3,180,78,258
https://kawalpemilu.org#75659,"SALUADAK, TOBADAK, MAMUJU TENGAH, SULAWESI BARAT",2,158,47,205
https://kawalpemilu.org#75932,"AMASSANGAN, BINUANG, POLEWALI MANDAR, SULAWESI BARAT",5,108,108,216
https://kawalpemilu.org#75950,"TAPANGO BARAT, TAPANGO, POLEWALI MANDAR, SULAWESI BARAT",4,157,86,243
https://kawalpemilu.org#75736,"TALLANG BULAWAN, PANA, MAMASA, SULAWESI BARAT",2,145,10,155
https://kawalpemilu.org#75569,"KOMBILING, PANGALE, MAMUJU TENGAH, SULAWESI BARAT",3,119,109,228
https://kawalpemilu.org#75927,"POLLEWANI, TUTAR, POLEWALI MANDAR, SULAWESI BARAT",1,179,16,195
https://kawalpemilu.org#76091,"BAURUNG, BANGGAE TIMUR, MAJENE, SULAWESI BARAT",13,168,81,249
https://kawalpemilu.org#75606,"KAROSSA, KAROSSA, MAMUJU TENGAH, SULAWESI BARAT",15,150,82,232
https://kawalpemilu.org#75497,"BAJAWALI, LARIANG, MAMUJU UTARA, SULAWESI BARAT",3,160,22,182
https://kawalpemilu.org#70752,"ALLIRITENGAE, TURIKALE, MAROS, SULAWESI SELATAN",2,65,126,191
https://kawalpemilu.org#70227,"MASSAILE, TELLU LIMPOE, SINJAI, SULAWESI SELATAN",4,17,123,140
https://kawalpemilu.org#69952,"BODDIA, GALESONG, TAKALAR, SULAWESI SELATAN",14,67,122,189
https://kawalpemilu.org#70527,"PATTIRO, DUA BOCCOE, BONE, SULAWESI SELATAN",4,127,35,162
https://kawalpemilu.org#69884,"BANGGAE, MANGARABOMBANG, TAKALAR, SULAWESI SELATAN",3,71,120,191
https://kawalpemilu.org#69590,"GUNTURU, HERLANG, BULUKUMBA, SULAWESI SELATAN",3,25,130,155
https://kawalpemilu.org#70220,"BONTO KATUTE, SINJAI BORONG, SINJAI, SULAWESI SELATAN",9,53,96,149
https://kawalpemilu.org#71411,"MANGKI, CEMPA, PINRANG, SULAWESI SELATAN",2,24,131,155
https://kawalpemilu.org#72489,"LUMPUE, BACUKIKI BARAT, KOTA PARE PARE, SULAWESI SELATAN",22,92,125,217
https://kawalpemilu.org#69534,"JALANJANG, GANTARANG, BULUKUMBA, SULAWESI SELATAN",6,69,82,151
https://kawalpemilu.org#69454,"KAHU-KAHU, BONTOHARU, KEPULAUAN SELAYAR, SULAWESI SELATAN",4,58,103,161
https://kawalpemilu.org#71101,"TEDDAOPU, TEMPE, WAJO, SULAWESI SELATAN",5,114,89,203
https://kawalpemilu.org#70822,"KASSI LOE, LABAKKANG, PANGKAJENE DAN KEPULAUAN, SULAWESI SELATAN",7,50,108,158
https://kawalpemilu.org#70583,"CELLU, TANETE RIATTANG TIMUR, BONE, SULAWESI SELATAN",5,68,133,201
https://kawalpemilu.org#70949,"SOGA, MARIORIWAWO, SOPPENG, SULAWESI SELATAN",5,92,60,152
https://kawalpemilu.org#70140,"BILANRENGI, PARIGI, GOWA, SULAWESI SELATAN",4,78,121,199
https://kawalpemilu.org#72312,"MATTOANGIN, MARISO, KOTA MAKASSAR, SULAWESI SELATAN",8,109,74,183
https://kawalpemilu.org#71527,"BANUA, BUNGIN, ENREKANG, SULAWESI SELATAN",1,149,93,242
https://kawalpemilu.org#72425,"MACCINI SOMBALA, TAMALATE, KOTA MAKASSAR, SULAWESI SELATAN",39,37,63,100
https://kawalpemilu.org#69821,"KARELOE, BONTORAMBA, JENEPONTO, SULAWESI SELATAN",10,146,54,200
https://kawalpemilu.org#71329,"LANGNGA, MATIRRO SOMPE, PINRANG, SULAWESI SELATAN",16,102,43,145
https://kawalpemilu.org#70817,"GENTUNG, LABAKKANG, PANGKAJENE DAN KEPULAUAN, SULAWESI SELATAN",3,56,131,187
https://kawalpemilu.org#70084,"BERUTALLASA, BIRINGBULU, GOWA, SULAWESI SELATAN",14,100,21,121
https://kawalpemilu.org#69536,"BIALO, GANTARANG, BULUKUMBA, SULAWESI SELATAN",1,59,99,158
https://kawalpemilu.org#70201,"BALANGNIPA, SINJAI UTARA, SINJAI, SULAWESI SELATAN",17,65,116,181
https://kawalpemilu.org#72394,"SUANGGA, TALLO, KOTA MAKASSAR, SULAWESI SELATAN",27,50,121,171
https://kawalpemilu.org#69358,"LILI'KIRA' AO'GADING, BALUSU, TORAJA UTARA, SULAWESI SELATAN",4,137,13,150
https://kawalpemilu.org#69795,"TOLO, KELARA, JENEPONTO, SULAWESI SELATAN",3,21,188,209
https://kawalpemilu.org#70769,"KALU-KALUKUANG, LIUKANG KALMAS, PANGKAJENE DAN KEPULAUAN, SULAWESI SELATAN",4,152,78,230
https://kawalpemilu.org#70745,"MONCONGLOE BULU, MONCONG LOE, MAROS, SULAWESI SELATAN",10,83,58,141
https://kawalpemilu.org#70883,"LALOLANG, TANETE RILAU, BARRU, SULAWESI SELATAN",5,57,144,201
https://kawalpemilu.org#71859,"MAPPA', BONGGAKARADENG, TANA TORAJA, SULAWESI SELATAN",2,174,19,193
https://kawalpemilu.org#70506,"LAPPAE, TELLU SIATTINGE, BONE, SULAWESI SELATAN",3,97,80,177
https://kawalpemilu.org#70782,"MATTIRO DOLANGENG, LIUKANG TUPABBIRING, PANGKAJENE DAN KEPULAUAN, SULAWESI SELATAN",3,73,123,196
https://kawalpemilu.org#69699,"MAMAMPANG, EREMERASA, BANTAENG, SULAWESI SELATAN",8,16,93,109
https://kawalpemilu.org#70642,"BONTOA, MANDAI, MAROS, SULAWESI SELATAN",38,59,153,212
https://kawalpemilu.org#69391,"BATU BUSA, BUNTU PEPASAN, TORAJA UTARA, SULAWESI SELATAN",3,100,22,122
https://kawalpemilu.org#70715,"SAMBUEJA, SIMBANG, MAROS, SULAWESI SELATAN",9,1,22,23
https://kawalpemilu.org#71513,"KAMBIOLANGI, ALLA, ENREKANG, SULAWESI SELATAN",13,24,134,158
https://kawalpemilu.org#72222,"LASKAP, MALILI, LUWU TIMUR, SULAWESI SELATAN",2,46,183,229
https://kawalpemilu.org#69867,"BALANGLOE TAROWANG, TAROWANG, JENEPONTO, SULAWESI SELATAN",2,77,143,220
https://kawalpemilu.org#69883,"PANYANGKALANG, MANGARABOMBANG, TAKALAR, SULAWESI SELATAN",5,60,127,187
https://kawalpemilu.org#70410,"PATTIMPA, PONRE, BONE, SULAWESI SELATAN",4,126,70,196
https://kawalpemilu.org#70276,"ABBUM PUNGENG, KAJUARA, BONE, SULAWESI SELATAN",1,92,112,204
https://kawalpemilu.org#69834,"BUNGUNGLOE, TURATEA, JENEPONTO, SULAWESI SELATAN",8,11,144,155
https://kawalpemilu.org#71303,"PONRANGAE, PITU RIAWA, SIDENRENG RAPPANG, SULAWESI SELATAN",1,84,107,191
https://kawalpemilu.org#71868,"TONDON MAMULLU, MAKALE, TANA TORAJA, SULAWESI SELATAN",4,140,33,173
https://kawalpemilu.org#71811,"TETTEKANG, BAJO BARAT, LUWU, SULAWESI SELATAN",3,62,117,179
https://kawalpemilu.org#70048,"BATANGKALUKU, SOMBA OPU, GOWA, SULAWESI SELATAN",32,97,106,203
https://kawalpemilu.org#71712,"SALUSANA, LAROMPONG SELATAN, LUWU, SULAWESI SELATAN",4,61,37,98
https://kawalpemilu.org#71718,"TIROWALI, PONRANG, LUWU, SULAWESI SELATAN",3,42,187,229
https://kawalpemilu.org#71357,"BUNGA, MATTIRO BULU, PINRANG, SULAWESI SELATAN",2,89,137,226
https://kawalpemilu.org#69795,"TOLO, KELARA, JENEPONTO, SULAWESI SELATAN",2,35,126,161
https://kawalpemilu.org#69822,"BATUJALA, BONTORAMBA, JENEPONTO, SULAWESI SELATAN",4,37,162,199
https://kawalpemilu.org#72162,"CENDANA PUTIH I, MAPPEDECENG, LUWU UTARA, SULAWESI SELATAN",6,145,53,198
https://kawalpemilu.org#72534,"PADANG LAMBE, WARA BARAT, KOTA PALOPO, SULAWESI SELATAN",5,129,7,136
https://kawalpemilu.org#85777,"LALENG BATA, PALETEANG, PINRANG, SULAWESI SELATAN",19,57,69,126
https://kawalpemilu.org#69823,"BULUSUKA, BONTORAMBA, JENEPONTO, SULAWESI SELATAN",9,122,110,232
https://kawalpemilu.org#71249,"SIPODECENG, BARANTI, SIDENRENG RAPPANG, SULAWESI SELATAN",5,54,148,202
https://kawalpemilu.org#70053,"TOMBOLO, SOMBA OPU, GOWA, SULAWESI SELATAN",8,52,123,175
https://kawalpemilu.org#70288,"MASSANGKAE, KAJUARA, BONE, SULAWESI SELATAN",2,41,168,209
https://kawalpemilu.org#71572,"MUNDAN, MASALLE, ENREKANG, SULAWESI SELATAN",2,81,85,166
https://kawalpemilu.org#70219,"KASSI BULENG, SINJAI BORONG, SINJAI, SULAWESI SELATAN",7,14,148,162
https://kawalpemilu.org#85764,"SOPA, KINDANG, BULUKUMBA, SULAWESI SELATAN",5,44,118,162
https://kawalpemilu.org#71255,"MACCORAWALIE, PANCA RIJANG, SIDENRENG RAPPANG, SULAWESI SELATAN",6,46,170,216
https://kawalpemilu.org#67538,"BEKA, MARAWOLA, SIGI, SULAWESI TENGAH",3,43,82,125
https://kawalpemilu.org#87568,"NGUNE, LAKEA, BUOL, SULAWESI TENGAH",2,79,89,168
https://kawalpemilu.org#67704,"TIKUPAN, BUALEMO, BANGGAI, SULAWESI TENGAH",4,76,33,109
https://kawalpemilu.org#68288,"TINIGI, GALANG, TOLITOLI, SULAWESI TENGAH",9,82,115,197
https://kawalpemilu.org#87821,"KERATON, LUWUK, BANGGAI, SULAWESI TENGAH",8,57,54,111
https://kawalpemilu.org#69021,"KAYU AGUNG, MEPANGA, PARIGI MOUTONG, SULAWESI TENGAH",2,128,74,202
https://kawalpemilu.org#67981,"TRI MULYA, POSO PESISIR UTARA, POSO, SULAWESI TENGAH",1,162,4,166
https://kawalpemilu.org#67639,"NIPA, LAMALA, BANGGAI, SULAWESI TENGAH",1,204,8,212
https://kawalpemilu.org#67694,"BUNGAWON, PAGIMANA, BANGGAI, SULAWESI TENGAH",2,74,62,136
https://kawalpemilu.org#68273,"BARU, BAOLAN, TOLITOLI, SULAWESI TENGAH",42,80,137,217
https://kawalpemilu.org#68346,"BUNOBOGU, BUNOBOGU, BUOL, SULAWESI TENGAH",4,74,104,178
https://kawalpemilu.org#68210,"SONI, DAMPAL SELATAN, TOLITOLI, SULAWESI TENGAH",2,72,108,180
https://kawalpemilu.org#68272,"NALU, BAOLAN, TOLITOLI, SULAWESI TENGAH",19,110,142,252
https://kawalpemilu.org#67727,"PIONDO, TOILI, BANGGAI, SULAWESI TENGAH",2,148,26,174
https://kawalpemilu.org#67901,"LABUAN, LAGE, POSO, SULAWESI TENGAH",1,104,89,193
https://kawalpemilu.org#68538,"NAMBO, BUNGKU TIMUR, MOROWALI, SULAWESI TENGAH",2,102,127,229
https://kawalpemilu.org#69253,"TAVANJUKA, TATANGA, KOTA PALU, SULAWESI TENGAH",5,50,63,113
https://kawalpemilu.org#68687,"MANSALEAN, LABOBO, BANGGAI LAUT, SULAWESI TENGAH",2,93,79,172
https://kawalpemilu.org#69238,"BARU, PALU BARAT, KOTA PALU, SULAWESI TENGAH",7,93,109,202
https://kawalpemilu.org#68193,"OGOAMAS I, SOJOL UTARA, DONGGALA, SULAWESI TENGAH",12,121,60,181
https://kawalpemilu.org#68049,"POLANTO JAYA, RIO PAKAVA, DONGGALA, SULAWESI TENGAH",5,174,22,196
https://kawalpemilu.org#68074,"GUNUNG BALE, BANAWA, DONGGALA, SULAWESI TENGAH",4,117,103,220
https://kawalpemilu.org#68820,"LANTIBUNG, BANGKURUNG, BANGGAI LAUT, SULAWESI TENGAH",2,84,81,165
https://kawalpemilu.org#74667,"KATOBENGKE, BETOAMBARI, KOTA BAU BAU, SULAWESI TENGGARA",24,84,117,201
https://kawalpemilu.org#74193,"WAELUMU, WANGI-WANGI, WAKATOBI, SULAWESI TENGGARA",3,150,69,219
https://kawalpemilu.org#74684,"BUGI, SORA WALIO, KOTA BAU BAU, SULAWESI TENGGARA",4,82,75,157
https://kawalpemilu.org#74247,"KABITA, WANGI WANGI SELATAN, WAKATOBI, SULAWESI TENGGARA",3,113,74,187
https://kawalpemilu.org#74167,"PASARE APUA, LANTARI JAYA, BOMBANA, SULAWESI TENGGARA",1,134,116,250
https://kawalpemilu.org#73934,"WONUA SARI, MOWILA, KONAWE SELATAN, SULAWESI TENGGARA",1,71,66,137
https://kawalpemilu.org#73747,"ARONGO, LANDONO, KONAWE SELATAN, SULAWESI TENGGARA",3,140,55,195
https://kawalpemilu.org#74276,"TONGANO TIMUR, TOMIA TIMUR, WAKATOBI, SULAWESI TENGGARA",4,94,28,122
https://kawalpemilu.org#72750,"WIA-WIA, POLI-POLIA, KOLAKA TIMUR, SULAWESI TENGGARA",2,149,18,167
https://kawalpemilu.org#928694,"PUU LAWULO, SAMATURU, KOLAKA, SULAWESI TENGGARA",1,78,120,198
https://kawalpemilu.org#73314,"LAMAEO, KABAWO, MUNA, SULAWESI TENGGARA",3,50,95,145
https://kawalpemilu.org#74549,"MATA, KAMBOWA, BUTON UTARA, SULAWESI TENGGARA",2,86,93,179
https://kawalpemilu.org#927856,"Humboto, UEPAI, KONAWE, SULAWESI TENGGARA",3,91,88,179
https://kawalpemilu.org#73763,"MATABUBU JAYA, LAINEA, KONAWE SELATAN, SULAWESI TENGGARA",2,85,108,193
https://kawalpemilu.org#74674,"TOMBA, WOLIO, KOTA BAU BAU, SULAWESI TENGGARA",2,59,127,186
https://kawalpemilu.org#74251,"LIYA MAWI, WANGI WANGI SELATAN, WAKATOBI, SULAWESI TENGGARA",1,104,77,181
https://kawalpemilu.org#72597,"DAWI-DAWI, POMALAA, KOLAKA, SULAWESI TENGGARA",16,31,113,144
https://kawalpemilu.org#72780,"LAMOARE, LOEA, KOLAKA TIMUR, SULAWESI TENGGARA",3,115,123,238
https://kawalpemilu.org#85862,"OTIPULU, WAWOLESEA, KONAWE UTARA, SULAWESI TENGGARA",1,40,150,190
https://kawalpemilu.org#931109,"WAKOKO, PASARWAJO, BUTON, SULAWESI TENGGARA",8,87,93,180
https://kawalpemilu.org#67210,"BUHA, MAPANGET, KOTA MANADO, SULAWESI UTARA",20,144,45,189
https://kawalpemilu.org#67218,"MALALAYANG SATU, MALALAYANG, KOTA MANADO, SULAWESI UTARA",13,159,17,176
https://kawalpemilu.org#66167,"WINEBETAN, LANGOWAN SELATAN, MINAHASA, SULAWESI UTARA",3,206,21,227
https://kawalpemilu.org#66686,"WAWONTULAP, TATAPAAN, MINAHASA SELATAN, SULAWESI UTARA",3,123,63,186
https://kawalpemilu.org#85591,"TOMBATU TIGA, TOMBATU UTARA, MINAHASA TENGGARA, SULAWESI UTARA",1,240,29,269
https://kawalpemilu.org#67196,"WANEA, WANEA, KOTA MANADO, SULAWESI UTARA",20,207,7,214
https://kawalpemilu.org#85597,"LIWUTUNG SATU, PASAN, MINAHASA TENGGARA, SULAWESI UTARA",2,155,5,160
https://kawalpemilu.org#66120,"WAREMBUNGAN, PINELENG, MINAHASA, SULAWESI UTARA",6,208,20,228
https://kawalpemilu.org#66480,"BINALANG TIMUR, TAMPAN' AMMA, KEPULAUAN TALAUD, SULAWESI UTARA",2,134,10,144
https://kawalpemilu.org#89889,"DONDOMON UTARA, DUMOGA UTARA, BOLAANG MONGONDOW, SULAWESI UTARA",1,139,14,153
https://kawalpemilu.org#66424,"KORDAKEL, KABARUAN, KEPULAUAN TALAUD, SULAWESI UTARA",1,164,61,225
https://kawalpemilu.org#67190,"SARIO TUMPAAN, SARIO, KOTA MANADO, SULAWESI UTARA",12,75,36,111
https://kawalpemilu.org#67145,"SINDULANG SATU, TUMINITING, KOTA MANADO, SULAWESI UTARA",9,74,80,154
https://kawalpemilu.org#67361,"BILALANG II, KOTAMOBAGU UTARA, KOTA KOTAMOBAGU, SULAWESI UTARA",6,42,178,220
https://kawalpemilu.org#67373,"KOBO KECIL, KOTAMOBAGU TIMUR, KOTA KOTAMOBAGU, SULAWESI UTARA",6,84,140,224
https://kawalpemilu.org#65782,"MOMALIA II, POSIGADAN, BOLAANG MONGONDOW SELATAN, SULAWESI UTARA",2,66,140,206
https://kawalpemilu.org#67182,"TIKALA BARU, TIKALA, KOTA MANADO, SULAWESI UTARA",4,225,16,241
https://kawalpemilu.org#66453,"TARUAN, GEMEH, KEPULAUAN TALAUD, SULAWESI UTARA",1,149,15,164
https://kawalpemilu.org#67225,"WINANGUN SATU, MALALAYANG, KOTA MANADO, SULAWESI UTARA",22,186,21,207
https://kawalpemilu.org#66753,"TIWOHO, WORI, MINAHASA UTARA, SULAWESI UTARA",2,175,30,205
https://kawalpemilu.org#12963,"GURUN PANJANG, BAYANG, PESISIR SELATAN, SUMATERA BARAT",6,2,115,117
https://kawalpemilu.org#13689,"AIA GADANG, PASAMAN, PASAMAN BARAT, SUMATERA BARAT",27,14,198,212
https://kawalpemilu.org#13967,"KAPALO KOTO DIBALAI, PAYAKUMBUH UTARA, KOTA PAYAKUMBUH, SUMATERA BARAT",3,34,191,225
https://kawalpemilu.org#87294,"III KOTO AUR MALINTANG SELATAN, IV KOTO AUR MALINTANG, PADANG PARIAMAN, SUMATERA BARAT",27,15,95,110
https://kawalpemilu.org#13729,"JATI, PADANG TIMUR, KOTA PADANG, SUMATERA BARAT",5,31,102,133
https://kawalpemilu.org#13478,"BUKIK SIKUMPA, LAREH SAGO HALABAN, LIMA PULUH KOTA, SUMATERA BARAT",4,30,172,202
https://kawalpemilu.org#13434,"SUNGAI BERINGIN, PAYAKUMBUH, LIMA PULUH KOTA, SUMATERA BARAT",3,13,129,142
https://kawalpemilu.org#84395,"DUSUN BARU TAPAN, BASA AMPEK BALAI TAPAN, PESISIR SELATAN, SUMATERA BARAT",1,37,124,161
https://kawalpemilu.org#13425,"GUGUAK VIII KOTO, GUGUAK, LIMA PULUH KOTA, SUMATERA BARAT",40,19,143,162
https://kawalpemilu.org#13148,"TANJUNG, KOTO VII, SIJUNJUNG, SUMATERA BARAT",15,16,176,192
https://kawalpemilu.org#13162,"DESA KAMPUNG BARU, KUPITAN, SIJUNJUNG, SUMATERA BARAT",2,11,122,133
https://kawalpemilu.org#13330,"SUNGAI BATANG, TANJUNG RAYA, AGAM, SUMATERA BARAT",3,6,68,74
https://kawalpemilu.org#13685,"UJUNG GADIANG, LEMBAH MELINTANG, PASAMAN BARAT, SUMATERA BARAT",70,11,211,222
https://kawalpemilu.org#84379,"GANTING MUDIAK SELATAN SURANTIH, SUTERA, PESISIR SELATAN, SUMATERA BARAT",4,24,208,232
https://kawalpemilu.org#13625,"SUNGAI LIMAU, ASAM JUJUHAN, DHARMASRAYA, SUMATERA BARAT",3,69,94,163
https://kawalpemilu.org#13323,"LUBUK BASUNG, LUBUK BASUNG, AGAM, SUMATERA BARAT",55,39,122,161
https://kawalpemilu.org#13815,"BALAI GADANG, KOTO TANGAH, KOTA PADANG, SUMATERA BARAT",22,21,169,190
https://kawalpemilu.org#87295,"BALAI BAIAK MALAI III KOTO, IV KOTO AUR MALINTANG, PADANG PARIAMAN, SUMATERA BARAT",1,7,143,150
https://kawalpemilu.org#13969,"TIGO KOTO DIATE, PAYAKUMBUH UTARA, KOTA PAYAKUMBUH, SUMATERA BARAT",7,22,178,200
https://kawalpemilu.org#13117,"SIJUNJUNG, SIJUNJUNG, SIJUNJUNG, SUMATERA BARAT",15,13,191,204
https://kawalpemilu.org#13240,"TANJUNG ALAM, TANJUANG BARU, TANAH DATAR, SUMATERA BARAT",20,11,191,202
https://kawalpemilu.org#13847,"KUBANG SIRAKUK UTARA, LEMBAH SEGAR, KOTA SAWAHLUNTO, SUMATERA BARAT",3,22,156,178
https://kawalpemilu.org#931218,"Sungai Buluah Barat, BATANG ANAI, PADANG PARIAMAN, SUMATERA BARAT",12,114,90,204
https://kawalpemilu.org#84351,"SAWAH LAWEH PASAR BARU, BAYANG, PESISIR SELATAN, SUMATERA BARAT",3,10,166,176
https://kawalpemilu.org#13540,"MUARO SUNGAI LOLO, MAPAT TUNGGUL SELATAN, PASAMAN, SUMATERA BARAT",2,3,216,219
https://kawalpemilu.org#13003,"BATANG ARAH TAPAN, BASA AMPEK BALAI TAPAN, PESISIR SELATAN, SUMATERA BARAT",3,31,167,198
https://kawalpemilu.org#13299,"GASAN GADANG, BATANG GASAN, PADANG PARIAMAN, SUMATERA BARAT",6,6,126,132
https://kawalpemilu.org#13446,"TARANTANG, HARAU, LIMA PULUH KOTA, SUMATERA BARAT",9,20,122,142
https://kawalpemilu.org#13755,"GUNUNG PANGILUN, PADANG UTARA, KOTA PADANG, SUMATERA BARAT",7,22,151,173
https://kawalpemilu.org#13909,"PAKAN KURAI, GUGUAK PANJANG, KOTA BUKITTINGGI, SUMATERA BARAT",3,25,157,182
https://kawalpemilu.org#13391,"SALAREH AIA, PELEMBAYAN, AGAM, SUMATERA BARAT",40,10,119,129
https://kawalpemilu.org#13752,"ULAK KARANG SELATAN, PADANG UTARA, KOTA PADANG, SUMATERA BARAT",13,22,119,141
https://kawalpemilu.org#12975,"MANDEH, KOTO XI TARUSAN, PESISIR SELATAN, SUMATERA BARAT",2,30,181,211
https://kawalpemilu.org#13377,"KOTO TANGAH, TILATANG KAMANG, AGAM, SUMATERA BARAT",21,14,194,208
https://kawalpemilu.org#13583,"SIGAPOKNA, SIBERUT BARAT, KEPULAUAN MENTAWAI, SUMATERA BARAT",7,91,44,135
https://kawalpemilu.org#13196,"TANJUNG BARULAK, TANJUNG EMAS, TANAH DATAR, SUMATERA BARAT",4,33,111,144
https://kawalpemilu.org#13695,"KINALI, KINALI, PASAMAN BARAT, SUMATERA BARAT",73,30,191,221
https://kawalpemilu.org#13389,"IV KOTO PALEMBAYAN, PELEMBAYAN, AGAM, SUMATERA BARAT",12,18,139,157
https://kawalpemilu.org#13044,"DILAM, BUKIT SUNDI, SOLOK, SUMATERA BARAT",14,10,111,121
https://kawalpemilu.org#13804,"KURANJI, KURANJI, KOTA PADANG, SUMATERA BARAT",53,14,200,214
https://kawalpemilu.org#84371,"BARUNG-BARUNG BALANTAI TENGAH, KOTO XI TARUSAN, PESISIR SELATAN, SUMATERA BARAT",3,5,141,146
https://kawalpemilu.org#13823,"LUBUK BUAYA, KOTO TANGAH, KOTA PADANG, SUMATERA BARAT",32,29,181,210
https://kawalpemilu.org#19947,"SIDO RAHAYU, BUAY PEMACA, OGAN KOMERING ULU SELATAN, SUMATERA SELATAN",12,154,14,168
https://kawalpemilu.org#17613,"MAKARTI MULYA, MESUJI, OGAN KOMERING ILIR, SUMATERA SELATAN",8,140,113,253
https://kawalpemilu.org#19392,"SUKOMORO, TALANG KELAPA, BANYUASIN, SUMATERA SELATAN",38,46,173,119
https://kawalpemilu.org#20281,"SERIJABO, SUNGAI PINANG, OGAN ILIR, SUMATERA SELATAN",7,162,64,226
https://kawalpemilu.org#17870,"MUARA BURNAI I, LEMPUING JAYA, OGAN KOMERING ILIR, SUMATERA SELATAN",19,125,49,174
https://kawalpemilu.org#17466,"TALANG JAWA, BATURAJA BARAT, OGAN KOMERING ULU, SUMATERA SELATAN",3,66,134,200
https://kawalpemilu.org#17867,"RANTAU DURIAN II, LEMPUING JAYA, OGAN KOMERING ILIR, SUMATERA SELATAN",3,134,82,216
https://kawalpemilu.org#20769,"GUNUNG IBUL, PRABUMULIH TIMUR, KOTA PRABUMULIH, SUMATERA SELATAN",23,54,161,215
https://kawalpemilu.org#19974,"PULAU PANGGUNG, KISAM TINGGI, OGAN KOMERING ULU SELATAN, SUMATERA SELATAN",4,36,118,154
https://kawalpemilu.org#19987,"CAMPANG JAYA, KISAM ILIR, OGAN KOMERING ULU SELATAN, SUMATERA SELATAN",3,87,46,133
https://kawalpemilu.org#20594,"KALIDONI, KALIDONI, KOTA PALEMBANG, SUMATERA SELATAN",61,68,69,137
https://kawalpemilu.org#20744,"MARGA RAHAYU, LUBUK LINGGAU SELATAN II, KOTA LUBUKLINGGAU, SUMATERA SELATAN",14,60,180,240
https://kawalpemilu.org#20477,"BABATAN, LINTANG KANAN, EMPAT LAWANG, SUMATERA SELATAN",9,50,34,84
https://kawalpemilu.org#19721,"TANJUNG MAS, SEMENDAWAI BARAT, OGAN KOMERING ULU TIMUR, SUMATERA SELATAN",3,80,81,161
https://kawalpemilu.org#929007,"KEBUR JAYA, TIANG PUMPUNG KEPUNGUT, MUSI RAWAS, SUMATERA SELATAN",2,50,99,149
https://kawalpemilu.org#17920,"PULAU PANGGUNG, TANJUNG AGUNG, MUARA ENIM, SUMATERA SELATAN",6,29,181,210
https://kawalpemilu.org#18161,"SUKA MERINDU, SUNGAI ROTAN, MUARA ENIM, SUMATERA SELATAN",6,128,76,204
https://kawalpemilu.org#19038,"KASMARAN, BABAT TOMAN, MUSI BANYUASIN, SUMATERA SELATAN",3,59,153,212
https://kawalpemilu.org#91906,"LUBUK GETAM, BELIDA DARAT, MUARA ENIM, SUMATERA SELATAN",2,25,191,216
https://kawalpemilu.org#19562,"MALUAI INDAH, CEMPAKA, OGAN KOMERING ULU TIMUR, SUMATERA SELATAN",4,76,49,125
https://kawalpemilu.org#20658,"JANGKAR MAS, DEMPO UTARA, KOTA PAGAR ALAM, SUMATERA SELATAN",3,82,78,160
https://kawalpemilu.org#17438,"MENDALA, PENINJAUAN, OGAN KOMERING ULU, SUMATERA SELATAN",4,31,214,245
https://kawalpemilu.org#18266,"MUARA TAWI, JARAI, LAHAT, SUMATERA SELATAN",1,45,96,141
https://kawalpemilu.org#17731,"MEKAR JAYA, LEMPUING, OGAN KOMERING ILIR, SUMATERA SELATAN",5,88,166,254
https://kawalpemilu.org#20624,"TALANG PUTRI, PLAJU, KOTA PALEMBANG, SUMATERA SELATAN",29,92,124,216
https://kawalpemilu.org#19884,"SIMPANGAN, SIMPANG, OGAN KOMERING ULU SELATAN, SUMATERA SELATAN",4,69,90,159
https://kawalpemilu.org#20334,"TEBEDAK I, PAYARAMAN, OGAN ILIR, SUMATERA SELATAN",4,47,166,213
https://kawalpemilu.org#18913,"SUMBER HARTA, SUMBER HARTA, MUSI RAWAS, SUMATERA SELATAN",12,30,121,151
https://kawalpemilu.org#18111,"AIR ITAM, PENUKAL, PENUKAL ABAB LEMATANG ILIR, SUMATERA SELATAN",7,78,89,167
https://kawalpemilu.org#17953,"GUNUNG RAJA, RAMBANG DANGKU, MUARA ENIM, SUMATERA SELATAN",1,92,176,268
https://kawalpemilu.org#17764,"PINANG INDAH, SUNGAI MENANG, OGAN KOMERING ILIR, SUMATERA SELATAN",1,50,32,82
https://kawalpemilu.org#19265,"PENUGUAN, PULAU RIMAU, BANYUASIN, SUMATERA SELATAN",10,65,95,160
https://kawalpemilu.org#19096,"BAYUNG LENCIR, BAYUNG LENCIR, MUSI BANYUASIN, SUMATERA SELATAN",10,142,112,254
https://kawalpemilu.org#18446,"KARANG CAHAYA, KIKIM SELATAN, LAHAT, SUMATERA SELATAN",1,66,183,249
https://kawalpemilu.org#18714,"BERINGIN MAKMUR II, RAWAS ILIR, MUSI RAWAS UTARA, SUMATERA SELATAN",16,90,38,128
https://kawalpemilu.org#20567,"2 ILIR, ILIR TIMUR II, KOTA PALEMBANG, SUMATERA SELATAN",20,111,116,227
https://kawalpemilu.org#17794,"CENGAL, CENGAL, OGAN KOMERING ILIR, SUMATERA SELATAN",6,64,71,135
https://kawalpemilu.org#19124,"SINAR HARAPAN, TUNGKAL JAYA, MUSI BANYUASIN, SUMATERA SELATAN",2,138,62,200
https://kawalpemilu.org#17851,"KERTA MUKTI, MESUJI RAYA, OGAN KOMERING ILIR, SUMATERA SELATAN",3,124,82,206
https://kawalpemilu.org#18664,"SEMANGUS, MUARA LAKITAN, MUSI RAWAS, SUMATERA SELATAN",3,129,55,184
https://kawalpemilu.org#18715,"PAUH I, RAWAS ILIR, MUSI RAWAS UTARA, SUMATERA SELATAN",1,50,90,140
https://kawalpemilu.org#20704,"AIR TEMAM, LUBUK LINGGAU SELATAN I, KOTA LUBUKLINGGAU, SUMATERA SELATAN",5,131,131,262
https://kawalpemilu.org#89351,"PLAJU ULU, PLAJU, KOTA PALEMBANG, SUMATERA SELATAN",52,64,131,195
https://kawalpemilu.org#19848,"TALANG MERBAU, BANDING AGUNG, OGAN KOMERING ULU SELATAN, SUMATERA SELATAN",4,98,26,128
https://kawalpemilu.org#20725,"MESAT JAYA, LUBUK LINGGAU TIMUR II, KOTA LUBUKLINGGAU, SUMATERA SELATAN",12,44,115,159
https://kawalpemilu.org#18944,"KAYU ARA, SEKAYU, MUSI BANYUASIN, SUMATERA SELATAN",27,12,113,125
https://kawalpemilu.org#18793,"BABAT, STL ULU TERAWAS, MUSI RAWAS, SUMATERA SELATAN",5,65,159,224
https://kawalpemilu.org#20528,"8 ULU, JAKABARING, KOTA PALEMBANG, SUMATERA SELATAN",23,99,128,227
https://kawalpemilu.org#19295,"RIMBA ASAM, BETUNG, BANYUASIN, SUMATERA SELATAN",18,35,124,159
https://kawalpemilu.org#18322,"GUNUNG AGUNG, MERAPI BARAT, LAHAT, SUMATERA SELATAN",5,8,101,109
https://kawalpemilu.org#19288,"RINGIN HARJO, PULAU RIMAU, BANYUASIN, SUMATERA SELATAN",3,141,34,175
https://kawalpemilu.org#20173,"PEMULUTAN ULU, PEMULUTAN, OGAN ILIR, SUMATERA SELATAN",2,48,202,250
https://kawalpemilu.org#19911,"KOTA AMAN, BUAY RUNJUNG, OGAN KOMERING ULU SELATAN, SUMATERA SELATAN",2,56,83,139
https://kawalpemilu.org#19990,"SIMPANG SENDER, BUAY PEMATANG RIBU RANAU TENGAH, OGAN KOMERING ULU SELATAN, SUMATERA SELATAN",5,118,162,280
https://kawalpemilu.org#20285,"PENYANDINGAN, SUNGAI PINANG, OGAN ILIR, SUMATERA SELATAN",2,130,73,203
https://kawalpemilu.org#17507,"ULAK PANDAN, SEMIDANG AJI, OGAN KOMERING ULU, SUMATERA SELATAN",1,50,181,231
https://kawalpemilu.org#17567,"LEKIS REJO, LUBUK RAJA, OGAN KOMERING ULU, SUMATERA SELATAN",14,50,136,186
https://kawalpemilu.org#20780,"SUNGAI MEDANG, CAMBAI, KOTA PRABUMULIH, SUMATERA SELATAN",2,52,113,165
https://kawalpemilu.org#17483,"SUKAJADI, BATURAJA TIMUR, OGAN KOMERING ULU, SUMATERA SELATAN",1,29,137,166
https://kawalpemilu.org#20273,"KOTA DARO II, RANTAU PANJANG, OGAN ILIR, SUMATERA SELATAN",4,120,82,202
https://kawalpemilu.org#17609,"PEMATANG PANGGANG, MESUJI, OGAN KOMERING ILIR, SUMATERA SELATAN",7,61,99,160
https://kawalpemilu.org#19232,"LANGKAN, BANYUASIN III, BANYUASIN, SUMATERA SELATAN",12,36,159,195
https://kawalpemilu.org#17525,"TANJUNG DALAM, LUBUK BATANG, OGAN KOMERING ULU, SUMATERA SELATAN",3,26,196,222
https://kawalpemilu.org#7709,"SIALOGO, ANGKOLA BARAT, TAPANULI SELATAN, SUMATERA UTARA",1,27,221,248
https://kawalpemilu.org#11815,"HARJOSARI II, MEDAN AMPLAS, KOTA MEDAN, SUMATERA UTARA",10,37,169,206
https://kawalpemilu.org#10063,"HAUNATAS II, LAGUBOTI, TOBA SAMOSIR, SUMATERA UTARA",1,177,7,184
https://kawalpemilu.org#11861,"HAMDAN, MEDAN MAIMUN, KOTA MEDAN, SUMATERA UTARA",16,99,122,221
https://kawalpemilu.org#12241,"AEK SIMANAT, DOLOK SIGOMPULON, PADANG LAWAS UTARA, SUMATERA UTARA",2,36,77,113
https://kawalpemilu.org#9299,"HARANGGAOL, HARANGGAOL HORISON, SIMALUNGUN, SUMATERA UTARA",6,243,0,243
https://kawalpemilu.org#8117,"PERK. TJ. KELILING, SALAPIAN, LANGKAT, SUMATERA UTARA",4,111,112,223
https://kawalpemilu.org#11911,"TANJUNG SARI, MEDAN SELAYANG, KOTA MEDAN, SUMATERA UTARA",60,87,76,163
https://kawalpemilu.org#12136,"TIMBANGAN, PADANG SIDEMPUAN UTARA, KOTA PADANG SIDEMPUAN, SUMATERA UTARA",8,19,214,233
https://kawalpemilu.org#10042,"LUMBAN SILINTONG, BALIGE, TOBA SAMOSIR, SUMATERA UTARA",1,212,3,215
https://kawalpemilu.org#9819,"SEI BEROMBANG, PANAI HILIR, LABUHANBATU, SUMATERA UTARA",6,22,130,152
https://kawalpemilu.org#9124,"NUSA HARAPAN, SIANTAR, SIMALUNGUN, SUMATERA UTARA",10,125,49,174
https://kawalpemilu.org#8761,"SUKA MAKMUR, KUTALIMBARU, DELI SERDANG, SUMATERA UTARA",2,209,15,224
https://kawalpemilu.org#6767,"ASAM JAWA, TORGAMBA, LABUHANBATU SELATAN, SUMATERA UTARA",49,42,124,166
https://kawalpemilu.org#9058,"LUBUK PAKAM PEKAN, LUBUK PAKAM, DELI SERDANG, SUMATERA UTARA",26,157,5,162
https://kawalpemilu.org#6836,"SIPARE-PARE TENGAH, MARBAU, LABUHANBATU UTARA, SUMATERA UTARA",2,110,69,179
https://kawalpemilu.org#12044,"KEBUN LADA, BINJAI UTARA, KOTA BINJAI, SUMATERA UTARA",14,24,84,108
https://kawalpemilu.org#9613,"SENDANG SARI, KOTA KISARAN BARAT, ASAHAN, SUMATERA UTARA",2,66,154,220
https://kawalpemilu.org#11770,"DWI KORA, MEDAN HELVETIA, KOTA MEDAN, SUMATERA UTARA",12,83,150,233
https://kawalpemilu.org#9804,"PANGKATAN, PANGKATAN, LABUHANBATU, SUMATERA UTARA",16,131,2,133
https://kawalpemilu.org#11709,"BANGUN SARI, TALAWI, BATU BARA, SUMATERA UTARA",1,83,40,123
https://kawalpemilu.org#8796,"TANJUNG ANOM, PANCUR BATU, DELI SERDANG, SUMATERA UTARA",1,120,150,270
https://kawalpemilu.org#10531,"KAMPUNG SAWAH, NATAL, MANDAILING NATAL, SUMATERA UTARA",1,19,130,149
https://kawalpemilu.org#9050,"SUGIHARJO, BATANG KUIS, DELI SERDANG, SUMATERA UTARA",4,98,103,201
https://kawalpemilu.org#7680,"PARINSORAN, GAROGA, TAPANULI UTARA, SUMATERA UTARA",5,152,2,154
https://kawalpemilu.org#8317,"PAYA TAMPAK, PANGKALAN SUSU, LANGKAT, SUMATERA UTARA",7,51,118,169
https://kawalpemilu.org#11396,"CITAMAN JERNIH, PERBAUNGAN, SERDANG BEDAGAI, SUMATERA UTARA",24,45,96,141
https://kawalpemilu.org#8981,"TANJUNG GUSTA, SUNGGAL, DELI SERDANG, SUMATERA UTARA",14,86,96,182
https://kawalpemilu.org#8755,"SUKA MAJU, SIBOLANGIT, DELI SERDANG, SUMATERA UTARA",1,244,7,251
https://kawalpemilu.org#9465,"RAYA BOSI, RAYA, SIMALUNGUN, SUMATERA UTARA",3,140,13,153
https://kawalpemilu.org#9832,"CINTA MAKMUR, PANAI HULU, LABUHANBATU, SUMATERA UTARA",9,86,154,240
https://kawalpemilu.org#9449,"PURBASARI, TAPIAN DOLOK, SIMALUNGUN, SUMATERA UTARA",7,91,157,248
https://kawalpemilu.org#8978,"MULIO REJO, SUNGGAL, DELI SERDANG, SUMATERA UTARA",5,97,71,168
https://kawalpemilu.org#9738,"AEK PAING, RANTAU UTARA, LABUHANBATU, SUMATERA UTARA",10,28,115,143
https://kawalpemilu.org#11833,"TITI KUNING, MEDAN JOHOR, KOTA MEDAN, SUMATERA UTARA",83,50,84,134
https://kawalpemilu.org#7291,"SARAGIH, MANDUAMAS, TAPANULI TENGAH, SUMATERA UTARA",2,107,26,133
https://kawalpemilu.org#10835,"RAMBA-RAMBA, ULUSUSUA, NIAS SELATAN, SUMATERA UTARA",1,93,7,100
https://kawalpemilu.org#11353,"SITOLU HUTA, PANGURURAN, SAMOSIR, SUMATERA UTARA",1,225,2,227
https://kawalpemilu.org#9683,"SEI SILAU TUA, SETIA JANJI, ASAHAN, SUMATERA UTARA",5,44,69,113
https://kawalpemilu.org#7187,"TETEHOSI AFIA, GUNUNGSITOLI UTARA, KOTA GUNUNGSITOLI, SUMATERA UTARA",5,116,11,127
https://kawalpemilu.org#11830,"TEGAL SARI III, MEDAN AREA, KOTA MEDAN, SUMATERA UTARA",11,58,187,245
https://kawalpemilu.org#8411,"LAU CIMBA, KABANJAHE, KARO, SUMATERA UTARA",30,103,17,120
https://kawalpemilu.org#6815,"SEI SENTANG, KUALUH HILIR, LABUHANBATU UTARA, SUMATERA UTARA",4,50,62,112
https://kawalpemilu.org#7492,"ADIAN KOTING, ADIAN KOTING, TAPANULI UTARA, SUMATERA UTARA",4,66,2,68
https://kawalpemilu.org#9202,"PULIBUAH, RAYA KAHEAN, SIMALUNGUN, SUMATERA UTARA",1,178,24,202
https://kawalpemilu.org#11478,"PABATU III, DOLOK MERAWAN, SERDANG BEDAGAI, SUMATERA UTARA",1,73,137,210
https://kawalpemilu.org#11074,"PRONGIL, TINADA, PAKPAK BHARAT, SUMATERA UTARA",3,95,5,100
https://kawalpemilu.org#11767,"HELVETIA TIMUR, MEDAN HELVETIA, KOTA MEDAN, SUMATERA UTARA",29,176,124,303
https://kawalpemilu.org#9054,"PALUH KEMIRI, LUBUK PAKAM, DELI SERDANG, SUMATERA UTARA",5,98,57,155
https://kawalpemilu.org#9067,"PURWODADI, PAGAR MERBAU, DELI SERDANG, SUMATERA UTARA",7,91,103,194
https://kawalpemilu.org#9804,"PANGKATAN, PANGKATAN, LABUHANBATU, SUMATERA UTARA",4,214,3,217
https://kawalpemilu.org#11841,"TERJUN, MEDAN MARELAN, KOTA MEDAN, SUMATERA UTARA",38,41,137,178
https://kawalpemilu.org#9658,"SEI KAMAH BARU, SEI DADAP, ASAHAN, SUMATERA UTARA",2,64,157,221
https://kawalpemilu.org#12054,"TANGSI, BINJAI KOTA, KOTA BINJAI, SUMATERA UTARA",5,51,146,197
https://kawalpemilu.org#8026,"HILIALAWA, BAWOLATO, NIAS, SUMATERA UTARA",1,55,2,57
https://kawalpemilu.org#8192,"PERDAMAIAN, STABAT, LANGKAT, SUMATERA UTARA",4,72,147,219
https://kawalpemilu.org#12071,"SUMBER KARYA, BINJAI TIMUR, KOTA BINJAI, SUMATERA UTARA",24,84,175,259
https://kawalpemilu.org#7602,"DOLOKSARIBU, PAGARAN, TAPANULI UTARA, SUMATERA UTARA",5,214,1,215
https://kawalpemilu.org#10874,"BOTOHILI, LOLOWA'U, NIAS SELATAN, SUMATERA UTARA",1,102,6,108
https://kawalpemilu.org#6767,"ASAM JAWA, TORGAMBA, LABUHANBATU SELATAN, SUMATERA UTARA",22,64,112,176
https://kawalpemilu.org#6839,"BELONGKUT, MARBAU, LABUHANBATU UTARA, SUMATERA UTARA",12,62,185,247
https://kawalpemilu.org#9840,"SIDIKALANG, SIDIKALANG, DAIRI, SUMATERA UTARA",7,224,24,248
https://kawalpemilu.org#11877,"PADANG BULAN, MEDAN BARU, KOTA MEDAN, SUMATERA UTARA",9,95,109,204
https://kawalpemilu.org#12034,"SEMULA JADI, DATUK BANDAR TIMUR, KOTA TANJUNG BALAI, SUMATERA UTARA",5,26,113,139
https://kawalpemilu.org#12135,"LOSUNG BATU, PADANG SIDEMPUAN UTARA, KOTA PADANG SIDEMPUAN, SUMATERA UTARA",17,12,92,104
https://kawalpemilu.org#7427,"AEK GAMBIR, LUMUT, TAPANULI TENGAH, SUMATERA UTARA",3,87,36,123
https://kawalpemilu.org#7871,"NANGGAR JATI HUTAPADANG, ARSE, TAPANULI SELATAN, SUMATERA UTARA",2,101,66,167
https://kawalpemilu.org#7991,"HILIWETO GIDO, GIDO, NIAS, SUMATERA UTARA",1,194,10,204
https://kawalpemilu.org#11167,"PASARIBU, DOLOK SANGGUL, HUMBANG HASUNDUTAN, SUMATERA UTARA",10,137,3,140
https://kawalpemilu.org#11815,"HARJOSARI II, MEDAN AMPLAS, KOTA MEDAN, SUMATERA UTARA",76,45,107,152
https://kawalpemilu.org#11473,"PABATU I, DOLOK MERAWAN, SERDANG BEDAGAI, SUMATERA UTARA",3,50,93,143
https://kawalpemilu.org#12261,"BINTAIS JULU, DOLOK, PADANG LAWAS UTARA, SUMATERA UTARA",1,20,164,184
https://kawalpemilu.org#9327,"HUTA BAYU, HUTA BAYU RAJA, SIMALUNGUN, SUMATERA UTARA",4,232,5,260
https://kawalpemilu.org#10400,"PANGKAT, LEMBAH SORIK MARAPI, MANDAILING NATAL, SUMATERA UTARA",2,4,172,176
https://kawalpemilu.org#9570,"PERKEBUNAN AEK TARUM, BANDAR PULAU, ASAHAN, SUMATERA UTARA",9,84,121,205
https://kawalpemilu.org#8354,"LUBUK KASIH, BRANDAN BARAT, LANGKAT, SUMATERA UTARA",10,60,95,155
https://kawalpemilu.org#9619,"TELADAN, KOTA KISARAN TIMUR, ASAHAN, SUMATERA UTARA",17,60,142,202
https://kawalpemilu.org#11770,"DWI KORA, MEDAN HELVETIA, KOTA MEDAN, SUMATERA UTARA",55,146,16,162
https://kawalpemilu.org#11559,"PULAU GAMBAR, SERBA JADI, SERDANG BEDAGAI, SUMATERA UTARA",5,40,104,144
https://kawalpemilu.org#11858,"BANTAN TIMUR, MEDAN TEMBUNG, KOTA MEDAN, SUMATERA UTARA",27,109,75,184
https://kawalpemilu.org#11766,"HELVETIA TENGAH, MEDAN HELVETIA, KOTA MEDAN, SUMATERA UTARA",41,98,56,154
https://kawalpemilu.org#8425,"TAMBAK LAU MULGAP II, BERASTAGI, KARO, SUMATERA UTARA",3,216,13,229
https://kawalpemilu.org#11874,"BABURA, MEDAN BARU, KOTA MEDAN, SUMATERA UTARA",5,86,141,227
https://kawalpemilu.org#9429,"SILOU DUNIA, SILOU KAHEAN, SIMALUNGUN, SUMATERA UTARA",2,44,45,89
https://kawalpemilu.org#8767,"SAMPE CITA, KUTALIMBARU, DELI SERDANG, SUMATERA UTARA",5,116,48,164
https://kawalpemilu.org#7658,"PURBATUA, PANGARIBUAN, TAPANULI UTARA, SUMATERA UTARA",2,208,9,217
https://kawalpemilu.org#12107,"DURIAN, BAJENIS, KOTA TEBING TINGGI, SUMATERA UTARA",8,33,148,181
https://kawalpemilu.org#9747,"SIGAMBAL, RANTAU SELATAN, LABUHANBATU, SUMATERA UTARA",2,54,199,253
https://kawalpemilu.org#11853,"SIDOREJO HILIR, MEDAN TEMBUNG, KOTA MEDAN, SUMATERA UTARA",41,82,69,151
https://kawalpemilu.org#7183,"AFIA, GUNUNGSITOLI UTARA, KOTA GUNUNGSITOLI, SUMATERA UTARA",6,32,111,143
https://kawalpemilu.org#9386,"NAGORI BANDAR, BANDAR, SIMALUNGUN, SUMATERA UTARA",10,150,8,158
https://kawalpemilu.org#7403,"SUGA SUGA HUTAGODANG, PASARIBU TOBING, TAPANULI TENGAH, SUMATERA UTARA",4,145,10,155
https://kawalpemilu.org#6767,"ASAM JAWA, TORGAMBA, LABUHANBATU SELATAN, SUMATERA UTARA",5,48,126,174
https://kawalpemilu.org#9408,"SERIBU DOLOK, SILIMAKUTA, SIMALUNGUN, SUMATERA UTARA",19,188,2,190
https://kawalpemilu.org#9685,"SILAU MARAJA, SETIA JANJI, ASAHAN, SUMATERA UTARA",3,92,45,137
https://kawalpemilu.org#11599,"SUKA DAMAI, SEI BAMBAN, SERDANG BEDAGAI, SUMATERA UTARA",23,67,80,147
https://kawalpemilu.org#9004,"TANDEM HILIR I, HAMPARAN PERAK, DELI SERDANG, SUMATERA UTARA",20,43,86,129
https://kawalpemilu.org#9130,"PEMATANG SIMALUNGUN, SIANTAR, SIMALUNGUN, SUMATERA UTARA",27,73,32,105
https://kawalpemilu.org#8396,"KUTAMBARU, KUTAMBARU, LANGKAT, SUMATERA UTARA",9,68,19,87
https://kawalpemilu.org#8343,"LAMA, SEI LEPAN, LANGKAT, SUMATERA UTARA",5,102,40,142
https://kawalpemilu.org#10347,"MALINTANG JAE, BUKIT MALINTANG, MANDAILING NATAL, SUMATERA UTARA",1,4,145,149
https://kawalpemilu.org#7599,"PARHORBOAN, PAGARAN, TAPANULI UTARA, SUMATERA UTARA",5,158,0,158
https://kawalpemilu.org#9674,"TINGGI RAJA, TINGGI RAJA, ASAHAN, SUMATERA UTARA",14,47,60,107
https://kawalpemilu.org#11324,"RONGGUR NIHUTA, RONGGUR NIHUTA, SAMOSIR, SUMATERA UTARA",5,124,2,126
https://kawalpemilu.org#9532,"PERKEBUNAN HESSA, SIMPANG EMPAT, ASAHAN, SUMATERA UTARA",6,100,60,160
