Link KawalPemilu,Nama Kelurahan,Nomor TPS,Suara 01,Suara 02,Suara Sah
https://kawalpemilu.org#599,"SEPAKAT, DELENG POKHKISEN, ACEH TENGGARA, ACEH",1,63,122,185
https://kawalpemilu.org#759,"TANOH ANOU, IDI RAYEUK, ACEH TIMUR, ACEH",10,12,168,180
https://kawalpemilu.org#5772,"DALAM, KARANG BARU, ACEH TAMIANG, ACEH",3,0,0,0
https://kawalpemilu.org#4184,"BULU HADEK, TELUK DALAM, SIMEULUE, ACEH",1,82,95,177
https://kawalpemilu.org#379,"PULONAS, BABUSSALAM, ACEH TENGGARA, ACEH",4,29,120,149
https://kawalpemilu.org#2983,"UJONG BAROH, SIMPANG TIGA, PIDIE, ACEH",1,10,193,203
https://kawalpemilu.org#5056,"PAWOH, SUSOH, ACEH BARAT DAYA, ACEH",1,26,237,263
https://kawalpemilu.org#3048,"BLANG DHOT, TANGSE, PIDIE, ACEH",2,27,151,178
https://kawalpemilu.org#3060,"BLANG PANDAK, TANGSE, PIDIE, ACEH",1,10,183,193
https://kawalpemilu.org#5417,"JAMBO MASI, JAYA, ACEH JAYA, ACEH",1,12,248,260
https://kawalpemilu.org#5184,"LUKUP BARU, RIKIT GAIB, GAYO LUES, ACEH",1,82,22,104
https://kawalpemilu.org#331,"LAWE SIGALA BARAT JAYA, LAWE SIGALA-GALA, ACEH TENGGARA, ACEH",1,41,128,169
https://kawalpemilu.org#5036,"PANTON MAKMUR, MANGGENG, ACEH BARAT DAYA, ACEH",1,15,148,163
https://kawalpemilu.org#4451,"ALUE LAMSABA, JEUNIEB, BIREUEN, ACEH",1,1,86,87
https://kawalpemilu.org#5772,"DALAM, KARANG BARU, ACEH TAMIANG, ACEH",12,30,115,145
https://kawalpemilu.org#3919,"MATANG BAYU, BAKTIYA BARAT, ACEH UTARA, ACEH",3,0,0,0
https://kawalpemilu.org#5698,"BUKET PANYANG DUA, MANYAK PAYED, ACEH TAMIANG, ACEH",2,22,132,154
https://kawalpemilu.org#6631,"PONDOK PABRIK, LANGSA LAMA, KOTA LANGSA, ACEH",4,60,157,217
https://kawalpemilu.org#2096,"LAMBARO NEJID, PEUKAN BADA, ACEH BESAR, ACEH",3,14,149,163
https://kawalpemilu.org#2522,"SAGOE, DELIMA, PIDIE, ACEH",1,10,122,132
https://kawalpemilu.org#6528,"MEUNASAH MESJID, MUARA DUA, KOTA LHOKSEUMAWE, ACEH",8,17,208,225
https://kawalpemilu.org#3465,"MEUNASAH ARON, MUARA BATU, ACEH UTARA, ACEH",2,0,0,0
https://kawalpemilu.org#779,"GAMPONG JALAN, IDI RAYEUK, ACEH TIMUR, ACEH",8,8,141,149
https://kawalpemilu.org#4274,"TELUK AMBON, SINGKIL, ACEH SINGKIL, ACEH",1,45,204,249
https://kawalpemilu.org#6276,"MEURANDEH ALUE, BANDAR DUA, PIDIE JAYA, ACEH",2,15,231,246
https://kawalpemilu.org#6721,"LAE SAGA, LONGKIB, KOTA SUBULUSSALAM, ACEH",1,70,118,188
https://kawalpemilu.org#533,"LAWE KINGA LAPTER, SEMADAM, ACEH TENGGARA, ACEH",2,149,3,152
https://kawalpemilu.org#1578,"KUALA BHEE, WOYLA, ACEH BARAT, ACEH",1,13,140,153
https://kawalpemilu.org#502,"LAWE DUA GABUNGAN, BUKIT TUSAM, ACEH TENGGARA, ACEH",3,30,190,220
https://kawalpemilu.org#2878,"ULEE TUTUE, PIDIE, PIDIE, ACEH",1,20,226,246
https://kawalpemilu.org#759,"TANOH ANOU, IDI RAYEUK, ACEH TIMUR, ACEH",8,6,166,172
https://kawalpemilu.org#2722,"BARO YAMAN, MUTIARA, PIDIE, ACEH",1,15,141,156
https://kawalpemilu.org#149,"KEUDE TRUMON, TRUMON, ACEH SELATAN, ACEH",3,59,184,243
https://kawalpemilu.org#5842,"SIDODADI, KEJURUAN MUDA, ACEH TAMIANG, ACEH",4,19,114,133
https://kawalpemilu.org#6322,"MNS. KAYE RAYA, BANDAR BARU, PIDIE JAYA, ACEH",2,14,150,164
https://kawalpemilu.org#5282,"BUNTUL MUSARA, TERIPE JAYA, GAYO LUES, ACEH",2,90,44,134
https://kawalpemilu.org#5028,"KEDAI, MANGGENG, ACEH BARAT DAYA, ACEH",2,28,170,198
https://kawalpemilu.org#1776,"ALUE KEUMUNING, WOYLA BARAT, ACEH BARAT, ACEH",1,30,124,154
https://kawalpemilu.org#5637,"KUTA PADANG, SUKA MAKMUE, NAGAN RAYA, ACEH",1,9,156,165
https://kawalpemilu.org#432,"SEJAHTERA BARU, BABUL MAKMUR, ACEH TENGGARA, ACEH",1,129,5,134
https://kawalpemilu.org#2899,"LHOK KEUTAPANG, PIDIE, PIDIE, ACEH",4,11,166,177
https://kawalpemilu.org#3274,"ULEE PULO, DEWANTARA, ACEH UTARA, ACEH",4,0,0,0
https://kawalpemilu.org#1017,"BLANG AWE, MADAT, ACEH TIMUR, ACEH",2,8,167,175
https://kawalpemilu.org#53419,"ANTAPAN, BATURITI, TABANAN, BALI",4,197,18,215
https://kawalpemilu.org#53897,"PANJI, SUKASADA, BULELENG, BALI",20,195,21,216
https://kawalpemilu.org#53791,"JUNGUTAN, BEBANDEM, KARANGASEM, BALI",25,148,12,160
https://kawalpemilu.org#53251,"KALIAKAH, NEGARA, JEMBRANA, BALI",16,199,28,227
https://kawalpemilu.org#53953,"DEPEHE, KUBUTAMBAHAN, BULELENG, BALI",14,188,21,209
https://kawalpemilu.org#53606,"TAKMUNG, BANJARANGKAN, KLUNGKUNG, BALI",9,177,27,204
https://kawalpemilu.org#53925,"SARIMEKAR, BULELENG, BULELENG, BALI",6,199,11,210
https://kawalpemilu.org#53381,"BATANNYUH, MARGA, TABANAN, BALI",5,199,0,199
https://kawalpemilu.org#53249,"BALUK, NEGARA, JEMBRANA, BALI",15,239,9,248
https://kawalpemilu.org#53574,"SEBATU, TEGALALLANG, GIANYAR, BALI",26,225,1,226
https://kawalpemilu.org#53645,"PESINGGAHAN, DAWAN, KLUNGKUNG, BALI",11,179,7,186
https://kawalpemilu.org#53495,"BENOA, KUTA SELATAN, BADUNG, BALI",84,184,11,195
https://kawalpemilu.org#53495,"BENOA, KUTA SELATAN, BADUNG, BALI",17,216,25,241
https://kawalpemilu.org#53805,"BAN, KUBU, KARANGASEM, BALI",43,143,1,144
https://kawalpemilu.org#53938,"SAWAN, SAWAN, BULELENG, BALI",2,178,12,190
https://kawalpemilu.org#53638,"PAKSEBALI, DAWAN, KLUNGKUNG, BALI",14,200,6,206
https://kawalpemilu.org#53419,"ANTAPAN, BATURITI, TABANAN, BALI",8,205,4,209
https://kawalpemilu.org#53549,"TEGAL TUGU, GIANYAR, GIANYAR, BALI",6,221,10,231
https://kawalpemilu.org#53975,"PEDUNGAN, DENPASAR SELATAN, KOTA DENPASAR, BALI",57,165,24,189
https://kawalpemilu.org#53505,"TIBUBENENG, KUTA UTARA, BADUNG, BALI",29,276,1,277
https://kawalpemilu.org#53951,"TAJUN, KUBUTAMBAHAN, BULELENG, BALI",13,151,10,161
https://kawalpemilu.org#53431,"PUJUNGAN, PUPUAN, TABANAN, BALI",15,236,5,241
https://kawalpemilu.org#53760,"SUBAGAN, KARANGASEM, KARANGASEM, BALI",41,55,108,163
https://kawalpemilu.org#53460,"SOBANGAN, MENGWI, BADUNG, BALI",3,283,9,292
https://kawalpemilu.org#53385,"MARGA, MARGA, TABANAN, BALI",6,222,1,223
https://kawalpemilu.org#53528,"BURUAN, BLAHBATUH, GIANYAR, BALI",8,238,11,249
https://kawalpemilu.org#53429,"KEBON PADANGAN, PUPUAN, TABANAN, BALI",11,159,8,167
https://kawalpemilu.org#53331,"ANGKAH, SELEMADEG BARAT, TABANAN, BALI",3,153,3,156
https://kawalpemilu.org#53896,"SAMBANGAN, SUKASADA, BULELENG, BALI",1,195,10,205
https://kawalpemilu.org#53677,"PENINJOAN, TEMBUKU, BANGLI, BALI",32,167,7,174
https://kawalpemilu.org#53553,"TAMPAKSIRING, TAMPAKSIRING, GIANYAR, BALI",17,178,5,183
https://kawalpemilu.org#52081,"PAJA, SAJIRA, LEBAK, BANTEN",1,96,80,176
https://kawalpemilu.org#53197,"LENGKONG KARYA, SERPONG UTARA, KOTA TANGERANG SELATAN, BANTEN",20,69,103,172
https://kawalpemilu.org#53231,"KEDAUNG, PAMULANG, KOTA TANGERANG SELATAN, BANTEN",11,99,70,169
https://kawalpemilu.org#52524,"MALANG NENGAH, PAGEDANGAN, TANGERANG, BANTEN",12,34,123,157
https://kawalpemilu.org#53199,"PONDOK BETUNG, PONDOK AREN, KOTA TANGERANG SELATAN, BANTEN",67,79,113,192
https://kawalpemilu.org#53227,"BENDA BARU, PAMULANG, KOTA TANGERANG SELATAN, BANTEN",95,81,79,160
https://kawalpemilu.org#52983,"PARUNG SERAB, CILEDUG, KOTA TANGERANG, BANTEN",15,84,127,211
https://kawalpemilu.org#52536,"KALIASIN, SUKAMULYA, TANGERANG, BANTEN",25,41,114,155
https://kawalpemilu.org#52495,"RANCA IYUH, PANONGAN, TANGERANG, BANTEN",27,80,89,169
https://kawalpemilu.org#52494,"MEKAR BAKTI, PANONGAN, TANGERANG, BANTEN",37,224,39,263
https://kawalpemilu.org#52285,"WANGUNJAYA, CIGEMLONG, LEBAK, BANTEN",4,174,21,195
https://kawalpemilu.org#53238,"KADEMANGAN, SETU, KOTA TANGERANG SELATAN, BANTEN",9,88,133,221
https://kawalpemilu.org#52685,"DOMAS, PONTANG, SERANG, BANTEN",13,38,185,223
https://kawalpemilu.org#52215,"SUKATANI, WANASALAM, LEBAK, BANTEN",7,122,82,204
https://kawalpemilu.org#53067,"CIWADUK, CILEGON, KOTA CILEGON, BANTEN",15,98,160,258
https://kawalpemilu.org#52959,"BATUSARI, BATUCEPER, KOTA TANGERANG, BANTEN",44,42,118,160
https://kawalpemilu.org#52755,"GEMBOR, BINUANG, SERANG, BANTEN",1,78,114,192
https://kawalpemilu.org#52458,"KIARA PAYUNG, PAKUHAJI, TANGERANG, BANTEN",7,59,216,275
https://kawalpemilu.org#52316,"CISEREH, TIGARAKSA, TANGERANG, BANTEN",3,39,132,171
https://kawalpemilu.org#53083,"MASIGIT, JOMBANG, KOTA CILEGON, BANTEN",40,133,101,234
https://kawalpemilu.org#51651,"CIPINANG, ANGSANA, PANDEGLANG, BANTEN",5,63,125,188
https://kawalpemilu.org#52027,"BENDUNGAN, BANJARSARI, LEBAK, BANTEN",1,52,138,190
https://kawalpemilu.org#52457,"SURYA BAHARI, PAKUHAJI, TANGERANG, BANTEN",1,117,39,156
https://kawalpemilu.org#52105,"MUARA CIUJUNG TIMUR, RANGKASBITUNG, LEBAK, BANTEN",31,60,195,255
https://kawalpemilu.org#53123,"TERUMBU, KASEMEN, KOTA SERANG, BANTEN",3,90,85,175
https://kawalpemilu.org#52529,"SURADITA, CISAUK, TANGERANG, BANTEN",11,41,114,155
https://kawalpemilu.org#53182,"RAWA BUNTU, SERPONG, KOTA TANGERANG SELATAN, BANTEN",48,147,55,1
https://kawalpemilu.org#52473,"BINONG, CURUG, TANGERANG, BANTEN",91,104,124,228
https://kawalpemilu.org#52115,"CIMANGEUNTEUNG, RANGKASBITUNG, LEBAK, BANTEN",6,107,99,206
https://kawalpemilu.org#53187,"LENGKONG GUDANG TIMUR, SERPONG, KOTA TANGERANG SELATAN, BANTEN",4,129,151,280
https://kawalpemilu.org#51935,"SITUREGEN, PANGGARANGAN, LEBAK, BANTEN",8,24,165,189
https://kawalpemilu.org#53231,"KEDAUNG, PAMULANG, KOTA TANGERANG SELATAN, BANTEN",150,138,72,210
https://kawalpemilu.org#53221,"PISANGAN, CIPUTAT TIMUR, KOTA TANGERANG SELATAN, BANTEN",23,93,71,164
https://kawalpemilu.org#53155,"CURUG MANIS, CURUG, KOTA SERANG, BANTEN",2,37,139,176
https://kawalpemilu.org#52561,"SANGIANG, SEPATAN TIMUR, TANGERANG, BANTEN",25,60,156,216
https://kawalpemilu.org#52290,"CANGKUDU, BALARAJA, TANGERANG, BANTEN",19,83,120,203
https://kawalpemilu.org#53223,"REMPOA, CIPUTAT TIMUR, KOTA TANGERANG SELATAN, BANTEN",18,142,82,224
https://kawalpemilu.org#53186,"BUARAN, SERPONG, KOTA TANGERANG SELATAN, BANTEN",2,102,140,242
https://kawalpemilu.org#52971,"GONDRONG, CIPONDOH, KOTA TANGERANG, BANTEN",4,56,145,201
https://kawalpemilu.org#52962,"BELENDUNG, BENDA, KOTA TANGERANG, BANTEN",80,170,27,197
https://kawalpemilu.org#53119,"KAGUNGAN, SERANG, KOTA SERANG, BANTEN",12,115,129,244
https://kawalpemilu.org#53194,"PONDOK JAGUNG, SERPONG UTARA, KOTA TANGERANG SELATAN, BANTEN",18,73,122,195
https://kawalpemilu.org#53223,"REMPOA, CIPUTAT TIMUR, KOTA TANGERANG SELATAN, BANTEN",89,92,35,127
https://kawalpemilu.org#52736,"BARENGKOK, KIBIN, SERANG, BANTEN",5,73,149,222
https://kawalpemilu.org#53226,"PAMULANG BARAT, PAMULANG, KOTA TANGERANG SELATAN, BANTEN",93,131,55,189
https://kawalpemilu.org#52414,"KUTA JAYA, PASAR KEMIS, TANGERANG, BANTEN",34,129,98,227
https://kawalpemilu.org#52239,"CIDADAP, CURUG BITUNG, LEBAK, BANTEN",3,67,145,212
https://kawalpemilu.org#51697,"LABUAN, LABUAN, PANDEGLANG, BANTEN",6,50,158,208
https://kawalpemilu.org#52337,"SUKATANI, CISOKA, TANGERANG, BANTEN",10,70,147,217
https://kawalpemilu.org#52416,"PASAR KEMIS, PASAR KEMIS, TANGERANG, BANTEN",5,85,116,201
https://kawalpemilu.org#52592,"GANDARIA, MEKAR BARU, TANGERANG, BANTEN",8,34,133,167
https://kawalpemilu.org#51617,"NANGGALA, CIKEUSIK, PANDEGLANG, BANTEN",3,101,87,188
https://kawalpemilu.org#53212,"SERUA, CIPUTAT, KOTA TANGERANG SELATAN, BANTEN",75,148,69,217
https://kawalpemilu.org#51721,"SODONG, SAKETI, PANDEGLANG, BANTEN",7,89,132,221
https://kawalpemilu.org#52943,"KELAPA INDAH, TANGERANG, KOTA TANGERANG, BANTEN",36,73,97,170
https://kawalpemilu.org#53159,"KARUNDANG, CIPOCOK JAYA, KOTA SERANG, BANTEN",2,95,95,190
https://kawalpemilu.org#53001,"SUKAJADI, KARAWACI, KOTA TANGERANG, BANTEN",23,115,3,118
https://kawalpemilu.org#51713,"PURWARAJA, MENES, PANDEGLANG, BANTEN",3,76,121,197
https://kawalpemilu.org#53175,"UMBUL TENGAH, TAKTAKAN, KOTA SERANG, BANTEN",11,43,192,235
https://kawalpemilu.org#52488,"PASIR GADUNG, CIKUPA, TANGERANG, BANTEN",39,64,112,176
https://kawalpemilu.org#52796,"SINARMUKTI, BAROS, SERANG, BANTEN",4,57,161,218
https://kawalpemilu.org#52548,"CURUG SANGERENG, KELAPA DUA, TANGERANG, BANTEN",7,47,198,245
https://kawalpemilu.org#52325,"TIPAR RAYA, JAMBE, TANGERANG, BANTEN",2,62,120,182
https://kawalpemilu.org#51690,"KOLELET, PICUNG, PANDEGLANG, BANTEN",7,96,56,152
https://kawalpemilu.org#53043,"PADURENAN, KARANG TENGAH, KOTA TANGERANG, BANTEN",51,146,30,176
https://kawalpemilu.org#53203,"PONDOK AREN, PONDOK AREN, KOTA TANGERANG SELATAN, BANTEN",25,98,193,291
https://kawalpemilu.org#52950,"GANDASARI, JATIUWUNG, KOTA TANGERANG, BANTEN",5,77,153,230
https://kawalpemilu.org#53227,"BENDA BARU, PAMULANG, KOTA TANGERANG SELATAN, BANTEN",111,149,95,244
https://kawalpemilu.org#52415,"KUTA BARU, PASAR KEMIS, TANGERANG, BANTEN",64,96,83,179
https://kawalpemilu.org#52657,"RANJENG, CIRUAS, SERANG, BANTEN",3,66,122,188
https://kawalpemilu.org#52672,"KENDAYAKAN, KRAGILAN, SERANG, BANTEN",33,83,92,175
https://kawalpemilu.org#52747,"WALIKUKUN, CARENANG, SERANG, BANTEN",14,41,196,237
https://kawalpemilu.org#51980,"GIRIJAGABAYA, MUNCANG, LEBAK, BANTEN",7,38,161,199
https://kawalpemilu.org#51752,"SUKAMANAH, JIPUT, PANDEGLANG, BANTEN",5,20,172,192
https://kawalpemilu.org#51908,"PASIRLOA, SINDANGRESMI, PANDEGLANG, BANTEN",6,78,41,119
https://kawalpemilu.org#52105,"MUARA CIUJUNG TIMUR, RANGKASBITUNG, LEBAK, BANTEN",46,72,154,226
https://kawalpemilu.org#53001,"SUKAJADI, KARAWACI, KOTA TANGERANG, BANTEN",11,218,0,218
https://kawalpemilu.org#52920,"GUNUNGSARI, GUNUNG SARI, SERANG, BANTEN",9,67,92,159
https://kawalpemilu.org#51712,"SUKAMANAH, MENES, PANDEGLANG, BANTEN",4,62,98,160
https://kawalpemilu.org#51917,"SUKARAJA, MALINGPING, LEBAK, BANTEN",13,109,132,241
https://kawalpemilu.org#53187,"LENGKONG GUDANG TIMUR, SERPONG, KOTA TANGERANG SELATAN, BANTEN",11,78,159,237
https://kawalpemilu.org#52513,"CIRARAB, LEGOK, TANGERANG, BANTEN",2,85,155,240
https://kawalpemilu.org#53124,"WARUNG JAUD, KASEMEN, KOTA SERANG, BANTEN",19,108,131,239
https://kawalpemilu.org#21475,"PASAR BEMBAH, AIR NAPAL, BENGKULU UTARA, BENGKULU",1,139,87,226
https://kawalpemilu.org#21324,"GUNUNG AGUNG, ARGA MAKMUR, BENGKULU UTARA, BENGKULU",6,72,117,189
https://kawalpemilu.org#22246,"SOSOKAN TABA, MUARA KEMUMU, KEPAHIANG, BENGKULU",13,105,47,152
https://kawalpemilu.org#22302,"KEBUN TEBENG, RATU AGUNG, KOTA BENGKULU, BENGKULU",14,93,139,232
https://kawalpemilu.org#21833,"TALANG BERINGIN, SELUMA UTARA, SELUMA, BENGKULU",1,39,149,188
https://kawalpemilu.org#21388,"DURIAN AMPARAN, BATIK NAU, BENGKULU UTARA, BENGKULU",1,100,60,160
https://kawalpemilu.org#22000,"MARGA MULYA SAKTI, PENARIK, MUKOMUKO, BENGKULU",3,147,67,214
https://kawalpemilu.org#21194,"AIR MELES BAWAH, CURUP TIMUR, REJANG LEBONG, BENGKULU",3,72,85,157
https://kawalpemilu.org#20997,"JERANGLAH TINGGI, MANNA, BENGKULU SELATAN, BENGKULU",2,127,97,224
https://kawalpemilu.org#22268,"TIMUR INDAH, SINGARAN PATI, KOTA BENGKULU, BENGKULU",7,77,148,225
https://kawalpemilu.org#20848,"SIDOREJO, PONDOK KELAPA, BENGKULU TENGAH, BENGKULU",1,104,53,157
https://kawalpemilu.org#21213,"SIDEREJO, CURUP TENGAH, REJANG LEBONG, BENGKULU",8,79,152,231
https://kawalpemilu.org#84753,"SUKAU DATANG I, PELABAI, LEBONG, BENGKULU",2,101,135,236
https://kawalpemilu.org#21797,"KUNGKAI BARU, AIR PERIUKAN, SELUMA, BENGKULU",5,202,12,214
https://kawalpemilu.org#22247,"TALANG TIGE, MUARA KEMUMU, KEPAHIANG, BENGKULU",4,138,125,263
https://kawalpemilu.org#20999,"TAMBANGAN, MANNA, BENGKULU SELATAN, BENGKULU",1,143,95,238
https://kawalpemilu.org#42042,"SRIMARTANI, PIYUNGAN, BANTUL, DAERAH ISTIMEWA YOGYAKARTA",42,222,16,238
https://kawalpemilu.org#41944,"PURWOSARI, GIRIMULYO, KULON PROGO, DAERAH ISTIMEWA YOGYAKARTA",7,99,39,138
https://kawalpemilu.org#42289,"SINDUHARJO, NGAGLIK, SLEMAN, DAERAH ISTIMEWA YOGYAKARTA",49,140,51,191
https://kawalpemilu.org#42361,"PANEMBAHAN, KRATON, KOTA YOGYAKARTA, DAERAH ISTIMEWA YOGYAKARTA",34,161,62,223
https://kawalpemilu.org#42152,"PONJONG, PONJONG, GUNUNGKIDUL, DAERAH ISTIMEWA YOGYAKARTA",16,80,68,148
https://kawalpemilu.org#42199,"PLANJAN, SAPTOSARI, GUNUNGKIDUL, DAERAH ISTIMEWA YOGYAKARTA",18,134,16,150
https://kawalpemilu.org#42085,"BLEBERAN, PLAYEN, GUNUNGKIDUL, DAERAH ISTIMEWA YOGYAKARTA",20,171,8,179
https://kawalpemilu.org#41941,"JATIMULYO, GIRIMULYO, KULON PROGO, DAERAH ISTIMEWA YOGYAKARTA",14,119,16,135
https://kawalpemilu.org#42152,"PONJONG, PONJONG, GUNUNGKIDUL, DAERAH ISTIMEWA YOGYAKARTA",5,64,90,154
https://kawalpemilu.org#41978,"TIRTOSARI, KRETEK, BANTUL, DAERAH ISTIMEWA YOGYAKARTA",15,86,57,143
https://kawalpemilu.org#42370,"KEPARAKAN, MERGANGSAN, KOTA YOGYAKARTA, DAERAH ISTIMEWA YOGYAKARTA",4,136,36,172
https://kawalpemilu.org#42279,"SELOMARTANI, KALASAN, SLEMAN, DAERAH ISTIMEWA YOGYAKARTA",29,94,28,122
https://kawalpemilu.org#42045,"TIMBULHARJO, SEWON, BANTUL, DAERAH ISTIMEWA YOGYAKARTA",49,214,70,284
https://kawalpemilu.org#42078,"PENGKOL, NGLIPAR, GUNUNGKIDUL, DAERAH ISTIMEWA YOGYAKARTA",11,118,44,162
https://kawalpemilu.org#42047,"PANGGUNGHARJO, SEWON, BANTUL, DAERAH ISTIMEWA YOGYAKARTA",12,157,65,222
https://kawalpemilu.org#42113,"KARANGASEM, PALIYAN, GUNUNGKIDUL, DAERAH ISTIMEWA YOGYAKARTA",12,199,51,250
https://kawalpemilu.org#42212,"KEMADANG, TANJUNGSARI, GUNUNGKIDUL, DAERAH ISTIMEWA YOGYAKARTA",17,89,117,206
https://kawalpemilu.org#42131,"SEMANU, SEMANU, GUNUNGKIDUL, DAERAH ISTIMEWA YOGYAKARTA",27,125,19,144
https://kawalpemilu.org#42370,"KEPARAKAN, MERGANGSAN, KOTA YOGYAKARTA, DAERAH ISTIMEWA YOGYAKARTA",23,144,24,168
https://kawalpemilu.org#41971,"GADINGHARJO, SANDEN, BANTUL, DAERAH ISTIMEWA YOGYAKARTA",8,122,91,213
https://kawalpemilu.org#42370,"KEPARAKAN, MERGANGSAN, KOTA YOGYAKARTA, DAERAH ISTIMEWA YOGYAKARTA",2,147,75,222
https://kawalpemilu.org#41885,"NGESTIHARJO, WATES, KULON PROGO, DAERAH ISTIMEWA YOGYAKARTA",6,141,99,240
https://kawalpemilu.org#41975,"TIRTOMULYO, KRETEK, BANTUL, DAERAH ISTIMEWA YOGYAKARTA",1,102,72,174
https://kawalpemilu.org#41868,"PALIHAN, TEMON, KULON PROGO, DAERAH ISTIMEWA YOGYAKARTA",5,132,61,193
https://kawalpemilu.org#41968,"TRIMURTI, SRANDAKAN, BANTUL, DAERAH ISTIMEWA YOGYAKARTA",18,167,45,212
https://kawalpemilu.org#41986,"MULYODADI, BAMBANGLIPURO, BANTUL, DAERAH ISTIMEWA YOGYAKARTA",21,144,48,192
https://kawalpemilu.org#42374,"SEMAKI, UMBULHARJO, KOTA YOGYAKARTA, DAERAH ISTIMEWA YOGYAKARTA",18,127,34,161
https://kawalpemilu.org#42244,"SENDANGAGUNG, MINGGIR, SLEMAN, DAERAH ISTIMEWA YOGYAKARTA",27,144,30,174
https://kawalpemilu.org#42374,"SEMAKI, UMBULHARJO, KOTA YOGYAKARTA, DAERAH ISTIMEWA YOGYAKARTA",5,186,48,234
https://kawalpemilu.org#26057,"TANJUNG BARAT, JAGAKARSA, JAKARTA SELATAN, DKI JAKARTA",99,51,132,183
https://kawalpemilu.org#26115,"KLENDER, DUREN SAWIT, JAKARTA TIMUR, DKI JAKARTA",13,90,154,244
https://kawalpemilu.org#26137,"SETU, CIPAYUNG, JAKARTA TIMUR, DKI JAKARTA",27,149,119,268
https://kawalpemilu.org#26107,"RAWA TERATE, CAKUNG, JAKARTA TIMUR, DKI JAKARTA",75,89,85,174
https://kawalpemilu.org#26108,"PENGGILINGAN, CAKUNG, JAKARTA TIMUR, DKI JAKARTA",215,89,126,215
https://kawalpemilu.org#25861,"KWITANG, SENEN, JAKARTA PUSAT, DKI JAKARTA",49,140,95,235
https://kawalpemilu.org#25962,"KEBON JERUK, KEBON JERUK, JAKARTA BARAT, DKI JAKARTA",138,80,194,274
https://kawalpemilu.org#25915,"SEMPER BARAT, CILINCING, JAKARTA UTARA, DKI JAKARTA",86,105,100,205
https://kawalpemilu.org#26127,"CIRACAS, CIRACAS, JAKARTA TIMUR, DKI JAKARTA",69,133,131,264
https://kawalpemilu.org#26003,"MENTENG ATAS, SETIABUDI, JAKARTA SELATAN, DKI JAKARTA",89,144,52,196
https://kawalpemilu.org#26074,"PULO GADUNG, PULOGADUNG, JAKARTA TIMUR, DKI JAKARTA",101,183,98,281
https://kawalpemilu.org#26094,"BATU AMPAR, KRAMATJATI, JAKARTA TIMUR, DKI JAKARTA",25,73,145,218
https://kawalpemilu.org#25931,"CENGKARENG TIMUR, CENGKARENG, JAKARTA BARAT, DKI JAKARTA",149,148,92,240
https://kawalpemilu.org#26116,"PONDOK KELAPA, DUREN SAWIT, JAKARTA TIMUR, DKI JAKARTA",177,85,136,221
https://kawalpemilu.org#25928,"RAWA BUAYA, CENGKARENG, JAKARTA BARAT, DKI JAKARTA",166,112,142,254
https://kawalpemilu.org#25868,"MENTENG, MENTENG, JAKARTA PUSAT, DKI JAKARTA",31,88,131,219
https://kawalpemilu.org#26071,"KEBON MANGGIS, MATRAMAN, JAKARTA TIMUR, DKI JAKARTA",23,68,145,213
https://kawalpemilu.org#25938,"JELAMBAR BARU, GROGOL PETAMBURAN, JAKARTA BARAT, DKI JAKARTA",99,211,42,253
https://kawalpemilu.org#26128,"CIBUBUR, CIRACAS, JAKARTA TIMUR, DKI JAKARTA",128,90,125,215
https://kawalpemilu.org#26068,"UTAN KAYU UTARA, MATRAMAN, JAKARTA TIMUR, DKI JAKARTA",89,104,152,256
https://kawalpemilu.org#25870,"CIKINI, MENTENG, JAKARTA PUSAT, DKI JAKARTA",4,110,130,240
https://kawalpemilu.org#25926,"CENGKARENG BARAT, CENGKARENG, JAKARTA BARAT, DKI JAKARTA",98,133,95,228
https://kawalpemilu.org#25995,"BUKIT DURI, TEBET, JAKARTA SELATAN, DKI JAKARTA",41,48,161,209
https://kawalpemilu.org#26118,"MALAKA JAYA, DUREN SAWIT, JAKARTA TIMUR, DKI JAKARTA",62,98,136,234
https://kawalpemilu.org#25931,"CENGKARENG TIMUR, CENGKARENG, JAKARTA BARAT, DKI JAKARTA",51,134,84,218
https://kawalpemilu.org#26128,"CIBUBUR, CIRACAS, JAKARTA TIMUR, DKI JAKARTA",101,129,128,257
https://kawalpemilu.org#25923,"KELAPA GADING BARAT, KELAPA GADING, JAKARTA UTARA, DKI JAKARTA",65,105,110,215
https://kawalpemilu.org#25843,"KARANG ANYAR, SAWAH BESAR, JAKARTA PUSAT, DKI JAKARTA",51,54,156,210
https://kawalpemilu.org#25997,"MANGGARAI, TEBET, JAKARTA SELATAN, DKI JAKARTA",69,59,112,171
https://kawalpemilu.org#26111,"CAKUNG BARAT, CAKUNG, JAKARTA TIMUR, DKI JAKARTA",3,65,156,221
https://kawalpemilu.org#25981,"KOTA BAMBU SELATAN, PALMERAH, JAKARTA BARAT, DKI JAKARTA",62,62,151,213
https://kawalpemilu.org#25872,"KEBON SIRIH, MENTENG, JAKARTA PUSAT, DKI JAKARTA",2,116,108,224
https://kawalpemilu.org#26097,"CAWANG, KRAMATJATI, JAKARTA TIMUR, DKI JAKARTA",92,96,99,195
https://kawalpemilu.org#26110,"UJUNG MENTENG, CAKUNG, JAKARTA TIMUR, DKI JAKARTA",57,79,135,214
https://kawalpemilu.org#26078,"RAWAMANGUN, PULOGADUNG, JAKARTA TIMUR, DKI JAKARTA",23,138,98,236
https://kawalpemilu.org#25898,"KEBON BAWANG, TANJUNG PRIOK, JAKARTA UTARA, DKI JAKARTA",147,116,71,187
https://kawalpemilu.org#26049,"DUREN TIGA, PANCORAN, JAKARTA SELATAN, DKI JAKARTA",24,73,88,161
https://kawalpemilu.org#25962,"KEBON JERUK, KEBON JERUK, JAKARTA BARAT, DKI JAKARTA",6,95,152,247
https://kawalpemilu.org#26089,"CIPINANG BESAR UTARA, JATINEGARA, JAKARTA TIMUR, DKI JAKARTA",14,77,138,215
https://kawalpemilu.org#26128,"CIBUBUR, CIRACAS, JAKARTA TIMUR, DKI JAKARTA",37,95,138,233
https://kawalpemilu.org#26029,"CILANDAK BARAT, CILANDAK, JAKARTA SELATAN, DKI JAKARTA",29,102,111,213
https://kawalpemilu.org#26057,"TANJUNG BARAT, JAGAKARSA, JAKARTA SELATAN, DKI JAKARTA",64,75,114,189
https://kawalpemilu.org#26017,"RAGUNAN, PASAR MINGGU, JAKARTA SELATAN, DKI JAKARTA",28,98,127,225
https://kawalpemilu.org#25958,"PEKOJAN, TAMBORA, JAKARTA BARAT, DKI JAKARTA",51,164,96,260
https://kawalpemilu.org#26064,"ULUJAMI, PESANGGRAHAN, JAKARTA SELATAN, DKI JAKARTA",81,74,137,211
https://kawalpemilu.org#25939,"WIJAYA KUSUMA, GROGOL PETAMBURAN, JAKARTA BARAT, DKI JAKARTA",10,188,6,194
https://kawalpemilu.org#25883,"KAMPUNG RAWA, JOHAR BARU, JAKARTA PUSAT, DKI JAKARTA",63,67,138,205
https://kawalpemilu.org#26108,"PENGGILINGAN, CAKUNG, JAKARTA TIMUR, DKI JAKARTA",130,83,125,208
https://kawalpemilu.org#26111,"CAKUNG BARAT, CAKUNG, JAKARTA TIMUR, DKI JAKARTA",9,62,95,157
https://kawalpemilu.org#26121,"MAKASAR, MAKASAR, JAKARTA TIMUR, DKI JAKARTA",67,128,96,224
https://kawalpemilu.org#26119,"PONDOK KOPI, DUREN SAWIT, JAKARTA TIMUR, DKI JAKARTA",33,92,119,211
https://kawalpemilu.org#25923,"KELAPA GADING BARAT, KELAPA GADING, JAKARTA UTARA, DKI JAKARTA",55,202,9,0
https://kawalpemilu.org#25955,"JEMBATAN BESI, TAMBORA, JAKARTA BARAT, DKI JAKARTA",70,141,75,216
https://kawalpemilu.org#25917,"PADEMANGAN TIMUR, PADEMANGAN, JAKARTA UTARA, DKI JAKARTA",96,111,87,198
https://kawalpemilu.org#26111,"CAKUNG BARAT, CAKUNG, JAKARTA TIMUR, DKI JAKARTA",162,50,132,182
https://kawalpemilu.org#25898,"KEBON BAWANG, TANJUNG PRIOK, JAKARTA UTARA, DKI JAKARTA",21,115,100,215
https://kawalpemilu.org#25888,"PENJARINGAN, PENJARINGAN, JAKARTA UTARA, DKI JAKARTA",286,91,116,207
https://kawalpemilu.org#25931,"CENGKARENG TIMUR, CENGKARENG, JAKARTA BARAT, DKI JAKARTA",109,125,93,218
https://kawalpemilu.org#26097,"CAWANG, KRAMATJATI, JAKARTA TIMUR, DKI JAKARTA",2,77,67,144
https://kawalpemilu.org#26133,"CIPAYUNG, CIPAYUNG, JAKARTA TIMUR, DKI JAKARTA",60,128,105,233
https://kawalpemilu.org#25868,"MENTENG, MENTENG, JAKARTA PUSAT, DKI JAKARTA",80,84,156,240
https://kawalpemilu.org#25909,"CILINCING, CILINCING, JAKARTA UTARA, DKI JAKARTA",97,117,90,207
https://kawalpemilu.org#25971,"SEMANAN, KALIDERES, JAKARTA BARAT, DKI JAKARTA",124,63,80,143
https://kawalpemilu.org#26020,"KEBAGUSAN, PASAR MINGGU, JAKARTA SELATAN, DKI JAKARTA",104,120,112,232
https://kawalpemilu.org#25928,"RAWA BUAYA, CENGKARENG, JAKARTA BARAT, DKI JAKARTA",51,194,60,254
https://kawalpemilu.org#26053,"JAGAKARSA, JAGAKARSA, JAKARTA SELATAN, DKI JAKARTA",17,90,125,215
https://kawalpemilu.org#25966,"DURI KEPA, KEBON JERUK, JAKARTA BARAT, DKI JAKARTA",94,61,80,141
https://kawalpemilu.org#25903,"TUGU UTARA, KOJA, JAKARTA UTARA, DKI JAKARTA",139,129,101,230
https://kawalpemilu.org#25984,"MERUYA UTARA, KEMBANGAN, JAKARTA BARAT, DKI JAKARTA",91,100,102,202
https://kawalpemilu.org#26009,"BANGKA, MAMPANG PRAPATAN, JAKARTA SELATAN, DKI JAKARTA",22,132,76,208
https://kawalpemilu.org#25972,"TEGAL ALUR, KALIDERES, JAKARTA BARAT, DKI JAKARTA",93,134,80,214
https://kawalpemilu.org#25890,"KAPUK MUARA, PENJARINGAN, JAKARTA UTARA, DKI JAKARTA",1,65,137,202
https://kawalpemilu.org#75273,"MEKAR JAYA, DUHIADAA, PAHUWATO, GORONTALO",1,164,107,271
https://kawalpemilu.org#75089,"MOUTONG, TILONGKABILA, BONE BOLANGO, GORONTALO",1,100,124,224
https://kawalpemilu.org#75304,"GENTUMA, GENTUMA RAYA, GORONTALO UTARA, GORONTALO",1,39,130,169
https://kawalpemilu.org#74724,"HUTUO, LIMBOTO, GORONTALO, GORONTALO",3,134,118,252
https://kawalpemilu.org#75305,"IMANA, ATINGGOLA, GORONTALO UTARA, GORONTALO",5,44,170,214
https://kawalpemilu.org#75229,"PENTADU, PAGUAT, PAHUWATO, GORONTALO",2,131,88,219
https://kawalpemilu.org#75237,"BUHU JAYA, PAGUAT, PAHUWATO, GORONTALO",3,163,95,258
https://kawalpemilu.org#74858,"SIDOMUKTI, MOOTILANGO, GORONTALO, GORONTALO",4,169,39,208
https://kawalpemilu.org#75108,"OLELE, KABILA BONE, BONE BOLANGO, GORONTALO",2,113,115,228
https://kawalpemilu.org#16780,"PONDOK MEJA, MESTONG, MUARO JAMBI, JAMBI",9,149,75,224
https://kawalpemilu.org#17037,"LAGAN TENGAH, GERAGAI, TANJUNG JABUNG TIMUR, JAMBI",9,173,79,252
https://kawalpemilu.org#16485,"PANGKAL BULIAN, PAUH, SAROLANGUN, JAMBI",2,101,151,252
https://kawalpemilu.org#17041,"KOTA BARU, GERAGAI, TANJUNG JABUNG TIMUR, JAMBI",1,205,54,259
https://kawalpemilu.org#17371,"SUNGAI ASAM, PASAR JAMBI, KOTA JAMBI, JAMBI",1,97,37,134
https://kawalpemilu.org#17364,"RAJAWALI, JAMBI TIMUR, KOTA JAMBI, JAMBI",25,128,48,176
https://kawalpemilu.org#17392,"KENALI BESAR, ALAM BARAJO, KOTA JAMBI, JAMBI",98,95,57,152
https://kawalpemilu.org#16800,"KASANG KUMPEH, KUMPEH ULU, MUARO JAMBI, JAMBI",4,71,82,153
https://kawalpemilu.org#16189,"RENAH ALAI, JANGKAT, MERANGIN, JAMBI",3,65,120,185
https://kawalpemilu.org#17016,"PARIT CULUM I, MUARA SABAK BARAT, TANJUNG JABUNG TIMUR, JAMBI",9,31,141,172
https://kawalpemilu.org#16245,"LUBUK NAPAL, TABIR, MERANGIN, JAMBI",2,46,112,158
https://kawalpemilu.org#17255,"WIROTHO AGUNG, RIMBO BUJANG, TEBO, JAMBI",36,75,110,185
https://kawalpemilu.org#17390,"KENALI ASAM BAWAH, KOTA BARU, KOTA JAMBI, JAMBI",42,82,94,176
https://kawalpemilu.org#16466,"AUR GADING, SAROLANGUN, SAROLANGUN, JAMBI",11,41,133,174
https://kawalpemilu.org#16431,"LUBUK BANGKAR, BATANG ASAI, SAROLANGUN, JAMBI",3,85,27,112
https://kawalpemilu.org#17391,"KENALI ASAM ATAS, KOTA BARU, KOTA JAMBI, JAMBI",6,95,139,234
https://kawalpemilu.org#16972,"MENDAHARA ILIR, MENDAHARA, TANJUNG JABUNG TIMUR, JAMBI",8,138,102,240
https://kawalpemilu.org#16804,"PANCA MULYA, SUNGAI BAHAR, MUARO JAMBI, JAMBI",7,94,39,133
https://kawalpemilu.org#84663,"DATARAN PINANG, KUALA BETARA, TANJUNG JABUNG BARAT, JAMBI",2,94,87,181
https://kawalpemilu.org#16818,"TANGKIT, SUNGAI GELAM, MUARO JAMBI, JAMBI",3,154,71,225
https://kawalpemilu.org#16900,"SUKA DAMAI, TEBING TINGGI, TANJUNG JABUNG BARAT, JAMBI",2,62,60,122
https://kawalpemilu.org#16987,"RANTAU JAYA, RANTAU RASAU, TANJUNG JABUNG TIMUR, JAMBI",3,123,111,234
https://kawalpemilu.org#17148,"BANGUN HARJO, PELEPAT ILIR, BUNGO, JAMBI",5,167,33,200
https://kawalpemilu.org#17350,"THEHOK, JAMBI SELATAN, KOTA JAMBI, JAMBI",37,54,70,124
https://kawalpemilu.org#16587,"PEMATANG GADUNG, MERSAM, BATANGHARI, JAMBI",8,115,55,170
https://kawalpemilu.org#16779,"SUKA MAJU, MESTONG, MUARO JAMBI, JAMBI",3,89,144,233
https://kawalpemilu.org#17351,"WIJAYA PURA, JAMBI SELATAN, KOTA JAMBI, JAMBI",6,130,127,257
https://kawalpemilu.org#16639,"KOTO BOYO, BATIN XXIV, BATANGHARI, JAMBI",2,77,92,169
https://kawalpemilu.org#27514,"JAGABAYA, CIMAUNG, BANDUNG, JAWA BARAT",39,114,123,237
https://kawalpemilu.org#27430,"CIPOREAT, CILENGKRANG, BANDUNG, JAWA BARAT",11,89,169,258
https://kawalpemilu.org#26426,"TAPOS, TENJO, BOGOR, JAWA BARAT",14,63,190,253
https://kawalpemilu.org#30760,"KERTAJAYA, BONGAS, INDRAMAYU, JAWA BARAT",9,164,59,223
https://kawalpemilu.org#31059,"CIKAUM BARAT, CIKAUM, SUBANG, JAWA BARAT",6,147,68,215
https://kawalpemilu.org#31989,"CIBURUY, PADALARANG, BANDUNG BARAT, JAWA BARAT",30,64,190,254
https://kawalpemilu.org#26822,"SUKALUYU, KALIBUNDER, SUKABUMI, JAWA BARAT",4,18,72,90
https://kawalpemilu.org#32202,"SADANGSERANG, COBLONG, KOTA BANDUNG, JAWA BARAT",3,78,155,233
https://kawalpemilu.org#29779,"KALIBARU, TENGAH TANI, CIREBON, JAWA BARAT",12,149,86,235
https://kawalpemilu.org#31048,"PANGARENGAN, LEGONKULON, SUBANG, JAWA BARAT",1,144,43,187
https://kawalpemilu.org#26964,"BOJONGSARI, NYALINDUNG, SUKABUMI, JAWA BARAT",3,12,173,185
https://kawalpemilu.org#28433,"SALEBU, MANGUNREJA, TASIKMALAYA, JAWA BARAT",3,99,130,229
https://kawalpemilu.org#30900,"PASIRBUNGUR, PURWADADI, SUBANG, JAWA BARAT",10,132,63,195
https://kawalpemilu.org#28333,"KARANGMUKTI, SALAWU, TASIKMALAYA, JAWA BARAT",7,30,115,145
https://kawalpemilu.org#27163,"BENJOT, CUGENANG, CIANJUR, JAWA BARAT",12,74,92,166
https://kawalpemilu.org#29865,"SINDANGHURIP, BANTARUJEG, MAJALENGKA, JAWA BARAT",2,47,108,155
https://kawalpemilu.org#31951,"MARGALAKSANA, CIPEUNDEUY, BANDUNG BARAT, JAWA BARAT",10,37,190,227
https://kawalpemilu.org#32024,"KARANGANYAR, CILILIN, BANDUNG BARAT, JAWA BARAT",3,88,135,223
https://kawalpemilu.org#30127,"KARAYUNAN, CIGASONG, MAJALENGKA, JAWA BARAT",4,92,128,220
https://kawalpemilu.org#26268,"PADURENAN, GUNUNG SINDUR, BOGOR, JAWA BARAT",13,42,91,133
https://kawalpemilu.org#89265,"RANCAEKEK KENCANA, RANCAEKEK, BANDUNG, JAWA BARAT",28,50,127,177
https://kawalpemilu.org#30793,"SITURAJA, GANTAR, INDRAMAYU, JAWA BARAT",1,108,61,169
https://kawalpemilu.org#29395,"ASTANALANGGAR, LOSARI, CIREBON, JAWA BARAT",1,103,47,150
https://kawalpemilu.org#27279,"PADASUKA, CIBINONG, CIANJUR, JAWA BARAT",16,47,92,139
https://kawalpemilu.org#32523,"KALIBARU, CILODONG, KOTA DEPOK, JAWA BARAT",44,46,120,166
https://kawalpemilu.org#26149,"CIBINONG, CIBINONG, BOGOR, JAWA BARAT",59,25,113,138
https://kawalpemilu.org#32331,"MARGASARI, BUAHBATU, KOTA BANDUNG, JAWA BARAT",112,66,170,236
https://kawalpemilu.org#27536,"NAGREG, NAGREG, BANDUNG, JAWA BARAT",10,62,86,148
https://kawalpemilu.org#27073,"SIRNAGALIH, CILAKU, CIANJUR, JAWA BARAT",16,62,100,177
https://kawalpemilu.org#31740,"SUMBERJAYA, TAMBUN SELATAN, BEKASI, JAWA BARAT",200,89,149,238
https://kawalpemilu.org#30831,"RANCAJAWAT, TUKDANA, INDRAMAYU, JAWA BARAT",12,93,48,141
https://kawalpemilu.org#31383,"DUREN, KLARI, KARAWANG, JAWA BARAT",49,99,135,234
https://kawalpemilu.org#32423,"PEKAYON JAYA, BEKASI SELATAN, KOTA BEKASI, JAWA BARAT",84,164,114,278
https://kawalpemilu.org#32410,"BINTARA, BEKASI BARAT, KOTA BEKASI, JAWA BARAT",23,81,122,203
https://kawalpemilu.org#30794,"BALERAJA, GANTAR, INDRAMAYU, JAWA BARAT",3,93,109,202
https://kawalpemilu.org#28177,"TENJONAGARA, SUCINARAJA, GARUT, JAWA BARAT",11,107,131,238
https://kawalpemilu.org#30691,"PANYINDANGAN WETAN, SINDANG, INDRAMAYU, JAWA BARAT",10,162,66,228
https://kawalpemilu.org#31597,"CIPTAMARGA, JAYAKERTA, KARAWANG, JAWA BARAT",17,75,128,203
https://kawalpemilu.org#27055,"CIBAREGBEG, CIBEBER, CIANJUR, JAWA BARAT",12,46,143,189
https://kawalpemilu.org#28698,"BANGBAYANG, CIPAKU, CIAMIS, JAWA BARAT",20,45,107,152
https://kawalpemilu.org#26224,"MAMPIR, CILEUNGSI, BOGOR, JAWA BARAT",19,41,90,131
https://kawalpemilu.org#28373,"SETIAWANGI, JATIWARAS, TASIKMALAYA, JAWA BARAT",7,55,100,155
https://kawalpemilu.org#31920,"CIGUGUR GIRANG, PARONGPONG, BANDUNG BARAT, JAWA BARAT",25,51,151,202
https://kawalpemilu.org#28577,"MALEBER, CIAMIS, CIAMIS, JAWA BARAT",15,93,47,140
https://kawalpemilu.org#31253,"TARINGGULTONGGOH, WANAYASA, PURWAKARTA, JAWA BARAT",8,43,198,241
https://kawalpemilu.org#31804,"KARANGREJA, PEBAYURAN, BEKASI, JAWA BARAT",8,117,95,212
https://kawalpemilu.org#27654,"SUDI, IBUN, BANDUNG, JAWA BARAT",17,124,52,176
https://kawalpemilu.org#27961,"MANGKURAKYAT, CILAWU, GARUT, JAWA BARAT",3,71,176,247
https://kawalpemilu.org#32148,"MEKARWANGI, TANAH SAREAL, KOTA BOGOR, JAWA BARAT",42,32,136,168
https://kawalpemilu.org#28567,"SUKARATU, SUKARESIK, TASIKMALAYA, JAWA BARAT",14,36,131,167
https://kawalpemilu.org#31413,"SAMPALAN, KUTAWALUYA, KARAWANG, JAWA BARAT",9,95,142,237
https://kawalpemilu.org#32000,"JATI, SAGULING, BANDUNG BARAT, JAWA BARAT",13,108,118,226
https://kawalpemilu.org#31465,"KEDUNGJAYA, CIBUAYA, KARAWANG, JAWA BARAT",16,120,31,151
https://kawalpemilu.org#30171,"RANJI WETAN, KASOKANDEL, MAJALENGKA, JAWA BARAT",15,64,83,147
https://kawalpemilu.org#29058,"LENGKONG, GARAWANGI, KUNINGAN, JAWA BARAT",3,72,129,201
https://kawalpemilu.org#29609,"KEDAWUNG, KEDAWUNG, CIREBON, JAWA BARAT",1,103,119,222
https://kawalpemilu.org#32281,"CIKUTRA, CIBEUNYING KIDUL, KOTA BANDUNG, JAWA BARAT",37,69,126,195
https://kawalpemilu.org#30281,"CACABAN, CONGGEANG, SUMEDANG, JAWA BARAT",4,76,105,181
https://kawalpemilu.org#26166,"KARANGGAN, GUNUNG PUTRI, BOGOR, JAWA BARAT",58,52,93,145
https://kawalpemilu.org#27475,"MEKARJAYA, BANJARAN, BANDUNG, JAWA BARAT",17,64,142,206
https://kawalpemilu.org#29328,"GARAHAJI, MALEBER, KUNINGAN, JAWA BARAT",2,32,89,121
https://kawalpemilu.org#32424,"MARGA JAYA, BEKASI SELATAN, KOTA BEKASI, JAWA BARAT",47,87,163,250
https://kawalpemilu.org#27953,"MEKARSARI, CILAWU, GARUT, JAWA BARAT",11,28,200,228
https://kawalpemilu.org#32623,"MANGKUBUMI, MANGKUBUMI, KOTA TASIKMALAYA, JAWA BARAT",23,29,200,229
https://kawalpemilu.org#30817,"KEDOKAN BUNDER, KEDOKAN BUNDER, INDRAMAYU, JAWA BARAT",6,147,64,211
https://kawalpemilu.org#26320,"CIBANTENG, CIAMPEA, BOGOR, JAWA BARAT",55,30,117,147
https://kawalpemilu.org#32474,"DEPOK, PANCORAN MAS, KOTA DEPOK, JAWA BARAT",28,87,50,137
https://kawalpemilu.org#31735,"SETIADARMA, TAMBUN SELATAN, BEKASI, JAWA BARAT",11,80,139,219
https://kawalpemilu.org#32556,"CIGUGUR TENGAH, CIMAHI TENGAH, KOTA CIMAHI, JAWA BARAT",34,86,112,198
https://kawalpemilu.org#32132,"BANTARJATI, BOGOR UTARA, KOTA BOGOR, JAWA BARAT",72,66,169,235
https://kawalpemilu.org#30839,"SUKADANA, TUKDANA, INDRAMAYU, JAWA BARAT",20,22,95,117
https://kawalpemilu.org#27582,"CIPEUJEUH, PACET, BANDUNG, JAWA BARAT",11,120,98,218
https://kawalpemilu.org#29652,"KREYO, KLANGENAN, CIREBON, JAWA BARAT",11,138,48,186
https://kawalpemilu.org#30774,"KOPYAH, ANJATAN, INDRAMAYU, JAWA BARAT",11,126,90,216
https://kawalpemilu.org#32442,"SUMUR BATU, BANTAR GEBANG, KOTA BEKASI, JAWA BARAT",19,107,93,200
https://kawalpemilu.org#32556,"CIGUGUR TENGAH, CIMAHI TENGAH, KOTA CIMAHI, JAWA BARAT",15,48,93,141
https://kawalpemilu.org#27819,"PADAASIH, PASIRWANGI, GARUT, JAWA BARAT",14,5,135,140
https://kawalpemilu.org#27212,"CIDADAP, CAMPAKA, CIANJUR, JAWA BARAT",8,165,63,228
https://kawalpemilu.org#32389,"KECAPI, HARJAMUKTI, KOTA CIREBON, JAWA BARAT",4,180,66,246
https://kawalpemilu.org#32137,"CILUAR, BOGOR UTARA, KOTA BOGOR, JAWA BARAT",30,41,146,187
https://kawalpemilu.org#26453,"CIBEUREUM, CISARUA, BOGOR, JAWA BARAT",23,36,183,219
https://kawalpemilu.org#32510,"TANAH BARU, BEJI, KOTA DEPOK, JAWA BARAT",71,68,134,202
https://kawalpemilu.org#28833,"SUKARESIK, SIDAMULIH, PANGANDARAN, JAWA BARAT",4,144,50,194
https://kawalpemilu.org#28717,"TIGAHERANG, RAJADESA, CIAMIS, JAWA BARAT",21,24,137,161
https://kawalpemilu.org#30629,"TAMBI, SLIYEG, INDRAMAYU, JAWA BARAT",1,173,45,218
https://kawalpemilu.org#30399,"MARGAMEKAR, SUMEDANG SELATAN, SUMEDANG, JAWA BARAT",9,45,113,158
https://kawalpemilu.org#28272,"HEGARWANGI, BANTARKALONG, TASIKMALAYA, JAWA BARAT",2,77,132,209
https://kawalpemilu.org#30621,"PONDOH, JUNTINYUAT, INDRAMAYU, JAWA BARAT",3,126,73,199
https://kawalpemilu.org#27140,"SUKASIRNA, SUKALUYU, CIANJUR, JAWA BARAT",19,16,122,138
https://kawalpemilu.org#28664,"KARANGPAWITAN, KAWALI, CIAMIS, JAWA BARAT",18,69,113,182
https://kawalpemilu.org#28667,"CITEUREUP, KAWALI, CIAMIS, JAWA BARAT",3,18,110,128
https://kawalpemilu.org#28188,"BANTARKALONG, CIPATUJAH, TASIKMALAYA, JAWA BARAT",12,55,110,165
https://kawalpemilu.org#30048,"PUTRIDALEM, JATITUJUH, MAJALENGKA, JAWA BARAT",8,116,24,140
https://kawalpemilu.org#28306,"MUNCANG, SODONGHILIR, TASIKMALAYA, JAWA BARAT",8,54,112,166
https://kawalpemilu.org#31738,"TRIDAYA SAKTI, TAMBUN SELATAN, BEKASI, JAWA BARAT",70,78,75,153
https://kawalpemilu.org#31074,"MANDALAWANGI, SUKASARI, SUBANG, JAWA BARAT",9,90,40,130
https://kawalpemilu.org#27015,"SUKAMAJU, CIMANGGU, SUKABUMI, JAWA BARAT",7,67,43,110
https://kawalpemilu.org#32435,"HARAPAN MULYA, MEDAN SATRIA, KOTA BEKASI, JAWA BARAT",55,66,84,150
https://kawalpemilu.org#26210,"SUKASIRNA, JONGGOL, BOGOR, JAWA BARAT",5,56,107,163
https://kawalpemilu.org#26509,"CIHERANG, DRAMAGA, BOGOR, JAWA BARAT",1,95,127,222
https://kawalpemilu.org#32192,"LIMUSNUNGGAL, CIBEUREUM, KOTA SUKABUMI, JAWA BARAT",12,91,163,254
https://kawalpemilu.org#32521,"SUKAMAJU, CILODONG, KOTA DEPOK, JAWA BARAT",67,72,114,186
https://kawalpemilu.org#29274,"CILEUYA, CIMAHI, KUNINGAN, JAWA BARAT",14,106,27,133
https://kawalpemilu.org#32352,"PASIR ENDAH, UJUNG BERUNG, KOTA BANDUNG, JAWA BARAT",42,71,160,231
https://kawalpemilu.org#92019,"SURADE, SURADE, SUKABUMI, JAWA BARAT",6,28,142,170
https://kawalpemilu.org#27604,"BALEENDAH, BALEENDAH, BANDUNG, JAWA BARAT",11,52,155,207
https://kawalpemilu.org#32540,"BOJONGSARI, BOJONGSARI, KOTA DEPOK, JAWA BARAT",26,74,143,217
https://kawalpemilu.org#30584,"KERTASEMAYA, KERTASEMAYA, INDRAMAYU, JAWA BARAT",6,139,58,197
https://kawalpemilu.org#30259,"MEKARMULYA, SITURAJA, SUMEDANG, JAWA BARAT",1,89,81,170
https://kawalpemilu.org#31321,"PARUNGBANTENG, SUKASARI, PURWAKARTA, JAWA BARAT",6,176,75,251
https://kawalpemilu.org#27947,"CILAWU, CILAWU, GARUT, JAWA BARAT",2,65,169,234
https://kawalpemilu.org#931119,"KOSAR, CIPEUNDEUY, SUBANG, JAWA BARAT",3,123,93,216
https://kawalpemilu.org#26598,"SADENG KOLOT, LEUWISADENG, BOGOR, JAWA BARAT",9,43,157,200
https://kawalpemilu.org#27677,"MEKARMAJU, PASIRJAMBU, BANDUNG, JAWA BARAT",14,113,133,246
https://kawalpemilu.org#29652,"KREYO, KLANGENAN, CIREBON, JAWA BARAT",16,109,77,186
https://kawalpemilu.org#32163,"CISARUA, CIKOLE, KOTA SUKABUMI, JAWA BARAT",40,29,91,120
https://kawalpemilu.org#29568,"SINDANGMEKAR, DUKUPUNTANG, CIREBON, JAWA BARAT",16,193,46,239
https://kawalpemilu.org#32164,"SUBANGJAYA, CIKOLE, KOTA SUKABUMI, JAWA BARAT",2,104,139,243
https://kawalpemilu.org#30634,"MAJASIH, SLIYEG, INDRAMAYU, JAWA BARAT",2,199,19,218
https://kawalpemilu.org#27935,"SUKASENANG, BAYONGBONG, GARUT, JAWA BARAT",16,34,124,158
https://kawalpemilu.org#30063,"TEGALAREN, LIGUNG, MAJALENGKA, JAWA BARAT",2,68,104,172
https://kawalpemilu.org#32518,"BOJONG PONDOK TERONG, CIPAYUNG, KOTA DEPOK, JAWA BARAT",80,56,183,239
https://kawalpemilu.org#32159,"CIKOLE, CIKOLE, KOTA SUKABUMI, JAWA BARAT",6,80,151,231
https://kawalpemilu.org#32418,"HARAPAN BARU, BEKASI UTARA, KOTA BEKASI, JAWA BARAT",18,50,203,253
https://kawalpemilu.org#29925,"CIEURIH, MAJA, MAJALENGKA, JAWA BARAT",4,77,132,209
https://kawalpemilu.org#28946,"PURWADADI, PURWADADI, CIAMIS, JAWA BARAT",16,93,59,152
https://kawalpemilu.org#28043,"SIRNABAKTI, PAMEUNGPEUK, GARUT, JAWA BARAT",2,80,151,231
https://kawalpemilu.org#29876,"BAGJASARI, CIKIJING, MAJALENGKA, JAWA BARAT",11,26,138,164
https://kawalpemilu.org#28750,"SIDAHARJA, LAKBOK, CIAMIS, JAWA BARAT",2,145,66,211
https://kawalpemilu.org#27994,"GIRIAWAS, CIKAJANG, GARUT, JAWA BARAT",11,21,73,94
https://kawalpemilu.org#31145,"MUNJULJAYA, PURWAKARTA, PURWAKARTA, JAWA BARAT",1,66,193,259
https://kawalpemilu.org#27625,"RANCAKASUMBA, SOLOKANJERUK, BANDUNG, JAWA BARAT",19,96,93,189
https://kawalpemilu.org#30874,"CIGADUNG, SUBANG, SUBANG, JAWA BARAT",7,64,115,179
https://kawalpemilu.org#31601,"TEGALURUNG, CILAMAYA KULON, KARAWANG, JAWA BARAT",8,121,49,170
https://kawalpemilu.org#30722,"ARAHAN LOR, ARAHAN, INDRAMAYU, JAWA BARAT",5,169,68,237
https://kawalpemilu.org#32432,"BOJONG MENTENG, RAWA LUMBU, KOTA BEKASI, JAWA BARAT",19,87,85,172
https://kawalpemilu.org#26174,"SANJA, CITEUREUP, BOGOR, JAWA BARAT",18,36,212,248
https://kawalpemilu.org#32214,"KOPO, BOJONGLOA KALER, KOTA BANDUNG, JAWA BARAT",20,84,148,232
https://kawalpemilu.org#29579,"CIAWI, PALIMANAN, CIREBON, JAWA BARAT",3,86,120,206
https://kawalpemilu.org#31014,"SUMURBARANG, CIBOGO, SUBANG, JAWA BARAT",5,178,49,227
https://kawalpemilu.org#26871,"SUKASARI, CISAAT, SUKABUMI, JAWA BARAT",24,14,140,154
https://kawalpemilu.org#26798,"JAMPANG KULON, JAMPANG KULON, SUKABUMI, JAWA BARAT",4,43,154,197
https://kawalpemilu.org#32276,"TURANGGA, LENGKONG, KOTA BANDUNG, JAWA BARAT",17,62,126,188
https://kawalpemilu.org#29468,"PASAWAHAN, SUSUKAN LEBAK, CIREBON, JAWA BARAT",5,110,50,160
https://kawalpemilu.org#32013,"MEKARMUKTI, CIHAMPELAS, BANDUNG BARAT, JAWA BARAT",13,47,152,199
https://kawalpemilu.org#27673,"CUKANGGENTENG, PASIRJAMBU, BANDUNG, JAWA BARAT",9,69,125,194
https://kawalpemilu.org#27231,"HEGARMANAH, TAKOKAK, CIANJUR, JAWA BARAT",3,78,130,208
https://kawalpemilu.org#27750,"WANAMEKAR, WANARAJA, GARUT, JAWA BARAT",8,47,177,224
https://kawalpemilu.org#31357,"TAMANMEKAR, PANGKALAN, KARAWANG, JAWA BARAT",12,104,90,194
https://kawalpemilu.org#32372,"KARANG PAMULANG, MANDALAJATI, KOTA BANDUNG, JAWA BARAT",50,94,118,212
https://kawalpemilu.org#30629,"TAMBI, SLIYEG, INDRAMAYU, JAWA BARAT",11,147,75,222
https://kawalpemilu.org#26232,"LIMUSNUNGGAL, CILEUNGSI, BOGOR, JAWA BARAT",71,74,61,135
https://kawalpemilu.org#29649,"JEMARAS LOR, KLANGENAN, CIREBON, JAWA BARAT",5,112,21,133
https://kawalpemilu.org#931118,"PABUARAN MEKAR, CIBINONG, BOGOR, JAWA BARAT",20,64,117,181
https://kawalpemilu.org#31220,"SINARGALIH, MANIIS, PURWAKARTA, JAWA BARAT",7,30,171,201
https://kawalpemilu.org#28654,"KERTAMANDALA, PANJALU, CIAMIS, JAWA BARAT",11,21,88,109
https://kawalpemilu.org#32436,"PEJUANG, MEDAN SATRIA, KOTA BEKASI, JAWA BARAT",25,50,191,241
https://kawalpemilu.org#27148,"CIPENDAWA, PACET, CIANJUR, JAWA BARAT",37,66,141,207
https://kawalpemilu.org#26875,"BABAKAN, CISAAT, SUKABUMI, JAWA BARAT",11,32,170,202
https://kawalpemilu.org#31383,"DUREN, KLARI, KARAWANG, JAWA BARAT",23,51,135,186
https://kawalpemilu.org#30925,"KARANGWANGI, BINONG, SUBANG, JAWA BARAT",3,89,62,151
https://kawalpemilu.org#31690,"PAHLAWAN SETIA, TARUMAJAYA, BEKASI, JAWA BARAT",16,73,103,176
https://kawalpemilu.org#28186,"SINDANGKERTA, CIPATUJAH, TASIKMALAYA, JAWA BARAT",5,82,162,244
https://kawalpemilu.org#31094,"KASOMALANG KULON, KASOMALANG, SUBANG, JAWA BARAT",21,75,138,213
https://kawalpemilu.org#26261,"COGREG, PARUNG, BOGOR, JAWA BARAT",34,71,129,200
https://kawalpemilu.org#32636,"CIBUNIGEULIS, BUNGURSARI, KOTA TASIKMALAYA, JAWA BARAT",19,73,222,295
https://kawalpemilu.org#30637,"MEKARGADING, SLIYEG, INDRAMAYU, JAWA BARAT",10,165,69,234
https://kawalpemilu.org#27571,"CIHEULANG, CIPARAY, BANDUNG, JAWA BARAT",42,57,113,170
https://kawalpemilu.org#26914,"SUKARAJA, SUKARAJA, SUKABUMI, JAWA BARAT",45,72,133,205
https://kawalpemilu.org#32300,"BABAKAN SARI, KIARACONDONG, KOTA BANDUNG, JAWA BARAT",85,83,107,190
https://kawalpemilu.org#26769,"BABAKAN PARI, CIDAHU, SUKABUMI, JAWA BARAT",13,21,210,231
https://kawalpemilu.org#27729,"LEBAKJAYA, KARANGPAWITAN, GARUT, JAWA BARAT",16,54,110,164
https://kawalpemilu.org#32419,"TELUK PUCUNG, BEKASI UTARA, KOTA BEKASI, JAWA BARAT",69,120,99,219
https://kawalpemilu.org#26885,"CITAMIANG, KADUDAMPIT, SUKABUMI, JAWA BARAT",3,39,141,180
https://kawalpemilu.org#26629,"CIKAKAK, CIKAKAK, SUKABUMI, JAWA BARAT",13,58,131,189
https://kawalpemilu.org#30806,"CIBEBER, SUKAGUMIWANG, INDRAMAYU, JAWA BARAT",9,87,96,183
https://kawalpemilu.org#30145,"KAGOK, BANJARAN, MAJALENGKA, JAWA BARAT",4,95,151,246
https://kawalpemilu.org#32265,"CIBANGKONG, BATUNUNGGAL, KOTA BANDUNG, JAWA BARAT",38,110,135,245
https://kawalpemilu.org#29321,"TANJUNGKERTA, KARANG KANCANA, KUNINGAN, JAWA BARAT",4,44,105,149
https://kawalpemilu.org#26613,"PELABUHAN RATU, PELABUHAN RATU, SUKABUMI, JAWA BARAT",56,85,55,140
https://kawalpemilu.org#29802,"WALAHAR, GEMPOL, CIREBON, JAWA BARAT",5,141,57,198
https://kawalpemilu.org#26229,"CIPEUCANG, CILEUNGSI, BOGOR, JAWA BARAT",22,36,134,170
https://kawalpemilu.org#31514,"SUKAKERTA, CILAMAYA WETAN, KARAWANG, JAWA BARAT",13,159,51,210
https://kawalpemilu.org#27426,"JATIENDAH, CILENGKRANG, BANDUNG, JAWA BARAT",8,56,155,211
https://kawalpemilu.org#29223,"CIMARA, PASAWAHAN, KUNINGAN, JAWA BARAT",6,101,96,197
https://kawalpemilu.org#32466,"MUSTIKAJAYA, MUSTIKA JAYA, KOTA BEKASI, JAWA BARAT",149,114,93,207
https://kawalpemilu.org#30741,"SANTING, LOSARANG, INDRAMAYU, JAWA BARAT",10,181,43,224
https://kawalpemilu.org#27189,"CIKANYERE, SUKARESMI, CIANJUR, JAWA BARAT",16,124,74,198
https://kawalpemilu.org#28536,"BUGEL, CIAWI, TASIKMALAYA, JAWA BARAT",7,84,108,192
https://kawalpemilu.org#28350,"CINTAJAYA, TANJUNGJAYA, TASIKMALAYA, JAWA BARAT",1,66,160,226
https://kawalpemilu.org#31638,"PALUMBONSARI, KARAWANG TIMUR, KARAWANG, JAWA BARAT",42,128,135,263
https://kawalpemilu.org#29696,"WIYONG, SUSUKAN, CIREBON, JAWA BARAT",18,70,51,121
https://kawalpemilu.org#27123,"JAMALI, MANDE, CIANJUR, JAWA BARAT",6,76,71,147
https://kawalpemilu.org#31507,"SUKATANI, CILAMAYA WETAN, KARAWANG, JAWA BARAT",7,155,84,239
https://kawalpemilu.org#26217,"SINGASARI, JONGGOL, BOGOR, JAWA BARAT",16,48,149,197
https://kawalpemilu.org#27485,"LANGONSARI, PAMEUNGPEUK, BANDUNG, JAWA BARAT",25,49,185,234
https://kawalpemilu.org#29977,"PARAKAN, LEUWIMUNDING, MAJALENGKA, JAWA BARAT",4,123,60,183
https://kawalpemilu.org#31785,"HEGARMANAH, CIKARANG TIMUR, BEKASI, JAWA BARAT",9,99,129,228
https://kawalpemilu.org#27623,"SUKAMUKTI, MAJALAYA, BANDUNG, JAWA BARAT",3,44,70,114
https://kawalpemilu.org#31551,"SUKAPURA, RAWAMERTA, KARAWANG, JAWA BARAT",6,70,139,209
https://kawalpemilu.org#29994,"BURUJUL KULON, JATIWANGI, MAJALENGKA, JAWA BARAT",5,58,182,240
https://kawalpemilu.org#32135,"CIPARIGI, BOGOR UTARA, KOTA BOGOR, JAWA BARAT",7,43,124,167
https://kawalpemilu.org#28180,"LINGGAMUKTI, SUCINARAJA, GARUT, JAWA BARAT",3,54,134,188
https://kawalpemilu.org#31290,"MARACANG, BABAKANCIKAO, PURWAKARTA, JAWA BARAT",14,87,120,207
https://kawalpemilu.org#27572,"PAKUTANDANG, CIPARAY, BANDUNG, JAWA BARAT",36,100,121,221
https://kawalpemilu.org#32402,"KARYAMULYA, KESAMBI, KOTA CIREBON, JAWA BARAT",67,105,114,219
https://kawalpemilu.org#32406,"MARGAHAYU, BEKASI TIMUR, KOTA BEKASI, JAWA BARAT",120,87,152,239
https://kawalpemilu.org#27404,"KARANGJAYA, PASIRKUDA, CIANJUR, JAWA BARAT",4,102,75,177
https://kawalpemilu.org#26927,"CIREUNGHAS, CIREUNGHAS, SUKABUMI, JAWA BARAT",7,34,197,231
https://kawalpemilu.org#29566,"CANGKOAK, DUKUPUNTANG, CIREBON, JAWA BARAT",3,135,42,177
https://kawalpemilu.org#26363,"CIPINANG, RUMPIN, BOGOR, JAWA BARAT",39,100,20,120
https://kawalpemilu.org#32139,"CIMAHPAR, BOGOR UTARA, KOTA BOGOR, JAWA BARAT",12,73,129,202
https://kawalpemilu.org#30402,"MEKAR RAHAYU, SUMEDANG SELATAN, SUMEDANG, JAWA BARAT",7,124,113,237
https://kawalpemilu.org#28013,"WANGUNJAYA, BANJARWANGI, GARUT, JAWA BARAT",13,23,82,105
https://kawalpemilu.org#31817,"SUKALAKSANA, SUKAKARYA, BEKASI, JAWA BARAT",4,61,96,157
https://kawalpemilu.org#31726,"SRIMUKTI, TAMBUN UTARA, BEKASI, JAWA BARAT",22,60,132,192
https://kawalpemilu.org#29812,"GREGED, GREGED, CIREBON, JAWA BARAT",10,94,67,161
https://kawalpemilu.org#26580,"SASAKPANJANG, TAJURHALANG, BOGOR, JAWA BARAT",67,58,113,171
https://kawalpemilu.org#26694,"UBRUG, WARUNG KIARA, SUKABUMI, JAWA BARAT",12,60,142,202
https://kawalpemilu.org#27201,"SUKANAGARA, SUKANAGARA, CIANJUR, JAWA BARAT",14,67,108,175
https://kawalpemilu.org#28467,"JAYAMUKTI, LEUWISARI, TASIKMALAYA, JAWA BARAT",14,88,116,204
https://kawalpemilu.org#32432,"BOJONG MENTENG, RAWA LUMBU, KOTA BEKASI, JAWA BARAT",41,74,64,138
https://kawalpemilu.org#32440,"CIKIWUL, BANTAR GEBANG, KOTA BEKASI, JAWA BARAT",55,74,134,208
https://kawalpemilu.org#30149,"SANGIANG, BANJARAN, MAJALENGKA, JAWA BARAT",1,114,99,213
https://kawalpemilu.org#29492,"JAPURA KIDUL, ASTANAJAPURA, CIREBON, JAWA BARAT",18,127,32,159
https://kawalpemilu.org#31036,"TANJUNGWANGI, CIJAMBE, SUBANG, JAWA BARAT",22,132,122,254
https://kawalpemilu.org#27872,"GIRIMUKTI, CIBATU, GARUT, JAWA BARAT",2,61,106,167
https://kawalpemilu.org#31508,"TEGALWARU, CILAMAYA WETAN, KARAWANG, JAWA BARAT",3,90,127,217
https://kawalpemilu.org#26405,"NANGGUNG, NANGGUNG, BOGOR, JAWA BARAT",5,25,167,192
https://kawalpemilu.org#32496,"MERUYUNG, LIMO, KOTA DEPOK, JAWA BARAT",48,83,84,167
https://kawalpemilu.org#32001,"SELACAU, BATUJAJAR, BANDUNG BARAT, JAWA BARAT",23,85,93,178
https://kawalpemilu.org#28380,"MANDALAMEKAR, JATIWARAS, TASIKMALAYA, JAWA BARAT",8,32,161,193
https://kawalpemilu.org#27113,"SABANDAR, KARANGTENGAH, CIANJUR, JAWA BARAT",3,43,191,234
https://kawalpemilu.org#30203,"CIKAREO UTARA, WADO, SUMEDANG, JAWA BARAT",2,61,171,232
https://kawalpemilu.org#26174,"SANJA, CITEUREUP, BOGOR, JAWA BARAT",9,50,184,234
https://kawalpemilu.org#32523,"KALIBARU, CILODONG, KOTA DEPOK, JAWA BARAT",73,75,124,199
https://kawalpemilu.org#29978,"PATUANAN, LEUWIMUNDING, MAJALENGKA, JAWA BARAT",9,117,55,172
https://kawalpemilu.org#31736,"SETIAMEKAR, TAMBUN SELATAN, BEKASI, JAWA BARAT",140,103,170,273
https://kawalpemilu.org#28552,"PAMOYANAN, KADIPATEN, TASIKMALAYA, JAWA BARAT",14,17,133,150
https://kawalpemilu.org#27047,"BUNISARI, WARUNGKONDANG, CIANJUR, JAWA BARAT",7,32,179,211
https://kawalpemilu.org#27135,"SUKAMULYA, SUKALUYU, CIANJUR, JAWA BARAT",31,50,116,166
https://kawalpemilu.org#31965,"MARGAJAYA, NGAMPRAH, BANDUNG BARAT, JAWA BARAT",4,49,179,228
https://kawalpemilu.org#30956,"RANCAHILIR, PAMANUKAN, SUBANG, JAWA BARAT",5,100,45,145
https://kawalpemilu.org#32201,"LEBAKGEDE, COBLONG, KOTA BANDUNG, JAWA BARAT",4,80,184,264
https://kawalpemilu.org#27442,"MARGAHAYU SELATAN, MARGAHAYU, BANDUNG, JAWA BARAT",54,74,69,143
https://kawalpemilu.org#31092,"SUKAMELANG, KASOMALANG, SUBANG, JAWA BARAT",8,42,175,217
https://kawalpemilu.org#89282,"MEKARSARI, MEKARMUKTI, GARUT, JAWA BARAT",8,58,45,103
https://kawalpemilu.org#30886,"CARACAS, KALIJATI, SUBANG, JAWA BARAT",5,180,53,233
https://kawalpemilu.org#27556,"BOJONGLOA, RANCAEKEK, BANDUNG, JAWA BARAT",31,43,171,214
https://kawalpemilu.org#32416,"KALIABANG TENGAH, BEKASI UTARA, KOTA BEKASI, JAWA BARAT",122,78,86,164
https://kawalpemilu.org#28088,"WANGUNJAYA, BUNGBULANG, GARUT, JAWA BARAT",12,77,97,174
https://kawalpemilu.org#32475,"DEPOK JAYA, PANCORAN MAS, KOTA DEPOK, JAWA BARAT",33,69,110,179
https://kawalpemilu.org#30554,"CEMPEH, LELEA, INDRAMAYU, JAWA BARAT",12,148,37,185
https://kawalpemilu.org#27790,"CIPICUNG, BANYURESMI, GARUT, JAWA BARAT",14,25,199,224
https://kawalpemilu.org#30835,"SUKAMULYA, TUKDANA, INDRAMAYU, JAWA BARAT",15,137,62,199
https://kawalpemilu.org#29928,"BANJARAN, MAJA, MAJALENGKA, JAWA BARAT",2,40,186,226
https://kawalpemilu.org#32313,"CIGADUNG, CIBEUNYING KALER, KOTA BANDUNG, JAWA BARAT",75,96,165,261
https://kawalpemilu.org#28846,"CIBENDA, PARIGI, PANGANDARAN, JAWA BARAT",5,119,92,211
https://kawalpemilu.org#28614,"TANJUNGSARI, SADANANYA, CIAMIS, JAWA BARAT",4,20,127,147
https://kawalpemilu.org#32575,"PANGLAYUNGAN, CIPEDES, KOTA TASIKMALAYA, JAWA BARAT",1,55,121,176
https://kawalpemilu.org#32134,"KEDUNGHALANG, BOGOR UTARA, KOTA BOGOR, JAWA BARAT",47,69,149,218
https://kawalpemilu.org#31530,"CARIUMULYA, TELAGASARI, KARAWANG, JAWA BARAT",1,78,160,238
https://kawalpemilu.org#32551,"UTAMA, CIMAHI SELATAN, KOTA CIMAHI, JAWA BARAT",7,60,168,228
https://kawalpemilu.org#31080,"WANAJAYA, TAMBAKDAHAN, SUBANG, JAWA BARAT",4,174,31,205
https://kawalpemilu.org#32552,"LEUWIGAJAH, CIMAHI SELATAN, KOTA CIMAHI, JAWA BARAT",90,92,143,235
https://kawalpemilu.org#32313,"CIGADUNG, CIBEUNYING KALER, KOTA BANDUNG, JAWA BARAT",17,86,142,228
https://kawalpemilu.org#32132,"BANTARJATI, BOGOR UTARA, KOTA BOGOR, JAWA BARAT",17,64,149,213
https://kawalpemilu.org#30137,"LEUWILAJA, SINDANGWANGI, MAJALENGKA, JAWA BARAT",8,133,72,205
https://kawalpemilu.org#31391,"ANGGADITA, KLARI, KARAWANG, JAWA BARAT",24,98,95,193
https://kawalpemilu.org#29182,"KRAMATMULYA, KRAMATMULYA, KUNINGAN, JAWA BARAT",7,82,128,210
https://kawalpemilu.org#26301,"PABANGBON, LEUWILIANG, BOGOR, JAWA BARAT",17,49,89,138
https://kawalpemilu.org#27638,"SINDANGSARI, PASEH, BANDUNG, JAWA BARAT",16,154,94,248
https://kawalpemilu.org#28592,"DARMACAANG, CIKONENG, CIAMIS, JAWA BARAT",4,53,115,168
https://kawalpemilu.org#31560,"KARANGTANJUNG, LEMAHABANG, KARAWANG, JAWA BARAT",8,115,105,220
https://kawalpemilu.org#27134,"SELAJAMBE, SUKALUYU, CIANJUR, JAWA BARAT",21,51,84,135
https://kawalpemilu.org#32304,"KEBON LEGA, BOJONGLOA KIDUL, KOTA BANDUNG, JAWA BARAT",55,79,122,201
https://kawalpemilu.org#26813,"GIRI MUKTI, CIEMAS, SUKABUMI, JAWA BARAT",4,128,89,217
https://kawalpemilu.org#27673,"CUKANGGENTENG, PASIRJAMBU, BANDUNG, JAWA BARAT",19,96,125,221
https://kawalpemilu.org#27995,"CIBODAS, CIKAJANG, GARUT, JAWA BARAT",9,16,125,141
https://kawalpemilu.org#31543,"KUTAWARGI, RAWAMERTA, KARAWANG, JAWA BARAT",10,94,123,217
https://kawalpemilu.org#27105,"BOJONG, KARANGTENGAH, CIANJUR, JAWA BARAT",34,61,162,223
https://kawalpemilu.org#26531,"LULUT, KLAPANUNGGAL, BOGOR, JAWA BARAT",31,16,149,165
https://kawalpemilu.org#28468,"MANDALAGIRI, LEUWISARI, TASIKMALAYA, JAWA BARAT",2,62,158,220
https://kawalpemilu.org#28169,"SUKAHURIP, PANGATIKAN, GARUT, JAWA BARAT",7,55,132,187
https://kawalpemilu.org#32010,"CITAPEN, CIHAMPELAS, BANDUNG BARAT, JAWA BARAT",4,51,176,227
https://kawalpemilu.org#31740,"SUMBERJAYA, TAMBUN SELATAN, BEKASI, JAWA BARAT",115,147,140,287
https://kawalpemilu.org#30322,"JATISARI, TANJUNGSARI, SUMEDANG, JAWA BARAT",15,57,84,141
https://kawalpemilu.org#32227,"HUSEN SASTRANEGARA, CICENDO, KOTA BANDUNG, JAWA BARAT",18,42,92,134
https://kawalpemilu.org#32439,"BANTARGEBANG, BANTAR GEBANG, KOTA BEKASI, JAWA BARAT",86,49,54,103
https://kawalpemilu.org#27993,"GIRIJAYA, CIKAJANG, GARUT, JAWA BARAT",26,81,165,246
https://kawalpemilu.org#30096,"JATIPAMOR, PANYINGKIRAN, MAJALENGKA, JAWA BARAT",1,89,126,215
https://kawalpemilu.org#27523,"CICALENGKA KULON, CICALENGKA, BANDUNG, JAWA BARAT",9,49,160,209
https://kawalpemilu.org#26292,"KEDUNGWARINGIN, BOJONG GEDE, BOGOR, JAWA BARAT",7,66,94,160
https://kawalpemilu.org#30587,"LARANGAN JAMBE, KERTASEMAYA, INDRAMAYU, JAWA BARAT",5,163,46,209
https://kawalpemilu.org#29472,"KARANGWUNI, SEDONG, CIREBON, JAWA BARAT",3,140,42,182
https://kawalpemilu.org#32503,"MEKAR JAYA, SUKMAJAYA, KOTA DEPOK, JAWA BARAT",85,66,123,189
https://kawalpemilu.org#30324,"KUTAMANDIRI, TANJUNGSARI, SUMEDANG, JAWA BARAT",30,114,121,235
https://kawalpemilu.org#32389,"KECAPI, HARJAMUKTI, KOTA CIREBON, JAWA BARAT",33,93,98,191
https://kawalpemilu.org#27696,"TANJUNGSARI, CANGKUANG, BANDUNG, JAWA BARAT",29,57,135,192
https://kawalpemilu.org#28106,"DEPOK, PAKENJENG, GARUT, JAWA BARAT",22,17,163,180
https://kawalpemilu.org#26228,"CILEUNGSI KIDUL, CILEUNGSI, BOGOR, JAWA BARAT",29,56,105,161
https://kawalpemilu.org#27596,"SUKAPURA, KERTASARI, BANDUNG, JAWA BARAT",8,97,129,226
https://kawalpemilu.org#31817,"SUKALAKSANA, SUKAKARYA, BEKASI, JAWA BARAT",23,112,91,203
https://kawalpemilu.org#27480,"SUKASARI, PAMEUNGPEUK, BANDUNG, JAWA BARAT",10,78,134,212
https://kawalpemilu.org#27614,"WANGISAGARA, MAJALAYA, BANDUNG, JAWA BARAT",35,102,110,212
https://kawalpemilu.org#28664,"KARANGPAWITAN, KAWALI, CIAMIS, JAWA BARAT",5,64,86,150
https://kawalpemilu.org#32176,"BENTENG, WARUDOYONG, KOTA SUKABUMI, JAWA BARAT",32,60,121,181
https://kawalpemilu.org#26702,"BOJONG, CIKEMBAR, SUKABUMI, JAWA BARAT",6,28,190,218
https://kawalpemilu.org#30888,"JALUPANG, KALIJATI, SUBANG, JAWA BARAT",3,96,88,184
https://kawalpemilu.org#30726,"PRANGGONG, ARAHAN, INDRAMAYU, JAWA BARAT",12,124,41,165
https://kawalpemilu.org#26848,"PURWASEDAR, CIRACAP, SUKABUMI, JAWA BARAT",12,53,154,207
https://kawalpemilu.org#30000,"CIBENTAR, JATIWANGI, MAJALENGKA, JAWA BARAT",9,119,99,218
https://kawalpemilu.org#32245,"TAMANSARI, BANDUNG WETAN, KOTA BANDUNG, JAWA BARAT",31,91,183,274
https://kawalpemilu.org#31750,"TELAGAMURNI, CIKARANG BARAT, BEKASI, JAWA BARAT",97,100,180,280
https://kawalpemilu.org#32671,"BOJONGKANTONG, LANGENSARI, KOTA BANJAR, JAWA BARAT",24,119,35,154
https://kawalpemilu.org#27870,"PADASUKA, CIBATU, GARUT, JAWA BARAT",5,46,101,147
https://kawalpemilu.org#29742,"DEPOK, DEPOK, CIREBON, JAWA BARAT",3,106,99,205
https://kawalpemilu.org#27608,"WARGAMEKAR, BALEENDAH, BANDUNG, JAWA BARAT",14,81,89,170
https://kawalpemilu.org#27363,"BATULAWANG, CIPANAS, CIANJUR, JAWA BARAT",33,152,87,239
https://kawalpemilu.org#30126,"KUTAMANGGU, CIGASONG, MAJALENGKA, JAWA BARAT",9,57,182,239
https://kawalpemilu.org#31736,"SETIAMEKAR, TAMBUN SELATAN, BEKASI, JAWA BARAT",4,123,74,197
https://kawalpemilu.org#27888,"CISITU, MALANGBONG, GARUT, JAWA BARAT",19,26,181,197
https://kawalpemilu.org#28497,"SUKASUKUR, CISAYONG, TASIKMALAYA, JAWA BARAT",10,67,112,179
https://kawalpemilu.org#32502,"ABADI JAYA, SUKMAJAYA, KOTA DEPOK, JAWA BARAT",12,59,106,165
https://kawalpemilu.org#89419,"GANJAR SABAR, NAGREG, BANDUNG, JAWA BARAT",6,52,73,125
https://kawalpemilu.org#28418,"GIRIWANGI, GUNUNGTANJUNG, TASIKMALAYA, JAWA BARAT",9,48,143,191
https://kawalpemilu.org#27042,"CIKAROYA, WARUNGKONDANG, CIANJUR, JAWA BARAT",1,65,153,218
https://kawalpemilu.org#26317,"CIBADAK, CIAMPEA, BOGOR, JAWA BARAT",18,59,76,135
https://kawalpemilu.org#30677,"PAOMAN, INDRAMAYU, INDRAMAYU, JAWA BARAT",19,100,28,128
https://kawalpemilu.org#26397,"KABASIRAN, PARUNG PANJANG, BOGOR, JAWA BARAT",31,109,101,210
https://kawalpemilu.org#32175,"SUKAKARYA, WARUDOYONG, KOTA SUKABUMI, JAWA BARAT",28,107,115,222
https://kawalpemilu.org#31143,"CISEUREUH, PURWAKARTA, PURWAKARTA, JAWA BARAT",29,69,211,280
https://kawalpemilu.org#27660,"SADU, SOREANG, BANDUNG, JAWA BARAT",14,117,142,259
https://kawalpemilu.org#32564,"CITEUREUP, CIMAHI UTARA, KOTA CIMAHI, JAWA BARAT",4,109,123,232
https://kawalpemilu.org#32382,"PEGAMBIRAN, LEMAH WUNGKUK, KOTA CIREBON, JAWA BARAT",56,109,70,179
https://kawalpemilu.org#32446,"JATIMAKMUR, PONDOK GEDE, KOTA BEKASI, JAWA BARAT",115,96,183,279
https://kawalpemilu.org#30287,"LEGOK KIDUL, PASEH, SUMEDANG, JAWA BARAT",8,45,92,137
https://kawalpemilu.org#28011,"TANJUNGJAYA, BANJARWANGI, GARUT, JAWA BARAT",17,158,84,242
https://kawalpemilu.org#27097,"JATI, BOJONGPICUNG, CIANJUR, JAWA BARAT",8,84,118,202
https://kawalpemilu.org#32431,"SEPANJANG JAYA, RAWA LUMBU, KOTA BEKASI, JAWA BARAT",92,94,106,200
https://kawalpemilu.org#39185,"KOPENG, GETASAN, SEMARANG, JAWA TENGAH",24,142,31,173
https://kawalpemilu.org#39943,"KOROWELANGANYAR, CEPIRING, KENDAL, JAWA TENGAH",12,108,15,123
https://kawalpemilu.org#36621,"PURWOSARI, WONOGIRI, WONOGIRI, JAWA TENGAH",13,124,13,137
https://kawalpemilu.org#40789,"KENDALDOYONG, PETARUKAN, PEMALANG, JAWA TENGAH",29,96,15,111
https://kawalpemilu.org#36436,"MENURAN, BAKI, SUKOHARJO, JAWA TENGAH",13,240,39,279
https://kawalpemilu.org#33153,"TIPAR KIDUL, AJIBARANG, BANYUMAS, JAWA TENGAH",6,156,82,238
https://kawalpemilu.org#33300,"KARANGSALAM KIDUL, KEDUNG BANTENG, BANYUMAS, JAWA TENGAH",13,142,102,244
https://kawalpemilu.org#33005,"JAMBU, WANGON, BANYUMAS, JAWA TENGAH",8,163,41,204
https://kawalpemilu.org#39029,"KUNCIR, WONOSALAM, DEMAK, JAWA TENGAH",3,178,18,196
https://kawalpemilu.org#38576,"GARUNG LOR, KALIWUNGU, KUDUS, JAWA TENGAH",5,146,41,187
https://kawalpemilu.org#41442,"JEMASIH, KETANGGUNGAN, BREBES, JAWA TENGAH",16,131,40,171
https://kawalpemilu.org#36629,"GEMAWANG, NGADIROJO, WONOGIRI, JAWA TENGAH",6,132,12,144
https://kawalpemilu.org#39151,"MANDUNG, WEDUNG, DEMAK, JAWA TENGAH",4,125,67,192
https://kawalpemilu.org#34382,"WADASMALANG, KARANGSAMBUNG, KEBUMEN, JAWA TENGAH",16,110,18,128
https://kawalpemilu.org#33219,"TAMANSARI, KARANG LEWAS, BANYUMAS, JAWA TENGAH",9,169,43,212
https://kawalpemilu.org#40246,"KLIDANG LOR, BATANG, BATANG, JAWA TENGAH",12,145,30,175
https://kawalpemilu.org#35286,"WONOLELO, SAWANGAN, MAGELANG, JAWA TENGAH",3,152,33,185
https://kawalpemilu.org#33507,"PONJEN, KARANGANYAR, PURBALINGGA, JAWA TENGAH",10,134,24,158
https://kawalpemilu.org#39658,"LOSARI, TLOGOMULYO, TEMANGGUNG, JAWA TENGAH",6,148,15,163
https://kawalpemilu.org#39767,"PAGERUYUNG, PAGERUYUNG, KENDAL, JAWA TENGAH",7,141,24,165
https://kawalpemilu.org#34585,"SIDO MULYO, PURWOREJO, PURWOREJO, JAWA TENGAH",15,130,25,155
https://kawalpemilu.org#39178,"SOLOWIRE, KEBONAGUNG, DEMAK, JAWA TENGAH",6,159,36,195
https://kawalpemilu.org#37574,"KEDUNGTUBAN, KEDUNGTUBAN, BLORA, JAWA TENGAH",19,135,21,156
https://kawalpemilu.org#41194,"CINANAS, BANTARKAWUNG, BREBES, JAWA TENGAH",18,135,21,156
https://kawalpemilu.org#41744,"KEMBANGARUM, SEMARANG BARAT, KOTA SEMARANG, JAWA TENGAH",17,119,49,168
https://kawalpemilu.org#36712,"MADE, SLOGOHIMO, WONOGIRI, JAWA TENGAH",5,173,15,188
https://kawalpemilu.org#35386,"SUTOPATI, KAJORAN, MAGELANG, JAWA TENGAH",20,193,25,218
https://kawalpemilu.org#84912,"JERUKLEGI WETAN, JERUKLEGI, CILACAP, JAWA TENGAH",12,107,37,144
https://kawalpemilu.org#32845,"GUNUNGTELU, KARANGPUCUNG, CILACAP, JAWA TENGAH",9,84,87,171
https://kawalpemilu.org#38719,"BUGEL, KEDUNG, JEPARA, JAWA TENGAH",9,205,42,247
https://kawalpemilu.org#36907,"JATEN, JATEN, KARANGANYAR, JAWA TENGAH",12,144,53,197
https://kawalpemilu.org#38759,"KUANYAR, MAYONG, JEPARA, JAWA TENGAH",6,188,60,248
https://kawalpemilu.org#37078,"KEBONROMO, NGRAMPAL, SRAGEN, JAWA TENGAH",8,147,11,158
https://kawalpemilu.org#36519,"BATUWARNO, BATUWARNO, WONOGIRI, JAWA TENGAH",10,114,26,140
https://kawalpemilu.org#37338,"TUNGGULREJO, GABUS, GROBOGAN, JAWA TENGAH",17,169,33,202
https://kawalpemilu.org#41397,"TANJUNG, TANJUNG, BREBES, JAWA TENGAH",12,150,69,219
https://kawalpemilu.org#40340,"KALIOMBO, PANINGGARAN, PEKALONGAN, JAWA TENGAH",2,145,26,171
https://kawalpemilu.org#41361,"BOJONGSARI, LOSARI, BREBES, JAWA TENGAH",4,103,34,137
https://kawalpemilu.org#41476,"SINDANGHEULA, BANJARHARJO, BREBES, JAWA TENGAH",5,83,83,166
https://kawalpemilu.org#38692,"KANDANGMAS, DAWE, KUDUS, JAWA TENGAH",11,132,62,194
https://kawalpemilu.org#37242,"PUTATNGANTEN, KARANGRAYUNG, GROBOGAN, JAWA TENGAH",4,134,26,160
https://kawalpemilu.org#33445,"BABAKAN, KALIMANAH, PURBALINGGA, JAWA TENGAH",1,196,72,268
https://kawalpemilu.org#929419,"KUTOWINANGUN LOR, TINGKIR, KOTA SALATIGA, JAWA TENGAH",9,122,50,172
https://kawalpemilu.org#39121,"KALIKONDANG, DEMAK, DEMAK, JAWA TENGAH",14,188,32,220
https://kawalpemilu.org#34020,"BULUSPESANTREN, BULUSPESANTREN, KEBUMEN, JAWA TENGAH",1,162,56,218
https://kawalpemilu.org#37266,"WOLO, PENAWANGAN, GROBOGAN, JAWA TENGAH",6,161,30,191
https://kawalpemilu.org#41650,"MUKTIHARJO KIDUL, PEDURUNGAN, KOTA SEMARANG, JAWA TENGAH",76,173,32,205
https://kawalpemilu.org#40552,"NGALIAN, TIRTO, PEKALONGAN, JAWA TENGAH",6,217,22,239
https://kawalpemilu.org#39505,"NGIPIK, PRINGSURAT, TEMANGGUNG, JAWA TENGAH",10,195,13,208
https://kawalpemilu.org#35361,"MADUKORO, KAJORAN, MAGELANG, JAWA TENGAH",3,124,40,164
https://kawalpemilu.org#41604,"BULU LOR, SEMARANG UTARA, KOTA SEMARANG, JAWA TENGAH",19,201,47,248
https://kawalpemilu.org#39847,"NGABEAN, BOJA, KENDAL, JAWA TENGAH",6,141,95,236
https://kawalpemilu.org#35868,"KEBONDALEM KIDUL, PRAMBANAN, KLATEN, JAWA TENGAH",4,135,49,184
https://kawalpemilu.org#37409,"KARANGANYAR, PURWODADI, GROBOGAN, JAWA TENGAH",12,165,28,193
https://kawalpemilu.org#41605,"PLOMBOKAN, SEMARANG UTARA, KOTA SEMARANG, JAWA TENGAH",8,166,49,215
https://kawalpemilu.org#34742,"PRIGELAN, PITURUH, PURWOREJO, JAWA TENGAH",2,60,100,160
https://kawalpemilu.org#40572,"WIRADESA, WIRADESA, PEKALONGAN, JAWA TENGAH",6,161,30,191
https://kawalpemilu.org#41629,"PANDEAN LAMPER, GAYAM SARI, KOTA SEMARANG, JAWA TENGAH",38,128,25,153
https://kawalpemilu.org#36000,"DOMPYONGAN, JOGONALAN, KLATEN, JAWA TENGAH",1,145,33,178
https://kawalpemilu.org#41336,"JATIROKEH, SONGGOM, BREBES, JAWA TENGAH",4,157,26,183
https://kawalpemilu.org#39252,"SEMOWO, PABELAN, SEMARANG, JAWA TENGAH",15,141,8,149
https://kawalpemilu.org#36093,"JETIS, JUWIRING, KLATEN, JAWA TENGAH",3,92,67,159
https://kawalpemilu.org#36784,"GIRIHARJO, PUHPELEM, WONOGIRI, JAWA TENGAH",7,126,37,163
https://kawalpemilu.org#38807,"JAMBU, MLONGGO, JEPARA, JAWA TENGAH",16,200,37,237
https://kawalpemilu.org#36834,"SAMBIREJO, JUMANTONO, KARANGANYAR, JAWA TENGAH",5,139,35,174
https://kawalpemilu.org#39546,"CANDIMULYO, KEDU, TEMANGGUNG, JAWA TENGAH",9,171,56,227
https://kawalpemilu.org#33416,"TOYAREJA, PURBALINGGA, PURBALINGGA, JAWA TENGAH",1,130,63,193
https://kawalpemilu.org#33013,"PEKUNCEN, JATILAWANG, BANYUMAS, JAWA TENGAH",4,140,33,173
https://kawalpemilu.org#36321,"KEDUNGJAMBAL, TAWANGSARI, SUKOHARJO, JAWA TENGAH",5,196,13,209
https://kawalpemilu.org#35534,"SECANG, SECANG, MAGELANG, JAWA TENGAH",21,160,69,229
https://kawalpemilu.org#32700,"KARANGJENGKOL, KESUGIHAN, CILACAP, JAWA TENGAH",3,118,51,169
https://kawalpemilu.org#37076,"PILANGSARI, NGRAMPAL, SRAGEN, JAWA TENGAH",12,119,51,170
https://kawalpemilu.org#84913,"BREBEG, JERUKLEGI, CILACAP, JAWA TENGAH",7,126,8,134
https://kawalpemilu.org#36634,"NGADIROJO KIDUL, NGADIROJO, WONOGIRI, JAWA TENGAH",31,155,14,169
https://kawalpemilu.org#40739,"SUGIHWARAS, PEMALANG, PEMALANG, JAWA TENGAH",3,170,13,183
https://kawalpemilu.org#41303,"SIGENTONG, WANASARI, BREBES, JAWA TENGAH",6,181,49,230
https://kawalpemilu.org#33003,"WANGON, WANGON, BANYUMAS, JAWA TENGAH",6,120,80,200
https://kawalpemilu.org#35162,"SUROYUDAN, SUKOHARJO, WONOSOBO, JAWA TENGAH",5,154,24,178
https://kawalpemilu.org#35628,"JEMOWO, MUSUK, BOYOLALI, JAWA TENGAH",8,204,6,210
https://kawalpemilu.org#41340,"WANATAWANG, SONGGOM, BREBES, JAWA TENGAH",22,100,32,132
https://kawalpemilu.org#32865,"CIBALUNG, CIMANGGU, CILACAP, JAWA TENGAH",10,106,65,171
https://kawalpemilu.org#33379,"MAJASARI, BUKATEJA, PURBALINGGA, JAWA TENGAH",7,160,57,217
https://kawalpemilu.org#34141,"KALIRANCANG, ALIAN, KEBUMEN, JAWA TENGAH",11,78,57,135
https://kawalpemilu.org#33951,"KRANDEGAN, PURING, KEBUMEN, JAWA TENGAH",5,136,57,193
https://kawalpemilu.org#33854,"DAWUHAN, WANAYASA, BANJARNEGARA, JAWA TENGAH",4,161,66,227
https://kawalpemilu.org#34860,"KALISEMO, LOANO, PURWOREJO, JAWA TENGAH",5,109,53,162
https://kawalpemilu.org#38837,"BUMIHARJO, KELING, JEPARA, JAWA TENGAH",5,186,12,198
https://kawalpemilu.org#37498,"KEDUNGWUNGU, TEGOWANU, GROBOGAN, JAWA TENGAH",3,116,63,179
https://kawalpemilu.org#41214,"KALINUSU, BUMIAYU, BREBES, JAWA TENGAH",2,95,24,119
https://kawalpemilu.org#35122,"LENGKONG, GARUNG, WONOSOBO, JAWA TENGAH",5,168,29,197
https://kawalpemilu.org#34865,"KEBONGUNUNG, LOANO, PURWOREJO, JAWA TENGAH",6,175,39,214
https://kawalpemilu.org#35644,"PUSPORENGGO, MUSUK, BOYOLALI, JAWA TENGAH",4,194,28,222
https://kawalpemilu.org#36906,"JATI, JATEN, KARANGANYAR, JAWA TENGAH",18,122,109,231
https://kawalpemilu.org#39602,"GUNUNGGEMPOL, JUMO, TEMANGGUNG, JAWA TENGAH",1,200,48,248
https://kawalpemilu.org#40262,"PANDANSARI, WARUNGASEM, BATANG, JAWA TENGAH",12,133,22,155
https://kawalpemilu.org#36051,"NGAWONGGO, CEPER, KLATEN, JAWA TENGAH",13,30,144,174
https://kawalpemilu.org#35417,"BANYUWANGI, BANDONGAN, MAGELANG, JAWA TENGAH",10,154,80,234
https://kawalpemilu.org#33558,"BUMISARI, BOJONGSARI, PURBALINGGA, JAWA TENGAH",19,106,6,112
https://kawalpemilu.org#40585,"MEJASEM, SIWALAN, PEKALONGAN, JAWA TENGAH",2,194,9,203
https://kawalpemilu.org#39810,"CENING, SINGOROJO, KENDAL, JAWA TENGAH",7,192,10,202
https://kawalpemilu.org#34034,"TANJUNGREJO, BULUSPESANTREN, KEBUMEN, JAWA TENGAH",5,131,43,174
https://kawalpemilu.org#33671,"MANTRIANOM, BAWANG, BANJARNEGARA, JAWA TENGAH",6,85,55,140
https://kawalpemilu.org#40050,"PLANTARAN, KALIWUNGU SELATAN, KENDAL, JAWA TENGAH",18,162,30,192
https://kawalpemilu.org#37003,"NGROMBO, PLUPUH, SRAGEN, JAWA TENGAH",10,139,18,157
https://kawalpemilu.org#41363,"JATISAWIT, LOSARI, BREBES, JAWA TENGAH",6,84,32,116
https://kawalpemilu.org#35427,"SIDOMULYO, CANDIMULYO, MAGELANG, JAWA TENGAH",1,191,67,258
https://kawalpemilu.org#39392,"JETIS, KALIWUNGU, SEMARANG, JAWA TENGAH",4,141,5,146
https://kawalpemilu.org#35706,"BANYUDONO, BANYUDONO, BOYOLALI, JAWA TENGAH",2,206,34,240
https://kawalpemilu.org#41784,"SAPURO KEBULEN, PEKALONGAN BARAT, KOTA PEKALONGAN, JAWA TENGAH",28,215,34,249
https://kawalpemilu.org#36623,"MANJUNG, WONOGIRI, WONOGIRI, JAWA TENGAH",11,77,27,104
https://kawalpemilu.org#37247,"MOJOAGUNG, KARANGRAYUNG, GROBOGAN, JAWA TENGAH",3,148,15,163
https://kawalpemilu.org#35200,"KRASAK, SALAMAN, MAGELANG, JAWA TENGAH",2,88,144,202
https://kawalpemilu.org#39292,"GEMAWANG, JAMBU, SEMARANG, JAWA TENGAH",5,127,70,197
https://kawalpemilu.org#41350,"KRADENAN, KERSANA, BREBES, JAWA TENGAH",4,178,37,215
https://kawalpemilu.org#35973,"MANDONG, TRUCUK, KLATEN, JAWA TENGAH",9,153,63,216
https://kawalpemilu.org#37454,"KEMLOKO, GODONG, GROBOGAN, JAWA TENGAH",13,108,41,149
https://kawalpemilu.org#41284,"PEDESLOHOR, JATIBARANG, BREBES, JAWA TENGAH",8,56,40,96
https://kawalpemilu.org#38470,"SEKARJALAK, MARGOYOSO, PATI, JAWA TENGAH",5,82,21,103
https://kawalpemilu.org#38684,"KEDUNGSARI, GEBOG, KUDUS, JAWA TENGAH",8,118,29,147
https://kawalpemilu.org#41703,"PEDALANGAN, BANYUMANIK, KOTA SEMARANG, JAWA TENGAH",3,148,101,249
https://kawalpemilu.org#38696,"LAU, DAWE, KUDUS, JAWA TENGAH",34,152,17,169
https://kawalpemilu.org#34298,"WONOSIGRO, GOMBONG, KEBUMEN, JAWA TENGAH",2,97,69,166
https://kawalpemilu.org#36165,"JAMBEYAN, KARANGANOM, KLATEN, JAWA TENGAH",5,169,34,203
https://kawalpemilu.org#33677,"GEMURUH, BAWANG, BANJARNEGARA, JAWA TENGAH",8,111,47,158
https://kawalpemilu.org#41134,"KERTASARI, SURADADI, TEGAL, JAWA TENGAH",13,78,114,192
https://kawalpemilu.org#35343,"RINGINANOM, TEMPURAN, MAGELANG, JAWA TENGAH",9,166,32,198
https://kawalpemilu.org#36501,"TIRTOSUWORO, GIRIWOYO, WONOGIRI, JAWA TENGAH",7,169,24,193
https://kawalpemilu.org#38086,"BALONGMULYO, KRAGAN, REMBANG, JAWA TENGAH",6,117,13,130
https://kawalpemilu.org#40801,"KARANGTALOK, AMPELGADING, PEMALANG, JAWA TENGAH",8,161,25,186
https://kawalpemilu.org#39500,"SOROPADAN, PRINGSURAT, TEMANGGUNG, JAWA TENGAH",9,154,80,234
https://kawalpemilu.org#37389,"NGABENREJO, GROBOGAN, GROBOGAN, JAWA TENGAH",10,182,18,200
https://kawalpemilu.org#36489,"WONODADI, PRACIMANTORO, WONOGIRI, JAWA TENGAH",4,167,9,176
https://kawalpemilu.org#37016,"KARUNGAN, PLUPUH, SRAGEN, JAWA TENGAH",7,97,11,108
https://kawalpemilu.org#39968,"TROMPO, KENDAL, KENDAL, JAWA TENGAH",5,150,33,183
https://kawalpemilu.org#38710,"KARANGAJI, KEDUNG, JEPARA, JAWA TENGAH",1,200,24,224
https://kawalpemilu.org#41547,"GILINGAN, BANJARSARI, KOTA SURAKARTA, JAWA TENGAH",9,201,13,214
https://kawalpemilu.org#38681,"BESITO, GEBOG, KUDUS, JAWA TENGAH",23,153,19,172
https://kawalpemilu.org#38796,"UJUNGBATU, JEPARA, JEPARA, JAWA TENGAH",9,182,21,203
https://kawalpemilu.org#40655,"MENDELEM, BELIK, PEMALANG, JAWA TENGAH",38,98,3,101
https://kawalpemilu.org#33806,"KARANGNANGKA, PAGENTAN, BANJARNEGARA, JAWA TENGAH",3,160,19,179
https://kawalpemilu.org#41768,"TAMBAKAJI, NGALIYAN, KOTA SEMARANG, JAWA TENGAH",25,128,57,185
https://kawalpemilu.org#34698,"POLOMARTO, BUTUH, PURWOREJO, JAWA TENGAH",2,130,46,176
https://kawalpemilu.org#38830,"KLEPU, KELING, JEPARA, JAWA TENGAH",9,173,37,210
https://kawalpemilu.org#39600,"KERTOSARI, JUMO, TEMANGGUNG, JAWA TENGAH",4,188,29,217
https://kawalpemilu.org#39366,"BERGAS KIDUL, BERGAS, SEMARANG, JAWA TENGAH",12,243,14,257
https://kawalpemilu.org#35272,"NGARGOMULYO, DUKUN, MAGELANG, JAWA TENGAH",7,202,1,203
https://kawalpemilu.org#37828,"RONGGOMULYO, SUMBER, REMBANG, JAWA TENGAH",4,204,7,211
https://kawalpemilu.org#38449,"WEDARIJAKSA, WEDARIJAKSA, PATI, JAWA TENGAH",13,139,27,166
https://kawalpemilu.org#40629,"BANYUMUDAL, MOGA, PEMALANG, JAWA TENGAH",17,144,70,214
https://kawalpemilu.org#39528,"KANDANGAN, KANDANGAN, TEMANGGUNG, JAWA TENGAH",1,183,68,251
https://kawalpemilu.org#33131,"NOTOG, PATIKRAJA, BANYUMAS, JAWA TENGAH",12,129,84,213
https://kawalpemilu.org#40027,"CARUBAN, RINGINARUM, KENDAL, JAWA TENGAH",10,88,94,182
https://kawalpemilu.org#36354,"PLESAN, NGUTER, SUKOHARJO, JAWA TENGAH",4,122,47,169
https://kawalpemilu.org#36130,"JETIS, DELANGGU, KLATEN, JAWA TENGAH",2,122,34,156
https://kawalpemilu.org#41084,"KADEMANGARAN, DUKUHTURI, TEGAL, JAWA TENGAH",4,148,98,246
https://kawalpemilu.org#40295,"PECALUNGAN, PECALUNGAN, BATANG, JAWA TENGAH",2,186,22,208
https://kawalpemilu.org#33713,"MADUKARA, MADUKARA, BANJARNEGARA, JAWA TENGAH",3,150,55,205
https://kawalpemilu.org#35330,"PASURUHAN, MERTOYUDAN, MAGELANG, JAWA TENGAH",24,117,20,137
https://kawalpemilu.org#36599,"KALIANCAR, SELOGIRI, WONOGIRI, JAWA TENGAH",16,148,92,240
https://kawalpemilu.org#37539,"KEDIREN, RANDUBLATUNG, BLORA, JAWA TENGAH",18,107,45,152
https://kawalpemilu.org#41036,"TEMBOK LUWUNG, ADIWERNA, TEGAL, JAWA TENGAH",7,167,70,237
https://kawalpemilu.org#35685,"MANJUNG, SAWIT, BOYOLALI, JAWA TENGAH",7,182,12,194
https://kawalpemilu.org#33648,"MERDEN, PURWONEGORO, BANJARNEGARA, JAWA TENGAH",26,126,48,174
https://kawalpemilu.org#41116,"KEPUNDUHAN, KRAMAT, TEGAL, JAWA TENGAH",1,126,61,187
https://kawalpemilu.org#40736,"BOJONGBATA, PEMALANG, PEMALANG, JAWA TENGAH",35,144,58,202
https://kawalpemilu.org#32852,"BABAKAN, KARANGPUCUNG, CILACAP, JAWA TENGAH",18,70,69,139
https://kawalpemilu.org#33544,"PANUSUPAN, REMBANG, PURBALINGGA, JAWA TENGAH",17,88,76,164
https://kawalpemilu.org#41263,"TONJONG, TONJONG, BREBES, JAWA TENGAH",2,65,122,187
https://kawalpemilu.org#38732,"TROSO, PECANGAAN, JEPARA, JAWA TENGAH",4,188,39,227
https://kawalpemilu.org#38632,"KARANGROWO, UNDAAN, KUDUS, JAWA TENGAH",15,157,16,173
https://kawalpemilu.org#36690,"KENTENG, PURWANTORO, WONOGIRI, JAWA TENGAH",6,122,22,144
https://kawalpemilu.org#40125,"SUKOMANGLI, REBAN, BATANG, JAWA TENGAH",1,209,8,217
https://kawalpemilu.org#34025,"AMBALKUMOLO, BULUSPESANTREN, KEBUMEN, JAWA TENGAH",1,73,80,153
https://kawalpemilu.org#40503,"SEMBUNGJAMBU, BOJONG, PEKALONGAN, JAWA TENGAH",14,126,11,137
https://kawalpemilu.org#39081,"KARANGANYAR, KARANGANYAR, DEMAK, JAWA TENGAH",14,145,71,216
https://kawalpemilu.org#41687,"METESEH, TEMBALANG, KOTA SEMARANG, JAWA TENGAH",30,178,81,259
https://kawalpemilu.org#33156,"BANJARSARI, AJIBARANG, BANYUMAS, JAWA TENGAH",22,161,53,214
https://kawalpemilu.org#38621,"TUMPANGKRASAK, JATI, KUDUS, JAWA TENGAH",22,117,84,201
https://kawalpemilu.org#37442,"LATAK, GODONG, GROBOGAN, JAWA TENGAH",4,164,15,179
https://kawalpemilu.org#41168,"BENTAR, SALEM, BREBES, JAWA TENGAH",9,45,175,220
https://kawalpemilu.org#33524,"GRANTUNG, KARANGMONCOL, PURBALINGGA, JAWA TENGAH",4,118,29,147
https://kawalpemilu.org#39587,"KATEKAN, NGADIREJO, TEMANGGUNG, JAWA TENGAH",8,185,24,214
https://kawalpemilu.org#39337,"SAMBAN, BAWEN, SEMARANG, JAWA TENGAH",8,203,32,235
https://kawalpemilu.org#35641,"KEBONGULO, MUSUK, BOYOLALI, JAWA TENGAH",1,221,15,236
https://kawalpemilu.org#41649,"TLOGOSARI KULON, PEDURUNGAN, KOTA SEMARANG, JAWA TENGAH",54,121,70,191
https://kawalpemilu.org#39365,"MUNDING, BERGAS, SEMARANG, JAWA TENGAH",11,168,22,190
https://kawalpemilu.org#37421,"KRONGGEN, BRATI, GROBOGAN, JAWA TENGAH",21,170,19,189
https://kawalpemilu.org#37420,"KARANGSARI, BRATI, GROBOGAN, JAWA TENGAH",13,188,22,210
https://kawalpemilu.org#32988,"CIRAHAB, LUMBIR, BANYUMAS, JAWA TENGAH",8,123,57,180
https://kawalpemilu.org#39536,"MARGOLELO, KANDANGAN, TEMANGGUNG, JAWA TENGAH",3,155,35,190
https://kawalpemilu.org#39298,"KEBONDALEM, JAMBU, SEMARANG, JAWA TENGAH",11,190,20,210
https://kawalpemilu.org#41543,"MOJOSONGO, JEBRES, KOTA SURAKARTA, JAWA TENGAH",65,234,23,257
https://kawalpemilu.org#36004,"NANGSRI, MANISRENGGO, KLATEN, JAWA TENGAH",10,230,21,251
https://kawalpemilu.org#40849,"LIMBANGAN, ULUJAMI, PEMALANG, JAWA TENGAH",14,195,10,205
https://kawalpemilu.org#37553,"MENDENREJO, KRADENAN, BLORA, JAWA TENGAH",8,198,10,208
https://kawalpemilu.org#35555,"WINDUSARI, WINDUSARI, MAGELANG, JAWA TENGAH",4,106,74,180
https://kawalpemilu.org#41802,"KLEGO, PEKALONGAN TIMUR, KOTA PEKALONGAN, JAWA TENGAH",2,155,80,235
https://kawalpemilu.org#39137,"TRIDONOREJO, BONANG, DEMAK, JAWA TENGAH",6,136,53,189
https://kawalpemilu.org#38610,"JATI WETAN, JATI, KUDUS, JAWA TENGAH",9,150,32,182
https://kawalpemilu.org#33031,"TIPAR, RAWALO, BANYUMAS, JAWA TENGAH",8,142,43,185
https://kawalpemilu.org#41668,"LAMPER TENGAH, SEMARANG SELATAN, KOTA SEMARANG, JAWA TENGAH",4,198,63,261
https://kawalpemilu.org#34993,"PACARMULYO, LEKSONO, WONOSOBO, JAWA TENGAH",5,151,66,217
https://kawalpemilu.org#37983,"SEREN, SULANG, REMBANG, JAWA TENGAH",2,145,37,182
https://kawalpemilu.org#36562,"SENDANGREJO, BATURETNO, WONOGIRI, JAWA TENGAH",5,155,15,170
https://kawalpemilu.org#39978,"PATUKANGAN, KENDAL, KENDAL, JAWA TENGAH",5,121,66,187
https://kawalpemilu.org#41858,"CABAWAN, MARGADANA, KOTA TEGAL, JAWA TENGAH",13,101,41,142
https://kawalpemilu.org#38267,"NGENING, BATANGAN, PATI, JAWA TENGAH",6,158,14,172
https://kawalpemilu.org#40337,"LOMENENG, PANINGGARAN, PEKALONGAN, JAWA TENGAH",3,109,32,141
https://kawalpemilu.org#36149,"NGARAN, POLANHARJO, KLATEN, JAWA TENGAH",2,110,43,153
https://kawalpemilu.org#36920,"GAWANAN, COLOMADU, KARANGANYAR, JAWA TENGAH",13,155,35,190
https://kawalpemilu.org#38978,"PRAMPELAN, SAYUNG, DEMAK, JAWA TENGAH",9,189,56,245
https://kawalpemilu.org#36083,"KARANGWUNGU, KARANGDOWO, KLATEN, JAWA TENGAH",4,110,18,128
https://kawalpemilu.org#41342,"JATIMAKMUR, SONGGOM, BREBES, JAWA TENGAH",4,104,40,144
https://kawalpemilu.org#36198,"MALANGAN, TULUNG, KLATEN, JAWA TENGAH",11,127,52,179
https://kawalpemilu.org#35744,"POTRONAYAN, NOGOSARI, BOYOLALI, JAWA TENGAH",16,174,27,201
https://kawalpemilu.org#38529,"PURWOKERTO, TAYU, PATI, JAWA TENGAH",11,133,54,187
https://kawalpemilu.org#33871,"MAJATENGAH, KALIBENING, BANJARNEGARA, JAWA TENGAH",2,145,40,185
https://kawalpemilu.org#38516,"PAKIS, TAYU, PATI, JAWA TENGAH",2,194,13,207
https://kawalpemilu.org#38568,"PRAMBATAN LOR, KALIWUNGU, KUDUS, JAWA TENGAH",6,115,73,188
https://kawalpemilu.org#41299,"PESANTUNAN, WANASARI, BREBES, JAWA TENGAH",1,106,116,222
https://kawalpemilu.org#38057,"KALITENGAH, PANCUR, REMBANG, JAWA TENGAH",1,207,51,258
https://kawalpemilu.org#37022,"SEPAT, MASARAN, SRAGEN, JAWA TENGAH",16,101,18,119
https://kawalpemilu.org#35445,"PAKIS, PAKIS, MAGELANG, JAWA TENGAH",12,100,12,112
https://kawalpemilu.org#33084,"BUNIAYU, TAMBAK, BANYUMAS, JAWA TENGAH",13,117,47,164
https://kawalpemilu.org#35492,"BALEAGUNG, GRABAG, MAGELANG, JAWA TENGAH",7,210,14,224
https://kawalpemilu.org#40195,"BABADAN, LIMPUNG, BATANG, JAWA TENGAH",11,133,69,202
https://kawalpemilu.org#38168,"TRIMULYO, KAYEN, PATI, JAWA TENGAH",13,145,14,159
https://kawalpemilu.org#41128,"MEJASEM TIMUR, KRAMAT, TEGAL, JAWA TENGAH",23,64,179,243
https://kawalpemilu.org#38616,"LORAM KULON, JATI, KUDUS, JAWA TENGAH",22,137,43,180
https://kawalpemilu.org#39208,"BENER, TENGARAN, SEMARANG, JAWA TENGAH",16,213,67,280
https://kawalpemilu.org#38677,"KLUMPIT, GEBOG, KUDUS, JAWA TENGAH",3,153,23,176
https://kawalpemilu.org#41615,"MLATIBARU, SEMARANG TIMUR, KOTA SEMARANG, JAWA TENGAH",5,206,31,237
https://kawalpemilu.org#33835,"BEJI, PEJAWARAN, BANJARNEGARA, JAWA TENGAH",2,76,150,226
https://kawalpemilu.org#39938,"SIDOMULYO, CEPIRING, KENDAL, JAWA TENGAH",2,112,87,199
https://kawalpemilu.org#37163,"MOJOPURO, SUMBERLAWANG, SRAGEN, JAWA TENGAH",1,217,5,222
https://kawalpemilu.org#40122,"KARANGANYAR, REBAN, BATANG, JAWA TENGAH",5,144,28,172
https://kawalpemilu.org#36831,"NGUNUT, JUMANTONO, KARANGANYAR, JAWA TENGAH",12,146,72,218
https://kawalpemilu.org#34023,"BOCOR, BULUSPESANTREN, KEBUMEN, JAWA TENGAH",7,148,63,211
https://kawalpemilu.org#35136,"TEGALSARI, GARUNG, WONOSOBO, JAWA TENGAH",11,188,34,222
https://kawalpemilu.org#41235,"WINDUAJI, PAGUYANGAN, BREBES, JAWA TENGAH",21,49,69,118
https://kawalpemilu.org#40751,"TAMBAKREJO, PEMALANG, PEMALANG, JAWA TENGAH",9,152,43,195
https://kawalpemilu.org#36527,"HARGOSARI, TIRTOMOYO, WONOGIRI, JAWA TENGAH",16,140,12,152
https://kawalpemilu.org#35879,"JOHO, PRAMBANAN, KLATEN, JAWA TENGAH",9,163,20,183
https://kawalpemilu.org#41020,"SLAWI WETAN, SLAWI, TEGAL, JAWA TENGAH",21,127,95,222
https://kawalpemilu.org#39411,"LEREP, UNGARAN BARAT, SEMARANG, JAWA TENGAH",20,164,71,235
https://kawalpemilu.org#39183,"TAJUK, GETASAN, SEMARANG, JAWA TENGAH",8,126,20,146
https://kawalpemilu.org#38804,"MOROREJO, MLONGGO, JEPARA, JAWA TENGAH",3,106,39,145
https://kawalpemilu.org#40191,"KALISALAK, LIMPUNG, BATANG, JAWA TENGAH",9,138,21,159
https://kawalpemilu.org#41603,"BANDARHARJO, SEMARANG UTARA, KOTA SEMARANG, JAWA TENGAH",10,227,27,254
https://kawalpemilu.org#34709,"BINANGUN, BUTUH, PURWOREJO, JAWA TENGAH",2,75,37,112
https://kawalpemilu.org#36674,"MIRI, KISMANTORO, WONOGIRI, JAWA TENGAH",3,151,19,170
https://kawalpemilu.org#38663,"TANJUNGREJO, JEKULO, KUDUS, JAWA TENGAH",3,140,22,162
https://kawalpemilu.org#38325,"KALIMULYO, JAKENAN, PATI, JAWA TENGAH",3,141,8,149
https://kawalpemilu.org#36784,"GIRIHARJO, PUHPELEM, WONOGIRI, JAWA TENGAH",9,191,12,203
https://kawalpemilu.org#37389,"NGABENREJO, GROBOGAN, GROBOGAN, JAWA TENGAH",12,178,29,207
https://kawalpemilu.org#41465,"CIKUYA, BANJARHARJO, BREBES, JAWA TENGAH",7,157,16,173
https://kawalpemilu.org#39719,"DUREN, BEJEN, TEMANGGUNG, JAWA TENGAH",3,157,21,178
https://kawalpemilu.org#39350,"WIRU, BRINGIN, SEMARANG, JAWA TENGAH",10,207,20,227
https://kawalpemilu.org#41823,"JENGGOT, PEKALONGAN SELATAN, KOTA PEKALONGAN, JAWA TENGAH",12,208,48,256
https://kawalpemilu.org#32716,"ADIPALA, ADIPALA, CILACAP, JAWA TENGAH",10,182,68,250
https://kawalpemilu.org#40311,"LUWUNG, BANYUPUTIH, BATANG, JAWA TENGAH",2,177,29,206
https://kawalpemilu.org#34156,"JATISARI, KEBUMEN, KEBUMEN, JAWA TENGAH",1,122,76,198
https://kawalpemilu.org#38350,"PATI LOR, PATI, PATI, JAWA TENGAH",4,121,64,185
https://kawalpemilu.org#84904,"MUJUR LOR, KROYA, CILACAP, JAWA TENGAH",9,89,114,203
https://kawalpemilu.org#39856,"BEBENGAN, BOJA, KENDAL, JAWA TENGAH",7,154,51,205
https://kawalpemilu.org#87513,"KARANGREJA, CIPARI, CILACAP, JAWA TENGAH",8,136,29,165
https://kawalpemilu.org#33317,"BERKOH, PURWOKERTO SELATAN, BANYUMAS, JAWA TENGAH",21,157,34,191
https://kawalpemilu.org#39647,"KLEPU, KRANGGAN, TEMANGGUNG, JAWA TENGAH",8,176,20,196
https://kawalpemilu.org#40867,"MARGASARI, MARGASARI, TEGAL, JAWA TENGAH",9,145,75,220
https://kawalpemilu.org#32718,"ADIREJA WETAN, ADIPALA, CILACAP, JAWA TENGAH",2,172,21,193
https://kawalpemilu.org#41389,"LEMAHABANG, TANJUNG, BREBES, JAWA TENGAH",15,146,33,179
https://kawalpemilu.org#36749,"KEMBANG, JATIPURNO, WONOGIRI, JAWA TENGAH",6,109,1,110
https://kawalpemilu.org#39956,"BANGUNREJO, PATEBON, KENDAL, JAWA TENGAH",5,144,66,210
https://kawalpemilu.org#39242,"CUKILAN, SURUH, SEMARANG, JAWA TENGAH",12,135,13,148
https://kawalpemilu.org#33375,"KEBUTUH, BUKATEJA, PURBALINGGA, JAWA TENGAH",6,132,44,176
https://kawalpemilu.org#33872,"KALISAT KIDUL, KALIBENING, BANJARNEGARA, JAWA TENGAH",5,110,47,157
https://kawalpemilu.org#38145,"PORANGPARING, SUKOLILO, PATI, JAWA TENGAH",7,110,9,119
https://kawalpemilu.org#41611,"DADAPSARI, SEMARANG UTARA, KOTA SEMARANG, JAWA TENGAH",14,151,76,227
https://kawalpemilu.org#41561,"SIDOREJO LOR, SIDOREJO, KOTA SALATIGA, JAWA TENGAH",11,165,82,247
https://kawalpemilu.org#35244,"SELOBORO, SALAM, MAGELANG, JAWA TENGAH",6,132,54,186
https://kawalpemilu.org#41366,"KARANGJUNTI, LOSARI, BREBES, JAWA TENGAH",9,147,34,181
https://kawalpemilu.org#38054,"PANDAN, PANCUR, REMBANG, JAWA TENGAH",2,123,78,201
https://kawalpemilu.org#33672,"BINORONG, BAWANG, BANJARNEGARA, JAWA TENGAH",1,68,53,121
https://kawalpemilu.org#34766,"REJOSARI, KEMIRI, PURWOREJO, JAWA TENGAH",3,122,50,172
https://kawalpemilu.org#42595,"WONODADI, NGRAYUN, PONOROGO, JAWA TIMUR",9,125,34,159
https://kawalpemilu.org#47023,"SUKOPINGGIR, GUDO, JOMBANG, JAWA TIMUR",4,116,49,165
https://kawalpemilu.org#50689,"SUMBER WARU, WARU, PAMEKASAN, JAWA TIMUR",14,2,207,209
https://kawalpemilu.org#50745,"PABERASAN, KOTA SUMENEP, SUMENEP, JAWA TIMUR",13,118,104,222
https://kawalpemilu.org#43763,"NGASEM, GURAH, KEDIRI, JAWA TIMUR",3,154,30,184
https://kawalpemilu.org#50499,"SOKOBANAH DAYA, SOKOBANAH, SAMPANG, JAWA TIMUR",12,25,167,192
https://kawalpemilu.org#49950,"KEMBANGAN, KEBOMAS, GRESIK, JAWA TIMUR",10,119,110,229
https://kawalpemilu.org#44484,"KRATON, YOSOWILANGUN, LUMAJANG, JAWA TIMUR",5,91,87,178
https://kawalpemilu.org#46492,"MODONG, TULANGAN, SIDOARJO, JAWA TIMUR",1,180,56,236
https://kawalpemilu.org#44768,"SUCI, PANTI, JEMBER, JAWA TIMUR",16,75,80,155
https://kawalpemilu.org#43347,"BANGUNJAYA, PAKEL, TULUNGAGUNG, JAWA TIMUR",1,147,20,167
https://kawalpemilu.org#51381,"NGAGEL REJO, WONOKROMO, KOTA SURABAYA, JAWA TIMUR",117,175,41,216
https://kawalpemilu.org#45210,"MASKUNING WETAN, PUJER, BONDOWOSO, JAWA TIMUR",7,88,49,137
https://kawalpemilu.org#45808,"SUMBERPOH, MARON, PROBOLINGGO, JAWA TIMUR",1,124,53,177
https://kawalpemilu.org#44112,"PAGEDANGAN, TUREN, MALANG, JAWA TIMUR",25,128,60,188
https://kawalpemilu.org#44237,"SUMBERKRADENAN, PAKIS, MALANG, JAWA TIMUR",14,166,56,222
https://kawalpemilu.org#43668,"BLEBER, KRAS, KEDIRI, JAWA TIMUR",3,181,16,197
https://kawalpemilu.org#45534,"SUMBERWARU, BANYUPUTIH, SITUBONDO, JAWA TIMUR",10,134,29,163
https://kawalpemilu.org#46371,"JUWETKENONGO, PORONG, SIDOARJO, JAWA TIMUR",4,150,55,205
https://kawalpemilu.org#43789,"MENANG, PAGU, KEDIRI, JAWA TIMUR",8,150,38,188
https://kawalpemilu.org#51137,"TINALAN, PESANTREN, KOTA KEDIRI, JAWA TIMUR",12,160,34,194
https://kawalpemilu.org#46744,"KESIMAN, TRAWAS, MOJOKERTO, JAWA TIMUR",1,218,32,250
https://kawalpemilu.org#46421,"KEDENSARI, TANGGULANGIN, SIDOARJO, JAWA TIMUR",14,192,50,242
https://kawalpemilu.org#47474,"KEMADUH, BARON, NGANJUK, JAWA TIMUR",14,145,47,192
https://kawalpemilu.org#48886,"RAYUNG, SENORI, TUBAN, JAWA TIMUR",11,118,45,163
https://kawalpemilu.org#51017,"JAMBUIR, GAYAM, SUMENEP, JAWA TIMUR",4,48,89,137
https://kawalpemilu.org#50772,"MANDING DAYA, MANDING, SUMENEP, JAWA TIMUR",3,36,136,172
https://kawalpemilu.org#51413,"KLAMPIS NGASEM, SUKOLILO, KOTA SURABAYA, JAWA TIMUR",40,205,48,253
https://kawalpemilu.org#51144,"BURENGAN, PESANTREN, KOTA KEDIRI, JAWA TIMUR",18,138,40,178
https://kawalpemilu.org#46155,"ORO-ORO OMBOKULON, REMBANG, PASURUAN, JAWA TIMUR",9,143,102,245
https://kawalpemilu.org#44689,"TANGGULKULON, TANGGUL, JEMBER, JAWA TIMUR",6,99,130,229
https://kawalpemilu.org#44793,"ROWOINDAH, AJUNG, JEMBER, JAWA TIMUR",4,179,41,220
https://kawalpemilu.org#49865,"ROOMO, MANYAR, GRESIK, JAWA TIMUR",13,71,75,146
https://kawalpemilu.org#43988,"SEKOTO, BADAS, KEDIRI, JAWA TIMUR",14,138,46,184
https://kawalpemilu.org#47137,"KEPANJEN, JOMBANG, JOMBANG, JAWA TIMUR",7,115,51,166
https://kawalpemilu.org#43171,"NYAWANGAN, SENDANG, TULUNGAGUNG, JAWA TIMUR",5,128,17,145
https://kawalpemilu.org#43595,"PAGERGUNUNG, KESAMBEN, BLITAR, JAWA TIMUR",5,97,33,130
https://kawalpemilu.org#48144,"KLETEKAN, JOGOROGO, NGAWI, JAWA TIMUR",5,147,31,178
https://kawalpemilu.org#43440,"BENDO, PONGGOK, BLITAR, JAWA TIMUR",4,192,11,203
https://kawalpemilu.org#43548,"GANDUSARI, GANDUSARI, BLITAR, JAWA TIMUR",5,109,23,132
https://kawalpemilu.org#45710,"TRIWUNGAN, KOTAANYAR, PROBOLINGGO, JAWA TIMUR",15,132,73,205
https://kawalpemilu.org#45488,"TREBUNGAN, MANGARAN, SITUBONDO, JAWA TIMUR",7,121,52,173
https://kawalpemilu.org#43654,"KEDAWUNG, MOJO, KEDIRI, JAWA TIMUR",4,144,1,145
https://kawalpemilu.org#49655,"SARIREJO, SARIREJO, LAMONGAN, JAWA TIMUR",2,133,73,206
https://kawalpemilu.org#44887,"SUMBERSALAK, LEDOKOMBO, JEMBER, JAWA TIMUR",17,149,9,158
https://kawalpemilu.org#51515,"MANYAR SABRANGAN, MULYOREJO, KOTA SURABAYA, JAWA TIMUR",34,111,20,131
https://kawalpemilu.org#46322,"KRAMATTEMENGGUNG, TARIK, SIDOARJO, JAWA TIMUR",5,162,63,225
https://kawalpemilu.org#47274,"KUDUBANJAR, KUDU, JOMBANG, JAWA TIMUR",6,179,18,197
https://kawalpemilu.org#42503,"PETUNGSINARANG, BANDAR, PACITAN, JAWA TIMUR",6,83,105,188
https://kawalpemilu.org#44476,"KUNIR KIDUL, KUNIR, LUMAJANG, JAWA TIMUR",23,159,60,219
https://kawalpemilu.org#45262,"BENDOARUM, WONOSARI, BONDOWOSO, JAWA TIMUR",15,66,75,141
https://kawalpemilu.org#47492,"KAMPUNGBARU, TANJUNGANOM, NGANJUK, JAWA TIMUR",5,183,46,229
https://kawalpemilu.org#45129,"TEMUGURUH, SEMPU, BANYUWANGI, JAWA TIMUR",21,152,55,207
https://kawalpemilu.org#47299,"NGUMPUL, JOGOROTO, JOMBANG, JAWA TIMUR",17,138,59,197
https://kawalpemilu.org#44004,"PURWODADI, DONOMULYO, MALANG, JAWA TIMUR",9,151,11,162
https://kawalpemilu.org#43623,"JATITENGAH, SELOPURO, BLITAR, JAWA TIMUR",9,103,41,144
https://kawalpemilu.org#51462,"UJUNG, SEMAMPIR, KOTA SURABAYA, JAWA TIMUR",72,40,61,101
https://kawalpemilu.org#44611,"KUDUS, KLAKAH, LUMAJANG, JAWA TIMUR",9,43,200,243
https://kawalpemilu.org#47724,"BRUMBUN, WUNGU, MADIUN, JAWA TIMUR",4,129,38,167
https://kawalpemilu.org#42868,"NGROGUNG, NGEBEL, PONOROGO, JAWA TIMUR",8,87,25,112
https://kawalpemilu.org#50472,"TEBANAH, BANYUATES, SAMPANG, JAWA TIMUR",10,69,133,202
https://kawalpemilu.org#43565,"UMBULDAMAR, BINANGUN, BLITAR, JAWA TIMUR",4,141,27,168
https://kawalpemilu.org#50381,"PRAJJAN, CAMPLONG, SAMPANG, JAWA TIMUR",6,105,84,189
https://kawalpemilu.org#49097,"BANDUNGREJO, PLUMPANG, TUBAN, JAWA TIMUR",7,145,30,175
https://kawalpemilu.org#51406,"AIRLANGGA, GUBENG, KOTA SURABAYA, JAWA TIMUR",18,173,68,241
https://kawalpemilu.org#50128,"BRAGANG, KLAMPIS, BANGKALAN, JAWA TIMUR",2,102,98,200
https://kawalpemilu.org#51243,"PAKISTAJI, WONOASIH, KOTA PROBOLINGGO, JAWA TIMUR",4,125,73,198
https://kawalpemilu.org#43443,"CANDIREJO, PONGGOK, BLITAR, JAWA TIMUR",11,189,17,206
https://kawalpemilu.org#50686,"LEBBEK, PAKONG, PAMEKASAN, JAWA TIMUR",10,36,161,197
https://kawalpemilu.org#47808,"SAMBIREJO, SARADAN, MADIUN, JAWA TIMUR",5,151,26,177
https://kawalpemilu.org#47289,"KARANGDAGANGAN, BANDARKEDUNGMULYO, JOMBANG, JAWA TIMUR",4,123,44,167
https://kawalpemilu.org#46578,"JEMUNDO, TAMAN, SIDOARJO, JAWA TIMUR",5,144,51,195
https://kawalpemilu.org#42543,"TANJUNGPURO, NGADIROJO, PACITAN, JAWA TIMUR",4,64,140,204
https://kawalpemilu.org#44749,"SUMBEREJO, AMBULU, JEMBER, JAWA TIMUR",20,130,78,208
https://kawalpemilu.org#50027,"PEROMAAN, TAMBAK, GRESIK, JAWA TIMUR",7,35,72,107
https://kawalpemilu.org#44686,"PALERAN, UMBULSARI, JEMBER, JAWA TIMUR",23,130,59,189
https://kawalpemilu.org#50678,"CEN LECEN, PAKONG, PAMEKASAN, JAWA TIMUR",5,29,219,248
https://kawalpemilu.org#46399,"DUKUHSARI, JABON, SIDOARJO, JAWA TIMUR",4,160,67,227
https://kawalpemilu.org#47654,"KRADINAN, DOLOPO, MADIUN, JAWA TIMUR",13,148,15,163
https://kawalpemilu.org#46117,"SIDOWAYAH, BEJI, PASURUAN, JAWA TIMUR",1,135,85,220
https://kawalpemilu.org#48502,"KARANGAN, KEPOH BARU, BOJONEGORO, JAWA TIMUR",5,151,23,174
https://kawalpemilu.org#45698,"KALIDANDAN, PAKUNIRAN, PROBOLINGGO, JAWA TIMUR",1,141,138,279
https://kawalpemilu.org#49582,"MAYONG, KARANGBINANGUN, LAMONGAN, JAWA TIMUR",10,131,80,211
https://kawalpemilu.org#47795,"NGAMPEL, MEJAYAN, MADIUN, JAWA TIMUR",8,128,69,197
https://kawalpemilu.org#43662,"KENITEN, MOJO, KEDIRI, JAWA TIMUR",2,192,26,218
https://kawalpemilu.org#51329,"ORO-ORO OMBO, KARTOHARJO, KOTA MADIUN, JAWA TIMUR",3,115,79,194
https://kawalpemilu.org#47369,"SONOPATIK, BERBEK, NGANJUK, JAWA TIMUR",11,140,43,183
https://kawalpemilu.org#51559,"ORO-ORO OMBO, BATU, KOTA BATU, JAWA TIMUR",18,148,16,164
https://kawalpemilu.org#49708,"BANJARAGUNG, BALONGPANGGANG, GRESIK, JAWA TIMUR",6,121,101,222
https://kawalpemilu.org#43474,"DAYU, NGLEGOK, BLITAR, JAWA TIMUR",7,145,26,171
https://kawalpemilu.org#46032,"SENGONAGUNG, PURWOSARI, PASURUAN, JAWA TIMUR",12,160,67,227
https://kawalpemilu.org#49818,"KEDAMEAN, KEDAMEAN, GRESIK, JAWA TIMUR",15,179,54,233
https://kawalpemilu.org#48587,"KENEP, BALEN, BOJONEGORO, JAWA TIMUR",4,154,53,207
https://kawalpemilu.org#50654,"TEBUL TIMUR, PEGANTENAN, PAMEKASAN, JAWA TIMUR",5,36,185,221
https://kawalpemilu.org#47483,"KEDUNGOMBO, TANJUNGANOM, NGANJUK, JAWA TIMUR",5,183,20,203
https://kawalpemilu.org#46342,"WONOPLINTAHAN, PRAMBON, SIDOARJO, JAWA TIMUR",8,186,51,237
https://kawalpemilu.org#42496,"NAWANGAN, NAWANGAN, PACITAN, JAWA TIMUR",14,49,126,175
https://kawalpemilu.org#51253,"WIROBORANG, MAYANGAN, KOTA PROBOLINGGO, JAWA TIMUR",15,195,61,256
https://kawalpemilu.org#44795,"SIDODADI, TEMPUREJO, JEMBER, JAWA TIMUR",26,147,74,221
https://kawalpemilu.org#46939,"MOJOWATESREJO, KEMLAGI, MOJOKERTO, JAWA TIMUR",5,191,47,238
https://kawalpemilu.org#51214,"TANJUNGREJO, SUKUN, KOTA MALANG, JAWA TIMUR",30,130,45,175
https://kawalpemilu.org#43429,"TUMPAKKEPUH, BAKUNG, BLITAR, JAWA TIMUR",12,184,20,204
https://kawalpemilu.org#44590,"BANYUPUTIH KIDUL, JATIROTO, LUMAJANG, JAWA TIMUR",13,120,81,201
https://kawalpemilu.org#43780,"GAYAM, GURAH, KEDIRI, JAWA TIMUR",4,133,53,186
https://kawalpemilu.org#42525,"NGLARAN, TULAKAN, PACITAN, JAWA TIMUR",15,35,113,148
https://kawalpemilu.org#51340,"SOGATEN, MANGUHARJO, KOTA MADIUN, JAWA TIMUR",11,101,104,205
https://kawalpemilu.org#44137,"SUKOWILANGUN, KALIPARE, MALANG, JAWA TIMUR",18,169,29,198
https://kawalpemilu.org#45135,"KLATAK, KALIPURO, BANYUWANGI, JAWA TIMUR",20,128,51,179
https://kawalpemilu.org#51313,"PRAJURIT KULON, PRAJURIT KULON, KOTA MOJOKERTO, JAWA TIMUR",12,122,64,186
https://kawalpemilu.org#51509,"GUNUNG ANYAR, GUNUNG ANYAR, KOTA SURABAYA, JAWA TIMUR",35,155,111,266
https://kawalpemilu.org#47181,"KEDUNG PAPAR, SUMOBITO, JOMBANG, JAWA TIMUR",11,181,33,214
https://kawalpemilu.org#44808,"JEMBERKIDUL, KALIWATES, JEMBER, JAWA TIMUR",58,100,45,145
https://kawalpemilu.org#45815,"PUSPAN, MARON, PROBOLINGGO, JAWA TIMUR",4,142,80,222
https://kawalpemilu.org#49081,"BATURETNO, TUBAN, TUBAN, JAWA TIMUR",1,150,63,213
https://kawalpemilu.org#51330,"SUKOSARI, KARTOHARJO, KOTA MADIUN, JAWA TIMUR",9,125,50,175
https://kawalpemilu.org#44007,"PANDANREJO, PAGAK, MALANG, JAWA TIMUR",5,78,78,156
https://kawalpemilu.org#43413,"DAWUHAN, KADEMANGAN, BLITAR, JAWA TIMUR",22,82,6,88
https://kawalpemilu.org#47028,"KREMBANGAN, GUDO, JOMBANG, JAWA TIMUR",3,134,36,170
https://kawalpemilu.org#45486,"SEMIRING, MANGARAN, SITUBONDO, JAWA TIMUR",1,148,55,203
https://kawalpemilu.org#43572,"TANGKIL, WLINGI, BLITAR, JAWA TIMUR",11,117,43,160
https://kawalpemilu.org#44875,"PLALANGAN, KALISAT, JEMBER, JAWA TIMUR",14,122,46,168
https://kawalpemilu.org#51419,"TAMBAKSARI, TAMBAKSARI, KOTA SURABAYA, JAWA TIMUR",13,161,66,227
https://kawalpemilu.org#44663,"SUMBERAGUNG, SUMBERBARU, JEMBER, JAWA TIMUR",31,72,122,194
https://kawalpemilu.org#43843,"BELOR, PURWOASRI, KEDIRI, JAWA TIMUR",4,137,12,149
https://kawalpemilu.org#44774,"SUKORAMBI, SUKORAMBI, JEMBER, JAWA TIMUR",7,121,82,203
https://kawalpemilu.org#44702,"SIDOMEKAR, SEMBORO, JEMBER, JAWA TIMUR",40,83,49,132
https://kawalpemilu.org#44080,"WONOMULYO, PONCOKUSUMO, MALANG, JAWA TIMUR",17,187,28,215
https://kawalpemilu.org#48277,"SIDOLAJU, WIDODAREN, NGAWI, JAWA TIMUR",4,165,63,228
https://kawalpemilu.org#45000,"SETAIL, GENTENG, BANYUWANGI, JAWA TIMUR",41,114,22,136
https://kawalpemilu.org#47100,"GONDEK, MOJOWARNO, JOMBANG, JAWA TIMUR",9,119,60,179
https://kawalpemilu.org#51217,"KARANG BESUKI, SUKUN, KOTA MALANG, JAWA TIMUR",22,168,54,222
https://kawalpemilu.org#42514,"NGRECO, TEGALOMBO, PACITAN, JAWA TIMUR",11,69,75,144
https://kawalpemilu.org#50712,"BUJUR TENGAH, BATUMARMAR, PAMEKASAN, JAWA TIMUR",31,4,207,211
https://kawalpemilu.org#50408,"RONGDALEM, OMBEN, SAMPANG, JAWA TIMUR",9,211,18,229
https://kawalpemilu.org#50525,"BLU'URAN, KARANGPENANG, SAMPANG, JAWA TIMUR",43,9,206,215
https://kawalpemilu.org#47549,"SUDIMOROHARJO, WILANGAN, NGANJUK, JAWA TIMUR",13,192,7,199
https://kawalpemilu.org#45625,"LIPRAK KULON, BANYUANYAR, PROBOLINGGO, JAWA TIMUR",11,0,0,0
https://kawalpemilu.org#46736,"SUMBERKEMBAR, PACET, MOJOKERTO, JAWA TIMUR",3,157,58,215
https://kawalpemilu.org#51435,"NYAMPLUNGAN, PABEAN CANTIKAN, KOTA SURABAYA, JAWA TIMUR",23,113,75,188
https://kawalpemilu.org#44630,"WONOAYU, RANUYOSO, LUMAJANG, JAWA TIMUR",7,60,114,174
https://kawalpemilu.org#51212,"BANDUNGREJOSARI, SUKUN, KOTA MALANG, JAWA TIMUR",86,151,70,221
https://kawalpemilu.org#43479,"MODANGAN, NGLEGOK, BLITAR, JAWA TIMUR",11,124,24,148
https://kawalpemilu.org#43435,"KEBONDUREN, PONGGOK, BLITAR, JAWA TIMUR",29,146,14,160
https://kawalpemilu.org#50732,"DEMPO TIMUR, PASEAN, PAMEKASAN, JAWA TIMUR",10,11,197,208
https://kawalpemilu.org#46647,"KALANGANYAR, SEDATI, SIDOARJO, JAWA TIMUR",13,164,33,197
https://kawalpemilu.org#47108,"WRINGINPITU, MOJOWARNO, JOMBANG, JAWA TIMUR",15,134,61,195
https://kawalpemilu.org#48247,"KEDUNG PUTRI, PARON, NGAWI, JAWA TIMUR",29,163,16,179
https://kawalpemilu.org#48728,"TEMBELING, KASIMAN, BOJONEGORO, JAWA TIMUR",9,150,47,197
https://kawalpemilu.org#51493,"KETINTANG, GAYUNGAN, KOTA SURABAYA, JAWA TIMUR",1,133,72,205
https://kawalpemilu.org#43654,"KEDAWUNG, MOJO, KEDIRI, JAWA TIMUR",2,121,6,127
https://kawalpemilu.org#46451,"SIDOKARE, SIDOARJO, SIDOARJO, JAWA TIMUR",11,118,77,195
https://kawalpemilu.org#49401,"SENDANGAGUNG, PACIRAN, LAMONGAN, JAWA TIMUR",5,141,83,224
https://kawalpemilu.org#45312,"PURNAMA, TEGALAMPEL, BONDOWOSO, JAWA TIMUR",6,38,106,144
https://kawalpemilu.org#51488,"DUKUH PAKIS, DUKUHPAKIS, KOTA SURABAYA, JAWA TIMUR",11,125,41,166
https://kawalpemilu.org#44325,"SRIGADING, LAWANG, MALANG, JAWA TIMUR",9,187,25,212
https://kawalpemilu.org#48408,"GAYAM, GAYAM, BOJONEGORO, JAWA TIMUR",4,129,49,178
https://kawalpemilu.org#48641,"BANJARJO, BOJONEGORO, BOJONEGORO, JAWA TIMUR",4,156,25,181
https://kawalpemilu.org#43243,"PURWOREJO, NGUNUT, TULUNGAGUNG, JAWA TIMUR",2,174,20,194
https://kawalpemilu.org#44362,"PAIT, KASEMBON, MALANG, JAWA TIMUR",11,124,18,142
https://kawalpemilu.org#44455,"SELOK ANYAR, PASIRIAN, LUMAJANG, JAWA TIMUR",15,113,68,181
https://kawalpemilu.org#42844,"NOLOGATEN, PONOROGO, PONOROGO, JAWA TIMUR",7,122,89,211
https://kawalpemilu.org#43094,"MOYOKETEN, BOYOLANGU, TULUNGAGUNG, JAWA TIMUR",4,147,61,208
https://kawalpemilu.org#45837,"WATUWUNGKUK, DRINGU, PROBOLINGGO, JAWA TIMUR",3,102,94,196
https://kawalpemilu.org#45349,"ANDUNGSARI, PAKEM, BONDOWOSO, JAWA TIMUR",3,115,82,197
https://kawalpemilu.org#43858,"KEMPLENG, PURWOASRI, KEDIRI, JAWA TIMUR",13,100,18,118
https://kawalpemilu.org#44670,"MAYANGAN, GUMUKMAS, JEMBER, JAWA TIMUR",3,147,36,183
https://kawalpemilu.org#50059,"TUNJUNG, BURNEH, BANGKALAN, JAWA TIMUR",38,75,144,219
https://kawalpemilu.org#47657,"BADER, DOLOPO, MADIUN, JAWA TIMUR",10,158,59,217
https://kawalpemilu.org#42830,"PAJU, PONOROGO, PONOROGO, JAWA TIMUR",10,178,35,213
https://kawalpemilu.org#50802,"GILANG, BLUTO, SUMENEP, JAWA TIMUR",1,103,51,6
https://kawalpemilu.org#51161,"TANJUNGSARI, SUKOREJO, KOTA BLITAR, JAWA TIMUR",24,167,78,245
https://kawalpemilu.org#51216,"BANDULAN, SUKUN, KOTA MALANG, JAWA TIMUR",2,176,55,231
https://kawalpemilu.org#49397,"BLIMBING, PACIRAN, LAMONGAN, JAWA TIMUR",10,40,127,167
https://kawalpemilu.org#50646,"PLAK PAK, PEGANTENAN, PAMEKASAN, JAWA TIMUR",40,2,128,130
https://kawalpemilu.org#44795,"SIDODADI, TEMPUREJO, JEMBER, JAWA TIMUR",12,156,38,194
https://kawalpemilu.org#47183,"CURAHMALANG, SUMOBITO, JOMBANG, JAWA TIMUR",5,140,56,196
https://kawalpemilu.org#44897,"SUKOSARI, SUKOWONO, JEMBER, JAWA TIMUR",11,120,93,213
https://kawalpemilu.org#51393,"BANYU URIP, SAWAHAN, KOTA SURABAYA, JAWA TIMUR",105,148,55,203
https://kawalpemilu.org#43502,"KARANGREJO, GARUM, BLITAR, JAWA TIMUR",1,138,6,144
https://kawalpemilu.org#47898,"KEPUHREJO, TAKERAN, MAGETAN, JAWA TIMUR",8,91,62,153
https://kawalpemilu.org#47338,"MARGOPATUT, SAWAHAN, NGANJUK, JAWA TIMUR",16,233,9,242
https://kawalpemilu.org#49036,"MAIBIT, RENGEL, TUBAN, JAWA TIMUR",8,88,105,193
https://kawalpemilu.org#46197,"GONDANG WETAN, GONDANGWETAN, PASURUAN, JAWA TIMUR",8,160,55,215
https://kawalpemilu.org#43972,"TUGUREJO, NGASEM, KEDIRI, JAWA TIMUR",18,142,56,198
https://kawalpemilu.org#46962,"BENDUNG, JETIS, MOJOKERTO, JAWA TIMUR",16,127,28,155
https://kawalpemilu.org#45079,"KEBALENAN, BANYUWANGI, BANYUWANGI, JAWA TIMUR",15,129,88,217
https://kawalpemilu.org#49962,"BANJARAN, DRIYOREJO, GRESIK, JAWA TIMUR",2,157,67,224
https://kawalpemilu.org#47988,"TRUNENG, SUKOMORO, MAGETAN, JAWA TIMUR",4,55,58,113
https://kawalpemilu.org#44362,"PAIT, KASEMBON, MALANG, JAWA TIMUR",14,118,18,136
https://kawalpemilu.org#43500,"SLOROK, GARUM, BLITAR, JAWA TIMUR",14,157,37,194
https://kawalpemilu.org#43139,"KAUMAN, KAUMAN, TULUNGAGUNG, JAWA TIMUR",5,124,78,202
https://kawalpemilu.org#48792,"JARI, GONDANG, BOJONEGORO, JAWA TIMUR",1,150,62,212
https://kawalpemilu.org#44666,"PRINGGOWIRAWAN, SUMBERBARU, JEMBER, JAWA TIMUR",41,17,132,149
https://kawalpemilu.org#87494,"KEBONSARI KULON, KANIGARAN, KOTA PROBOLINGGO, JAWA TIMUR",29,102,105,207
https://kawalpemilu.org#43470,"SUMBERASRI, NGLEGOK, BLITAR, JAWA TIMUR",26,209,27,236
https://kawalpemilu.org#50757,"KARTASADA, KALIANGET, SUMENEP, JAWA TIMUR",4,109,37,146
https://kawalpemilu.org#43176,"BUNGUR, KARANGREJO, TULUNGAGUNG, JAWA TIMUR",14,161,55,216
https://kawalpemilu.org#45138,"KETAPANG, KALIPURO, BANYUWANGI, JAWA TIMUR",41,114,81,195
https://kawalpemilu.org#46045,"SUKOREJO, SUKOREJO, PASURUAN, JAWA TIMUR",8,117,68,185
https://kawalpemilu.org#47581,"SUMBERJO, GONDANG, NGANJUK, JAWA TIMUR",8,102,103,205
https://kawalpemilu.org#50869,"GANDING, GANDING, SUMENEP, JAWA TIMUR",16,50,44,94
https://kawalpemilu.org#46040,"BAKALAN, PURWOSARI, PASURUAN, JAWA TIMUR",5,96,125,221
https://kawalpemilu.org#44036,"SUMBERMANJING WETAN, SUMBERMANJING WETAN, MALANG, JAWA TIMUR",3,153,82,235
https://kawalpemilu.org#50228,"POTER, TANAH MERAH, BANGKALAN, JAWA TIMUR",1,252,20,272
https://kawalpemilu.org#45306,"KLABANG, TEGALAMPEL, BONDOWOSO, JAWA TIMUR",1,96,13,109
https://kawalpemilu.org#43588,"RESAPOMBO, DOKO, BLITAR, JAWA TIMUR",20,99,18,117
https://kawalpemilu.org#51479,"SEMEMI, BENOWO, KOTA SURABAYA, JAWA TIMUR",29,128,32,160
https://kawalpemilu.org#45022,"SINGOJURUH, SINGOJURUH, BANYUWANGI, JAWA TIMUR",14,132,63,195
https://kawalpemilu.org#42661,"SOOKO, SOOKO, PONOROGO, JAWA TIMUR",15,139,24,163
https://kawalpemilu.org#46438,"SUGIHWARAS, CANDI, SIDOARJO, JAWA TIMUR",22,76,148,224
https://kawalpemilu.org#44744,"TANJUNGREJO, WULUHAN, JEMBER, JAWA TIMUR",27,119,66,185
https://kawalpemilu.org#43170,"PICISAN, SENDANG, TULUNGAGUNG, JAWA TIMUR",12,160,25,185
https://kawalpemilu.org#50384,"SEJATI, CAMPLONG, SAMPANG, JAWA TIMUR",8,44,184,228
https://kawalpemilu.org#47410,"PLOSOHARJO, PACE, NGANJUK, JAWA TIMUR",6,147,58,205
https://kawalpemilu.org#49149,"NGANDONG, GRABAGAN, TUBAN, JAWA TIMUR",3,160,35,195
https://kawalpemilu.org#45487,"TANJUNG PECINAN, MANGARAN, SITUBONDO, JAWA TIMUR",21,25,148,173
https://kawalpemilu.org#51196,"KOTALAMA, KEDUNGKANDANG, KOTA MALANG, JAWA TIMUR",83,81,129,210
https://kawalpemilu.org#47948,"RANDUGEDE, PLAOSAN, MAGETAN, JAWA TIMUR",4,163,51,214
https://kawalpemilu.org#47304,"TURIPINGGIR, MEGALUH, JOMBANG, JAWA TIMUR",8,149,13,162
https://kawalpemilu.org#43859,"SUMBERJO, PURWOASRI, KEDIRI, JAWA TIMUR",3,122,12,134
https://kawalpemilu.org#43753,"KAWEDUSAN, PLOSOKLATEN, KEDIRI, JAWA TIMUR",12,189,39,228
https://kawalpemilu.org#42976,"SUMBERINGIN, KARANGAN, TRENGGALEK, JAWA TIMUR",19,96,68,164
https://kawalpemilu.org#43974,"PARON, NGASEM, KEDIRI, JAWA TIMUR",6,145,38,183
https://kawalpemilu.org#50869,"GANDING, GANDING, SUMENEP, JAWA TIMUR",10,66,84,150
https://kawalpemilu.org#42690,"NGLUMPANG, MLARAK, PONOROGO, JAWA TIMUR",5,95,82,177
https://kawalpemilu.org#45391,"PUCANGANOM, JAMBESARI DARUS SHOLAH, BONDOWOSO, JAWA TIMUR",1,57,109,166
https://kawalpemilu.org#47992,"BELOTAN, BENDO, MAGETAN, JAWA TIMUR",14,151,53,204
https://kawalpemilu.org#45171,"GAMBANGAN, MAESAN, BONDOWOSO, JAWA TIMUR",9,101,58,159
https://kawalpemilu.org#46946,"MOJOREJO, KEMLAGI, MOJOKERTO, JAWA TIMUR",2,171,37,208
https://kawalpemilu.org#43329,"BULUS, BANDUNG, TULUNGAGUNG, JAWA TIMUR",6,139,23,162
https://kawalpemilu.org#51182,"JODIPAN, BLIMBING, KOTA MALANG, JAWA TIMUR",5,145,69,214
https://kawalpemilu.org#46812,"KAUMAN, MOJOSARI, MOJOKERTO, JAWA TIMUR",3,168,62,230
https://kawalpemilu.org#49044,"PUNGGULREJO, RENGEL, TUBAN, JAWA TIMUR",15,109,114,223
https://kawalpemilu.org#49336,"SEMAMPIREJO, SAMBENG, LAMONGAN, JAWA TIMUR",8,107,21,128
https://kawalpemilu.org#45150,"TEGALSARI, TEGALSARI, BANYUWANGI, JAWA TIMUR",11,156,32,188
https://kawalpemilu.org#44674,"PURWOASRI, GUMUKMAS, JEMBER, JAWA TIMUR",1,102,45,147
https://kawalpemilu.org#49103,"KEDUNGSOKO, PLUMPANG, TUBAN, JAWA TIMUR",8,128,32,160
https://kawalpemilu.org#46030,"KERTOSARI, PURWOSARI, PASURUAN, JAWA TIMUR",10,144,64,208
https://kawalpemilu.org#50418,"KOMIS, KEDUNGDUNG, SAMPANG, JAWA TIMUR",9,40,136,176
https://kawalpemilu.org#45556,"SELOWOGO, BUNGATAN, SITUBONDO, JAWA TIMUR",6,86,132,218
https://kawalpemilu.org#43917,"KEDUNGSARI, TAROKAN, KEDIRI, JAWA TIMUR",13,137,18,155
https://kawalpemilu.org#49402,"SENDANGDUWUR, PACIRAN, LAMONGAN, JAWA TIMUR",1,162,52,214
https://kawalpemilu.org#46237,"GRATI TUNON, GRATI, PASURUAN, JAWA TIMUR",9,177,39,216
https://kawalpemilu.org#51463,"SIDOTOPO, SEMAMPIR, KOTA SURABAYA, JAWA TIMUR",5,88,124,212
https://kawalpemilu.org#51231,"LOWOKWARU, LOWOKWARU, KOTA MALANG, JAWA TIMUR",28,152,69,221
https://kawalpemilu.org#45726,"PLAMPANG, PAITON, PROBOLINGGO, JAWA TIMUR",6,78,104,182
https://kawalpemilu.org#47059,"BANJARAGUNG, BARENG, JOMBANG, JAWA TIMUR",4,167,13,180
https://kawalpemilu.org#43729,"KUNJANG, NGANCAR, KEDIRI, JAWA TIMUR",14,147,13,160
https://kawalpemilu.org#48567,"SAMBONGREJO, SUMBEREJO, BOJONEGORO, JAWA TIMUR",3,84,61,145
https://kawalpemilu.org#46959,"MOJOREJO, JETIS, MOJOKERTO, JAWA TIMUR",10,132,46,178
https://kawalpemilu.org#46105,"WATUKOSEK, GEMPOL, PASURUAN, JAWA TIMUR",2,188,62,250
https://kawalpemilu.org#49817,"BANYUURIP, KEDAMEAN, GRESIK, JAWA TIMUR",8,225,17,242
https://kawalpemilu.org#51343,"WINONGO, MANGUHARJO, KOTA MADIUN, JAWA TIMUR",10,154,92,246
https://kawalpemilu.org#47128,"BALONGBESUK, DIWEK, JOMBANG, JAWA TIMUR",16,98,75,173
https://kawalpemilu.org#49818,"KEDAMEAN, KEDAMEAN, GRESIK, JAWA TIMUR",3,191,61,252
https://kawalpemilu.org#51178,"PURWANTORO, BLIMBING, KOTA MALANG, JAWA TIMUR",68,184,50,234
https://kawalpemilu.org#49324,"PARENGAN, MADURAN, LAMONGAN, JAWA TIMUR",2,101,74,175
https://kawalpemilu.org#50009,"SUNGAI TELUK, SANGKAPURA, GRESIK, JAWA TIMUR",3,72,114,186
https://kawalpemilu.org#46257,"NGULING, NGULING, PASURUAN, JAWA TIMUR",1,115,76,191
https://kawalpemilu.org#51546,"SAMBIKEREP, SAMBIKEREP, KOTA SURABAYA, JAWA TIMUR",25,153,32,185
https://kawalpemilu.org#49782,"SOOKO, WRINGINANOM, GRESIK, JAWA TIMUR",4,209,19,228
https://kawalpemilu.org#44939,"GRAJAGAN, PURWOHARJO, BANYUWANGI, JAWA TIMUR",17,184,38,222
https://kawalpemilu.org#42505,"BANDAR, BANDAR, PACITAN, JAWA TIMUR",15,88,126,214
https://kawalpemilu.org#44694,"SELODAKON, TANGGUL, JEMBER, JAWA TIMUR",3,41,87,128
https://kawalpemilu.org#44411,"KANIGORO, PAGELARAN, MALANG, JAWA TIMUR",25,122,64,186
https://kawalpemilu.org#87668,"JRAKAH, SAMBIT, PONOROGO, JAWA TIMUR",6,149,70,219
https://kawalpemilu.org#42707,"KARANGGEBANG, JETIS, PONOROGO, JAWA TIMUR",9,94,89,183
https://kawalpemilu.org#44306,"CANDIRENGGO, SINGOSARI, MALANG, JAWA TIMUR",44,71,56,127
https://kawalpemilu.org#48458,"DAYUKIDUL, KEDUNGADEM, BOJONEGORO, JAWA TIMUR",3,129,75,204
https://kawalpemilu.org#46869,"KINTELAN, PURI, MOJOKERTO, JAWA TIMUR",7,164,52,216
https://kawalpemilu.org#50886,"PRAGAAN LAOK, PRAGAAN, SUMENEP, JAWA TIMUR",13,118,96,214
https://kawalpemilu.org#50108,"TOGUBANG, GEGER, BANGKALAN, JAWA TIMUR",9,110,66,176
https://kawalpemilu.org#46154,"ORO-ORO OMBOWETAN, REMBANG, PASURUAN, JAWA TIMUR",9,74,161,235
https://kawalpemilu.org#47159,"TUGUSUMBERJO, PETERONGAN, JOMBANG, JAWA TIMUR",15,123,28,151
https://kawalpemilu.org#51209,"CIPTOMULYO, SUKUN, KOTA MALANG, JAWA TIMUR",19,144,51,195
https://kawalpemilu.org#47439,"KALIANYAR, NGRONGGOT, NGANJUK, JAWA TIMUR",9,174,26,200
https://kawalpemilu.org#47064,"GALENGDOWO, WONOSALAM, JOMBANG, JAWA TIMUR",11,181,33,214
https://kawalpemilu.org#47966,"TAPAK, PANEKAN, MAGETAN, JAWA TIMUR",7,177,14,191
https://kawalpemilu.org#51434,"BONGKARAN, PABEAN CANTIKAN, KOTA SURABAYA, JAWA TIMUR",6,106,92,198
https://kawalpemilu.org#44421,"PUROREJO, TEMPURSARI, LUMAJANG, JAWA TIMUR",14,133,17,150
https://kawalpemilu.org#44591,"ROJOPOLO, JATIROTO, LUMAJANG, JAWA TIMUR",21,69,87,156
https://kawalpemilu.org#50364,"DALPENANG, SAMPANG, SAMPANG, JAWA TIMUR",10,36,204,240
https://kawalpemilu.org#45968,"PETUNG, PASREPAN, PASURUAN, JAWA TIMUR",4,102,88,190
https://kawalpemilu.org#47482,"WARUJAYENG, TANJUNGANOM, NGANJUK, JAWA TIMUR",27,153,21,174
https://kawalpemilu.org#42603,"NGRAYUN, NGRAYUN, PONOROGO, JAWA TIMUR",4,136,102,238
https://kawalpemilu.org#43645,"JUGO, MOJO, KEDIRI, JAWA TIMUR",14,157,11,168
https://kawalpemilu.org#44597,"BANYUPUTIH LOR, RANDUAGUNG, LUMAJANG, JAWA TIMUR",13,60,134,194
https://kawalpemilu.org#46055,"CURAH REJO, SUKOREJO, PASURUAN, JAWA TIMUR",6,100,71,171
https://kawalpemilu.org#46675,"KEDUNGREJO, WARU, SIDOARJO, JAWA TIMUR",9,162,54,216
https://kawalpemilu.org#45432,"GUNUNG PUTRI, SUBOH, SITUBONDO, JAWA TIMUR",8,91,81,172
https://kawalpemilu.org#45830,"SEBAUNG, GENDING, PROBOLINGGO, JAWA TIMUR",20,140,22,162
https://kawalpemilu.org#42412,"PELEM, PRINGKUKU, PACITAN, JAWA TIMUR",5,40,129,169
https://kawalpemilu.org#43131,"NGANTRU, NGANTRU, TULUNGAGUNG, JAWA TIMUR",7,152,54,206
https://kawalpemilu.org#51149,"SENTUL, KEPANJENKIDUL, KOTA BLITAR, JAWA TIMUR",8,169,49,218
https://kawalpemilu.org#43273,"BUNTARAN, REJOTANGAN, TULUNGAGUNG, JAWA TIMUR",2,120,20,140
https://kawalpemilu.org#51059,"DUKO, ARJASA, SUMENEP, JAWA TIMUR",6,54,102,156
https://kawalpemilu.org#44970,"TAMPO, CLURING, BANYUWANGI, JAWA TIMUR",12,163,32,195
https://kawalpemilu.org#42541,"SIDOMULYO, NGADIROJO, PACITAN, JAWA TIMUR",11,29,158,187
https://kawalpemilu.org#45114,"BIMOREJO, WONGSOREJO, BANYUWANGI, JAWA TIMUR",3,154,51,205
https://kawalpemilu.org#47058,"MOJOTENGAH, BARENG, JOMBANG, JAWA TIMUR",12,127,14,141
https://kawalpemilu.org#50825,"POREH, LENTENG, SUMENEP, JAWA TIMUR",12,56,126,182
https://kawalpemilu.org#44997,"KEMBIRITAN, GENTENG, BANYUWANGI, JAWA TIMUR",22,128,57,185
https://kawalpemilu.org#50051,"JADDIH, SOCAH, BANGKALAN, JAWA TIMUR",24,124,102,226
https://kawalpemilu.org#44701,"SEMBORO, SEMBORO, JEMBER, JAWA TIMUR",13,118,61,179
https://kawalpemilu.org#44320,"RANDUANGUNG, SINGOSARI, MALANG, JAWA TIMUR",2,136,74,210
https://kawalpemilu.org#48449,"BULU, SUGIHWARAS, BOJONEGORO, JAWA TIMUR",4,120,70,190
https://kawalpemilu.org#48209,"LEGUNDI, KARANGJATI, NGAWI, JAWA TIMUR",11,184,17,201
https://kawalpemilu.org#44049,"PAMOTAN, DAMPIT, MALANG, JAWA TIMUR",26,184,13,197
https://kawalpemilu.org#50745,"PABERASAN, KOTA SUMENEP, SUMENEP, JAWA TIMUR",10,62,95,157
https://kawalpemilu.org#46665,"TROPODO, WARU, SIDOARJO, JAWA TIMUR",17,203,82,285
https://kawalpemilu.org#44236,"PAKISKEMBAR, PAKIS, MALANG, JAWA TIMUR",9,122,73,195
https://kawalpemilu.org#50513,"KETAPANG BARAT, KETAPANG, SAMPANG, JAWA TIMUR",4,149,45,194
https://kawalpemilu.org#43382,"SUKOREJO, UDANAWU, BLITAR, JAWA TIMUR",12,185,26,211
https://kawalpemilu.org#48190,"KWADUNGAN, KWADUNGAN, NGAWI, JAWA TIMUR",3,114,54,168
https://kawalpemilu.org#42969,"KARANGAN, KARANGAN, TRENGGALEK, JAWA TIMUR",6,183,25,208
https://kawalpemilu.org#48779,"DUYUNGAN, SUKOSEWU, BOJONEGORO, JAWA TIMUR",6,101,89,190
https://kawalpemilu.org#44244,"BUNUTWETAN, PAKIS, MALANG, JAWA TIMUR",4,170,55,225
https://kawalpemilu.org#47105,"SIDOKERTO, MOJOWARNO, JOMBANG, JAWA TIMUR",7,152,40,192
https://kawalpemilu.org#45203,"PECALONGAN, SUKOSARI, BONDOWOSO, JAWA TIMUR",9,37,90,127
https://kawalpemilu.org#46339,"KEDUNGSUGO, PRAMBON, SIDOARJO, JAWA TIMUR",13,155,55,210
https://kawalpemilu.org#59653,"CAPKALA, CAPKALA, BENGKAYANG, KALIMANTAN BARAT",9,129,29,158
https://kawalpemilu.org#58585,"SUNGAI ALAI, KAPUAS, SANGGAU, KALIMANTAN BARAT",2,122,5,127
https://kawalpemilu.org#58905,"JUNGKAL, TUMBANG TITI, KETAPANG, KALIMANTAN BARAT",1,123,6,129
https://kawalpemilu.org#60241,"SANGGAU KULOR, SINGKAWANG TIMUR, KOTA SINGKAWANG, KALIMANTAN BARAT",5,164,13,177
https://kawalpemilu.org#60201,"SUNGAI JAWI LUAR, PONTIANAK BARAT, KOTA PONTIANAK, KALIMANTAN BARAT",69,27,115,142
https://kawalpemilu.org#59844,"SEKAIS, JELIMPO, LANDAK, KALIMANTAN BARAT",7,143,9,152
https://kawalpemilu.org#60251,"SEDAU, SINGKAWANG SELATAN, KOTA SINGKAWANG, KALIMANTAN BARAT",67,95,22,117
https://kawalpemilu.org#59516,"TEKUDAK, KALIS, KAPUAS HULU, KALIMANTAN BARAT",4,106,65,171
https://kawalpemilu.org#58543,"PENITI DALAM II, SEGEDONG, MEMPAWAH, KALIMANTAN BARAT",7,28,141,169
https://kawalpemilu.org#60361,"JERUJU BESAR, SUNGAI KAKAP, KUBU RAYA, KALIMANTAN BARAT",6,42,163,205
https://kawalpemilu.org#59101,"SUNGAI DERAS, KETUNGAU HILIR, SINTANG, KALIMANTAN BARAT",2,132,8,140
https://kawalpemilu.org#58516,"PENIRAMAN, SUNGAI PINYUH, MEMPAWAH, KALIMANTAN BARAT",5,5,210,215
https://kawalpemilu.org#60213,"SUNGAI JAWI, PONTIANAK KOTA, KOTA PONTIANAK, KALIMANTAN BARAT",43,70,147,217
https://kawalpemilu.org#58842,"KUALAN TENGAH, SIMPANG HULU, KETAPANG, KALIMANTAN BARAT",6,127,9,136
https://kawalpemilu.org#59261,"BUNTUT PIMPIN, AMBALAU, SINTANG, KALIMANTAN BARAT",1,84,27,111
https://kawalpemilu.org#60188,"KOTA BARU, PONTIANAK SELATAN, KOTA PONTIANAK, KALIMANTAN BARAT",2,26,199,225
https://kawalpemilu.org#59291,"MERARAI DUA, SUNGAI TEBELIAN, SINTANG, KALIMANTAN BARAT",1,150,59,209
https://kawalpemilu.org#58574,"BUNUT, KAPUAS, SANGGAU, KALIMANTAN BARAT",24,74,122,196
https://kawalpemilu.org#60260,"KUALA DUA, SUNGAI RAYA, KUBU RAYA, KALIMANTAN BARAT",73,35,104,139
https://kawalpemilu.org#59127,"KAYU DUJUNG, KETUNGAU TENGAH, SINTANG, KALIMANTAN BARAT",2,161,5,166
https://kawalpemilu.org#931003,"LAMAN RAYA, SUNGAI TEBELIAN, SINTANG, KALIMANTAN BARAT",2,142,68,210
https://kawalpemilu.org#58497,"PASIR, MEMPAWAH HILIR, MEMPAWAH, KALIMANTAN BARAT",19,13,174,187
https://kawalpemilu.org#59809,"KERANJI MANCAL, SENGAH TEMILA, LANDAK, KALIMANTAN BARAT",8,169,18,187
https://kawalpemilu.org#85289,"RATU ELOK, MANIS MATA, KETAPANG, KALIMANTAN BARAT",8,74,69,143
https://kawalpemilu.org#59158,"PENGKADAN BARU, DEDAI, SINTANG, KALIMANTAN BARAT",1,166,76,242
https://kawalpemilu.org#59397,"PARANG, HULU GURUNG, KAPUAS HULU, KALIMANTAN BARAT",1,40,170,210
https://kawalpemilu.org#58614,"PISANG, JANGKANG, SANGGAU, KALIMANTAN BARAT",9,119,27,146
https://kawalpemilu.org#60213,"SUNGAI JAWI, PONTIANAK KOTA, KOTA PONTIANAK, KALIMANTAN BARAT",30,50,188,238
https://kawalpemilu.org#59933,"MERBANG, BELITANG HILIR, SEKADAU, KALIMANTAN BARAT",7,159,26,185
https://kawalpemilu.org#59790,"SIDAN, MENYUKE, LANDAK, KALIMANTAN BARAT",3,151,13,164
https://kawalpemilu.org#60225,"ROBAN, SINGKAWANG TENGAH, KOTA SINGKAWANG, KALIMANTAN BARAT",5,76,166,242
https://kawalpemilu.org#60251,"SEDAU, SINGKAWANG SELATAN, KOTA SINGKAWANG, KALIMANTAN BARAT",57,97,79,176
https://kawalpemilu.org#85358,"PARIT BARU, SUNGAI RAYA, KUBU RAYA, KALIMANTAN BARAT",93,77,49,119
https://kawalpemilu.org#58798,"MEKAR UTAMA, KENDAWANGAN, KETAPANG, KALIMANTAN BARAT",14,89,53,142
https://kawalpemilu.org#59560,"SUNGAI JAGA A, SUNGAI RAYA, BENGKAYANG, KALIMANTAN BARAT",6,25,136,161
https://kawalpemilu.org#59147,"MUAKAN PETINGGI, KETUNGAU HULU, SINTANG, KALIMANTAN BARAT",1,156,11,167
https://kawalpemilu.org#58294,"LORONG, SAMBAS, SAMBAS, KALIMANTAN BARAT",9,111,109,220
https://kawalpemilu.org#59559,"SUNGAI DURI, SUNGAI RAYA, BENGKAYANG, KALIMANTAN BARAT",13,69,57,126
https://kawalpemilu.org#59690,"PAPAN UDUK, LEMBAH BAWANG, BENGKAYANG, KALIMANTAN BARAT",1,148,7,155
https://kawalpemilu.org#58532,"SUNGAI KUNYIT HULU, SUNGAI KUNYIT, MEMPAWAH, KALIMANTAN BARAT",6,1,172,173
https://kawalpemilu.org#59903,"SENANGAK, NANGA TAMAN, SEKADAU, KALIMANTAN BARAT",1,231,13,244
https://kawalpemilu.org#64079,"SEBERANG MESJID, BANJARMASIN TENGAH, KOTA BANJARMASIN, KALIMANTAN SELATAN",1,54,190,244
https://kawalpemilu.org#63650,"SUPUT, HARUAI, TABALONG, KALIMANTAN SELATAN",2,31,149,180
https://kawalpemilu.org#63281,"KAPAR, BATANG ALAI SELATAN, HULU SUNGAI TENGAH, KALIMANTAN SELATAN",2,25,131,156
https://kawalpemilu.org#62814,"TINGGIRAN BARU, MEKARSARI, BARITO KUALA, KALIMANTAN SELATAN",7,63,124,187
https://kawalpemilu.org#62023,"SARIKANDI, KURAU, TANAH LAUT, KALIMANTAN SELATAN",2,65,81,146
https://kawalpemilu.org#62398,"SUNGAI PINANG BARU, SUNGAI TABUK, BANJAR, KALIMANTAN SELATAN",5,25,181,206
https://kawalpemilu.org#63622,"TANTA HULU, TANTA, TABALONG, KALIMANTAN SELATAN",8,61,154,215
https://kawalpemilu.org#62769,"SIMPANG NUNGKI, CERBON, BARITO KUALA, KALIMANTAN SELATAN",2,42,152,194
https://kawalpemilu.org#63850,"BAROKAH, SIMPANG EMPAT, TANAH BUMBU, KALIMANTAN SELATAN",28,75,35,110
https://kawalpemilu.org#62864,"RAYA BELANTI, BINUANG, TAPIN, KALIMANTAN SELATAN",14,180,93,273
https://kawalpemilu.org#62412,"SEKUMPUL, MARTAPURA, BANJAR, KALIMANTAN SELATAN",9,50,80,130
https://kawalpemilu.org#63495,"SUNGAI TURAK, AMUNTAI UTARA, HULU SUNGAI UTARA, KALIMANTAN SELATAN",2,39,177,216
https://kawalpemilu.org#62915,"ANTASARI HILIR, TAPIN UTARA, TAPIN, KALIMANTAN SELATAN",1,45,162,207
https://kawalpemilu.org#62183,"SEMAYAP, PULAULAUT UTARA, KOTABARU, KALIMANTAN SELATAN",10,82,55,137
https://kawalpemilu.org#63612,"WARUKIN, TANTA, TABALONG, KALIMANTAN SELATAN",2,173,24,197
https://kawalpemilu.org#63131,"PASUNGKAN, DAHA UTARA, HULU SUNGAI SELATAN, KALIMANTAN SELATAN",1,28,152,180
https://kawalpemilu.org#63784,"SATUI BARAT, SATUI, TANAH BUMBU, KALIMANTAN SELATAN",4,40,163,203
https://kawalpemilu.org#62751,"DANDA JAYA, RANTAU BADAUH, BARITO KUALA, KALIMANTAN SELATAN",3,87,129,216
https://kawalpemilu.org#62419,"TUNGGUL IRANG ILIR, MARTAPURA, BANJAR, KALIMANTAN SELATAN",2,42,95,137
https://kawalpemilu.org#62094,"TIRTA JAYA, BAJUIN, TANAH LAUT, KALIMANTAN SELATAN",4,95,138,233
https://kawalpemilu.org#62249,"SUKADANA, PAMUKAN SELATAN, KOTABARU, KALIMANTAN SELATAN",1,106,101,207
https://kawalpemilu.org#63476,"MUARA TAPUS, AMUNTAI TENGAH, HULU SUNGAI UTARA, KALIMANTAN SELATAN",2,39,103,142
https://kawalpemilu.org#63321,"HARUYAN DAYAK, HANTAKAN, HULU SUNGAI TENGAH, KALIMANTAN SELATAN",3,34,26,60
https://kawalpemilu.org#62045,"KURINGKIT, PANYIPATAN, TANAH LAUT, KALIMANTAN SELATAN",1,73,118,191
https://kawalpemilu.org#63260,"BARABAI DARAT, BARABAI, HULU SUNGAI TENGAH, KALIMANTAN SELATAN",25,17,95,112
https://kawalpemilu.org#62722,"SEMANGAT DALAM, ALALAK, BARITO KUALA, KALIMANTAN SELATAN",34,76,112,188
https://kawalpemilu.org#64100,"LANDASAN ULIN SELATAN, LIANG ANGGANG, KOTA BANJARBARU, KALIMANTAN SELATAN",3,76,98,174
https://kawalpemilu.org#63121,"PAKAN DALAM, DAHA UTARA, HULU SUNGAI SELATAN, KALIMANTAN SELATAN",1,59,160,219
https://kawalpemilu.org#62391,"PEMAKUAN, SUNGAI TABUK, BANJAR, KALIMANTAN SELATAN",7,71,164,235
https://kawalpemilu.org#62302,"SELARU, PULAULAUT TENGAH, KOTABARU, KALIMANTAN SELATAN",4,38,98,136
https://kawalpemilu.org#63644,"HALONG, HARUAI, TABALONG, KALIMANTAN SELATAN",6,31,153,184
https://kawalpemilu.org#64059,"KUIN CERUCUK, BANJARMASIN BARAT, KOTA BANJARMASIN, KALIMANTAN SELATAN",4,68,162,230
https://kawalpemilu.org#63586,"HABAU, BANUA LAWAS, TABALONG, KALIMANTAN SELATAN",6,31,105,136
https://kawalpemilu.org#60942,"BUNTOK KOTA, DUSUN SELATAN, BARITO SELATAN, KALIMANTAN TENGAH",11,164,66,230
https://kawalpemilu.org#61621,"TALIO MUARA, PANDIH BATU, PULANG PISAU, KALIMANTAN TENGAH",3,149,54,203
https://kawalpemilu.org#61932,"PANARUNG, PAHANDUT, KOTA PALANGKARAYA, KALIMANTAN TENGAH",70,62,140,202
https://kawalpemilu.org#61054,"LAHEI II, LAHEI, BARITO UTARA, KALIMANTAN TENGAH",8,68,143,211
https://kawalpemilu.org#85395,"HUJUNG PATA, RUNGAN BARAT, GUNUNG MAS, KALIMANTAN TENGAH",2,135,7,142
https://kawalpemilu.org#61947,"MENTENG, JEKAN RAYA, KOTA PALANGKARAYA, KALIMANTAN TENGAH",27,183,39,222
https://kawalpemilu.org#60852,"TUMBANG PUROH, KAPUAS HULU, KAPUAS, KALIMANTAN TENGAH",1,122,21,143
https://kawalpemilu.org#60787,"LAMUNTI, MANTANGAI, KAPUAS, KALIMANTAN TENGAH",1,133,68,201
https://kawalpemilu.org#60738,"DADAHUP, DADAHUP, KAPUAS, KALIMANTAN TENGAH",7,143,80,223
https://kawalpemilu.org#61082,"PARUPUK, KAMIPANG, KATINGAN, KALIMANTAN TENGAH",1,32,35,67
https://kawalpemilu.org#61947,"MENTENG, JEKAN RAYA, KOTA PALANGKARAYA, KALIMANTAN TENGAH",136,122,36,158
https://kawalpemilu.org#61244,"RANTAU PANDAN, BUKIT RAYA, KATINGAN, KALIMANTAN TENGAH",1,130,28,158
https://kawalpemilu.org#60700,"WARNA SARI, TAMBAN CATUR, KAPUAS, KALIMANTAN TENGAH",3,66,96,162
https://kawalpemilu.org#928325,"SUKA MAJU, MANTANGAI, KAPUAS, KALIMANTAN TENGAH",2,104,33,137
https://kawalpemilu.org#60393,"MENDAWAI, ARUT SELATAN, KOTAWARINGIN BARAT, KALIMANTAN TENGAH",20,83,145,228
https://kawalpemilu.org#61129,"SAMBA DANUM, KATINGAN TENGAH, KATINGAN, KALIMANTAN TENGAH",10,93,107,200
https://kawalpemilu.org#61946,"PALANGKA, JEKAN RAYA, KOTA PALANGKARAYA, KALIMANTAN TENGAH",126,135,30,165
https://kawalpemilu.org#61896,"NAGALEAH, PEMATANG KARAU, BARITO TIMUR, KALIMANTAN TENGAH",2,31,192,223
https://kawalpemilu.org#60937,"PALU REJO, GN. BINTANG AWAI, BARITO SELATAN, KALIMANTAN TENGAH",2,167,57,224
https://kawalpemilu.org#61933,"LANGKAI, PAHANDUT, KOTA PALANGKARAYA, KALIMANTAN TENGAH",20,74,46,120
https://kawalpemilu.org#64408,"SIDOMULYO, TABANG, KUTAI KARTANEGARA, KALIMANTAN TIMUR",1,67,48,115
https://kawalpemilu.org#65666,"BERBAS TENGAH, BONTANG SELATAN, KOTA BONTANG, KALIMANTAN TIMUR",13,108,106,214
https://kawalpemilu.org#65660,"LOK TUAN, BONTANG UTARA, KOTA BONTANG, KALIMANTAN TIMUR",51,121,124,245
https://kawalpemilu.org#65547,"GUNUNGSARI ULU, BALIKPAPAN TENGAH, KOTA BALIKPAPAN, KALIMANTAN TIMUR",45,77,80,157
https://kawalpemilu.org#65177,"LAMBING, MUARA LAWA, KUTAI BARAT, KALIMANTAN TIMUR",1,140,45,185
https://kawalpemilu.org#64550,"SUNGAI BEDUNGUN, TANJUNG REDEB, BERAU, KALIMANTAN TIMUR",10,100,95,195
https://kawalpemilu.org#85500,"AWAI, NYUATAN, KUTAI BARAT, KALIMANTAN TIMUR",1,195,18,213
https://kawalpemilu.org#65581,"AIR PUTIH, SAMARINDA ULU, KOTA SAMARINDA, KALIMANTAN TIMUR",42,45,114,159
https://kawalpemilu.org#64127,"SELENGOT, TANJUNG HARAPAN, PASER, KALIMANTAN TIMUR",3,58,160,218
https://kawalpemilu.org#65665,"TANJUNG LAUT, BONTANG SELATAN, KOTA BONTANG, KALIMANTAN TIMUR",23,75,44,119
https://kawalpemilu.org#65535,"BARU ILIR, BALIKPAPAN BARAT, KOTA BALIKPAPAN, KALIMANTAN TIMUR",27,72,39,111
https://kawalpemilu.org#65215,"MUARA GUSIK, BONGAN, KUTAI BARAT, KALIMANTAN TIMUR",2,144,28,172
https://kawalpemilu.org#64552,"BUGIS, TANJUNG REDEB, BERAU, KALIMANTAN TIMUR",31,82,85,167
https://kawalpemilu.org#65481,"PENAJAM, PENAJAM, PENAJAM PASER UTARA, KALIMANTAN TIMUR",2,65,161,226
https://kawalpemilu.org#64519,"SUKA MURYA, TALISAYAN, BERAU, KALIMANTAN TIMUR",2,142,31,173
https://kawalpemilu.org#65572,"SIMPANG PASIR, PALARAN, KOTA SAMARINDA, KALIMANTAN TIMUR",10,97,36,133
https://kawalpemilu.org#65581,"AIR PUTIH, SAMARINDA ULU, KOTA SAMARINDA, KALIMANTAN TIMUR",52,82,152,234
https://kawalpemilu.org#65322,"LONG TESAK, MUARA ANCALONG, KUTAI TIMUR, KALIMANTAN TIMUR",1,139,16,155
https://kawalpemilu.org#65551,"MEKAR SARI, BALIKPAPAN TENGAH, KOTA BALIKPAPAN, KALIMANTAN TIMUR",1,73,101,174
https://kawalpemilu.org#85501,"TANAH MEA, SILUQ NGURAI, KUTAI BARAT, KALIMANTAN TIMUR",1,112,12,124
https://kawalpemilu.org#65624,"SUNGAI PINANG LUAR, SAMARINDA KOTA, KOTA SAMARINDA, KALIMANTAN TIMUR",10,54,79,133
https://kawalpemilu.org#65530,"MANGGAR, BALIKPAPAN TIMUR, KOTA BALIKPAPAN, KALIMANTAN TIMUR",21,91,60,151
https://kawalpemilu.org#65097,"MEMAHAK BESAR, LONG BAGUN, MAHAKAM ULU, KALIMANTAN TIMUR",2,147,71,218
https://kawalpemilu.org#65579,"TELUK LERONG ILIR, SAMARINDA ULU, KOTA SAMARINDA, KALIMANTAN TIMUR",39,51,58,109
https://kawalpemilu.org#65390,"SEKERAT, BENGALON, KUTAI TIMUR, KALIMANTAN TIMUR",5,100,56,156
https://kawalpemilu.org#64470,"TELUK DALAM, TENGGARONG SEBERANG, KUTAI KARTANEGARA, KALIMANTAN TIMUR",2,94,117,211
https://kawalpemilu.org#65389,"SEPASO, BENGALON, KUTAI TIMUR, KALIMANTAN TIMUR",19,175,68,243
https://kawalpemilu.org#65612,"PULAU ATAS, SAMBUTAN, KOTA SAMARINDA, KALIMANTAN TIMUR",5,72,96,168
https://kawalpemilu.org#64725,"NUNUKAN BARAT, NUNUKAN, NUNUKAN, KALIMANTAN UTARA",44,92,46,138
https://kawalpemilu.org#64621,"TANJUNG PALAS HILIR, TANJUNG PALAS, BULUNGAN, KALIMANTAN UTARA",3,144,104,248
https://kawalpemilu.org#65017,"SETULANG, MALINAU SELATAN HILIR, MALINAU, KALIMANTAN UTARA",3,172,11,183
https://kawalpemilu.org#64652,"TANJUNG SELOR HILIR, TANJUNG SELOR, BULUNGAN, KALIMANTAN UTARA",5,118,65,183
https://kawalpemilu.org#85475,"SUNGAI LIMAU, SEBATIK TENGAH, NUNUKAN, KALIMANTAN UTARA",2,179,25,204
https://kawalpemilu.org#64661,"SALIMBATU, TANJUNG PALAS TENGAH, BULUNGAN, KALIMANTAN UTARA",4,125,87,212
https://kawalpemilu.org#25141,"AIR GEGAS, AIR GEGAS, BANGKA SELATAN, KEPULAUAN BANGKA BELITUNG",9,29,161,190
https://kawalpemilu.org#25083,"AIR SAGA, TANJUNG PANDAN, BELITUNG, KEPULAUAN BANGKA BELITUNG",10,134,87,221
https://kawalpemilu.org#25352,"SUKAMANDI, DAMAR, BELITUNG TIMUR, KEPULAUAN BANGKA BELITUNG",10,135,24,159
https://kawalpemilu.org#25272,"LIMBUNG, JEBUS, BANGKA BARAT, KEPULAUAN BANGKA BELITUNG",2,142,120,262
https://kawalpemilu.org#25116,"SUNGAI SAMAK, BADAU, BELITUNG, KEPULAUAN BANGKA BELITUNG",1,165,28,193
https://kawalpemilu.org#25031,"KEMUJA, MENDO BARAT, BANGKA, KEPULAUAN BANGKA BELITUNG",7,34,175,209
https://kawalpemilu.org#25209,"LAMPUR, SUNGAI SELAN, BANGKA TENGAH, KEPULAUAN BANGKA BELITUNG",7,162,61,223
https://kawalpemilu.org#24996,"SUNGAILIAT, SUNGAILIAT, BANGKA, KEPULAUAN BANGKA BELITUNG",16,162,30,192
https://kawalpemilu.org#25163,"PANGKAL BULUH, PAYUNG, BANGKA SELATAN, KEPULAUAN BANGKA BELITUNG",7,102,97,199
https://kawalpemilu.org#25392,"PASIR PUTIH, BUKITINTAN, KOTA PANGKALPINANG, KEPULAUAN BANGKA BELITUNG",8,220,23,243
https://kawalpemilu.org#25723,"TANJUNG KELIT, SENAYANG, LINGGA, KEPULAUAN RIAU",5,154,12,166
https://kawalpemilu.org#25485,"TANJUNG UBAN SELATAN, BINTAN UTARA, BINTAN, KEPULAUAN RIAU",3,106,99,205
https://kawalpemilu.org#25768,"KABIL, NONGSA, KOTA BATAM, KEPULAUAN RIAU",61,102,73,175
https://kawalpemilu.org#25599,"SABANG BARAT, MIDAI, NATUNA, KEPULAUAN RIAU",8,146,35,181
https://kawalpemilu.org#25786,"TANJUNG PIAYU, SEI BEDUK, KOTA BATAM, KEPULAUAN RIAU",44,81,66,147
https://kawalpemilu.org#25568,"PAMAK, TEBING, KARIMUN, KEPULAUAN RIAU",7,56,119,175
https://kawalpemilu.org#25516,"TOAPAYA SELATAN, TOAPAYA, BINTAN, KEPULAUAN RIAU",8,85,68,153
https://kawalpemilu.org#25557,"TULANG, KARIMUN, KARIMUN, KEPULAUAN RIAU",1,92,146,238
https://kawalpemilu.org#25685,"DABO, SINGKEP, LINGGA, KEPULAUAN RIAU",15,47,59,106
https://kawalpemilu.org#25566,"TELUK UMA, TEBING, KARIMUN, KEPULAUAN RIAU",5,82,111,193
https://kawalpemilu.org#25499,"KAMPUNG MELAYU, TAMBELAN, BINTAN, KEPULAUAN RIAU",1,129,71,200
https://kawalpemilu.org#25663,"CERUK, BUNGURAN TIMUR LAUT, NATUNA, KEPULAUAN RIAU",3,99,78,177
https://kawalpemilu.org#25817,"SUNGAI PELUNGGUT, SAGULUNG, KOTA BATAM, KEPULAUAN RIAU",22,167,16,183
https://kawalpemilu.org#25806,"TAMAN BALOI, BATAM KOTA, KOTA BATAM, KEPULAUAN RIAU",41,212,51,263
https://kawalpemilu.org#23200,"KOTABUMI UDIK, KOTABUMI, LAMPUNG UTARA, LAMPUNG",17,55,83,138
https://kawalpemilu.org#23016,"VARIA AGUNG, SEPUTIH MATARAM, LAMPUNG TENGAH, LAMPUNG",10,184,33,217
https://kawalpemilu.org#24365,"GUNUNG AGUNG, SEKAMPUNG UDIK, LAMPUNG TIMUR, LAMPUNG",12,146,12,158
https://kawalpemilu.org#23524,"SUKAJAYA, SUMBER JAYA, LAMPUNG BARAT, LAMPUNG",5,121,101,222
https://kawalpemilu.org#24781,"BAKUNG, TELUKBETUNG BARAT, KOTA BANDAR LAMPUNG, LAMPUNG",9,132,116,248
https://kawalpemilu.org#24075,"REJO SARI, ULU BELU, TANGGAMUS, LAMPUNG",2,199,26,225
https://kawalpemilu.org#24781,"BAKUNG, TELUKBETUNG BARAT, KOTA BANDAR LAMPUNG, LAMPUNG",10,98,139,237
https://kawalpemilu.org#22916,"HADUYANG RATU, PADANG RATU, LAMPUNG TENGAH, LAMPUNG",8,38,105,143
https://kawalpemilu.org#24711,"KAMPUNG BARU, LABUHAN RATU, KOTA BANDAR LAMPUNG, LAMPUNG",6,124,155,279
https://kawalpemilu.org#24840,"YOSODADI, METRO TIMUR, KOTA METRO, LAMPUNG",12,163,83,246
https://kawalpemilu.org#87255,"KOTA SEPANG, LABUHAN RATU, KOTA BANDAR LAMPUNG, LAMPUNG",5,70,89,159
https://kawalpemilu.org#24805,"PERUMNAS WAY KANDIS, TANJUNG SENANG, KOTA BANDAR LAMPUNG, LAMPUNG",19,49,116,165
https://kawalpemilu.org#84831,"PANGGUNG REJO UTARA, SUKOHARJO, PRINGSEWU, LAMPUNG",5,123,32,155
https://kawalpemilu.org#24222,"LABUHAN MARINGGAI, LABUHAN MARINGGAI, LAMPUNG TIMUR, LAMPUNG",30,189,26,215
https://kawalpemilu.org#23470,"WAY JAMBU, PESISIR SELATAN, PESISIR BARAT, LAMPUNG",2,103,52,155
https://kawalpemilu.org#87860,"CERINGIN SARI, WAY RATAI, PESAWARAN, LAMPUNG",2,165,39,204
https://kawalpemilu.org#23979,"AIR BAKOMAN, PULAU PANGGUNG, TANGGAMUS, LAMPUNG",2,84,98,182
https://kawalpemilu.org#23162,"SUKO BINANGUN, WAY SEPUTIH, LAMPUNG TENGAH, LAMPUNG",3,163,62,225
https://kawalpemilu.org#22965,"YUKUM JAYA, TERBANGGI BESAR, LAMPUNG TENGAH, LAMPUNG",46,81,88,169
https://kawalpemilu.org#24744,"KEBON JERUK, TANJUNGKARANG TIMUR, KOTA BANDAR LAMPUNG, LAMPUNG",4,91,115,206
https://kawalpemilu.org#24068,"PAGAR ALAM ULU BELU, ULU BELU, TANGGAMUS, LAMPUNG",5,81,77,158
https://kawalpemilu.org#24007,"SUMANDA, PUGUNG, TANGGAMUS, LAMPUNG",5,99,105,204
https://kawalpemilu.org#84003,"PAGAR BUKIT INDUK, BANGKUNAT, PESISIR BARAT, LAMPUNG",3,49,127,176
https://kawalpemilu.org#24035,"SIDODADI, SEMAKA, TANGGAMUS, LAMPUNG",2,120,89,209
https://kawalpemilu.org#23208,"KOTA GAPURA, KOTABUMI, LAMPUNG UTARA, LAMPUNG",119,26,100,126
https://kawalpemilu.org#22651,"TENGKUJUH, KALIANDA, LAMPUNG SELATAN, LAMPUNG",1,61,119,180
https://kawalpemilu.org#23275,"TRIMODADI, ABUNG SELATAN, LAMPUNG UTARA, LAMPUNG",66,131,85,216
https://kawalpemilu.org#24038,"KANOMAN, SEMAKA, TANGGAMUS, LAMPUNG",1,96,115,211
https://kawalpemilu.org#22401,"GEMAH RIPAH, PAGELARAN, PRINGSEWU, LAMPUNG",2,130,64,194
https://kawalpemilu.org#22774,"KARANG SARI, KETAPANG, LAMPUNG SELATAN, LAMPUNG",3,120,78,198
https://kawalpemilu.org#24773,"TALANG, TELUKBETUNG SELATAN, KOTA BANDAR LAMPUNG, LAMPUNG",22,92,134,226
https://kawalpemilu.org#23318,"KOTA ALAM, KOTABUMI SELATAN, LAMPUNG UTARA, LAMPUNG",158,39,146,185
https://kawalpemilu.org#24773,"TALANG, TELUKBETUNG SELATAN, KOTA BANDAR LAMPUNG, LAMPUNG",24,89,41,130
https://kawalpemilu.org#24555,"GUNUNG KATUN, BARADATU, WAY KANAN, LAMPUNG",19,51,113,164
https://kawalpemilu.org#22361,"AMBARAWA, AMBARAWA, PRINGSEWU, LAMPUNG",16,74,37,111
https://kawalpemilu.org#22896,"SIDO LUHUR, BANGUN REJO, LAMPUNG TENGAH, LAMPUNG",9,116,32,148
https://kawalpemilu.org#23265,"CAHAYA NEGERI, ABUNG BARAT, LAMPUNG UTARA, LAMPUNG",62,61,68,129
https://kawalpemilu.org#24758,"KALIAWI, TANJUNGKARANG PUSAT, KOTA BANDAR LAMPUNG, LAMPUNG",11,62,187,249
https://kawalpemilu.org#24486,"BLAMBANGAN UMPU, BLAMBANGAN UMPU, WAY KANAN, LAMPUNG",7,61,110,171
https://kawalpemilu.org#22938,"ADI PURO, TRIMURJO, LAMPUNG TENGAH, LAMPUNG",13,80,39,119
https://kawalpemilu.org#24418,"SUMBER HADI, MELINTING, LAMPUNG TIMUR, LAMPUNG",11,142,15,157
https://kawalpemilu.org#23023,"GAYA BARU VI, SEPUTIH SURABAYA, LAMPUNG TENGAH, LAMPUNG",7,157,52,209
https://kawalpemilu.org#22987,"BUYUT BARU, SEPUTIH RAMAN, LAMPUNG TENGAH, LAMPUNG",4,192,36,228
https://kawalpemilu.org#22759,"KARANG ANYAR, JATI AGUNG, LAMPUNG SELATAN, LAMPUNG",40,180,29,209
https://kawalpemilu.org#24726,"GEDONG AIR, TANJUNGKARANG BARAT, KOTA BANDAR LAMPUNG, LAMPUNG",19,77,71,148
https://kawalpemilu.org#22414,"NUSA WUNGU, BANYUMAS, PRINGSEWU, LAMPUNG",5,75,61,136
https://kawalpemilu.org#24346,"TANJUNG HARAPAN, MARGA TIGA, LAMPUNG TIMUR, LAMPUNG",11,150,97,247
https://kawalpemilu.org#23128,"NEGARA BUMI UDIK, ANAK TUHA, LAMPUNG TENGAH, LAMPUNG",3,125,43,168
https://kawalpemilu.org#23281,"ABUNG JAYO, ABUNG SELATAN, LAMPUNG UTARA, LAMPUNG",4,0,0,0
https://kawalpemilu.org#24766,"TELUKBETUNG, TELUKBETUNG SELATAN, KOTA BANDAR LAMPUNG, LAMPUNG",4,52,103,155
https://kawalpemilu.org#24727,"SUKAJAWA, TANJUNGKARANG BARAT, KOTA BANDAR LAMPUNG, LAMPUNG",22,68,117,185
https://kawalpemilu.org#24685,"BIMA SAKTI, NEGERI BESAR, WAY KANAN, LAMPUNG",5,110,28,138
https://kawalpemilu.org#24646,"GUNUNG LABUHAN, GUNUNG LABUHAN, WAY KANAN, LAMPUNG",9,29,142,171
https://kawalpemilu.org#24568,"MEKAR ASRI, BARADATU, WAY KANAN, LAMPUNG",6,116,53,169
https://kawalpemilu.org#24739,"KARANG MARITIM, PANJANG, KOTA BANDAR LAMPUNG, LAMPUNG",4,107,53,160
https://kawalpemilu.org#24255,"TULUS REJO, PEKALONGAN, LAMPUNG TIMUR, LAMPUNG",8,81,106,187
https://kawalpemilu.org#24746,"SAWAH BREBES, TANJUNGKARANG TIMUR, KOTA BANDAR LAMPUNG, LAMPUNG",17,118,116,234
https://kawalpemilu.org#84825,"PUJI HARJO, PAGELARAN, PRINGSEWU, LAMPUNG",3,118,94,212
https://kawalpemilu.org#23050,"BUMI RATU, BUMI RATU NUBAN, LAMPUNG TENGAH, LAMPUNG",10,16,120,136
https://kawalpemilu.org#23916,"KEDAMAIAN, KOTA AGUNG, TANGGAMUS, LAMPUNG",5,48,118,166
https://kawalpemilu.org#24984,"TEMPEL REJO, KEDONDONG, PESAWARAN, LAMPUNG",15,77,60,137
https://kawalpemilu.org#22757,"JATI MULYO, JATI AGUNG, LAMPUNG SELATAN, LAMPUNG",31,158,82,240
https://kawalpemilu.org#22688,"SIDOMULYO, SIDOMULYO, LAMPUNG SELATAN, LAMPUNG",14,139,26,165
https://kawalpemilu.org#24778,"KETEGUHAN, TELUKBETUNG TIMUR, KOTA BANDAR LAMPUNG, LAMPUNG",26,106,60,166
https://kawalpemilu.org#24898,"GEDUNG GUMANTI, TEGINENENG, PESAWARAN, LAMPUNG",10,154,45,199
https://kawalpemilu.org#84794,"SUMBER REJEKI MATARAM, BANDAR MATARAM, LAMPUNG TENGAH, LAMPUNG",7,158,15,173
https://kawalpemilu.org#22828,"TITIWANGI, CANDIPURO, LAMPUNG SELATAN, LAMPUNG",17,153,66,219
https://kawalpemilu.org#23212,"SUMBER ARUM, KOTABUMI, LAMPUNG UTARA, LAMPUNG",111,125,36,161
https://kawalpemilu.org#24227,"KARYA TANI, LABUHAN MARINGGAI, LAMPUNG TIMUR, LAMPUNG",17,85,12,97
https://kawalpemilu.org#-991044,"Hong Kong, Hong Kong, Republik Rakyat Tiongkok, Luar Negeri",1014,480,84,564
https://kawalpemilu.org#-991084,"Johor Bahru, Johor Bahru, Malaysia, Luar Negeri",2072,128,86,214
https://kawalpemilu.org#-990784,"Singapura, Singapura, Singapura, Luar Negeri",10,468,69,537
https://kawalpemilu.org#-991074,"Jeddah, Jeddah, Arab Saudi, Luar Negeri",2005,103,414,517
https://kawalpemilu.org#-990454,"Kopenhagen, Kopenhagen, Denmark, Luar Negeri",1,117,34,151
https://kawalpemilu.org#-991084,"Johor Bahru, Johor Bahru, Malaysia, Luar Negeri",2110,134,50,184
https://kawalpemilu.org#-991144,"Melbourne, Melbourne, Australia, Luar Negeri",1,312,34,346
https://kawalpemilu.org#-991304,"Taipei, Taipei, Taiwan, Luar Negeri",1026,1107,142,1249
https://kawalpemilu.org#78070,"TANAH TINGGI, KOTA TERNATE SELATAN, KOTA TERNATE, MALUKU UTARA",6,63,134,197
https://kawalpemilu.org#77874,"WAILAU, SANANA, KEPULAUAN SULA, MALUKU UTARA",1,29,200,229
https://kawalpemilu.org#77288,"TALAGA, IBU SELATAN, HALMAHERA BARAT, MALUKU UTARA",2,12,137,149
https://kawalpemilu.org#78083,"SANGADJI, KOTA TERNATE UTARA, KOTA TERNATE, MALUKU UTARA",4,39,84,123
https://kawalpemilu.org#77872,"UMALOYA, SANANA, KEPULAUAN SULA, MALUKU UTARA",1,26,138,164
https://kawalpemilu.org#77288,"TALAGA, IBU SELATAN, HALMAHERA BARAT, MALUKU UTARA",1,19,105,124
https://kawalpemilu.org#77183,"TAURO, JAILOLO, HALMAHERA BARAT, MALUKU UTARA",3,110,2,112
https://kawalpemilu.org#77790,"BIBINOI, BACAN TIMUR TENGAH, HALMAHERA SELATAN, MALUKU UTARA",2,84,104,188
https://kawalpemilu.org#78108,"TANAH RAJA, KOTA TERNATE TENGAH, KOTA TERNATE, MALUKU UTARA",2,55,81,136
https://kawalpemilu.org#928883,"MALULI, TALIABU SELATAN, PULAU TALIABU, MALUKU UTARA",2,79,114,193
https://kawalpemilu.org#77017,"BATU GAJAH, SIRIMAU, KOTA AMBON, MALUKU",3,194,8,202
https://kawalpemilu.org#76676,"WAEKASAR, WAEAPO, BURU, MALUKU",4,189,60,249
https://kawalpemilu.org#77059,"OHOITEL, PULAU DULLAH UTARA, KOTA TUAL, MALUKU",6,121,50,171
https://kawalpemilu.org#77007,"KELURAHAN NUSANIWE, NUSANIWE, KOTA AMBON, MALUKU",8,195,9,204
https://kawalpemilu.org#76805,"PIRU, SERAM BARAT, SERAM BAGIAN BARAT, MALUKU",28,65,175,240
https://kawalpemilu.org#77023,"BATU MERAH, SIRIMAU, KOTA AMBON, MALUKU",80,30,116,146
https://kawalpemilu.org#76783,"WAIMITAL, KAIRATU, SERAM BAGIAN BARAT, MALUKU",2,41,149,190
https://kawalpemilu.org#77064,"LODAR ELL, PULAU DULLAH SELATAN, KOTA TUAL, MALUKU",12,65,169,234
https://kawalpemilu.org#76356,"PULAU AY, BANDA, MALUKU TENGAH, MALUKU",1,82,115,197
https://kawalpemilu.org#76467,"ALLANG, LEIHITU BARAT, MALUKU TENGAH, MALUKU",7,111,9,120
https://kawalpemilu.org#76388,"ITAWAKA, SAPARUA TIMUR, MALUKU TENGAH, MALUKU",1,83,62,145
https://kawalpemilu.org#76660,"WAEPERANG, LILIALY, BURU, MALUKU",3,121,95,216
https://kawalpemilu.org#77017,"BATU GAJAH, SIRIMAU, KOTA AMBON, MALUKU",20,147,3,150
https://kawalpemilu.org#76677,"WAENETAT, WAEAPO, BURU, MALUKU",9,126,82,208
https://kawalpemilu.org#54605,"MANGGE NA'E, DOMPU, DOMPU, NUSA TENGGARA BARAT",5,52,149,201
https://kawalpemilu.org#54935,"DAYAN PEKEN, AMPENAN, KOTA MATARAM, NUSA TENGGARA BARAT",13,58,143,201
https://kawalpemilu.org#54304,"SELONG, SELONG, LOMBOK TIMUR, NUSA TENGGARA BARAT",17,64,154,218
https://kawalpemilu.org#54995,"KODO, RASANAE TIMUR, KOTA BIMA, NUSA TENGGARA BARAT",1,56,155,211
https://kawalpemilu.org#55037,"BENTEK, GANGGA, LOMBOK UTARA, NUSA TENGGARA BARAT",20,102,15,117
https://kawalpemilu.org#54317,"KERUMUT, PRINGGABAYA, LOMBOK TIMUR, NUSA TENGGARA BARAT",10,47,95,142
https://kawalpemilu.org#85064,"AIKMEL TIMUR, AIKMEL, LOMBOK TIMUR, NUSA TENGGARA BARAT",8,31,159,190
https://kawalpemilu.org#54860,"MENALA, TALIWANG, SUMBAWA BARAT, NUSA TENGGARA BARAT",13,75,125,200
https://kawalpemilu.org#54290,"PAOK MOTONG, MASBAGIK, LOMBOK TIMUR, NUSA TENGGARA BARAT",20,57,140,197
https://kawalpemilu.org#54284,"LOYOK, SIKUR, LOMBOK TIMUR, NUSA TENGGARA BARAT",7,108,75,183
https://kawalpemilu.org#54698,"SAMILI, WOHA, BIMA, NUSA TENGGARA BARAT",6,14,159,173
https://kawalpemilu.org#54350,"ANJANI, SURALAGA, LOMBOK TIMUR, NUSA TENGGARA BARAT",25,145,35,180
https://kawalpemilu.org#54967,"MONJOK, SELAPARANG, KOTA MATARAM, NUSA TENGGARA BARAT",3,37,178,215
https://kawalpemilu.org#54236,"LAJUT, PRAYA TENGAH, LOMBOK TENGAH, NUSA TENGGARA BARAT",9,26,184,210
https://kawalpemilu.org#54129,"PRAPEN, PRAYA, LOMBOK TENGAH, NUSA TENGGARA BARAT",37,47,124,171
https://kawalpemilu.org#54204,"LOANGMAKA, JANAPRIA, LOMBOK TENGAH, NUSA TENGGARA BARAT",11,25,138,163
https://kawalpemilu.org#54116,"SENTELUK, BATU LAYAR, LOMBOK BARAT, NUSA TENGGARA BARAT",13,41,207,248
https://kawalpemilu.org#54324,"AIKMEL, AIKMEL, LOMBOK TIMUR, NUSA TENGGARA BARAT",2,72,109,181
https://kawalpemilu.org#54967,"MONJOK, SELAPARANG, KOTA MATARAM, NUSA TENGGARA BARAT",6,28,148,176
https://kawalpemilu.org#54866,"LABUHAN LALAR, TALIWANG, SUMBAWA BARAT, NUSA TENGGARA BARAT",4,57,186,243
https://kawalpemilu.org#54192,"SEMOYANG, PRAYA TIMUR, LOMBOK TENGAH, NUSA TENGGARA BARAT",27,196,76,272
https://kawalpemilu.org#54443,"UMA SIMA, SUMBAWA, SUMBAWA, NUSA TENGGARA BARAT",3,94,74,168
https://kawalpemilu.org#54940,"PAGUTAN, MATARAM, KOTA MATARAM, NUSA TENGGARA BARAT",19,99,75,174
https://kawalpemilu.org#54382,"KORLEKO, LABUHAN HAJI, LOMBOK TIMUR, NUSA TENGGARA BARAT",9,107,35,142
https://kawalpemilu.org#54201,"LEKOR, JANAPRIA, LOMBOK TENGAH, NUSA TENGGARA BARAT",18,29,150,179
https://kawalpemilu.org#54210,"KEREMBONG, JANAPRIA, LOMBOK TENGAH, NUSA TENGGARA BARAT",5,41,146,187
https://kawalpemilu.org#85085,"WANASABA LAUK, WANASABA, LOMBOK TIMUR, NUSA TENGGARA BARAT",9,122,72,194
https://kawalpemilu.org#55042,"KAYANGAN, KAYANGAN, LOMBOK UTARA, NUSA TENGGARA BARAT",12,46,101,147
https://kawalpemilu.org#54164,"SENGKOL, PUJUT, LOMBOK TENGAH, NUSA TENGGARA BARAT",20,96,112,208
https://kawalpemilu.org#54168,"PENGENGAT, PUJUT, LOMBOK TENGAH, NUSA TENGGARA BARAT",10,76,105,181
https://kawalpemilu.org#54136,"MONTONG TEREP, PRAYA, LOMBOK TENGAH, NUSA TENGGARA BARAT",23,32,173,205
https://kawalpemilu.org#87682,"LEMBAR SELATAN, LEMBAR, LOMBOK BARAT, NUSA TENGGARA BARAT",28,68,92,160
https://kawalpemilu.org#85070,"PRINGGAJURANG UTARA, MONTONG GADING, LOMBOK TIMUR, NUSA TENGGARA BARAT",1,92,108,200
https://kawalpemilu.org#54110,"LABUAN TERENG, LEMBAR, LOMBOK BARAT, NUSA TENGGARA BARAT",7,22,162,184
https://kawalpemilu.org#54126,"LENENG, PRAYA, LOMBOK TENGAH, NUSA TENGGARA BARAT",4,41,142,183
https://kawalpemilu.org#54182,"MANGKUNG, PRAYA BARAT, LOMBOK TENGAH, NUSA TENGGARA BARAT",16,129,55,184
https://kawalpemilu.org#55019,"SAMBINAE, MPUNDA, KOTA BIMA, NUSA TENGGARA BARAT",7,22,173,195
https://kawalpemilu.org#92045,"MEKAR DAMAI, PRAYA, LOMBOK TENGAH, NUSA TENGGARA BARAT",9,45,168,213
https://kawalpemilu.org#54800,"RATO, LAMBU, BIMA, NUSA TENGGARA BARAT",10,15,186,201
https://kawalpemilu.org#54890,"TATAR, SEKONGKANG, SUMBAWA BARAT, NUSA TENGGARA BARAT",1,56,134,190
https://kawalpemilu.org#56720,"RUKUN LIMA, ENDE SELATAN, ENDE, NUSA TENGGARA TIMUR",13,130,52,182
https://kawalpemilu.org#58066,"OESAPA, KELAPA LIMA, KOTA KUPANG, NUSA TENGGARA TIMUR",31,156,7,163
https://kawalpemilu.org#58055,"OEPURA, MAULAFA, KOTA KUPANG, NUSA TENGGARA TIMUR",21,169,10,179
https://kawalpemilu.org#55865,"KABUNA, KAKULUK MESAK, BELU, NUSA TENGGARA TIMUR",8,138,50,188
https://kawalpemilu.org#55504,"SANBET, TOIANAS, TIMOR TENGAH SELATAN, NUSA TENGGARA TIMUR",2,165,11,176
https://kawalpemilu.org#57660,"PACAR, PACAR, MANGGARAI BARAT, NUSA TENGGARA TIMUR",2,119,3,122
https://kawalpemilu.org#57175,"PAMBOTANDJARA, KOTA WAINGAPU, SUMBA TIMUR, NUSA TENGGARA TIMUR",4,75,0,75
https://kawalpemilu.org#57154,"PONG  LENGOR, RAHONG UTARA, MANGGARAI, NUSA TENGGARA TIMUR",3,124,1,125
https://kawalpemilu.org#58066,"OESAPA, KELAPA LIMA, KOTA KUPANG, NUSA TENGGARA TIMUR",54,181,7,188
https://kawalpemilu.org#56035,"BEIRAFU, ATAMBUA BARAT, BELU, NUSA TENGGARA TIMUR",7,141,16,157
https://kawalpemilu.org#56478,"KOKOTOBO, ADONARA TENGAH, FLORES TIMUR, NUSA TENGGARA TIMUR",3,87,5,92
https://kawalpemilu.org#90886,"DELU DEPA, KODI BANGEDO, SUMBA BARAT DAYA, NUSA TENGGARA TIMUR",1,195,14,209
https://kawalpemilu.org#56895,"KELIMUTU, ENDE TENGAH, ENDE, NUSA TENGGARA TIMUR",6,90,13,103
https://kawalpemilu.org#56097,"HALERMAN, ALOR BARAT DAYA, ALOR, NUSA TENGGARA TIMUR",2,133,6,139
https://kawalpemilu.org#56380,"WAIWERANG KOTA, ADONARA TIMUR, FLORES TIMUR, NUSA TENGGARA TIMUR",5,157,106,263
https://kawalpemilu.org#56577,"NANGATOBONG, WAIGETE, SIKKA, NUSA TENGGARA TIMUR",6,108,3,111
https://kawalpemilu.org#57162,"KETANG, LELAK, MANGGARAI, NUSA TENGGARA TIMUR",2,98,17,115
https://kawalpemilu.org#57304,"MALUMBI, KAMBERA, SUMBA TIMUR, NUSA TENGGARA TIMUR",6,148,5,153
https://kawalpemilu.org#58028,"HOHA WUNGO, KODI UTARA, SUMBA BARAT DAYA, NUSA TENGGARA TIMUR",2,142,14,156
https://kawalpemilu.org#90862,"KALAKI KAMBE, WEWEWA BARAT, SUMBA BARAT DAYA, NUSA TENGGARA TIMUR",4,173,6,179
https://kawalpemilu.org#56185,"ALILA TIMUR, KABOLA, ALOR, NUSA TENGGARA TIMUR",3,19,176,195
https://kawalpemilu.org#56690,"ONDOREA BARAT, NANGAPANDA, ENDE, NUSA TENGGARA TIMUR",1,149,9,158
https://kawalpemilu.org#91236,"RANGGATALO, LIO TIMUR, ENDE, NUSA TENGGARA TIMUR",1,145,3,148
https://kawalpemilu.org#58208,"MBENGAN, KOTA KOMBA, MANGGARAI TIMUR, NUSA TENGGARA TIMUR",6,164,11,175
https://kawalpemilu.org#56834,"FATAMARI, LIO TIMUR, ENDE, NUSA TENGGARA TIMUR",1,196,16,212
https://kawalpemilu.org#58073,"OEBUFU, OEBOBO, KOTA KUPANG, NUSA TENGGARA TIMUR",29,201,5,206
https://kawalpemilu.org#57031,"BULAN, RUTENG, MANGGARAI, NUSA TENGGARA TIMUR",3,144,9,153
https://kawalpemilu.org#58148,"WANGKAR WELI, POCO RANAKA TIMUR, MANGGARAI TIMUR, NUSA TENGGARA TIMUR",1,177,33,210
https://kawalpemilu.org#56168,"NAILANG, ALOR TIMUR LAUT, ALOR, NUSA TENGGARA TIMUR",1,137,5,142
https://kawalpemilu.org#58076,"KAYU PUTIH, OEBOBO, KOTA KUPANG, NUSA TENGGARA TIMUR",26,61,134,195
https://kawalpemilu.org#56032,"BARDAO, ATAMBUA BARAT, BELU, NUSA TENGGARA TIMUR",5,119,50,169
https://kawalpemilu.org#57169,"KAMBAJAWA, KOTA WAINGAPU, SUMBA TIMUR, NUSA TENGGARA TIMUR",23,107,9,116
https://kawalpemilu.org#57809,"UTETOTO, NANGARORO, NAGEKEO, NUSA TENGGARA TIMUR",2,125,5,130
https://kawalpemilu.org#57771,"ORONG, WELAK, MANGGARAI BARAT, NUSA TENGGARA TIMUR",1,188,9,197
https://kawalpemilu.org#56407,"HORINARA, KELUBAGOLIT, FLORES TIMUR, NUSA TENGGARA TIMUR",2,97,112,209
https://kawalpemilu.org#85150,"KOLIPETUNG, ADONARA, FLORES TIMUR, NUSA TENGGARA TIMUR",1,31,103,134
https://kawalpemilu.org#57679,"NDOSO, NDOSO, MANGGARAI BARAT, NUSA TENGGARA TIMUR",4,85,7,92
https://kawalpemilu.org#81962,"MEFKAJIM II, AYAMARU, MAYBRAT, PAPUA BARAT",1,197,1,198
https://kawalpemilu.org#81918,"WOMBA, AIFAT TIMUR SELATAN, MAYBRAT, PAPUA BARAT",1,90,0,90
https://kawalpemilu.org#81980,"HUBERITA, AYAMARU TIMUR, MAYBRAT, PAPUA BARAT",1,203,0,203
https://kawalpemilu.org#929818,"WARMON KOKODA, MAYAMUK, SORONG, PAPUA BARAT",1,66,73,139
https://kawalpemilu.org#82908,"WAIFOI, TIPLOL MAYALIBIT, RAJA AMPAT, PAPUA BARAT",1,111,0,111
https://kawalpemilu.org#82191,"DESAY, PRAFI, MANOKWARI, PAPUA BARAT",6,65,105,170
https://kawalpemilu.org#82942,"DABATAN, MISOOL SELATAN, RAJA AMPAT, PAPUA BARAT",1,125,112,237
https://kawalpemilu.org#83291,"REMU UTARA, SORONG, KOTA SORONG, PAPUA BARAT",14,84,126,210
https://kawalpemilu.org#929278,"PUNCAK CENDRAWASIH, SORONG BARAT, KOTA SORONG, PAPUA BARAT",18,201,2,203
https://kawalpemilu.org#83110,"RADO, WASIOR, TELUK WONDAMA, PAPUA BARAT",1,189,3,192
https://kawalpemilu.org#79906,"GURINDA JAYA, JAGEBOB, MERAUKE, PAPUA",4,45,87,132
https://kawalpemilu.org#79967,"WAMAL, TUBANG, MERAUKE, PAPUA",1,144,14,158
https://kawalpemilu.org#930588,"KOMOPA, AWEIDA, PANIAI, PAPUA",1,212,0,212
https://kawalpemilu.org#80879,"BEKO, PANIAI BARAT, PANIAI, PAPUA",2,75,100,175
https://kawalpemilu.org#86822,"TIKOME, AYUMNATI, LANNY JAYA, PAPUA",6,254,0,254
https://kawalpemilu.org#86240,"SOOR, YAWOSI, BIAK NUMFOR, PAPUA",1,197,6,203
https://kawalpemilu.org#81176,"WAKDE 1, PANTAI TIMUR BAGIAN BARAT, SARMI, PAPUA",2,62,1,63
https://kawalpemilu.org#81689,"SENTUL, ENDOMEN, YAHUKIMO, PAPUA",1,224,0,224
https://kawalpemilu.org#81710,"WANIM, LOLAT, YAHUKIMO, PAPUA",11,297,0,297
https://kawalpemilu.org#79832,"KELAPA LIMA, MERAUKE, MERAUKE, PAPUA",3,134,6,140
https://kawalpemilu.org#89096,"NAME / KONDENAME, MOKONI, LANNY JAYA, PAPUA",2,280,0,280
https://kawalpemilu.org#930761,"GIWO, SIRIWO, PANIAI, PAPUA",1,32,168,200
https://kawalpemilu.org#90831,"GOAK, DURAM, YAHUKIMO, PAPUA",2,241,0,241
https://kawalpemilu.org#930513,"DAGOUTO, WEGEE BINO, PANIAI, PAPUA",1,250,0,250
https://kawalpemilu.org#929058,"SAEFEN EMPAT DUA, SKANTO, KEEROM, PAPUA",1,75,133,208
https://kawalpemilu.org#80720,"MARYENDI, SAMOFA, BIAK NUMFOR, PAPUA",1,155,4,159
https://kawalpemilu.org#929750,"DELEGARI, KARU, LANNY JAYA, PAPUA",2,226,0,226
https://kawalpemilu.org#929745,"BAWI, LANNYNA, LANNY JAYA, PAPUA",1,250,0,250
https://kawalpemilu.org#79833,"RIMBA JAYA, MERAUKE, MERAUKE, PAPUA",24,168,2,170
https://kawalpemilu.org#930498,"UWAMANI, WEGEE MUKA, PANIAI, PAPUA",3,177,0,177
https://kawalpemilu.org#999008,"OBAYA DIMI, BAYA BIRU, PANIAI, PAPUA",1,244,0,244
https://kawalpemilu.org#79967,"WAMAL, TUBANG, MERAUKE, PAPUA",2,105,4,109
https://kawalpemilu.org#79498,"PELANME, KELILA, MAMBERAMO TENGAH, PAPUA",4,155,0,155
https://kawalpemilu.org#79830,"MANDALA, MERAUKE, MERAUKE, PAPUA",5,173,14,187
https://kawalpemilu.org#78589,"BOKONERI, BOKONERI, TOLIKARA, PAPUA",1,155,0,155
https://kawalpemilu.org#81234,"JAIFURI, SKANTO, KEEROM, PAPUA",4,136,85,221
https://kawalpemilu.org#80008,"SUKA MAJU, MALIND, MERAUKE, PAPUA",3,100,77,177
https://kawalpemilu.org#78972,"ANYUMKA, AMBATKWI, BOVEN DIGOEL, PAPUA",1,67,18,85
https://kawalpemilu.org#78996,"KAKUNA, MINDIPTANA, BOVEN DIGOEL, PAPUA",1,74,2,76
https://kawalpemilu.org#81081,"TEMBAGAPURA, TEMBAGAPURA, MIMIKA, PAPUA",24,131,69,200
https://kawalpemilu.org#86474,"KAMENAWARI, PANTAI BARAT, SARMI, PAPUA",1,59,0,59
https://kawalpemilu.org#90610,"BIRUBI, YENDIDORI, BIAK NUMFOR, PAPUA",1,155,0,155
https://kawalpemilu.org#86783,"LIBOME, GOLLO, LANNY JAYA, PAPUA",1,342,0,342
https://kawalpemilu.org#79856,"IWOL, OKABA, MERAUKE, PAPUA",1,93,4,97
https://kawalpemilu.org#929751,"IGIMBUA, KARU, LANNY JAYA, PAPUA",2,257,0,257
https://kawalpemilu.org#80532,"MANDALA, BIAK KOTA, BIAK NUMFOR, PAPUA",15,152,47,199
https://kawalpemilu.org#78462,"PIRILUK, UMAGI, TOLIKARA, PAPUA",1,217,0,217
https://kawalpemilu.org#79830,"MANDALA, MERAUKE, MERAUKE, PAPUA",17,110,32,142
https://kawalpemilu.org#15423,"SUNGAI APIT, SUNGAI APIT, SIAK, RIAU",12,65,192,257
https://kawalpemilu.org#15819,"SIMPANG BARU, TAMPAN, KOTA PEKANBARU, RIAU",17,32,142,174
https://kawalpemilu.org#90469,"BAGAN SINEMBAH KOTA, BAGAN SINEMBAH, ROKAN HILIR, RIAU",3,87,95,182
https://kawalpemilu.org#15808,"RUMBAI BUKIT, RUMBAI, KOTA PEKANBARU, RIAU",5,52,171,223
https://kawalpemilu.org#15316,"BAGAN BATU, BAGAN SINEMBAH, ROKAN HILIR, RIAU",6,115,77,192
https://kawalpemilu.org#15149,"KOTA LAMA, KUNTO DARUSSALAM, ROKAN HULU, RIAU",23,143,96,239
https://kawalpemilu.org#90475,"BALAM JAYA, BAGAN SINEMBAH, ROKAN HILIR, RIAU",18,39,95,134
https://kawalpemilu.org#14089,"SELATPANJANG KOTA, TEBING TINGGI, KEPULAUAN MERANTI, RIAU",12,61,134,195
https://kawalpemilu.org#15865,"BUMI AYU, DUMAI SELATAN, KOTA DUMAI, RIAU",18,87,129,216
https://kawalpemilu.org#84503,"GEMBIRA, Gaung, INDRAGIRI HILIR, RIAU",4,93,62,155
https://kawalpemilu.org#15825,"TANGKERANG TENGAH, MARPOYAN DAMAI, KOTA PEKANBARU, RIAU",64,50,124,174
https://kawalpemilu.org#15486,"SEMINAI, KERINCI KANAN, SIAK, RIAU",7,94,44,138
https://kawalpemilu.org#14971,"PANGKALAN KERINCI TIMUR, PANGKALAN KERINCI, PELALAWAN, RIAU",51,79,132,211
https://kawalpemilu.org#14873,"PULAUPALAS, Tembilahan Hulu, INDRAGIRI HILIR, RIAU",10,92,114,206
https://kawalpemilu.org#15491,"JAYA PURA, BUNGA RAYA, SIAK, RIAU",7,120,99,219
https://kawalpemilu.org#15822,"DELIMA, TAMPAN, KOTA PEKANBARU, RIAU",35,23,118,141
https://kawalpemilu.org#14228,"TANAH MERAH, SIAK HULU, KAMPAR, RIAU",23,161,4,165
https://kawalpemilu.org#15440,"MINAS TIMUR, MINAS, SIAK, RIAU",4,98,73,171
https://kawalpemilu.org#14729,"TITIAN ANTUI, PINGGIR, BENGKALIS, RIAU",47,109,71,180
https://kawalpemilu.org#15320,"BALAM SEMPURNA, BAGAN SINEMBAH, ROKAN HILIR, RIAU",28,143,18,161
https://kawalpemilu.org#14824,"KOTA BARU RETEH, Keritang, INDRAGIRI HILIR, RIAU",13,48,153,201
https://kawalpemilu.org#14672,"TEMIANG, BANDAR LAKSAMANA, BENGKALIS, RIAU",6,24,125,150
https://kawalpemilu.org#15803,"KAMPUNG BARU, SENAPELAN, KOTA PEKANBARU, RIAU",24,103,100,203
https://kawalpemilu.org#14196,"KEMANG INDAH, TAMBANG, KAMPAR, RIAU",3,4,175,179
https://kawalpemilu.org#14377,"KOTO PERAMBAHAN, KAMPA, KAMPAR, RIAU",11,13,121,134
https://kawalpemilu.org#14418,"KAMPUNG BESAR KOTA, RENGAT, INDRAGIRI HULU, RIAU",8,56,135,191
https://kawalpemilu.org#15843,"LEMBAH DAMAI, RUMBAI PESISIR, KOTA PEKANBARU, RIAU",16,11,216,227
https://kawalpemilu.org#15530,"LAKSAMANA, SABAK AUH, SIAK, RIAU",1,39,133,172
https://kawalpemilu.org#14418,"KAMPUNG BESAR KOTA, RENGAT, INDRAGIRI HULU, RIAU",6,58,123,181
https://kawalpemilu.org#14974,"MAKMUR, PANGKALAN KERINCI, PELALAWAN, RIAU",4,55,75,130
https://kawalpemilu.org#90481,"BABUSSALAM ROKAN, PUJUD, ROKAN HILIR, RIAU",1,20,157,177
https://kawalpemilu.org#15700,"TEBERAU PANJANG, GUNUNGTOAR, KUANTAN SINGINGI, RIAU",4,31,183,214
https://kawalpemilu.org#14736,"SERAI WANGI, TALANG MUANDAU, BENGKALIS, RIAU",2,100,51,151
https://kawalpemilu.org#90492,"BANGKO MAS RAYA, BANGKO PUSAKO, ROKAN HILIR, RIAU",3,31,129,160
https://kawalpemilu.org#14450,"SUNGAI BAUNG, RENGAT BARAT, INDRAGIRI HULU, RIAU",3,79,143,222
https://kawalpemilu.org#14231,"KAPAU JAYA, SIAK HULU, KAMPAR, RIAU",7,144,76,220
https://kawalpemilu.org#14586,"PERKEBUNAN SEI LALA, SUNGAI LALA, INDRAGIRI HULU, RIAU",2,128,113,241
https://kawalpemilu.org#14785,"TELUKKIAMBANG, Tempuling, INDRAGIRI HILIR, RIAU",7,23,80,103
https://kawalpemilu.org#90467,"BALAI JAYA KOTA, BAGAN SINEMBAH, ROKAN HILIR, RIAU",8,116,114,230
https://kawalpemilu.org#14780,"SUNGAIBERINGIN, Tembilahan, INDRAGIRI HILIR, RIAU",16,39,171,210
https://kawalpemilu.org#14999,"MAYANG SARI, PANGKALAN LESUNG, PELALAWAN, RIAU",2,78,138,216
https://kawalpemilu.org#15821,"TUAH KARYA, TAMPAN, KOTA PEKANBARU, RIAU",22,20,111,131
https://kawalpemilu.org#15594,"KOTO TUO, KUANTAN TENGAH, KUANTAN SINGINGI, RIAU",2,59,152,211
https://kawalpemilu.org#931197,"PEMATANGKAPAU, TENAYAN RAYA, KOTA PEKANBARU, RIAU",15,41,169,210
https://kawalpemilu.org#75910,"SULEWATANG, POLEWALI, POLEWALI MANDAR, SULAWESI BARAT",7,131,113,244
https://kawalpemilu.org#76055,"SIRINDU, PAMBOANG, MAJENE, SULAWESI BARAT",2,83,69,152
https://kawalpemilu.org#75584,"TARAILU, SAMPAGA, MAMUJU, SULAWESI BARAT",7,181,88,269
https://kawalpemilu.org#76091,"BAURUNG, BANGGAE TIMUR, MAJENE, SULAWESI BARAT",2,100,125,225
https://kawalpemilu.org#75529,"KABULOANG, KALUKKU, MAMUJU, SULAWESI BARAT",8,172,89,261
https://kawalpemilu.org#75691,"SALUDURIAN, MAMBI, MAMASA, SULAWESI BARAT",2,70,82,152
https://kawalpemilu.org#75546,"KONDO BULO, KALUMPANG, MAMUJU, SULAWESI BARAT",1,183,15,198
https://kawalpemilu.org#87604,"RANGAS, BANGGAE, MAJENE, SULAWESI BARAT",4,137,54,191
https://kawalpemilu.org#75476,"LARIANG, TIKKE RAYA, MAMUJU UTARA, SULAWESI BARAT",10,110,52,162
https://kawalpemilu.org#75550,"BABANA, BUDONG-BUDONG, MAMUJU TENGAH, SULAWESI BARAT",4,177,74,251
https://kawalpemilu.org#72373,"BONTOALA, BONTOALA, KOTA MAKASSAR, SULAWESI SELATAN",2,88,104,192
https://kawalpemilu.org#69289,"PARINDING, SESEAN, TORAJA UTARA, SULAWESI SELATAN",4,99,26,125
https://kawalpemilu.org#71052,"SORO, TAKKALALLA, WAJO, SULAWESI SELATAN",1,128,60,188
https://kawalpemilu.org#71495,"KADINGEH, BARAKA, ENREKANG, SULAWESI SELATAN",4,9,144,153
https://kawalpemilu.org#70899,"PALAKKA, BARRU, BARRU, SULAWESI SELATAN",4,91,129,220
https://kawalpemilu.org#931283,"Bitowa, MANGGALA, KOTA MAKASSAR, SULAWESI SELATAN",22,67,113,180
https://kawalpemilu.org#72436,"DAYA, BIRINGKANAYA, KOTA MAKASSAR, SULAWESI SELATAN",24,96,107,203
https://kawalpemilu.org#69458,"BATANGMATA SAPO, BONTOMATENE, KEPULAUAN SELAYAR, SULAWESI SELATAN",4,27,44,71
https://kawalpemilu.org#70341,"UJUNG TANAH, MARE, BONE, SULAWESI SELATAN",7,90,56,146
https://kawalpemilu.org#70473,"CAREBBU, AWANGPONE, BONE, SULAWESI SELATAN",3,154,45,199
https://kawalpemilu.org#70408,"SALEBBA, PONRE, BONE, SULAWESI SELATAN",1,91,157,248
https://kawalpemilu.org#71904,"PAKALA, MENGKENDEK, TANA TORAJA, SULAWESI SELATAN",1,158,36,194
https://kawalpemilu.org#72389,"TALLO, TALLO, KOTA MAKASSAR, SULAWESI SELATAN",2,101,132,233
https://kawalpemilu.org#72546,"TEMMALEBBA, BARA, KOTA PALOPO, SULAWESI SELATAN",17,56,168,224
https://kawalpemilu.org#70326,"WANUAWARU, LIBURENG, BONE, SULAWESI SELATAN",5,92,141,233
https://kawalpemilu.org#70932,"KAMIRI, BALUSU, BARRU, SULAWESI SELATAN",4,137,84,221
https://kawalpemilu.org#71226,"BAULA, TELLU LIMPOE, SIDENRENG RAPPANG, SULAWESI SELATAN",2,140,83,223
https://kawalpemilu.org#70973,"LALABATA RILAU, LALABATA, SOPPENG, SULAWESI SELATAN",8,73,104,177
https://kawalpemilu.org#71638,"TALANG BULAWANG, BAJO, LUWU, SULAWESI SELATAN",3,47,148,195
https://kawalpemilu.org#72480,"UJUNG BARU, SOREANG, KOTA PARE PARE, SULAWESI SELATAN",5,85,124,209
https://kawalpemilu.org#71110,"BELAWA, BELAWA, WAJO, SULAWESI SELATAN",3,86,110,196
https://kawalpemilu.org#69301,"KARRE PENANIAN, NANGGALA, TORAJA UTARA, SULAWESI SELATAN",1,136,12,148
https://kawalpemilu.org#71001,"TOTTONG, DONRI DONRI, SOPPENG, SULAWESI SELATAN",8,149,42,191
https://kawalpemilu.org#70083,"PENCONG, BIRINGBULU, GOWA, SULAWESI SELATAN",8,68,122,190
https://kawalpemilu.org#71414,"TADANGPALIE, CEMPA, PINRANG, SULAWESI SELATAN",9,41,136,177
https://kawalpemilu.org#71249,"SIPODECENG, BARANTI, SIDENRENG RAPPANG, SULAWESI SELATAN",8,88,112,200
https://kawalpemilu.org#71165,"BOLA, BOLA, WAJO, SULAWESI SELATAN",1,124,108,232
https://kawalpemilu.org#71526,"SAWITO, BUNGIN, ENREKANG, SULAWESI SELATAN",4,63,51,114
https://kawalpemilu.org#70666,"BAJI PAMAI, MAROS BARU, MAROS, SULAWESI SELATAN",5,79,127,206
https://kawalpemilu.org#72263,"LAUWO, BURAU, LUWU TIMUR, SULAWESI SELATAN",2,95,138,233
https://kawalpemilu.org#71559,"LUNJEN, BUNTU BATU, ENREKANG, SULAWESI SELATAN",5,10,122,132
https://kawalpemilu.org#71043,"TADANGPALIE, PAMMANA, WAJO, SULAWESI SELATAN",2,107,41,148
https://kawalpemilu.org#70408,"SALEBBA, PONRE, BONE, SULAWESI SELATAN",2,102,154,256
https://kawalpemilu.org#69928,"AENG BATU-BATU, GALESONG UTARA, TAKALAR, SULAWESI SELATAN",16,96,127,223
https://kawalpemilu.org#72428,"BONGAYA, TAMALATE, KOTA MAKASSAR, SULAWESI SELATAN",15,57,92,149
https://kawalpemilu.org#69703,"BANYORANG, TOMPO BULU, BANTAENG, SULAWESI SELATAN",2,32,160,192
https://kawalpemilu.org#71284,"KANYUARA, WT. SIDENRENG, SIDENRENG RAPPANG, SULAWESI SELATAN",8,126,78,204
https://kawalpemilu.org#72028,"BUNGADIDI, TANA LILI, LUWU UTARA, SULAWESI SELATAN",13,42,140,182
https://kawalpemilu.org#71371,"TONYAMANG, PATAMPANUA, PINRANG, SULAWESI SELATAN",15,31,136,167
https://kawalpemilu.org#71042,"WATAMPANUA, PAMMANA, WAJO, SULAWESI SELATAN",4,54,57,111
https://kawalpemilu.org#71858,"BUAKAYU, BONGGAKARADENG, TANA TORAJA, SULAWESI SELATAN",1,120,16,136
https://kawalpemilu.org#70786,"JAGONG, PANGKAJENE, PANGKAJENE DAN KEPULAUAN, SULAWESI SELATAN",6,68,156,224
https://kawalpemilu.org#71506,"TINDALUN, ANGGERAJA, ENREKANG, SULAWESI SELATAN",3,26,143,169
https://kawalpemilu.org#72019,"TAKKALALA, MALANGKE, LUWU UTARA, SULAWESI SELATAN",8,34,122,156
https://kawalpemilu.org#70057,"TAMARUNANG, SOMBA OPU, GOWA, SULAWESI SELATAN",27,70,123,193
https://kawalpemilu.org#72510,"SONGKA, WARA SELATAN, KOTA PALOPO, SULAWESI SELATAN",2,58,160,218
https://kawalpemilu.org#71374,"MALIMPUNG, PATAMPANUA, PINRANG, SULAWESI SELATAN",1,110,108,218
https://kawalpemilu.org#70942,"BARAE, MARIORIWAWO, SOPPENG, SULAWESI SELATAN",1,89,86,175
https://kawalpemilu.org#70171,"ALENANGKA, SINJAI  SELATAN, SINJAI, SULAWESI SELATAN",15,13,122,135
https://kawalpemilu.org#71722,"TUMALE, PONRANG, LUWU, SULAWESI SELATAN",5,231,25,256
https://kawalpemilu.org#70571,"MASUMPU, TANETE RIATTANG, BONE, SULAWESI SELATAN",17,124,90,214
https://kawalpemilu.org#69813,"PAPPALLUANG, BANGKALA BARAT, JENEPONTO, SULAWESI SELATAN",4,137,50,187
https://kawalpemilu.org#69734,"BAJIMINASA, GANTARANG KEKE, BANTAENG, SULAWESI SELATAN",1,43,158,201
https://kawalpemilu.org#70015,"BELAPUNRANGA, PARANGLOE, GOWA, SULAWESI SELATAN",2,101,95,196
https://kawalpemilu.org#70906,"MANGKOSO, SOPPENG RIAJA, BARRU, SULAWESI SELATAN",8,101,90,191
https://kawalpemilu.org#70052,"PANDANG-PANDANG, SOMBA OPU, GOWA, SULAWESI SELATAN",3,66,149,215
https://kawalpemilu.org#72353,"PISANG UTARA, UJUNG PANDANG, KOTA MAKASSAR, SULAWESI SELATAN",6,112,87,199
https://kawalpemilu.org#70723,"LEBBO TENGNGAE, CENRANA, MAROS, SULAWESI SELATAN",1,102,113,215
https://kawalpemilu.org#71464,"PUSERREN, ENREKANG, ENREKANG, SULAWESI SELATAN",1,52,141,193
https://kawalpemilu.org#69746,"BENTENG, BANGKALA, JENEPONTO, SULAWESI SELATAN",5,51,191,242
https://kawalpemilu.org#69855,"UJUNG BULU, RUMBIA, JENEPONTO, SULAWESI SELATAN",8,75,12,87
https://kawalpemilu.org#69931,"TAMASAJU, GALESONG UTARA, TAKALAR, SULAWESI SELATAN",11,97,136,233
https://kawalpemilu.org#71749,"SABE, BELOPA UTARA, LUWU, SULAWESI SELATAN",7,40,158,1
https://kawalpemilu.org#71225,"PAJALELE, TELLU LIMPOE, SIDENRENG RAPPANG, SULAWESI SELATAN",8,86,122,208
https://kawalpemilu.org#71971,"BELAU UTARA, MASANDA, TANA TORAJA, SULAWESI SELATAN",2,138,12,150
https://kawalpemilu.org#87569,"ILAMBE, LAKEA, BUOL, SULAWESI TENGAH",1,139,73,212
https://kawalpemilu.org#68369,"JATIMULYA, TILOAN, BUOL, SULAWESI TENGAH",3,58,78,136
https://kawalpemilu.org#68778,"KASUARI, BOKAN KEPULAUAN, BANGGAI LAUT, SULAWESI TENGAH",3,69,78,147
https://kawalpemilu.org#67874,"MAPANE, POSO PESISIR, POSO, SULAWESI TENGAH",4,74,110,184
https://kawalpemilu.org#68875,"TATABAU, BUKO SELATAN, BANGGAI KEPULAUAN, SULAWESI TENGAH",2,149,38,187
https://kawalpemilu.org#68829,"BADUMPAYAN, BANGGAI TENGAH, BANGGAI LAUT, SULAWESI TENGAH",2,109,76,185
https://kawalpemilu.org#928671,"WAWUJAI, MARAWOLA BARAT, SIGI, SULAWESI TENGAH",2,113,2,115
https://kawalpemilu.org#68969,"ONGKA, ONGKA MALINO, PARIGI MOUTONG, SULAWESI TENGAH",3,71,65,136
https://kawalpemilu.org#67735,"SINDANG BARU, TOILI, BANGGAI, SULAWESI TENGAH",2,169,25,194
https://kawalpemilu.org#69097,"WAKAI, UNA UNA, TOJO UNA-UNA, SULAWESI TENGAH",5,99,69,168
https://kawalpemilu.org#68077,"BOYA, BANAWA, DONGGALA, SULAWESI TENGAH",5,136,67,203
https://kawalpemilu.org#67763,"MALINO, LUWUK TIMUR, BANGGAI, SULAWESI TENGAH",2,182,50,232
https://kawalpemilu.org#68867,"BAKALINGA, BULAGI UTARA, BANGGAI KEPULAUAN, SULAWESI TENGAH",1,107,104,211
https://kawalpemilu.org#67402,"SIDERA, SIGI BIROMARU, SIGI, SULAWESI TENGAH",7,50,83,133
https://kawalpemilu.org#68114,"SIBADO, SIRENJA, DONGGALA, SULAWESI TENGAH",5,62,34,96
https://kawalpemilu.org#68208,"KOMBO, DAMPAL SELATAN, TOLITOLI, SULAWESI TENGAH",3,135,78,213
https://kawalpemilu.org#67770,"KAMI WANGI, TOILI BARAT, BANGGAI, SULAWESI TENGAH",8,175,14,189
https://kawalpemilu.org#68863,"BANGUNEMO, BULAGI UTARA, BANGGAI KEPULAUAN, SULAWESI TENGAH",3,133,44,177
https://kawalpemilu.org#68607,"DONGKALAN, MENUI KEPULAUAN, MOROWALI, SULAWESI TENGAH",2,33,88,121
https://kawalpemilu.org#69143,"LONGGE, AMPANA TETE, TOJO UNA-UNA, SULAWESI TENGAH",1,151,74,225
https://kawalpemilu.org#67771,"SINDANG SARI, TOILI BARAT, BANGGAI, SULAWESI TENGAH",3,130,81,211
https://kawalpemilu.org#85724,"KADODA, TALATAKO, TOJO UNA-UNA, SULAWESI TENGAH",2,125,60,185
https://kawalpemilu.org#68411,"TIMBULON, PALELEH BARAT, BUOL, SULAWESI TENGAH",3,80,113,193
https://kawalpemilu.org#74675,"BATARAGURU, WOLIO, KOTA BAU BAU, SULAWESI TENGGARA",7,55,120,175
https://kawalpemilu.org#73906,"LAKARA, PALANGGA SELATAN, KONAWE SELATAN, SULAWESI TENGGARA",2,135,103,238
https://kawalpemilu.org#74653,"WOWAWANGGU, KADIA, KOTA KENDARI, SULAWESI TENGGARA",8,41,152,193
https://kawalpemilu.org#74041,"LAKOMEA, RAROWATU, BOMBANA, SULAWESI TENGGARA",1,67,120,187
https://kawalpemilu.org#72803,"ASINUA, UNAAHA, KONAWE, SULAWESI TENGGARA",5,24,199,223
https://kawalpemilu.org#74419,"SIMBULA, KATOI, KOLAKA UTARA, SULAWESI TENGGARA",2,38,147,185
https://kawalpemilu.org#73409,"KASIMPA JAYA, TIWORO SELATAN, MUNA BARAT, SULAWESI TENGGARA",2,115,82,197
https://kawalpemilu.org#74116,"BATUAWU, KABAENA SELATAN, BOMBANA, SULAWESI TENGGARA",3,45,121,166
https://kawalpemilu.org#72795,"WANUA HOA, LAMBUYA, KONAWE, SULAWESI TENGGARA",3,34,130,164
https://kawalpemilu.org#74625,"SANUA, KENDARI BARAT, KOTA KENDARI, SULAWESI TENGGARA",13,86,73,159
https://kawalpemilu.org#73522,"TALAGA DUA, TELAGA RAYA, BUTON TENGAH, SULAWESI TENGGARA",1,92,49,141
https://kawalpemilu.org#74675,"BATARAGURU, WOLIO, KOTA BAU BAU, SULAWESI TENGGARA",16,56,120,176
https://kawalpemilu.org#73547,"BATUATAS LIWU, BATU ATAS, BUTON SELATAN, SULAWESI TENGGARA",4,50,43,93
https://kawalpemilu.org#72853,"TOTOMBE JAYA, SAMPARA, KONAWE, SULAWESI TENGGARA",3,44,123,167
https://kawalpemilu.org#89819,"RANTE GOLA, BONEGUNU, BUTON UTARA, SULAWESI TENGGARA",2,74,115,189
https://kawalpemilu.org#74592,"MANDONGA, MANDONGA, KOTA KENDARI, SULAWESI TENGGARA",30,75,196,271
https://kawalpemilu.org#74677,"BATULO, WOLIO, KOTA BAU BAU, SULAWESI TENGGARA",10,93,80,173
https://kawalpemilu.org#72773,"PLASMA JAYA, POLINGGONA, KOLAKA, SULAWESI TENGGARA",3,78,71,149
https://kawalpemilu.org#73072,"MENDIKONU, AMONGGEDO, KONAWE, SULAWESI TENGGARA",1,54,126,180
https://kawalpemilu.org#73534,"MARAWALI, KADATUA, BUTON SELATAN, SULAWESI TENGGARA",1,73,106,179
https://kawalpemilu.org#66899,"SOYOAN, RATATOTOK, MINAHASA TENGGARA, SULAWESI UTARA",1,202,15,217
https://kawalpemilu.org#66862,"WIOI, RATAHAN TIMUR, MINAHASA TENGGARA, SULAWESI UTARA",2,184,11,195
https://kawalpemilu.org#65782,"MOMALIA II, POSIGADAN, BOLAANG MONGONDOW SELATAN, SULAWESI UTARA",3,67,135,202
https://kawalpemilu.org#65981,"WAWALINTOUAN, TONDANO BARAT, MINAHASA, SULAWESI UTARA",7,131,86,217
https://kawalpemilu.org#66971,"BINJEITA, BOLANGITANG TIMUR, BOLAANG MONGONDOW UTARA, SULAWESI UTARA",3,43,139,182
https://kawalpemilu.org#65847,"IMANDI, DUMOGA TIMUR, BOLAANG MONGONDOW, SULAWESI UTARA",5,198,14,212
https://kawalpemilu.org#67219,"BAHU, MALALAYANG, KOTA MANADO, SULAWESI UTARA",25,134,23,157
https://kawalpemilu.org#67343,"WOLOAN TIGA, TOMOHON BARAT, KOTA TOMOHON, SULAWESI UTARA",7,203,13,216
https://kawalpemilu.org#67201,"TELING ATAS, WANEA, KOTA MANADO, SULAWESI UTARA",34,165,22,187
https://kawalpemilu.org#66638,"RUMOONG ATAS, TARERAN, MINAHASA SELATAN, SULAWESI UTARA",4,187,7,194
https://kawalpemilu.org#66743,"AIRMADIDI BAWAH, AIRMADIDI, MINAHASA UTARA, SULAWESI UTARA",6,128,14,142
https://kawalpemilu.org#66995,"OLLOT I, BOLANGITANG BARAT, BOLAANG MONGONDOW UTARA, SULAWESI UTARA",2,90,166,256
https://kawalpemilu.org#65911,"TAPA AOG, LOLAYAN, BOLAANG MONGONDOW, SULAWESI UTARA",3,52,154,206
https://kawalpemilu.org#66765,"KULU, WORI, MINAHASA UTARA, SULAWESI UTARA",1,232,16,248
https://kawalpemilu.org#66824,"MAUMBI, KALAWAT, MINAHASA UTARA, SULAWESI UTARA",9,185,18,203
https://kawalpemilu.org#66429,"PANNULAN, KABARUAN, KEPULAUAN TALAUD, SULAWESI UTARA",2,123,14,137
https://kawalpemilu.org#66175,"TATAARAN I, TONDANO SELATAN, MINAHASA, SULAWESI UTARA",1,251,25,276
https://kawalpemilu.org#66611,"SAPA BARAT, TENGA, MINAHASA SELATAN, SULAWESI UTARA",2,252,8,260
https://kawalpemilu.org#65885,"MONGKOINIT, LOLAK, BOLAANG MONGONDOW, SULAWESI UTARA",2,105,118,223
https://kawalpemilu.org#66829,"WATUTUMOU DUA, KALAWAT, MINAHASA UTARA, SULAWESI UTARA",8,224,16,240
https://kawalpemilu.org#13824,"BATANG KABUNG GANTING, KOTO TANGAH, KOTA PADANG, SUMATERA BARAT",17,18,190,208
https://kawalpemilu.org#13688,"AUA KUNIANG, PASAMAN, PASAMAN BARAT, SUMATERA BARAT",61,25,119,144
https://kawalpemilu.org#12987,"PADANG XI PUNGGASAN, LINGGO SARI BAGANTI, PESISIR SELATAN, SUMATERA BARAT",4,6,138,144
https://kawalpemilu.org#13466,"KOTO LAMO, KAPUR IX, LIMA PULUH KOTA, SUMATERA BARAT",7,38,144,182
https://kawalpemilu.org#13892,"GUGUK MALINTANG, PADANG PANJANG TIMUR, KOTA PADANG PANJANG, SUMATERA BARAT",19,33,157,190
https://kawalpemilu.org#13585,"KATUREI, SIBERUT BARAT DAYA, KEPULAUAN MENTAWAI, SUMATERA BARAT",2,125,31,156
https://kawalpemilu.org#13280,"KURANJI HULU, SUNGAI GARINGGING, PADANG PARIAMAN, SUMATERA BARAT",22,19,116,135
https://kawalpemilu.org#13695,"KINALI, KINALI, PASAMAN BARAT, SUMATERA BARAT",45,106,90,196
https://kawalpemilu.org#13394,"SUNGAI PUA, SUNGAI PUA, AGAM, SUMATERA BARAT",33,17,194,211
https://kawalpemilu.org#13463,"MUARO PAITI, KAPUR IX, LIMA PULUH KOTA, SUMATERA BARAT",8,8,164,172
https://kawalpemilu.org#13766,"TANAH SIRAH PIAI NAN XX, LUBUK BEGALUNG, KOTA PADANG, SUMATERA BARAT",14,14,155,169
https://kawalpemilu.org#84367,"CEROCOK ANAU AMPANG PULAI, KOTO XI TARUSAN, PESISIR SELATAN, SUMATERA BARAT",3,52,137,189
https://kawalpemilu.org#13542,"ALAHAN MATI, SIMPANG ALAHAN MATI, PASAMAN, SUMATERA BARAT",14,3,171,174
https://kawalpemilu.org#13319,"TIKU SELATAN, TANJUNG MUTIARA, AGAM, SUMATERA BARAT",8,8,193,201
https://kawalpemilu.org#13493,"TALANG MAUR, MUNGKA, LIMA PULUH KOTA, SUMATERA BARAT",10,14,143,157
https://kawalpemilu.org#13016,"SUNGAI NANAM, LEMBAH GUMANTI, SOLOK, SUMATERA BARAT",58,4,148,152
https://kawalpemilu.org#84355,"KOTO BARU KOTO BERAPAK, BAYANG, PESISIR SELATAN, SUMATERA BARAT",5,7,157,164
https://kawalpemilu.org#13283,"KURANJI HILIR, SUNGAI LIMAU, PADANG PARIAMAN, SUMATERA BARAT",6,19,152,171
https://kawalpemilu.org#13057,"SELAYO, KUBUNG, SOLOK, SUMATERA BARAT",28,11,113,124
https://kawalpemilu.org#13451,"GURUN, HARAU, LIMA PULUH KOTA, SUMATERA BARAT",1,20,197,217
https://kawalpemilu.org#13804,"KURANJI, KURANJI, KOTA PADANG, SUMATERA BARAT",12,18,211,229
https://kawalpemilu.org#13203,"TIGO JANGKO, LINTAU BUO, TANAH DATAR, SUMATERA BARAT",8,16,95,111
https://kawalpemilu.org#13523,"PANTI, PANTI, PASAMAN, SUMATERA BARAT",6,58,148,206
https://kawalpemilu.org#13298,"MALAI V SUKU, BATANG GASAN, PADANG PARIAMAN, SUMATERA BARAT",4,18,146,164
https://kawalpemilu.org#931239,"Seulayat Ulakan, ULAKAN TAPAKIH, PADANG PARIAMAN, SUMATERA BARAT",2,7,133,140
https://kawalpemilu.org#13097,"SIMPANG TJ. NAN IV, DANAU KEMBAR, SOLOK, SUMATERA BARAT",15,7,172,179
https://kawalpemilu.org#13955,"IBUAH, PAYAKUMBUH BARAT, KOTA PAYAKUMBUH, SUMATERA BARAT",7,36,209,245
https://kawalpemilu.org#13238,"PADANG GANTING, PADANG GANTING, TANAH DATAR, SUMATERA BARAT",15,37,157,194
https://kawalpemilu.org#13804,"KURANJI, KURANJI, KOTA PADANG, SUMATERA BARAT",80,30,223,253
https://kawalpemilu.org#13772,"BANUARAN NAN XX, LUBUK BEGALUNG, KOTA PADANG, SUMATERA BARAT",16,42,135,177
https://kawalpemilu.org#87713,"PONDOK PARIAN LUNANG, LUNANG, PESISIR SELATAN, SUMATERA BARAT",4,34,129,163
https://kawalpemilu.org#13080,"BUKIT KANDUANG, X KOTO DIATAS, SOLOK, SUMATERA BARAT",8,3,81,84
https://kawalpemilu.org#13765,"KAMPUNG BARU NAN XX, LUBUK BEGALUNG, KOTA PADANG, SUMATERA BARAT",6,26,194,220
https://kawalpemilu.org#84348,"API-API PASAR BARU, BAYANG, PESISIR SELATAN, SUMATERA BARAT",3,8,179,187
https://kawalpemilu.org#13334,"DUO KOTO, TANJUNG RAYA, AGAM, SUMATERA BARAT",5,20,108,128
https://kawalpemilu.org#12924,"MUARO SAKAI INDERAPURA, PANCUNG SOAL, PESISIR SELATAN, SUMATERA BARAT",8,18,78,96
https://kawalpemilu.org#13925,"AUR KUNING, AUR BIRUGO TIGO BALEH, KOTA BUKITTINGGI, SUMATERA BARAT",9,8,151,159
https://kawalpemilu.org#13303,"GUNUNG PADANG ALAI, V KOTO TIMUR, PADANG PARIAMAN, SUMATERA BARAT",15,20,123,143
https://kawalpemilu.org#13206,"SUNGAI PATAI, SUNGAYANG, TANAH DATAR, SUMATERA BARAT",7,9,98,107
https://kawalpemilu.org#13693,"SINURUIK, TALAMAU, PASAMAN BARAT, SUMATERA BARAT",14,13,59,72
https://kawalpemilu.org#13645,"PULAKEK KOTO BARU, SUNGAI PAGU, SOLOK SELATAN, SUMATERA BARAT",3,15,129,144
https://kawalpemilu.org#13032,"TALANG, GUNUNG TALANG, SOLOK, SUMATERA BARAT",14,17,203,220
https://kawalpemilu.org#20586,"20 ILIR II, KEMUNING, KOTA PALEMBANG, SUMATERA SELATAN",19,117,148,265
https://kawalpemilu.org#17998,"TALANG BULANG, TALANG UBI, PENUKAL ABAB LEMATANG ILIR, SUMATERA SELATAN",7,90,90,180
https://kawalpemilu.org#18834,"PURWODADI, PURWODADI, MUSI RAWAS, SUMATERA SELATAN",2,105,166,271
https://kawalpemilu.org#20624,"TALANG PUTRI, PLAJU, KOTA PALEMBANG, SUMATERA SELATAN",22,84,141,225
https://kawalpemilu.org#929006,"TALANG UBI, MEGANG SAKTI, MUSI RAWAS, SUMATERA SELATAN",3,68,132,200
https://kawalpemilu.org#20772,"TUGU KECIL, PRABUMULIH TIMUR, KOTA PRABUMULIH, SUMATERA SELATAN",6,53,98,151
https://kawalpemilu.org#17776,"JEJAWI, JEJAWI, OGAN KOMERING ILIR, SUMATERA SELATAN",10,17,149,166
https://kawalpemilu.org#19872,"ULAK AGUNG ULU, MUARA DUA KISAM, OGAN KOMERING ULU SELATAN, SUMATERA SELATAN",2,104,88,192
https://kawalpemilu.org#19188,"NUSA MAKMUR, AIR KUMBANG, BANYUASIN, SUMATERA SELATAN",3,169,62,231
https://kawalpemilu.org#20656,"GUNUNG DEMPO, PAGAR ALAM SELATAN, KOTA PAGAR ALAM, SUMATERA SELATAN",1,43,110,153
https://kawalpemilu.org#18866,"KARANG JAYA, KARANG JAYA, MUSI RAWAS UTARA, SUMATERA SELATAN",11,55,116,171
https://kawalpemilu.org#20646,"BANGUN REJO, PAGAR ALAM UTARA, KOTA PAGAR ALAM, SUMATERA SELATAN",14,72,211,283
https://kawalpemilu.org#20281,"SERIJABO, SUNGAI PINANG, OGAN ILIR, SUMATERA SELATAN",3,75,155,230
https://kawalpemilu.org#17480,"BATURAJA LAMA, BATURAJA TIMUR, OGAN KOMERING ULU, SUMATERA SELATAN",7,52,74,126
https://kawalpemilu.org#20595,"SEI SELAYUR, KALIDONI, KOTA PALEMBANG, SUMATERA SELATAN",15,43,167,210
https://kawalpemilu.org#20588,"SEKIP JAYA, KEMUNING, KOTA PALEMBANG, SUMATERA SELATAN",43,134,40,174
https://kawalpemilu.org#19901,"MADURA, BUAY SANDANG AJI, OGAN KOMERING ULU SELATAN, SUMATERA SELATAN",1,96,148,244
https://kawalpemilu.org#17753,"SUNGAI MENANG, SUNGAI MENANG, OGAN KOMERING ILIR, SUMATERA SELATAN",14,93,94,187
https://kawalpemilu.org#17536,"BANDAR JAYA, LENGKITI, OGAN KOMERING ULU, SUMATERA SELATAN",2,39,143,182
https://kawalpemilu.org#19794,"PURWODADI, BELITANG MULYA, OGAN KOMERING ULU TIMUR, SUMATERA SELATAN",10,47,43,90
https://kawalpemilu.org#17621,"KEMBANG JAJAR, MESUJI, OGAN KOMERING ILIR, SUMATERA SELATAN",3,65,178,243
https://kawalpemilu.org#20591,"TALANG AMAN, KEMUNING, KOTA PALEMBANG, SUMATERA SELATAN",27,56,125,181
https://kawalpemilu.org#18145,"TANJUNG RAYA, RAMBANG, MUARA ENIM, SUMATERA SELATAN",4,57,192,249
https://kawalpemilu.org#19627,"TARAMAN JAYA, SEMENDAWAI SUKU III, OGAN KOMERING ULU TIMUR, SUMATERA SELATAN",5,102,76,178
https://kawalpemilu.org#18283,"BANGKE, KOTA AGUNG, LAHAT, SUMATERA SELATAN",1,67,122,189
https://kawalpemilu.org#20546,"BUKIT BARU, ILIR BARAT I, KOTA PALEMBANG, SUMATERA SELATAN",41,75,125,200
https://kawalpemilu.org#19393,"SUKAJADI, TALANG KELAPA, BANYUASIN, SUMATERA SELATAN",49,52,158,210
https://kawalpemilu.org#20588,"SEKIP JAYA, KEMUNING, KOTA PALEMBANG, SUMATERA SELATAN",29,45,85,130
https://kawalpemilu.org#90638,"KARANG ASAM, TUNGKAL ILIR, BANYUASIN, SUMATERA SELATAN",1,189,25,214
https://kawalpemilu.org#17579,"PULAU GEMANTUNG, TANJUNG LUBUK, OGAN KOMERING ILIR, SUMATERA SELATAN",2,25,156,181
https://kawalpemilu.org#20600,"22 ILIR, BUKIT KECIL, KOTA PALEMBANG, SUMATERA SELATAN",6,46,145,191
https://kawalpemilu.org#18040,"TEGAL REJO, LAWANG KIDUL, MUARA ENIM, SUMATERA SELATAN",22,119,118,237
https://kawalpemilu.org#17688,"SIMPANG TIGA SAKTI, TULUNG SELAPAN, OGAN KOMERING ILIR, SUMATERA SELATAN",5,110,10,120
https://kawalpemilu.org#19602,"JAYA BAKTI, MADANG SUKU I, OGAN KOMERING ULU TIMUR, SUMATERA SELATAN",2,32,98,130
https://kawalpemilu.org#20722,"DEMPO, LUBUK LINGGAU TIMUR II, KOTA LUBUKLINGGAU, SUMATERA SELATAN",3,92,119,211
https://kawalpemilu.org#19742,"MULIA JAYA, SEMENDAWAI TIMUR, OGAN KOMERING ULU TIMUR, SUMATERA SELATAN",1,116,67,183
https://kawalpemilu.org#18763,"MARGOYOSO, JAYALOKA, MUSI RAWAS, SUMATERA SELATAN",1,123,37,160
https://kawalpemilu.org#19669,"DADI REJO, BELITANG III, OGAN KOMERING ULU TIMUR, SUMATERA SELATAN",1,71,159,230
https://kawalpemilu.org#18014,"GAUNG TELANG, GELUMBANG, MUARA ENIM, SUMATERA SELATAN",4,54,144,198
https://kawalpemilu.org#17550,"TUALANG, LENGKITI, OGAN KOMERING ULU, SUMATERA SELATAN",3,34,138,172
https://kawalpemilu.org#19024,"KEBAN I, SANGA DESA, MUSI BANYUASIN, SUMATERA SELATAN",8,21,23,44
https://kawalpemilu.org#17862,"MUKTI SARI, LEMPUING JAYA, OGAN KOMERING ILIR, SUMATERA SELATAN",4,40,92,132
https://kawalpemilu.org#19863,"BAYUR TENGAH, MUARA DUA KISAM, OGAN KOMERING ULU SELATAN, SUMATERA SELATAN",1,53,83,136
https://kawalpemilu.org#19693,"SUMBER MULYO, BUAY MADANG TIMUR, OGAN KOMERING ULU TIMUR, SUMATERA SELATAN",7,102,122,224
https://kawalpemilu.org#20610,"PULOKERTO, GANDUS, KOTA PALEMBANG, SUMATERA SELATAN",35,83,95,178
https://kawalpemilu.org#18121,"LECAH, LUBAI ULU, MUARA ENIM, SUMATERA SELATAN",4,127,73,200
https://kawalpemilu.org#20660,"BUMI AGUNG, DEMPO UTARA, KOTA PAGAR ALAM, SUMATERA SELATAN",2,64,115,179
https://kawalpemilu.org#19541,"SIDO GEDE, BELITANG, OGAN KOMERING ULU TIMUR, SUMATERA SELATAN",8,94,81,175
https://kawalpemilu.org#18046,"BABATAN, SEMENDE DARAT LAUT, MUARA ENIM, SUMATERA SELATAN",4,100,181,281
https://kawalpemilu.org#17629,"PAKU, KAYU AGUNG, OGAN KOMERING ILIR, SUMATERA SELATAN",5,75,150,225
https://kawalpemilu.org#20554,"20 ILIR III, ILIR TIMUR I, KOTA PALEMBANG, SUMATERA SELATAN",28,96,102,198
https://kawalpemilu.org#20602,"24 ILIR, BUKIT KECIL, KOTA PALEMBANG, SUMATERA SELATAN",34,66,114,180
https://kawalpemilu.org#18403,"TONGKOK, PAJAR BULAN, LAHAT, SUMATERA SELATAN",2,72,141,213
https://kawalpemilu.org#18866,"KARANG JAYA, KARANG JAYA, MUSI RAWAS UTARA, SUMATERA SELATAN",14,41,162,203
https://kawalpemilu.org#17839,"EMBACANG, MESUJI RAYA, OGAN KOMERING ILIR, SUMATERA SELATAN",3,62,186,248
https://kawalpemilu.org#18963,"LAIS, LAIS, MUSI BANYUASIN, SUMATERA SELATAN",5,65,166,231
https://kawalpemilu.org#20070,"SUKARENA, TIGA DIHAJI, OGAN KOMERING ULU SELATAN, SUMATERA SELATAN",5,66,104,170
https://kawalpemilu.org#19295,"RIMBA ASAM, BETUNG, BANYUASIN, SUMATERA SELATAN",23,57,147,204
https://kawalpemilu.org#91968,"AGUNG LAWANGAN, DEMPO UTARA, KOTA PAGAR ALAM, SUMATERA SELATAN",1,106,54,160
https://kawalpemilu.org#18777,"BUMI AGUNG, MUARA BELITI, MUSI RAWAS, SUMATERA SELATAN",4,20,135,155
https://kawalpemilu.org#18779,"TANAH PERIUK I, MUARA BELITI, MUSI RAWAS, SUMATERA SELATAN",2,36,174,210
https://kawalpemilu.org#19566,"NEGERI PAKUAN, BUAY PEMUKA PELIUNG, OGAN KOMERING ULU TIMUR, SUMATERA SELATAN",5,116,89,205
https://kawalpemilu.org#19238,"SIDANG MAS, BANYUASIN III, BANYUASIN, SUMATERA SELATAN",3,29,178,207
https://kawalpemilu.org#8044,"LEWA LEWA, MA'U, NIAS, SUMATERA UTARA",3,120,2,122
https://kawalpemilu.org#8715,"TANJUNG MORAWA B, TANJUNG MORAWA, DELI SERDANG, SUMATERA UTARA",33,73,73,146
https://kawalpemilu.org#10248,"IPAR BONDAR, PANYABUNGAN KOTA, MANDAILING NATAL, SUMATERA UTARA",5,7,173,180
https://kawalpemilu.org#11609,"PAYA PASIR, TEBING SYAHBANDAR, SERDANG BEDAGAI, SUMATERA UTARA",2,40,149,189
https://kawalpemilu.org#7577,"BAHAL BATU III, SIBORONG-BORONG, TAPANULI UTARA, SUMATERA UTARA",3,161,2,163
https://kawalpemilu.org#12052,"SETIA, BINJAI KOTA, KOTA BINJAI, SUMATERA UTARA",11,144,79,223
https://kawalpemilu.org#9002,"PAYA BAKUNG, HAMPARAN PERAK, DELI SERDANG, SUMATERA UTARA",30,96,133,229
https://kawalpemilu.org#10037,"AEK BOLON JULU, BALIGE, TOBA SAMOSIR, SUMATERA UTARA",2,89,2,91
https://kawalpemilu.org#12295,"SIMATANIARI, DOLOK, PADANG LAWAS UTARA, SUMATERA UTARA",2,27,85,112
https://kawalpemilu.org#8970,"KEDAI DURIAN, DELI TUA, DELI SERDANG, SUMATERA UTARA",15,73,80,153
https://kawalpemilu.org#7175,"SIHARE'O I TABALOHO, GUNUNGSITOLI SELATAN, KOTA GUNUNGSITOLI, SUMATERA UTARA",3,101,2,103
https://kawalpemilu.org#10071,"OMPU RAJA HUTAPEA, LAGUBOTI, TOBA SAMOSIR, SUMATERA UTARA",3,123,1,124
https://kawalpemilu.org#9430,"DOLOK MARAWA, SILOU KAHEAN, SIMALUNGUN, SUMATERA UTARA",1,116,16,132
https://kawalpemilu.org#8207,"GOHOR LAMA, WAMPU, LANGKAT, SUMATERA UTARA",2,119,103,222
https://kawalpemilu.org#11815,"HARJOSARI II, MEDAN AMPLAS, KOTA MEDAN, SUMATERA UTARA",11,94,45,139
https://kawalpemilu.org#8974,"SEI SEMAYANG, SUNGGAL, DELI SERDANG, SUMATERA UTARA",70,103,13,116
https://kawalpemilu.org#8310,"SECURAI SELATAN, BABALAN, LANGKAT, SUMATERA UTARA",9,74,118,192
https://kawalpemilu.org#8959,"PATUMBAK  I, PATUMBAK, DELI SERDANG, SUMATERA UTARA",9,76,117,193
https://kawalpemilu.org#12077,"PUJIDADI, BINJAI SELATAN, KOTA BINJAI, SUMATERA UTARA",6,54,177,231
https://kawalpemilu.org#12022,"PEMATANG PASIR, TELUK NIBUNG, KOTA TANJUNG BALAI, SUMATERA UTARA",12,16,198,214
https://kawalpemilu.org#11499,"SIMALAS, SIPISPIS, SERDANG BEDAGAI, SUMATERA UTARA",1,64,142,206
https://kawalpemilu.org#7426,"LUMUT, LUMUT, TAPANULI TENGAH, SUMATERA UTARA",1,83,165,248
https://kawalpemilu.org#12107,"DURIAN, BAJENIS, KOTA TEBING TINGGI, SUMATERA UTARA",16,62,131,193
https://kawalpemilu.org#11378,"KOTA PARI, PANTAI CERMIN, SERDANG BEDAGAI, SUMATERA UTARA",15,84,119,203
https://kawalpemilu.org#9428,"BANDAR MARUHUR, SILOU KAHEAN, SIMALUNGUN, SUMATERA UTARA",3,202,44,246
https://kawalpemilu.org#11972,"SIMARIMBUN, SIANTAR MARIMBUN, KOTA PEMATANGSIANTAR, SUMATERA UTARA",3,125,5,130
https://kawalpemilu.org#9826,"WONOSARI, PANAI HILIR, LABUHANBATU, SUMATERA UTARA",4,62,0,62
https://kawalpemilu.org#9729,"PADANG MATINGGI, RANTAU UTARA, LABUHANBATU, SUMATERA UTARA",3,33,221,254
https://kawalpemilu.org#10468,"HADANGKAHAN, BATANG NATAL, MANDAILING NATAL, SUMATERA UTARA",1,21,242,263
https://kawalpemilu.org#7702,"SIUHOM, ANGKOLA BARAT, TAPANULI SELATAN, SUMATERA UTARA",2,29,119,148
https://kawalpemilu.org#9329,"PULO BAYU, HUTA BAYU RAJA, SIMALUNGUN, SUMATERA UTARA",1,212,4,216
https://kawalpemilu.org#7879,"GUNUNG BINANGA, MARANCAR, TAPANULI SELATAN, SUMATERA UTARA",1,82,142,224
https://kawalpemilu.org#6763,"AEK BATU, TORGAMBA, LABUHANBATU SELATAN, SUMATERA UTARA",19,71,67,138
https://kawalpemilu.org#11777,"BINJAI, MEDAN DENAI, KOTA MEDAN, SUMATERA UTARA",133,6,102,108
https://kawalpemilu.org#10211,"LINTONG NIHUTA, TAMPAHAN, TOBA SAMOSIR, SUMATERA UTARA",1,203,7,210
https://kawalpemilu.org#9854,"PAGAGAN JULU VI, SUMBUL, DAIRI, SUMATERA UTARA",3,149,12,161
https://kawalpemilu.org#11805,"BELAWAN II, MEDAN BELAWAN, KOTA MEDAN, SUMATERA UTARA",14,78,108,186
https://kawalpemilu.org#9471,"UJUNG PADANG, UJUNG PADANG, SIMALUNGUN, SUMATERA UTARA",14,137,67,204
https://kawalpemilu.org#12022,"PEMATANG PASIR, TELUK NIBUNG, KOTA TANJUNG BALAI, SUMATERA UTARA",22,20,134,154
https://kawalpemilu.org#8732,"BATU MBELIN, SIBOLANGIT, DELI SERDANG, SUMATERA UTARA",3,138,10,148
https://kawalpemilu.org#7502,"SIMANUNGKALIT, SIPOHOLON, TAPANULI UTARA, SUMATERA UTARA",2,151,5,156
https://kawalpemilu.org#11518,"BANTAN, DOLOK MASIHUL, SERDANG BEDAGAI, SUMATERA UTARA",13,84,70,154
https://kawalpemilu.org#6818,"TELUK BINJAI, KUALUH HILIR, LABUHANBATU UTARA, SUMATERA UTARA",2,36,112,148
https://kawalpemilu.org#8418,"SAMURA, KABANJAHE, KARO, SUMATERA UTARA",6,149,69,218
https://kawalpemilu.org#9054,"PALUH KEMIRI, LUBUK PAKAM, DELI SERDANG, SUMATERA UTARA",12,46,116,162
https://kawalpemilu.org#8380,"SUKA PULUNG, SIRAPIT, LANGKAT, SUMATERA UTARA",1,151,47,198
https://kawalpemilu.org#9669,"SEI PASIR, SEI KEPAYANG TIMUR, ASAHAN, SUMATERA UTARA",1,39,186,225
https://kawalpemilu.org#10510,"BANJAR AUR, BATAHAN, MANDAILING NATAL, SUMATERA UTARA",1,23,178,201
https://kawalpemilu.org#7469,"HUTATORUAN I, TARUTUNG, TAPANULI UTARA, SUMATERA UTARA",1,211,3,214
https://kawalpemilu.org#9013,"HELVETIA, LABUHAN DELI, DELI SERDANG, SUMATERA UTARA",39,41,91,132
https://kawalpemilu.org#8676,"TIGA NDERKET, TIGANDERKET, KARO, SUMATERA UTARA",4,198,32,230
https://kawalpemilu.org#9602,"RAWA SARI, AEK KUASAN, ASAHAN, SUMATERA UTARA",9,137,91,228
https://kawalpemilu.org#11352,"PARDOMUAN I, PANGURURAN, SAMOSIR, SUMATERA UTARA",6,213,6,219
https://kawalpemilu.org#11784,"SEI AGUL, MEDAN BARAT, KOTA MEDAN, SUMATERA UTARA",52,26,167,193
https://kawalpemilu.org#8922,"JAHARUN A, GALANG, DELI SERDANG, SUMATERA UTARA",11,62,88,150
https://kawalpemilu.org#9267,"BUTTU BAYU, HATONDUHAN, SIMALUNGUN, SUMATERA UTARA",1,208,36,244
https://kawalpemilu.org#6802,"SUKARAME, KUALUH HULU, LABUHANBATU UTARA, SUMATERA UTARA",1,138,39,177
https://kawalpemilu.org#11701,"PULAUSEJUK, LIMA PULUH, BATU BARA, SUMATERA UTARA",4,58,86,144
https://kawalpemilu.org#10019,"SITINJO II, SITINJO, DAIRI, SUMATERA UTARA",10,115,26,141
https://kawalpemilu.org#11856,"TEMBUNG, MEDAN TEMBUNG, KOTA MEDAN, SUMATERA UTARA",9,24,208,232
https://kawalpemilu.org#9159,"GAJING JAYA, GUNUNG MALIGAS, SIMALUNGUN, SUMATERA UTARA",6,57,128,8
https://kawalpemilu.org#11847,"BESAR, MEDAN LABUHAN, KOTA MEDAN, SUMATERA UTARA",76,113,58,171
https://kawalpemilu.org#10096,"LUMBAN PEA, HABINSARAN, TOBA SAMOSIR, SUMATERA UTARA",1,187,4,191
https://kawalpemilu.org#8417,"KETAREN, KABANJAHE, KARO, SUMATERA UTARA",18,147,65,212
https://kawalpemilu.org#11899,"SIDODADI, MEDAN TIMUR, KOTA MEDAN, SUMATERA UTARA",15,180,19,199
https://kawalpemilu.org#8417,"KETAREN, KABANJAHE, KARO, SUMATERA UTARA",15,232,23,255
https://kawalpemilu.org#11785,"KARANG BEROMBAK, MEDAN BARAT, KOTA MEDAN, SUMATERA UTARA",19,96,141,237
https://kawalpemilu.org#11918,"KEBUN SAYUR, SIANTAR TIMUR, KOTA PEMATANGSIANTAR, SUMATERA UTARA",10,165,4,169
https://kawalpemilu.org#8577,"BULUH PANCUR, LAUBALENG, KARO, SUMATERA UTARA",1,159,11,170
https://kawalpemilu.org#8828,"JABA, NAMORAMBE, DELI SERDANG, SUMATERA UTARA",2,192,25,217
https://kawalpemilu.org#11904,"PULO BRAYAN DARAT II, MEDAN TIMUR, KOTA MEDAN, SUMATERA UTARA",23,103,135,238
https://kawalpemilu.org#11428,"BOGAK BESAR, TELUK MENGKUDU, SERDANG BEDAGAI, SUMATERA UTARA",8,58,71,129
https://kawalpemilu.org#11312,"SIMBOLON PURBA, PALIPI, SAMOSIR, SUMATERA UTARA",5,236,3,239
https://kawalpemilu.org#9024,"PERCUT, PERCUT SEI TUAN, DELI SERDANG, SUMATERA UTARA",31,77,52,129
https://kawalpemilu.org#8370,"ALUR GADUNG, SAWIT SEBERANG, LANGKAT, SUMATERA UTARA",5,61,98,159
https://kawalpemilu.org#7652,"RAHUT BOSI, PANGARIBUAN, TAPANULI UTARA, SUMATERA UTARA",1,101,5,106
https://kawalpemilu.org#11597,"GEMPOLAN, SEI BAMBAN, SERDANG BEDAGAI, SUMATERA UTARA",2,166,3,169
https://kawalpemilu.org#91612,"MEKAR SARI, PULAU RAKYAT, ASAHAN, SUMATERA UTARA",8,52,134,186
https://kawalpemilu.org#89945,"PERBATASAN, LINGGA BAYU, MANDAILING NATAL, SUMATERA UTARA",1,42,137,179
https://kawalpemilu.org#7968,"TUHEGAFOA II, HILIDUHO, NIAS, SUMATERA UTARA",1,145,9,154
https://kawalpemilu.org#12074,"BINJAI ESTATE, BINJAI SELATAN, KOTA BINJAI, SUMATERA UTARA",23,90,135,225
https://kawalpemilu.org#9247,"TANJUNG PASIR, TANAH JAWA, SIMALUNGUN, SUMATERA UTARA",10,70,12,82
https://kawalpemilu.org#9822,"SEI SANGGUL, PANAI HILIR, LABUHANBATU, SUMATERA UTARA",5,55,186,241
https://kawalpemilu.org#11683,"BULAN BULAN, LIMA PULUH, BATU BARA, SUMATERA UTARA",6,122,52,174
https://kawalpemilu.org#11841,"TERJUN, MEDAN MARELAN, KOTA MEDAN, SUMATERA UTARA",61,74,119,193
https://kawalpemilu.org#11231,"PAKKAT HAUAGONG, PAKKAT, HUMBANG HASUNDUTAN, SUMATERA UTARA",6,159,12,171
https://kawalpemilu.org#11919,"TOMUAN, SIANTAR TIMUR, KOTA PEMATANGSIANTAR, SUMATERA UTARA",6,90,131,221
https://kawalpemilu.org#8413,"GUNG NEGERI, KABANJAHE, KARO, SUMATERA UTARA",26,133,31,164
https://kawalpemilu.org#12029,"SIJAMBI, DATUK BANDAR, KOTA TANJUNG BALAI, SUMATERA UTARA",19,203,53,256
https://kawalpemilu.org#9750,"SIBARGOT, BILAH BARAT, LABUHANBATU, SUMATERA UTARA",2,8,210,218
https://kawalpemilu.org#11835,"PANGKALAN MANSUR, MEDAN JOHOR, KOTA MEDAN, SUMATERA UTARA",5,36,117,153
https://kawalpemilu.org#9070,"JATI REJO, PAGAR MERBAU, DELI SERDANG, SUMATERA UTARA",5,95,112,207
https://kawalpemilu.org#8235,"PERKOTAAN, SECANGGANG, LANGKAT, SUMATERA UTARA",4,84,119,203
https://kawalpemilu.org#8979,"PORWODADI, SUNGGAL, DELI SERDANG, SUMATERA UTARA",3,97,87,184
https://kawalpemilu.org#11787,"TITIPAPAN, MEDAN DELI, KOTA MEDAN, SUMATERA UTARA",4,41,126,167
https://kawalpemilu.org#11771,"SEI SIKAMBING C II, MEDAN HELVETIA, KOTA MEDAN, SUMATERA UTARA",7,70,135,205
https://kawalpemilu.org#8236,"KWALA BESAR, SECANGGANG, LANGKAT, SUMATERA UTARA",4,113,78,191
https://kawalpemilu.org#9394,"TIMBAAN, BANDAR, SIMALUNGUN, SUMATERA UTARA",1,53,184,237
https://kawalpemilu.org#8177,"PEKAN SELESAI, SELESAI, LANGKAT, SUMATERA UTARA",23,60,158,218
https://kawalpemilu.org#9812,"SEI MERDEKA, PANAI TENGAH, LABUHANBATU, SUMATERA UTARA",4,38,140,178
https://kawalpemilu.org#12187,"MANUNGGANG JULU, PADANG SIDEMPUAN TENGGARA, KOTA PADANG SIDEMPUAN, SUMATERA UTARA",2,8,182,190
https://kawalpemilu.org#11126,"MARBUN TONGA MARBUN DOLOK, BAKTIRAJA, HUMBANG HASUNDUTAN, SUMATERA UTARA",4,129,0,129
https://kawalpemilu.org#8161,"PURSOBINANGUN, SEI BINGEI, LANGKAT, SUMATERA UTARA",3,196,24,220
https://kawalpemilu.org#10072,"GASARIBU, LAGUBOTI, TOBA SAMOSIR, SUMATERA UTARA",1,113,0,113
https://kawalpemilu.org#7401,"SITARDAS, BADIRI, TAPANULI TENGAH, SUMATERA UTARA",5,222,7,229
