Link KawalPemilu,Nama Kelurahan,Nomor TPS,Suara 01,Suara 02,Suara Sah
https://kawalpemilu.org#6532,"PAYA PUNTEUET, MUARA DUA, KOTA LHOKSEUMAWE, ACEH",3,11,210,221
https://kawalpemilu.org#3635,"BIE, SYAMTALIRA BAYU, ACEH UTARA, ACEH",18,10,185,195
https://kawalpemilu.org#1532,"PASI JEUMPA, KAWAY XVI, ACEH BARAT, ACEH",1,10,125,135
https://kawalpemilu.org#4118,"PANTON LAWE, SALANG, SIMEULUE, ACEH",1,104,151,255
https://kawalpemilu.org#3846,"MEUNASAH MEUCAT, NISAM, ACEH UTARA, ACEH",48,11,183,194
https://kawalpemilu.org#5583,"BABAH LUENG, TRIPA MAKMUR, NAGAN RAYA, ACEH",2,7,122,129
https://kawalpemilu.org#5703,"MESJID, MANYAK PAYED, ACEH TAMIANG, ACEH",1,30,150,180
https://kawalpemilu.org#2794,"KUMBANG GOGO, PADANG TIJI, PIDIE, ACEH",1,28,152,180
https://kawalpemilu.org#4243,"LIPAT KAJANG, SIMPANG KANAN, ACEH SINGKIL, ACEH",4,2,227,229
https://kawalpemilu.org#6534,"MEUNASAH MANYANG, MUARA DUA, KOTA LHOKSEUMAWE, ACEH",2,14,211,225
https://kawalpemilu.org#929323,"DASAN RAJA, PENANGGALAN, KOTA SUBULUSSALAM, ACEH",1,35,161,196
https://kawalpemilu.org#414,"TANOH MEGAKHE, BADAR, ACEH TENGGARA, ACEH",2,48,92,140
https://kawalpemilu.org#990,"PAYA DEMAM SA, PANTE BIDARI, ACEH TIMUR, ACEH",6,9,120,129
https://kawalpemilu.org#6583,"BATUPHAT TIMUR, MUARA SATU, KOTA LHOKSEUMAWE, ACEH",7,26,170,196
https://kawalpemilu.org#3750,"TEUPIN GAJAH, TANAH JAMBO AYE, ACEH UTARA, ACEH",25,3,165,168
https://kawalpemilu.org#4115,"NASREUHE, SALANG, SIMEULUE, ACEH",2,59,153,212
https://kawalpemilu.org#3119,"BLANGONG BASAH, MUTIARA TIMUR, PIDIE, ACEH",1,29,127,156
https://kawalpemilu.org#4820,"BLANG TAMBUE, SIMPANG MAMPLAM, BIREUEN, ACEH",3,21,162,183
https://kawalpemilu.org#2927,"PAYA LINTEUENG, PIDIE, PIDIE, ACEH",1,3,173,176
https://kawalpemilu.org#4050,"MATANG KEH, PIRAK TIMUR, ACEH UTARA, ACEH",21,35,169,204
https://kawalpemilu.org#5846,"ALUR TANI I, TAMIANG HULU, ACEH TAMIANG, ACEH",2,15,205,220
https://kawalpemilu.org#1861,"LAM ATEUK, LHOKNGA, ACEH BESAR, ACEH",2,12,150,162
https://kawalpemilu.org#5856,"BENUA RAJA, RANTAU, ACEH TAMIANG, ACEH",1,34,203,237
https://kawalpemilu.org#2528,"BANGKEH, GEUMPANG, PIDIE, ACEH",5,22,175,197
https://kawalpemilu.org#1046,"PAYA AWEE, IDI TUNONG, ACEH TIMUR, ACEH",2,15,125,140
https://kawalpemilu.org#6608,"MATANG SEULIMENG, LANGSA BARAT, KOTA LANGSA, ACEH",17,9,185,194
https://kawalpemilu.org#6555,"HAGU BARAT LAUT, BANDA SAKTI, KOTA LHOKSEUMAWE, ACEH",5,9,206,215
https://kawalpemilu.org#5782,"PAYA TAMPAH, KARANG BARU, ACEH TAMIANG, ACEH",1,3,161,164
https://kawalpemilu.org#3868,"COT GIREK, COT GIREK, ACEH UTARA, ACEH",5,8,153,161
https://kawalpemilu.org#6618,"GAMPONG TEUNGOH, LANGSA KOTA, KOTA LANGSA, ACEH",4,14,167,181
https://kawalpemilu.org#5942,"LAMPAHAN BARAT, TIMANG GAJAH, BENER MERIAH, ACEH",2,74,109,183
https://kawalpemilu.org#1983,"LAM PISANG TEUNGOH, SEULIMEUM, ACEH BESAR, ACEH",1,14,185,199
https://kawalpemilu.org#4504,"PAYA TIMU, PEUDADA, BIREUEN, ACEH",2,12,160,172
https://kawalpemilu.org#4577,"BAYU, PEUSANGAN, BIREUEN, ACEH",2,3,112,115
https://kawalpemilu.org#5580,"BUMI SARI, BEUTONG, NAGAN RAYA, ACEH",2,47,131,178
https://kawalpemilu.org#1053,"ALUE KUMBANG M, IDI TUNONG, ACEH TIMUR, ACEH",1,8,126,134
https://kawalpemilu.org#759,"TANOH ANOU, IDI RAYEUK, ACEH TIMUR, ACEH",2,25,141,166
https://kawalpemilu.org#6539,"TUMPOK TEUNGOH, BANDA SAKTI, KOTA LHOKSEUMAWE, ACEH",16,17,195,212
https://kawalpemilu.org#4473,"PAYA BEUNOT, PEUDADA, BIREUEN, ACEH",1,7,145,152
https://kawalpemilu.org#6399,"KAMPUNG BARU, BAITURRAHMAN, KOTA BANDA ACEH, ACEH",4,43,160,203
https://kawalpemilu.org#2913,"RAYA SANGGEUE, PIDIE, PIDIE, ACEH",1,8,175,183
https://kawalpemilu.org#3933,"COT LABA, BAKTIYA BARAT, ACEH UTARA, ACEH",51,2,135,137
https://kawalpemilu.org#4072,"ULEE NYEUE, BANDA BARO, ACEH UTARA, ACEH",2,27,185,212
https://kawalpemilu.org#53853,"SEPANG, BUSUNG BIU, BULELENG, BALI",6,164,12,176
https://kawalpemilu.org#53994,"SUMERTA KAUH, DENPASAR TIMUR, KOTA DENPASAR, BALI",3,188,23,211
https://kawalpemilu.org#53454,"MENGWITANI, MENGWI, BADUNG, BALI",10,273,9,282
https://kawalpemilu.org#53884,"TIGAWASA, BANJAR, BULELENG, BALI",1,172,26,198
https://kawalpemilu.org#53827,"TINGA-TINGA, GEROKGAK, BULELENG, BALI",4,197,22,219
https://kawalpemilu.org#53497,"JIMBARAN, KUTA SELATAN, BADUNG, BALI",62,181,27,208
https://kawalpemilu.org#53244,"BALER BALE AGUNG, NEGARA, JEMBRANA, BALI",23,155,59,214
https://kawalpemilu.org#53407,"WONGAYA GEDE, PENEBEL, TABANAN, BALI",9,127,10,137
https://kawalpemilu.org#53900,"SELAT, SUKASADA, BULELENG, BALI",16,128,23,151
https://kawalpemilu.org#53621,"SEMARAPURA TENGAH, KLUNGKUNG, KLUNGKUNG, BALI",9,169,22,191
https://kawalpemilu.org#53389,"PAYANGAN, MARGA, TABANAN, BALI",6,218,4,222
https://kawalpemilu.org#53675,"UNDISAN, TEMBUKU, BANGLI, BALI",11,153,21,174
https://kawalpemilu.org#53477,"TAMAN, ABIANSEMAL, BADUNG, BALI",12,205,15,220
https://kawalpemilu.org#53495,"BENOA, KUTA SELATAN, BADUNG, BALI",68,212,15,227
https://kawalpemilu.org#53853,"SEPANG, BUSUNG BIU, BULELENG, BALI",9,193,5,198
https://kawalpemilu.org#53304,"BEREMBENG, SELEMADEG, TABANAN, BALI",9,155,6,161
https://kawalpemilu.org#53986,"SUMERTA, DENPASAR TIMUR, KOTA DENPASAR, BALI",17,213,9,222
https://kawalpemilu.org#53405,"SENGANAN, PENEBEL, TABANAN, BALI",1,158,5,163
https://kawalpemilu.org#53896,"SAMBANGAN, SUKASADA, BULELENG, BALI",7,212,10,222
https://kawalpemilu.org#53449,"ABIANBASE, MENGWI, BADUNG, BALI",7,229,6,235
https://kawalpemilu.org#53405,"SENGANAN, PENEBEL, TABANAN, BALI",23,122,6,128
https://kawalpemilu.org#53400,"PENATAHAN, PENEBEL, TABANAN, BALI",5,181,22,203
https://kawalpemilu.org#54013,"PEGUYANGAN KANGIN, DENPASAR UTARA, KOTA DENPASAR, BALI",2,198,14,212
https://kawalpemilu.org#53553,"TAMPAKSIRING, TAMPAKSIRING, GIANYAR, BALI",26,194,23,217
https://kawalpemilu.org#53793,"BUANA GIRI, BEBANDEM, KARANGASEM, BALI",20,279,5,284
https://kawalpemilu.org#53992,"KESIMAN KERTALANGU, DENPASAR TIMUR, KOTA DENPASAR, BALI",38,205,15,220
https://kawalpemilu.org#53314,"BANTAS, SELEMADEG TIMUR, TABANAN, BALI",6,155,3,158
https://kawalpemilu.org#53353,"DAUH PEKEN, TABANAN, TABANAN, BALI",23,220,12,232
https://kawalpemilu.org#53822,"MUSI, GEROKGAK, BULELENG, BALI",7,227,16,243
https://kawalpemilu.org#53946,"GIRI EMAS, SAWAN, BULELENG, BALI",6,169,11,180
https://kawalpemilu.org#53269,"MEDEWI, PEKUTATAN, JEMBRANA, BALI",4,48,160,208
https://kawalpemilu.org#52102,"CIJORO LEBAK, RANGKASBITUNG, LEBAK, BANTEN",28,94,83,177
https://kawalpemilu.org#51891,"CIBUNGUR, SUKARESMI, PANDEGLANG, BANTEN",14,109,174,183
https://kawalpemilu.org#53226,"PAMULANG BARAT, PAMULANG, KOTA TANGERANG SELATAN, BANTEN",8,104,71,175
https://kawalpemilu.org#51811,"KABAYAN, PANDEGLANG, PANDEGLANG, BANTEN",3,36,187,223
https://kawalpemilu.org#52628,"KERTASANA, BOJONEGARA, SERANG, BANTEN",11,34,144,178
https://kawalpemilu.org#52443,"CENGKLONG, KOSAMBI, TANGERANG, BANTEN",13,145,17,162
https://kawalpemilu.org#51811,"KABAYAN, PANDEGLANG, PANDEGLANG, BANTEN",15,40,126,166
https://kawalpemilu.org#52469,"SARAKAN, SEPATAN, TANGERANG, BANTEN",19,78,123,201
https://kawalpemilu.org#52540,"BUNAR, SUKAMULYA, TANGERANG, BANTEN",6,41,113,154
https://kawalpemilu.org#51873,"PEJAMBEN, CARITA, PANDEGLANG, BANTEN",5,64,151,215
https://kawalpemilu.org#53186,"BUARAN, SERPONG, KOTA TANGERANG SELATAN, BANTEN",42,71,93,164
https://kawalpemilu.org#53061,"CIKERAI, CIBEBER, KOTA CILEGON, BANTEN",8,78,124,202
https://kawalpemilu.org#52460,"GAGA, PAKUHAJI, TANGERANG, BANTEN",6,37,94,131
https://kawalpemilu.org#52980,"SUDIMARA BARAT, CILEDUG, KOTA TANGERANG, BANTEN",12,115,156,271
https://kawalpemilu.org#51721,"SODONG, SAKETI, PANDEGLANG, BANTEN",11,57,145,202
https://kawalpemilu.org#51801,"BANJAR, BANJAR, PANDEGLANG, BANTEN",9,51,149,200
https://kawalpemilu.org#52767,"KADUGENEP, PETIR, SERANG, BANTEN",2,62,132,194
https://kawalpemilu.org#52597,"PEJATEN, KRAMATWATU, SERANG, BANTEN",10,44,116,160
https://kawalpemilu.org#52945,"BABAKAN, TANGERANG, KOTA TANGERANG, BANTEN",24,116,89,205
https://kawalpemilu.org#52939,"SUKAASIH, TANGERANG, KOTA TANGERANG, BANTEN",11,73,54,127
https://kawalpemilu.org#52562,"GEMPOL SARI, SEPATAN TIMUR, TANGERANG, BANTEN",31,98,116,214
https://kawalpemilu.org#52670,"TERAS BENDUNG, LEBAK WANGI, SERANG, BANTEN",4,84,89,173
https://kawalpemilu.org#52510,"BOJONGKAMAL, LEGOK, TANGERANG, BANTEN",9,44,161,205
https://kawalpemilu.org#51984,"CIBUNGUR, LEUWIDAMAR, LEBAK, BANTEN",9,79,99,178
https://kawalpemilu.org#53137,"PAGER AGUNG, WALANTAKA, KOTA SERANG, BANTEN",3,94,120,214
https://kawalpemilu.org#53200,"PONDOK PUCUNG, PONDOK AREN, KOTA TANGERANG SELATAN, BANTEN",55,182,67,249
https://kawalpemilu.org#53202,"PONDOK JAYA, PONDOK AREN, KOTA TANGERANG SELATAN, BANTEN",1,116,148,264
https://kawalpemilu.org#53224,"RENGAS, CIPUTAT TIMUR, KOTA TANGERANG SELATAN, BANTEN",15,131,79,210
https://kawalpemilu.org#52340,"CIBUGEL, CISOKA, TANGERANG, BANTEN",6,67,116,183
https://kawalpemilu.org#53064,"CIWEDUS, CILEGON, KOTA CILEGON, BANTEN",35,37,116,153
https://kawalpemilu.org#51829,"CIBARANI, CISATA, PANDEGLANG, BANTEN",11,26,197,223
https://kawalpemilu.org#53074,"BANJAR NEGARA, CIWANDAN, KOTA CILEGON, BANTEN",14,0,0,0
https://kawalpemilu.org#53026,"PINANG, PINANG, KOTA TANGERANG, BANTEN",6,31,125,156
https://kawalpemilu.org#53189,"SERPONG, SERPONG, KOTA TANGERANG SELATAN, BANTEN",31,89,107,196
https://kawalpemilu.org#52463,"KARET, SEPATAN, TANGERANG, BANTEN",28,82,144,226
https://kawalpemilu.org#52943,"KELAPA INDAH, TANGERANG, KOTA TANGERANG, BANTEN",8,139,18,157
https://kawalpemilu.org#51641,"CITEUREUP, PANIMBANG, PANDEGLANG, BANTEN",10,88,131,219
https://kawalpemilu.org#53015,"UWUNG JAYA, CIBODAS, KOTA TANGERANG, BANTEN",46,92,131,223
https://kawalpemilu.org#52973,"PETIR, CIPONDOH, KOTA TANGERANG, BANTEN",18,59,161,220
https://kawalpemilu.org#52413,"KUTABUMI, PASAR KEMIS, TANGERANG, BANTEN",107,94,117,211
https://kawalpemilu.org#52963,"JURUMUDI, BENDA, KOTA TANGERANG, BANTEN",21,32,151,183
https://kawalpemilu.org#52951,"MANIS JAYA, JATIUWUNG, KOTA TANGERANG, BANTEN",42,44,98,142
https://kawalpemilu.org#53211,"SAWAH BARU, CIPUTAT, KOTA TANGERANG SELATAN, BANTEN",1,128,110,238
https://kawalpemilu.org#51700,"TELUK, LABUAN, PANDEGLANG, BANTEN",13,56,145,201
https://kawalpemilu.org#52365,"BLUKBUK, KRONJO, TANGERANG, BANTEN",15,50,118,168
https://kawalpemilu.org#51879,"SUKARAME, CARITA, PANDEGLANG, BANTEN",6,67,108,175
https://kawalpemilu.org#52804,"SUKAMENAK, CIKEUSAL, SERANG, BANTEN",7,96,67,163
https://kawalpemilu.org#53132,"WALANTAKA, WALANTAKA, KOTA SERANG, BANTEN",3,40,169,209
https://kawalpemilu.org#52570,"CIREUNDEU, SOLEAR, TANGERANG, BANTEN",4,112,137,249
https://kawalpemilu.org#53213,"CIPUTAT, CIPUTAT, KOTA TANGERANG SELATAN, BANTEN",20,141,98,239
https://kawalpemilu.org#52389,"SUKADIRI, SUKADIRI, TANGERANG, BANTEN",20,39,93,132
https://kawalpemilu.org#53006,"GEMBOR, PERIUK, KOTA TANGERANG, BANTEN",3,63,102,165
https://kawalpemilu.org#53057,"KEDALEMAN, CIBEBER, KOTA CILEGON, BANTEN",4,74,131,205
https://kawalpemilu.org#52417,"SUKAMANTRI, PASAR KEMIS, TANGERANG, BANTEN",13,121,80,201
https://kawalpemilu.org#52626,"KARANG KEPUH, BOJONEGARA, SERANG, BANTEN",4,34,165,199
https://kawalpemilu.org#53222,"CIREUNDEU, CIPUTAT TIMUR, KOTA TANGERANG SELATAN, BANTEN",66,75,121,196
https://kawalpemilu.org#53181,"CIATER, SERPONG, KOTA TANGERANG SELATAN, BANTEN",5,138,95,233
https://kawalpemilu.org#51778,"DALEMBALAR, CIMANUK, PANDEGLANG, BANTEN",10,25,105,130
https://kawalpemilu.org#52735,"NAMBO ILIR, KIBIN, SERANG, BANTEN",8,75,126,201
https://kawalpemilu.org#52510,"BOJONGKAMAL, LEGOK, TANGERANG, BANTEN",7,131,105,236
https://kawalpemilu.org#51925,"SUMBERWARAS, MALINGPING, LEBAK, BANTEN",18,62,95,157
https://kawalpemilu.org#52977,"PORIS PLAWAD INDAH, CIPONDOH, KOTA TANGERANG, BANTEN",25,55,140,195
https://kawalpemilu.org#53233,"PAMULANG TIMUR, PAMULANG, KOTA TANGERANG SELATAN, BANTEN",33,110,41,151
https://kawalpemilu.org#52315,"PEMATANG, TIGARAKSA, TANGERANG, BANTEN",7,35,191,226
https://kawalpemilu.org#52096,"PASIRKEMBANG, MAJA, LEBAK, BANTEN",3,74,132,206
https://kawalpemilu.org#52565,"TANAH MERAH, SEPATAN TIMUR, TANGERANG, BANTEN",15,85,136,221
https://kawalpemilu.org#53150,"CIPETE, CURUG, KOTA SERANG, BANTEN",7,93,69,162
https://kawalpemilu.org#52723,"BAKUNG, CIKANDE, SERANG, BANTEN",1,79,166,245
https://kawalpemilu.org#89651,"KERTARAHARJA, SOBANG, PANDEGLANG, BANTEN",3,72,124,196
https://kawalpemilu.org#52157,"KADUAGUNG TIMUR, CIBADAK, LEBAK, BANTEN",19,39,133,172
https://kawalpemilu.org#52564,"PONDOK KELOR, SEPATAN TIMUR, TANGERANG, BANTEN",21,93,108,201
https://kawalpemilu.org#52639,"ARGAWANA, PULO AMPEL, SERANG, BANTEN",16,22,214,236
https://kawalpemilu.org#52071,"SAJIRA, SAJIRA, LEBAK, BANTEN",1,50,151,201
https://kawalpemilu.org#52859,"KADUBEUREUM, PABUARAN, SERANG, BANTEN",17,61,55,116
https://kawalpemilu.org#52860,"TANJUNGSARI, PABUARAN, SERANG, BANTEN",2,14,219,233
https://kawalpemilu.org#52360,"MUNCUNG, KRONJO, TANGERANG, BANTEN",10,71,117,188
https://kawalpemilu.org#51788,"MANDALASARI, KADUHEJO, PANDEGLANG, BANTEN",16,21,161,182
https://kawalpemilu.org#53135,"PANGAMPELAN, WALANTAKA, KOTA SERANG, BANTEN",4,31,187,218
https://kawalpemilu.org#53224,"RENGAS, CIPUTAT TIMUR, KOTA TANGERANG SELATAN, BANTEN",48,74,50,124
https://kawalpemilu.org#53048,"CIPADU, LARANGAN, KOTA TANGERANG, BANTEN",32,89,141,230
https://kawalpemilu.org#52434,"KAMPUNG BESAR, TELUKNAGA, TANGERANG, BANTEN",28,81,150,231
https://kawalpemilu.org#53019,"KARANG SARI, NEGLASARI, KOTA TANGERANG, BANTEN",63,109,61,170
https://kawalpemilu.org#52960,"PORIS JAYA, BATUCEPER, KOTA TANGERANG, BANTEN",26,108,138,246
https://kawalpemilu.org#22325,"SURABAYA, SUNGAI SERUT, KOTA BENGKULU, BENGKULU",8,67,152,219
https://kawalpemilu.org#21438,"SUKA BARU, MARGA SAKTI SEBELAT, BENGKULU UTARA, BENGKULU",1,157,55,212
https://kawalpemilu.org#21195,"KAMPUNG DELIMA, CURUP TIMUR, REJANG LEBONG, BENGKULU",5,102,123,225
https://kawalpemilu.org#21210,"KEPALA SIRING, CURUP TENGAH, REJANG LEBONG, BENGKULU",4,49,84,134
https://kawalpemilu.org#20968,"MASAT, PINO, BENGKULU SELATAN, BENGKULU",2,83,126,209
https://kawalpemilu.org#21331,"PAGAR BANYU, ARMA JAYA, BENGKULU UTARA, BENGKULU",3,110,158,268
https://kawalpemilu.org#21285,"AUR GADING, KERKAP, BENGKULU UTARA, BENGKULU",4,116,72,188
https://kawalpemilu.org#21038,"KARANG CAYA, KEDURANG ILIR, BENGKULU SELATAN, BENGKULU",1,99,20,119
https://kawalpemilu.org#21522,"PADANG KEDONDONG, TANJUNG KEMUNING, KAUR, BENGKULU",2,96,63,159
https://kawalpemilu.org#928238,"HARAPAN MULYA, TALO, SELUMA, BENGKULU",1,90,41,131
https://kawalpemilu.org#21897,"BANDAR RATU, KOTA MUKOMUKO, MUKOMUKO, BENGKULU",1,54,179,233
https://kawalpemilu.org#22245,"SOSOKAN BARU, MUARA KEMUMU, KEPAHIANG, BENGKULU",4,62,108,170
https://kawalpemilu.org#20894,"RENA KANDIS, PAGAR JATI, BENGKULU TENGAH, BENGKULU",1,43,108,151
https://kawalpemilu.org#83916,"TALANG PANJANG, BANG HAJI, BENGKULU TENGAH, BENGKULU",1,147,70,217
https://kawalpemilu.org#21779,"GUNUNG KEMBANG, SEMIDANG ALAS MARAS, SELUMA, BENGKULU",1,92,66,158
https://kawalpemilu.org#22163,"BUMI SARI, UJAN MAS, KEPAHIANG, BENGKULU",3,39,98,137
https://kawalpemilu.org#41944,"PURWOSARI, GIRIMULYO, KULON PROGO, DAERAH ISTIMEWA YOGYAKARTA",4,157,49,206
https://kawalpemilu.org#42045,"TIMBULHARJO, SEWON, BANTUL, DAERAH ISTIMEWA YOGYAKARTA",6,150,99,249
https://kawalpemilu.org#41914,"SIDOREJO, LENDAH, KULON PROGO, DAERAH ISTIMEWA YOGYAKARTA",12,194,55,249
https://kawalpemilu.org#42002,"SABDODADI, BANTUL, BANTUL, DAERAH ISTIMEWA YOGYAKARTA",16,91,152,243
https://kawalpemilu.org#42354,"PATANGPULUHAN, WIROBRAJAN, KOTA YOGYAKARTA, DAERAH ISTIMEWA YOGYAKARTA",11,101,38,139
https://kawalpemilu.org#41935,"HARGOMULYO, KOKAP, KULON PROGO, DAERAH ISTIMEWA YOGYAKARTA",17,197,31,228
https://kawalpemilu.org#41886,"BENDUNGAN, WATES, KULON PROGO, DAERAH ISTIMEWA YOGYAKARTA",14,171,73,244
https://kawalpemilu.org#42187,"WATUGAJAH, GEDANGSARI, GUNUNGKIDUL, DAERAH ISTIMEWA YOGYAKARTA",12,142,31,173
https://kawalpemilu.org#42353,"WIROBRAJAN, WIROBRAJAN, KOTA YOGYAKARTA, DAERAH ISTIMEWA YOGYAKARTA",15,139,104,243
https://kawalpemilu.org#42272,"SAMBIREJO, PRAMBANAN, SLEMAN, DAERAH ISTIMEWA YOGYAKARTA",9,140,29,169
https://kawalpemilu.org#42378,"PANDEYAN, UMBULHARJO, KOTA YOGYAKARTA, DAERAH ISTIMEWA YOGYAKARTA",14,75,98,173
https://kawalpemilu.org#42011,"WUKIRSARI, IMOGIRI, BANTUL, DAERAH ISTIMEWA YOGYAKARTA",41,198,66,264
https://kawalpemilu.org#41922,"SUKORENO, SENTOLO, KULON PROGO, DAERAH ISTIMEWA YOGYAKARTA",14,61,186,247
https://kawalpemilu.org#42264,"SENDANGTIRTO, BERBAH, SLEMAN, DAERAH ISTIMEWA YOGYAKARTA",21,135,64,199
https://kawalpemilu.org#41947,"DONOMULYO, NANGGULAN, KULON PROGO, DAERAH ISTIMEWA YOGYAKARTA",6,132,98,230
https://kawalpemilu.org#42338,"KLITREN, GONDOKUSUMAN, KOTA YOGYAKARTA, DAERAH ISTIMEWA YOGYAKARTA",26,194,35,229
https://kawalpemilu.org#42379,"SOROSUTAN, UMBULHARJO, KOTA YOGYAKARTA, DAERAH ISTIMEWA YOGYAKARTA",1,106,38,144
https://kawalpemilu.org#42323,"KEPUHARJO, CANGKRINGAN, SLEMAN, DAERAH ISTIMEWA YOGYAKARTA",3,196,70,266
https://kawalpemilu.org#42312,"WONOKERTO, TURI, SLEMAN, DAERAH ISTIMEWA YOGYAKARTA",25,61,158,219
https://kawalpemilu.org#42212,"KEMADANG, TANJUNGSARI, GUNUNGKIDUL, DAERAH ISTIMEWA YOGYAKARTA",12,168,19,187
https://kawalpemilu.org#42296,"TRIDADI, SLEMAN, SLEMAN, DAERAH ISTIMEWA YOGYAKARTA",24,169,83,252
https://kawalpemilu.org#42083,"BANYUSOCO, PLAYEN, GUNUNGKIDUL, DAERAH ISTIMEWA YOGYAKARTA",19,146,14,160
https://kawalpemilu.org#42262,"CONDONGCATUR, DEPOK, SLEMAN, DAERAH ISTIMEWA YOGYAKARTA",123,158,80,238
https://kawalpemilu.org#42131,"SEMANU, SEMANU, GUNUNGKIDUL, DAERAH ISTIMEWA YOGYAKARTA",17,168,66,234
https://kawalpemilu.org#42296,"TRIDADI, SLEMAN, SLEMAN, DAERAH ISTIMEWA YOGYAKARTA",7,165,67,232
https://kawalpemilu.org#42350,"NOTOPRAJAN, NGAMPILAN, KOTA YOGYAKARTA, DAERAH ISTIMEWA YOGYAKARTA",18,57,64,121
https://kawalpemilu.org#42060,"WONOSARI, WONOSARI, GUNUNGKIDUL, DAERAH ISTIMEWA YOGYAKARTA",28,156,88,244
https://kawalpemilu.org#42066,"BALEHARJO, WONOSARI, GUNUNGKIDUL, DAERAH ISTIMEWA YOGYAKARTA",6,167,37,204
https://kawalpemilu.org#42349,"NGAMPILAN, NGAMPILAN, KOTA YOGYAKARTA, DAERAH ISTIMEWA YOGYAKARTA",17,116,65,181
https://kawalpemilu.org#25906,"TUGU SELATAN, KOJA, JAKARTA UTARA, DKI JAKARTA",43,150,131,281
https://kawalpemilu.org#25953,"TANAH SEREAL, TAMBORA, JAKARTA BARAT, DKI JAKARTA",52,205,45,250
https://kawalpemilu.org#26115,"KLENDER, DUREN SAWIT, JAKARTA TIMUR, DKI JAKARTA",7,122,119,241
https://kawalpemilu.org#25970,"KALIDERES, KALIDERES, JAKARTA BARAT, DKI JAKARTA",171,54,79,133
https://kawalpemilu.org#26092,"TENGAH, KRAMATJATI, JAKARTA TIMUR, DKI JAKARTA",79,121,131,252
https://kawalpemilu.org#25851,"SERDANG, KEMAYORAN, JAKARTA PUSAT, DKI JAKARTA",63,134,110,244
https://kawalpemilu.org#25939,"WIJAYA KUSUMA, GROGOL PETAMBURAN, JAKARTA BARAT, DKI JAKARTA",13,148,85,233
https://kawalpemilu.org#25848,"KEMAYORAN, KEMAYORAN, JAKARTA PUSAT, DKI JAKARTA",13,155,52,207
https://kawalpemilu.org#25966,"DURI KEPA, KEBON JERUK, JAKARTA BARAT, DKI JAKARTA",163,214,5,219
https://kawalpemilu.org#26053,"JAGAKARSA, JAGAKARSA, JAKARTA SELATAN, DKI JAKARTA",150,94,120,214
https://kawalpemilu.org#26056,"LENTENG AGUNG, JAGAKARSA, JAKARTA SELATAN, DKI JAKARTA",156,100,110,210
https://kawalpemilu.org#26018,"PEJATEN TIMUR, PASAR MINGGU, JAKARTA SELATAN, DKI JAKARTA",8,101,96,197
https://kawalpemilu.org#26095,"BALEKAMBANG, KRAMATJATI, JAKARTA TIMUR, DKI JAKARTA",83,103,147,250
https://kawalpemilu.org#25899,"SUNTER AGUNG, TANJUNG PRIOK, JAKARTA UTARA, DKI JAKARTA",186,214,47,261
https://kawalpemilu.org#25928,"RAWA BUAYA, CENGKARENG, JAKARTA BARAT, DKI JAKARTA",193,136,105,241
https://kawalpemilu.org#26033,"CIPETE SELATAN, CILANDAK, JAKARTA SELATAN, DKI JAKARTA",37,104,74,178
https://kawalpemilu.org#25970,"KALIDERES, KALIDERES, JAKARTA BARAT, DKI JAKARTA",17,100,143,243
https://kawalpemilu.org#25872,"KEBON SIRIH, MENTENG, JAKARTA PUSAT, DKI JAKARTA",22,56,204,260
https://kawalpemilu.org#25931,"CENGKARENG TIMUR, CENGKARENG, JAKARTA BARAT, DKI JAKARTA",24,164,92,256
https://kawalpemilu.org#25915,"SEMPER BARAT, CILINCING, JAKARTA UTARA, DKI JAKARTA",85,86,96,182
https://kawalpemilu.org#26047,"KALIBATA, PANCORAN, JAKARTA SELATAN, DKI JAKARTA",132,43,133,156
https://kawalpemilu.org#25930,"KAPUK, CENGKARENG, JAKARTA BARAT, DKI JAKARTA",376,109,63,172
https://kawalpemilu.org#26047,"KALIBATA, PANCORAN, JAKARTA SELATAN, DKI JAKARTA",22,77,162,239
https://kawalpemilu.org#25970,"KALIDERES, KALIDERES, JAKARTA BARAT, DKI JAKARTA",76,91,123,214
https://kawalpemilu.org#25971,"SEMANAN, KALIDERES, JAKARTA BARAT, DKI JAKARTA",40,74,98,172
https://kawalpemilu.org#26060,"PESANGGRAHAN, PESANGGRAHAN, JAKARTA SELATAN, DKI JAKARTA",16,96,96,192
https://kawalpemilu.org#26053,"JAGAKARSA, JAGAKARSA, JAKARTA SELATAN, DKI JAKARTA",112,109,95,204
https://kawalpemilu.org#26011,"TEGAL PARANG, MAMPANG PRAPATAN, JAKARTA SELATAN, DKI JAKARTA",92,108,130,238
https://kawalpemilu.org#25898,"KEBON BAWANG, TANJUNG PRIOK, JAKARTA UTARA, DKI JAKARTA",103,115,132,247
https://kawalpemilu.org#26105,"CAKUNG TIMUR, CAKUNG, JAKARTA TIMUR, DKI JAKARTA",33,69,100,169
https://kawalpemilu.org#25864,"CEMPAKA PUTIH TIMUR, CEMPAKA PUTIH, JAKARTA PUSAT, DKI JAKARTA",6,119,88,207
https://kawalpemilu.org#25872,"KEBON SIRIH, MENTENG, JAKARTA PUSAT, DKI JAKARTA",15,102,120,222
https://kawalpemilu.org#25970,"KALIDERES, KALIDERES, JAKARTA BARAT, DKI JAKARTA",123,122,119,241
https://kawalpemilu.org#25968,"KEDOYA SELATAN, KEBON JERUK, JAKARTA BARAT, DKI JAKARTA",9,80,117,197
https://kawalpemilu.org#26110,"UJUNG MENTENG, CAKUNG, JAKARTA TIMUR, DKI JAKARTA",51,83,120,203
https://kawalpemilu.org#25992,"TEBET BARAT, TEBET, JAKARTA SELATAN, DKI JAKARTA",5,109,65,174
https://kawalpemilu.org#25994,"KEBON BARU, TEBET, JAKARTA SELATAN, DKI JAKARTA",22,134,61,195
https://kawalpemilu.org#25976,"PALMERAH, PALMERAH, JAKARTA BARAT, DKI JAKARTA",204,101,126,227
https://kawalpemilu.org#26017,"RAGUNAN, PASAR MINGGU, JAKARTA SELATAN, DKI JAKARTA",106,103,128,231
https://kawalpemilu.org#26022,"KEBAYORAN LAMA UTARA, KEBAYORAN LAMA, JAKARTA SELATAN, DKI JAKARTA",107,130,66,196
https://kawalpemilu.org#26111,"CAKUNG BARAT, CAKUNG, JAKARTA TIMUR, DKI JAKARTA",168,140,72,212
https://kawalpemilu.org#25931,"CENGKARENG TIMUR, CENGKARENG, JAKARTA BARAT, DKI JAKARTA",203,204,6,210
https://kawalpemilu.org#25972,"TEGAL ALUR, KALIDERES, JAKARTA BARAT, DKI JAKARTA",87,150,59,209
https://kawalpemilu.org#26105,"CAKUNG TIMUR, CAKUNG, JAKARTA TIMUR, DKI JAKARTA",32,77,161,238
https://kawalpemilu.org#25922,"PEGANGSAAN DUA, KELAPA GADING, JAKARTA UTARA, DKI JAKARTA",50,118,108,226
https://kawalpemilu.org#25902,"KOJA, KOJA, JAKARTA UTARA, DKI JAKARTA",28,79,112,191
https://kawalpemilu.org#26011,"TEGAL PARANG, MAMPANG PRAPATAN, JAKARTA SELATAN, DKI JAKARTA",97,90,148,238
https://kawalpemilu.org#25917,"PADEMANGAN TIMUR, PADEMANGAN, JAKARTA UTARA, DKI JAKARTA",98,177,61,238
https://kawalpemilu.org#25983,"KEMBANGAN UTARA, KEMBANGAN, JAKARTA BARAT, DKI JAKARTA",105,98,75,173
https://kawalpemilu.org#26127,"CIRACAS, CIRACAS, JAKARTA TIMUR, DKI JAKARTA",116,113,135,248
https://kawalpemilu.org#26053,"JAGAKARSA, JAGAKARSA, JAKARTA SELATAN, DKI JAKARTA",81,83,124,207
https://kawalpemilu.org#26119,"PONDOK KOPI, DUREN SAWIT, JAKARTA TIMUR, DKI JAKARTA",109,99,110,209
https://kawalpemilu.org#26018,"PEJATEN TIMUR, PASAR MINGGU, JAKARTA SELATAN, DKI JAKARTA",60,63,172,235
https://kawalpemilu.org#26089,"CIPINANG BESAR UTARA, JATINEGARA, JAKARTA TIMUR, DKI JAKARTA",45,136,82,218
https://kawalpemilu.org#26119,"PONDOK KOPI, DUREN SAWIT, JAKARTA TIMUR, DKI JAKARTA",14,90,143,233
https://kawalpemilu.org#25917,"PADEMANGAN TIMUR, PADEMANGAN, JAKARTA UTARA, DKI JAKARTA",75,196,14,210
https://kawalpemilu.org#25895,"SUNTER JAYA, TANJUNG PRIOK, JAKARTA UTARA, DKI JAKARTA",63,125,87,212
https://kawalpemilu.org#25976,"PALMERAH, PALMERAH, JAKARTA BARAT, DKI JAKARTA",10,103,130,233
https://kawalpemilu.org#25976,"PALMERAH, PALMERAH, JAKARTA BARAT, DKI JAKARTA",55,126,104,230
https://kawalpemilu.org#25966,"DURI KEPA, KEBON JERUK, JAKARTA BARAT, DKI JAKARTA",176,254,1,255
https://kawalpemilu.org#26100,"KALISARI, PASAR REBO, JAKARTA TIMUR, DKI JAKARTA",20,91,141,232
https://kawalpemilu.org#25868,"MENTENG, MENTENG, JAKARTA PUSAT, DKI JAKARTA",72,93,124,217
https://kawalpemilu.org#25934,"TANJUNG DUREN UTARA, GROGOL PETAMBURAN, JAKARTA BARAT, DKI JAKARTA",15,236,8,244
https://kawalpemilu.org#26136,"MUNJUL, CIPAYUNG, JAKARTA TIMUR, DKI JAKARTA",38,124,139,263
https://kawalpemilu.org#25912,"KALIBARU, CILINCING, JAKARTA UTARA, DKI JAKARTA",212,40,43,83
https://kawalpemilu.org#26134,"CILANGKAP, CIPAYUNG, JAKARTA TIMUR, DKI JAKARTA",15,192,34,226
https://kawalpemilu.org#25939,"WIJAYA KUSUMA, GROGOL PETAMBURAN, JAKARTA BARAT, DKI JAKARTA",5,147,95,242
https://kawalpemilu.org#25902,"KOJA, KOJA, JAKARTA UTARA, DKI JAKARTA",9,108,85,193
https://kawalpemilu.org#25966,"DURI KEPA, KEBON JERUK, JAKARTA BARAT, DKI JAKARTA",34,130,74,204
https://kawalpemilu.org#25957,"JEMBATAN LIMA, TAMBORA, JAKARTA BARAT, DKI JAKARTA",32,94,102,196
https://kawalpemilu.org#25870,"CIKINI, MENTENG, JAKARTA PUSAT, DKI JAKARTA",13,64,140,204
https://kawalpemilu.org#26023,"PONDOK PINANG, KEBAYORAN LAMA, JAKARTA SELATAN, DKI JAKARTA",129,85,162,247
https://kawalpemilu.org#74964,"DILOATO, PAGUYAMAN, BOALEMO, GORONTALO",1,143,93,236
https://kawalpemilu.org#75372,"MOLOSIPAT  W, KOTA BARAT, KOTA GORONTALO, GORONTALO",8,48,145,193
https://kawalpemilu.org#74902,"TERATAI, TABONGO, GORONTALO, GORONTALO",2,146,81,227
https://kawalpemilu.org#75295,"TUNAS JAYA, POPAYATO BARAT, PAHUWATO, GORONTALO",1,193,30,223
https://kawalpemilu.org#74802,"PENTADIO BARAT, TELAGA BIRU, GORONTALO, GORONTALO",8,93,128,221
https://kawalpemilu.org#74748,"BARAKATI, BATUDAA, GORONTALO, GORONTALO",5,103,120,223
https://kawalpemilu.org#74997,"BAJO, TILAMUTA, BOALEMO, GORONTALO",1,125,123,248
https://kawalpemilu.org#75372,"MOLOSIPAT  W, KOTA BARAT, KOTA GORONTALO, GORONTALO",5,108,145,253
https://kawalpemilu.org#75382,"WONGKADITI TIMUR, KOTA UTARA, KOTA GORONTALO, GORONTALO",14,117,99,216
https://kawalpemilu.org#17340,"MURNI, DANAU SIPIN, KOTA JAMBI, JAMBI",17,95,149,244
https://kawalpemilu.org#17075,"JAYA SETIA, PASAR MUARO BUNGO, BUNGO, JAMBI",6,60,163,223
https://kawalpemilu.org#17355,"LINGKAR SELATAN, PAAL MERAH, KOTA JAMBI, JAMBI",57,90,56,146
https://kawalpemilu.org#15897,"SUMUR ANYIR, SUNGAI BUNGKAL, KOTA SUNGAI PENUH, JAMBI",1,37,155,192
https://kawalpemilu.org#17197,"TANAH PERIUK, TANAH SEPENGGAL LINTAS, BUNGO, JAMBI",2,18,155,173
https://kawalpemilu.org#17149,"KUNING GADING, PELEPAT ILIR, BUNGO, JAMBI",6,83,64,147
https://kawalpemilu.org#17047,"RANTAU MAKMUR, BERBAK, TANJUNG JABUNG TIMUR, JAMBI",4,115,51,166
https://kawalpemilu.org#16320,"LIMBUR MERANGIN, PAMENANG BARAT, MERANGIN, JAMBI",7,67,88,155
https://kawalpemilu.org#17196,"TEPIAN DANTO, JUJUHAN ILIR, BUNGO, JAMBI",1,37,122,159
https://kawalpemilu.org#17392,"KENALI BESAR, ALAM BARAJO, KOTA JAMBI, JAMBI",83,33,121,154
https://kawalpemilu.org#17364,"RAJAWALI, JAMBI TIMUR, KOTA JAMBI, JAMBI",22,156,83,239
https://kawalpemilu.org#16259,"SUNGAI UDANG, PAMENANG, MERANGIN, JAMBI",5,144,49,193
https://kawalpemilu.org#16649,"TEBING TINGGI, PEMAYUNG, BATANGHARI, JAMBI",5,52,31,83
https://kawalpemilu.org#16370,"GEDANG, JANGKAT TIMUR, MERANGIN, JAMBI",2,77,118,195
https://kawalpemilu.org#17255,"WIROTHO AGUNG, RIMBO BUJANG, TEBO, JAMBI",29,70,115,185
https://kawalpemilu.org#84660,"BRAM ITAM RAYA, BRAM ITAM, TANJUNG JABUNG BARAT, JAMBI",6,75,43,118
https://kawalpemilu.org#15986,"TANJUNGTANAH, DANAU KERINCI, KERINCI, JAMBI",1,20,110,130
https://kawalpemilu.org#16780,"PONDOK MEJA, MESTONG, MUARO JAMBI, JAMBI",15,65,91,156
https://kawalpemilu.org#17225,"PELAYANG, TEBO TENGAH, TEBO, JAMBI",2,117,55,172
https://kawalpemilu.org#16818,"TANGKIT, SUNGAI GELAM, MUARO JAMBI, JAMBI",24,88,76,164
https://kawalpemilu.org#17099,"DWI KARYA BAKTI, PELEPAT, BUNGO, JAMBI",1,107,70,177
https://kawalpemilu.org#90515,"BINTANG MARAK, BUKITKERMAN, KERINCI, JAMBI",2,29,154,183
https://kawalpemilu.org#16067,"KOTO TUO P. TENGAH, KELILING DANAU, KERINCI, JAMBI",1,19,199,218
https://kawalpemilu.org#17392,"KENALI BESAR, ALAM BARAJO, KOTA JAMBI, JAMBI",47,31,84,115
https://kawalpemilu.org#16613,"RENGAS CONDONG, MUARA BULIAN, BATANGHARI, JAMBI",10,29,91,120
https://kawalpemilu.org#17354,"EKA JAYA, PAAL MERAH, KOTA JAMBI, JAMBI",82,60,65,125
https://kawalpemilu.org#16697,"DESA TERUSAN, MARO SEBO ILIR, BATANGHARI, JAMBI",6,31,238,269
https://kawalpemilu.org#16695,"BUKIT SARI, MARO SEBO ILIR, BATANGHARI, JAMBI",6,106,59,165
https://kawalpemilu.org#26620,"CITARIK, PELABUHAN RATU, SUKABUMI, JAWA BARAT",28,24,169,193
https://kawalpemilu.org#32565,"CIPAGERAN, CIMAHI UTARA, KOTA CIMAHI, JAWA BARAT",66,86,118,204
https://kawalpemilu.org#27150,"GADOG, PACET, CIANJUR, JAWA BARAT",28,44,170,214
https://kawalpemilu.org#31747,"SUKAJAYA, CIBITUNG, BEKASI, JAWA BARAT",59,62,131,193
https://kawalpemilu.org#26789,"MEKAR JAYA, KABANDUNGAN, SUKABUMI, JAWA BARAT",7,79,107,186
https://kawalpemilu.org#26730,"GIRIJAYA, NAGRAK, SUKABUMI, JAWA BARAT",15,74,89,163
https://kawalpemilu.org#30596,"KEDUNGWUNGU, KRANGKENG, INDRAMAYU, JAWA BARAT",17,114,45,159
https://kawalpemilu.org#30643,"SUKALILA, JATIBARANG, INDRAMAYU, JAWA BARAT",1,138,19,157
https://kawalpemilu.org#28898,"CISAGA, CISAGA, CIAMIS, JAWA BARAT",22,60,120,180
https://kawalpemilu.org#92032,"PASALAKAN, SUMBER, CIREBON, JAWA BARAT",4,71,113,184
https://kawalpemilu.org#32406,"MARGAHAYU, BEKASI TIMUR, KOTA BEKASI, JAWA BARAT",97,99,114,213
https://kawalpemilu.org#32333,"JATISARI, BUAHBATU, KOTA BANDUNG, JAWA BARAT",7,109,110,219
https://kawalpemilu.org#32224,"GARUDA, ANDIR, KOTA BANDUNG, JAWA BARAT",20,75,107,182
https://kawalpemilu.org#27609,"BOJONGMALAKA, BALEENDAH, BANDUNG, JAWA BARAT",73,63,101,164
https://kawalpemilu.org#31973,"CITATAH, CIPATAT, BANDUNG BARAT, JAWA BARAT",14,115,121,236
https://kawalpemilu.org#27988,"PADAMUKTI, SUKARESMI, GARUT, JAWA BARAT",14,51,166,217
https://kawalpemilu.org#30783,"TEGALTAMAN, SUKRA, INDRAMAYU, JAWA BARAT",6,164,29,193
https://kawalpemilu.org#28655,"CIOMAS, PANJALU, CIAMIS, JAWA BARAT",26,36,148,184
https://kawalpemilu.org#28599,"CIHARALANG, CIJEUNGJING, CIAMIS, JAWA BARAT",19,58,139,197
https://kawalpemilu.org#31140,"SINDANGKASIH, PURWAKARTA, PURWAKARTA, JAWA BARAT",64,37,144,181
https://kawalpemilu.org#26359,"GOBANG, RUMPIN, BOGOR, JAWA BARAT",23,95,97,192
https://kawalpemilu.org#32173,"NYOMPLONG, WARUDOYONG, KOTA SUKABUMI, JAWA BARAT",8,94,71,165
https://kawalpemilu.org#27740,"SINDANGPALAY, KARANGPAWITAN, GARUT, JAWA BARAT",11,37,142,179
https://kawalpemilu.org#28635,"PAMOKOLAN, CIHAURBEUTI, CIAMIS, JAWA BARAT",13,78,94,172
https://kawalpemilu.org#31989,"CIBURUY, PADALARANG, BANDUNG BARAT, JAWA BARAT",53,85,161,246
https://kawalpemilu.org#27487,"PANGALENGAN, PANGALENGAN, BANDUNG, JAWA BARAT",22,52,97,149
https://kawalpemilu.org#32060,"CICANGKANGGIRANG, SINDANGKERTA, BANDUNG BARAT, JAWA BARAT",19,58,154,212
https://kawalpemilu.org#31401,"AMANSARI, RENGASDENGKLOK, KARAWANG, JAWA BARAT",16,140,68,208
https://kawalpemilu.org#30786,"SUMURADEM TIMUR, SUKRA, INDRAMAYU, JAWA BARAT",3,153,38,191
https://kawalpemilu.org#32040,"GIRIMUKTI, CIPONGKOR, BANDUNG BARAT, JAWA BARAT",9,59,158,217
https://kawalpemilu.org#30608,"KARANGAMPEL KIDUL, KARANGAMPEL, INDRAMAYU, JAWA BARAT",8,84,64,148
https://kawalpemilu.org#28039,"PAAS, PAMEUNGPEUK, GARUT, JAWA BARAT",14,46,153,199
https://kawalpemilu.org#32468,"JATIRAHAYU, PONDOK MELATI, KOTA BEKASI, JAWA BARAT",118,111,78,189
https://kawalpemilu.org#30096,"JATIPAMOR, PANYINGKIRAN, MAJALENGKA, JAWA BARAT",2,66,123,189
https://kawalpemilu.org#28636,"SUKAHAJI, CIHAURBEUTI, CIAMIS, JAWA BARAT",12,34,74,108
https://kawalpemilu.org#29523,"HALIMPU, BEBER, CIREBON, JAWA BARAT",10,78,78,156
https://kawalpemilu.org#27031,"SAYANG, CIANJUR, CIANJUR, JAWA BARAT",42,88,163,251
https://kawalpemilu.org#32440,"CIKIWUL, BANTAR GEBANG, KOTA BEKASI, JAWA BARAT",39,65,115,180
https://kawalpemilu.org#26441,"TELUK PINANG, CIAWI, BOGOR, JAWA BARAT",4,58,183,241
https://kawalpemilu.org#31823,"SUKAMANAH, SUKATANI, BEKASI, JAWA BARAT",5,65,170,235
https://kawalpemilu.org#31933,"CIKALONG, CIKALONGWETAN, BANDUNG BARAT, JAWA BARAT",22,99,91,190
https://kawalpemilu.org#32501,"SUKMAJAYA, SUKMAJAYA, KOTA DEPOK, JAWA BARAT",46,49,101,150
https://kawalpemilu.org#29891,"TALAGA KULON, TALAGA, MAJALENGKA, JAWA BARAT",10,39,205,244
https://kawalpemilu.org#31036,"TANJUNGWANGI, CIJAMBE, SUBANG, JAWA BARAT",5,59,122,181
https://kawalpemilu.org#30046,"PANONGAN, JATITUJUH, MAJALENGKA, JAWA BARAT",4,134,69,203
https://kawalpemilu.org#32457,"JATISAMPURNA, JATISAMPURNA, KOTA BEKASI, JAWA BARAT",45,60,119,179
https://kawalpemilu.org#31027,"WANASARI, CIPUNAGARA, SUBANG, JAWA BARAT",9,142,57,199
https://kawalpemilu.org#31077,"SUKASARI, SUKASARI, SUBANG, JAWA BARAT",24,150,54,204
https://kawalpemilu.org#31738,"TRIDAYA SAKTI, TAMBUN SELATAN, BEKASI, JAWA BARAT",8,111,126,237
https://kawalpemilu.org#28672,"LINGGAPURA, KAWALI, CIAMIS, JAWA BARAT",5,72,114,186
https://kawalpemilu.org#31671,"CENGKONG, PURWASARI, KARAWANG, JAWA BARAT",25,42,125,167
https://kawalpemilu.org#28370,"BANJARWARINGIN, SALOPA, TASIKMALAYA, JAWA BARAT",17,66,118,184
https://kawalpemilu.org#31433,"GEMPOLKARYA, TIRTAJAYA, KARAWANG, JAWA BARAT",13,138,62,200
https://kawalpemilu.org#27226,"SINDANGHAYU, TAKOKAK, CIANJUR, JAWA BARAT",12,108,57,165
https://kawalpemilu.org#32291,"CIGONDEWAH KALER, BANDUNG KULON, KOTA BANDUNG, JAWA BARAT",49,37,201,238
https://kawalpemilu.org#27397,"KERTAMUKTI, HAURWANGI, CIANJUR, JAWA BARAT",26,67,72,139
https://kawalpemilu.org#31460,"KEDUNGJERUK, CIBUAYA, KARAWANG, JAWA BARAT",6,121,70,191
https://kawalpemilu.org#32322,"ANTAPANI TENGAH, ANTAPANI, KOTA BANDUNG, JAWA BARAT",27,86,172,258
https://kawalpemilu.org#27701,"CANGKUANG, CANGKUANG, BANDUNG, JAWA BARAT",19,82,91,173
https://kawalpemilu.org#29887,"ARGASARI, TALAGA, MAJALENGKA, JAWA BARAT",2,62,125,187
https://kawalpemilu.org#32638,"SUKALAKSANA, BUNGURSARI, KOTA TASIKMALAYA, JAWA BARAT",19,61,128,189
https://kawalpemilu.org#26713,"KARANGTENGAH, CIBADAK, SUKABUMI, JAWA BARAT",16,59,139,198
https://kawalpemilu.org#26162,"TLAJUNG UDIK, GUNUNG PUTRI, BOGOR, JAWA BARAT",56,23,122,145
https://kawalpemilu.org#29791,"SARABAU, PLERED, CIREBON, JAWA BARAT",14,137,42,179
https://kawalpemilu.org#30965,"CURUGRENDENG, JALANCAGAK, SUBANG, JAWA BARAT",18,89,111,200
https://kawalpemilu.org#28802,"KARANGPAWITAN, PADAHERANG, PANGANDARAN, JAWA BARAT",19,98,38,136
https://kawalpemilu.org#27258,"SELAGEDANG, PAGELARAN, CIANJUR, JAWA BARAT",15,103,114,217
https://kawalpemilu.org#26265,"JABONMEKAR, PARUNG, BOGOR, JAWA BARAT",2,42,177,219
https://kawalpemilu.org#26792,"WALURAN, WALURAN, SUKABUMI, JAWA BARAT",1,35,147,182
https://kawalpemilu.org#30171,"RANJI WETAN, KASOKANDEL, MAJALENGKA, JAWA BARAT",2,112,113,225
https://kawalpemilu.org#32454,"JATILUHUR, JATIASIH, KOTA BEKASI, JAWA BARAT",25,103,125,228
https://kawalpemilu.org#27381,"PUNCAKWANGI, LELES, CIANJUR, JAWA BARAT",2,115,59,174
https://kawalpemilu.org#26809,"CIEMAS, CIEMAS, SUKABUMI, JAWA BARAT",3,101,60,161
https://kawalpemilu.org#26613,"PELABUHAN RATU, PELABUHAN RATU, SUKABUMI, JAWA BARAT",55,107,109,216
https://kawalpemilu.org#28732,"CISONTROL, RANCAH, CIAMIS, JAWA BARAT",10,124,113,237
https://kawalpemilu.org#31995,"BATUJAJAR TIMUR, BATUJAJAR, BANDUNG BARAT, JAWA BARAT",19,60,202,262
https://kawalpemilu.org#32245,"TAMANSARI, BANDUNG WETAN, KOTA BANDUNG, JAWA BARAT",27,57,105,162
https://kawalpemilu.org#27126,"MULYASARI, MANDE, CIANJUR, JAWA BARAT",6,45,108,153
https://kawalpemilu.org#31699,"HURIP JAYA, BABELAN, BEKASI, JAWA BARAT",2,64,180,244
https://kawalpemilu.org#32421,"HARAPAN JAYA, BEKASI UTARA, KOTA BEKASI, JAWA BARAT",150,72,130,202
https://kawalpemilu.org#28554,"CIPACING, PAGERAGEUNG, TASIKMALAYA, JAWA BARAT",5,39,139,173
https://kawalpemilu.org#32421,"HARAPAN JAYA, BEKASI UTARA, KOTA BEKASI, JAWA BARAT",15,74,148,222
https://kawalpemilu.org#28788,"NEGLASARI, PAMARICAN, CIAMIS, JAWA BARAT",17,36,73,109
https://kawalpemilu.org#27953,"MEKARSARI, CILAWU, GARUT, JAWA BARAT",9,29,205,234
https://kawalpemilu.org#30292,"CIJAMBE, PASEH, SUMEDANG, JAWA BARAT",2,120,75,195
https://kawalpemilu.org#32649,"MEKARSARI, BANJAR, KOTA BANJAR, JAWA BARAT",52,74,110,184
https://kawalpemilu.org#30362,"CIHANJUANG, CIMANGGUNG, SUMEDANG, JAWA BARAT",24,65,181,246
https://kawalpemilu.org#31170,"PLERED, PLERED, PURWAKARTA, JAWA BARAT",2,38,217,255
https://kawalpemilu.org#29998,"SUKARAJA WETAN, JATIWANGI, MAJALENGKA, JAWA BARAT",18,96,104,200
https://kawalpemilu.org#89265,"RANCAEKEK KENCANA, RANCAEKEK, BANDUNG, JAWA BARAT",10,39,135,174
https://kawalpemilu.org#32091,"MUARASARI, BOGOR SELATAN, KOTA BOGOR, JAWA BARAT",25,77,155,232
https://kawalpemilu.org#28283,"CIKUYA, CULAMEGA, TASIKMALAYA, JAWA BARAT",7,19,210,229
https://kawalpemilu.org#30080,"BONGAS WETAN, SUMBERJAYA, MAJALENGKA, JAWA BARAT",19,151,41,192
https://kawalpemilu.org#27417,"CIBEUNYING, CIMENYAN, BANDUNG, JAWA BARAT",91,50,184,234
https://kawalpemilu.org#26509,"CIHERANG, DRAMAGA, BOGOR, JAWA BARAT",25,39,90,129
https://kawalpemilu.org#32559,"PADASUKA, CIMAHI TENGAH, KOTA CIMAHI, JAWA BARAT",37,25,166,191
https://kawalpemilu.org#30854,"LELES, SAGALAHERANG, SUBANG, JAWA BARAT",1,77,162,239
https://kawalpemilu.org#28612,"WERASARI, SADANANYA, CIAMIS, JAWA BARAT",9,84,96,180
https://kawalpemilu.org#31916,"CIHANJUANG, PARONGPONG, BANDUNG BARAT, JAWA BARAT",43,42,124,166
https://kawalpemilu.org#31969,"PAKUHAJI, NGAMPRAH, BANDUNG BARAT, JAWA BARAT",20,163,79,242
https://kawalpemilu.org#30408,"MULYASARI, SUMEDANG UTARA, SUMEDANG, JAWA BARAT",13,88,119,207
https://kawalpemilu.org#32431,"SEPANJANG JAYA, RAWA LUMBU, KOTA BEKASI, JAWA BARAT",32,97,90,187
https://kawalpemilu.org#27447,"LAGADAR, MARGAASIH, BANDUNG, JAWA BARAT",43,37,184,221
https://kawalpemilu.org#32477,"MAMPANG, PANCORAN MAS, KOTA DEPOK, JAWA BARAT",1,47,94,141
https://kawalpemilu.org#27272,"SUKAJAYA, TANGGEUNG, CIANJUR, JAWA BARAT",4,68,98,166
https://kawalpemilu.org#27361,"CIMACAN, CIPANAS, CIANJUR, JAWA BARAT",27,45,110,155
https://kawalpemilu.org#26353,"GUNUNGSARI, PAMIJAHAN, BOGOR, JAWA BARAT",31,42,178,220
https://kawalpemilu.org#26392,"PARUNG PANJANG, PARUNG PANJANG, BOGOR, JAWA BARAT",4,82,92,174
https://kawalpemilu.org#28221,"CIKADU, CIKALONG, TASIKMALAYA, JAWA BARAT",6,29,227,256
https://kawalpemilu.org#26439,"JAMBULUWUK, CIAWI, BOGOR, JAWA BARAT",1,68,176,244
https://kawalpemilu.org#32501,"SUKMAJAYA, SUKMAJAYA, KOTA DEPOK, JAWA BARAT",34,80,143,223
https://kawalpemilu.org#32119,"BALUMBANG JAYA, BOGOR BARAT, KOTA BOGOR, JAWA BARAT",7,93,75,168
https://kawalpemilu.org#27176,"WARUDOYONG, CIKALONGKULON, CIANJUR, JAWA BARAT",3,43,135,178
https://kawalpemilu.org#27394,"MEKARWANGI, HAURWANGI, CIANJUR, JAWA BARAT",1,96,90,186
https://kawalpemilu.org#28794,"SIDAHARJA, PAMARICAN, CIAMIS, JAWA BARAT",4,106,78,184
https://kawalpemilu.org#30992,"COMPRENG, COMPRENG, SUBANG, JAWA BARAT",1,159,64,223
https://kawalpemilu.org#26377,"SETU, JASINGA, BOGOR, JAWA BARAT",8,79,149,228
https://kawalpemilu.org#27666,"CINGCIN, SOREANG, BANDUNG, JAWA BARAT",19,56,201,257
https://kawalpemilu.org#32476,"PANCORAN MAS, PANCORAN MAS, KOTA DEPOK, JAWA BARAT",25,98,107,205
https://kawalpemilu.org#32268,"KEBONGEDANG, BATUNUNGGAL, KOTA BANDUNG, JAWA BARAT",28,109,130,239
https://kawalpemilu.org#32589,"PANYINGKIRAN, INDIHIANG, KOTA TASIKMALAYA, JAWA BARAT",6,53,141,194
https://kawalpemilu.org#32491,"CINANGKA, SAWANGAN, KOTA DEPOK, JAWA BARAT",22,71,106,177
https://kawalpemilu.org#32446,"JATIMAKMUR, PONDOK GEDE, KOTA BEKASI, JAWA BARAT",70,66,124,190
https://kawalpemilu.org#28781,"KARYAMUKTI, BANJARANYAR, CIAMIS, JAWA BARAT",13,73,107,180
https://kawalpemilu.org#27346,"CISARANTEN, CIKADU, CIANJUR, JAWA BARAT",6,111,29,140
https://kawalpemilu.org#32590,"SUKAMAJU KALER, INDIHIANG, KOTA TASIKMALAYA, JAWA BARAT",21,76,147,223
https://kawalpemilu.org#31588,"LEMAHMULYA, MAJALAYA, KARAWANG, JAWA BARAT",7,67,143,210
https://kawalpemilu.org#27619,"MAJAKERTA, MAJALAYA, BANDUNG, JAWA BARAT",4,94,93,187
https://kawalpemilu.org#30514,"SUMBERMULYA, HAURGEULIS, INDRAMAYU, JAWA BARAT",16,131,36,167
https://kawalpemilu.org#27991,"SIMPANG, CIKAJANG, GARUT, JAWA BARAT",18,18,169,187
https://kawalpemilu.org#28810,"KARANGMULYA, PADAHERANG, PANGANDARAN, JAWA BARAT",1,117,84,201
https://kawalpemilu.org#26483,"LEMAH DUHUR, CARINGIN, BOGOR, JAWA BARAT",25,37,151,188
https://kawalpemilu.org#28181,"SUKALAKSANA, SUCINARAJA, GARUT, JAWA BARAT",1,48,157,205
https://kawalpemilu.org#31764,"KARANGASIH, CIKARANG UTARA, BEKASI, JAWA BARAT",107,102,120,222
https://kawalpemilu.org#31233,"SUKAHAJI, TEGALWARU, PURWAKARTA, JAWA BARAT",6,35,123,158
https://kawalpemilu.org#26531,"LULUT, KLAPANUNGGAL, BOGOR, JAWA BARAT",35,8,124,132
https://kawalpemilu.org#30371,"CINTAMULYA, JATINANGOR, SUMEDANG, JAWA BARAT",16,31,149,180
https://kawalpemilu.org#31950,"JATIMEKAR, CIPEUNDEUY, BANDUNG BARAT, JAWA BARAT",12,46,132,178
https://kawalpemilu.org#30024,"KARANGSAMBUNG, KADIPATEN, MAJALENGKA, JAWA BARAT",20,53,142,195
https://kawalpemilu.org#27545,"CIKASUNGKA, CIKANCUNG, BANDUNG, JAWA BARAT",8,62,167,229
https://kawalpemilu.org#32006,"CIPANGERAN, SAGULING, BANDUNG BARAT, JAWA BARAT",1,110,91,201
https://kawalpemilu.org#27237,"BOJONGKASIH, KADUPANDAK, CIANJUR, JAWA BARAT",3,69,77,146
https://kawalpemilu.org#30731,"KRIMUN, LOSARANG, INDRAMAYU, JAWA BARAT",6,179,35,214
https://kawalpemilu.org#32420,"MARGA MULYA, BEKASI UTARA, KOTA BEKASI, JAWA BARAT",1,144,114,258
https://kawalpemilu.org#27493,"MARGAMULYA, PANGALENGAN, BANDUNG, JAWA BARAT",16,83,96,179
https://kawalpemilu.org#31629,"PANGULAH BARU, KOTA BARU, KARAWANG, JAWA BARAT",4,48,193,241
https://kawalpemilu.org#26811,"CIWARU, CIEMAS, SUKABUMI, JAWA BARAT",10,48,131,179
https://kawalpemilu.org#27477,"NEGLASARI, BANJARAN, BANDUNG, JAWA BARAT",14,37,93,130
https://kawalpemilu.org#32202,"SADANGSERANG, COBLONG, KOTA BANDUNG, JAWA BARAT",75,94,134,228
https://kawalpemilu.org#31923,"JAMBUDIPA, CISARUA, BANDUNG BARAT, JAWA BARAT",19,61,159,220
https://kawalpemilu.org#29336,"KARANGTENGAH, MALEBER, KUNINGAN, JAWA BARAT",2,21,171,192
https://kawalpemilu.org#29685,"KEDONGDONG, SUSUKAN, CIREBON, JAWA BARAT",19,144,44,188
https://kawalpemilu.org#31939,"MANDALAMUKTI, CIKALONGWETAN, BANDUNG BARAT, JAWA BARAT",35,34,101,135
https://kawalpemilu.org#30131,"LENGKONG KULON, SINDANGWANGI, MAJALENGKA, JAWA BARAT",3,108,113,221
https://kawalpemilu.org#27558,"LINGGAR, RANCAEKEK, BANDUNG, JAWA BARAT",21,60,172,232
https://kawalpemilu.org#26155,"PABUARAN, CIBINONG, BOGOR, JAWA BARAT",35,136,39,175
https://kawalpemilu.org#26914,"SUKARAJA, SUKARAJA, SUKABUMI, JAWA BARAT",9,28,164,192
https://kawalpemilu.org#27523,"CICALENGKA KULON, CICALENGKA, BANDUNG, JAWA BARAT",21,60,136,196
https://kawalpemilu.org#27679,"TENJOLAYA, PASIRJAMBU, BANDUNG, JAWA BARAT",6,74,141,215
https://kawalpemilu.org#26904,"PARUNGSEAH, SUKABUMI, SUKABUMI, JAWA BARAT",9,46,147,193
https://kawalpemilu.org#27361,"CIMACAN, CIPANAS, CIANJUR, JAWA BARAT",58,64,172,236
https://kawalpemilu.org#31446,"SUNGAIBUNTU, PEDES, KARAWANG, JAWA BARAT",17,135,61,196
https://kawalpemilu.org#31694,"PANTAI MAKMUR, TARUMAJAYA, BEKASI, JAWA BARAT",16,36,108,144
https://kawalpemilu.org#27682,"CIWIDEY, CIWIDEY, BANDUNG, JAWA BARAT",46,83,83,166
https://kawalpemilu.org#31574,"PURWAJAYA, TEMPURAN, KARAWANG, JAWA BARAT",1,106,113,119
https://kawalpemilu.org#26933,"SUKALARANG, SUKALARANG, SUKABUMI, JAWA BARAT",1,42,61,103
https://kawalpemilu.org#31675,"KERTAMUKTI, CILEBAR, KARAWANG, JAWA BARAT",3,91,84,175
https://kawalpemilu.org#26924,"SASAGARAN, KEBON PEDES, SUKABUMI, JAWA BARAT",9,50,117,167
https://kawalpemilu.org#30105,"CISAMBENG, PALASAH, MAJALENGKA, JAWA BARAT",6,98,80,178
https://kawalpemilu.org#30400,"CIHERANG, SUMEDANG SELATAN, SUMEDANG, JAWA BARAT",14,99,77,176
https://kawalpemilu.org#32416,"KALIABANG TENGAH, BEKASI UTARA, KOTA BEKASI, JAWA BARAT",54,84,114,198
https://kawalpemilu.org#26247,"PABUARAN, SUKAMAKMUR, BOGOR, JAWA BARAT",2,41,184,225
https://kawalpemilu.org#31020,"JATI, CIPUNAGARA, SUBANG, JAWA BARAT",13,149,78,227
https://kawalpemilu.org#31056,"TANJUNGSARI TIMUR, CIKAUM, SUBANG, JAWA BARAT",17,154,105,259
https://kawalpemilu.org#27641,"SUKAMANTRI, PASEH, BANDUNG, JAWA BARAT",41,125,121,246
https://kawalpemilu.org#30792,"GANTAR, GANTAR, INDRAMAYU, JAWA BARAT",9,70,121,191
https://kawalpemilu.org#26288,"BOJONGBARU, BOJONG GEDE, BOGOR, JAWA BARAT",29,48,129,177
https://kawalpemilu.org#27608,"WARGAMEKAR, BALEENDAH, BANDUNG, JAWA BARAT",1,57,107,164
https://kawalpemilu.org#32212,"CIRANGRANG, BABAKAN CIPARAY, KOTA BANDUNG, JAWA BARAT",26,83,171,254
https://kawalpemilu.org#31248,"NANGERANG, WANAYASA, PURWAKARTA, JAWA BARAT",1,36,161,197
https://kawalpemilu.org#32674,"WARINGINSARI, LANGENSARI, KOTA BANJAR, JAWA BARAT",7,108,58,166
https://kawalpemilu.org#30740,"MUNTUR, LOSARANG, INDRAMAYU, JAWA BARAT",8,104,64,168
https://kawalpemilu.org#26324,"SITU UDIK, CIBUNGBULANG, BOGOR, JAWA BARAT",37,42,182,224
https://kawalpemilu.org#31389,"KLARI, KLARI, KARAWANG, JAWA BARAT",15,92,143,235
https://kawalpemilu.org#32017,"TANJUNGWANGI, CIHAMPELAS, BANDUNG BARAT, JAWA BARAT",27,64,102,166
https://kawalpemilu.org#26228,"CILEUNGSI KIDUL, CILEUNGSI, BOGOR, JAWA BARAT",68,90,136,226
https://kawalpemilu.org#30358,"SAWAHDADAP, CIMANGGUNG, SUMEDANG, JAWA BARAT",8,10,125,135
https://kawalpemilu.org#26887,"GEDEPANGRANGO, KADUDAMPIT, SUKABUMI, JAWA BARAT",2,45,152,197
https://kawalpemilu.org#32293,"CIGONDEWAH RAHAYU, BANDUNG KULON, KOTA BANDUNG, JAWA BARAT",4,58,193,251
https://kawalpemilu.org#31880,"JAYASAMPURNA, SERANG BARU, BEKASI, JAWA BARAT",15,45,187,232
https://kawalpemilu.org#30955,"MULYASARI, PAMANUKAN, SUBANG, JAWA BARAT",15,156,79,235
https://kawalpemilu.org#31917,"CIHANJUANG RAHAYU, PARONGPONG, BANDUNG BARAT, JAWA BARAT",35,74,68,142
https://kawalpemilu.org#30706,"CEMARA, CANTIGI, INDRAMAYU, JAWA BARAT",7,173,29,202
https://kawalpemilu.org#31494,"JATIRAGAS, JATISARI, KARAWANG, JAWA BARAT",10,101,147,248
https://kawalpemilu.org#84884,"PANGURANGAN KULON, PANGURAGAN, CIREBON, JAWA BARAT",1,136,35,171
https://kawalpemilu.org#28336,"MANDALASARI, PUSPAHIANG, TASIKMALAYA, JAWA BARAT",3,50,144,194
https://kawalpemilu.org#30250,"SUNDAMEKAR, CISITU, SUMEDANG, JAWA BARAT",6,153,82,235
https://kawalpemilu.org#28281,"TOBLONGAN, BOJONGASIH, TASIKMALAYA, JAWA BARAT",4,20,176,196
https://kawalpemilu.org#28004,"TALAGAJAYA, BANJARWANGI, GARUT, JAWA BARAT",9,37,154,191
https://kawalpemilu.org#32001,"SELACAU, BATUJAJAR, BANDUNG BARAT, JAWA BARAT",21,73,121,194
https://kawalpemilu.org#32209,"SUKAHAJI, BABAKAN CIPARAY, KOTA BANDUNG, JAWA BARAT",61,85,149,234
https://kawalpemilu.org#89218,"JAYARAHARJA, SUKAJAYA, BOGOR, JAWA BARAT",4,67,119,186
https://kawalpemilu.org#31512,"RAWAGEMPOL WETAN, CILAMAYA WETAN, KARAWANG, JAWA BARAT",11,107,89,196
https://kawalpemilu.org#28387,"CIAMPANAN, CINEAM, TASIKMALAYA, JAWA BARAT",9,114,98,212
https://kawalpemilu.org#29396,"BARISAN, LOSARI, CIREBON, JAWA BARAT",12,104,42,146
https://kawalpemilu.org#31402,"KARYASARI, RENGASDENGKLOK, KARAWANG, JAWA BARAT",36,96,95,191
https://kawalpemilu.org#32202,"SADANGSERANG, COBLONG, KOTA BANDUNG, JAWA BARAT",66,108,109,217
https://kawalpemilu.org#29490,"ASTANAJAPURA, ASTANAJAPURA, CIREBON, JAWA BARAT",12,141,58,199
https://kawalpemilu.org#30735,"JANGGA, LOSARANG, INDRAMAYU, JAWA BARAT",9,110,106,216
https://kawalpemilu.org#31887,"CIBARUSAH JAYA, CIBARUSAH, BEKASI, JAWA BARAT",12,80,123,203
https://kawalpemilu.org#27277,"SUKAJADI, CIBINONG, CIANJUR, JAWA BARAT",3,77,130,207
https://kawalpemilu.org#30158,"WANGKELANG, CINGAMBUL, MAJALENGKA, JAWA BARAT",9,47,109,156
https://kawalpemilu.org#29583,"CEMPAKA, PLUMBON, CIREBON, JAWA BARAT",14,149,44,193
https://kawalpemilu.org#31580,"JAYANEGARA, TEMPURAN, KARAWANG, JAWA BARAT",1,65,186,251
https://kawalpemilu.org#32564,"CITEUREUP, CIMAHI UTARA, KOTA CIMAHI, JAWA BARAT",64,109,136,245
https://kawalpemilu.org#27615,"BIRU, MAJALAYA, BANDUNG, JAWA BARAT",30,50,106,156
https://kawalpemilu.org#32306,"MEKARWANGI, BOJONGLOA KIDUL, KOTA BANDUNG, JAWA BARAT",21,86,98,184
https://kawalpemilu.org#32352,"PASIR ENDAH, UJUNG BERUNG, KOTA BANDUNG, JAWA BARAT",26,63,165,228
https://kawalpemilu.org#27890,"LEWOBARU, MALANGBONG, GARUT, JAWA BARAT",8,51,154,205
https://kawalpemilu.org#32086,"CIKARET, BOGOR SELATAN, KOTA BOGOR, JAWA BARAT",29,27,174,201
https://kawalpemilu.org#32085,"MULYAHARJA, BOGOR SELATAN, KOTA BOGOR, JAWA BARAT",34,28,185,213
https://kawalpemilu.org#27721,"SUKAMENTRI, GARUT KOTA, GARUT, JAWA BARAT",10,21,117,138
https://kawalpemilu.org#32326,"WATES, BANDUNG KIDUL, KOTA BANDUNG, JAWA BARAT",6,78,106,184
https://kawalpemilu.org#26331,"CIMANGGU II, CIBUNGBULANG, BOGOR, JAWA BARAT",19,105,119,224
https://kawalpemilu.org#28685,"KARANGPANINGAL, PANAWANGAN, CIAMIS, JAWA BARAT",3,73,105,178
https://kawalpemilu.org#28027,"MEKARWANGI, CIHURIP, GARUT, JAWA BARAT",15,106,71,177
https://kawalpemilu.org#29987,"HEULEUT, LEUWIMUNDING, MAJALENGKA, JAWA BARAT",12,91,53,144
https://kawalpemilu.org#32242,"LEDENG, CIDADAP, KOTA BANDUNG, JAWA BARAT",6,85,148,233
https://kawalpemilu.org#28301,"CUKANGKAWUNG, SODONGHILIR, TASIKMALAYA, JAWA BARAT",4,30,170,200
https://kawalpemilu.org#31221,"TEGALDATAR, MANIIS, PURWAKARTA, JAWA BARAT",10,51,88,139
https://kawalpemilu.org#26872,"SUKAMANAH, CISAAT, SUKABUMI, JAWA BARAT",30,54,161,215
https://kawalpemilu.org#26945,"CIBADAK, PABUARAN, SUKABUMI, JAWA BARAT",16,133,100,233
https://kawalpemilu.org#26765,"BANGBAYANG, CICURUG, SUKABUMI, JAWA BARAT",6,74,185,259
https://kawalpemilu.org#29867,"SUKASARI, CIKIJING, MAJALENGKA, JAWA BARAT",2,74,159,233
https://kawalpemilu.org#32399,"SUNYARAGI, KESAMBI, KOTA CIREBON, JAWA BARAT",34,58,143,201
https://kawalpemilu.org#30963,"TAMBAKAN, JALANCAGAK, SUBANG, JAWA BARAT",19,109,109,218
https://kawalpemilu.org#27124,"CIKIDANGBAYABANG, MANDE, CIANJUR, JAWA BARAT",6,20,135,155
https://kawalpemilu.org#29552,"PERBUTULAN, SUMBER, CIREBON, JAWA BARAT",12,58,137,195
https://kawalpemilu.org#29070,"CIJOHO, KUNINGAN, KUNINGAN, JAWA BARAT",18,50,170,220
https://kawalpemilu.org#26553,"MEKARSARI, RANCA BUNGUR, BOGOR, JAWA BARAT",16,33,118,151
https://kawalpemilu.org#27885,"CIKARANG, MALANGBONG, GARUT, JAWA BARAT",8,56,181,237
https://kawalpemilu.org#27886,"SAKAWAYANG, MALANGBONG, GARUT, JAWA BARAT",6,15,192,207
https://kawalpemilu.org#26783,"GUNUNGENDUT, KALAPA NUNGGAL, SUKABUMI, JAWA BARAT",8,27,109,136
https://kawalpemilu.org#89246,"TANJUNGSARI, AGRABINTA, CIANJUR, JAWA BARAT",12,86,56,142
https://kawalpemilu.org#29966,"BABAKAN KAREO, RAJAGALUH, MAJALENGKA, JAWA BARAT",4,123,70,193
https://kawalpemilu.org#29998,"SUKARAJA WETAN, JATIWANGI, MAJALENGKA, JAWA BARAT",12,94,111,205
https://kawalpemilu.org#26500,"CIOMAS, CIOMAS, BOGOR, JAWA BARAT",14,42,110,152
https://kawalpemilu.org#27203,"SUKAKARYA, SUKANAGARA, CIANJUR, JAWA BARAT",10,65,67,132
https://kawalpemilu.org#28539,"CIAWI, CIAWI, TASIKMALAYA, JAWA BARAT",4,67,165,232
https://kawalpemilu.org#31080,"WANAJAYA, TAMBAKDAHAN, SUBANG, JAWA BARAT",4,174,31,205
https://kawalpemilu.org#32164,"SUBANGJAYA, CIKOLE, KOTA SUKABUMI, JAWA BARAT",50,107,159,266
https://kawalpemilu.org#30989,"JATIREJA, COMPRENG, SUBANG, JAWA BARAT",10,102,50,152
https://kawalpemilu.org#27419,"MANDALAMEKAR, CIMENYAN, BANDUNG, JAWA BARAT",21,114,100,214
https://kawalpemilu.org#32229,"PAJAJARAN, CICENDO, KOTA BANDUNG, JAWA BARAT",73,71,87,158
https://kawalpemilu.org#32616,"TAMANJAYA, TAMANSARI, KOTA TASIKMALAYA, JAWA BARAT",23,15,123,138
https://kawalpemilu.org#32396,"PEKALANGAN, PEKALIPAN, KOTA CIREBON, JAWA BARAT",18,90,61,151
https://kawalpemilu.org#89242,"MEKARLAKSANA, SINDANGBARANG, CIANJUR, JAWA BARAT",8,63,85,148
https://kawalpemilu.org#28513,"KUDADEPA, SUKAHENING, TASIKMALAYA, JAWA BARAT",9,101,126,227
https://kawalpemilu.org#26747,"PARAKAN SALAK, PARAKAN SALAK, SUKABUMI, JAWA BARAT",7,37,81,118
https://kawalpemilu.org#32123,"CILENDEK TIMUR, BOGOR BARAT, KOTA BOGOR, JAWA BARAT",48,64,152,216
https://kawalpemilu.org#32209,"SUKAHAJI, BABAKAN CIPARAY, KOTA BANDUNG, JAWA BARAT",33,85,110,195
https://kawalpemilu.org#32134,"KEDUNGHALANG, BOGOR UTARA, KOTA BOGOR, JAWA BARAT",31,38,121,159
https://kawalpemilu.org#27417,"CIBEUNYING, CIMENYAN, BANDUNG, JAWA BARAT",17,58,60,118
https://kawalpemilu.org#27699,"BANDASARI, CANGKUANG, BANDUNG, JAWA BARAT",2,60,85,145
https://kawalpemilu.org#27716,"KOTA KULON, GARUT KOTA, GARUT, JAWA BARAT",6,41,184,225
https://kawalpemilu.org#32159,"CIKOLE, CIKOLE, KOTA SUKABUMI, JAWA BARAT",6,80,151,231
https://kawalpemilu.org#30719,"RAMBATAN KULON, LOHBENER, INDRAMAYU, JAWA BARAT",15,196,37,233
https://kawalpemilu.org#31899,"KAYUAMBON, LEMBANG, BANDUNG BARAT, JAWA BARAT",24,147,125,272
https://kawalpemilu.org#31427,"KUTAAMPEL, BATUJAYA, KARAWANG, JAWA BARAT",19,100,113,213
https://kawalpemilu.org#32444,"JATIWARINGIN, PONDOK GEDE, KOTA BEKASI, JAWA BARAT",94,78,153,231
https://kawalpemilu.org#31134,"RANGDU, PUSAKAJAYA, SUBANG, JAWA BARAT",9,166,44,210
https://kawalpemilu.org#30088,"PANJALIN KIDUL, SUMBERJAYA, MAJALENGKA, JAWA BARAT",2,143,32,175
https://kawalpemilu.org#29192,"CIPASUNG, DARMA, KUNINGAN, JAWA BARAT",2,45,152,197
https://kawalpemilu.org#27040,"JAMBUDIPA, WARUNGKONDANG, CIANJUR, JAWA BARAT",20,75,80,155
https://kawalpemilu.org#31061,"SINDANGSARI, CIKAUM, SUBANG, JAWA BARAT",12,169,42,211
https://kawalpemilu.org#27041,"CISARANDI, WARUNGKONDANG, CIANJUR, JAWA BARAT",6,61,126,187
https://kawalpemilu.org#28440,"SUKAMENAK, SUKARAME, TASIKMALAYA, JAWA BARAT",12,48,111,159
https://kawalpemilu.org#26899,"MEKARJAYA, CARINGIN, SUKABUMI, JAWA BARAT",10,38,121,159
https://kawalpemilu.org#28682,"SADAPAINGAN, PANAWANGAN, CIAMIS, JAWA BARAT",7,93,68,161
https://kawalpemilu.org#31834,"SETIALAKSANA, CABANGBUNGIN, BEKASI, JAWA BARAT",11,120,96,216
https://kawalpemilu.org#28576,"KERTASARI, CIAMIS, CIAMIS, JAWA BARAT",29,55,106,161
https://kawalpemilu.org#28824,"PURBAHAYU, PANGANDARAN, PANGANDARAN, JAWA BARAT",11,142,21,163
https://kawalpemilu.org#28611,"SADANANYA, SADANANYA, CIAMIS, JAWA BARAT",19,33,156,189
https://kawalpemilu.org#27251,"BUNIWANGI, PAGELARAN, CIANJUR, JAWA BARAT",3,26,211,237
https://kawalpemilu.org#26912,"SELAAWI, SUKARAJA, SUKABUMI, JAWA BARAT",17,40,102,142
https://kawalpemilu.org#29362,"SANGKANHURIP, CIGANDAMEKAR, KUNINGAN, JAWA BARAT",5,92,120,212
https://kawalpemilu.org#31125,"SANCA, CIATER, SUBANG, JAWA BARAT",12,94,67,161
https://kawalpemilu.org#28799,"KARANGSARI, PADAHERANG, PANGANDARAN, JAWA BARAT",16,158,48,206
https://kawalpemilu.org#30878,"WANAREJA, SUBANG, SUBANG, JAWA BARAT",13,106,50,156
https://kawalpemilu.org#27879,"GIRIJAYA, KERSAMANAH, GARUT, JAWA BARAT",2,50,161,211
https://kawalpemilu.org#27379,"WALAHIR, LELES, CIANJUR, JAWA BARAT",2,156,87,243
https://kawalpemilu.org#29793,"CANGKRING, PLERED, CIREBON, JAWA BARAT",11,124,83,207
https://kawalpemilu.org#30355,"TEGALMANGGUNG, CIMANGGUNG, SUMEDANG, JAWA BARAT",6,76,113,189
https://kawalpemilu.org#28109,"PAKENJENG, PAMULIHAN, GARUT, JAWA BARAT",10,32,144,176
https://kawalpemilu.org#32488,"PASIR PUTIH, SAWANGAN, KOTA DEPOK, JAWA BARAT",82,82,20,102
https://kawalpemilu.org#27061,"SELAGEDANG, CIBEBER, CIANJUR, JAWA BARAT",16,79,105,184
https://kawalpemilu.org#26283,"SEMPLAK BARAT, KEMANG, BOGOR, JAWA BARAT",18,36,186,222
https://kawalpemilu.org#26352,"CIASIHAN, PAMIJAHAN, BOGOR, JAWA BARAT",15,12,157,169
https://kawalpemilu.org#32253,"PELINDUNG HEWAN, ASTANA ANYAR, KOTA BANDUNG, JAWA BARAT",22,61,154,215
https://kawalpemilu.org#26770,"PONDOKASO TENGAH, CIDAHU, SUKABUMI, JAWA BARAT",2,44,108,152
https://kawalpemilu.org#27094,"CIBARENGKOK, BOJONGPICUNG, CIANJUR, JAWA BARAT",14,62,143,205
https://kawalpemilu.org#31344,"SUMBERSARI, KIARAPEDES, PURWAKARTA, JAWA BARAT",4,89,154,243
https://kawalpemilu.org#32290,"CARINGIN, BANDUNG KULON, KOTA BANDUNG, JAWA BARAT",25,65,135,200
https://kawalpemilu.org#31353,"NAGASARI, KARAWANG BARAT, KARAWANG, JAWA BARAT",46,116,104,220
https://kawalpemilu.org#27100,"SUKARATU, BOJONGPICUNG, CIANJUR, JAWA BARAT",1,56,150,208
https://kawalpemilu.org#26467,"SUKAMANAH, MEGAMENDUNG, BOGOR, JAWA BARAT",18,37,178,215
https://kawalpemilu.org#26780,"MAKASARI, KALAPA NUNGGAL, SUKABUMI, JAWA BARAT",12,29,127,156
https://kawalpemilu.org#26433,"SINGABANGSA, TENJO, BOGOR, JAWA BARAT",9,92,117,209
https://kawalpemilu.org#31465,"KEDUNGJAYA, CIBUAYA, KARAWANG, JAWA BARAT",9,96,99,195
https://kawalpemilu.org#32342,"CISARANTEN KULON, ARCAMANIK, KOTA BANDUNG, JAWA BARAT",41,75,176,251
https://kawalpemilu.org#32092,"GENTENG, BOGOR SELATAN, KOTA BOGOR, JAWA BARAT",13,54,131,185
https://kawalpemilu.org#31299,"CIBUNGUR, BUNGURSARI, PURWAKARTA, JAWA BARAT",2,60,126,186
https://kawalpemilu.org#29871,"SINDANG, CIKIJING, MAJALENGKA, JAWA BARAT",8,68,117,185
https://kawalpemilu.org#27050,"MEKARWANGI, WARUNGKONDANG, CIANJUR, JAWA BARAT",14,43,106,149
https://kawalpemilu.org#26144,"PONDOK RAJEG, CIBINONG, BOGOR, JAWA BARAT",43,76,163,239
https://kawalpemilu.org#32559,"PADASUKA, CIMAHI TENGAH, KOTA CIMAHI, JAWA BARAT",6,58,148,206
https://kawalpemilu.org#31768,"SIMPANGAN, CIKARANG UTARA, BEKASI, JAWA BARAT",43,100,69,169
https://kawalpemilu.org#28631,"SUMBERJAYA, CIHAURBEUTI, CIAMIS, JAWA BARAT",21,33,138,171
https://kawalpemilu.org#27539,"CIHERANG, NAGREG, BANDUNG, JAWA BARAT",16,47,61,108
https://kawalpemilu.org#29392,"CILEDUG TENGAH, CILEDUG, CIREBON, JAWA BARAT",7,133,79,212
https://kawalpemilu.org#32557,"KARANGMEKAR, CIMAHI TENGAH, KOTA CIMAHI, JAWA BARAT",19,93,119,212
https://kawalpemilu.org#30598,"LUWUNGGESIK, KRANGKENG, INDRAMAYU, JAWA BARAT",3,117,50,167
https://kawalpemilu.org#32284,"SUKAPADA, CIBEUNYING KIDUL, KOTA BANDUNG, JAWA BARAT",21,71,181,252
https://kawalpemilu.org#26656,"WANAJAYA, CISOLOK, SUKABUMI, JAWA BARAT",8,84,84,168
https://kawalpemilu.org#26815,"MANDRAJAYA, CIEMAS, SUKABUMI, JAWA BARAT",6,68,153,221
https://kawalpemilu.org#32463,"PADURENAN, MUSTIKA JAYA, KOTA BEKASI, JAWA BARAT",93,104,103,207
https://kawalpemilu.org#927644,"BABAKAN ASIH, BOJONGLOA KALER, KOTA BANDUNG, JAWA BARAT",9,79,156,235
https://kawalpemilu.org#32501,"SUKMAJAYA, SUKMAJAYA, KOTA DEPOK, JAWA BARAT",75,78,92,170
https://kawalpemilu.org#31486,"DAWUAN BARAT, CIKAMPEK, KARAWANG, JAWA BARAT",1,98,121,219
https://kawalpemilu.org#29073,"CIRENDANG, KUNINGAN, KUNINGAN, JAWA BARAT",7,68,159,227
https://kawalpemilu.org#28818,"BANJARHARJA, KALIPUCANG, PANGANDARAN, JAWA BARAT",15,112,22,134
https://kawalpemilu.org#29935,"BABAKAN JAWA, MAJALENGKA, MAJALENGKA, JAWA BARAT",17,118,78,196
https://kawalpemilu.org#28380,"MANDALAMEKAR, JATIWARAS, TASIKMALAYA, JAWA BARAT",4,19,164,183
https://kawalpemilu.org#30535,"DRUNTEN KULON, GABUSWETAN, INDRAMAYU, JAWA BARAT",8,167,43,210
https://kawalpemilu.org#28731,"CILEUNGSIR, RANCAH, CIAMIS, JAWA BARAT",7,123,98,221
https://kawalpemilu.org#31825,"SUKAASIH, SUKATANI, BEKASI, JAWA BARAT",3,50,134,184
https://kawalpemilu.org#31950,"JATIMEKAR, CIPEUNDEUY, BANDUNG BARAT, JAWA BARAT",14,58,94,152
https://kawalpemilu.org#32563,"CIBABAT, CIMAHI UTARA, KOTA CIMAHI, JAWA BARAT",109,70,130,200
https://kawalpemilu.org#28581,"SINDANGRASA, CIAMIS, CIAMIS, JAWA BARAT",3,43,125,168
https://kawalpemilu.org#30716,"LOHBENER, LOHBENER, INDRAMAYU, JAWA BARAT",12,134,101,235
https://kawalpemilu.org#40820,"SIDOREJO, COMAL, PEMALANG, JAWA TENGAH",21,161,20,181
https://kawalpemilu.org#40013,"JUNGSEMI, KANGKUNG, KENDAL, JAWA TENGAH",13,138,15,153
https://kawalpemilu.org#40493,"KETITANGLOR, BOJONG, PEKALONGAN, JAWA TENGAH",3,143,60,203
https://kawalpemilu.org#36649,"TREMES, SIDOHARJO, WONOGIRI, JAWA TENGAH",9,133,34,167
https://kawalpemilu.org#38648,"MEJOBO, MEJOBO, KUDUS, JAWA TENGAH",8,136,52,188
https://kawalpemilu.org#36766,"SANAN, GIRIMARTO, WONOGIRI, JAWA TENGAH",9,112,7,119
https://kawalpemilu.org#41509,"PURWOSARI, LAWEYAN, KOTA SURAKARTA, JAWA TENGAH",6,151,68,221
https://kawalpemilu.org#35323,"BUMIREJO, MUNGKID, MAGELANG, JAWA TENGAH",14,90,39,129
https://kawalpemilu.org#37298,"SOBO, GEYER, GROBOGAN, JAWA TENGAH",21,164,7,171
https://kawalpemilu.org#39657,"TANJUNGSARI, TLOGOMULYO, TEMANGGUNG, JAWA TENGAH",2,117,13,130
https://kawalpemilu.org#84921,"ADIMULYA, WANAREJA, CILACAP, JAWA TENGAH",14,70,96,166
https://kawalpemilu.org#36074,"TUMPUKAN, KARANGDOWO, KLATEN, JAWA TENGAH",8,132,19,151
https://kawalpemilu.org#35816,"SEMAWUNG, ANDONG, BOYOLALI, JAWA TENGAH",3,172,12,184
https://kawalpemilu.org#36301,"KARAKAN, WERU, SUKOHARJO, JAWA TENGAH",5,167,21,188
https://kawalpemilu.org#39108,"BINTORO, DEMAK, DEMAK, JAWA TENGAH",34,122,69,191
https://kawalpemilu.org#35804,"SEMPU, ANDONG, BOYOLALI, JAWA TENGAH",9,163,30,193
https://kawalpemilu.org#37717,"BERGOLO, NGAWEN, BLORA, JAWA TENGAH",2,114,16,130
https://kawalpemilu.org#34279,"TUNJUNGSETO, SEMPOR, KEBUMEN, JAWA TENGAH",15,132,24,156
https://kawalpemilu.org#33338,"PURWANEGARA, PURWOKERTO UTARA, BANYUMAS, JAWA TENGAH",7,160,78,238
https://kawalpemilu.org#36459,"NGADIREJO, KARTASURA, SUKOHARJO, JAWA TENGAH",11,185,63,248
https://kawalpemilu.org#33020,"TINGGARJAYA, JATILAWANG, BANYUMAS, JAWA TENGAH",24,158,40,198
https://kawalpemilu.org#40375,"DONOWANGUN, TALUN, PEKALONGAN, JAWA TENGAH",2,78,127,205
https://kawalpemilu.org#38946,"KURIPAN, KARANGAWEN, DEMAK, JAWA TENGAH",7,96,115,211
https://kawalpemilu.org#40772,"ASEMDOYONG, TAMAN, PEMALANG, JAWA TENGAH",30,172,27,199
https://kawalpemilu.org#40273,"KALIBELUK, WARUNGASEM, BATANG, JAWA TENGAH",14,159,39,198
https://kawalpemilu.org#35294,"PODOSOKO, SAWANGAN, MAGELANG, JAWA TENGAH",18,40,48,88
https://kawalpemilu.org#36876,"TOHKUNING, KARANGPANDAN, KARANGANYAR, JAWA TENGAH",3,199,22,221
https://kawalpemilu.org#33453,"KARANGREJA, KUTASARI, PURBALINGGA, JAWA TENGAH",9,180,59,239
https://kawalpemilu.org#39352,"TEMPURAN, BRINGIN, SEMARANG, JAWA TENGAH",4,166,19,185
https://kawalpemilu.org#40670,"MAJALANGU, WATUKUMPUL, PEMALANG, JAWA TENGAH",23,103,51,154
https://kawalpemilu.org#40216,"SENGON, SUBAH, BATANG, JAWA TENGAH",23,103,104,207
https://kawalpemilu.org#33966,"SIDODADI, PURING, KEBUMEN, JAWA TENGAH",4,156,32,188
https://kawalpemilu.org#87408,"BULAKSARI, BANTARSARI, CILACAP, JAWA TENGAH",36,116,48,164
https://kawalpemilu.org#33172,"KEDUNGURANG, GUMELAR, BANYUMAS, JAWA TENGAH",16,170,24,194
https://kawalpemilu.org#40329,"LAMBUR, KANDANGSERANG, PEKALONGAN, JAWA TENGAH",10,134,21,155
https://kawalpemilu.org#32876,"CIBEUNYING, MAJENANG, CILACAP, JAWA TENGAH",5,106,71,177
https://kawalpemilu.org#33946,"WALUYOREJO, PURING, KEBUMEN, JAWA TENGAH",13,146,16,162
https://kawalpemilu.org#37210,"DAWUNG, JENAR, SRAGEN, JAWA TENGAH",10,101,64,165
https://kawalpemilu.org#33319,"PURWOKERTO KULON, PURWOKERTO SELATAN, BANYUMAS, JAWA TENGAH",13,167,50,217
https://kawalpemilu.org#33761,"PINGIT, RAKIT, BANJARNEGARA, JAWA TENGAH",3,69,134,203
https://kawalpemilu.org#40774,"WANAREJAN UTARA, TAMAN, PEMALANG, JAWA TENGAH",10,145,59,204
https://kawalpemilu.org#38659,"KLALING, JEKULO, KUDUS, JAWA TENGAH",19,144,37,181
https://kawalpemilu.org#34317,"PENIMBUN, KARANGGAYAM, KEBUMEN, JAWA TENGAH",8,157,6,163
https://kawalpemilu.org#37511,"TANGGUNGHARJO, TANGGUNGHARJO, GROBOGAN, JAWA TENGAH",22,132,34,166
https://kawalpemilu.org#35007,"WONOREJO, SELOMERTO, WONOSOBO, JAWA TENGAH",1,193,40,233
https://kawalpemilu.org#40995,"DEPOK, PANGKAH, TEGAL, JAWA TENGAH",6,121,87,208
https://kawalpemilu.org#36619,"PURWOREJO, WONOGIRI, WONOGIRI, JAWA TENGAH",2,193,34,227
https://kawalpemilu.org#41310,"BREBES, BREBES, BREBES, JAWA TENGAH",5,115,107,222
https://kawalpemilu.org#32703,"BULUPAYUNG, KESUGIHAN, CILACAP, JAWA TENGAH",13,173,28,201
https://kawalpemilu.org#39804,"KALIBARENG, PATEAN, KENDAL, JAWA TENGAH",1,142,35,177
https://kawalpemilu.org#37701,"SENDANGWUNGU, BANJAREJO, BLORA, JAWA TENGAH",4,169,52,221
https://kawalpemilu.org#32736,"PAGUBUGAN, BINANGUN, CILACAP, JAWA TENGAH",2,153,11,164
https://kawalpemilu.org#41274,"KEBOGADUNG, JATIBARANG, BREBES, JAWA TENGAH",3,121,55,176
https://kawalpemilu.org#41860,"MARGADANA, MARGADANA, KOTA TEGAL, JAWA TENGAH",39,110,100,210
https://kawalpemilu.org#41408,"DUKUHLO, BULAKAMBA, BREBES, JAWA TENGAH",9,117,32,149
https://kawalpemilu.org#41627,"SIWALAN, GAYAM SARI, KOTA SEMARANG, JAWA TENGAH",10,212,23,235
https://kawalpemilu.org#41821,"BANYURIP, PEKALONGAN SELATAN, KOTA PEKALONGAN, JAWA TENGAH",15,189,14,203
https://kawalpemilu.org#37071,"BANARAN, SAMBUNGMACAN, SRAGEN, JAWA TENGAH",11,65,0,65
https://kawalpemilu.org#35157,"SUKOHARJO, SUKOHARJO, WONOSOBO, JAWA TENGAH",8,122,27,149
https://kawalpemilu.org#38394,"JAMBEAN KIDUL, MARGOREJO, PATI, JAWA TENGAH",7,191,14,205
https://kawalpemilu.org#34655,"PURWOSARI, KUTOARJO, PURWOREJO, JAWA TENGAH",9,101,44,145
https://kawalpemilu.org#38089,"TERJAN, KRAGAN, REMBANG, JAWA TENGAH",7,147,41,188
https://kawalpemilu.org#35676,"SALAKAN, TERAS, BOYOLALI, JAWA TENGAH",2,181,17,198
https://kawalpemilu.org#37355,"TANJUNGHARJO, NGARINGAN, GROBOGAN, JAWA TENGAH",10,149,17,166
https://kawalpemilu.org#34650,"KEBONDALEM, KUTOARJO, PURWOREJO, JAWA TENGAH",1,119,48,167
https://kawalpemilu.org#37322,"PAKIS, KRADENAN, GROBOGAN, JAWA TENGAH",14,151,27,178
https://kawalpemilu.org#32721,"KALIKUDI, ADIPALA, CILACAP, JAWA TENGAH",10,135,39,174
https://kawalpemilu.org#33003,"WANGON, WANGON, BANYUMAS, JAWA TENGAH",5,122,95,217
https://kawalpemilu.org#39509,"NGLOROG, PRINGSURAT, TEMANGGUNG, JAWA TENGAH",9,182,11,193
https://kawalpemilu.org#37222,"KEDUNGJATI, KEDUNGJATI, GROBOGAN, JAWA TENGAH",3,129,52,181
https://kawalpemilu.org#84940,"CINYAWANG, PATIMUAN, CILACAP, JAWA TENGAH",1,151,47,198
https://kawalpemilu.org#33134,"KEDUNGWULUH KIDUL, PATIKRAJA, BANYUMAS, JAWA TENGAH",8,38,93,131
https://kawalpemilu.org#41709,"PADANGSARI, BANYUMANIK, KOTA SEMARANG, JAWA TENGAH",31,184,55,239
https://kawalpemilu.org#36601,"KELORAN, SELOGIRI, WONOGIRI, JAWA TENGAH",1,75,39,114
https://kawalpemilu.org#39407,"LANGENSARI, UNGARAN BARAT, SEMARANG, JAWA TENGAH",15,207,33,240
https://kawalpemilu.org#34569,"DOPLANG, PURWOREJO, PURWOREJO, JAWA TENGAH",9,109,75,184
https://kawalpemilu.org#41204,"TERLAYA, BANTARKAWUNG, BREBES, JAWA TENGAH",20,128,16,144
https://kawalpemilu.org#41545,"KADIPIRO, BANJARSARI, KOTA SURAKARTA, JAWA TENGAH",12,101,32,133
https://kawalpemilu.org#87407,"RAWAJAYA, BANTARSARI, CILACAP, JAWA TENGAH",28,80,63,143
https://kawalpemilu.org#41438,"CIKEUSAL LOR, KETANGGUNGAN, BREBES, JAWA TENGAH",7,64,91,155
https://kawalpemilu.org#36391,"MRANGGEN, POLOKARTO, SUKOHARJO, JAWA TENGAH",25,170,22,192
https://kawalpemilu.org#34738,"MEGULUNG KIDUL, PITURUH, PURWOREJO, JAWA TENGAH",6,73,85,158
https://kawalpemilu.org#34177,"PEJAGOAN, PEJAGOAN, KEBUMEN, JAWA TENGAH",11,122,82,204
https://kawalpemilu.org#41324,"PAGEJUGAN, BREBES, BREBES, JAWA TENGAH",11,137,56,193
https://kawalpemilu.org#35730,"NGARGOREJO, NGEMPLAK, BOYOLALI, JAWA TENGAH",3,214,23,237
https://kawalpemilu.org#40789,"KENDALDOYONG, PETARUKAN, PEMALANG, JAWA TENGAH",32,132,23,155
https://kawalpemilu.org#35142,"TAMBI, KEJAJAR, WONOSOBO, JAWA TENGAH",7,209,13,222
https://kawalpemilu.org#41228,"PAGOJENGAN, PAGUYANGAN, BREBES, JAWA TENGAH",19,101,61,162
https://kawalpemilu.org#40251,"DENASRI WETAN, BATANG, BATANG, JAWA TENGAH",12,176,29,205
https://kawalpemilu.org#40651,"KUTA, BELIK, PEMALANG, JAWA TENGAH",10,97,58,155
https://kawalpemilu.org#37714,"SAMBONGANYAR, NGAWEN, BLORA, JAWA TENGAH",9,154,23,177
https://kawalpemilu.org#38567,"PRAMBATAN KIDUL, KALIWUNGU, KUDUS, JAWA TENGAH",17,144,35,179
https://kawalpemilu.org#33769,"TANJUNGANOM, RAKIT, BANJARNEGARA, JAWA TENGAH",3,147,37,184
https://kawalpemilu.org#41059,"TEGALWANGI, TALANG, TEGAL, JAWA TENGAH",17,51,58,109
https://kawalpemilu.org#38964,"TEMUROSO, GUNTUR, DEMAK, JAWA TENGAH",17,147,87,234
https://kawalpemilu.org#36262,"KARANGANOM, KLATEN UTARA, KLATEN, JAWA TENGAH",6,180,27,207
https://kawalpemilu.org#41546,"NUSUKAN, BANJARSARI, KOTA SURAKARTA, JAWA TENGAH",44,181,25,206
https://kawalpemilu.org#39240,"PLUMBON, SURUH, SEMARANG, JAWA TENGAH",15,207,27,234
https://kawalpemilu.org#91442,"TEGALKAMULYAN, CILACAP SELATAN, CILACAP, JAWA TENGAH",28,91,110,201
https://kawalpemilu.org#40227,"BEJI, TULIS, BATANG, JAWA TENGAH",2,141,32,173
https://kawalpemilu.org#41697,"SENDANGMULYO, TEMBALANG, KOTA SEMARANG, JAWA TENGAH",73,185,66,251
https://kawalpemilu.org#35594,"NGENDEN, AMPEL, BOYOLALI, JAWA TENGAH",3,136,14,150
https://kawalpemilu.org#91441,"TAMBAKREJA, CILACAP SELATAN, CILACAP, JAWA TENGAH",57,148,51,199
https://kawalpemilu.org#40794,"KLAREYAN, PETARUKAN, PEMALANG, JAWA TENGAH",24,0,0,0
https://kawalpemilu.org#35751,"BENDO, NOGOSARI, BOYOLALI, JAWA TENGAH",6,152,27,179
https://kawalpemilu.org#33684,"KUTABANJARNEGARA, BANJARNEGARA, BANJARNEGARA, JAWA TENGAH",9,97,125,222
https://kawalpemilu.org#38867,"DAREN, NALUMSARI, JEPARA, JAWA TENGAH",8,169,33,202
https://kawalpemilu.org#41861,"SUMURPANGGANG, MARGADANA, KOTA TEGAL, JAWA TENGAH",15,122,97,219
https://kawalpemilu.org#39821,"TRAYU, SINGOROJO, KENDAL, JAWA TENGAH",4,188,41,229
https://kawalpemilu.org#36875,"KARANGPANDAN, KARANGPANDAN, KARANGANYAR, JAWA TENGAH",3,178,21,199
https://kawalpemilu.org#37726,"GONDANG, NGAWEN, BLORA, JAWA TENGAH",1,177,30,207
https://kawalpemilu.org#35874,"BUGISAN, PRAMBANAN, KLATEN, JAWA TENGAH",11,184,76,260
https://kawalpemilu.org#39198,"SUGIHAN, TENGARAN, SEMARANG, JAWA TENGAH",13,145,43,188
https://kawalpemilu.org#38566,"BAKALANKRAPYAK, KALIWUNGU, KUDUS, JAWA TENGAH",24,161,50,211
https://kawalpemilu.org#41603,"BANDARHARJO, SEMARANG UTARA, KOTA SEMARANG, JAWA TENGAH",20,188,53,241
https://kawalpemilu.org#37237,"MANGIN, KARANGRAYUNG, GROBOGAN, JAWA TENGAH",11,158,28,186
https://kawalpemilu.org#39870,"TUNGGULSARI, BRANGSONG, KENDAL, JAWA TENGAH",16,166,2,168
https://kawalpemilu.org#39091,"BANTENGMATI, MIJEN, DEMAK, JAWA TENGAH",3,122,53,175
https://kawalpemilu.org#33315,"KARANGKLESEM, PURWOKERTO SELATAN, BANYUMAS, JAWA TENGAH",30,182,38,220
https://kawalpemilu.org#33685,"ARGASOKA, BANJARNEGARA, BANJARNEGARA, JAWA TENGAH",4,166,53,219
https://kawalpemilu.org#35648,"BANARAN, BOYOLALI, BOYOLALI, JAWA TENGAH",13,136,112,248
https://kawalpemilu.org#37207,"JAPOH, JENAR, SRAGEN, JAWA TENGAH",4,190,6,196
https://kawalpemilu.org#38255,"SIDOMUKTI, JAKEN, PATI, JAWA TENGAH",2,171,23,194
https://kawalpemilu.org#41600,"PENDRIKAN KIDUL, SEMARANG TENGAH, KOTA SEMARANG, JAWA TENGAH",6,178,44,222
https://kawalpemilu.org#38886,"MANYARGADING, KALINYAMATAN, JEPARA, JAWA TENGAH",5,198,36,234
https://kawalpemilu.org#37952,"TEMPALING, PAMOTAN, REMBANG, JAWA TENGAH",7,204,20,224
https://kawalpemilu.org#35435,"TAMPIRKULON, CANDIMULYO, MAGELANG, JAWA TENGAH",11,91,84,175
https://kawalpemilu.org#37246,"PANGKALAN, KARANGRAYUNG, GROBOGAN, JAWA TENGAH",8,162,31,193
https://kawalpemilu.org#36940,"BANJARHARJO, KEBAKKRAMAT, KARANGANYAR, JAWA TENGAH",3,208,40,248
https://kawalpemilu.org#39056,"TANJUNGANYAR, GAJAH, DEMAK, JAWA TENGAH",6,146,39,185
https://kawalpemilu.org#33107,"KALIBAGOR, KALIBAGOR, BANYUMAS, JAWA TENGAH",18,128,103,231
https://kawalpemilu.org#38680,"KARANGMALANG, GEBOG, KUDUS, JAWA TENGAH",26,168,37,205
https://kawalpemilu.org#37411,"CINGKRONG, PURWODADI, GROBOGAN, JAWA TENGAH",18,168,44,212
https://kawalpemilu.org#38865,"NALUMSARI, NALUMSARI, JEPARA, JAWA TENGAH",10,153,20,173
https://kawalpemilu.org#39639,"KRANGGAN, KRANGGAN, TEMANGGUNG, JAWA TENGAH",15,148,67,215
https://kawalpemilu.org#36857,"TENGKLIK, TAWANGMANGU, KARANGANYAR, JAWA TENGAH",3,171,21,192
https://kawalpemilu.org#41200,"PANGEBATAN, BANTARKAWUNG, BREBES, JAWA TENGAH",10,116,41,157
https://kawalpemilu.org#33171,"GANCANG, GUMELAR, BANYUMAS, JAWA TENGAH",7,116,59,175
https://kawalpemilu.org#41022,"DUKUHWRINGIN, SLAWI, TEGAL, JAWA TENGAH",16,152,53,205
https://kawalpemilu.org#91437,"KARANGTALUN, CILACAP UTARA, CILACAP, JAWA TENGAH",12,159,70,229
https://kawalpemilu.org#37923,"KARAS, SEDAN, REMBANG, JAWA TENGAH",12,96,53,149
https://kawalpemilu.org#37406,"WARUKARANGANYAR, PURWODADI, GROBOGAN, JAWA TENGAH",6,136,8,144
https://kawalpemilu.org#36347,"TANJUNGREJO, NGUTER, SUKOHARJO, JAWA TENGAH",7,157,10,167
https://kawalpemilu.org#38549,"TRANGKIL, TRANGKIL, PATI, JAWA TENGAH",15,177,16,193
https://kawalpemilu.org#38625,"KALIREJO, UNDAAN, KUDUS, JAWA TENGAH",11,133,49,182
https://kawalpemilu.org#36480,"PRACIMANTORO, PRACIMANTORO, WONOGIRI, JAWA TENGAH",23,158,14,172
https://kawalpemilu.org#41547,"GILINGAN, BANJARSARI, KOTA SURAKARTA, JAWA TENGAH",11,170,18,188
https://kawalpemilu.org#37262,"KLUWAN, PENAWANGAN, GROBOGAN, JAWA TENGAH",9,134,37,171
https://kawalpemilu.org#36621,"PURWOSARI, WONOGIRI, WONOGIRI, JAWA TENGAH",17,186,34,220
https://kawalpemilu.org#36987,"KEDEN, KALIJAMBE, SRAGEN, JAWA TENGAH",1,87,25,112
https://kawalpemilu.org#37692,"SIDOMULYO, BANJAREJO, BLORA, JAWA TENGAH",3,163,18,181
https://kawalpemilu.org#34244,"MANGLI, KUWARASAN, KEBUMEN, JAWA TENGAH",6,111,39,150
https://kawalpemilu.org#41796,"NOYONTAANSARI, PEKALONGAN TIMUR, KOTA PEKALONGAN, JAWA TENGAH",28,176,59,235
https://kawalpemilu.org#35428,"MEJING, CANDIMULYO, MAGELANG, JAWA TENGAH",12,120,15,135
https://kawalpemilu.org#38466,"LANGGENHARJO, MARGOYOSO, PATI, JAWA TENGAH",2,131,21,152
https://kawalpemilu.org#41403,"BULAKAMBA, BULAKAMBA, BREBES, JAWA TENGAH",16,121,49,170
https://kawalpemilu.org#41330,"TENGKI, BREBES, BREBES, JAWA TENGAH",7,119,65,184
https://kawalpemilu.org#35322,"AMBARTAWANG, MUNGKID, MAGELANG, JAWA TENGAH",9,135,66,201
https://kawalpemilu.org#41733,"KALIBANTENG KULON, SEMARANG BARAT, KOTA SEMARANG, JAWA TENGAH",2,176,45,221
https://kawalpemilu.org#39418,"GEDANGANAK, UNGARAN TIMUR, SEMARANG, JAWA TENGAH",35,152,89,241
https://kawalpemilu.org#33791,"PAWEDEN, KARANGKOBAR, BANJARNEGARA, JAWA TENGAH",2,113,28,141
https://kawalpemilu.org#39197,"DUREN, TENGARAN, SEMARANG, JAWA TENGAH",10,161,33,194
https://kawalpemilu.org#38753,"TELUKWETAN, WELAHAN, JEPARA, JAWA TENGAH",27,204,39,243
https://kawalpemilu.org#41545,"KADIPIRO, BANJARSARI, KOTA SURAKARTA, JAWA TENGAH",175,180,18,198
https://kawalpemilu.org#39330,"BAWEN, BAWEN, SEMARANG, JAWA TENGAH",32,99,6,105
https://kawalpemilu.org#38815,"PAPASAN, BANGSRI, JEPARA, JAWA TENGAH",5,139,21,160
https://kawalpemilu.org#38646,"JOJO, MEJOBO, KUDUS, JAWA TENGAH",6,151,32,183
https://kawalpemilu.org#37817,"PENGKOLREJO, JAPAH, BLORA, JAWA TENGAH",5,192,22,214
https://kawalpemilu.org#38843,"NGABUL, TAHUNAN, JEPARA, JAWA TENGAH",3,222,30,252
https://kawalpemilu.org#40819,"PURWOSARI, COMAL, PEMALANG, JAWA TENGAH",19,142,54,196
https://kawalpemilu.org#38836,"KELET, KELING, JEPARA, JAWA TENGAH",24,159,10,169
https://kawalpemilu.org#39019,"KARANGREJO, WONOSALAM, DEMAK, JAWA TENGAH",9,169,53,222
https://kawalpemilu.org#40633,"GENDOWANG, MOGA, PEMALANG, JAWA TENGAH",14,108,29,137
https://kawalpemilu.org#38645,"KESAMBI, MEJOBO, KUDUS, JAWA TENGAH",4,128,55,183
https://kawalpemilu.org#37036,"MOJODOYONG, KEDAWUNG, SRAGEN, JAWA TENGAH",1,151,22,173
https://kawalpemilu.org#32700,"KARANGJENGKOL, KESUGIHAN, CILACAP, JAWA TENGAH",15,134,23,157
https://kawalpemilu.org#39845,"KLIRIS, BOJA, KENDAL, JAWA TENGAH",5,108,48,156
https://kawalpemilu.org#38281,"LENGKONG, BATANGAN, PATI, JAWA TENGAH",3,198,24,222
https://kawalpemilu.org#39327,"BEJALEN, AMBARAWA, SEMARANG, JAWA TENGAH",1,198,39,237
https://kawalpemilu.org#38948,"BRAMBANG, KARANGAWEN, DEMAK, JAWA TENGAH",30,173,29,202
https://kawalpemilu.org#34980,"TANJUNGANOM, KALIWIRO, WONOSOBO, JAWA TENGAH",2,173,46,219
https://kawalpemilu.org#41190,"BANJARSARI, BANTARKAWUNG, BREBES, JAWA TENGAH",12,56,45,101
https://kawalpemilu.org#41667,"LAMPER KIDUL, SEMARANG SELATAN, KOTA SEMARANG, JAWA TENGAH",10,150,85,235
https://kawalpemilu.org#38668,"GONDANGMANIS, BAE, KUDUS, JAWA TENGAH",19,111,57,168
https://kawalpemilu.org#41370,"LIMBANGAN, LOSARI, BREBES, JAWA TENGAH",20,113,15,128
https://kawalpemilu.org#36234,"KEMALANG, KEMALANG, KLATEN, JAWA TENGAH",5,244,5,249
https://kawalpemilu.org#87511,"SIDAMULYA, WANAREJA, CILACAP, JAWA TENGAH",3,122,85,207
https://kawalpemilu.org#41810,"KRAPYAK, PEKALONGAN UTARA, KOTA PEKALONGAN, JAWA TENGAH",24,104,49,153
https://kawalpemilu.org#36596,"GUNUNGAN, MANYARAN, WONOGIRI, JAWA TENGAH",14,253,3,256
https://kawalpemilu.org#37550,"GETAS, KRADENAN, BLORA, JAWA TENGAH",15,119,13,132
https://kawalpemilu.org#37638,"PULEDAGEL, JEPON, BLORA, JAWA TENGAH",4,142,49,191
https://kawalpemilu.org#32848,"CIPOROS, KARANGPUCUNG, CILACAP, JAWA TENGAH",7,118,68,186
https://kawalpemilu.org#36617,"SENDANG, WONOGIRI, WONOGIRI, JAWA TENGAH",2,166,20,186
https://kawalpemilu.org#33332,"KRANJI, PURWOKERTO TIMUR, BANYUMAS, JAWA TENGAH",15,131,76,207
https://kawalpemilu.org#37200,"DUKUH, TANGEN, SRAGEN, JAWA TENGAH",13,195,13,208
https://kawalpemilu.org#34226,"MELES, ADIMULYO, KEBUMEN, JAWA TENGAH",1,111,44,155
https://kawalpemilu.org#35146,"SERANG, KEJAJAR, WONOSOBO, JAWA TENGAH",8,174,36,210
https://kawalpemilu.org#32693,"SLARANG, KESUGIHAN, CILACAP, JAWA TENGAH",12,192,16,208
https://kawalpemilu.org#34136,"SELILING, ALIAN, KEBUMEN, JAWA TENGAH",7,104,22,126
https://kawalpemilu.org#41524,"SEMANGGI, PASAR KLIWON, KOTA SURAKARTA, JAWA TENGAH",79,173,25,198
https://kawalpemilu.org#33261,"DUKUHWALUH, KEMBARAN, BANYUMAS, JAWA TENGAH",20,156,55,211
https://kawalpemilu.org#41182,"PASIRPANJANG, SALEM, BREBES, JAWA TENGAH",8,100,70,170
https://kawalpemilu.org#40306,"BANYUPUTIH, BANYUPUTIH, BATANG, JAWA TENGAH",16,185,17,202
https://kawalpemilu.org#40796,"NYAMPLUNGSARI, PETARUKAN, PEMALANG, JAWA TENGAH",2,125,20,145
https://kawalpemilu.org#33552,"KAJONGAN, BOJONGSARI, PURBALINGGA, JAWA TENGAH",10,237,19,256
https://kawalpemilu.org#32812,"SARWADADI, KAWUNGANTEN, CILACAP, JAWA TENGAH",1,0,0,0
https://kawalpemilu.org#37385,"GETASREJO, GROBOGAN, GROBOGAN, JAWA TENGAH",14,156,40,196
https://kawalpemilu.org#39791,"KEBUMEN, SUKOREJO, KENDAL, JAWA TENGAH",7,103,77,180
https://kawalpemilu.org#33215,"SOKAWERA, CILONGOK, BANYUMAS, JAWA TENGAH",1,166,69,235
https://kawalpemilu.org#38683,"GONDOSARI, GEBOG, KUDUS, JAWA TENGAH",39,205,18,223
https://kawalpemilu.org#37675,"ADIREJO, TUNJUNGAN, BLORA, JAWA TENGAH",6,116,69,185
https://kawalpemilu.org#34121,"TANJUNGSARI, KUTOWINANGUN, KEBUMEN, JAWA TENGAH",2,127,96,223
https://kawalpemilu.org#39961,"PIDODO KULON, PATEBON, KENDAL, JAWA TENGAH",12,140,10,150
https://kawalpemilu.org#36906,"JATI, JATEN, KARANGANYAR, JAWA TENGAH",6,117,55,172
https://kawalpemilu.org#33000,"RAWAHENG, WANGON, BANYUMAS, JAWA TENGAH",2,169,34,203
https://kawalpemilu.org#36021,"GUMUL, KARANGNONGKO, KLATEN, JAWA TENGAH",4,176,12,188
https://kawalpemilu.org#33271,"TAMBAKSOGRA, SUMBANG, BANYUMAS, JAWA TENGAH",5,110,104,214
https://kawalpemilu.org#40830,"KEBOJONGAN, COMAL, PEMALANG, JAWA TENGAH",13,127,8,135
https://kawalpemilu.org#36771,"NGAMBARSARI, KARANGTENGAH, WONOGIRI, JAWA TENGAH",4,171,17,188
https://kawalpemilu.org#38674,"BAE, BAE, KUDUS, JAWA TENGAH",33,126,30,156
https://kawalpemilu.org#39541,"TLOGOPUCANG, KANDANGAN, TEMANGGUNG, JAWA TENGAH",3,215,47,262
https://kawalpemilu.org#37175,"JEKANI, MONDOKAN, SRAGEN, JAWA TENGAH",8,119,13,132
https://kawalpemilu.org#37251,"BOLOGARANG, PENAWANGAN, GROBOGAN, JAWA TENGAH",12,172,2,174
https://kawalpemilu.org#41465,"CIKUYA, BANJARHARJO, BREBES, JAWA TENGAH",25,107,60,167
https://kawalpemilu.org#35401,"GIRIREJO, KALIANGKRIK, MAGELANG, JAWA TENGAH",4,127,35,162
https://kawalpemilu.org#36083,"KARANGWUNGU, KARANGDOWO, KLATEN, JAWA TENGAH",1,191,27,218
https://kawalpemilu.org#36472,"GEDONG, PRACIMANTORO, WONOGIRI, JAWA TENGAH",8,191,42,233
https://kawalpemilu.org#37309,"JETAKSARI, PULOKULON, GROBOGAN, JAWA TENGAH",5,188,24,212
https://kawalpemilu.org#36414,"TELUKAN, GROGOL, SUKOHARJO, JAWA TENGAH",27,237,38,275
https://kawalpemilu.org#34355,"MERDEN, PADURESO, KEBUMEN, JAWA TENGAH",2,97,33,130
https://kawalpemilu.org#39501,"KUPEN, PRINGSURAT, TEMANGGUNG, JAWA TENGAH",12,237,13,250
https://kawalpemilu.org#37839,"RANDUAGUNG, SUMBER, REMBANG, JAWA TENGAH",5,140,30,170
https://kawalpemilu.org#36282,"DANGURAN, KLATEN SELATAN, KLATEN, JAWA TENGAH",16,114,96,210
https://kawalpemilu.org#41216,"KALIWADAS, BUMIAYU, BREBES, JAWA TENGAH",7,130,66,196
https://kawalpemilu.org#41425,"LUWUNGGEDE, LARANGAN, BREBES, JAWA TENGAH",11,143,51,194
https://kawalpemilu.org#37219,"KENTENGSARI, KEDUNGJATI, GROBOGAN, JAWA TENGAH",5,185,15,200
https://kawalpemilu.org#36494,"TLOGOSARI, GIRITONTRO, WONOGIRI, JAWA TENGAH",7,141,18,159
https://kawalpemilu.org#40876,"SIGEDONG, BUMIJAWA, TEGAL, JAWA TENGAH",5,95,119,214
https://kawalpemilu.org#39302,"KEBONAGUNG, SUMOWONO, SEMARANG, JAWA TENGAH",4,201,21,222
https://kawalpemilu.org#40813,"TEGALSARI BARAT, AMPELGADING, PEMALANG, JAWA TENGAH",20,127,20,147
https://kawalpemilu.org#33535,"KARANGBAWANG, REMBANG, PURBALINGGA, JAWA TENGAH",7,73,17,90
https://kawalpemilu.org#37365,"TANJUNGREJO, WIROSARI, GROBOGAN, JAWA TENGAH",18,119,31,150
https://kawalpemilu.org#40332,"TRAJUMAS, KANDANGSERANG, PEKALONGAN, JAWA TENGAH",2,87,76,163
https://kawalpemilu.org#38870,"BENDANPETE, NALUMSARI, JEPARA, JAWA TENGAH",6,159,48,207
https://kawalpemilu.org#35512,"TEGALREJO, TEGALREJO, MAGELANG, JAWA TENGAH",1,199,19,218
https://kawalpemilu.org#41077,"PEKAUMAN KULON, DUKUHTURI, TEGAL, JAWA TENGAH",1,119,115,234
https://kawalpemilu.org#35089,"BANYUKEMBAR, WATUMALANG, WONOSOBO, JAWA TENGAH",11,127,10,137
https://kawalpemilu.org#41536,"GANDEKAN, JEBRES, KOTA SURAKARTA, JAWA TENGAH",1,200,9,209
https://kawalpemilu.org#38460,"TEGALARUM, MARGOYOSO, PATI, JAWA TENGAH",5,161,25,186
https://kawalpemilu.org#39640,"BADRAN, KRANGGAN, TEMANGGUNG, JAWA TENGAH",3,170,73,243
https://kawalpemilu.org#36641,"SEMPUKEREP, SIDOHARJO, WONOGIRI, JAWA TENGAH",3,140,8,148
https://kawalpemilu.org#34222,"SEKARTEJA, ADIMULYO, KEBUMEN, JAWA TENGAH",2,75,82,157
https://kawalpemilu.org#41582,"DUKUH, SIDOMUKTI, KOTA SALATIGA, JAWA TENGAH",2,140,49,189
https://kawalpemilu.org#37516,"BANGKLEYAN, JATI, BLORA, JAWA TENGAH",1,196,10,206
https://kawalpemilu.org#35611,"GEDANGAN, CEPOGO, BOYOLALI, JAWA TENGAH",5,239,6,245
https://kawalpemilu.org#36556,"BATURETNO, BATURETNO, WONOGIRI, JAWA TENGAH",26,136,26,162
https://kawalpemilu.org#39518,"KALIMANGGIS, KALORAN, TEMANGGUNG, JAWA TENGAH",7,105,29,134
https://kawalpemilu.org#36698,"NGAGLIK, BULUKERTO, WONOGIRI, JAWA TENGAH",4,104,55,159
https://kawalpemilu.org#33282,"GANDATAPA, SUMBANG, BANYUMAS, JAWA TENGAH",12,172,66,238
https://kawalpemilu.org#33542,"SUMAMPIR, REMBANG, PURBALINGGA, JAWA TENGAH",14,120,31,151
https://kawalpemilu.org#41254,"KUTAMENDALA, TONJONG, BREBES, JAWA TENGAH",13,99,62,161
https://kawalpemilu.org#33448,"MUNJUL, KUTASARI, PURBALINGGA, JAWA TENGAH",6,152,60,212
https://kawalpemilu.org#34846,"NGAGLIK, GEBANG, PURWOREJO, JAWA TENGAH",3,129,8,137
https://kawalpemilu.org#35392,"NGARGOSOKO, KALIANGKRIK, MAGELANG, JAWA TENGAH",7,152,31,183
https://kawalpemilu.org#41752,"WONOLOPO, MIJEN, KOTA SEMARANG, JAWA TENGAH",10,146,48,194
https://kawalpemilu.org#33497,"PALUMBUNGAN WETAN, BOBOTSARI, PURBALINGGA, JAWA TENGAH",2,113,57,170
https://kawalpemilu.org#33746,"PRENDENGAN, BANJARMANGU, BANJARNEGARA, JAWA TENGAH",4,132,58,190
https://kawalpemilu.org#41556,"SUMBER, BANJARSARI, KOTA SURAKARTA, JAWA TENGAH",10,151,11,162
https://kawalpemilu.org#39094,"REJOSARI, MIJEN, DEMAK, JAWA TENGAH",7,110,42,152
https://kawalpemilu.org#35601,"KEMBANG, AMPEL, BOYOLALI, JAWA TENGAH",10,151,22,173
https://kawalpemilu.org#36915,"BOLON, COLOMADU, KARANGANYAR, JAWA TENGAH",15,199,37,236
https://kawalpemilu.org#35771,"MANYARAN, KARANGGEDE, BOYOLALI, JAWA TENGAH",5,172,34,206
https://kawalpemilu.org#41164,"BULAKPACING, DUKUHWARU, TEGAL, JAWA TENGAH",9,97,58,155
https://kawalpemilu.org#37126,"GABUGAN, TANON, SRAGEN, JAWA TENGAH",13,164,16,180
https://kawalpemilu.org#34739,"PITURUH, PITURUH, PURWOREJO, JAWA TENGAH",9,83,44,127
https://kawalpemilu.org#36344,"BULAKREJO, SUKOHARJO, SUKOHARJO, JAWA TENGAH",14,203,47,250
https://kawalpemilu.org#36931,"REJOSARI, GONDANGREJO, KARANGANYAR, JAWA TENGAH",8,163,33,196
https://kawalpemilu.org#35731,"SOBOKERTO, NGEMPLAK, BOYOLALI, JAWA TENGAH",13,127,36,163
https://kawalpemilu.org#35747,"KETITANG, NOGOSARI, BOYOLALI, JAWA TENGAH",16,185,54,239
https://kawalpemilu.org#35791,"JATEN, KLEGO, BOYOLALI, JAWA TENGAH",6,99,30,129
https://kawalpemilu.org#38731,"RENGGING, PECANGAAN, JEPARA, JAWA TENGAH",6,175,52,227
https://kawalpemilu.org#36761,"TAMBAKMERANG, GIRIMARTO, WONOGIRI, JAWA TENGAH",11,69,20,80
https://kawalpemilu.org#40768,"PEDURUNGAN, TAMAN, PEMALANG, JAWA TENGAH",16,114,42,156
https://kawalpemilu.org#41509,"PURWOSARI, LAWEYAN, KOTA SURAKARTA, JAWA TENGAH",26,147,37,184
https://kawalpemilu.org#43817,"BAKALAN, GROGOL, KEDIRI, JAWA TIMUR",10,149,30,179
https://kawalpemilu.org#44762,"RAMBIGUNDAM, RAMBIPUJI, JEMBER, JAWA TIMUR",7,93,99,192
https://kawalpemilu.org#45513,"JANGKAR, JANGKAR, SITUBONDO, JAWA TIMUR",2,71,62,133
https://kawalpemilu.org#48867,"KARANGREJO, BANCAR, TUBAN, JAWA TIMUR",6,172,39,211
https://kawalpemilu.org#42575,"CALUK, SLAHUNG, PONOROGO, JAWA TIMUR",5,132,40,172
https://kawalpemilu.org#50644,"PALENGAAN DAJA, PALENGAAN, PAMEKASAN, JAWA TIMUR",42,49,162,211
https://kawalpemilu.org#51554,"SISIR, BATU, KOTA BATU, JAWA TIMUR",36,93,97,190
https://kawalpemilu.org#43757,"SUMBERAGUNG, PLOSOKLATEN, KEDIRI, JAWA TIMUR",23,135,20,155
https://kawalpemilu.org#48890,"NGULAHAN, TAMBAKBOYO, TUBAN, JAWA TIMUR",2,151,40,191
https://kawalpemilu.org#49920,"BOTENG, MENGANTI, GRESIK, JAWA TIMUR",11,182,61,243
https://kawalpemilu.org#46260,"SUMBER ANYAR, NGULING, PASURUAN, JAWA TIMUR",12,181,32,213
https://kawalpemilu.org#46360,"PLOSO, KREMBUNG, SIDOARJO, JAWA TIMUR",1,150,68,218
https://kawalpemilu.org#51466,"SIDOTOPO WETAN, KENJERAN, KOTA SURABAYA, JAWA TIMUR",130,123,69,192
https://kawalpemilu.org#51503,"KUTISARI, TENGGILIS MEJOYO, KOTA SURABAYA, JAWA TIMUR",15,128,72,200
https://kawalpemilu.org#44356,"TULUNGREJO, NGANTANG, MALANG, JAWA TIMUR",6,179,12,191
https://kawalpemilu.org#50148,"BANYIOR, SEPULU, BANGKALAN, JAWA TIMUR",3,90,110,200
https://kawalpemilu.org#46462,"MAGERSARI, SIDOARJO, SIDOARJO, JAWA TIMUR",23,149,38,187
https://kawalpemilu.org#43855,"KARANGPAKIS, PURWOASRI, KEDIRI, JAWA TIMUR",9,91,46,137
https://kawalpemilu.org#42835,"PURBOSUMAN, PONOROGO, PONOROGO, JAWA TIMUR",7,156,65,221
https://kawalpemilu.org#44980,"JAJAG, GAMBIRAN, BANYUWANGI, JAWA TIMUR",6,187,41,228
https://kawalpemilu.org#51175,"PURWODADI, BLIMBING, KOTA MALANG, JAWA TIMUR",31,138,69,207
https://kawalpemilu.org#47771,"WARUREJO, BALEREJO, MADIUN, JAWA TIMUR",6,98,14,112
https://kawalpemilu.org#44266,"BABADAN, NGAJUM, MALANG, JAWA TIMUR",13,90,43,133
https://kawalpemilu.org#49935,"SETRO, MENGANTI, GRESIK, JAWA TIMUR",13,198,40,238
https://kawalpemilu.org#45014,"KAJAR HARJO, KALIBARU, BANYUWANGI, JAWA TIMUR",47,142,62,204
https://kawalpemilu.org#50379,"BANJAR TALELA, CAMPLONG, SAMPANG, JAWA TIMUR",2,90,184,274
https://kawalpemilu.org#44306,"CANDIRENGGO, SINGOSARI, MALANG, JAWA TIMUR",9,145,81,226
https://kawalpemilu.org#49266,"BRENGKOK, BRONDONG, LAMONGAN, JAWA TIMUR",10,158,42,200
https://kawalpemilu.org#51432,"TAMBAKREJO, SIMOKERTO, KOTA SURABAYA, JAWA TIMUR",4,117,44,161
https://kawalpemilu.org#87494,"KEBONSARI KULON, KANIGARAN, KOTA PROBOLINGGO, JAWA TIMUR",37,138,68,206
https://kawalpemilu.org#47047,"KERTOREJO, NGORO, JOMBANG, JAWA TIMUR",8,157,31,188
https://kawalpemilu.org#44298,"AMPELDENTO, KARANGPLOSO, MALANG, JAWA TIMUR",9,184,63,247
https://kawalpemilu.org#44779,"WONOJATI, JENGGAWAH, JEMBER, JAWA TIMUR",23,133,84,217
https://kawalpemilu.org#46668,"TAMBAKOSO, WARU, SIDOARJO, JAWA TIMUR",10,91,24,115
https://kawalpemilu.org#42539,"KETRO, TULAKAN, PACITAN, JAWA TIMUR",27,33,110,143
https://kawalpemilu.org#84962,"SAUBI, KANGAYAN, SUMENEP, JAWA TIMUR",7,65,63,128
https://kawalpemilu.org#48553,"BUNGUR, KANOR, BOJONEGORO, JAWA TIMUR",9,130,53,183
https://kawalpemilu.org#49063,"PENAMBANGAN, SEMANDING, TUBAN, JAWA TIMUR",10,170,73,243
https://kawalpemilu.org#44006,"SUMBERMANJING KULON, PAGAK, MALANG, JAWA TIMUR",16,107,69,176
https://kawalpemilu.org#46641,"SAWOTRATAP, GEDANGAN, SIDOARJO, JAWA TIMUR",28,139,74,213
https://kawalpemilu.org#50431,"PALENGGIYAN, KEDUNGDUNG, SAMPANG, JAWA TIMUR",15,128,26,154
https://kawalpemilu.org#49719,"CAMPUREJO, PANCENG, GRESIK, JAWA TIMUR",17,144,45,189
https://kawalpemilu.org#44516,"ROGOTRUNAN, LUMAJANG, LUMAJANG, JAWA TIMUR",3,102,131,233
https://kawalpemilu.org#43111,"TAPAN, KEDUNGWARU, TULUNGAGUNG, JAWA TIMUR",19,161,42,203
https://kawalpemilu.org#45467,"TALKANDANG, SITUBONDO, SITUBONDO, JAWA TIMUR",7,101,78,179
https://kawalpemilu.org#49887,"CERME LOR, CERME, GRESIK, JAWA TIMUR",7,180,64,244
https://kawalpemilu.org#50781,"GAPURANA, TALANGO, SUMENEP, JAWA TIMUR",34,34,126,160
https://kawalpemilu.org#44967,"KUMENDUNG, MUNCAR, BANYUWANGI, JAWA TIMUR",22,111,19,130
https://kawalpemilu.org#48090,"SUKOWIDI, NGUNTORONADI, MAGETAN, JAWA TIMUR",6,96,53,149
https://kawalpemilu.org#51056,"BILIS BILIS, ARJASA, SUMENEP, JAWA TIMUR",5,88,40,128
https://kawalpemilu.org#45862,"BLADOKULON, TEGALSIWALAN, PROBOLINGGO, JAWA TIMUR",8,112,96,208
https://kawalpemilu.org#49788,"SUMENGKO, WRINGINANOM, GRESIK, JAWA TIMUR",9,180,53,233
https://kawalpemilu.org#51408,"BARATAJAYA, GUBENG, KOTA SURABAYA, JAWA TIMUR",28,153,40,193
https://kawalpemilu.org#44535,"PANDANSARI, SENDURO, LUMAJANG, JAWA TIMUR",5,93,75,168
https://kawalpemilu.org#50627,"CAMPOR, PROPPO, PAMEKASAN, JAWA TIMUR",16,0,244,244
https://kawalpemilu.org#51449,"MANUKAN KULON, TANDES, KOTA SURABAYA, JAWA TIMUR",15,146,68,214
https://kawalpemilu.org#44807,"KALIWATES, KALIWATES, JEMBER, JAWA TIMUR",3,152,37,189
https://kawalpemilu.org#42945,"SALAM WATES, DONGKO, TRENGGALEK, JAWA TIMUR",17,142,10,152
https://kawalpemilu.org#51537,"BULAK, BULAK, KOTA SURABAYA, JAWA TIMUR",39,191,49,240
https://kawalpemilu.org#43793,"PAGU, PAGU, KEDIRI, JAWA TIMUR",12,158,31,189
https://kawalpemilu.org#44949,"KENDALREJO, TEGALDLIMO, BANYUWANGI, JAWA TIMUR",2,119,57,176
https://kawalpemilu.org#51356,"DEMANGAN, TAMAN, KOTA MADIUN, JAWA TIMUR",18,136,56,192
https://kawalpemilu.org#51317,"GUNUNG GEDANGAN, MAGERSARI, KOTA MOJOKERTO, JAWA TIMUR",19,171,35,206
https://kawalpemilu.org#44034,"ARGOTIRTO, SUMBERMANJING WETAN, MALANG, JAWA TIMUR",5,126,80,206
https://kawalpemilu.org#45424,"PESISIR, BESUKI, SITUBONDO, JAWA TIMUR",19,192,55,247
https://kawalpemilu.org#44437,"SUMBERREJO, CANDIPURO, LUMAJANG, JAWA TIMUR",11,152,55,207
https://kawalpemilu.org#43683,"TALES, NGADILUWIH, KEDIRI, JAWA TIMUR",22,189,41,230
https://kawalpemilu.org#51204,"MADYOPURO, KEDUNGKANDANG, KOTA MALANG, JAWA TIMUR",26,161,78,239
https://kawalpemilu.org#49708,"BANJARAGUNG, BALONGPANGGANG, GRESIK, JAWA TIMUR",2,162,57,219
https://kawalpemilu.org#51179,"BUNULREJO, BLIMBING, KOTA MALANG, JAWA TIMUR",55,133,105,238
https://kawalpemilu.org#42513,"GEDANGAN, TEGALOMBO, PACITAN, JAWA TIMUR",5,77,104,181
https://kawalpemilu.org#42680,"MUNGGUNG, PULUNG, PONOROGO, JAWA TIMUR",7,135,73,208
https://kawalpemilu.org#46078,"JOGOSARI, PANDAAN, PASURUAN, JAWA TIMUR",3,129,81,210
https://kawalpemilu.org#44336,"SUKOMULYO, PUJON, MALANG, JAWA TIMUR",8,161,18,179
https://kawalpemilu.org#46439,"KEDUNGKENDO, CANDI, SIDOARJO, JAWA TIMUR",18,86,134,220
https://kawalpemilu.org#51393,"BANYU URIP, SAWAHAN, KOTA SURABAYA, JAWA TIMUR",42,135,51,186
https://kawalpemilu.org#47208,"PESANTREN, TEMBELANG, JOMBANG, JAWA TIMUR",7,123,51,174
https://kawalpemilu.org#45208,"MANGLI, PUJER, BONDOWOSO, JAWA TIMUR",9,46,140,186
https://kawalpemilu.org#46270,"GEJUG JATI, LEKOK, PASURUAN, JAWA TIMUR",13,220,50,270
https://kawalpemilu.org#48607,"MULYOREJO, BALEN, BOJONEGORO, JAWA TIMUR",5,158,46,204
https://kawalpemilu.org#47483,"KEDUNGOMBO, TANJUNGANOM, NGANJUK, JAWA TIMUR",19,151,34,185
https://kawalpemilu.org#49723,"WOTAN, PANCENG, GRESIK, JAWA TIMUR",2,49,135,184
https://kawalpemilu.org#44172,"KASRI, BULULAWANG, MALANG, JAWA TIMUR",2,150,60,210
https://kawalpemilu.org#51460,"PEGIRIAN, SEMAMPIR, KOTA SURABAYA, JAWA TIMUR",87,103,149,252
https://kawalpemilu.org#46436,"GELAM, CANDI, SIDOARJO, JAWA TIMUR",4,130,118,248
https://kawalpemilu.org#46668,"TAMBAKOSO, WARU, SIDOARJO, JAWA TIMUR",3,75,36,111
https://kawalpemilu.org#42936,"KARANG ANYAR, PULE, TRENGGALEK, JAWA TIMUR",12,94,14,108
https://kawalpemilu.org#48013,"MALANG, MAOSPATI, MAGETAN, JAWA TIMUR",6,164,52,216
https://kawalpemilu.org#49118,"LERAN KULON, PALANG, TUBAN, JAWA TIMUR",17,149,78,227
https://kawalpemilu.org#49754,"TAMBAK REJO, DUDUKSAMPEYAN, GRESIK, JAWA TIMUR",12,66,137,203
https://kawalpemilu.org#50294,"MANGGAAN, MODUNG, BANGKALAN, JAWA TIMUR",9,165,35,200
https://kawalpemilu.org#47690,"DAGANGAN, DAGANGAN, MADIUN, JAWA TIMUR",10,97,96,193
https://kawalpemilu.org#48008,"KRATON, MAOSPATI, MAGETAN, JAWA TIMUR",9,106,100,206
https://kawalpemilu.org#48728,"TEMBELING, KASIMAN, BOJONEGORO, JAWA TIMUR",9,150,47,197
https://kawalpemilu.org#48854,"SUKOLILO, BANCAR, TUBAN, JAWA TIMUR",6,174,23,197
https://kawalpemilu.org#46433,"KALIPECABEAN, CANDI, SIDOARJO, JAWA TIMUR",9,162,47,209
https://kawalpemilu.org#42705,"COPER, JETIS, PONOROGO, JAWA TIMUR",7,170,65,235
https://kawalpemilu.org#51430,"SIDODADI, SIMOKERTO, KOTA SURABAYA, JAWA TIMUR",44,73,39,112
https://kawalpemilu.org#43110,"BORO, KEDUNGWARU, TULUNGAGUNG, JAWA TIMUR",2,161,28,189
https://kawalpemilu.org#45471,"MIMBAAN, PANJI, SITUBONDO, JAWA TIMUR",54,61,48,109
https://kawalpemilu.org#51204,"MADYOPURO, KEDUNGKANDANG, KOTA MALANG, JAWA TIMUR",11,157,55,212
https://kawalpemilu.org#44846,"SUMBERPINANG, PAKUSARI, JEMBER, JAWA TIMUR",6,137,32,169
https://kawalpemilu.org#45532,"SUMBEREJO, BANYUPUTIH, SITUBONDO, JAWA TIMUR",35,87,27,114
https://kawalpemilu.org#47265,"PENGAMPON, KABUH, JOMBANG, JAWA TIMUR",7,175,51,226
https://kawalpemilu.org#51559,"ORO-ORO OMBO, BATU, KOTA BATU, JAWA TIMUR",33,154,33,187
https://kawalpemilu.org#46277,"PASINAN, LEKOK, PASURUAN, JAWA TIMUR",10,90,171,261
https://kawalpemilu.org#51412,"GEBANG PUTIH, SUKOLILO, KOTA SURABAYA, JAWA TIMUR",14,177,57,234
https://kawalpemilu.org#51081,"BABBALAN, BATUAN, SUMENEP, JAWA TIMUR",4,94,59,153
https://kawalpemilu.org#48870,"BANCAR, BANCAR, TUBAN, JAWA TIMUR",6,142,47,189
https://kawalpemilu.org#50089,"BATONAONG, AROSBAYA, BANGKALAN, JAWA TIMUR",4,85,92,177
https://kawalpemilu.org#48262,"PELANG KIDUL, KEDUNGGALAR, NGAWI, JAWA TIMUR",7,164,37,201
https://kawalpemilu.org#49626,"KENTONG, GLAGAH, LAMONGAN, JAWA TIMUR",6,148,44,192
https://kawalpemilu.org#46248,"SUMBER AGUNG, GRATI, PASURUAN, JAWA TIMUR",4,165,89,254
https://kawalpemilu.org#44783,"JATISARI, JENGGAWAH, JEMBER, JAWA TIMUR",25,67,92,159
https://kawalpemilu.org#51381,"NGAGEL REJO, WONOKROMO, KOTA SURABAYA, JAWA TIMUR",34,146,62,208
https://kawalpemilu.org#51526,"SIMOMULYO BARU, SUKOMANUNGGAL, KOTA SURABAYA, JAWA TIMUR",34,152,46,198
https://kawalpemilu.org#43956,"SRIKATON, RINGINREJO, KEDIRI, JAWA TIMUR",1,156,40,196
https://kawalpemilu.org#45449,"TAMBAK UKIR, KENDIT, SITUBONDO, JAWA TIMUR",1,72,140,212
https://kawalpemilu.org#51472,"LAKARSANTRI, LAKARSANTRI, KOTA SURABAYA, JAWA TIMUR",7,148,46,194
https://kawalpemilu.org#50814,"JULUK, SARONGGI, SUMENEP, JAWA TIMUR",9,110,54,164
https://kawalpemilu.org#45957,"PANDITAN, LUMBANG, PASURUAN, JAWA TIMUR",2,120,101,221
https://kawalpemilu.org#43843,"BELOR, PURWOASRI, KEDIRI, JAWA TIMUR",6,189,31,220
https://kawalpemilu.org#45231,"JETIS, CURAHDAMI, BONDOWOSO, JAWA TIMUR",14,55,146,201
https://kawalpemilu.org#44906,"KARANGHARJO, SILO, JEMBER, JAWA TIMUR",4,126,68,194
https://kawalpemilu.org#45379,"BENDELAN, BINAKAL, BONDOWOSO, JAWA TIMUR",3,49,68,117
https://kawalpemilu.org#47122,"PUNDONG, DIWEK, JOMBANG, JAWA TIMUR",10,135,52,187
https://kawalpemilu.org#43444,"KARANGBENDO, PONGGOK, BLITAR, JAWA TIMUR",18,134,16,150
https://kawalpemilu.org#48214,"BANJARANSARI, PADAS, NGAWI, JAWA TIMUR",1,230,18,248
https://kawalpemilu.org#48892,"MANDER, TAMBAKBOYO, TUBAN, JAWA TIMUR",4,183,19,202
https://kawalpemilu.org#48472,"DROKILO, KEDUNGADEM, BOJONEGORO, JAWA TIMUR",1,31,151,182
https://kawalpemilu.org#45870,"LAWEYAN, SUMBERASIH, PROBOLINGGO, JAWA TIMUR",11,113,71,184
https://kawalpemilu.org#51380,"NGAGEL, WONOKROMO, KOTA SURABAYA, JAWA TIMUR",14,114,60,174
https://kawalpemilu.org#50059,"TUNJUNG, BURNEH, BANGKALAN, JAWA TIMUR",22,53,140,193
https://kawalpemilu.org#47920,"SUGIHREJO, KAWEDANAN, MAGETAN, JAWA TIMUR",9,116,19,135
https://kawalpemilu.org#44875,"PLALANGAN, KALISAT, JEMBER, JAWA TIMUR",13,122,43,165
https://kawalpemilu.org#43331,"GANDONG, BANDUNG, TULUNGAGUNG, JAWA TIMUR",5,141,28,169
https://kawalpemilu.org#43725,"SEMPU, NGANCAR, KEDIRI, JAWA TIMUR",11,144,12,156
https://kawalpemilu.org#42462,"WORAWARI, KEBONAGUNG, PACITAN, JAWA TIMUR",9,22,100,122
https://kawalpemilu.org#44306,"CANDIRENGGO, SINGOSARI, MALANG, JAWA TIMUR",25,107,73,180
https://kawalpemilu.org#48320,"CANTEL, PITU, NGAWI, JAWA TIMUR",4,194,39,233
https://kawalpemilu.org#43188,"TULUNGREJO, KARANGREJO, TULUNGAGUNG, JAWA TIMUR",3,151,40,191
https://kawalpemilu.org#51388,"KEPUTRAN, TEGALSARI, KOTA SURABAYA, JAWA TIMUR",41,148,31,179
https://kawalpemilu.org#50575,"TOBUNGAN, GALIS, PAMEKASAN, JAWA TIMUR",6,63,143,206
https://kawalpemilu.org#48248,"TEMPURAN, PARON, NGAWI, JAWA TIMUR",22,82,92,174
https://kawalpemilu.org#51500,"KEBONSARI, JAMBANGAN, KOTA SURABAYA, JAWA TIMUR",6,129,68,197
https://kawalpemilu.org#50783,"GULUKMANJUNG, BLUTO, SUMENEP, JAWA TIMUR",3,60,162,222
https://kawalpemilu.org#43128,"BANJARSARI, NGANTRU, TULUNGAGUNG, JAWA TIMUR",14,124,28,152
https://kawalpemilu.org#42538,"WONOSIDI, TULAKAN, PACITAN, JAWA TIMUR",13,44,139,183
https://kawalpemilu.org#51470,"BANGKINGAN, LAKARSANTRI, KOTA SURABAYA, JAWA TIMUR",3,141,55,196
https://kawalpemilu.org#51395,"KUPANG KRAJAN, SAWAHAN, KOTA SURABAYA, JAWA TIMUR",12,163,58,221
https://kawalpemilu.org#48301,"PARAS, PANGKUR, NGAWI, JAWA TIMUR",5,188,48,236
https://kawalpemilu.org#42590,"GUNDIK, SLAHUNG, PONOROGO, JAWA TIMUR",7,109,79,188
https://kawalpemilu.org#47239,"KAMPUNGBARU, PLANDAAN, JOMBANG, JAWA TIMUR",2,103,55,158
https://kawalpemilu.org#43074,"TAMANAN, TULUNGAGUNG, TULUNGAGUNG, JAWA TIMUR",4,125,47,172
https://kawalpemilu.org#51267,"JREBENG LOR, KEDOPAK, KOTA PROBOLINGGO, JAWA TIMUR",8,101,151,252
https://kawalpemilu.org#47114,"PUTON, DIWEK, JOMBANG, JAWA TIMUR",8,197,35,232
https://kawalpemilu.org#46813,"SARIREJO, MOJOSARI, MOJOKERTO, JAWA TIMUR",7,85,63,148
https://kawalpemilu.org#44572,"SUMBEREJO, SUKODONO, LUMAJANG, JAWA TIMUR",13,145,57,202
https://kawalpemilu.org#45427,"DEMUNG, BESUKI, SITUBONDO, JAWA TIMUR",3,50,78,128
https://kawalpemilu.org#44093,"BLAYU, WAJAK, MALANG, JAWA TIMUR",5,115,25,140
https://kawalpemilu.org#50560,"BUDDIH, PADEMAWU, PAMEKASAN, JAWA TIMUR",3,42,170,212
https://kawalpemilu.org#44595,"JATIROTO, JATIROTO, LUMAJANG, JAWA TIMUR",12,141,36,177
https://kawalpemilu.org#45934,"KAYU KEBEK, TUTUR, PASURUAN, JAWA TIMUR",6,150,91,241
https://kawalpemilu.org#43976,"DOKO, NGASEM, KEDIRI, JAWA TIMUR",5,107,62,169
https://kawalpemilu.org#49262,"BRONDONG, BRONDONG, LAMONGAN, JAWA TIMUR",17,116,86,202
https://kawalpemilu.org#42984,"KARANGREJO, KAMPAK, TRENGGALEK, JAWA TIMUR",15,120,7,127
https://kawalpemilu.org#47994,"TANJUNG, BENDO, MAGETAN, JAWA TIMUR",4,138,79,217
https://kawalpemilu.org#45000,"SETAIL, GENTENG, BANYUWANGI, JAWA TIMUR",50,136,21,157
https://kawalpemilu.org#50520,"GULBUNG, PANGARENGAN, SAMPANG, JAWA TIMUR",4,79,135,214
https://kawalpemilu.org#46777,"SEKARGADUNG, PUNGGING, MOJOKERTO, JAWA TIMUR",16,95,58,153
https://kawalpemilu.org#43756,"PRANGGANG, PLOSOKLATEN, KEDIRI, JAWA TIMUR",23,91,12,103
https://kawalpemilu.org#46447,"BLIGO, CANDI, SIDOARJO, JAWA TIMUR",11,152,69,221
https://kawalpemilu.org#45201,"SUKOSARI LOR, SUKOSARI, BONDOWOSO, JAWA TIMUR",3,60,90,150
https://kawalpemilu.org#50497,"TAMBERU DAYA, SOKOBANAH, SAMPANG, JAWA TIMUR",15,5,173,178
https://kawalpemilu.org#46906,"MODONGAN, SOOKO, MOJOKERTO, JAWA TIMUR",8,149,73,222
https://kawalpemilu.org#45919,"DAWUHAN SENGON, PURWODADI, PASURUAN, JAWA TIMUR",1,188,43,231
https://kawalpemilu.org#49497,"LOPANG, KEMBANGBAHU, LAMONGAN, JAWA TIMUR",14,147,93,240
https://kawalpemilu.org#44487,"YOSOWILANGUN KIDUL, YOSOWILANGUN, LUMAJANG, JAWA TIMUR",22,148,61,209
https://kawalpemilu.org#49599,"SIDOREJO, DEKET, LAMONGAN, JAWA TIMUR",5,177,66,243
https://kawalpemilu.org#50161,"TAGUNGGUH, TANJUNG BUMI, BANGKALAN, JAWA TIMUR",11,270,0,270
https://kawalpemilu.org#43266,"SUMBERAGUNG, REJOTANGAN, TULUNGAGUNG, JAWA TIMUR",16,165,24,189
https://kawalpemilu.org#47308,"BALONGSARI, MEGALUH, JOMBANG, JAWA TIMUR",5,130,61,191
https://kawalpemilu.org#43890,"KAMPUNGBARU, KEPUNG, KEDIRI, JAWA TIMUR",18,175,17,192
https://kawalpemilu.org#43004,"SUMURUP, BENDUNGAN, TRENGGALEK, JAWA TIMUR",13,143,9,152
https://kawalpemilu.org#43748,"JARAK, PLOSOKLATEN, KEDIRI, JAWA TIMUR",24,153,35,188
https://kawalpemilu.org#47472,"WAUNG, BARON, NGANJUK, JAWA TIMUR",2,124,70,194
https://kawalpemilu.org#43026,"SUMBERGEDONG, TRENGGALEK, TRENGGALEK, JAWA TIMUR",12,137,77,214
https://kawalpemilu.org#45731,"PONDOK KELOR, PAITON, PROBOLINGGO, JAWA TIMUR",9,104,139,243
https://kawalpemilu.org#44009,"SEMPOL, PAGAK, MALANG, JAWA TIMUR",15,109,5,114
https://kawalpemilu.org#46113,"PAGAK, BEJI, PASURUAN, JAWA TIMUR",7,115,138,253
https://kawalpemilu.org#44981,"GAMBIRAN, GAMBIRAN, BANYUWANGI, JAWA TIMUR",31,162,33,195
https://kawalpemilu.org#45522,"PERANTE, ASEMBAGUS, SITUBONDO, JAWA TIMUR",12,58,142,200
https://kawalpemilu.org#49933,"SIDO WUNGU, MENGANTI, GRESIK, JAWA TIMUR",2,194,59,253
https://kawalpemilu.org#50050,"PARSEH, SOCAH, BANGKALAN, JAWA TIMUR",18,115,84,199
https://kawalpemilu.org#43112,"REJOAGUNG, KEDUNGWARU, TULUNGAGUNG, JAWA TIMUR",20,159,36,195
https://kawalpemilu.org#46808,"KEPUHPANDAK, KUTOREJO, MOJOKERTO, JAWA TIMUR",11,141,60,201
https://kawalpemilu.org#47756,"WAYUT, JIWAN, MADIUN, JAWA TIMUR",5,137,32,169
https://kawalpemilu.org#50147,"KLABETAN, SEPULU, BANGKALAN, JAWA TIMUR",4,100,50,150
https://kawalpemilu.org#51438,"PERAK UTARA, PABEAN CANTIKAN, KOTA SURABAYA, JAWA TIMUR",40,107,84,191
https://kawalpemilu.org#43887,"PELEM, PARE, KEDIRI, JAWA TIMUR",29,155,45,200
https://kawalpemilu.org#51514,"MULYOREJO, MULYOREJO, KOTA SURABAYA, JAWA TIMUR",36,180,20,200
https://kawalpemilu.org#44645,"PADOMASAN, JOMBANG, JEMBER, JAWA TIMUR",2,87,41,128
https://kawalpemilu.org#51572,"BEJI, JUNREJO, KOTA BATU, JAWA TIMUR",7,131,62,193
https://kawalpemilu.org#49181,"KEDUNGWARAS, MODO, LAMONGAN, JAWA TIMUR",1,154,59,213
https://kawalpemilu.org#50588,"BUGIH, PAMEKASAN, PAMEKASAN, JAWA TIMUR",43,67,133,200
https://kawalpemilu.org#46146,"SIYAR, REMBANG, PASURUAN, JAWA TIMUR",6,113,154,267
https://kawalpemilu.org#50720,"KERTAGENAH TENGAH, KADUR, PAMEKASAN, JAWA TIMUR",9,112,57,169
https://kawalpemilu.org#50370,"PEKALONGAN, SAMPANG, SAMPANG, JAWA TIMUR",6,52,150,202
https://kawalpemilu.org#43356,"TANGGUNG GUNUNG, TANGGUNGGUNUNG, TULUNGAGUNG, JAWA TIMUR",10,159,17,176
https://kawalpemilu.org#51387,"KEDUNGDORO, TEGALSARI, KOTA SURABAYA, JAWA TIMUR",63,149,48,197
https://kawalpemilu.org#44725,"TISNOGAMBAR, BANGSALSARI, JEMBER, JAWA TIMUR",26,87,85,172
https://kawalpemilu.org#49998,"SIDO RUKUN, GRESIK, GRESIK, JAWA TIMUR",2,116,141,257
https://kawalpemilu.org#51444,"TEMBOK DUKUH, BUBUTAN, KOTA SURABAYA, JAWA TIMUR",26,121,49,170
https://kawalpemilu.org#46598,"PADEMONEGORO, SUKODONO, SIDOARJO, JAWA TIMUR",6,158,41,199
https://kawalpemilu.org#44775,"KARANGPRING, SUKORAMBI, JEMBER, JAWA TIMUR",6,102,81,183
https://kawalpemilu.org#47134,"JOMBATAN, JOMBANG, JOMBANG, JAWA TIMUR",6,124,94,218
https://kawalpemilu.org#46469,"BLURU KIDUL, SIDOARJO, SIDOARJO, JAWA TIMUR",17,156,31,187
https://kawalpemilu.org#44807,"KALIWATES, KALIWATES, JEMBER, JAWA TIMUR",16,133,38,171
https://kawalpemilu.org#45129,"TEMUGURUH, SEMPU, BANYUWANGI, JAWA TIMUR",11,169,40,209
https://kawalpemilu.org#43510,"JEGU, SUTOJAYAN, BLITAR, JAWA TIMUR",6,156,24,180
https://kawalpemilu.org#45452,"KLATAKAN, KENDIT, SITUBONDO, JAWA TIMUR",10,130,53,183
https://kawalpemilu.org#43442,"MALIRAN, PONGGOK, BLITAR, JAWA TIMUR",5,154,14,168
https://kawalpemilu.org#44751,"KARANGANYAR, AMBULU, JEMBER, JAWA TIMUR",48,184,13,197
https://kawalpemilu.org#49660,"GEDONGKEDOAN, DUKUN, GRESIK, JAWA TIMUR",1,152,35,187
https://kawalpemilu.org#50723,"BANGKES, KADUR, PAMEKASAN, JAWA TIMUR",30,12,140,152
https://kawalpemilu.org#51206,"ARJOWINANGUN, KEDUNGKANDANG, KOTA MALANG, JAWA TIMUR",11,154,92,246
https://kawalpemilu.org#46462,"MAGERSARI, SIDOARJO, SIDOARJO, JAWA TIMUR",41,125,101,226
https://kawalpemilu.org#49300,"KUDIKAN, SEKARAN, LAMONGAN, JAWA TIMUR",3,52,27,79
https://kawalpemilu.org#47514,"KRAMAT, NGANJUK, NGANJUK, JAWA TIMUR",15,149,36,185
https://kawalpemilu.org#44186,"GUNUNGSARI, TAJINAN, MALANG, JAWA TIMUR",1,182,35,217
https://kawalpemilu.org#43215,"BENDILWUNGU, SUMBERGEMPOL, TULUNGAGUNG, JAWA TIMUR",7,151,23,174
https://kawalpemilu.org#49218,"SOGO, BABAT, LAMONGAN, JAWA TIMUR",6,146,61,207
https://kawalpemilu.org#45686,"GUNGGUNGAN LOR, PAKUNIRAN, PROBOLINGGO, JAWA TIMUR",6,130,88,218
https://kawalpemilu.org#46063,"PECALUKAN, PRIGEN, PASURUAN, JAWA TIMUR",27,149,47,196
https://kawalpemilu.org#46085,"TUNGGUL WULUNG, PANDAAN, PASURUAN, JAWA TIMUR",11,166,37,203
https://kawalpemilu.org#51536,"KENJERAN, BULAK, KOTA SURABAYA, JAWA TIMUR",18,213,18,231
https://kawalpemilu.org#47013,"SUKOREJO, PERAK, JOMBANG, JAWA TIMUR",18,100,44,144
https://kawalpemilu.org#46937,"MOJOSARIREJO, KEMLAGI, MOJOKERTO, JAWA TIMUR",7,144,24,168
https://kawalpemilu.org#49092,"SUMBERAGUNG, PLUMPANG, TUBAN, JAWA TIMUR",17,155,51,206
https://kawalpemilu.org#43152,"WONOREJO, PAGERWOJO, TULUNGAGUNG, JAWA TIMUR",7,189,36,225
https://kawalpemilu.org#49905,"KEMANGI, BUNGAH, GRESIK, JAWA TIMUR",3,153,36,189
https://kawalpemilu.org#47705,"BOLO, KARE, MADIUN, JAWA TIMUR",2,143,41,184
https://kawalpemilu.org#49883,"IKER IKER GEGER, CERME, GRESIK, JAWA TIMUR",5,113,99,212
https://kawalpemilu.org#50588,"BUGIH, PAMEKASAN, PAMEKASAN, JAWA TIMUR",3,29,114,143
https://kawalpemilu.org#42663,"JURUG, SOOKO, PONOROGO, JAWA TIMUR",4,164,61,225
https://kawalpemilu.org#46528,"KATERUNGAN, KRIAN, SIDOARJO, JAWA TIMUR",9,147,75,222
https://kawalpemilu.org#43587,"SIDOREJO, DOKO, BLITAR, JAWA TIMUR",5,160,11,171
https://kawalpemilu.org#50403,"KAMONDUNG, OMBEN, SAMPANG, JAWA TIMUR",12,2,238,238
https://kawalpemilu.org#45110,"WATUKEBO, WONGSOREJO, BANYUWANGI, JAWA TIMUR",18,163,57,220
https://kawalpemilu.org#46208,"LAJUK, GONDANGWETAN, PASURUAN, JAWA TIMUR",3,154,75,229
https://kawalpemilu.org#42893,"KRISIK, PUDAK, PONOROGO, JAWA TIMUR",4,124,19,143
https://kawalpemilu.org#44460,"LEMPENI, TEMPEH, LUMAJANG, JAWA TIMUR",16,158,38,196
https://kawalpemilu.org#47824,"KENONGOREJO, PILANGKENCENG, MADIUN, JAWA TIMUR",9,122,96,218
https://kawalpemilu.org#49007,"MENTOSO, JENU, TUBAN, JAWA TIMUR",2,144,49,193
https://kawalpemilu.org#44743,"GLUNDENGAN, WULUHAN, JEMBER, JAWA TIMUR",38,118,69,187
https://kawalpemilu.org#42489,"GAYUHAN, ARJOSARI, PACITAN, JAWA TIMUR",6,67,108,175
https://kawalpemilu.org#49626,"KENTONG, GLAGAH, LAMONGAN, JAWA TIMUR",1,37,154,191
https://kawalpemilu.org#43886,"TULUNGREJO, PARE, KEDIRI, JAWA TIMUR",20,144,83,227
https://kawalpemilu.org#43733,"BABADAN, NGANCAR, KEDIRI, JAWA TIMUR",10,192,13,205
https://kawalpemilu.org#46702,"KALIKATIR, GONDANG, MOJOKERTO, JAWA TIMUR",3,173,37,210
https://kawalpemilu.org#45400,"GAYAM, BOTOLINGGO, BONDOWOSO, JAWA TIMUR",1,65,153,218
https://kawalpemilu.org#48595,"SOBONTORO, BALEN, BOJONEGORO, JAWA TIMUR",12,122,63,185
https://kawalpemilu.org#43310,"PELEM, CAMPURDARAT, TULUNGAGUNG, JAWA TIMUR",18,173,17,190
https://kawalpemilu.org#48003,"DUWET, BENDO, MAGETAN, JAWA TIMUR",2,106,89,195
https://kawalpemilu.org#42538,"WONOSIDI, TULAKAN, PACITAN, JAWA TIMUR",4,44,137,181
https://kawalpemilu.org#43589,"KALIMANIS, DOKO, BLITAR, JAWA TIMUR",11,125,30,155
https://kawalpemilu.org#46423,"GANGGANGPANJANG, TANGGULANGIN, SIDOARJO, JAWA TIMUR",14,126,76,202
https://kawalpemilu.org#46407,"KETAPANG, TANGGULANGIN, SIDOARJO, JAWA TIMUR",2,120,56,176
https://kawalpemilu.org#47278,"KATEMAS, KUDU, JOMBANG, JAWA TIMUR",16,137,35,172
https://kawalpemilu.org#44826,"WIROLEGI, SUMBERSARI, JEMBER, JAWA TIMUR",38,142,41,183
https://kawalpemilu.org#47299,"NGUMPUL, JOGOROTO, JOMBANG, JAWA TIMUR",20,125,27,152
https://kawalpemilu.org#49648,"DERMOLEMAHBANG, SARIREJO, LAMONGAN, JAWA TIMUR",13,136,74,210
https://kawalpemilu.org#47870,"MATEGAL, PARANG, MAGETAN, JAWA TIMUR",9,136,30,166
https://kawalpemilu.org#50544,"LARANGAN TOKOL, TLANAKAN, PAMEKASAN, JAWA TIMUR",17,42,151,193
https://kawalpemilu.org#43319,"NGUNGGAHAN, BANDUNG, TULUNGAGUNG, JAWA TIMUR",21,182,31,213
https://kawalpemilu.org#50363,"GUNUNG SEKAR, SAMPANG, SAMPANG, JAWA TIMUR",7,19,186,205
https://kawalpemilu.org#44733,"BALUNGKULON, BALUNG, JEMBER, JAWA TIMUR",1,118,85,203
https://kawalpemilu.org#51309,"MIJI, KRANGGAN, KOTA MOJOKERTO, JAWA TIMUR",12,145,51,196
https://kawalpemilu.org#48240,"WATUALANG, NGAWI, NGAWI, JAWA TIMUR",5,135,31,166
https://kawalpemilu.org#45506,"CURAH TATAL, ARJASA, SITUBONDO, JAWA TIMUR",5,90,99,189
https://kawalpemilu.org#48169,"TAMBAKROMO, GENENG, NGAWI, JAWA TIMUR",3,145,97,242
https://kawalpemilu.org#43102,"GEDANGSEWU, BOYOLANGU, TULUNGAGUNG, JAWA TIMUR",9,158,42,200
https://kawalpemilu.org#51521,"SUKOMANUNGGAL, SUKOMANUNGGAL, KOTA SURABAYA, JAWA TIMUR",6,151,50,201
https://kawalpemilu.org#50846,"BANBARU, GILI GINTING, SUMENEP, JAWA TIMUR",5,17,72,89
https://kawalpemilu.org#48170,"TEPAS, GENENG, NGAWI, JAWA TIMUR",1,152,34,186
https://kawalpemilu.org#44536,"SENDURO, SENDURO, LUMAJANG, JAWA TIMUR",18,119,52,171
https://kawalpemilu.org#51389,"WONOREJO, TEGALSARI, KOTA SURABAYA, JAWA TIMUR",47,117,53,170
https://kawalpemilu.org#48487,"BRANGKAL, KEPOH BARU, BOJONEGORO, JAWA TIMUR",9,99,104,203
https://kawalpemilu.org#44098,"WAJAK, WAJAK, MALANG, JAWA TIMUR",26,114,78,222
https://kawalpemilu.org#43438,"KAWEDUSAN, PONGGOK, BLITAR, JAWA TIMUR",13,115,37,152
https://kawalpemilu.org#51559,"ORO-ORO OMBO, BATU, KOTA BATU, JAWA TIMUR",26,143,68,211
https://kawalpemilu.org#46670,"WADUNGASRI, WARU, SIDOARJO, JAWA TIMUR",24,190,38,228
https://kawalpemilu.org#51218,"MULYOREJO, SUKUN, KOTA MALANG, JAWA TIMUR",30,148,47,195
https://kawalpemilu.org#44885,"LEDOKOMBO, LEDOKOMBO, JEMBER, JAWA TIMUR",14,122,45,167
https://kawalpemilu.org#50985,"BICABI, DUNGKEK, SUMENEP, JAWA TIMUR",1,95,58,153
https://kawalpemilu.org#44002,"SUMBEROTO, DONOMULYO, MALANG, JAWA TIMUR",11,174,36,210
https://kawalpemilu.org#51239,"KADEMANGAN, KADEMANGAN, KOTA PROBOLINGGO, JAWA TIMUR",18,170,57,227
https://kawalpemilu.org#51043,"SUKAJERUK, MASALEMBU, SUMENEP, JAWA TIMUR",3,102,31,133
https://kawalpemilu.org#51159,"KARANGSARI, SUKOREJO, KOTA BLITAR, JAWA TIMUR",7,155,21,176
https://kawalpemilu.org#43184,"KARANGREJO, KARANGREJO, TULUNGAGUNG, JAWA TIMUR",3,124,68,192
https://kawalpemilu.org#46474,"SUMPUT, SIDOARJO, SIDOARJO, JAWA TIMUR",16,107,53,160
https://kawalpemilu.org#44310,"WATUGEDE, SINGOSARI, MALANG, JAWA TIMUR",4,114,88,202
https://kawalpemilu.org#51139,"NGLETIH, PESANTREN, KOTA KEDIRI, JAWA TIMUR",8,171,25,196
https://kawalpemilu.org#42869,"SAHANG, NGEBEL, PONOROGO, JAWA TIMUR",5,152,20,172
https://kawalpemilu.org#46077,"KUTOREJO, PANDAAN, PASURUAN, JAWA TIMUR",10,142,76,218
https://kawalpemilu.org#50727,"SANA DAJA, PASEAN, PAMEKASAN, JAWA TIMUR",13,5,171,176
https://kawalpemilu.org#46723,"PACET, PACET, MOJOKERTO, JAWA TIMUR",10,157,44,201
https://kawalpemilu.org#51086,"KANGAYAN, KANGAYAN, SUMENEP, JAWA TIMUR",9,46,60,106
https://kawalpemilu.org#46308,"MLIRIPROWO, TARIK, SIDOARJO, JAWA TIMUR",10,155,81,236
https://kawalpemilu.org#49965,"TANJUNGAN, DRIYOREJO, GRESIK, JAWA TIMUR",11,154,57,211
https://kawalpemilu.org#48422,"DANDER, DANDER, BOJONEGORO, JAWA TIMUR",3,101,59,160
https://kawalpemilu.org#48590,"BULAKLO, BALEN, BOJONEGORO, JAWA TIMUR",4,82,83,165
https://kawalpemilu.org#49781,"SEMBUNG, WRINGINANOM, GRESIK, JAWA TIMUR",10,129,72,201
https://kawalpemilu.org#43887,"PELEM, PARE, KEDIRI, JAWA TIMUR",14,139,29,168
https://kawalpemilu.org#51182,"JODIPAN, BLIMBING, KOTA MALANG, JAWA TIMUR",18,144,57,201
https://kawalpemilu.org#49519,"SUGIHWARAS, KALITENGAH, LAMONGAN, JAWA TIMUR",2,123,56,179
https://kawalpemilu.org#44593,"KALIBOTO LOR, JATIROTO, LUMAJANG, JAWA TIMUR",23,117,71,188
https://kawalpemilu.org#51161,"TANJUNGSARI, SUKOREJO, KOTA BLITAR, JAWA TIMUR",14,162,24,186
https://kawalpemilu.org#46817,"SUMBERTANGGUL, MOJOSARI, MOJOKERTO, JAWA TIMUR",5,168,77,245
https://kawalpemilu.org#43219,"JUNJUNG, SUMBERGEMPOL, TULUNGAGUNG, JAWA TIMUR",7,159,23,182
https://kawalpemilu.org#60364,"PAL SEMBILAN, SUNGAI KAKAP, KUBU RAYA, KALIMANTAN BARAT",41,54,187,241
https://kawalpemilu.org#58802,"KERAMAT JAYA, KENDAWANGAN, KETAPANG, KALIMANTAN BARAT",3,180,49,229
https://kawalpemilu.org#59714,"AMBOYO INTI, NGABANG, LANDAK, KALIMANTAN BARAT",33,80,1,81
https://kawalpemilu.org#59521,"NANGA SANGAN, BOYAN TANJUNG, KAPUAS HULU, KALIMANTAN BARAT",1,33,192,225
https://kawalpemilu.org#60206,"SIANTAN HILIR, PONTIANAK UTARA, KOTA PONTIANAK, KALIMANTAN BARAT",69,33,189,222
https://kawalpemilu.org#59763,"KAYU TANAM, MANDOR, LANDAK, KALIMANTAN BARAT",7,198,2,200
https://kawalpemilu.org#59560,"SUNGAI JAGA A, SUNGAI RAYA, BENGKAYANG, KALIMANTAN BARAT",4,120,5,125
https://kawalpemilu.org#60095,"BINA JAYA, PINOH SELATAN, MELAWI, KALIMANTAN BARAT",2,192,11,203
https://kawalpemilu.org#58524,"JUNGKAT, SIANTAN, MEMPAWAH, KALIMANTAN BARAT",32,67,118,185
https://kawalpemilu.org#59780,"TENGON, AIR BESAR, LANDAK, KALIMANTAN BARAT",4,115,28,143
https://kawalpemilu.org#60192,"BANJAR SERASAN, PONTIANAK TIMUR, KOTA PONTIANAK, KALIMANTAN BARAT",23,56,195,251
https://kawalpemilu.org#58752,"KUALA SATONG, MATAN HILIR UTARA, KETAPANG, KALIMANTAN BARAT",2,60,164,224
https://kawalpemilu.org#60186,"BENUA MELAYU DARAT, PONTIANAK SELATAN, KOTA PONTIANAK, KALIMANTAN BARAT",89,138,51,189
https://kawalpemilu.org#60202,"SUNGAI BELIUNG, PONTIANAK BARAT, KOTA PONTIANAK, KALIMANTAN BARAT",68,53,188,241
https://kawalpemilu.org#60253,"SIJANGKUNG, SINGKAWANG SELATAN, KOTA SINGKAWANG, KALIMANTAN BARAT",7,166,1,167
https://kawalpemilu.org#85358,"PARIT BARU, SUNGAI RAYA, KUBU RAYA, KALIMANTAN BARAT",80,104,109,213
https://kawalpemilu.org#58417,"SUNGAI DEDEN, SUBAH, SAMBAS, KALIMANTAN BARAT",9,107,48,155
https://kawalpemilu.org#58947,"SAMPIT, DELTA PAWAN, KETAPANG, KALIMANTAN BARAT",31,64,150,214
https://kawalpemilu.org#59631,"TERIAK, TERIAK, BENGKAYANG, KALIMANTAN BARAT",1,221,16,237
https://kawalpemilu.org#58572,"ILIR KOTA, KAPUAS, SANGGAU, KALIMANTAN BARAT",10,69,112,181
https://kawalpemilu.org#60213,"SUNGAI JAWI, PONTIANAK KOTA, KOTA PONTIANAK, KALIMANTAN BARAT",111,44,173,217
https://kawalpemilu.org#58362,"MATANG LABONG, TEBAS, SAMBAS, KALIMANTAN BARAT",8,98,115,213
https://kawalpemilu.org#58340,"SUNGAI NYIRIH, JAWAI, SAMBAS, KALIMANTAN BARAT",9,42,114,156
https://kawalpemilu.org#59935,"SEBETUNG, BELITANG HULU, SEKADAU, KALIMANTAN BARAT",8,142,2,144
https://kawalpemilu.org#85358,"PARIT BARU, SUNGAI RAYA, KUBU RAYA, KALIMANTAN BARAT",85,48,77,125
https://kawalpemilu.org#60055,"MADONG RAYA, TANAH PINOH, MELAWI, KALIMANTAN BARAT",5,113,106,219
https://kawalpemilu.org#60270,"MEKAR SARI, SUNGAI RAYA, KUBU RAYA, KALIMANTAN BARAT",22,36,190,226
https://kawalpemilu.org#60202,"SUNGAI BELIUNG, PONTIANAK BARAT, KOTA PONTIANAK, KALIMANTAN BARAT",34,73,78,151
https://kawalpemilu.org#58646,"SUNGAI TEKAM, SEKAYAM, SANGGAU, KALIMANTAN BARAT",5,187,3,190
https://kawalpemilu.org#59607,"KUMBA, JAGOI BABANG, BENGKAYANG, KALIMANTAN BARAT",2,93,124,217
https://kawalpemilu.org#58464,"MATANG TERAP, JAWAI SELATAN, SAMBAS, KALIMANTAN BARAT",11,90,24,114
https://kawalpemilu.org#59055,"RIAM BATU, TEMPUNAK, SINTANG, KALIMANTAN BARAT",3,144,14,158
https://kawalpemilu.org#58754,"TANJUNG BAIK BUDI, MATAN HILIR UTARA, KETAPANG, KALIMANTAN BARAT",10,98,110,208
https://kawalpemilu.org#930878,"BOTUH BOSI, SIMPANG HULU, KETAPANG, KALIMANTAN BARAT",7,48,8,56
https://kawalpemilu.org#59026,"BANING KOTA, SINTANG, SINTANG, KALIMANTAN BARAT",19,31,90,121
https://kawalpemilu.org#60260,"KUALA DUA, SUNGAI RAYA, KUBU RAYA, KALIMANTAN BARAT",11,33,204,237
https://kawalpemilu.org#58294,"LORONG, SAMBAS, SAMBAS, KALIMANTAN BARAT",4,97,105,202
https://kawalpemilu.org#60251,"SEDAU, SINGKAWANG SELATAN, KOTA SINGKAWANG, KALIMANTAN BARAT",70,127,15,142
https://kawalpemilu.org#58744,"NEKAN, ENTIKONG, SANGGAU, KALIMANTAN BARAT",1,144,9,153
https://kawalpemilu.org#58524,"JUNGKAT, SIANTAN, MEMPAWAH, KALIMANTAN BARAT",8,45,165,210
https://kawalpemilu.org#58382,"SENUJUH, SEJANGKUNG, SAMBAS, KALIMANTAN BARAT",4,50,91,141
https://kawalpemilu.org#64063,"ALALAK UTARA, BANJARMASIN UTARA, KOTA BANJARMASIN, KALIMANTAN SELATAN",34,66,191,257
https://kawalpemilu.org#62730,"PUNTIK LUAR, MANDASTANA, BARITO KUALA, KALIMANTAN SELATAN",1,53,148,201
https://kawalpemilu.org#64034,"KELAYAN DALAM, BANJARMASIN SELATAN, KOTA BANJARMASIN, KALIMANTAN SELATAN",1,42,170,212
https://kawalpemilu.org#62731,"PUNTIK DALAM, MANDASTANA, BARITO KUALA, KALIMANTAN SELATAN",1,103,105,208
https://kawalpemilu.org#63759,"RANTAU PANJANG HULU, KUSAN HILIR, TANAH BUMBU, KALIMANTAN SELATAN",1,67,102,169
https://kawalpemilu.org#62023,"SARIKANDI, KURAU, TANAH LAUT, KALIMANTAN SELATAN",3,82,76,158
https://kawalpemilu.org#62255,"SAMPANAHAN, SAMPANAHAN, KOTABARU, KALIMANTAN SELATAN",1,37,90,127
https://kawalpemilu.org#63273,"BANUA JINGAH, BARABAI, HULU SUNGAI TENGAH, KALIMANTAN SELATAN",1,46,179,225
https://kawalpemilu.org#62032,"NUSA INDAH, BATI BATI, TANAH LAUT, KALIMANTAN SELATAN",8,110,120,230
https://kawalpemilu.org#63377,"PARUPUKAN, BABIRIK, HULU SUNGAI UTARA, KALIMANTAN SELATAN",1,54,50,104
https://kawalpemilu.org#63587,"BANUA RANTAU, BANUA LAWAS, TABALONG, KALIMANTAN SELATAN",5,26,142,168
https://kawalpemilu.org#62085,"GUNUNG MELATI, BATU AMPAR, TANAH LAUT, KALIMANTAN SELATAN",2,130,83,213
https://kawalpemilu.org#62887,"MANDURIAN, TAPIN TENGAH, TAPIN, KALIMANTAN SELATAN",1,25,179,204
https://kawalpemilu.org#63993,"LAMIDA BAWAH, PARINGIN, BALANGAN, KALIMANTAN SELATAN",2,12,73,85
https://kawalpemilu.org#64033,"KELAYAN TENGAH, BANJARMASIN SELATAN, KOTA BANJARMASIN, KALIMANTAN SELATAN",17,84,142,226
https://kawalpemilu.org#64110,"SUNGAI  BESAR, BANJARBARU SELATAN, KOTA BANJARBARU, KALIMANTAN SELATAN",21,77,147,224
https://kawalpemilu.org#62517,"PENYIURAN, PENGAROM, BANJAR, KALIMANTAN SELATAN",3,36,112,148
https://kawalpemilu.org#63333,"ATIRAN, BATANG ALAI TIMUR, HULU SUNGAI TENGAH, KALIMANTAN SELATAN",1,114,93,207
https://kawalpemilu.org#62440,"LIHUNG, KARANG INTAN, BANJAR, KALIMANTAN SELATAN",3,10,54,64
https://kawalpemilu.org#63748,"MUDALANG, KUSAN HILIR, TANAH BUMBU, KALIMANTAN SELATAN",3,79,120,199
https://kawalpemilu.org#63158,"ULANG, LOKSADO, HULU SUNGAI SELATAN, KALIMANTAN SELATAN",3,141,24,165
https://kawalpemilu.org#62711,"HANDIL BAKTI, ALALAK, BARITO KUALA, KALIMANTAN SELATAN",8,63,125,188
https://kawalpemilu.org#62391,"PEMAKUAN, SUNGAI TABUK, BANJAR, KALIMANTAN SELATAN",3,28,158,186
https://kawalpemilu.org#63660,"KAPAR, MURUNG PUDAK, TABALONG, KALIMANTAN SELATAN",6,45,99,144
https://kawalpemilu.org#64076,"TELUK DALAM, BANJARMASIN TENGAH, KOTA BANJARMASIN, KALIMANTAN SELATAN",58,99,151,250
https://kawalpemilu.org#64094,"SUNGAI TIUNG, CEMPAKA, KOTA BANJARBARU, KALIMANTAN SELATAN",24,53,64,117
https://kawalpemilu.org#62192,"GEDAMBAAN, PULAULAUT UTARA, KOTABARU, KALIMANTAN SELATAN",3,65,62,127
https://kawalpemilu.org#62188,"HILIR MUARA, PULAULAUT UTARA, KOTABARU, KALIMANTAN SELATAN",4,60,145,205
https://kawalpemilu.org#63786,"SUNGAIDANAU, SATUI, TANAH BUMBU, KALIMANTAN SELATAN",36,53,116,169
https://kawalpemilu.org#63792,"SEJAHTERA MULIA, SATUI, TANAH BUMBU, KALIMANTAN SELATAN",5,106,66,172
https://kawalpemilu.org#63925,"AWAYAN HILIR, AWAYAN, BALANGAN, KALIMANTAN SELATAN",2,16,101,117
https://kawalpemilu.org#62564,"PINDAHAN BARU, BERUNTUNG BARU, BANJAR, KALIMANTAN SELATAN",2,53,170,223
https://kawalpemilu.org#63282,"TEMBUK BAHALANG, BATANG ALAI SELATAN, HULU SUNGAI TENGAH, KALIMANTAN SELATAN",2,41,87,128
https://kawalpemilu.org#61036,"LEMO I, TEWEH TENGAH, BARITO UTARA, KALIMANTAN TENGAH",5,52,15,67
https://kawalpemilu.org#61758,"MUARA TUHUP, LAUNG TUHUP, MURUNG RAYA, KALIMANTAN TENGAH",5,68,166,234
https://kawalpemilu.org#61905,"TELANG, PAJU EPAT, BARITO TIMUR, KALIMANTAN TENGAH",1,162,24,186
https://kawalpemilu.org#60680,"BAKUNGIN, KAPUAS HILIR, KAPUAS, KALIMANTAN TENGAH",1,45,99,144
https://kawalpemilu.org#61028,"MELAYU, TEWEH TENGAH, BARITO UTARA, KALIMANTAN TENGAH",15,48,108,156
https://kawalpemilu.org#92612,"BAHAUR BATU RAYA, KAHAYAN KUALA, PULANG PISAU, KALIMANTAN TENGAH",2,90,48,138
https://kawalpemilu.org#60549,"PONDOK DAMAR, MENTAYA HILIR UTARA, KOTAWARINGIN TIMUR, KALIMANTAN TENGAH",3,96,36,132
https://kawalpemilu.org#61933,"LANGKAI, PAHANDUT, KOTA PALANGKARAYA, KALIMANTAN TENGAH",10,101,72,173
https://kawalpemilu.org#60398,"BARU, ARUT SELATAN, KOTAWARINGIN BARAT, KALIMANTAN TENGAH",37,121,92,213
https://kawalpemilu.org#61933,"LANGKAI, PAHANDUT, KOTA PALANGKARAYA, KALIMANTAN TENGAH",86,123,38,161
https://kawalpemilu.org#60904,"MARAWAN LAMA, DUSUN UTARA, BARITO SELATAN, KALIMANTAN TENGAH",5,80,21,101
https://kawalpemilu.org#61939,"TUMBANG TAHAI, BUKIT BATU, KOTA PALANGKARAYA, KALIMANTAN TENGAH",2,221,46,267
https://kawalpemilu.org#60942,"BUNTOK KOTA, DUSUN SELATAN, BARITO SELATAN, KALIMANTAN TENGAH",12,87,108,195
https://kawalpemilu.org#61381,"LUPU PERUCA, BALAI RIAM, SUKAMARA, KALIMANTAN TENGAH",1,185,54,239
https://kawalpemilu.org#60395,"SIDOREJO, ARUT SELATAN, KOTAWARINGIN BARAT, KALIMANTAN TENGAH",41,72,53,125
https://kawalpemilu.org#60630,"SUNGAI UBAR MANDIIRI, CEMPAGA HULU, KOTAWARINGIN TIMUR, KALIMANTAN TENGAH",2,66,57,123
https://kawalpemilu.org#61171,"TUMBANG TUNDU, MARIKIT, KATINGAN, KALIMANTAN TENGAH",1,61,7,68
https://kawalpemilu.org#61919,"PATUNG, PAKU, BARITO TIMUR, KALIMANTAN TENGAH",2,121,13,134
https://kawalpemilu.org#61940,"BANTURUNG, BUKIT BATU, KOTA PALANGKARAYA, KALIMANTAN TENGAH",13,120,10,130
https://kawalpemilu.org#61470,"BAYAT, BELANTIKAN RAYA, LAMANDAU, KALIMANTAN TENGAH",3,151,46,197
https://kawalpemilu.org#64592,"SEMURUT, TABALAR, BERAU, KALIMANTAN TIMUR",1,65,145,210
https://kawalpemilu.org#65624,"SUNGAI PINANG LUAR, SAMARINDA KOTA, KOTA SAMARINDA, KALIMANTAN TIMUR",16,65,161,226
https://kawalpemilu.org#65218,"JAMBUK MAKMUR, BONGAN, KUTAI BARAT, KALIMANTAN TIMUR",3,137,66,203
https://kawalpemilu.org#65582,"SIDODADI, SAMARINDA ULU, KOTA SAMARINDA, KALIMANTAN TIMUR",40,117,56,173
https://kawalpemilu.org#65488,"JENEBORA, PENAJAM, PENAJAM PASER UTARA, KALIMANTAN TIMUR",9,89,48,137
https://kawalpemilu.org#64316,"KAMPUNG BARU, TENGGARONG, KUTAI KARTANEGARA, KALIMANTAN TIMUR",2,55,127,182
https://kawalpemilu.org#65536,"BARU TENGAH, BALIKPAPAN BARAT, KOTA BALIKPAPAN, KALIMANTAN TIMUR",49,82,142,224
https://kawalpemilu.org#65150,"REJO BASUKI, BARONG TONGKOK, KUTAI BARAT, KALIMANTAN TIMUR",1,228,32,260
https://kawalpemilu.org#87249,"DAMAI BARU, BALIKPAPAN SELATAN, KOTA BALIKPAPAN, KALIMANTAN TIMUR",14,133,84,217
https://kawalpemilu.org#65560,"GUNUNGBAHAGIA, BALIKPAPAN SELATAN, KOTA BALIKPAPAN, KALIMANTAN TIMUR",34,121,129,250
https://kawalpemilu.org#64459,"BUKIT RAYA, TENGGARONG SEBERANG, KUTAI KARTANEGARA, KALIMANTAN TIMUR",1,137,69,206
https://kawalpemilu.org#65603,"LOK BAHU, SUNGAI KUNJANG, KOTA SAMARINDA, KALIMANTAN TIMUR",7,62,77,139
https://kawalpemilu.org#64165,"PASIR MAYANG, KUARO, PASER, KALIMANTAN TIMUR",3,110,135,245
https://kawalpemilu.org#65570,"HANDIL BAKTI, PALARAN, KOTA SAMARINDA, KALIMANTAN TIMUR",25,58,60,118
https://kawalpemilu.org#64272,"KARYA UTAMA, LOA KULU, KUTAI KARTANEGARA, KALIMANTAN TIMUR",5,107,85,192
https://kawalpemilu.org#65666,"BERBAS TENGAH, BONTANG SELATAN, KOTA BONTANG, KALIMANTAN TIMUR",12,152,95,247
https://kawalpemilu.org#92755,"HANDIL BARU DARAT, SAMBOJA, KUTAI KARTANEGARA, KALIMANTAN TIMUR",6,61,121,182
https://kawalpemilu.org#64118,"SUNGAI TERIK, BATU SOPANG, PASER, KALIMANTAN TIMUR",3,84,49,133
https://kawalpemilu.org#64478,"SANTAN ULU, MARANG KAYU, KUTAI KARTANEGARA, KALIMANTAN TIMUR",10,118,17,135
https://kawalpemilu.org#64144,"TANAH GROGOT, TANAH GROGOT, PASER, KALIMANTAN TIMUR",12,43,199,242
https://kawalpemilu.org#929152,"CAPUAK, TALISAYAN, BERAU, KALIMANTAN TIMUR",2,119,20,139
https://kawalpemilu.org#64408,"SIDOMULYO, TABANG, KUTAI KARTANEGARA, KALIMANTAN TIMUR",3,66,44,110
https://kawalpemilu.org#64547,"HARAPAN JAYA, SEGAH, BERAU, KALIMANTAN TIMUR",2,146,83,229
https://kawalpemilu.org#65389,"SEPASO, BENGALON, KUTAI TIMUR, KALIMANTAN TIMUR",15,127,108,235
https://kawalpemilu.org#65603,"LOK BAHU, SUNGAI KUNJANG, KOTA SAMARINDA, KALIMANTAN TIMUR",38,109,140,249
https://kawalpemilu.org#64192,"KERTA BHAKTI, LONG IKIS, PASER, KALIMANTAN TIMUR",3,130,61,191
https://kawalpemilu.org#65579,"TELUK LERONG ILIR, SAMARINDA ULU, KOTA SAMARINDA, KALIMANTAN TIMUR",34,47,59,106
https://kawalpemilu.org#65597,"SEMPAJA UTARA, SAMARINDA UTARA, KOTA SAMARINDA, KALIMANTAN TIMUR",15,69,72,141
https://kawalpemilu.org#65633,"KARANG ANYAR, TARAKAN BARAT, KOTA TARAKAN, KALIMANTAN UTARA",45,116,35,151
https://kawalpemilu.org#65636,"KARANG BALIK, TARAKAN BARAT, KOTA TARAKAN, KALIMANTAN UTARA",1,150,75,225
https://kawalpemilu.org#64665,"LEPAK ARU, PESO, BULUNGAN, KALIMANTAN UTARA",1,217,19,236
https://kawalpemilu.org#64984,"LONG PIPA, KAYAN HILIR, MALINAU, KALIMANTAN UTARA",1,166,10,176
https://kawalpemilu.org#64970,"MALINAU HILIR, MALINAU KOTA, MALINAU, KALIMANTAN UTARA",4,129,51,180
https://kawalpemilu.org#64886,"LONG SEPAYANG, KRAYAN TIMUR, NUNUKAN, KALIMANTAN UTARA",1,59,1,60
https://kawalpemilu.org#24998,"KUDAI, SUNGAILIAT, BANGKA, KEPULAUAN BANGKA BELITUNG",14,154,5,159
https://kawalpemilu.org#25006,"BUKIT KETOK, BELINYU, BANGKA, KEPULAUAN BANGKA BELITUNG",5,144,61,205
https://kawalpemilu.org#25350,"BURONG MANDI, DAMAR, BELITUNG TIMUR, KEPULAUAN BANGKA BELITUNG",3,188,19,207
https://kawalpemilu.org#25125,"SERDANG, TOBOALI, BANGKA SELATAN, KEPULAUAN BANGKA BELITUNG",9,174,28,202
https://kawalpemilu.org#25109,"TANJUNG BINGA, SIJUK, BELITUNG, KEPULAUAN BANGKA BELITUNG",9,227,26,253
https://kawalpemilu.org#25087,"MEMBALONG, MEMBALONG, BELITUNG, KEPULAUAN BANGKA BELITUNG",9,213,29,242
https://kawalpemilu.org#25096,"PULAU SUMEDANG, MEMBALONG, BELITUNG, KEPULAUAN BANGKA BELITUNG",1,141,15,156
https://kawalpemilu.org#25007,"GUNUNG MUDA, BELINYU, BANGKA, KEPULAUAN BANGKA BELITUNG",1,160,9,169
https://kawalpemilu.org#25109,"TANJUNG BINGA, SIJUK, BELITUNG, KEPULAUAN BANGKA BELITUNG",10,223,18,241
https://kawalpemilu.org#25387,"SELINDUNG, GABEK, KOTA PANGKALPINANG, KEPULAUAN BANGKA BELITUNG",5,155,112,267
https://kawalpemilu.org#25770,"BATU BESAR, NONGSA, KOTA BATAM, KEPULAUAN RIAU",30,96,110,206
https://kawalpemilu.org#25513,"TOAPAYA ASRI, TOAPAYA, BINTAN, KEPULAUAN RIAU",9,114,118,232
https://kawalpemilu.org#25421,"SENGGARANG, TANJUNG PINANG KOTA, KOTA TANJUNGPINANG, KEPULAUAN RIAU",4,179,4,183
https://kawalpemilu.org#25554,"SUNGAILAKAM TIMUR, KARIMUN, KARIMUN, KEPULAUAN RIAU",29,84,110,194
https://kawalpemilu.org#25688,"KOTE, SINGKEP PESISIR, LINGGA, KEPULAUAN RIAU",1,70,56,126
https://kawalpemilu.org#84861,"SUNGAILAKAM BARAT, KARIMUN, KARIMUN, KEPULAUAN RIAU",23,69,53,122
https://kawalpemilu.org#25812,"TEMBESI, SAGULUNG, KOTA BATAM, KEPULAUAN RIAU",51,73,151,224
https://kawalpemilu.org#25766,"TIBAN BARU, SEKUPANG, KOTA BATAM, KEPULAUAN RIAU",7,76,168,244
https://kawalpemilu.org#25784,"LUBUK BAJA KOTA, LUBUK BAJA, KOTA BATAM, KEPULAUAN RIAU",7,131,15,146
https://kawalpemilu.org#25810,"BALOI PERMAI, BATAM KOTA, KOTA BATAM, KEPULAUAN RIAU",60,97,146,243
https://kawalpemilu.org#25816,"SUNGAI LANGKAI, SAGULUNG, KOTA BATAM, KEPULAUAN RIAU",124,111,84,195
https://kawalpemilu.org#25812,"TEMBESI, SAGULUNG, KOTA BATAM, KEPULAUAN RIAU",111,66,86,152
https://kawalpemilu.org#25805,"TELUK TERING, BATAM KOTA, KOTA BATAM, KEPULAUAN RIAU",45,63,58,121
https://kawalpemilu.org#25574,"LUBUK PUDING, BURU, KARIMUN, KEPULAUAN RIAU",6,83,124,207
https://kawalpemilu.org#22934,"PUTRA BUYUT, GUNUNG SUGIH, LAMPUNG TENGAH, LAMPUNG",3,117,98,215
https://kawalpemilu.org#23822,"RINGIN SARI, BANJAR MARGO, TULANG BAWANG, LAMPUNG",9,136,49,185
https://kawalpemilu.org#24245,"MUMBANG JAYA, JABUNG, LAMPUNG TIMUR, LAMPUNG",3,108,69,177
https://kawalpemilu.org#23742,"MENGGALA KOTA, MENGGALA, TULANG BAWANG, LAMPUNG",9,20,117,137
https://kawalpemilu.org#22607,"HAJIMENA, NATAR, LAMPUNG SELATAN, LAMPUNG",28,50,107,157
https://kawalpemilu.org#23050,"BUMI RATU, BUMI RATU NUBAN, LAMPUNG TENGAH, LAMPUNG",2,16,119,135
https://kawalpemilu.org#24938,"SIDODADI, TELUK PANDAN, PESAWARAN, LAMPUNG",3,96,77,173
https://kawalpemilu.org#23138,"SENDANG RETNO, SENDANG AGUNG, LAMPUNG TENGAH, LAMPUNG",5,75,109,184
https://kawalpemilu.org#24397,"SRIBHAWONO, BANDAR SRIBHAWONO, LAMPUNG TIMUR, LAMPUNG",27,126,60,186
https://kawalpemilu.org#24799,"RAJABASA RAYA, RAJABASA, KOTA BANDAR LAMPUNG, LAMPUNG",10,68,118,186
https://kawalpemilu.org#22543,"GUNUNG KATUN MALAI, TULANG BAWANG UDIK, TULANG BAWANG BARAT, LAMPUNG",1,39,128,167
https://kawalpemilu.org#23519,"SIMPANGSARI, SUMBER JAYA, LAMPUNG BARAT, LAMPUNG",5,162,40,202
https://kawalpemilu.org#24802,"TANJUNG SENANG, TANJUNG SENANG, KOTA BANDAR LAMPUNG, LAMPUNG",9,67,102,169
https://kawalpemilu.org#24374,"PURWO KENCONO, SEKAMPUNG UDIK, LAMPUNG TIMUR, LAMPUNG",15,226,3,229
https://kawalpemilu.org#24228,"MARGA SARI, LABUHAN MARINGGAI, LAMPUNG TIMUR, LAMPUNG",17,187,64,251
https://kawalpemilu.org#24370,"SIDOREJO, SEKAMPUNG UDIK, LAMPUNG TIMUR, LAMPUNG",15,168,32,200
https://kawalpemilu.org#23409,"PAMPANG TANGGUK JAYA, SUNGKAI TENGAH, LAMPUNG UTARA, LAMPUNG",3,93,93,186
https://kawalpemilu.org#23350,"KEBUN DALAM, ABUNG TINGGI, LAMPUNG UTARA, LAMPUNG",6,48,94,142
https://kawalpemilu.org#23336,"SUBIK, ABUNG TENGAH, LAMPUNG UTARA, LAMPUNG",3,96,33,129
https://kawalpemilu.org#24423,"PELINDUNG JAYA, GUNUNG PELINDUNG, LAMPUNG TIMUR, LAMPUNG",11,109,32,141
https://kawalpemilu.org#22335,"PRINGSEWU TIMUR, PRINGSEWU, PRINGSEWU, LAMPUNG",16,154,33,187
https://kawalpemilu.org#24912,"PEKONDOH GEDUNG, WAY LIMA, PESAWARAN, LAMPUNG",3,117,131,248
https://kawalpemilu.org#92001,"PANARAGAN JAYA, TULANG BAWANG TENGAH, TULANG BAWANG BARAT, LAMPUNG",5,82,139,221
https://kawalpemilu.org#24842,"IRING MULYO, METRO TIMUR, KOTA METRO, LAMPUNG",25,161,74,235
https://kawalpemilu.org#23865,"MAKARTITAMA, GEDUNG AJI BARU, TULANG BAWANG, LAMPUNG",1,163,86,249
https://kawalpemilu.org#23544,"PADANG TAMBAK, WAY TENONG, LAMPUNG BARAT, LAMPUNG",11,85,63,148
https://kawalpemilu.org#22965,"YUKUM JAYA, TERBANGGI BESAR, LAMPUNG TENGAH, LAMPUNG",46,81,88,169
https://kawalpemilu.org#23021,"BANJAR AGUNG, SEPUTIH MATARAM, LAMPUNG TENGAH, LAMPUNG",13,199,28,227
https://kawalpemilu.org#23373,"KARANG REJO II, MUARA SUNGKAI, LAMPUNG UTARA, LAMPUNG",4,0,0,0
https://kawalpemilu.org#23087,"TERBANGGI MULYA, BANDAR MATARAM, LAMPUNG TENGAH, LAMPUNG",2,168,59,227
https://kawalpemilu.org#22990,"REKSO BINANGUN, RUMBIA, LAMPUNG TENGAH, LAMPUNG",12,169,74,243
https://kawalpemilu.org#22533,"MULYA KENCANA, TULANG BAWANG TENGAH, TULANG BAWANG BARAT, LAMPUNG",15,202,46,248
https://kawalpemilu.org#24592,"TANJUNG SERUPA, PAKUAN RATU, WAY KANAN, LAMPUNG",7,165,41,206
https://kawalpemilu.org#24600,"SERUPA INDAH, PAKUAN RATU, WAY KANAN, LAMPUNG",5,173,42,215
https://kawalpemilu.org#87246,"KOTA JAWA, NEGARA BATIN, WAY KANAN, LAMPUNG",1,131,20,151
https://kawalpemilu.org#24464,"BRAJA LUHUR, BRAJA SELEBAH, LAMPUNG TIMUR, LAMPUNG",12,158,32,190
https://kawalpemilu.org#23602,"CAHAYA NEGERI, LEMONG, PESISIR BARAT, LAMPUNG",2,47,55,102
https://kawalpemilu.org#22703,"SIDOMEKAR, KATIBUNG, LAMPUNG SELATAN, LAMPUNG",9,91,7,98
https://kawalpemilu.org#24731,"SUKADANA HAM, TANJUNGKARANG BARAT, KOTA BANDAR LAMPUNG, LAMPUNG",9,88,145,233
https://kawalpemilu.org#22879,"KALIREJO, KALIREJO, LAMPUNG TENGAH, LAMPUNG",21,122,64,186
https://kawalpemilu.org#24840,"YOSODADI, METRO TIMUR, KOTA METRO, LAMPUNG",19,120,62,182
https://kawalpemilu.org#23206,"SINDANG SARI, KOTABUMI, LAMPUNG UTARA, LAMPUNG",63,110,68,178
https://kawalpemilu.org#24810,"SUKABUMI INDAH, SUKABUMI, KOTA BANDAR LAMPUNG, LAMPUNG",12,114,168,282
https://kawalpemilu.org#23385,"SUKADANA UDIK, BUNGA MAYANG, LAMPUNG UTARA, LAMPUNG",87,115,47,162
https://kawalpemilu.org#22759,"KARANG ANYAR, JATI AGUNG, LAMPUNG SELATAN, LAMPUNG",28,158,51,209
https://kawalpemilu.org#24335,"REJO KATON, RAMAN UTARA, LAMPUNG TIMUR, LAMPUNG",11,159,58,217
https://kawalpemilu.org#24423,"PELINDUNG JAYA, GUNUNG PELINDUNG, LAMPUNG TIMUR, LAMPUNG",2,52,50,102
https://kawalpemilu.org#24928,"BUNUT SEBERANG, WAY RATAI, PESAWARAN, LAMPUNG",8,68,73,141
https://kawalpemilu.org#22896,"SIDO LUHUR, BANGUN REJO, LAMPUNG TENGAH, LAMPUNG",7,109,86,195
https://kawalpemilu.org#24718,"SEPANG JAYA, LABUHAN RATU, KOTA BANDAR LAMPUNG, LAMPUNG",7,103,65,168
https://kawalpemilu.org#24928,"BUNUT SEBERANG, WAY RATAI, PESAWARAN, LAMPUNG",3,112,86,198
https://kawalpemilu.org#23456,"TANJUNG IMAN, BLAMBANGAN PAGAR, LAMPUNG UTARA, LAMPUNG",6,49,166,215
https://kawalpemilu.org#24770,"GARUNTANG, BUMI WARAS, KOTA BANDAR LAMPUNG, LAMPUNG",26,71,51,122
https://kawalpemilu.org#24838,"GANJAR ASRI, METRO BARAT, KOTA METRO, LAMPUNG",6,104,82,186
https://kawalpemilu.org#23338,"GUNUNG GIJUL, ABUNG TENGAH, LAMPUNG UTARA, LAMPUNG",4,0,0,0
https://kawalpemilu.org#22708,"PADAN, PENENGAHAN, LAMPUNG SELATAN, LAMPUNG",7,76,74,150
https://kawalpemilu.org#24819,"SUMBER AGUNG, KEMILING, KOTA BANDAR LAMPUNG, LAMPUNG",7,120,85,205
https://kawalpemilu.org#23129,"NEGARA AJI BARU, ANAK TUHA, LAMPUNG TENGAH, LAMPUNG",8,179,10,189
https://kawalpemilu.org#23526,"KENALI, BELALAU, LAMPUNG BARAT, LAMPUNG",5,60,122,182
https://kawalpemilu.org#24907,"TRIMULYO, TEGINENENG, PESAWARAN, LAMPUNG",9,182,29,211
https://kawalpemilu.org#24948,"MULYOSARI, WAY RATAI, PESAWARAN, LAMPUNG",4,139,45,184
https://kawalpemilu.org#24402,"BANDAR AGUNG, BANDAR SRIBHAWONO, LAMPUNG TIMUR, LAMPUNG",40,129,13,142
https://kawalpemilu.org#22504,"ADI MULYO, PANCA JAYA, MESUJI, LAMPUNG",6,177,31,208
https://kawalpemilu.org#22844,"MEKARJAYA, MERBAU MATARAM, LAMPUNG SELATAN, LAMPUNG",5,106,84,190
https://kawalpemilu.org#24257,"GANTI WARNO, PEKALONGAN, LAMPUNG TIMUR, LAMPUNG",4,139,41,180
https://kawalpemilu.org#24721,"WAY HALIM PERMAI, WAY HALIM, KOTA BANDAR LAMPUNG, LAMPUNG",10,126,119,245
https://kawalpemilu.org#22758,"FAJAR BARU, JATI AGUNG, LAMPUNG SELATAN, LAMPUNG",3,89,164,253
https://kawalpemilu.org#24770,"GARUNTANG, BUMI WARAS, KOTA BANDAR LAMPUNG, LAMPUNG",25,140,72,212
https://kawalpemilu.org#22377,"RANTAU TIJANG, PARDASUKA, PRINGSEWU, LAMPUNG",6,117,18,135
https://kawalpemilu.org#-990684,"Pretoria, Pretoria, Afrika Selatan, Luar Negeri",1001,27,2,29
https://kawalpemilu.org#-990784,"Singapura, Singapura, Singapura, Luar Negeri",26,1011,122,1133
https://kawalpemilu.org#-991074,"Jeddah, Jeddah, Arab Saudi, Luar Negeri",2004,159,784,943
https://kawalpemilu.org#-990644,"Paris, Paris, Perancis, Luar Negeri",3,237,52,289
https://kawalpemilu.org#-991084,"Johor Bahru, Johor Bahru, Malaysia, Luar Negeri",2281,88,166,254
https://kawalpemilu.org#-990724,"Riyadh, Riyadh, Arab Saudi, Luar Negeri",2005,18,39,57
https://kawalpemilu.org#-990454,"Kopenhagen, Kopenhagen, Denmark, Luar Negeri",1,117,34,151
https://kawalpemilu.org#-990304,"Damascus, Damascus, Suriah, Luar Negeri",1,28,50,78
https://kawalpemilu.org#77961,"BATU RAJA, WASILE, HALMAHERA TIMUR, MALUKU UTARA",4,72,105,177
https://kawalpemilu.org#77175,"TEDENG, JAILOLO, HALMAHERA BARAT, MALUKU UTARA",6,177,6,183
https://kawalpemilu.org#77443,"GISIK, LOLODA UTARA, HALMAHERA UTARA, MALUKU UTARA",1,116,15,131
https://kawalpemilu.org#77472,"KALI UPA, TOBELO TENGAH, HALMAHERA UTARA, MALUKU UTARA",2,195,7,202
https://kawalpemilu.org#78083,"SANGADJI, KOTA TERNATE UTARA, KOTA TERNATE, MALUKU UTARA",7,62,142,204
https://kawalpemilu.org#78029,"PATLEAN, MABA UTARA, HALMAHERA TIMUR, MALUKU UTARA",4,7,91,98
https://kawalpemilu.org#78063,"KALUMATA, KOTA TERNATE SELATAN, KOTA TERNATE, MALUKU UTARA",6,49,102,151
https://kawalpemilu.org#77308,"TABA CAMPAKA, SAHU TIMUR, HALMAHERA BARAT, MALUKU UTARA",2,18,109,127
https://kawalpemilu.org#78159,"TOLOA, TIDORE SELATAN, KOTA TIDORE KEPULAUAN, MALUKU UTARA",4,42,136,178
https://kawalpemilu.org#77154,"SAMBIKI BARU, MOROTAI TIMUR, PULAU MOROTAI, MALUKU UTARA",3,180,13,193
https://kawalpemilu.org#77000,"KUDAMATI, NUSANIWE, KOTA AMBON, MALUKU",16,193,6,199
https://kawalpemilu.org#76465,"LARIKE, LEIHITU BARAT, MALUKU TENGAH, MALUKU",3,23,104,127
https://kawalpemilu.org#76421,"SEITH, LEIHITU, MALUKU TENGAH, MALUKU",11,42,103,145
https://kawalpemilu.org#76496,"WAUR, KEI BESAR, MALUKU TENGGARA, MALUKU",4,196,38,234
https://kawalpemilu.org#77023,"BATU MERAH, SIRIMAU, KOTA AMBON, MALUKU",100,208,25,233
https://kawalpemilu.org#76812,"LUHU, HUAMUAL, SERAM BAGIAN BARAT, MALUKU",5,59,235,294
https://kawalpemilu.org#76697,"NAMSINA, WAPLAU, BURU, MALUKU",3,92,107,199
https://kawalpemilu.org#928793,"BOIYAUW, BANDA, MALUKU TENGAH, MALUKU",3,37,79,116
https://kawalpemilu.org#86058,"KAMPUNG TENGAH WERMAF, TEOR, SERAM BAGIAN TIMUR, MALUKU",1,110,30,140
https://kawalpemilu.org#77023,"BATU MERAH, SIRIMAU, KOTA AMBON, MALUKU",88,29,193,222
https://kawalpemilu.org#76547,"REWAV, KEI KECIL TIMUR, MALUKU TENGGARA, MALUKU",2,169,5,174
https://kawalpemilu.org#76812,"LUHU, HUAMUAL, SERAM BAGIAN BARAT, MALUKU",77,22,269,291
https://kawalpemilu.org#76370,"WOLU, TELUTIH, MALUKU TENGAH, MALUKU",6,57,55,112
https://kawalpemilu.org#76605,"MAKATIAN, WER MAKTIAN, MALUKU TENGGARA BARAT, MALUKU",1,240,14,254
https://kawalpemilu.org#54213,"SEPAKEK, PRINGGARATA, LOMBOK TENGAH, NUSA TENGGARA BARAT",3,53,69,122
https://kawalpemilu.org#54025,"GAPUK, GERUNG, LOMBOK BARAT, NUSA TENGGARA BARAT",6,13,147,160
https://kawalpemilu.org#84995,"TAMAN AYU, GERUNG, LOMBOK BARAT, NUSA TENGGARA BARAT",20,67,168,235
https://kawalpemilu.org#85044,"PRINGGABAYA UTARA, PRINGGABAYA, LOMBOK TIMUR, NUSA TENGGARA BARAT",6,120,114,234
https://kawalpemilu.org#54176,"PRABU, PUJUT, LOMBOK TENGAH, NUSA TENGGARA BARAT",10,128,82,210
https://kawalpemilu.org#54712,"NGALI, BELO, BIMA, NUSA TENGGARA BARAT",12,3,193,196
https://kawalpemilu.org#54282,"SIKUR, SIKUR, LOMBOK TIMUR, NUSA TENGGARA BARAT",13,62,164,226
https://kawalpemilu.org#54676,"TOLOUWI, MONTA, BIMA, NUSA TENGGARA BARAT",10,29,161,190
https://kawalpemilu.org#85108,"MONTONG BETER, SAKRA BARAT, LOMBOK TIMUR, NUSA TENGGARA BARAT",13,64,113,177
https://kawalpemilu.org#54110,"LABUAN TERENG, LEMBAR, LOMBOK BARAT, NUSA TENGGARA BARAT",11,69,92,161
https://kawalpemilu.org#54708,"PENAPALI, WOHA, BIMA, NUSA TENGGARA BARAT",2,13,169,182
https://kawalpemilu.org#55031,"TEGAL MAJA, TANJUNG, LOMBOK UTARA, NUSA TENGGARA BARAT",7,107,20,127
https://kawalpemilu.org#54512,"LABUHAN BADAS, LABUHAN BADAS, SUMBAWA, NUSA TENGGARA BARAT",5,128,47,175
https://kawalpemilu.org#54412,"KALIMANGO, ALAS, SUMBAWA, NUSA TENGGARA BARAT",12,69,105,174
https://kawalpemilu.org#54655,"SUKA DAMAI, MANGGELEWA, DOMPU, NUSA TENGGARA BARAT",2,74,157,231
https://kawalpemilu.org#85083,"BINTANG RINJANI, SURALAGA, LOMBOK TIMUR, NUSA TENGGARA BARAT",1,71,53,124
https://kawalpemilu.org#54976,"BABAKAN, SANDUBAYA, KOTA MATARAM, NUSA TENGGARA BARAT",12,51,159,210
https://kawalpemilu.org#54880,"KELANIR, SETELUK, SUMBAWA BARAT, NUSA TENGGARA BARAT",5,140,41,181
https://kawalpemilu.org#54792,"DUMU, LANGGUDU, BIMA, NUSA TENGGARA BARAT",3,21,61,82
https://kawalpemilu.org#54687,"BONTOKAPE, BOLO, BIMA, NUSA TENGGARA BARAT",1,27,182,209
https://kawalpemilu.org#85082,"BAGIK PAYUNG TIMUR, SURALAGA, LOMBOK TIMUR, NUSA TENGGARA BARAT",6,57,58,115
https://kawalpemilu.org#54419,"STOWE BRANG, UTAN, SUMBAWA, NUSA TENGGARA BARAT",2,81,149,230
https://kawalpemilu.org#54106,"LEMBAR, LEMBAR, LOMBOK BARAT, NUSA TENGGARA BARAT",14,15,113,128
https://kawalpemilu.org#55030,"JENGGALA, TANJUNG, LOMBOK UTARA, NUSA TENGGARA BARAT",23,133,113,246
https://kawalpemilu.org#54031,"BELEKE, GERUNG, LOMBOK BARAT, NUSA TENGGARA BARAT",19,20,208,228
https://kawalpemilu.org#54713,"RENDA, BELO, BIMA, NUSA TENGGARA BARAT",5,20,162,182
https://kawalpemilu.org#54655,"SUKA DAMAI, MANGGELEWA, DOMPU, NUSA TENGGARA BARAT",3,110,147,257
https://kawalpemilu.org#54174,"TUMPAK, PUJUT, LOMBOK TENGAH, NUSA TENGGARA BARAT",12,153,74,227
https://kawalpemilu.org#54520,"LABANGKA, LABANGKA, SUMBAWA, NUSA TENGGARA BARAT",1,65,158,223
https://kawalpemilu.org#85053,"LENEK BARU, AIKMEL, LOMBOK TIMUR, NUSA TENGGARA BARAT",12,40,134,174
https://kawalpemilu.org#54114,"SANDIK, BATU LAYAR, LOMBOK BARAT, NUSA TENGGARA BARAT",7,62,118,180
https://kawalpemilu.org#54047,"NYUR LEMBANG, NARMADA, LOMBOK BARAT, NUSA TENGGARA BARAT",10,36,131,167
https://kawalpemilu.org#85074,"PRINGGASELA SELATAN, PRINGGASELA, LOMBOK TIMUR, NUSA TENGGARA BARAT",17,62,94,156
https://kawalpemilu.org#54408,"EMANG LESTARI, LUNYUK, SUMBAWA, NUSA TENGGARA BARAT",7,59,58,117
https://kawalpemilu.org#85119,"SERIWE, JEROWARU, LOMBOK TIMUR, NUSA TENGGARA BARAT",6,102,76,178
https://kawalpemilu.org#54241,"MONTONG SAPAH, PRAYA BARAT DAYA, LOMBOK TENGAH, NUSA TENGGARA BARAT",10,34,169,203
https://kawalpemilu.org#54161,"BEBER, BATUKLIANG, LOMBOK TENGAH, NUSA TENGGARA BARAT",21,112,103,215
https://kawalpemilu.org#54235,"BATUNYALA, PRAYA TENGAH, LOMBOK TENGAH, NUSA TENGGARA BARAT",25,61,148,209
https://kawalpemilu.org#85122,"PARE MAS, JEROWARU, LOMBOK TIMUR, NUSA TENGGARA BARAT",4,99,50,149
https://kawalpemilu.org#54761,"O'O, DONGGO, BIMA, NUSA TENGGARA BARAT",3,25,194,219
https://kawalpemilu.org#55587,"NAUKAE, KUATNANA, TIMOR TENGAH SELATAN, NUSA TENGGARA TIMUR",2,183,10,193
https://kawalpemilu.org#57203,"BILLA, TABUNDUNG, SUMBA TIMUR, NUSA TENGGARA TIMUR",4,132,10,142
https://kawalpemilu.org#55212,"FATUNAUS, AMFOANG UTARA, KUPANG, NUSA TENGGARA TIMUR",5,90,8,98
https://kawalpemilu.org#58053,"PENKASE OELETA, ALAK, KOTA KUPANG, NUSA TENGGARA TIMUR",15,141,79,220
https://kawalpemilu.org#56526,"WULIWUTIK, NITA, SIKKA, NUSA TENGGARA TIMUR",4,137,3,140
https://kawalpemilu.org#57635,"SEDEOEN, ROTE BARAT, ROTE NDAO, NUSA TENGGARA TIMUR",1,247,7,254
https://kawalpemilu.org#927912,"GOLO NDEWENG, LEMBOR, MANGGARAI BARAT, NUSA TENGGARA TIMUR",1,188,12,200
https://kawalpemilu.org#56054,"KALABAHI KOTA, TELUK MUTIARA, ALOR, NUSA TENGGARA TIMUR",5,58,70,128
https://kawalpemilu.org#55154,"NOELBAKI, KUPANG TENGAH, KUPANG, NUSA TENGGARA TIMUR",3,166,1,167
https://kawalpemilu.org#56791,"LISEDETU, WOLOWARU, ENDE, NUSA TENGGARA TIMUR",3,162,4,166
https://kawalpemilu.org#57705,"SURUNUMBENG, LEMBOR SELATAN, MANGGARAI BARAT, NUSA TENGGARA TIMUR",2,159,29,188
https://kawalpemilu.org#58190,"SISIR, ELAR, MANGGARAI TIMUR, NUSA TENGGARA TIMUR",2,168,17,185
https://kawalpemilu.org#55994,"UMALAWAIN, WELIMAN, MALAKA, NUSA TENGGARA TIMUR",3,153,2,155
https://kawalpemilu.org#57810,"NATAUTE, NANGARORO, NAGEKEO, NUSA TENGGARA TIMUR",2,135,2,137
https://kawalpemilu.org#58066,"OESAPA, KELAPA LIMA, KOTA KUPANG, NUSA TENGGARA TIMUR",71,198,20,218
https://kawalpemilu.org#56117,"KELAISI TENGAH, ALOR SELATAN, ALOR, NUSA TENGGARA TIMUR",3,102,4,106
https://kawalpemilu.org#55142,"OETETA, SULAMU, KUPANG, NUSA TENGGARA TIMUR",1,235,4,239
https://kawalpemilu.org#56290,"WATOTUTU, ILE MANDIRI, FLORES TIMUR, NUSA TENGGARA TIMUR",2,230,5,235
https://kawalpemilu.org#56304,"KOLAKA, TANJUNG BUNGA, FLORES TIMUR, NUSA TENGGARA TIMUR",1,157,5,162
https://kawalpemilu.org#56506,"KOROBHERA, MEGO, SIKKA, NUSA TENGGARA TIMUR",1,222,14,236
https://kawalpemilu.org#56270,"WAIBALUN, LARANTUKA, FLORES TIMUR, NUSA TENGGARA TIMUR",4,249,9,258
https://kawalpemilu.org#57730,"GOLO MBU, SANO NGGOANG, MANGGARAI BARAT, NUSA TENGGARA TIMUR",3,170,47,217
https://kawalpemilu.org#57738,"GOLO SENGANG, SANO NGGOANG, MANGGARAI BARAT, NUSA TENGGARA TIMUR",3,87,47,134
https://kawalpemilu.org#55489,"OEBOBO, BATU PUTIH, TIMOR TENGAH SELATAN, NUSA TENGGARA TIMUR",2,226,11,237
https://kawalpemilu.org#57344,"LULUNDILU, MAHU, SUMBA TIMUR, NUSA TENGGARA TIMUR",1,130,22,152
https://kawalpemilu.org#58202,"TANAH RATA, KOTA KOMBA, MANGGARAI TIMUR, NUSA TENGGARA TIMUR",11,155,4,159
https://kawalpemilu.org#55698,"NUNMAFO, INSANA, TIMOR TENGAH UTARA, NUSA TENGGARA TIMUR",5,159,15,174
https://kawalpemilu.org#57328,"TEMU, KANATANG, SUMBA TIMUR, NUSA TENGGARA TIMUR",8,181,9,190
https://kawalpemilu.org#57629,"LAKAMOLA, ROTE TIMUR, ROTE NDAO, NUSA TENGGARA TIMUR",1,111,11,122
https://kawalpemilu.org#57334,"PRAIWITU, NGADU NGALA, SUMBA TIMUR, NUSA TENGGARA TIMUR",2,151,5,156
https://kawalpemilu.org#58180,"TIWU KONDO, ELAR, MANGGARAI TIMUR, NUSA TENGGARA TIMUR",2,140,33,173
https://kawalpemilu.org#55401,"TUMU, AMANUBAN TENGAH, TIMOR TENGAH SELATAN, NUSA TENGGARA TIMUR",1,194,20,214
https://kawalpemilu.org#56720,"RUKUN LIMA, ENDE SELATAN, ENDE, NUSA TENGGARA TIMUR",14,173,33,206
https://kawalpemilu.org#56900,"REWARANGGA SELATAN, ENDE TIMUR, ENDE, NUSA TENGGARA TIMUR",1,161,8,169
https://kawalpemilu.org#56431,"LAMAWOLO, ILE BOLENG, FLORES TIMUR, NUSA TENGGARA TIMUR",1,142,4,146
https://kawalpemilu.org#57222,"WATUMBAKA, PANDAWAI, SUMBA TIMUR, NUSA TENGGARA TIMUR",6,165,11,176
https://kawalpemilu.org#57299,"WANGGA, KAMBERA, SUMBA TIMUR, NUSA TENGGARA TIMUR",15,230,8,238
https://kawalpemilu.org#82133,"MARIYAI, MARIAT, SORONG, PAPUA BARAT",7,55,75,130
https://kawalpemilu.org#927679,"WOMAN, AYAMARU JAYA, MAYBRAT, PAPUA BARAT",1,136,0,136
https://kawalpemilu.org#81953,"SEMBARO, AYAMARU SELATAN, MAYBRAT, PAPUA BARAT",1,228,0,228
https://kawalpemilu.org#83308,"KLAWASI, SORONG BARAT, KOTA SORONG, PAPUA BARAT",12,92,115,155
https://kawalpemilu.org#927740,"FASE, MARE SELATAN, MAYBRAT, PAPUA BARAT",1,102,0,102
https://kawalpemilu.org#927735,"BAKRABI, MARE, MAYBRAT, PAPUA BARAT",1,69,0,69
https://kawalpemilu.org#82675,"MALAKULI, KARAS, FAKFAK, PAPUA BARAT",2,157,52,209
https://kawalpemilu.org#87174,"WAIMECI, SALAWATI TENGAH, RAJA AMPAT, PAPUA BARAT",1,80,35,115
https://kawalpemilu.org#83317,"MATALAMAGI, SORONG UTARA, KOTA SORONG, PAPUA BARAT",8,152,87,239
https://kawalpemilu.org#82098,"MAKOTYAMSA, MAYAMUK, SORONG, PAPUA BARAT",7,99,71,170
https://kawalpemilu.org#81833,"HUSMO, KWIKMA, YAHUKIMO, PAPUA",2,276,0,276
https://kawalpemilu.org#81807,"KABIANGGAMA, KABIANGGAMA, YAHUKIMO, PAPUA",5,287,0,287
https://kawalpemilu.org#80146,"SENTANI KOTA, SENTANI, JAYAPURA, PAPUA",6,65,130,195
https://kawalpemilu.org#81073,"KUALA KENCANA, KUALA KENCANA, MIMIKA, PAPUA",7,200,89,289
https://kawalpemilu.org#79484,"KELILA, KELILA, MAMBERAMO TENGAH, PAPUA",2,231,0,231
https://kawalpemilu.org#88575,"UJUNGKIA, KI, BOVEN DIGOEL, PAPUA",2,83,3,86
https://kawalpemilu.org#79480,"WIYUGOBAK, KOBAGMA, MAMBERAMO TENGAH, PAPUA",1,300,0,300
https://kawalpemilu.org#79423,"GURABESI, JAYAPURA UTARA, KOTA JAYAPURA, PAPUA",29,101,67,168
https://kawalpemilu.org#80148,"DOBONSOLO, SENTANI, JAYAPURA, PAPUA",7,175,110,285
https://kawalpemilu.org#79835,"SERINGGU JAYA, MERAUKE, MERAUKE, PAPUA",3,101,58,159
https://kawalpemilu.org#79983,"IROMORO, TABONJI, MERAUKE, PAPUA",1,119,0,119
https://kawalpemilu.org#929789,"GILO, MELAGI, LANNY JAYA, PAPUA",3,273,0,273
https://kawalpemilu.org#79880,"MARGA MULYA, SEMANGGA, MERAUKE, PAPUA",7,72,111,183
https://kawalpemilu.org#929627,"UWOME, KUYAWAGE, LANNY JAYA, PAPUA",2,152,0,152
https://kawalpemilu.org#79443,"YOBE, ABEPURA, KOTA JAYAPURA, PAPUA",15,52,72,124
https://kawalpemilu.org#79008,"ASIKI I, JAIR, BOVEN DIGOEL, PAPUA",19,72,53,125
https://kawalpemilu.org#80188,"SEKORI, KEMTUK, JAYAPURA, PAPUA",1,145,7,152
https://kawalpemilu.org#79008,"ASIKI I, JAIR, BOVEN DIGOEL, PAPUA",30,66,7,73
https://kawalpemilu.org#86794,"JUTA, GELOK BEAM, LANNY JAYA, PAPUA",2,210,0,210
https://kawalpemilu.org#80958,"DADOU/SIRIWO, SIRIWO, PANIAI, PAPUA",2,256,0,256
https://kawalpemilu.org#80532,"MANDALA, BIAK KOTA, BIAK NUMFOR, PAPUA",15,152,47,199
https://kawalpemilu.org#80717,"MANDOUW, SAMOFA, BIAK NUMFOR, PAPUA",1,136,51,187
https://kawalpemilu.org#80146,"SENTANI KOTA, SENTANI, JAYAPURA, PAPUA",8,171,73,244
https://kawalpemilu.org#86518,"SERAMKATOP, SERAMBAKON, PEGUNUNGAN BINTANG, PAPUA",1,214,0,214
https://kawalpemilu.org#78489,"WISMAN, BOGONUK, TOLIKARA, PAPUA",1,202,0,202
https://kawalpemilu.org#78745,"KURUPU, DUNDU, TOLIKARA, PAPUA",1,209,0,209
https://kawalpemilu.org#89134,"DIMBA, DIMBA, LANNY JAYA, PAPUA",2,240,0,240
https://kawalpemilu.org#79342,"ARURI, KEPULAUAN ARURI, SUPIORI, PAPUA",2,142,1,143
https://kawalpemilu.org#81009,"KOPERAPOKA, MIMIKA BARU, MIMIKA, PAPUA",32,79,147,226
https://kawalpemilu.org#929766,"JUYIGA, KELULOME, LANNY JAYA, PAPUA",1,312,0,312
https://kawalpemilu.org#80864,"IPAKIYE, PANIAI TIMUR, PANIAI, PAPUA",1,200,44,244
https://kawalpemilu.org#81208,"YUWANAIM, ARSO, KEEROM, PAPUA",4,171,98,269
https://kawalpemilu.org#80177,"SABRON SARI, SENTANI BARAT, JAYAPURA, PAPUA",3,64,19,83
https://kawalpemilu.org#930602,"PASAR SENTRAL, MIMIKA BARU, MIMIKA, PAPUA",21,112,124,236
https://kawalpemilu.org#86493,"BOB, BIME, PEGUNUNGAN BINTANG, PAPUA",2,272,0,272
https://kawalpemilu.org#78971,"WOMBON, WAROPKO, BOVEN DIGOEL, PAPUA",1,41,1,42
https://kawalpemilu.org#81759,"ALIRJI, LANGDA, YAHUKIMO, PAPUA",3,209,0,209
https://kawalpemilu.org#79831,"MARO, MERAUKE, MERAUKE, PAPUA",22,192,26,218
https://kawalpemilu.org#90487,"SEI MERANTI DARUSSALAM, PUJUD, ROKAN HILIR, RIAU",4,94,46,140
https://kawalpemilu.org#15824,"TANGKERANG  BARAT, MARPOYAN DAMAI, KOTA PEKANBARU, RIAU",37,83,186,269
https://kawalpemilu.org#15515,"KANDIS, KANDIS, SIAK, RIAU",10,158,6,164
https://kawalpemilu.org#14679,"AIR JAMBAN, MANDAU, BENGKALIS, RIAU",128,105,16,121
https://kawalpemilu.org#15837,"LABUH BARU BARAT, PAYUNG SEKAKI, KOTA PEKANBARU, RIAU",41,81,67,148
https://kawalpemilu.org#15812,"PALAS, RUMBAI, KOTA PEKANBARU, RIAU",2,66,135,201
https://kawalpemilu.org#15845,"TEBING TINGGI OKURA, RUMBAI PESISIR, KOTA PEKANBARU, RIAU",6,21,135,156
https://kawalpemilu.org#928984,"SUNGAIMERANTI, PINGGIR, BENGKALIS, RIAU",1,70,85,155
https://kawalpemilu.org#15512,"TELAGA SAM-SAM, KANDIS, SIAK, RIAU",6,29,185,214
https://kawalpemilu.org#14362,"MUARA UWAI, BANGKINANG, KAMPAR, RIAU",6,10,180,190
https://kawalpemilu.org#90465,"BAGAN BATU KOTA, BAGAN SINEMBAH, ROKAN HILIR, RIAU",18,223,20,243
https://kawalpemilu.org#14641,"SENGGORO, BENGKALIS, BENGKALIS, RIAU",4,52,222,274
https://kawalpemilu.org#14888,"Rotan Semelur, Pelangiran, INDRAGIRI HILIR, RIAU",10,83,56,139
https://kawalpemilu.org#14971,"PANGKALAN KERINCI TIMUR, PANGKALAN KERINCI, PELALAWAN, RIAU",57,36,128,164
https://kawalpemilu.org#15150,"KOTA INTAN, KUNTO DARUSSALAM, ROKAN HULU, RIAU",7,49,164,213
https://kawalpemilu.org#14379,"DELI MAKMUR, KAMPA, KAMPAR, RIAU",4,38,84,122
https://kawalpemilu.org#14309,"KARYA INDAH, TAPUNG, KAMPAR, RIAU",4,98,36,134
https://kawalpemilu.org#15878,"BASILAM BARU, SUNGAI SEMBILAN, KOTA DUMAI, RIAU",5,162,70,232
https://kawalpemilu.org#14712,"TITI AKAR, RUPAT UTARA, BENGKALIS, RIAU",2,106,39,145
https://kawalpemilu.org#14687,"TALANG MANDI, MANDAU, BENGKALIS, RIAU",27,40,182,222
https://kawalpemilu.org#14169,"LANGGINI, BANGKINANG KOTA, KAMPAR, RIAU",3,23,178,201
https://kawalpemilu.org#15691,"MARSAWA, SENTAJO RAYA, KUANTAN SINGINGI, RIAU",7,128,81,209
https://kawalpemilu.org#15107,"ALAHAN, ROKAN IV KOTO, ROKAN HULU, RIAU",1,40,134,174
https://kawalpemilu.org#14206,"PULAU GADANG, XIII KOTO KAMPAR, KAMPAR, RIAU",4,29,119,148
https://kawalpemilu.org#15189,"MUARA MUSU, RAMBAH HILIR, ROKAN HULU, RIAU",8,12,196,208
https://kawalpemilu.org#14993,"BATANG KULIM, PANGKALAN KURAS, PELALAWAN, RIAU",5,140,119,259
https://kawalpemilu.org#928983,"SUNGAINIBUNG, SIAK KECIL, BENGKALIS, RIAU",2,102,149,251
https://kawalpemilu.org#14848,"SUNGAILUAR, Batang Tuaka, INDRAGIRI HILIR, RIAU",8,34,171,205
https://kawalpemilu.org#14519,"KUALA GADING, BATANG CENAKU, INDRAGIRI HULU, RIAU",1,137,104,241
https://kawalpemilu.org#931192,"SIALANGSAKTI, TENAYAN RAYA, KOTA PEKANBARU, RIAU",32,23,113,136
https://kawalpemilu.org#15644,"KEPALA PULAU, KUANTAN HILIR, KUANTAN SINGINGI, RIAU",5,26,199,225
https://kawalpemilu.org#15511,"SIMPANG BELUTU, KANDIS, SIAK, RIAU",6,100,132,232
https://kawalpemilu.org#14590,"RIMPIAN, LUBUK BATU JAYA, INDRAGIRI HULU, RIAU",9,82,62,144
https://kawalpemilu.org#15295,"SINTONG, TANAH PUTIH, ROKAN HILIR, RIAU",3,54,182,236
https://kawalpemilu.org#15808,"RUMBAI BUKIT, RUMBAI, KOTA PEKANBARU, RIAU",1,62,131,193
https://kawalpemilu.org#14312,"BENCAH KELUBI, TAPUNG, KAMPAR, RIAU",5,85,132,217
https://kawalpemilu.org#15797,"TANJUNG RHU, LIMA PULUH, KOTA PEKANBARU, RIAU",36,57,96,153
https://kawalpemilu.org#14326,"TANDAN SARI, TAPUNG HILIR, KAMPAR, RIAU",2,99,50,149
https://kawalpemilu.org#14696,"PERGAM, RUPAT, BENGKALIS, RIAU",6,90,145,235
https://kawalpemilu.org#931183,"AIRPUTIH, TAMPAN, KOTA PEKANBARU, RIAU",15,23,181,204
https://kawalpemilu.org#15875,"LUBUK GAUNG, SUNGAI SEMBILAN, KOTA DUMAI, RIAU",24,116,66,182
https://kawalpemilu.org#15799,"SEKIP, LIMA PULUH, KOTA PEKANBARU, RIAU",15,75,131,206
https://kawalpemilu.org#14828,"Pasar Kembang, Keritang, INDRAGIRI HILIR, RIAU",5,110,92,202
https://kawalpemilu.org#15801,"PADANG BULAN, SENAPELAN, KOTA PEKANBARU, RIAU",24,106,103,209
https://kawalpemilu.org#87639,"BONDE BONDE, TUBO SENDANA, MAJENE, SULAWESI BARAT",2,95,133,228
https://kawalpemilu.org#75916,"DARMA, POLEWALI, POLEWALI MANDAR, SULAWESI BARAT",6,102,144,246
https://kawalpemilu.org#75673,"TALIPUKKI, MAMBI, MAMASA, SULAWESI BARAT",1,60,117,177
https://kawalpemilu.org#75440,"GUNUNG SARI, PASANGKAYU, MAMUJU UTARA, SULAWESI BARAT",2,236,19,255
https://kawalpemilu.org#75912,"TAKATIDUNG, POLEWALI, POLEWALI MANDAR, SULAWESI BARAT",17,109,79,188
https://kawalpemilu.org#75982,"BATUPANGA, LUYO, POLEWALI MANDAR, SULAWESI BARAT",3,78,129,207
https://kawalpemilu.org#75488,"KALUKU NANGKA, BAMBAIRA, MAMUJU UTARA, SULAWESI BARAT",2,91,120,211
https://kawalpemilu.org#75933,"TONYAMAN, BINUANG, POLEWALI MANDAR, SULAWESI BARAT",15,104,34,138
https://kawalpemilu.org#75526,"SONDOANG, KALUKKU, MAMUJU, SULAWESI BARAT",8,79,28,107
https://kawalpemilu.org#75625,"KAKULLASANG, TOMMO, MAMUJU, SULAWESI BARAT",6,98,40,138
https://kawalpemilu.org#71957,"TIROMANDA, MAKALE SELATAN, TANA TORAJA, SULAWESI SELATAN",5,98,7,105
https://kawalpemilu.org#70044,"TAENG, PALLANGGA, GOWA, SULAWESI SELATAN",19,73,154,227
https://kawalpemilu.org#70713,"JENETAESA, SIMBANG, MAROS, SULAWESI SELATAN",9,43,129,172
https://kawalpemilu.org#70798,"TONASA, BALOCCI, PANGKAJENE DAN KEPULAUAN, SULAWESI SELATAN",7,87,122,209
https://kawalpemilu.org#70883,"LALOLANG, TANETE RILAU, BARRU, SULAWESI SELATAN",6,84,136,220
https://kawalpemilu.org#72509,"TAKKALALA, WARA SELATAN, KOTA PALOPO, SULAWESI SELATAN",15,88,129,217
https://kawalpemilu.org#69601,"BONTO BIRAENG, KAJANG, BULUKUMBA, SULAWESI SELATAN",6,53,116,170
https://kawalpemilu.org#71640,"SAGA, BAJO, LUWU, SULAWESI SELATAN",1,55,117,172
https://kawalpemilu.org#72481,"WATANG SOREANG, SOREANG, KOTA PARE PARE, SULAWESI SELATAN",8,93,133,226
https://kawalpemilu.org#71329,"LANGNGA, MATIRRO SOMPE, PINRANG, SULAWESI SELATAN",11,58,107,165
https://kawalpemilu.org#70127,"SENGKA, BONTONOMPO SELATAN, GOWA, SULAWESI SELATAN",6,74,148,222
https://kawalpemilu.org#72149,"LEBONI, RAMPI, LUWU UTARA, SULAWESI SELATAN",1,187,29,216
https://kawalpemilu.org#71008,"ENREKENG, GANRA, SOPPENG, SULAWESI SELATAN",1,74,135,209
https://kawalpemilu.org#70203,"BONGKI, SINJAI UTARA, SINJAI, SULAWESI SELATAN",23,44,152,196
https://kawalpemilu.org#69697,"MAPPILAWING, EREMERASA, BANTAENG, SULAWESI SELATAN",3,35,60,8
https://kawalpemilu.org#72379,"TOMPO BALANG, BONTOALA, KOTA MAKASSAR, SULAWESI SELATAN",2,64,93,157
https://kawalpemilu.org#69633,"MATTIRO WALIE, KINDANG, BULUKUMBA, SULAWESI SELATAN",1,21,163,184
https://kawalpemilu.org#71145,"ABBANUANGNGE, MANIANGPAJO, WAJO, SULAWESI SELATAN",1,127,71,198
https://kawalpemilu.org#69933,"AENG TOWA, GALESONG UTARA, TAKALAR, SULAWESI SELATAN",7,114,120,234
https://kawalpemilu.org#70226,"TELLU LIMPOE, TELLU LIMPOE, SINJAI, SULAWESI SELATAN",8,40,99,139
https://kawalpemilu.org#71410,"CEMPA, CEMPA, PINRANG, SULAWESI SELATAN",5,38,201,239
https://kawalpemilu.org#72333,"KARANG ANYAR, MAMAJANG, KOTA MAKASSAR, SULAWESI SELATAN",9,100,103,203
https://kawalpemilu.org#69871,"TAKALAR, MAPPAKASUNGGU, TAKALAR, SULAWESI SELATAN",6,96,133,229
https://kawalpemilu.org#69726,"BONTO TALLASA, ULUERE, BANTAENG, SULAWESI SELATAN",5,49,168,217
https://kawalpemilu.org#72436,"DAYA, BIRINGKANAYA, KOTA MAKASSAR, SULAWESI SELATAN",30,66,100,166
https://kawalpemilu.org#72096,"SALULEMO, SUKAMAJU, LUWU UTARA, SULAWESI SELATAN",1,58,60,118
https://kawalpemilu.org#69558,"BINTARORE, UJUNG BULU, BULUKUMBA, SULAWESI SELATAN",10,55,177,232
https://kawalpemilu.org#70957,"ROMPEGADING, LILIRIAJA, SOPPENG, SULAWESI SELATAN",3,81,89,170
https://kawalpemilu.org#70047,"BONTO BONTOA, SOMBA OPU, GOWA, SULAWESI SELATAN",36,81,85,166
https://kawalpemilu.org#72081,"SALAMA, SABBANG, LUWU UTARA, SULAWESI SELATAN",3,79,92,171
https://kawalpemilu.org#71000,"PESSE, DONRI DONRI, SOPPENG, SULAWESI SELATAN",4,153,76,229
https://kawalpemilu.org#70582,"BAJOE, TANETE RIATTANG TIMUR, BONE, SULAWESI SELATAN",13,54,100,154
https://kawalpemilu.org#71148,"BULETE, PITUMPANUA, WAJO, SULAWESI SELATAN",6,65,142,207
https://kawalpemilu.org#72074,"TETEURI, SABBANG, LUWU UTARA, SULAWESI SELATAN",5,54,161,215
https://kawalpemilu.org#69688,"KARATUANG, BANTAENG, BANTAENG, SULAWESI SELATAN",1,44,139,183
https://kawalpemilu.org#70957,"ROMPEGADING, LILIRIAJA, SOPPENG, SULAWESI SELATAN",4,93,95,188
https://kawalpemilu.org#71357,"BUNGA, MATTIRO BULU, PINRANG, SULAWESI SELATAN",2,89,137,226
https://kawalpemilu.org#69697,"MAPPILAWING, EREMERASA, BANTAENG, SULAWESI SELATAN",1,53,104,157
https://kawalpemilu.org#70630,"LATELLANG, PATIMPENG, BONE, SULAWESI SELATAN",3,45,136,181
https://kawalpemilu.org#70973,"LALABATA RILAU, LALABATA, SOPPENG, SULAWESI SELATAN",27,168,30,198
https://kawalpemilu.org#71825,"TO'BIA, PONRANG SELATAN, LUWU, SULAWESI SELATAN",1,19,180,199
https://kawalpemilu.org#72170,"LARA, BAEBUNTA, LUWU UTARA, SULAWESI SELATAN",4,92,82,174
https://kawalpemilu.org#71638,"TALANG BULAWANG, BAJO, LUWU, SULAWESI SELATAN",4,44,228,272
https://kawalpemilu.org#72439,"SUDIANG, BIRINGKANAYA, KOTA MAKASSAR, SULAWESI SELATAN",26,48,77,125
https://kawalpemilu.org#71412,"MATUNRU TUNRUE, CEMPA, PINRANG, SULAWESI SELATAN",1,77,96,173
https://kawalpemilu.org#931043,"MANISA, BARANTI, SIDENRENG RAPPANG, SULAWESI SELATAN",9,96,125,221
https://kawalpemilu.org#72502,"BATUPASI, WARA UTARA, KOTA PALOPO, SULAWESI SELATAN",2,101,99,200
https://kawalpemilu.org#72332,"BAJI MAPPAKASUNGGU, MAMAJANG, KOTA MAKASSAR, SULAWESI SELATAN",8,106,86,192
https://kawalpemilu.org#71355,"ALITTA, MATTIRO BULU, PINRANG, SULAWESI SELATAN",5,101,87,188
https://kawalpemilu.org#72499,"DANGERAKKO, WARA, KOTA PALOPO, SULAWESI SELATAN",14,74,100,174
https://kawalpemilu.org#72238,"TAMPINNA, ANGKONA, LUWU TIMUR, SULAWESI SELATAN",1,57,164,221
https://kawalpemilu.org#71206,"AWO, KEERA, WAJO, SULAWESI SELATAN",3,83,101,184
https://kawalpemilu.org#71725,"PAREKAJU, PONRANG, LUWU, SULAWESI SELATAN",2,44,186,230
https://kawalpemilu.org#70836,"BONTO MATENE, SEGERI, PANGKAJENE DAN KEPULAUAN, SULAWESI SELATAN",3,98,129,227
https://kawalpemilu.org#70832,"PITUE, MARANG, PANGKAJENE DAN KEPULAUAN, SULAWESI SELATAN",8,75,91,166
https://kawalpemilu.org#69537,"BONTO MACINNA, GANTARANG, BULUKUMBA, SULAWESI SELATAN",12,70,203,273
https://kawalpemilu.org#69566,"BENJALA, BONTO BAHARI, BULUKUMBA, SULAWESI SELATAN",7,74,84,158
https://kawalpemilu.org#71222,"AMPARITA, TELLU LIMPOE, SIDENRENG RAPPANG, SULAWESI SELATAN",9,94,95,189
https://kawalpemilu.org#70083,"PENCONG, BIRINGBULU, GOWA, SULAWESI SELATAN",2,81,174,255
https://kawalpemilu.org#69983,"BONTOSUNGGU, BAJENG, GOWA, SULAWESI SELATAN",7,69,125,194
https://kawalpemilu.org#71311,"BETAO, PITU RIAWA, SIDENRENG RAPPANG, SULAWESI SELATAN",3,195,38,233
https://kawalpemilu.org#85758,"TACCORONG, GANTARANG, BULUKUMBA, SULAWESI SELATAN",4,64,151,215
https://kawalpemilu.org#70287,"PUDE, KAJUARA, BONE, SULAWESI SELATAN",2,60,153,213
https://kawalpemilu.org#72288,"PERTASI KENCANA, KALAENA, LUWU TIMUR, SULAWESI SELATAN",1,46,167,213
https://kawalpemilu.org#69550,"BONTO MASILA, GANTARANG, BULUKUMBA, SULAWESI SELATAN",2,12,100,112
https://kawalpemilu.org#68120,"LABEAN, BALAESANG, DONGGALA, SULAWESI TENGAH",8,122,67,189
https://kawalpemilu.org#68067,"MALONAS, DAMPELAS, DONGGALA, SULAWESI TENGAH",3,130,73,203
https://kawalpemilu.org#68737,"BASOSOL, LIANG, BANGGAI KEPULAUAN, SULAWESI TENGAH",1,142,28,170
https://kawalpemilu.org#69142,"SABO, AMPANA TETE, TOJO UNA-UNA, SULAWESI TENGAH",3,145,78,223
https://kawalpemilu.org#85647,"KOMPO, LUWUK SELATAN, BANGGAI, SULAWESI TENGAH",2,89,143,232
https://kawalpemilu.org#68274,"PANASAKAN, BAOLAN, TOLITOLI, SULAWESI TENGAH",10,46,103,149
https://kawalpemilu.org#67434,"KAMARORA A, NOKILALAKI, SIGI, SULAWESI TENGAH",7,177,13,190
https://kawalpemilu.org#69236,"DONGGALA KODI, ULUJADI, KOTA PALU, SULAWESI TENGAH",22,68,160,228
https://kawalpemilu.org#68560,"BAKALA, BUNGKU SELATAN, MOROWALI, SULAWESI TENGAH",3,55,121,176
https://kawalpemilu.org#68639,"BAHODOPI, BAHODOPI, MOROWALI, SULAWESI TENGAH",3,54,128,182
https://kawalpemilu.org#69075,"PEBOUNANG, PALASA, PARIGI MOUTONG, SULAWESI TENGAH",1,65,60,125
https://kawalpemilu.org#68425,"LAKEA I, LAKEA, BUOL, SULAWESI TENGAH",1,76,98,174
https://kawalpemilu.org#68417,"LEOK II, BIAU, BUOL, SULAWESI TENGAH",3,49,154,203
https://kawalpemilu.org#67983,"TOBE, POSO PESISIR UTARA, POSO, SULAWESI TENGAH",2,178,23,201
https://kawalpemilu.org#68855,"LUK, PELING TENGAH, BANGGAI KEPULAUAN, SULAWESI TENGAH",2,58,79,137
https://kawalpemilu.org#67538,"BEKA, MARAWOLA, SIGI, SULAWESI TENGAH",3,43,82,125
https://kawalpemilu.org#69077,"AVOLUA, PARIGI UTARA, PARIGI MOUTONG, SULAWESI TENGAH",1,24,165,189
https://kawalpemilu.org#67502,"SIBALAYA UTARA, TANAMBULAVA, SIGI, SULAWESI TENGAH",7,60,60,120
https://kawalpemilu.org#67429,"TONGOA, PALOLO, SIGI, SULAWESI TENGAH",14,90,4,94
https://kawalpemilu.org#67870,"KAYAMANYA, POSO KOTA, POSO, SULAWESI TENGAH",3,62,153,217
https://kawalpemilu.org#68086,"LABUAN, LABUAN, DONGGALA, SULAWESI TENGAH",2,71,145,216
https://kawalpemilu.org#69073,"PALASA, PALASA, PARIGI MOUTONG, SULAWESI TENGAH",8,137,131,268
https://kawalpemilu.org#68630,"HARAPAN JAYA, BUMI RAYA, MOROWALI, SULAWESI TENGAH",3,154,62,216
https://kawalpemilu.org#72599,"TONGGONI, POMALAA, KOLAKA, SULAWESI TENGGARA",8,66,120,186
https://kawalpemilu.org#74625,"SANUA, KENDARI BARAT, KOTA KENDARI, SULAWESI TENGGARA",5,34,89,123
https://kawalpemilu.org#72597,"DAWI-DAWI, POMALAA, KOLAKA, SULAWESI TENGGARA",18,51,97,148
https://kawalpemilu.org#73464,"WATULEA, G U, BUTON TENGAH, SULAWESI TENGGARA",1,73,106,179
https://kawalpemilu.org#74702,"LANTO, BATUPOARO, KOTA BAU BAU, SULAWESI TENGGARA",4,119,85,204
https://kawalpemilu.org#74702,"LANTO, BATUPOARO, KOTA BAU BAU, SULAWESI TENGGARA",10,100,97,197
https://kawalpemilu.org#74495,"BASULE, LASOLO, KONAWE UTARA, SULAWESI TENGGARA",1,67,146,213
https://kawalpemilu.org#73698,"ALANGGA, ANDOOLO, KONAWE SELATAN, SULAWESI TENGGARA",1,30,128,158
https://kawalpemilu.org#73477,"MASIRI, BATAUGA, BUTON SELATAN, SULAWESI TENGGARA",8,122,27,149
https://kawalpemilu.org#73155,"ABADI JAYA, MAGINTI, MUNA BARAT, SULAWESI TENGGARA",1,129,59,188
https://kawalpemilu.org#72600,"KUMORO, POMALAA, KOLAKA, SULAWESI TENGGARA",2,124,130,254
https://kawalpemilu.org#72646,"LANGGOMALI, WOLO, KOLAKA, SULAWESI TENGGARA",2,20,144,164
https://kawalpemilu.org#74295,"PONGGIHA, LASUSUA, KOLAKA UTARA, SULAWESI TENGGARA",5,40,192,232
https://kawalpemilu.org#74192,"PADA RAYA MAKMUR, WANGI-WANGI, WAKATOBI, SULAWESI TENGGARA",1,107,136,243
https://kawalpemilu.org#73021,"ANDOMESINGGO, BESULUTU, KONAWE, SULAWESI TENGGARA",1,35,95,130
https://kawalpemilu.org#73324,"LAIBA, PARIGI, MUNA, SULAWESI TENGGARA",4,46,106,152
https://kawalpemilu.org#73366,"TAPI-TAPI, MAROBO, MUNA, SULAWESI TENGGARA",2,99,67,166
https://kawalpemilu.org#74323,"PUNCAK HARAPAN, BATU PUTIH, KOLAKA UTARA, SULAWESI TENGGARA",1,73,138,211
https://kawalpemilu.org#72732,"AWA, SAMATURU, KOLAKA, SULAWESI TENGGARA",3,25,111,136
https://kawalpemilu.org#73903,"PALOWEWU, BENUA, KONAWE SELATAN, SULAWESI TENGGARA",3,45,196,241
https://kawalpemilu.org#67214,"KAIRAGI DUA, MAPANGET, KOTA MANADO, SULAWESI UTARA",33,99,5,104
https://kawalpemilu.org#67242,"MADIDIR UNET, MADIDIR, KOTA BITUNG, SULAWESI UTARA",6,133,11,144
https://kawalpemilu.org#67259,"WINENET SATU, AERTEMBAGA, KOTA BITUNG, SULAWESI UTARA",3,136,22,158
https://kawalpemilu.org#928540,"DUMOGA III, DUMOGA TIMUR, BOLAANG MONGONDOW, SULAWESI UTARA",2,198,33,231
https://kawalpemilu.org#66732,"KAWILEY, KAUDITAN, MINAHASA UTARA, SULAWESI UTARA",4,191,16,207
https://kawalpemilu.org#65803,"LINAWAN I, PINOLOSIAN, BOLAANG MONGONDOW SELATAN, SULAWESI UTARA",1,99,120,219
https://kawalpemilu.org#65800,"KOMBOT, PINOLOSIAN, BOLAANG MONGONDOW SELATAN, SULAWESI UTARA",5,35,141,176
https://kawalpemilu.org#85541,"MAKALU SELATAN, PUSOMAEN, MINAHASA TENGGARA, SULAWESI UTARA",1,200,23,223
https://kawalpemilu.org#85518,"PANGIAN BARAT, PASSI TIMUR, BOLAANG MONGONDOW, SULAWESI UTARA",5,17,62,79
https://kawalpemilu.org#66810,"MARINSOW, LIKUPANG TIMUR, MINAHASA UTARA, SULAWESI UTARA",2,261,3,264
https://kawalpemilu.org#66168,"KAAYURAN ATAS, LANGOWAN SELATAN, MINAHASA, SULAWESI UTARA",2,138,5,143
https://kawalpemilu.org#67388,"MOLINOW, KOTAMOBAGU BARAT, KOTA KOTAMOBAGU, SULAWESI UTARA",15,40,156,196
https://kawalpemilu.org#66630,"TUMPAAN BARU, TUMPAAN, MINAHASA SELATAN, SULAWESI UTARA",2,192,23,215
https://kawalpemilu.org#66814,"PINENEK, LIKUPANG TIMUR, MINAHASA UTARA, SULAWESI UTARA",2,152,9,161
https://kawalpemilu.org#66639,"LANSOT, TARERAN, MINAHASA SELATAN, SULAWESI UTARA",1,215,7,222
https://kawalpemilu.org#85514,"MOPUYA SELATAN SATU, DUMOGA UTARA, BOLAANG MONGONDOW, SULAWESI UTARA",1,116,124,240
https://kawalpemilu.org#67162,"TIKALA KUMARAKA, WENANG, KOTA MANADO, SULAWESI UTARA",3,159,19,178
https://kawalpemilu.org#67200,"RANOTANA WERU, WANEA, KOTA MANADO, SULAWESI UTARA",9,236,19,255
https://kawalpemilu.org#67183,"TAAS, TIKALA, KOTA MANADO, SULAWESI UTARA",5,198,31,229
https://kawalpemilu.org#67219,"BAHU, MALALAYANG, KOTA MANADO, SULAWESI UTARA",6,187,9,196
https://kawalpemilu.org#13243,"BATU BULEK, LINTAU BUO UTARA, TANAH DATAR, SUMATERA BARAT",25,37,126,163
https://kawalpemilu.org#13226,"SIMABUR, PARIANGAN, TANAH DATAR, SUMATERA BARAT",10,6,109,115
https://kawalpemilu.org#13080,"BUKIT KANDUANG, X KOTO DIATAS, SOLOK, SUMATERA BARAT",4,7,121,128
https://kawalpemilu.org#13639,"LUBUK GADANG UTARA, SANGIR, SOLOK SELATAN, SUMATERA BARAT",17,4,110,114
https://kawalpemilu.org#13658,"LUBUK MALAKO, SANGIR JUJUAN, SOLOK SELATAN, SUMATERA BARAT",6,0,238,238
https://kawalpemilu.org#87713,"PONDOK PARIAN LUNANG, LUNANG, PESISIR SELATAN, SUMATERA BARAT",3,13,87,100
https://kawalpemilu.org#12937,"KAMBANG, LENGAYANG, PESISIR SELATAN, SUMATERA BARAT",14,18,163,181
https://kawalpemilu.org#13111,"SILOKEK, SIJUNJUNG, SIJUNJUNG, SUMATERA BARAT",2,24,161,185
https://kawalpemilu.org#13214,"GURUN, SUNGAI TARAB, TANAH DATAR, SUMATERA BARAT",7,9,132,141
https://kawalpemilu.org#84321,"SIMPANG LAMA INDERAPURA, PANCUNG SOAL, PESISIR SELATAN, SUMATERA BARAT",3,32,152,184
https://kawalpemilu.org#13147,"PADANG LAWEH, KOTO VII, SIJUNJUNG, SUMATERA BARAT",10,20,178,198
https://kawalpemilu.org#13414,"MALALAK SELATAN, MALALAK, AGAM, SUMATERA BARAT",2,18,93,111
https://kawalpemilu.org#13523,"PANTI, PANTI, PASAMAN, SUMATERA BARAT",31,19,160,179
https://kawalpemilu.org#13062,"KOTO HILALANG, KUBUNG, SOLOK, SUMATERA BARAT",8,14,121,135
https://kawalpemilu.org#931234,"Sikucua Timur, V KOTO KAMPUNG DALAM, PADANG PARIAMAN, SUMATERA BARAT",9,14,163,177
https://kawalpemilu.org#13689,"AIA GADANG, PASAMAN, PASAMAN BARAT, SUMATERA BARAT",31,15,234,249
https://kawalpemilu.org#13762,"TELUK KABUNG SELATAN, BUNGUS TELUK KABUNG, KOTA PADANG, SUMATERA BARAT",1,31,201,232
https://kawalpemilu.org#13804,"KURANJI, KURANJI, KOTA PADANG, SUMATERA BARAT",76,30,204,234
https://kawalpemilu.org#12993,"LUNANG UTARA, LUNANG, PESISIR SELATAN, SUMATERA BARAT",1,14,145,159
https://kawalpemilu.org#13742,"PADANG PASIR, PADANG BARAT, KOTA PADANG, SUMATERA BARAT",8,23,129,152
https://kawalpemilu.org#13203,"TIGO JANGKO, LINTAU BUO, TANAH DATAR, SUMATERA BARAT",23,5,136,141
https://kawalpemilu.org#13316,"GADUR, ENAM LINGKUNG, PADANG PARIAMAN, SUMATERA BARAT",7,10,167,177
https://kawalpemilu.org#13826,"PARUPUK TABING, KOTO TANGAH, KOTA PADANG, SUMATERA BARAT",7,35,195,230
https://kawalpemilu.org#13109,"MUARO, SIJUNJUNG, SIJUNJUNG, SUMATERA BARAT",22,4,136,140
https://kawalpemilu.org#13677,"SUNGAI KUNYIT, SANGIR BALAI JANGGO, SOLOK SELATAN, SUMATERA BARAT",8,74,83,157
https://kawalpemilu.org#13315,"PARIT MALINTANG, ENAM LINGKUNG, PADANG PARIAMAN, SUMATERA BARAT",12,22,112,134
https://kawalpemilu.org#13471,"PANDAM GADANG, GUNUANG OMEH, LIMA PULUH KOTA, SUMATERA BARAT",11,21,121,142
https://kawalpemilu.org#12997,"TAPAN, BASA AMPEK BALAI TAPAN, PESISIR SELATAN, SUMATERA BARAT",2,33,192,225
https://kawalpemilu.org#84408,"TEBING TINGGI TAPAN, RANAH AMPEK HULU TAPAN, PESISIR SELATAN, SUMATERA BARAT",8,52,129,181
https://kawalpemilu.org#13458,"GUNUANG MALINTANG, PANGKALAN KOTO BARU, LIMA PULUH KOTA, SUMATERA BARAT",13,20,104,124
https://kawalpemilu.org#12942,"LAKITAN UTARA, LENGAYANG, PESISIR SELATAN, SUMATERA BARAT",21,10,119,129
https://kawalpemilu.org#13040,"MUARO PANEH, BUKIT SUNDI, SOLOK, SUMATERA BARAT",18,6,142,148
https://kawalpemilu.org#13410,"KAMANG MUDIAK, KAMANG MAGEK, AGAM, SUMATERA BARAT",26,11,195,206
https://kawalpemilu.org#13699,"RABI JONGGOR, GUNUNG TULEH, PASAMAN BARAT, SUMATERA BARAT",29,23,189,212
https://kawalpemilu.org#13351,"SIANOK ANAM SUKU, IV KOTO, AGAM, SUMATERA BARAT",5,9,162,171
https://kawalpemilu.org#13553,"TANJUNG BETUNG, RAO SELATAN, PASAMAN, SUMATERA BARAT",25,11,208,219
https://kawalpemilu.org#13324,"GERAGAHAN, LUBUK BASUNG, AGAM, SUMATERA BARAT",15,20,138,158
https://kawalpemilu.org#13344,"PANTA PAUH, MATUR, AGAM, SUMATERA BARAT",4,18,189,207
https://kawalpemilu.org#12939,"KAMBANG UTARA, LENGAYANG, PESISIR SELATAN, SUMATERA BARAT",6,15,124,139
https://kawalpemilu.org#13401,"SITANANG, AMPEK NAGARI, AGAM, SUMATERA BARAT",3,2,156,158
https://kawalpemilu.org#13175,"ANDALEH, BATIPUH, TANAH DATAR, SUMATERA BARAT",8,20,91,111
https://kawalpemilu.org#13912,"KAYU KUBU, GUGUAK PANJANG, KOTA BUKITTINGGI, SUMATERA BARAT",10,29,152,181
https://kawalpemilu.org#19511,"SUKA RAJA, BUAY MADANG, OGAN KOMERING ULU TIMUR, SUMATERA SELATAN",14,105,159,264
https://kawalpemilu.org#17998,"TALANG BULANG, TALANG UBI, PENUKAL ABAB LEMATANG ILIR, SUMATERA SELATAN",2,72,95,167
https://kawalpemilu.org#20497,"TALANG PADANG, PASEMAH AIR KERUH, EMPAT LAWANG, SUMATERA SELATAN",12,35,129,164
https://kawalpemilu.org#19508,"PERJAYA BARAT, MARTAPURA, OGAN KOMERING ULU TIMUR, SUMATERA SELATAN",4,73,156,229
https://kawalpemilu.org#19452,"SUMBER MEKAR MUKTI, TANJUNG LAGO, BANYUASIN, SUMATERA SELATAN",6,160,19,179
https://kawalpemilu.org#90681,"BESEMAH SERASAN, PAGAR ALAM SELATAN, KOTA PAGAR ALAM, SUMATERA SELATAN",13,72,166,238
https://kawalpemilu.org#19100,"SIMPANG TUNGKAL, TUNGKAL JAYA, MUSI BANYUASIN, SUMATERA SELATAN",11,116,36,152
https://kawalpemilu.org#18661,"SIDOHARJO, TUGUMULYO, MUSI RAWAS, SUMATERA SELATAN",6,122,131,253
https://kawalpemilu.org#19583,"KERTA NEGARA, MADANG SUKU II, OGAN KOMERING ULU TIMUR, SUMATERA SELATAN",3,99,103,202
https://kawalpemilu.org#20594,"KALIDONI, KALIDONI, KOTA PALEMBANG, SUMATERA SELATAN",6,51,158,209
https://kawalpemilu.org#19032,"SUGI WARAS, BABAT TOMAN, MUSI BANYUASIN, SUMATERA SELATAN",3,104,117,221
https://kawalpemilu.org#18225,"PENGABUAN TIMUR, ABAB, PENUKAL ABAB LEMATANG ILIR, SUMATERA SELATAN",3,123,75,198
https://kawalpemilu.org#19514,"SUMBER AGUNG, BUAY MADANG, OGAN KOMERING ULU TIMUR, SUMATERA SELATAN",5,102,95,197
https://kawalpemilu.org#18039,"TANJUNG E. SELATAN, LAWANG KIDUL, MUARA ENIM, SUMATERA SELATAN",4,63,139,202
https://kawalpemilu.org#17745,"NEGERI SAKTI, AIR SUGIHAN, OGAN KOMERING ILIR, SUMATERA SELATAN",3,100,93,193
https://kawalpemilu.org#18889,"SUMBER SARI, NIBUNG, MUSI RAWAS UTARA, SUMATERA SELATAN",4,115,64,179
https://kawalpemilu.org#17816,"PERIGI, PANGKALAN LAMPAM, OGAN KOMERING ILIR, SUMATERA SELATAN",5,55,181,236
https://kawalpemilu.org#19977,"SINGA LAGA, KISAM TINGGI, OGAN KOMERING ULU SELATAN, SUMATERA SELATAN",2,131,54,185
https://kawalpemilu.org#18689,"LUBUK TUA, MUARA KELINGI, MUSI RAWAS, SUMATERA SELATAN",14,103,106,209
https://kawalpemilu.org#20591,"TALANG AMAN, KEMUNING, KOTA PALEMBANG, SUMATERA SELATAN",1,69,47,116
https://kawalpemilu.org#20577,"SUKA BANGUN, SUKARAMI, KOTA PALEMBANG, SUMATERA SELATAN",31,50,123,173
https://kawalpemilu.org#18665,"ANYAR, MUARA LAKITAN, MUSI RAWAS, SUMATERA SELATAN",4,61,90,151
https://kawalpemilu.org#91894,"SIMPANG TAIS, TALANG UBI, PENUKAL ABAB LEMATANG ILIR, SUMATERA SELATAN",5,69,83,152
https://kawalpemilu.org#20542,"LOROK PAKJO, ILIR BARAT I, KOTA PALEMBANG, SUMATERA SELATAN",28,61,76,137
https://kawalpemilu.org#19568,"BANU MAS, BUAY PEMUKA PELIUNG, OGAN KOMERING ULU TIMUR, SUMATERA SELATAN",5,90,164,254
https://kawalpemilu.org#20772,"TUGU KECIL, PRABUMULIH TIMUR, KOTA PRABUMULIH, SUMATERA SELATAN",1,73,79,152
https://kawalpemilu.org#20628,"SRIJAYA, ALANG-ALANG LEBAR, KOTA PALEMBANG, SUMATERA SELATAN",15,47,111,158
https://kawalpemilu.org#20562,"9 ILIR, ILIR TIMUR III, KOTA PALEMBANG, SUMATERA SELATAN",4,117,95,212
https://kawalpemilu.org#20054,"ULU DANAU, SINDANG DANAU, OGAN KOMERING ULU SELATAN, SUMATERA SELATAN",13,27,96,123
https://kawalpemilu.org#20629,"TALANG KELAPA, ALANG-ALANG LEBAR, KOTA PALEMBANG, SUMATERA SELATAN",32,55,163,218
https://kawalpemilu.org#20526,"5 ULU, SEBERANG ULU I, KOTA PALEMBANG, SUMATERA SELATAN",10,40,117,157
https://kawalpemilu.org#20688,"KAYU ARA, LUBUK LINGGAU BARAT I, KOTA LUBUKLINGGAU, SUMATERA SELATAN",8,51,121,172
https://kawalpemilu.org#18647,"TEGAL REJO, TUGUMULYO, MUSI RAWAS, SUMATERA SELATAN",4,65,174,239
https://kawalpemilu.org#18842,"SADAR KARYA, PURWODADI, MUSI RAWAS, SUMATERA SELATAN",3,78,164,242
https://kawalpemilu.org#90555,"TIRTO HARJO, MUARA SUGIHAN, BANYUASIN, SUMATERA SELATAN",1,105,117,222
https://kawalpemilu.org#18081,"UJAN MAS LAMA, UJAN MAS, MUARA ENIM, SUMATERA SELATAN",15,104,114,218
https://kawalpemilu.org#19399,"GASING, TALANG KELAPA, BANYUASIN, SUMATERA SELATAN",17,94,81,175
https://kawalpemilu.org#20796,"ANAK PETAI, PRABUMULIH UTARA, KOTA PRABUMULIH, SUMATERA SELATAN",4,78,114,192
https://kawalpemilu.org#19572,"TRANTANG SAKTI, BUAY PEMUKA PELIUNG, OGAN KOMERING ULU TIMUR, SUMATERA SELATAN",4,109,118,227
https://kawalpemilu.org#90671,"MUARALINTANG LAMA, PENDOPO BARAT, EMPAT LAWANG, SUMATERA SELATAN",2,34,93,127
https://kawalpemilu.org#19853,"KARANG INDAH, BANDING AGUNG, OGAN KOMERING ULU SELATAN, SUMATERA SELATAN",1,70,49,119
https://kawalpemilu.org#18944,"KAYU ARA, SEKAYU, MUSI BANYUASIN, SUMATERA SELATAN",18,45,231,229
https://kawalpemilu.org#17996,"PASAR BAYANGKARA, TALANG UBI, PENUKAL ABAB LEMATANG ILIR, SUMATERA SELATAN",10,98,107,205
https://kawalpemilu.org#90947,"MEKAR SARI, SOSOH BUAY RAYAP, OGAN KOMERING ULU, SUMATERA SELATAN",3,55,84,139
https://kawalpemilu.org#19420,"RANTAU  HARAPAN, RANTAU BAYUR, BANYUASIN, SUMATERA SELATAN",4,100,70,170
https://kawalpemilu.org#19219,"MEKAR SARI, BANYUASIN II, BANYUASIN, SUMATERA SELATAN",4,206,34,240
https://kawalpemilu.org#18866,"KARANG JAYA, KARANG JAYA, MUSI RAWAS UTARA, SUMATERA SELATAN",4,43,111,154
https://kawalpemilu.org#19864,"TANJUNG TEBAT, MUARA DUA KISAM, OGAN KOMERING ULU SELATAN, SUMATERA SELATAN",3,43,87,130
https://kawalpemilu.org#19158,"JAYA AGUNG, LALAN, MUSI BANYUASIN, SUMATERA SELATAN",1,126,17,143
https://kawalpemilu.org#19921,"KOTA DALAM, MEKAKAU ILIR, OGAN KOMERING ULU SELATAN, SUMATERA SELATAN",5,81,131,212
https://kawalpemilu.org#17468,"BATU PUTIH, BATURAJA BARAT, OGAN KOMERING ULU, SUMATERA SELATAN",5,59,148,207
https://kawalpemilu.org#17993,"TALANG UBI BARAT, TALANG UBI, PENUKAL ABAB LEMATANG ILIR, SUMATERA SELATAN",16,115,60,175
https://kawalpemilu.org#20614,"KERAMASAN, KERTAPATI, KOTA PALEMBANG, SUMATERA SELATAN",18,36,148,184
https://kawalpemilu.org#20621,"PLAJU ILIR, PLAJU, KOTA PALEMBANG, SUMATERA SELATAN",16,100,115,215
https://kawalpemilu.org#20783,"KARYA MULYA, RAMBANG KPK TENGAH, KOTA PRABUMULIH, SUMATERA SELATAN",6,91,107,198
https://kawalpemilu.org#17920,"PULAU PANGGUNG, TANJUNG AGUNG, MUARA ENIM, SUMATERA SELATAN",1,47,211,258
https://kawalpemilu.org#20725,"MESAT JAYA, LUBUK LINGGAU TIMUR II, KOTA LUBUKLINGGAU, SUMATERA SELATAN",6,57,173,230
https://kawalpemilu.org#17924,"TUNGKAL, MUARA ENIM, MUARA ENIM, SUMATERA SELATAN",8,76,160,236
https://kawalpemilu.org#20322,"LUBUK KELIAT, LUBUK KELIAT, OGAN ILIR, SUMATERA SELATAN",2,77,71,148
https://kawalpemilu.org#20525,"3 / 4 ULU, SEBERANG ULU I, KOTA PALEMBANG, SUMATERA SELATAN",48,70,76,146
https://kawalpemilu.org#18261,"SADAN, JARAI, LAHAT, SUMATERA SELATAN",4,173,91,264
https://kawalpemilu.org#19011,"AIR BALUI, SANGA DESA, MUSI BANYUASIN, SUMATERA SELATAN",5,93,72,165
https://kawalpemilu.org#19766,"WINDUSARI, BELITANG JAYA, OGAN KOMERING ULU TIMUR, SUMATERA SELATAN",3,176,42,218
https://kawalpemilu.org#9689,"SILO LAMA, SILAU LAUT, ASAHAN, SUMATERA UTARA",8,70,117,187
https://kawalpemilu.org#10193,"MARSANGAP, SIGUMPAR, TOBA SAMOSIR, SUMATERA UTARA",3,113,3,116
https://kawalpemilu.org#11662,"KUALA INDAH, SEI SUKA, BATU BARA, SUMATERA UTARA",6,93,92,185
https://kawalpemilu.org#8171,"SENDANG REJO, BINJAI, LANGKAT, SUMATERA UTARA",16,55,121,176
https://kawalpemilu.org#11811,"AMPLAS, MEDAN AMPLAS, KOTA MEDAN, SUMATERA UTARA",31,59,138,197
https://kawalpemilu.org#8442,"BULANJAHE, BARUSJAHE, KARO, SUMATERA UTARA",1,196,8,204
https://kawalpemilu.org#12446,"PADANG GARUGUR, PADANG BOLAK, PADANG LAWAS UTARA, SUMATERA UTARA",2,31,191,222
https://kawalpemilu.org#7768,"PADANG BUJUR, SIPIROK, TAPANULI SELATAN, SUMATERA UTARA",2,40,181,221
https://kawalpemilu.org#11437,"SILAU RAKYAT, SEI. RAMPAH, SERDANG BEDAGAI, SUMATERA UTARA",16,119,67,186
https://kawalpemilu.org#12103,"DAMAR SARI, PADANG HILIR, KOTA TEBING TINGGI, SUMATERA UTARA",7,205,5,210
https://kawalpemilu.org#12588,"GUNUNG MANAON SIM, SIMANGAMBAT, PADANG LAWAS UTARA, SUMATERA UTARA",2,50,81,131
https://kawalpemilu.org#11712,"KARANG BARU, TALAWI, BATU BARA, SUMATERA UTARA",2,106,74,180
https://kawalpemilu.org#7104,"LOLOMBOLI, MANDREHE UTARA, NIAS BARAT, SUMATERA UTARA",1,125,5,130
https://kawalpemilu.org#8015,"TETEHOSI, IDANO GAWO, NIAS, SUMATERA UTARA",5,183,25,208
https://kawalpemilu.org#12656,"SIBATU LOTING, BARUMUN TENGAH, PADANG LAWAS, SUMATERA UTARA",2,21,199,220
https://kawalpemilu.org#7593,"LUMBAN JULU, PAGARAN, TAPANULI UTARA, SUMATERA UTARA",1,228,6,234
https://kawalpemilu.org#9643,"PERKEBUNAN GUNUNG MELAYU, RAHUNING, ASAHAN, SUMATERA UTARA",10,60,122,182
https://kawalpemilu.org#11905,"PULO BRAYAN BENGKEL, MEDAN TIMUR, KOTA MEDAN, SUMATERA UTARA",21,57,90,147
https://kawalpemilu.org#11317,"HUTA GINJANG, SIMANINDO, SAMOSIR, SUMATERA UTARA",5,162,0,162
https://kawalpemilu.org#11937,"BARU, SIANTAR UTARA, KOTA PEMATANGSIANTAR, SUMATERA UTARA",19,40,91,131
https://kawalpemilu.org#9606,"BUNUT BARAT, KOTA KISARAN BARAT, ASAHAN, SUMATERA UTARA",13,60,93,153
https://kawalpemilu.org#12575,"AEK RARU, SIMANGAMBAT, PADANG LAWAS UTARA, SUMATERA UTARA",2,276,2,278
https://kawalpemilu.org#12181,"SIHITANG, PADANG SIDEMPUAN TENGGARA, KOTA PADANG SIDEMPUAN, SUMATERA UTARA",18,66,40,106
https://kawalpemilu.org#11409,"PEMATANG TATAL, PERBAUNGAN, SERDANG BEDAGAI, SUMATERA UTARA",1,118,87,205
https://kawalpemilu.org#12113,"TELUK KARANG, BAJENIS, KOTA TEBING TINGGI, SUMATERA UTARA",7,94,119,213
https://kawalpemilu.org#8902,"BAGERPANG, BANGUN PURBA, DELI SERDANG, SUMATERA UTARA",4,34,68,102
https://kawalpemilu.org#8221,"HINAI KIRI, SECANGGANG, LANGKAT, SUMATERA UTARA",11,95,93,188
https://kawalpemilu.org#12280,"TARUTUNG BOLAK, DOLOK, PADANG LAWAS UTARA, SUMATERA UTARA",1,81,81,162
https://kawalpemilu.org#11760,"SUNGGAL, MEDAN SUNGGAL, KOTA MEDAN, SUMATERA UTARA",68,99,45,144
https://kawalpemilu.org#9386,"NAGORI BANDAR, BANDAR, SIMALUNGUN, SUMATERA UTARA",4,187,13,200
https://kawalpemilu.org#8719,"BANGUN SARI, TANJUNG MORAWA, DELI SERDANG, SUMATERA UTARA",34,182,9,191
https://kawalpemilu.org#6803,"SUKARAME BARU, KUALUH HULU, LABUHANBATU UTARA, SUMATERA UTARA",3,147,49,196
https://kawalpemilu.org#7463,"PARBAJU TONGA, TARUTUNG, TAPANULI UTARA, SUMATERA UTARA",4,137,4,141
https://kawalpemilu.org#7174,"LOLOLAKHA, GUNUNGSITOLI SELATAN, KOTA GUNUNGSITOLI, SUMATERA UTARA",3,151,9,160
https://kawalpemilu.org#12102,"SATRIA, PADANG HILIR, KOTA TEBING TINGGI, SUMATERA UTARA",4,55,115,170
https://kawalpemilu.org#9632,"AEK SONGSONGAN, AEK SONGSONGAN, ASAHAN, SUMATERA UTARA",12,64,65,129
https://kawalpemilu.org#11165,"SILEANG, DOLOK SANGGUL, HUMBANG HASUNDUTAN, SUMATERA UTARA",1,155,0,155
https://kawalpemilu.org#8010,"AHEDANO, IDANO GAWO, NIAS, SUMATERA UTARA",3,96,10,106
https://kawalpemilu.org#12065,"TANAH TINGGI, BINJAI TIMUR, KOTA BINJAI, SUMATERA UTARA",5,77,162,239
https://kawalpemilu.org#8924,"GALANG SUKA, GALANG, DELI SERDANG, SUMATERA UTARA",6,48,178,226
https://kawalpemilu.org#12810,"PASAR SIBUHUAN, BARUMUN, PADANG LAWAS, SUMATERA UTARA",37,51,207,258
https://kawalpemilu.org#7417,"SIHARBANGAN, BARUS UTARA, TAPANULI TENGAH, SUMATERA UTARA",1,148,4,152
https://kawalpemilu.org#12027,"GADING, DATUK BANDAR, KOTA TANJUNG BALAI, SUMATERA UTARA",3,23,101,124
https://kawalpemilu.org#7253,"BUNGO TANJUNG, BARUS, TAPANULI TENGAH, SUMATERA UTARA",2,265,3,268
https://kawalpemilu.org#11432,"FIRDAUS, SEI. RAMPAH, SERDANG BEDAGAI, SUMATERA UTARA",9,71,158,229
https://kawalpemilu.org#9471,"UJUNG PADANG, UJUNG PADANG, SIMALUNGUN, SUMATERA UTARA",16,39,60,99
https://kawalpemilu.org#11899,"SIDODADI, MEDAN TIMUR, KOTA MEDAN, SUMATERA UTARA",14,147,49,196
https://kawalpemilu.org#11835,"PANGKALAN MANSUR, MEDAN JOHOR, KOTA MEDAN, SUMATERA UTARA",116,26,110,136
https://kawalpemilu.org#7276,"SIBULUAN NAULI, PANDAN, TAPANULI TENGAH, SUMATERA UTARA",4,149,26,175
https://kawalpemilu.org#6739,"PERKEBUNAN NAGODANG, KOTAPINANG, LABUHANBATU SELATAN, SUMATERA UTARA",5,58,95,153
https://kawalpemilu.org#12102,"SATRIA, PADANG HILIR, KOTA TEBING TINGGI, SUMATERA UTARA",9,66,101,167
https://kawalpemilu.org#9029,"SAENTIS, PERCUT SEI TUAN, DELI SERDANG, SUMATERA UTARA",9,87,137,224
https://kawalpemilu.org#11687,"KUALA GUNUNG, LIMA PULUH, BATU BARA, SUMATERA UTARA",6,105,21,126
https://kawalpemilu.org#8203,"ARA CONDONG, STABAT, LANGKAT, SUMATERA UTARA",1,27,146,173
https://kawalpemilu.org#12247,"NAHULA JAE, DOLOK SIGOMPULON, PADANG LAWAS UTARA, SUMATERA UTARA",3,6,50,56
https://kawalpemilu.org#7717,"AEK PINING, BATANG TORU, TAPANULI SELATAN, SUMATERA UTARA",8,66,73,139
https://kawalpemilu.org#8210,"KEBUN BALOK, WAMPU, LANGKAT, SUMATERA UTARA",9,74,116,190
https://kawalpemilu.org#10564,"TABUYUNG, MUARA BATANG GADIS, MANDAILING NATAL, SUMATERA UTARA",7,43,79,123
https://kawalpemilu.org#11997,"PANCURAN DEWA, SIBOLGA SAMBAS, KOTA SIBOLGA, SUMATERA UTARA",9,76,108,184
https://kawalpemilu.org#11807,"BELAWAN BAHARI, MEDAN BELAWAN, KOTA MEDAN, SUMATERA UTARA",23,34,126,160
https://kawalpemilu.org#8969,"DELI TUA BARAT, DELI TUA, DELI SERDANG, SUMATERA UTARA",7,80,78,158
https://kawalpemilu.org#12163,"PUDUN JAE, PADANG SIDEMPUAN BATUNADUA, KOTA PADANG SIDEMPUAN, SUMATERA UTARA",4,19,148,167
https://kawalpemilu.org#9593,"HUTA PADANG, BANDAR PASIR MANDOGE, ASAHAN, SUMATERA UTARA",8,195,21,216
https://kawalpemilu.org#6742,"PERK. PERLABIAN, KAMPUNG RAKYAT, LABUHANBATU SELATAN, SUMATERA UTARA",2,46,133,179
https://kawalpemilu.org#12448,"SIGAMA, PADANG BOLAK, PADANG LAWAS UTARA, SUMATERA UTARA",1,26,215,241
https://kawalpemilu.org#6943,"BANUA SIBOHOU III, ALASA TALUMUZOI, NIAS UTARA, SUMATERA UTARA",1,142,16,158
https://kawalpemilu.org#9715,"PERKEBUNAN TELUK DALAM, TELUK DALAM, ASAHAN, SUMATERA UTARA",4,50,179,229
https://kawalpemilu.org#11462,"KAYU BESAR, BANDAR KHALIFAH, SERDANG BEDAGAI, SUMATERA UTARA",7,47,126,173
https://kawalpemilu.org#11432,"FIRDAUS, SEI. RAMPAH, SERDANG BEDAGAI, SUMATERA UTARA",31,96,75,171
https://kawalpemilu.org#11750,"KOTAMATSUM III, MEDAN KOTA, KOTA MEDAN, SUMATERA UTARA",11,39,134,173
https://kawalpemilu.org#10321,"SIMANGAMBAT, SIABU, MANDAILING NATAL, SUMATERA UTARA",13,14,171,185
https://kawalpemilu.org#12765,"LUBUK BUNUT, HUTA RAJA TINGGI, PADANG LAWAS, SUMATERA UTARA",4,38,181,219
https://kawalpemilu.org#9605,"BUNUT, KOTA KISARAN BARAT, ASAHAN, SUMATERA UTARA",9,24,125,149
https://kawalpemilu.org#12259,"TANJUNG BARU B, DOLOK, PADANG LAWAS UTARA, SUMATERA UTARA",1,28,19,47
https://kawalpemilu.org#11895,"SEI PUTIH TIMUR I, MEDAN PETISAH, KOTA MEDAN, SUMATERA UTARA",6,142,53,195
https://kawalpemilu.org#8806,"UJUNG LABUHAN, NAMORAMBE, DELI SERDANG, SUMATERA UTARA",6,138,9,147
https://kawalpemilu.org#6896,"MAZIAYA, LOTU, NIAS UTARA, SUMATERA UTARA",1,225,7,232
https://kawalpemilu.org#11836,"GEDUNG JOHOR, MEDAN JOHOR, KOTA MEDAN, SUMATERA UTARA",64,57,134,191
https://kawalpemilu.org#6791,"AEK KANOPAN, KUALUH HULU, LABUHANBATU UTARA, SUMATERA UTARA",22,109,58,167
https://kawalpemilu.org#6792,"AEK KANOPAN TIMUR, KUALUH HULU, LABUHANBATU UTARA, SUMATERA UTARA",8,74,96,170
https://kawalpemilu.org#7419,"PULO PAKKAT, SUKA BANGUN, TAPANULI TENGAH, SUMATERA UTARA",3,127,5,132
https://kawalpemilu.org#11855,"BANTAN, MEDAN TEMBUNG, KOTA MEDAN, SUMATERA UTARA",65,113,98,211
https://kawalpemilu.org#8295,"AIR HITAM, GEBANG, LANGKAT, SUMATERA UTARA",3,69,169,238
https://kawalpemilu.org#8649,"GONGSOL, MERDEKA, KARO, SUMATERA UTARA",3,181,22,203
https://kawalpemilu.org#6758,"BANGAI, TORGAMBA, LABUHANBATU SELATAN, SUMATERA UTARA",10,116,78,194
https://kawalpemilu.org#7768,"PADANG BUJUR, SIPIROK, TAPANULI SELATAN, SUMATERA UTARA",3,20,125,145
https://kawalpemilu.org#11770,"DWI KORA, MEDAN HELVETIA, KOTA MEDAN, SUMATERA UTARA",7,144,52,196
https://kawalpemilu.org#9453,"PEMATANG RAYA, RAYA, SIMALUNGUN, SUMATERA UTARA",14,206,2,208
https://kawalpemilu.org#12141,"WEK V, PADANG SIDEMPUAN SELATAN, KOTA PADANG SIDEMPUAN, SUMATERA UTARA",30,24,115,139
https://kawalpemilu.org#9956,"SOPOBUTAR, SIEMPAT NEMPU HILIR, DAIRI, SUMATERA UTARA",2,113,2,115
https://kawalpemilu.org#8852,"SELAMAT, SIBIRU-BIRU, DELI SERDANG, SUMATERA UTARA",4,93,93,186
https://kawalpemilu.org#9309,"SABAGANDING, GIRSANG SIPANGAN BOLON, SIMALUNGUN, SUMATERA UTARA",4,131,16,147
https://kawalpemilu.org#11802,"MANGGA, MEDAN TUNTUNGAN, KOTA MEDAN, SUMATERA UTARA",29,106,61,167
https://kawalpemilu.org#9019,"KENANGAN, PERCUT SEI TUAN, DELI SERDANG, SUMATERA UTARA",23,104,94,198
https://kawalpemilu.org#9386,"NAGORI BANDAR, BANDAR, SIMALUNGUN, SUMATERA UTARA",11,77,4,81
https://kawalpemilu.org#8160,"EMP. KW. MENCIRIM, SEI BINGEI, LANGKAT, SUMATERA UTARA",5,91,120,211
https://kawalpemilu.org#12151,"PADANG MATINGGI LESTARI, PADANG SIDEMPUAN SELATAN, KOTA PADANG SIDEMPUAN, SUMATERA UTARA",4,150,12,162
https://kawalpemilu.org#9032,"BANDAR KLIPPA, PERCUT SEI TUAN, DELI SERDANG, SUMATERA UTARA",60,58,95,153
https://kawalpemilu.org#12141,"WEK V, PADANG SIDEMPUAN SELATAN, KOTA PADANG SIDEMPUAN, SUMATERA UTARA",29,33,103,136
https://kawalpemilu.org#87808,"SUKA JAYA, TANJUNG TIRAM, BATU BARA, SUMATERA UTARA",5,27,110,137
https://kawalpemilu.org#11808,"BELAWAN SICANANG, MEDAN BELAWAN, KOTA MEDAN, SUMATERA UTARA",25,121,62,183
https://kawalpemilu.org#8177,"PEKAN SELESAI, SELESAI, LANGKAT, SUMATERA UTARA",30,56,146,202
https://kawalpemilu.org#11401,"KOTA GALUH, PERBAUNGAN, SERDANG BEDAGAI, SUMATERA UTARA",9,180,5,185
https://kawalpemilu.org#7433,"PASIR BIDANG, SARUDIK, TAPANULI TENGAH, SUMATERA UTARA",10,153,13,166
https://kawalpemilu.org#9052,"LUBUK PAKAM I.II, LUBUK PAKAM, DELI SERDANG, SUMATERA UTARA",19,48,49,97
