,Link KawalPemilu,Nama Kelurahan,Nomor TPS,Suara 01,Suara 02,Suara Sah
1396,https://kawalpemilu.org#730,"JULOK TUNONG, JULOK, ACEH TIMUR, ACEH",4,4,130,134
11968,https://kawalpemilu.org#5826,"SRIWIJAYA, KOTA KUALASIMPANG, ACEH TAMIANG, ACEH",5,27,186,213
1375,https://kawalpemilu.org#716,"KEMUNING LIMONG, DARUL AMAN, ACEH TIMUR, ACEH",1,13,91,104
15095,https://kawalpemilu.org#6668,"KAMPUNG BARU, PENANGGALAN, KOTA SUBULUSSALAM, ACEH",2,17,218,235
6473,https://kawalpemilu.org#3395,"RAWA, LHOKSUKON, ACEH UTARA, ACEH",124,48,77,125
1193,https://kawalpemilu.org#554,"TUAH MESADE, BABUL RAHMAH, ACEH TENGGARA, ACEH",1,12,161,173
4576,https://kawalpemilu.org#2510,"CEURIH BLANG MEE, DELIMA, PIDIE, ACEH",1,6,107,113
9554,https://kawalpemilu.org#4724,"PANTE BARO, JULI, BIREUEN, ACEH",2,7,176,183
14163,https://kawalpemilu.org#6529,"PANGGOI, MUARA DUA, KOTA LHOKSEUMAWE, ACEH",11,19,222,241
1438,https://kawalpemilu.org#749,"PAYA PASI, JULOK, ACEH TIMUR, ACEH",1,21,219,240
10479,https://kawalpemilu.org#929317,"ALUE SEULASEH, JEUMPA, ACEH BARAT DAYA, ACEH",1,27,191,218
13441,https://kawalpemilu.org#6405,"ATEUK PAHLAWAN, BAITURRAHMAN, KOTA BANDA ACEH, ACEH",6,17,159,176
9182,https://kawalpemilu.org#4518,"BLANG COT BAROH, JEUMPA, BIREUEN, ACEH",3,6,146,152
11626,https://kawalpemilu.org#5577,"BABAH SUAK, BEUTONG ATEUH BANGGALANG, NAGAN RAYA, ACEH",2,3,143,146
13002,https://kawalpemilu.org#6211,"BALEE ULIM, ULIM, PIDIE JAYA, ACEH",1,17,185,202
9753,https://kawalpemilu.org#4833,"TAMBUE BARAT, SIMPANG MAMPLAM, BIREUEN, ACEH",2,14,107,121
5751,https://kawalpemilu.org#3158,"GRONG-GRONG, GRONG-GRONG, PIDIE, ACEH",2,27,178,205
2923,https://kawalpemilu.org#1477,"TAKENGON TIMUR, LUT TAWAR, ACEH TENGAH, ACEH",6,56,195,251
2914,https://kawalpemilu.org#1474,"UNING BERAWANG RAMUNG, CELALA, ACEH TENGAH, ACEH",1,76,119,195
13825,https://kawalpemilu.org#6471,"LAM ARA, BANDA RAYA, KOTA BANDA ACEH, ACEH",4,21,238,259
10885,https://kawalpemilu.org#5351,"LHOK TIMON, SETIA BAKTI, ACEH JAYA, ACEH",5,9,154,163
6913,https://kawalpemilu.org#3583,"COT TRUENG, SEUNUDDON, ACEH UTARA, ACEH",36,9,198,207
6894,https://kawalpemilu.org#3577,"ALUE CAPLI, SEUNUDDON, ACEH UTARA, ACEH",25,7,181,188
8876,https://kawalpemilu.org#4328,"TELAGA BAKTI, SINGKIL UTARA, ACEH SINGKIL, ACEH",4,78,68,146
4145,https://kawalpemilu.org#2254,"LAM DURO, DARUSSALAM, ACEH BESAR, ACEH",1,11,224,235
960,https://kawalpemilu.org#419,"LAWE DESKY SABAS, BABUL MAKMUR, ACEH TENGGARA, ACEH",3,169,3,172
1710,https://kawalpemilu.org#867,"BEURANDANG, NURUSSALAM, ACEH TIMUR, ACEH",1,8,82,90
5642,https://kawalpemilu.org#3107,"MESJID USI, MUTIARA TIMUR, PIDIE, ACEH",3,11,112,123
5253,https://kawalpemilu.org#2891,"PALOH, PIDIE, PIDIE, ACEH",4,8,168,176
3032,https://kawalpemilu.org#1500,"DRIEN RAMPAK, JOHAN PAHWALAN, ACEH BARAT, ACEH",5,15,211,226
5228,https://kawalpemilu.org#2881,"KEUNIREE, PIDIE, PIDIE, ACEH",1,13,196,209
982,https://kawalpemilu.org#428,"LAWE MANTIK, BABUL MAKMUR, ACEH TENGGARA, ACEH",3,145,2,147
2660,https://kawalpemilu.org#1339,"KUNG, PEGASING, ACEH TENGAH, ACEH",1,91,150,241
10543,https://kawalpemilu.org#5160,"KUTELINTANG, BLANGKEJEREN, GAYO LUES, ACEH",2,21,221,242
3867,https://kawalpemilu.org#2077,"LAMTHEUN, DARUL IMARAH, ACEH BESAR, ACEH",2,30,192,222
4479,https://kawalpemilu.org#2459,"GEUNTENG TIMUR, BATEE, PIDIE, ACEH",3,20,190,210
5124,https://kawalpemilu.org#2816,"DUA PAYA, PEUKAN BARO, PIDIE, ACEH",3,6,138,144
11255,https://kawalpemilu.org#5557,"BLANG MESJID, BEUTONG, NAGAN RAYA, ACEH",1,10,157,167
1722,https://kawalpemilu.org#883,"BEUSA MEURANOE, PEUREULAK, ACEH TIMUR, ACEH",1,26,145,171
9961,https://kawalpemilu.org#4928,"TANJONG BEURIDI, PEUSANGAN SELATAN, BIREUEN, ACEH",7,9,180,189
7747,https://kawalpemilu.org#3876,"KAMPUNG BANTAN, COT GIREK, ACEH UTARA, ACEH",30,24,130,154
3258,https://kawalpemilu.org#1611,"PANTON, WOYLA, ACEH BARAT, ACEH",1,16,104,120
11274,https://kawalpemilu.org#5567,"KUTA JEUMPA, BEUTONG, NAGAN RAYA, ACEH",1,15,198,213
5158,https://kawalpemilu.org#53580,"PUHU, PAYANGAN, GIANYAR, BALI",9,229,8,237
12014,https://kawalpemilu.org#54016,"DANGIN PURI KAJA, DENPASAR UTARA, KOTA DENPASAR, BALI",23,198,7,205
7467,https://kawalpemilu.org#53772,"ABABI, ABANG, KARANGASEM, BALI",3,226,2,228
1020,https://kawalpemilu.org#53321,"GADUNGSARI, SELEMADEG TIMUR, TABANAN, BALI",3,143,12,155
1508,https://kawalpemilu.org#53365,"BERABAN, KEDIRI, TABANAN, BALI",9,217,12,229
11309,https://kawalpemilu.org#53997,"PADANGSAMBIAN KELOD, DENPASAR BARAT, KOTA DENPASAR, BALI",43,190,10,200
2944,https://kawalpemilu.org#53470,"SIBANGGEDE, ABIANSEMAL, BADUNG, BALI",20,265,11,276
4027,https://kawalpemilu.org#53519,"SINGAPADU TENGAH, SUKAWATI, GIANYAR, BALI",7,265,0,265
4128,https://kawalpemilu.org#53525,"KERAMAS, BLAHBATUH, GIANYAR, BALI",14,208,6,214
5787,https://kawalpemilu.org#53643,"KUSAMBA, DAWAN, KLUNGKUNG, BALI",1,238,3,241
9702,https://kawalpemilu.org#53919,"KAMPUNG BARU, BULELENG, BULELENG, BALI",17,171,7,178
7197,https://kawalpemilu.org#53761,"PADANG KERTA, KARANGASEM, KARANGASEM, BALI",16,140,3,143
2584,https://kawalpemilu.org#53449,"ABIANBASE, MENGWI, BADUNG, BALI",4,244,9,253
5872,https://kawalpemilu.org#53653,"DEMULIH, SUSUT, BANGLI, BALI",1,194,16,210
8905,https://kawalpemilu.org#53860,"TINGGARSARI, BUSUNG BIU, BULELENG, BALI",2,203,10,213
1496,https://kawalpemilu.org#53364,"BELALANG, KEDIRI, TABANAN, BALI",5,239,31,270
9544,https://kawalpemilu.org#53910,"BANYUNING, BULELENG, BULELENG, BALI",20,188,4,192
4147,https://kawalpemilu.org#53526,"BELEGA, BLAHBATUH, GIANYAR, BALI",8,222,9,231
9001,https://kawalpemilu.org#53870,"TIRTASARI, BANJAR, BULELENG, BALI",2,203,18,121
2674,https://kawalpemilu.org#53453,"BUDUK, MENGWI, BADUNG, BALI",10,241,11,252
5272,https://kawalpemilu.org#53590,"KLUMPU, NUSA PENIDA, KLUNGKUNG, BALI",13,243,18,261
4223,https://kawalpemilu.org#53529,"BEDULU, BLAHBATUH, GIANYAR, BALI",16,188,19,207
2742,https://kawalpemilu.org#53456,"SEMBUNG, MENGWI, BADUNG, BALI",14,200,7,207
10890,https://kawalpemilu.org#53981,"PEMOGAN, DENPASAR SELATAN, KOTA DENPASAR, BALI",62,201,16,217
3817,https://kawalpemilu.org#53510,"BATUBULAN, SUKAWATI, GIANYAR, BALI",60,238,19,257
9208,https://kawalpemilu.org#53885,"KALIASEM, BANJAR, BULELENG, BALI",1,133,102,235
11016,https://kawalpemilu.org#53987,"DANGIN PURI, DENPASAR TIMUR, KOTA DENPASAR, BALI",10,193,34,227
5273,https://kawalpemilu.org#53590,"KLUMPU, NUSA PENIDA, KLUNGKUNG, BALI",14,253,4,257
8479,https://kawalpemilu.org#53821,"PENYABANGAN, GEROKGAK, BULELENG, BALI",14,68,144,212
2497,https://kawalpemilu.org#53443,"KEDONGANAN, KUTA, BADUNG, BALI",11,239,11,250
1561,https://kawalpemilu.org#53369,"NYAMBU, KEDIRI, TABANAN, BALI",2,274,0,274
17654,https://kawalpemilu.org#52734,"NAGARA, KIBIN, SERANG, BANTEN",11,86,126,212
11997,https://kawalpemilu.org#52462,"SEPATAN, SEPATAN, TANGERANG, BANTEN",31,55,116,171
25474,https://kawalpemilu.org#53074,"BANJAR NEGARA, CIWANDAN, KOTA CILEGON, BANTEN",9,42,157,199
18522,https://kawalpemilu.org#52806,"PANYABRANGAN, CIKEUSAL, SERANG, BANTEN",9,77,164,241
5367,https://kawalpemilu.org#52059,"JAYAMANIK, CIMARGA, LEBAK, BANTEN",7,21,142,163
26734,https://kawalpemilu.org#53117,"KALIGANDU, SERANG, KOTA SERANG, BANTEN",6,79,144,223
21708,https://kawalpemilu.org#52970,"CIPONDOH INDAH, CIPONDOH, KOTA TANGERANG, BANTEN",27,36,87,123
13999,https://kawalpemilu.org#52523,"KADU SIRUNG, PAGEDANGAN, TANGERANG, BANTEN",17,80,124,204
4845,https://kawalpemilu.org#52009,"CIGINGGANG, GUNUNGKENCANA, LEBAK, BANTEN",9,63,49,112
10944,https://kawalpemilu.org#52419,"GELAM JAYA, PASAR KEMIS, TANGERANG, BANTEN",80,237,22,259
23828,https://kawalpemilu.org#53022,"MEKARSARI, NEGLASARI, KOTA TANGERANG, BANTEN",31,212,13,225
26075,https://kawalpemilu.org#53100,"DRINGO, CITANGKIL, KOTA CILEGON, BANTEN",15,61,194,255
24389,https://kawalpemilu.org#53038,"KARANG TENGAH, KARANG TENGAH, KOTA TANGERANG, BANTEN",32,127,100,227
17467,https://kawalpemilu.org#52724,"JULANG, CIKANDE, SERANG, BANTEN",17,66,170,236
3591,https://kawalpemilu.org#84981,"SUKARATU, MAJASARI, PANDEGLANG, BANTEN",23,40,150,190
9754,https://kawalpemilu.org#52390,"BUARAN JATI, SUKADIRI, TANGERANG, BANTEN",3,56,198,254
13137,https://kawalpemilu.org#52492,"BOJONG, CIKUPA, TANGERANG, BANTEN",1,55,172,227
10724,https://kawalpemilu.org#52416,"PASAR KEMIS, PASAR KEMIS, TANGERANG, BANTEN",42,51,88,139
8693,https://kawalpemilu.org#52323,"SUKAMANAH, JAMBE, TANGERANG, BANTEN",6,94,130,224
8356,https://kawalpemilu.org#52309,"KADU AGUNG, TIGARAKSA, TANGERANG, BANTEN",15,66,140,206
21243,https://kawalpemilu.org#52959,"BATUSARI, BATUCEPER, KOTA TANGERANG, BANTEN",28,27,166,193
628,https://kawalpemilu.org#51639,"GOMBONG, PANIMBANG, PANDEGLANG, BANTEN",1,126,74,200
14302,https://kawalpemilu.org#52536,"KALIASIN, SUKAMULYA, TANGERANG, BANTEN",1,82,120,202
6400,https://kawalpemilu.org#52139,"SUKASENANG, CIJAKU, LEBAK, BANTEN",6,91,84,175
165,https://kawalpemilu.org#51597,"MANGKUALAM, CIMANGGU, PANDEGLANG, BANTEN",8,99,99,198
13453,https://kawalpemilu.org#52501,"PANONGAN, PANONGAN, TANGERANG, BANTEN",19,76,162,238
23645,https://kawalpemilu.org#53018,"NEGLASARI, NEGLASARI, KOTA TANGERANG, BANTEN",35,175,34,209
17702,https://kawalpemilu.org#52737,"SUKAMAJU, KIBIN, SERANG, BANTEN",5,72,161,233
11818,https://kawalpemilu.org#52454,"KOHOD, PAKUHAJI, TANGERANG, BANTEN",6,112,92,204
783,https://kawalpemilu.org#51651,"CIPINANG, ANGSANA, PANDEGLANG, BANTEN",3,74,160,234
200,https://kawalpemilu.org#51602,"MENDUNG, CIBALIUNG, PANDEGLANG, BANTEN",6,112,110,222
27378,https://kawalpemilu.org#53145,"LEBAKWANGI, WALANTAKA, KOTA SERANG, BANTEN",5,75,167,242
4561,https://kawalpemilu.org#51979,"MEKARWANGI, MUNCANG, LEBAK, BANTEN",12,33,130,163
11488,https://kawalpemilu.org#52439,"KOSAMBI TIMUR, KOSAMBI, TANGERANG, BANTEN",1,108,127,235
19786,https://kawalpemilu.org#52897,"UMBUL TANJUNG, CINANGKA, SERANG, BANTEN",3,56,153,209
14608,https://kawalpemilu.org#52544,"BENCONGAN, KELAPA DUA, TANGERANG, BANTEN",89,76,101,177
25949,https://kawalpemilu.org#53094,"KEBON DALEM, PURWAKARTA, KOTA CILEGON, BANTEN",5,85,166,251
18975,https://kawalpemilu.org#52838,"CEMPLANG, JAWILAN, SERANG, BANTEN",5,40,172,212
25162,https://kawalpemilu.org#53059,"KALITIMBANG, CIBEBER, KOTA CILEGON, BANTEN",20,49,113,162
12656,https://kawalpemilu.org#52477,"CUKANGGALIH, CURUG, TANGERANG, BANTEN",9,47,134,181
4203,https://kawalpemilu.org#51943,"SAWARNA, BAYAH, LEBAK, BANTEN",12,89,102,191
5242,https://kawalpemilu.org#52049,"KUJANGSARI, CILELES, LEBAK, BANTEN",9,70,113,183
8424,https://kawalpemilu.org#52312,"PASIR NANGKA, TIGARAKSA, TANGERANG, BANTEN",30,99,108,207
1406,https://kawalpemilu.org#51709,"CIGANDENG, MENES, PANDEGLANG, BANTEN",3,52,152,204
11407,https://kawalpemilu.org#52437,"SALEMBARAN JAYA, KOSAMBI, TANGERANG, BANTEN",29,118,82,200
358,https://kawalpemilu.org#51617,"NANGGALA, CIKEUSIK, PANDEGLANG, BANTEN",13,88,95,183
3012,https://kawalpemilu.org#51866,"MANGLID, CIBITUNG, PANDEGLANG, BANTEN",6,58,116,174
13947,https://kawalpemilu.org#52521,"JATAKE, PAGEDANGAN, TANGERANG, BANTEN",7,32,198,230
13957,https://kawalpemilu.org#52521,"JATAKE, PAGEDANGAN, TANGERANG, BANTEN",17,70,124,194
30388,https://kawalpemilu.org#53221,"PISANGAN, CIPUTAT TIMUR, KOTA TANGERANG SELATAN, BANTEN",34,109,122,231
8238,https://kawalpemilu.org#52303,"JAYANTI, JAYANTI, TANGERANG, BANTEN",23,78,187,265
8027,https://kawalpemilu.org#52295,"SUKAMURNI, BALARAJA, TANGERANG, BANTEN",11,32,159,191
3784,https://kawalpemilu.org#89650,"CIMANIS, SOBANG, PANDEGLANG, BANTEN",6,73,10,83
17784,https://kawalpemilu.org#52743,"MANDAYA, CARENANG, SERANG, BANTEN",6,64,171,235
16923,https://kawalpemilu.org#52675,"KRAMATJATI, KRAGILAN, SERANG, BANTEN",9,56,139,195
16599,https://kawalpemilu.org#52655,"CIGELAM, CIRUAS, SERANG, BANTEN",11,66,86,152
24407,https://kawalpemilu.org#53038,"KARANG TENGAH, KARANG TENGAH, KOTA TANGERANG, BANTEN",50,75,138,213
15427,https://kawalpemilu.org#52569,"CIKASUNGKA, SOLEAR, TANGERANG, BANTEN",7,78,119,197
29000,https://kawalpemilu.org#53201,"PONDOK KARYA, PONDOK AREN, KOTA TANGERANG SELATAN, BANTEN",18,95,103,198
24909,https://kawalpemilu.org#53051,"GAGA, LARANGAN, KOTA TANGERANG, BANTEN",24,111,122,233
13440,https://kawalpemilu.org#52501,"PANONGAN, PANONGAN, TANGERANG, BANTEN",6,67,131,198
14472,https://kawalpemilu.org#52543,"KELAPA DUA, KELAPA DUA, TANGERANG, BANTEN",37,78,128,206
21498,https://kawalpemilu.org#52966,"JURUMUDI BARU, BENDA, KOTA TANGERANG, BANTEN",27,34,129,163
30896,https://kawalpemilu.org#53227,"BENDA BARU, PAMULANG, KOTA TANGERANG SELATAN, BANTEN",46,143,79,222
7531,https://kawalpemilu.org#52253,"BANJARSARI, LEBAKGEDONG, LEBAK, BANTEN",1,4,95,99
13997,https://kawalpemilu.org#52523,"KADU SIRUNG, PAGEDANGAN, TANGERANG, BANTEN",15,54,146,200
21533,https://kawalpemilu.org#52966,"JURUMUDI BARU, BENDA, KOTA TANGERANG, BANTEN",68,108,5,113
26125,https://kawalpemilu.org#53102,"TAMAN BARU, CITANGKIL, KOTA CILEGON, BANTEN",21,87,117,204
25531,https://kawalpemilu.org#53076,"KUBANGSARI, CIWANDAN, KOTA CILEGON, BANTEN",17,65,203,268
7163,https://kawalpemilu.org#52215,"SUKATANI, WANASALAM, LEBAK, BANTEN",9,68,124,192
31378,https://kawalpemilu.org#53231,"KEDAUNG, PAMULANG, KOTA TANGERANG SELATAN, BANTEN",87,101,134,235
2870,https://kawalpemilu.org#51849,"JUHUT, KARANG TANJUNG, PANDEGLANG, BANTEN",22,69,160,229
9174,https://kawalpemilu.org#52352,"JENGKOL, KRESEK, TANGERANG, BANTEN",1,103,92,195
4628,https://kawalpemilu.org#51984,"CIBUNGUR, LEUWIDAMAR, LEBAK, BANTEN",14,71,124,195
31699,https://kawalpemilu.org#53238,"KADEMANGAN, SETU, KOTA TANGERANG SELATAN, BANTEN",16,95,158,253
3761,https://kawalpemilu.org#84986,"BOJEN, SOBANG, PANDEGLANG, BANTEN",7,145,45,190
16766,https://kawalpemilu.org#52665,"DUKUH, KRAGILAN, SERANG, BANTEN",10,57,138,295
30060,https://kawalpemilu.org#53216,"JOMBANG, CIPUTAT, KOTA TANGERANG SELATAN, BANTEN",63,109,139,247
9477,https://kawalpemilu.org#52372,"SASAK, MAUK, TANGERANG, BANTEN",2,71,157,228
22676,https://kawalpemilu.org#52993,"CIMONE JAYA, KARAWACI, KOTA TANGERANG, BANTEN",35,90,104,194
12818,https://kawalpemilu.org#52483,"TALAGASARI, CIKUPA, TANGERANG, BANTEN",11,58,117,175
17342,https://kawalpemilu.org#52718,"CIKANDE, CIKANDE, SERANG, BANTEN",38,100,105,205
6937,https://kawalpemilu.org#52197,"CIKAMUNDING, CILOGRANG, LEBAK, BANTEN",1,37,182,219
3954,https://kawalpemilu.org#21960,"TIRTA KENCANA, AIR RAMI, MUKOMUKO, BENGKULU",1,121,62,183
68,https://kawalpemilu.org#20826,"NAKAU, TALANG EMPAT, BENGKULU TENGAH, BENGKULU",1,125,61,186
4081,https://kawalpemilu.org#927477,"WONOSOBO, PENARIK, MUKOMUKO, BENGKULU",3,185,26,211
2327,https://kawalpemilu.org#21479,"AIR NAPAL, AIR NAPAL, BENGKULU UTARA, BENGKULU",1,97,117,214
2204,https://kawalpemilu.org#21427,"GEMBUNG RAYA, NAPAL PUTIH, BENGKULU UTARA, BENGKULU",3,187,46,233
3556,https://kawalpemilu.org#21848,"RIMBO KEDUI, SELUMA SELATAN, SELUMA, BENGKULU",5,125,131,256
4147,https://kawalpemilu.org#22020,"PONDOK TENGAH, V KOTO, MUKOMUKO, BENGKULU",1,75,110,185
455,https://kawalpemilu.org#20954,"GUNUNG AYU II, SEGINIM, BENGKULU SELATAN, BENGKULU",1,128,35,163
3934,https://kawalpemilu.org#21953,"RAMI MULIA, AIR RAMI, MUKOMUKO, BENGKULU",1,154,35,189
2196,https://kawalpemilu.org#21425,"TANJUNG KEMENYAN, NAPAL PUTIH, BENGKULU UTARA, BENGKULU",2,97,68,165
3018,https://kawalpemilu.org#21698,"PAGAR GUNUNG, PADANG GUCI HULU, KAUR, BENGKULU",3,90,61,151
4003,https://kawalpemilu.org#21980,"SURIAN BUNGKAL, SELAGAN RAYA, MUKOMUKO, BENGKULU",2,42,175,217
4090,https://kawalpemilu.org#927479,"MEKAR MULYA, PENARIK, MUKOMUKO, BENGKULU",6,149,70,219
3432,https://kawalpemilu.org#21812,"RENAH PANJANG, LUBUK SANDI, SELUMA, BENGKULU",2,98,153,251
2015,https://kawalpemilu.org#21355,"TAMBAK REJO, PADANG JAYA, BENGKULU UTARA, BENGKULU",3,158,77,235
5937,https://kawalpemilu.org#22324,"TANJUNG JAYA, SUNGAI SERUT, KOTA BENGKULU, BENGKULU",4,106,156,262
4644,https://kawalpemilu.org#42081,"KATONGAN, NGLIPAR, GUNUNGKIDUL, DAERAH ISTIMEWA YOGYAKARTA",13,84,35,119
10712,https://kawalpemilu.org#42346,"SOSROMENDURAN, GEDONGTENGEN, KOTA YOGYAKARTA, DAERAH ISTIMEWA YOGYAKARTA",17,143,14,157
9037,https://kawalpemilu.org#42278,"TAMANMARTANI, KALASAN, SLEMAN, DAERAH ISTIMEWA YOGYAKARTA",42,101,42,143
10861,https://kawalpemilu.org#42352,"PAKUNCEN, WIROBRAJAN, KOTA YOGYAKARTA, DAERAH ISTIMEWA YOGYAKARTA",33,129,53,182
1102,https://kawalpemilu.org#41957,"GERBOSARI, SAMIGALUH, KULON PROGO, DAERAH ISTIMEWA YOGYAKARTA",2,151,97,248
4329,https://kawalpemilu.org#42062,"PIYAMAN, WONOSARI, GUNUNGKIDUL, DAERAH ISTIMEWA YOGYAKARTA",12,106,155,261
7614,https://kawalpemilu.org#42244,"SENDANGAGUNG, MINGGIR, SLEMAN, DAERAH ISTIMEWA YOGYAKARTA",17,144,82,226
2997,https://kawalpemilu.org#42026,"BANGUNTAPAN, BANGUNTAPAN, BANTUL, DAERAH ISTIMEWA YOGYAKARTA",74,208,52,260
6226,https://kawalpemilu.org#42174,"KARANGSARI, SEMIN, GUNUNGKIDUL, DAERAH ISTIMEWA YOGYAKARTA",8,155,15,170
1754,https://kawalpemilu.org#41985,"SIDOMULYO, BAMBANGLIPURO, BANTUL, DAERAH ISTIMEWA YOGYAKARTA",44,159,78,237
7006,https://kawalpemilu.org#42223,"BALECATUR, GAMPING, SLEMAN, DAERAH ISTIMEWA YOGYAKARTA",42,196,59,255
10121,https://kawalpemilu.org#42316,"HARJOBINANGUN, PAKEM, SLEMAN, DAERAH ISTIMEWA YOGYAKARTA",6,116,137,253
8592,https://kawalpemilu.org#42266,"KALITIRTO, BERBAH, SLEMAN, DAERAH ISTIMEWA YOGYAKARTA",1,155,58,213
378,https://kawalpemilu.org#41907,"TIRTORAHAYU, GALUR, KULON PROGO, DAERAH ISTIMEWA YOGYAKARTA",10,92,150,242
9574,https://kawalpemilu.org#42294,"CATURHARJO, SLEMAN, SLEMAN, DAERAH ISTIMEWA YOGYAKARTA",17,122,72,194
4527,https://kawalpemilu.org#42073,"KARANGREJEK, WONOSARI, GUNUNGKIDUL, DAERAH ISTIMEWA YOGYAKARTA",15,168,67,235
9440,https://kawalpemilu.org#42290,"SUKOHARJO, NGAGLIK, SLEMAN, DAERAH ISTIMEWA YOGYAKARTA",7,100,37,137
1150,https://kawalpemilu.org#41961,"BANJARARUM, KALIBAWANG, KULON PROGO, DAERAH ISTIMEWA YOGYAKARTA",13,120,75,195
10666,https://kawalpemilu.org#42343,"TEGALPANGGUNG, DANUREJAN, KOTA YOGYAKARTA, DAERAH ISTIMEWA YOGYAKARTA",21,139,48,187
7566,https://kawalpemilu.org#42242,"SENDANGARUM, MINGGIR, SLEMAN, DAERAH ISTIMEWA YOGYAKARTA",7,138,76,214
7619,https://kawalpemilu.org#42244,"SENDANGAGUNG, MINGGIR, SLEMAN, DAERAH ISTIMEWA YOGYAKARTA",23,137,59,196
7205,https://kawalpemilu.org#42227,"TRIHANGGO, GAMPING, SLEMAN, DAERAH ISTIMEWA YOGYAKARTA",21,138,35,173
11069,https://kawalpemilu.org#42361,"PANEMBAHAN, KRATON, KOTA YOGYAKARTA, DAERAH ISTIMEWA YOGYAKARTA",18,130,65,195
11339,https://kawalpemilu.org#42374,"SEMAKI, UMBULHARJO, KOTA YOGYAKARTA, DAERAH ISTIMEWA YOGYAKARTA",13,161,53,214
3907,https://kawalpemilu.org#42050,"TIRTONIRMOLO, KASIHAN, BANTUL, DAERAH ISTIMEWA YOGYAKARTA",34,131,44,175
3880,https://kawalpemilu.org#42050,"TIRTONIRMOLO, KASIHAN, BANTUL, DAERAH ISTIMEWA YOGYAKARTA",7,97,135,232
9210,https://kawalpemilu.org#42284,"WEDOMARTANI, NGEMPLAK, SLEMAN, DAERAH ISTIMEWA YOGYAKARTA",45,166,62,228
173,https://kawalpemilu.org#41889,"WATES, WATES, KULON PROGO, DAERAH ISTIMEWA YOGYAKARTA",3,122,107,229
124,https://kawalpemilu.org#41886,"BENDUNGAN, WATES, KULON PROGO, DAERAH ISTIMEWA YOGYAKARTA",15,150,40,190
3325,https://kawalpemilu.org#25890,"KAPUK MUARA, PENJARINGAN, JAKARTA UTARA, DKI JAKARTA",34,219,9,228
16592,https://kawalpemilu.org#26025,"GROGOL UTARA, KEBAYORAN LAMA, JAKARTA SELATAN, DKI JAKARTA",98,117,143,260
24027,https://kawalpemilu.org#26111,"CAKUNG BARAT, CAKUNG, JAKARTA TIMUR, DKI JAKARTA",163,143,51,194
16466,https://kawalpemilu.org#26024,"CIPULIR, KEBAYORAN LAMA, JAKARTA SELATAN, DKI JAKARTA",71,80,122,202
23192,https://kawalpemilu.org#26107,"RAWA TERATE, CAKUNG, JAKARTA TIMUR, DKI JAKARTA",60,49,95,141
24486,https://kawalpemilu.org#26115,"KLENDER, DUREN SAWIT, JAKARTA TIMUR, DKI JAKARTA",125,78,195,273
4194,https://kawalpemilu.org#25897,"SUNGAI BAMBU, TANJUNG PRIOK, JAKARTA UTARA, DKI JAKARTA",3,110,112,222
9592,https://kawalpemilu.org#25943,"MAPHAR, TAMAN SARI, JAKARTA BARAT, DKI JAKARTA",52,74,111,185
7912,https://kawalpemilu.org#25928,"RAWA BUAYA, CENGKARENG, JAKARTA BARAT, DKI JAKARTA",33,141,100,241
9484,https://kawalpemilu.org#25942,"KRUKUT, TAMAN SARI, JAKARTA BARAT, DKI JAKARTA",4,101,87,188
5556,https://kawalpemilu.org#25907,"RAWA BADAK SELATAN, KOJA, JAKARTA UTARA, DKI JAKARTA",81,192,60,252
8213,https://kawalpemilu.org#25930,"KAPUK, CENGKARENG, JAKARTA BARAT, DKI JAKARTA",43,163,87,250
8721,https://kawalpemilu.org#25931,"CENGKARENG TIMUR, CENGKARENG, JAKARTA BARAT, DKI JAKARTA",158,168,56,224
13660,https://kawalpemilu.org#25985,"MERUYA SELATAN, KEMBANGAN, JAKARTA BARAT, DKI JAKARTA",61,91,150,241
14614,https://kawalpemilu.org#25997,"MANGGARAI, TEBET, JAKARTA SELATAN, DKI JAKARTA",5,142,100,242
16494,https://kawalpemilu.org#26024,"CIPULIR, KEBAYORAN LAMA, JAKARTA SELATAN, DKI JAKARTA",100,161,97,258
19530,https://kawalpemilu.org#26064,"ULUJAMI, PESANGGRAHAN, JAKARTA SELATAN, DKI JAKARTA",2,105,89,194
11366,https://kawalpemilu.org#25968,"KEDOYA SELATAN, KEBON JERUK, JAKARTA BARAT, DKI JAKARTA",12,96,150,246
25137,https://kawalpemilu.org#26122,"PINANGRANTI, MAKASAR, JAKARTA TIMUR, DKI JAKARTA",27,77,156,233
11362,https://kawalpemilu.org#25968,"KEDOYA SELATAN, KEBON JERUK, JAKARTA BARAT, DKI JAKARTA",8,121,109,230
12822,https://kawalpemilu.org#25977,"SLIPI, PALMERAH, JAKARTA BARAT, DKI JAKARTA",1,93,46,139
19764,https://kawalpemilu.org#26068,"UTAN KAYU UTARA, MATRAMAN, JAKARTA TIMUR, DKI JAKARTA",32,96,127,223
25586,https://kawalpemilu.org#26127,"CIRACAS, CIRACAS, JAKARTA TIMUR, DKI JAKARTA",105,105,131,236
7122,https://kawalpemilu.org#25922,"PEGANGSAAN DUA, KELAPA GADING, JAKARTA UTARA, DKI JAKARTA",3,80,124,204
2137,https://kawalpemilu.org#25872,"KEBON SIRIH, MENTENG, JAKARTA PUSAT, DKI JAKARTA",22,56,204,260
21870,https://kawalpemilu.org#26094,"BATU AMPAR, KRAMATJATI, JAKARTA TIMUR, DKI JAKARTA",38,69,111,180
7730,https://kawalpemilu.org#25927,"DURI KOSAMBI, CENGKARENG, JAKARTA BARAT, DKI JAKARTA",102,183,64,247
18425,https://kawalpemilu.org#26053,"JAGAKARSA, JAGAKARSA, JAKARTA SELATAN, DKI JAKARTA",185,97,136,233
3145,https://kawalpemilu.org#25888,"PENJARINGAN, PENJARINGAN, JAKARTA UTARA, DKI JAKARTA",186,139,35,174
16336,https://kawalpemilu.org#26023,"PONDOK PINANG, KEBAYORAN LAMA, JAKARTA SELATAN, DKI JAKARTA",103,67,144,211
4160,https://kawalpemilu.org#25896,"PAPANGGO, TANJUNG PRIOK, JAKARTA UTARA, DKI JAKARTA",97,112,90,202
5304,https://kawalpemilu.org#25905,"RAWA BADAK UTARA, KOJA, JAKARTA UTARA, DKI JAKARTA",38,78,128,206
17087,https://kawalpemilu.org#26030,"LEBAK BULUS, CILANDAK, JAKARTA SELATAN, DKI JAKARTA",85,130,42,172
8319,https://kawalpemilu.org#25930,"KAPUK, CENGKARENG, JAKARTA BARAT, DKI JAKARTA",152,182,43,225
8511,https://kawalpemilu.org#25930,"KAPUK, CENGKARENG, JAKARTA BARAT, DKI JAKARTA",346,170,76,246
5139,https://kawalpemilu.org#25904,"LAGOA, KOJA, JAKARTA UTARA, DKI JAKARTA",56,104,120,224
4401,https://kawalpemilu.org#25898,"KEBON BAWANG, TANJUNG PRIOK, JAKARTA UTARA, DKI JAKARTA",112,144,115,259
933,https://kawalpemilu.org#25851,"SERDANG, KEMAYORAN, JAKARTA PUSAT, DKI JAKARTA",13,110,143,253
1856,https://kawalpemilu.org#25866,"RAWASARI, CEMPAKA PUTIH, JAKARTA PUSAT, DKI JAKARTA",24,95,135,230
14099,https://kawalpemilu.org#25991,"TEBET TIMUR, TEBET, JAKARTA SELATAN, DKI JAKARTA",21,89,108,197
14111,https://kawalpemilu.org#25991,"TEBET TIMUR, TEBET, JAKARTA SELATAN, DKI JAKARTA",33,110,129,239
13397,https://kawalpemilu.org#25983,"KEMBANGAN UTARA, KEMBANGAN, JAKARTA BARAT, DKI JAKARTA",137,49,137,186
21934,https://kawalpemilu.org#26094,"BATU AMPAR, KRAMATJATI, JAKARTA TIMUR, DKI JAKARTA",108,86,80,166
16367,https://kawalpemilu.org#26023,"PONDOK PINANG, KEBAYORAN LAMA, JAKARTA SELATAN, DKI JAKARTA",135,101,129,230
13630,https://kawalpemilu.org#25985,"MERUYA SELATAN, KEMBANGAN, JAKARTA BARAT, DKI JAKARTA",31,110,114,224
8140,https://kawalpemilu.org#25929,"KEDAUNG KALI ANGKE, CENGKARENG, JAKARTA BARAT, DKI JAKARTA",69,195,14,209
8824,https://kawalpemilu.org#25933,"GROGOL, GROGOL PETAMBURAN, JAKARTA BARAT, DKI JAKARTA",26,182,63,245
15005,https://kawalpemilu.org#26008,"MAMPANG PRAPATAN, MAMPANG PRAPATAN, JAKARTA SELATAN, DKI JAKARTA",5,107,101,208
15612,https://kawalpemilu.org#26016,"CILANDAK TIMUR, PASAR MINGGU, JAKARTA SELATAN, DKI JAKARTA",1,109,94,203
21131,https://kawalpemilu.org#26086,"CIPINANG CEMPEDAK, JATINEGARA, JAKARTA TIMUR, DKI JAKARTA",47,64,183,247
3781,https://kawalpemilu.org#25892,"PLUIT, PENJARINGAN, JAKARTA UTARA, DKI JAKARTA",150,110,96,206
6196,https://kawalpemilu.org#25913,"SEMPER TIMUR, CILINCING, JAKARTA UTARA, DKI JAKARTA",54,97,112,209
3382,https://kawalpemilu.org#25890,"KAPUK MUARA, PENJARINGAN, JAKARTA UTARA, DKI JAKARTA",92,173,8,181
23408,https://kawalpemilu.org#26108,"PENGGILINGAN, CAKUNG, JAKARTA TIMUR, DKI JAKARTA",227,72,134,206
4292,https://kawalpemilu.org#25898,"KEBON BAWANG, TANJUNG PRIOK, JAKARTA UTARA, DKI JAKARTA",3,13,199,212
25782,https://kawalpemilu.org#26128,"CIBUBUR, CIRACAS, JAKARTA TIMUR, DKI JAKARTA",128,90,125,215
23028,https://kawalpemilu.org#26106,"JATINEGARA, CAKUNG, JAKARTA TIMUR, DKI JAKARTA",141,102,64,166
13173,https://kawalpemilu.org#25980,"KEMANGGISAN, PALMERAH, JAKARTA BARAT, DKI JAKARTA",95,87,125,212
4970,https://kawalpemilu.org#25903,"TUGU UTARA, KOJA, JAKARTA UTARA, DKI JAKARTA",75,94,153,247
1294,https://kawalpemilu.org#25855,"UTAN PANJANG, KEMAYORAN, JAKARTA PUSAT, DKI JAKARTA",77,84,121,205
19886,https://kawalpemilu.org#26069,"KAYU MANIS, MATRAMAN, JAKARTA TIMUR, DKI JAKARTA",68,96,146,242
6839,https://kawalpemilu.org#25918,"PADEMANGAN BARAT, PADEMANGAN, JAKARTA UTARA, DKI JAKARTA",140,107,73,180
21611,https://kawalpemilu.org#26091,"KRAMATJATI, KRAMATJATI, JAKARTA TIMUR, DKI JAKARTA",45,72,162,234
16109,https://kawalpemilu.org#26020,"KEBAGUSAN, PASAR MINGGU, JAKARTA SELATAN, DKI JAKARTA",66,126,85,211
19878,https://kawalpemilu.org#26069,"KAYU MANIS, MATRAMAN, JAKARTA TIMUR, DKI JAKARTA",60,115,117,232
9061,https://kawalpemilu.org#25936,"JELAMBAR, GROGOL PETAMBURAN, JAKARTA BARAT, DKI JAKARTA",52,207,29,236
22670,https://kawalpemilu.org#26103,"GEDONG, PASAR REBO, JAKARTA TIMUR, DKI JAKARTA",55,115,125,240
22935,https://kawalpemilu.org#26106,"JATINEGARA, CAKUNG, JAKARTA TIMUR, DKI JAKARTA",41,71,128,199
10230,https://kawalpemilu.org#25956,"ANGKE, TAMBORA, JAKARTA BARAT, DKI JAKARTA",18,151,28,179
4874,https://kawalpemilu.org#25902,"KOJA, KOJA, JAKARTA UTARA, DKI JAKARTA",68,78,124,202
18882,https://kawalpemilu.org#26057,"TANJUNG BARAT, JAGAKARSA, JAKARTA SELATAN, DKI JAKARTA",68,51,89,140
4450,https://kawalpemilu.org#25899,"SUNTER AGUNG, TANJUNG PRIOK, JAKARTA UTARA, DKI JAKARTA",8,131,81,227
1329,https://kawalpemilu.org#74984,"POLOHUNGO, DULUPI, BOALEMO, GORONTALO",5,179,28,207
2692,https://kawalpemilu.org#75327,"TANJUNG KARANG, TOMOLITO, GORONTALO UTARA, GORONTALO",1,75,133,208
2390,https://kawalpemilu.org#75298,"BUTUNGALE, POPAYATO BARAT, PAHUWATO, GORONTALO",3,125,44,169
69,https://kawalpemilu.org#74724,"HUTUO, LIMBOTO, GORONTALO, GORONTALO",2,83,133,216
1528,https://kawalpemilu.org#75030,"OLIBU, PAGUYAMAN PANTAI, BOALEMO, GORONTALO",1,169,45,216
2179,https://kawalpemilu.org#75233,"SOGINTI, PAGUAT, PAHUWATO, GORONTALO",4,155,99,254
582,https://kawalpemilu.org#74827,"HUNTULOHULAWA, BONGOMEME, GORONTALO, GORONTALO",3,113,88,201
628,https://kawalpemilu.org#74842,"TAMAILA, TOLANGOHULA, GORONTALO, GORONTALO",4,113,108,221
2815,https://kawalpemilu.org#75368,"LEKOBALO, KOTA BARAT, KOTA GORONTALO, GORONTALO",8,73,123,196
7792,https://kawalpemilu.org#17175,"PASIR PUTIH, RIMBO TENGAH, BUNGO, JAMBI",21,72,124,196
7908,https://kawalpemilu.org#17194,"SEBERANG JAYA, BATHIN II PELAYANG, BUNGO, JAMBI",4,68,169,237
2521,https://kawalpemilu.org#16479,"KARANG MENDAPO, PAUH, SAROLANGUN, JAMBI",6,103,139,242
7408,https://kawalpemilu.org#17124,"SEKAR MENGKUANG, LIMBUR LUBUK MENGKUANG, BUNGO, JAMBI",1,53,177,230
1855,https://kawalpemilu.org#16326,"PULAU TUJUH, PAMENANG BARAT, MERANGIN, JAMBI",1,123,64,187
6222,https://kawalpemilu.org#16941,"TELUKKETAPANG, SENYERANG, TANJUNG JABUNG BARAT, JAMBI",5,35,93,128
198,https://kawalpemilu.org#15900,"AUR DURI, PONDOK TINGGI, KOTA SUNGAI PENUH, JAMBI",7,26,207,233
1920,https://kawalpemilu.org#16341,"MUARA PANCO BARAT, RENAH PEMBARAP, MERANGIN, JAMBI",2,9,182,191
10244,https://kawalpemilu.org#17403,"HANDIL JAYA, JELUTUNG, KOTA JAMBI, JAMBI",25,81,117,198
10261,https://kawalpemilu.org#17388,"RAWA SARI, ALAM BARAJO, KOTA JAMBI, JAMBI",14,82,132,214
5139,https://kawalpemilu.org#16842,"TANJUNG LEBAR, BAHAR SELATAN, MUARO JAMBI, JAMBI",2,105,35,140
9075,https://kawalpemilu.org#17329,"BANGUN SERANTEN, MUARA TABIR, TEBO, JAMBI",12,130,51,181
227,https://kawalpemilu.org#15913,"KAMPUNG TENGAH, KOTO BARU, KOTA SUNGAI PENUH, JAMBI",3,30,179,209
878,https://kawalpemilu.org#16175,"KOTO TUO, DEPATI TUJUH, KERINCI, JAMBI",1,12,201,213
8077,https://kawalpemilu.org#17220,"MANGUN JAYO, TEBO TENGAH, TEBO, JAMBI",3,24,171,195
4579,https://kawalpemilu.org#16775,"BARU, MESTONG, MUARO JAMBI, JAMBI",6,109,63,172
2941,https://kawalpemilu.org#16558,"SUNGAI BENTENG, SINGKUT, SAROLANGUN, JAMBI",9,123,89,212
1091,https://kawalpemilu.org#16186,"TANJUNG KASRI, JANGKAT, MERANGIN, JAMBI",1,177,53,230
9965,https://kawalpemilu.org#17390,"KENALI ASAM BAWAH, KOTA BARU, KOTA JAMBI, JAMBI",17,84,121,205
8779,https://kawalpemilu.org#17293,"SUKA MAJU, RIMBO ULU, TEBO, JAMBI",3,111,21,132
422,https://kawalpemilu.org#84542,"ANGKASA PURA, SITINJAU LAUT, KERINCI, JAMBI",3,33,132,165
5458,https://kawalpemilu.org#16875,"TUNGKAL II, TUNGKAL ILIR, TANJUNG JABUNG BARAT, JAMBI",35,54,131,185
10889,https://kawalpemilu.org#17354,"EKA JAYA, PAAL MERAH, KOTA JAMBI, JAMBI",38,50,93,143
9545,https://kawalpemilu.org#17360,"BUDIMAN, JAMBI TIMUR, KOTA JAMBI, JAMBI",18,91,28,119
338,https://kawalpemilu.org#15986,"TANJUNGTANAH, DANAU KERINCI, KERINCI, JAMBI",1,20,110,130
527,https://kawalpemilu.org#16052,"TAMIAI, BATANG MERANGIN, KERINCI, JAMBI",4,42,124,166
8880,https://kawalpemilu.org#17305,"MUARA KILIS, TENGAH ILIR, TEBO, JAMBI",4,86,82,168
9522,https://kawalpemilu.org#17359,"TALANG BANJAR, JAMBI TIMUR, KOTA JAMBI, JAMBI",40,144,100,244
101058,https://kawalpemilu.org#32163,"CISARUA, CIKOLE, KOTA SUKABUMI, JAWA BARAT",35,68,123,191
31838,https://kawalpemilu.org#27607,"MANGGAHANG, BALEENDAH, BANDUNG, JAWA BARAT",1,76,162,238
48489,https://kawalpemilu.org#28581,"SINDANGRASA, CIAMIS, CIAMIS, JAWA BARAT",22,61,146,207
15037,https://kawalpemilu.org#26804,"TANJUNG, JAMPANG KULON, SUKABUMI, JAWA BARAT",10,43,135,178
101345,https://kawalpemilu.org#32174,"DAYEUHLUHUR, WARUDOYONG, KOTA SUKABUMI, JAWA BARAT",20,61,123,184
89433,https://kawalpemilu.org#31755,"GANDASARI, CIKARANG BARAT, BEKASI, JAWA BARAT",3,62,129,191
76810,https://kawalpemilu.org#30971,"JAYAMUKTI, BLANAKAN, SUBANG, JAWA BARAT",15,171,48,219
57570,https://kawalpemilu.org#29496,"ENDER, PANGENAN, CIREBON, JAWA BARAT",11,121,23,144
17245,https://kawalpemilu.org#26931,"TEGALPANJANG, CIREUNGHAS, SUKABUMI, JAWA BARAT",9,69,117,186
72359,https://kawalpemilu.org#30705,"LAMARAN TARUNG, CANTIGI, INDRAMAYU, JAWA BARAT",14,151,33,184
44115,https://kawalpemilu.org#28256,"PARUNG, CIBALONG, TASIKMALAYA, JAWA BARAT",4,90,143,233
94589,https://kawalpemilu.org#31963,"CIMANGGU, NGAMPRAH, BANDUNG BARAT, JAWA BARAT",11,127,94,221
22132,https://kawalpemilu.org#27204,"CIGUHA, SUKANAGARA, CIANJUR, JAWA BARAT",1,50,60,110
89655,https://kawalpemilu.org#31762,"CIKARANGKOTA, CIKARANG UTARA, BEKASI, JAWA BARAT",8,95,62,157
66103,https://kawalpemilu.org#30214,"SARIMEKAR, JATINUNGGAL, SUMEDANG, JAWA BARAT",6,71,162,233
121005,https://kawalpemilu.org#32577,"NAGARASARI, CIPEDES, KOTA TASIKMALAYA, JAWA BARAT",34,16,184,200
67789,https://kawalpemilu.org#30365,"CIKERUH, JATINANGOR, SUMEDANG, JAWA BARAT",17,28,92,120
102895,https://kawalpemilu.org#32216,"JAMIKA, BOJONGLOA KALER, KOTA BANDUNG, JAWA BARAT",18,134,88,222
66010,https://kawalpemilu.org#30204,"WADO, WADO, SUMEDANG, JAWA BARAT",11,117,112,229
34644,https://kawalpemilu.org#27697,"PANANJUNG, CANGKUANG, BANDUNG, JAWA BARAT",19,62,96,158
35887,https://kawalpemilu.org#27744,"SINDANGLAYA, KARANGPAWITAN, GARUT, JAWA BARAT",9,20,155,175
75805,https://kawalpemilu.org#30919,"GUNUNGSEMBUNG, PAGADEN, SUBANG, JAWA BARAT",14,155,91,246
31603,https://kawalpemilu.org#27604,"BALEENDAH, BALEENDAH, BANDUNG, JAWA BARAT",119,55,130,185
89535,https://kawalpemilu.org#31758,"KALIJAYA, CIKARANG BARAT, BEKASI, JAWA BARAT",19,57,146,203
68318,https://kawalpemilu.org#30397,"GUNASARI, SUMEDANG SELATAN, SUMEDANG, JAWA BARAT",2,90,128,218
21009,https://kawalpemilu.org#27142,"BABAKANSARI, SUKALUYU, CIANJUR, JAWA BARAT",5,32,141,173
26130,https://kawalpemilu.org#27435,"BUAHBATU, BOJONGSOANG, BANDUNG, JAWA BARAT",10,54,86,140
108079,https://kawalpemilu.org#89463,"PASIR BIRU, CIBIRU, KOTA BANDUNG, JAWA BARAT",24,50,126,176
33480,https://kawalpemilu.org#27654,"SUDI, IBUN, BANDUNG, JAWA BARAT",6,97,37,134
2804,https://kawalpemilu.org#26222,"PASIRANGIN, CILEUNGSI, BOGOR, JAWA BARAT",64,122,140,262
110476,https://kawalpemilu.org#32410,"BINTARA, BEKASI BARAT, KOTA BEKASI, JAWA BARAT",19,107,112,219
88977,https://kawalpemilu.org#31743,"WANAJAYA, CIBITUNG, BEKASI, JAWA BARAT",38,70,101,171
32665,https://kawalpemilu.org#27623,"SUKAMUKTI, MAJALAYA, BANDUNG, JAWA BARAT",4,108,110,218
86757,https://kawalpemilu.org#31689,"PUSAKA RAKYAT, TARUMAJAYA, BEKASI, JAWA BARAT",2,44,156,200
23554,https://kawalpemilu.org#27310,"CIDAMAR, CIDAUN, CIANJUR, JAWA BARAT",7,69,147,216
1171,https://kawalpemilu.org#26160,"GUNUNG PUTRI, GUNUNG PUTRI, BOGOR, JAWA BARAT",54,40,86,126
49541,https://kawalpemilu.org#28654,"KERTAMANDALA, PANJALU, CIAMIS, JAWA BARAT",10,17,153,170
40390,https://kawalpemilu.org#27998,"PADASUKA, CIKAJANG, GARUT, JAWA BARAT",9,54,137,191
63674,https://kawalpemilu.org#29978,"PATUANAN, LEUWIMUNDING, MAJALENGKA, JAWA BARAT",3,116,85,201
100311,https://kawalpemilu.org#32143,"KEDUNGBADAK, TANAH SAREAL, KOTA BOGOR, JAWA BARAT",71,27,110,137
97072,https://kawalpemilu.org#32054,"SUKARESMI, RONGGA, BANDUNG BARAT, JAWA BARAT",7,53,90,143
62301,https://kawalpemilu.org#29845,"CIGALEUH, LEMAHSUGIH, MAJALENGKA, JAWA BARAT",2,45,84,129
74831,https://kawalpemilu.org#30873,"KARANGANYAR, SUBANG, SUBANG, JAWA BARAT",19,81,150,231
56444,https://kawalpemilu.org#29406,"KALIBUNTU, PABEDILAN, CIREBON, JAWA BARAT",5,133,60,193
19050,https://kawalpemilu.org#27044,"CIWALEN, WARUNGKONDANG, CIANJUR, JAWA BARAT",14,61,86,147
28786,https://kawalpemilu.org#27505,"BAROS, ARJASARI, BANDUNG, JAWA BARAT",6,43,79,122
92273,https://kawalpemilu.org#31876,"JAYAMULYA, SERANG BARU, BEKASI, JAWA BARAT",21,49,169,218
27366,https://kawalpemilu.org#27459,"BANYUSARI, KATAPANG, BANDUNG, JAWA BARAT",6,109,108,217
93859,https://kawalpemilu.org#31936,"GANJARSARI, CIKALONGWETAN, BANDUNG BARAT, JAWA BARAT",13,18,105,123
99669,https://kawalpemilu.org#32132,"BANTARJATI, BOGOR UTARA, KOTA BOGOR, JAWA BARAT",78,38,135,173
104814,https://kawalpemilu.org#32266,"KACAPIRING, BATUNUNGGAL, KOTA BANDUNG, JAWA BARAT",19,107,131,238
33381,https://kawalpemilu.org#27650,"PANGGUH, IBUN, BANDUNG, JAWA BARAT",1,166,82,248
93424,https://kawalpemilu.org#31919,"CIWARUGA, PARONGPONG, BANDUNG BARAT, JAWA BARAT",45,78,86,164
46390,https://kawalpemilu.org#28435,"MARGAJAYA, MANGUNREJA, TASIKMALAYA, JAWA BARAT",12,107,106,213
74104,https://kawalpemilu.org#30820,"JAYALAKSANA, KEDOKAN BUNDER, INDRAMAYU, JAWA BARAT",12,120,51,171
102166,https://kawalpemilu.org#32202,"SADANGSERANG, COBLONG, KOTA BANDUNG, JAWA BARAT",57,84,127,211
95955,https://kawalpemilu.org#32004,"GIRIASIH, BATUJAJAR, BANDUNG BARAT, JAWA BARAT",24,35,132,167
51906,https://kawalpemilu.org#28921,"SUKAMAJU, BAREGBEG, CIAMIS, JAWA BARAT",1,30,165,195
72229,https://kawalpemilu.org#30693,"TERUSAN, SINDANG, INDRAMAYU, JAWA BARAT",13,160,67,227
12370,https://kawalpemilu.org#26655,"CICADAS, CISOLOK, SUKABUMI, JAWA BARAT",6,79,121,200
84501,https://kawalpemilu.org#31535,"KALISARI, TELAGASARI, KARAWANG, JAWA BARAT",6,39,106,145
8181,https://kawalpemilu.org#26451,"BATULAYANG, CISARUA, BOGOR, JAWA BARAT",8,33,229,262
37028,https://kawalpemilu.org#27801,"SAMARANG, SAMARANG, GARUT, JAWA BARAT",4,108,42,150
46813,https://kawalpemilu.org#28466,"LINGGAWANGI, LEUWISARI, TASIKMALAYA, JAWA BARAT",5,30,200,230
45687,https://kawalpemilu.org#28377,"PAPAYAN, JATIWARAS, TASIKMALAYA, JAWA BARAT",7,55,178,233
2148,https://kawalpemilu.org#26191,"PASIR JAMBU, SUKARAJA, BOGOR, JAWA BARAT",29,77,149,226
101831,https://kawalpemilu.org#32192,"LIMUSNUNGGAL, CIBEUREUM, KOTA SUKABUMI, JAWA BARAT",37,34,112,146
52759,https://kawalpemilu.org#28997,"BAOK, CIWARU, KUNINGAN, JAWA BARAT",5,79,76,155
79891,https://kawalpemilu.org#31172,"CIBOGOHILIR, PLERED, PURWAKARTA, JAWA BARAT",12,31,154,185
98809,https://kawalpemilu.org#32111,"PANARAGAN, BOGOR TENGAH, KOTA BOGOR, JAWA BARAT",9,78,120,198
1413,https://kawalpemilu.org#26164,"CIKEAS UDIK, GUNUNG PUTRI, BOGOR, JAWA BARAT",21,31,112,143
47161,https://kawalpemilu.org#28491,"SUKAGALIH, SUKARATU, TASIKMALAYA, JAWA BARAT",10,99,130,229
45054,https://kawalpemilu.org#28331,"SUKARASA, SALAWU, TASIKMALAYA, JAWA BARAT",7,95,94,189
58111,https://kawalpemilu.org#29539,"KEPONGPONGAN, TALUN, CIREBON, JAWA BARAT",9,101,81,182
18989,https://kawalpemilu.org#27041,"CISARANDI, WARUNGKONDANG, CIANJUR, JAWA BARAT",5,81,76,157
62972,https://kawalpemilu.org#29913,"ARGALINGGA, ARGAPURA, MAJALENGKA, JAWA BARAT",2,17,206,223
17271,https://kawalpemilu.org#26933,"SUKALARANG, SUKALARANG, SUKABUMI, JAWA BARAT",19,32,170,202
52106,https://kawalpemilu.org#28936,"CIKUPA, LUMBUNG, CIAMIS, JAWA BARAT",2,64,101,165
90633,https://kawalpemilu.org#31800,"KARANGHARJA, PEBAYURAN, BEKASI, JAWA BARAT",23,60,37,97
115410,https://kawalpemilu.org#32466,"MUSTIKAJAYA, MUSTIKA JAYA, KOTA BEKASI, JAWA BARAT",133,91,142,233
45358,https://kawalpemilu.org#28354,"LEUWIBUDAH, SUKARAJA, TASIKMALAYA, JAWA BARAT",15,69,175,244
54673,https://kawalpemilu.org#29196,"DARMA, DARMA, KUNINGAN, JAWA BARAT",22,49,121,170
80493,https://kawalpemilu.org#31224,"SUKAMUKTI, MANIIS, PURWAKARTA, JAWA BARAT",1,51,142,193
114564,https://kawalpemilu.org#32453,"JATIRASA, JATIASIH, KOTA BEKASI, JAWA BARAT",66,136,59,195
84135,https://kawalpemilu.org#31507,"SUKATANI, CILAMAYA WETAN, KARAWANG, JAWA BARAT",7,155,84,239
119635,https://kawalpemilu.org#32552,"LEUWIGAJAH, CIMAHI SELATAN, KOTA CIMAHI, JAWA BARAT",2,61,117,178
113589,https://kawalpemilu.org#32444,"JATIWARINGIN, PONDOK GEDE, KOTA BEKASI, JAWA BARAT",15,87,145,232
110359,https://kawalpemilu.org#32408,"AREN JAYA, BEKASI TIMUR, KOTA BEKASI, JAWA BARAT",93,89,111,200
122157,https://kawalpemilu.org#32623,"MANGKUBUMI, MANGKUBUMI, KOTA TASIKMALAYA, JAWA BARAT",27,22,193,215
49753,https://kawalpemilu.org#28668,"PURWASARI, KAWALI, CIAMIS, JAWA BARAT",7,20,152,172
88066,https://kawalpemilu.org#31731,"JATIMULYA, TAMBUN SELATAN, BEKASI, JAWA BARAT",211,146,112,258
120975,https://kawalpemilu.org#32577,"NAGARASARI, CIPEDES, KOTA TASIKMALAYA, JAWA BARAT",4,63,93,156
30709,https://kawalpemilu.org#27573,"SUMBERSARI, CIPARAY, BANDUNG, JAWA BARAT",35,60,161,221
61099,https://kawalpemilu.org#29746,"KEJUDEN, DEPOK, CIREBON, JAWA BARAT",4,110,91,201
116547,https://kawalpemilu.org#32483,"TUGU, CIMANGGIS, KOTA DEPOK, JAWA BARAT",126,111,68,179
112415,https://kawalpemilu.org#32427,"KAYURINGIN JAYA, BEKASI SELATAN, KOTA BEKASI, JAWA BARAT",131,131,127,258
75139,https://kawalpemilu.org#30880,"KALIJATI BARAT, KALIJATI, SUBANG, JAWA BARAT",33,91,120,211
75506,https://kawalpemilu.org#30901,"PARAPATAN, PURWADADI, SUBANG, JAWA BARAT",22,106,56,162
51599,https://kawalpemilu.org#28900,"KEPEL, CISAGA, CIAMIS, JAWA BARAT",6,53,101,154
6667,https://kawalpemilu.org#26368,"MEKARSARI, RUMPIN, BOGOR, JAWA BARAT",11,59,130,189
50782,https://kawalpemilu.org#28743,"TAMBAKSARI, TAMBAKSARI, CIAMIS, JAWA BARAT",5,94,38,132
80982,https://kawalpemilu.org#31278,"PANGKALAN, BOJONG, PURWAKARTA, JAWA BARAT",7,73,139,212
92017,https://kawalpemilu.org#31866,"CICAU, CIKARANG PUSAT, BEKASI, JAWA BARAT",3,21,176,197
104090,https://kawalpemilu.org#32244,"CIHAPIT, BANDUNG WETAN, KOTA BANDUNG, JAWA BARAT",10,124,54,178
44644,https://kawalpemilu.org#28301,"CUKANGKAWUNG, SODONGHILIR, TASIKMALAYA, JAWA BARAT",20,9,140,149
81775,https://kawalpemilu.org#31351,"TUNGGAKJATI, KARAWANG BARAT, KARAWANG, JAWA BARAT",29,88,197,285
57716,https://kawalpemilu.org#29510,"WARUDUWUR, MUNDU, CIREBON, JAWA BARAT",4,170,35,205
99793,https://kawalpemilu.org#32134,"KEDUNGHALANG, BOGOR UTARA, KOTA BOGOR, JAWA BARAT",25,68,103,171
113010,https://kawalpemilu.org#32432,"BOJONG MENTENG, RAWA LUMBU, KOTA BEKASI, JAWA BARAT",94,127,61,188
26446,https://kawalpemilu.org#27442,"MARGAHAYU SELATAN, MARGAHAYU, BANDUNG, JAWA BARAT",68,50,131,181
64623,https://kawalpemilu.org#30058,"PASINDANGAN, JATITUJUH, MAJALENGKA, JAWA BARAT",2,97,115,212
36626,https://kawalpemilu.org#27777,"JAYARAGA, TAROGONG KIDUL, GARUT, JAWA BARAT",32,42,221,263
113043,https://kawalpemilu.org#32434,"MEDAN SATRIA, MEDAN SATRIA, KOTA BEKASI, JAWA BARAT",14,64,185,249
30005,https://kawalpemilu.org#27553,"RANCAEKEK WETAN, RANCAEKEK, BANDUNG, JAWA BARAT",39,47,129,176
16276,https://kawalpemilu.org#26878,"SELAJAMBE, CISAAT, SUKABUMI, JAWA BARAT",7,50,195,245
107987,https://kawalpemilu.org#32346,"CISURUPAN, CIBIRU, KOTA BANDUNG, JAWA BARAT",30,113,116,229
9766,https://kawalpemilu.org#26519,"SUKAMANTRI, TAMANSARI, BOGOR, JAWA BARAT",17,112,128,240
74082,https://kawalpemilu.org#30819,"KAPLONGAN, KEDOKAN BUNDER, INDRAMAYU, JAWA BARAT",4,113,91,204
43590,https://kawalpemilu.org#28216,"KALAPAGENEP, CIKALONG, TASIKMALAYA, JAWA BARAT",13,57,145,202
124477,https://kawalpemilu.org#28956,"KERTAJAYA, MANGUNJAYA, PANGANDARAN, JAWA BARAT",18,149,54,203
46256,https://kawalpemilu.org#28426,"CIKADONGDONG, SINGAPARNA, TASIKMALAYA, JAWA BARAT",8,28,181,209
47587,https://kawalpemilu.org#28526,"CONDONG, JAMANIS, TASIKMALAYA, JAWA BARAT",6,25,146,171
97255,https://kawalpemilu.org#32063,"PUNCAKSARI, SINDANGKERTA, BANDUNG BARAT, JAWA BARAT",11,87,76,163
35423,https://kawalpemilu.org#27724,"REGOL, GARUT KOTA, GARUT, JAWA BARAT",32,36,105,141
120034,https://kawalpemilu.org#32557,"KARANGMEKAR, CIMAHI TENGAH, KOTA CIMAHI, JAWA BARAT",41,78,84,162
95991,https://kawalpemilu.org#32009,"CIPATIK, CIHAMPELAS, BANDUNG BARAT, JAWA BARAT",28,51,111,162
124462,https://kawalpemilu.org#28956,"KERTAJAYA, MANGUNJAYA, PANGANDARAN, JAWA BARAT",3,131,46,177
494,https://kawalpemilu.org#26152,"SUKAHATI, CIBINONG, BOGOR, JAWA BARAT",41,64,76,140
69032,https://kawalpemilu.org#30453,"TRUNAMANGGALA, CIMALAKA, SUMEDANG, JAWA BARAT",19,100,64,164
27999,https://kawalpemilu.org#27477,"NEGLASARI, BANJARAN, BANDUNG, JAWA BARAT",29,37,103,140
57353,https://kawalpemilu.org#29484,"SIDAMULYA, ASTANAJAPURA, CIREBON, JAWA BARAT",9,144,30,174
58961,https://kawalpemilu.org#29603,"SETU WETAN, WERU, CIREBON, JAWA BARAT",8,100,73,173
73310,https://kawalpemilu.org#30773,"LEMPUYANG, ANJATAN, INDRAMAYU, JAWA BARAT",15,123,63,186
72243,https://kawalpemilu.org#30694,"DERMAYU, SINDANG, INDRAMAYU, JAWA BARAT",5,68,162,230
23315,https://kawalpemilu.org#27292,"SIRNAGALIH, SINDANGBARANG, CIANJUR, JAWA BARAT",3,32,113,145
74160,https://kawalpemilu.org#30825,"PASEKAN, PASEKAN, INDRAMAYU, JAWA BARAT",8,229,24,253
6231,https://kawalpemilu.org#26351,"GUNUNG PICUNG, PAMIJAHAN, BOGOR, JAWA BARAT",30,87,132,219
101432,https://kawalpemilu.org#32176,"BENTENG, WARUDOYONG, KOTA SUKABUMI, JAWA BARAT",18,65,128,193
63775,https://kawalpemilu.org#29985,"LEUWIMUNDING, LEUWIMUNDING, MAJALENGKA, JAWA BARAT",16,131,106,237
48803,https://kawalpemilu.org#28598,"HANDAPHERANG, CIJEUNGJING, CIAMIS, JAWA BARAT",12,42,125,167
76376,https://kawalpemilu.org#30947,"MUNDUSARI, PUSAKANAGARA, SUBANG, JAWA BARAT",7,136,57,193
12266,https://kawalpemilu.org#26648,"CIKAHURIPAN, CISOLOK, SUKABUMI, JAWA BARAT",9,91,114,205
2914,https://kawalpemilu.org#26225,"DAYEUH, CILEUNGSI, BOGOR, JAWA BARAT",12,41,124,165
92458,https://kawalpemilu.org#31887,"CIBARUSAH JAYA, CIBARUSAH, BEKASI, JAWA BARAT",14,87,136,223
21160,https://kawalpemilu.org#27147,"SUKANAGALIH, PACET, CIANJUR, JAWA BARAT",50,35,79,114
96849,https://kawalpemilu.org#32043,"NEGLASARI, CIPONGKOR, BANDUNG BARAT, JAWA BARAT",5,38,95,133
78259,https://kawalpemilu.org#31069,"CINTAMEKAR, SERANGPANJANG, SUBANG, JAWA BARAT",8,107,54,161
67189,https://kawalpemilu.org#30329,"GUNUNGMANIK, TANJUNGSARI, SUMEDANG, JAWA BARAT",25,22,95,117
1095,https://kawalpemilu.org#26159,"CIANGSANA, GUNUNG PUTRI, BOGOR, JAWA BARAT",14,63,109,172
120627,https://kawalpemilu.org#32565,"CIPAGERAN, CIMAHI UTARA, KOTA CIMAHI, JAWA BARAT",125,93,120,213
119916,https://kawalpemilu.org#32556,"CIGUGUR TENGAH, CIMAHI TENGAH, KOTA CIMAHI, JAWA BARAT",65,46,119,165
45224,https://kawalpemilu.org#28346,"CIBALANARIK, TANJUNGJAYA, TASIKMALAYA, JAWA BARAT",5,45,164,209
45314,https://kawalpemilu.org#28351,"SUKASENANG, TANJUNGJAYA, TASIKMALAYA, JAWA BARAT",9,84,100,184
26736,https://kawalpemilu.org#27446,"MARGAASIH, MARGAASIH, BANDUNG, JAWA BARAT",77,56,74,130
46814,https://kawalpemilu.org#28466,"LINGGAWANGI, LEUWISARI, TASIKMALAYA, JAWA BARAT",6,19,226,245
114023,https://kawalpemilu.org#32447,"JATIBENING BARU, PONDOK GEDE, KOTA BEKASI, JAWA BARAT",67,140,84,224
17330,https://kawalpemilu.org#26936,"TITISAN, SUKALARANG, SUKABUMI, JAWA BARAT",19,27,95,122
11003,https://kawalpemilu.org#26590,"CISALADA, CIGOMBONG, BOGOR, JAWA BARAT",4,55,124,179
99585,https://kawalpemilu.org#32130,"LOJI, BOGOR BARAT, KOTA BOGOR, JAWA BARAT",46,47,91,138
111520,https://kawalpemilu.org#32419,"TELUK PUCUNG, BEKASI UTARA, KOTA BEKASI, JAWA BARAT",17,66,142,208
123640,https://kawalpemilu.org#28823,"SUKAHURIP, PANGANDARAN, PANGANDARAN, JAWA BARAT",1,135,73,208
63598,https://kawalpemilu.org#29972,"RAJAGALUH LOR, RAJAGALUH, MAJALENGKA, JAWA BARAT",3,90,57,147
55100,https://kawalpemilu.org#29249,"SILEBU, PANCALANG, KUNINGAN, JAWA BARAT",2,43,115,158
76268,https://kawalpemilu.org#30942,"PATIMBAN, PUSAKANAGARA, SUBANG, JAWA BARAT",16,144,16,160
120212,https://kawalpemilu.org#32560,"CIMAHI, CIMAHI TENGAH, KOTA CIMAHI, JAWA BARAT",11,70,152,222
34322,https://kawalpemilu.org#27685,"PANYOCOKAN, CIWIDEY, BANDUNG, JAWA BARAT",45,125,105,230
117794,https://kawalpemilu.org#32504,"BAKTIJAYA, SUKMAJAYA, KOTA DEPOK, JAWA BARAT",54,64,81,145
109231,https://kawalpemilu.org#32388,"HARJAMUKTI, HARJAMUKTI, KOTA CIREBON, JAWA BARAT",52,92,92,184
81040,https://kawalpemilu.org#31285,"CILANGKAP, BABAKANCIKAO, PURWAKARTA, JAWA BARAT",8,76,160,236
99376,https://kawalpemilu.org#32126,"PASIR JAYA, BOGOR BARAT, KOTA BOGOR, JAWA BARAT",25,84,129,213
77295,https://kawalpemilu.org#31002,"TAMBAKJATI, PATOKBEUSI, SUBANG, JAWA BARAT",27,158,74,232
48268,https://kawalpemilu.org#28575,"CIAMIS, CIAMIS, CIAMIS, JAWA BARAT",7,61,100,161
68265,https://kawalpemilu.org#30392,"CIPAMEUNGPEUK, SUMEDANG SELATAN, SUMEDANG, JAWA BARAT",8,61,169,230
14769,https://kawalpemilu.org#26785,"KABANDUNGAN, KABANDUNGAN, SUKABUMI, JAWA BARAT",20,40,123,163
80791,https://kawalpemilu.org#31259,"SAWAHKULON, PASAWAHAN, PURWAKARTA, JAWA BARAT",6,106,139,245
68536,https://kawalpemilu.org#30408,"MULYASARI, SUMEDANG UTARA, SUMEDANG, JAWA BARAT",3,76,135,211
54453,https://kawalpemilu.org#29172,"GEREBA, KRAMATMULYA, KUNINGAN, JAWA BARAT",3,59,133,192
66728,https://kawalpemilu.org#30287,"LEGOK KIDUL, PASEH, SUMEDANG, JAWA BARAT",1,100,76,176
119763,https://kawalpemilu.org#32553,"CIBEBER, CIMAHI SELATAN, KOTA CIMAHI, JAWA BARAT",28,70,185,255
122947,https://kawalpemilu.org#32659,"BATULAWANG, PATARUMAN, KOTA BANJAR, JAWA BARAT",3,87,116,203
10604,https://kawalpemilu.org#26572,"CIBADAK, TANJUNGSARI, BOGOR, JAWA BARAT",11,90,116,206
57712,https://kawalpemilu.org#29508,"LUWUNG, MUNDU, CIREBON, JAWA BARAT",14,118,67,185
101306,https://kawalpemilu.org#32173,"NYOMPLONG, WARUDOYONG, KOTA SUKABUMI, JAWA BARAT",5,92,101,193
55949,https://kawalpemilu.org#29363,"PANAWUAN, CIGANDAMEKAR, KUNINGAN, JAWA BARAT",2,66,162,228
6098,https://kawalpemilu.org#26346,"CIMAYANG, PAMIJAHAN, BOGOR, JAWA BARAT",14,38,126,164
19498,https://kawalpemilu.org#27069,"SALAMNUNGGAL, CIBEBER, CIANJUR, JAWA BARAT",6,49,127,176
49230,https://kawalpemilu.org#28631,"SUMBERJAYA, CIHAURBEUTI, CIAMIS, JAWA BARAT",6,57,135,192
30873,https://kawalpemilu.org#27578,"BABAKAN, CIPARAY, BANDUNG, JAWA BARAT",16,41,82,123
19540,https://kawalpemilu.org#27072,"SUKASARI, CILAKU, CIANJUR, JAWA BARAT",7,40,125,165
91342,https://kawalpemilu.org#31837,"LENGGAHSARI, CABANGBUNGIN, BEKASI, JAWA BARAT",25,65,165,230
57555,https://kawalpemilu.org#29495,"GETRAKMOYAN, PANGENAN, CIREBON, JAWA BARAT",11,120,36,156
86991,https://kawalpemilu.org#31696,"BUNIBAKTI, BABELAN, BEKASI, JAWA BARAT",3,41,178,219
1031,https://kawalpemilu.org#26158,"BOJONG KULUR, GUNUNG PUTRI, BOGOR, JAWA BARAT",81,53,111,164
9793,https://kawalpemilu.org#26519,"SUKAMANTRI, TAMANSARI, BOGOR, JAWA BARAT",53,95,133,228
30219,https://kawalpemilu.org#27558,"LINGGAR, RANCAEKEK, BANDUNG, JAWA BARAT",24,39,103,142
85695,https://kawalpemilu.org#31628,"PANGULAH UTARA, KOTA BARU, KARAWANG, JAWA BARAT",17,105,118,223
93906,https://kawalpemilu.org#31938,"MANDALASARI, CIKALONGWETAN, BANDUNG BARAT, JAWA BARAT",17,38,180,218
54678,https://kawalpemilu.org#29197,"JAGARA, DARMA, KUNINGAN, JAWA BARAT",5,40,155,195
34520,https://kawalpemilu.org#27693,"ALAMENDAH, RANCABALI, BANDUNG, JAWA BARAT",34,163,66,229
108835,https://kawalpemilu.org#32377,"KEJAKSAN, KEJAKSAN, KOTA CIREBON, JAWA BARAT",4,97,89,186
77842,https://kawalpemilu.org#31041,"SAWANGAN, CIPEUNDEUY, SUBANG, JAWA BARAT",15,76,86,162
81106,https://kawalpemilu.org#31290,"MARACANG, BABAKANCIKAO, PURWAKARTA, JAWA BARAT",13,49,145,194
81708,https://kawalpemilu.org#31349,"TANJUNGPURA, KARAWANG BARAT, KARAWANG, JAWA BARAT",54,72,137,209
5304,https://kawalpemilu.org#26313,"BOJONGJENGKOL, CIAMPEA, BOGOR, JAWA BARAT",7,87,121,208
64022,https://kawalpemilu.org#30002,"CIBORELANG, JATIWANGI, MAJALENGKA, JAWA BARAT",13,100,114,214
37852,https://kawalpemilu.org#27849,"TALAGASARI, KADUNGORA, GARUT, JAWA BARAT",17,43,207,250
114006,https://kawalpemilu.org#32447,"JATIBENING BARU, PONDOK GEDE, KOTA BEKASI, JAWA BARAT",49,113,105,218
67959,https://kawalpemilu.org#30372,"JATIMUKTI, JATINANGOR, SUMEDANG, JAWA BARAT",4,73,146,219
47624,https://kawalpemilu.org#28529,"KARANGMULYA, JAMANIS, TASIKMALAYA, JAWA BARAT",6,58,131,189
65845,https://kawalpemilu.org#30188,"WERASARI, MALAUSMA, MAJALENGKA, JAWA BARAT",15,61,104,165
115653,https://kawalpemilu.org#32469,"JATIWARNA, PONDOK MELATI, KOTA BEKASI, JAWA BARAT",53,57,126,183
40931,https://kawalpemilu.org#28037,"PAMEUNGPEUK, PAMEUNGPEUK, GARUT, JAWA BARAT",3,30,165,195
118400,https://kawalpemilu.org#32519,"PONDOK JAYA, CIPAYUNG, KOTA DEPOK, JAWA BARAT",77,79,87,166
115933,https://kawalpemilu.org#32474,"DEPOK, PANCORAN MAS, KOTA DEPOK, JAWA BARAT",147,77,125,202
53455,https://kawalpemilu.org#29071,"PURWAWINANGUN, KUNINGAN, KUNINGAN, JAWA BARAT",23,55,201,256
48988,https://kawalpemilu.org#28611,"SADANANYA, SADANANYA, CIAMIS, JAWA BARAT",12,45,117,162
57448,https://kawalpemilu.org#29489,"KANCI, ASTANAJAPURA, CIREBON, JAWA BARAT",5,93,107,200
116764,https://kawalpemilu.org#32484,"MEKARSARI, CIMANGGIS, KOTA DEPOK, JAWA BARAT",71,79,136,215
63349,https://kawalpemilu.org#29947,"CIBODAS, MAJALENGKA, MAJALENGKA, JAWA BARAT",6,107,79,186
74174,https://kawalpemilu.org#30827,"TOTORAN, PASEKAN, INDRAMAYU, JAWA BARAT",2,141,71,212
116325,https://kawalpemilu.org#32479,"RANGKAPAN JAYA, PANCORAN MAS, KOTA DEPOK, JAWA BARAT",89,88,149,237
84853,https://kawalpemilu.org#31570,"LEMAHDUHUR, TEMPURAN, KARAWANG, JAWA BARAT",14,91,77,168
54463,https://kawalpemilu.org#29173,"CILAJA, KRAMATMULYA, KUNINGAN, JAWA BARAT",8,99,123,222
59730,https://kawalpemilu.org#29648,"JEMARAS KIDUL, KLANGENAN, CIREBON, JAWA BARAT",14,132,56,188
116837,https://kawalpemilu.org#32485,"PASIR GUNUNG SELATAN, CIMANGGIS, KOTA DEPOK, JAWA BARAT",5,79,43,122
114645,https://kawalpemilu.org#32454,"JATILUHUR, JATIASIH, KOTA BEKASI, JAWA BARAT",28,119,104,223
119387,https://kawalpemilu.org#32549,"MELONG, CIMAHI SELATAN, KOTA CIMAHI, JAWA BARAT",128,62,175,243
52584,https://kawalpemilu.org#28972,"CISUKADANA, KADUGEDE, KUNINGAN, JAWA BARAT",3,90,94,184
60381,https://kawalpemilu.org#29694,"JATIANOM, SUSUKAN, CIREBON, JAWA BARAT",7,120,44,164
75995,https://kawalpemilu.org#30933,"DUKUH, CIASEM, SUBANG, JAWA BARAT",19,163,96,259
26141,https://kawalpemilu.org#27435,"BUAHBATU, BOJONGSOANG, BANDUNG, JAWA BARAT",21,56,100,156
39759,https://kawalpemilu.org#27966,"CISURUPAN, CISURUPAN, GARUT, JAWA BARAT",8,41,141,182
763,https://kawalpemilu.org#26155,"PABUARAN, CIBINONG, BOGOR, JAWA BARAT",114,128,123,251
26131,https://kawalpemilu.org#27435,"BUAHBATU, BOJONGSOANG, BANDUNG, JAWA BARAT",11,47,132,179
4934,https://kawalpemilu.org#26296,"BOJONGGEDE, BOJONG GEDE, BOGOR, JAWA BARAT",66,71,173,244
92405,https://kawalpemilu.org#31885,"WIBAWAMULYA, CIBARUSAH, BEKASI, JAWA BARAT",16,50,203,253
102042,https://kawalpemilu.org#32200,"CIPAGANTI, COBLONG, KOTA BANDUNG, JAWA BARAT",1,97,114,211
113189,https://kawalpemilu.org#32436,"PEJUANG, MEDAN SATRIA, KOTA BEKASI, JAWA BARAT",63,36,82,118
68513,https://kawalpemilu.org#30406,"TALUN, SUMEDANG UTARA, SUMEDANG, JAWA BARAT",16,73,145,218
21120,https://kawalpemilu.org#27147,"SUKANAGALIH, PACET, CIANJUR, JAWA BARAT",9,47,153,200
26966,https://kawalpemilu.org#27450,"RAHAYU, MARGAASIH, BANDUNG, JAWA BARAT",10,137,86,223
18637,https://kawalpemilu.org#27031,"SAYANG, CIANJUR, CIANJUR, JAWA BARAT",33,52,120,172
80118,https://kawalpemilu.org#31190,"SUKAMAJU, SUKATANI, PURWAKARTA, JAWA BARAT",3,52,183,235
46565,https://kawalpemilu.org#28447,"NANGTANG, CIGALONTANG, TASIKMALAYA, JAWA BARAT",5,27,144,171
88747,https://kawalpemilu.org#31742,"WANASARI, CIBITUNG, BEKASI, JAWA BARAT",2,48,91,139
24298,https://kawalpemilu.org#27361,"CIMACAN, CIPANAS, CIANJUR, JAWA BARAT",37,38,142,180
94365,https://kawalpemilu.org#31960,"CIMAREME, NGAMPRAH, BANDUNG BARAT, JAWA BARAT",9,63,159,222
83939,https://kawalpemilu.org#31491,"CIKALONGSARI, JATISARI, KARAWANG, JAWA BARAT",9,92,124,216
43909,https://kawalpemilu.org#28242,"CILUMBA, CIKATOMAS, TASIKMALAYA, JAWA BARAT",9,18,129,147
78185,https://kawalpemilu.org#31064,"CIPANCAR, SERANGPANJANG, SUBANG, JAWA BARAT",12,87,73,162
77229,https://kawalpemilu.org#31000,"RANCAMULYA, PATOKBEUSI, SUBANG, JAWA BARAT",4,82,134,216
46712,https://kawalpemilu.org#28458,"CIGALONTANG, CIGALONTANG, TASIKMALAYA, JAWA BARAT",5,33,163,4
79977,https://kawalpemilu.org#31179,"SINDANGSARI, PLERED, PURWAKARTA, JAWA BARAT",10,42,172,214
41114,https://kawalpemilu.org#28048,"SUKAMUKTI, CISOMPET, GARUT, JAWA BARAT",11,93,144,237
9285,https://kawalpemilu.org#26501,"PAGELARAN, CIOMAS, BOGOR, JAWA BARAT",40,104,122,226
47112,https://kawalpemilu.org#28489,"GUNUNGSARI, SUKARATU, TASIKMALAYA, JAWA BARAT",1,83,194,277
29642,https://kawalpemilu.org#27540,"CITAMAN, NAGREG, BANDUNG, JAWA BARAT",23,55,101,156
68214,https://kawalpemilu.org#30390,"KOTAKULON, SUMEDANG SELATAN, SUMEDANG, JAWA BARAT",11,78,141,219
40357,https://kawalpemilu.org#27996,"MEKARJAYA, CIKAJANG, GARUT, JAWA BARAT",25,41,128,169
30479,https://kawalpemilu.org#27567,"CIPARAY, CIPARAY, BANDUNG, JAWA BARAT",14,70,111,181
123798,https://kawalpemilu.org#28833,"SUKARESIK, SIDAMULIH, PANGANDARAN, JAWA BARAT",12,109,88,197
107473,https://kawalpemilu.org#32335,"CIPAMOKOLAN, RANCASARI, KOTA BANDUNG, JAWA BARAT",43,74,161,235
77902,https://kawalpemilu.org#31043,"LENGKONG, CIPEUNDEUY, SUBANG, JAWA BARAT",25,40,92,132
82312,https://kawalpemilu.org#31380,"MULYASEJATI, CIAMPEL, KARAWANG, JAWA BARAT",20,97,101,198
27080,https://kawalpemilu.org#27453,"SANGKANHURIP, KATAPANG, BANDUNG, JAWA BARAT",13,77,163,240
86885,https://kawalpemilu.org#31692,"SAMUDRAJAYA, TARUMAJAYA, BEKASI, JAWA BARAT",24,73,146,219
86012,https://kawalpemilu.org#31638,"PALUMBONSARI, KARAWANG TIMUR, KARAWANG, JAWA BARAT",30,84,162,246
33878,https://kawalpemilu.org#27671,"CIBODAS, PASIRJAMBU, BANDUNG, JAWA BARAT",31,152,61,213
8534,https://kawalpemilu.org#26467,"SUKAMANAH, MEGAMENDUNG, BOGOR, JAWA BARAT",11,46,136,182
109879,https://kawalpemilu.org#32405,"BEKASI JAYA, BEKASI TIMUR, KOTA BEKASI, JAWA BARAT",165,63,155,218
111498,https://kawalpemilu.org#32418,"HARAPAN BARU, BEKASI UTARA, KOTA BEKASI, JAWA BARAT",54,106,141,247
62182,https://kawalpemilu.org#29833,"BAKUNG LOR, JAMBLANG, CIREBON, JAWA BARAT",1,180,41,221
54039,https://kawalpemilu.org#29121,"SUKAMUKTI, JALAKSANA, KUNINGAN, JAWA BARAT",10,110,104,214
93894,https://kawalpemilu.org#31938,"MANDALASARI, CIKALONGWETAN, BANDUNG BARAT, JAWA BARAT",5,58,165,223
38430,https://kawalpemilu.org#27882,"MALANGBONG, MALANGBONG, GARUT, JAWA BARAT",3,57,187,244
112008,https://kawalpemilu.org#32423,"PEKAYON JAYA, BEKASI SELATAN, KOTA BEKASI, JAWA BARAT",113,65,143,208
111092,https://kawalpemilu.org#32414,"JAKA SAMPURNA, BEKASI BARAT, KOTA BEKASI, JAWA BARAT",154,117,133,250
28643,https://kawalpemilu.org#27498,"WANASUKA, PANGALENGAN, BANDUNG, JAWA BARAT",11,42,170,212
16183,https://kawalpemilu.org#26874,"NAGRAK, CISAAT, SUKABUMI, JAWA BARAT",20,32,202,234
119543,https://kawalpemilu.org#32550,"CIBEUREUM, CIMAHI SELATAN, KOTA CIMAHI, JAWA BARAT",147,72,110,182
89474,https://kawalpemilu.org#31757,"TELAGA ASIH, CIKARANG BARAT, BEKASI, JAWA BARAT",15,90,151,241
87313,https://kawalpemilu.org#31703,"BABELANKOTA, BABELAN, BEKASI, JAWA BARAT",32,88,165,253
113021,https://kawalpemilu.org#32432,"BOJONG MENTENG, RAWA LUMBU, KOTA BEKASI, JAWA BARAT",106,114,71,185
55515,https://kawalpemilu.org#29309,"CIMARA, CIBEUREUM, KUNINGAN, JAWA BARAT",6,99,73,172
17922,https://kawalpemilu.org#26981,"HEGARMANAH, SAGARANTEN, SUKABUMI, JAWA BARAT",11,47,173,220
103129,https://kawalpemilu.org#32221,"DUNGUS CARIANG, ANDIR, KOTA BANDUNG, JAWA BARAT",30,71,46,117
29992,https://kawalpemilu.org#27553,"RANCAEKEK WETAN, RANCAEKEK, BANDUNG, JAWA BARAT",25,39,121,160
5163,https://kawalpemilu.org#26308,"KAREHKEL, LEUWILIANG, BOGOR, JAWA BARAT",14,58,130,188
32340,https://kawalpemilu.org#27615,"BIRU, MAJALAYA, BANDUNG, JAWA BARAT",25,61,91,152
97080,https://kawalpemilu.org#32054,"SUKARESMI, RONGGA, BANDUNG BARAT, JAWA BARAT",15,30,131,161
82709,https://kawalpemilu.org#31401,"AMANSARI, RENGASDENGKLOK, KARAWANG, JAWA BARAT",3,133,107,240
63718,https://kawalpemilu.org#29982,"RAJAWANGI, LEUWIMUNDING, MAJALENGKA, JAWA BARAT",6,133,55,188
85115,https://kawalpemilu.org#31591,"JAYAMAKMUR, JAYAKERTA, KARAWANG, JAWA BARAT",15,69,146,215
35432,https://kawalpemilu.org#27725,"SUKANEGLA, GARUT KOTA, GARUT, JAWA BARAT",3,51,175,226
10005,https://kawalpemilu.org#26528,"KLAPANUNGGAL, KLAPANUNGGAL, BOGOR, JAWA BARAT",10,74,177,251
29056,https://kawalpemilu.org#27516,"CAMPAKAMULYA, CIMAUNG, BANDUNG, JAWA BARAT",19,119,106,225
118139,https://kawalpemilu.org#32511,"KEMIRI MUKA, BEJI, KOTA DEPOK, JAWA BARAT",53,77,93,170
105129,https://kawalpemilu.org#32276,"TURANGGA, LENGKONG, KOTA BANDUNG, JAWA BARAT",36,80,122,202
114043,https://kawalpemilu.org#32447,"JATIBENING BARU, PONDOK GEDE, KOTA BEKASI, JAWA BARAT",88,136,81,217
34922,https://kawalpemilu.org#27707,"CIBODAS, KUTAWARINGIN, BANDUNG, JAWA BARAT",16,87,142,239
13869,https://kawalpemilu.org#26739,"BABAKANJAYA, PARUNG KUDA, SUKABUMI, JAWA BARAT",22,31,124,155
59590,https://kawalpemilu.org#29640,"KAPETAKAN, KAPETAKAN, CIREBON, JAWA BARAT",9,145,61,206
104982,https://kawalpemilu.org#32270,"BINONG, BATUNUNGGAL, KOTA BANDUNG, JAWA BARAT",49,30,84,114
22333,https://kawalpemilu.org#27216,"SUKADANA, CAMPAKA, CIANJUR, JAWA BARAT",8,77,98,175
32508,https://kawalpemilu.org#27619,"MAJAKERTA, MAJALAYA, BANDUNG, JAWA BARAT",22,89,89,178
3134,https://kawalpemilu.org#26229,"CIPEUCANG, CILEUNGSI, BOGOR, JAWA BARAT",6,24,130,154
8362,https://kawalpemilu.org#26458,"TUGU SELATAN, CISARUA, BOGOR, JAWA BARAT",38,24,220,244
50748,https://kawalpemilu.org#28737,"KARANGPARI, RANCAH, CIAMIS, JAWA BARAT",4,78,92,170
120687,https://kawalpemilu.org#32570,"CILEMBANG, CIHIDEUNG, KOTA TASIKMALAYA, JAWA BARAT",14,34,91,125
103591,https://kawalpemilu.org#32232,"SUKARAJA, CICENDO, KOTA BANDUNG, JAWA BARAT",9,76,160,236
26841,https://kawalpemilu.org#27448,"NANJUNG, MARGAASIH, BANDUNG, JAWA BARAT",30,60,117,177
55321,https://kawalpemilu.org#29280,"MEKARJAYA, CIMAHI, KUNINGAN, JAWA BARAT",2,111,50,161
43351,https://kawalpemilu.org#28203,"KARANGNUNGGAL, KARANGNUNGGAL, TASIKMALAYA, JAWA BARAT",4,61,153,214
85669,https://kawalpemilu.org#31627,"PANGULAH SELATAN, KOTA BARU, KARAWANG, JAWA BARAT",27,91,111,202
5328,https://kawalpemilu.org#26313,"BOJONGJENGKOL, CIAMPEA, BOGOR, JAWA BARAT",31,85,131,216
43532,https://kawalpemilu.org#28212,"SARIMUKTI, KARANGNUNGGAL, TASIKMALAYA, JAWA BARAT",9,42,99,141
52826,https://kawalpemilu.org#29007,"SINDANGJAWA, CIBINGBIN, KUNINGAN, JAWA BARAT",9,127,38,165
23049,https://kawalpemilu.org#27271,"KERTAJAYA, TANGGEUNG, CIANJUR, JAWA BARAT",3,59,104,163
116844,https://kawalpemilu.org#32485,"PASIR GUNUNG SELATAN, CIMANGGIS, KOTA DEPOK, JAWA BARAT",24,58,89,147
102183,https://kawalpemilu.org#32202,"SADANGSERANG, COBLONG, KOTA BANDUNG, JAWA BARAT",74,88,131,219
4177,https://kawalpemilu.org#26279,"BOJONG, KEMANG, BOGOR, JAWA BARAT",33,59,112,171
119744,https://kawalpemilu.org#32553,"CIBEBER, CIMAHI SELATAN, KOTA CIMAHI, JAWA BARAT",5,72,213,285
75168,https://kawalpemilu.org#30882,"KALIANGSANA, KALIJATI, SUBANG, JAWA BARAT",5,81,105,186
81353,https://kawalpemilu.org#31309,"CIPINANG, CIBATU, PURWAKARTA, JAWA BARAT",8,118,113,231
25576,https://kawalpemilu.org#27417,"CIBEUNYING, CIMENYAN, BANDUNG, JAWA BARAT",18,37,88,125
17687,https://kawalpemilu.org#26963,"CISITU, NYALINDUNG, SUKABUMI, JAWA BARAT",14,65,55,120
63939,https://kawalpemilu.org#29996,"CICADAS, JATIWANGI, MAJALENGKA, JAWA BARAT",12,123,92,215
85814,https://kawalpemilu.org#31632,"JOMIN BARAT, KOTA BARU, KARAWANG, JAWA BARAT",24,112,118,230
65666,https://kawalpemilu.org#30171,"RANJI WETAN, KASOKANDEL, MAJALENGKA, JAWA BARAT",4,104,72,176
54432,https://kawalpemilu.org#29167,"KUTAWARINGIN, SELAJAMBE, KUNINGAN, JAWA BARAT",5,112,48,160
16636,https://kawalpemilu.org#26897,"SEUSEUPAN, CARINGIN, SUKABUMI, JAWA BARAT",6,24,122,146
27986,https://kawalpemilu.org#27477,"NEGLASARI, BANJARAN, BANDUNG, JAWA BARAT",16,105,84,189
57075,https://kawalpemilu.org#29458,"CURUG, SUSUKAN LEBAK, CIREBON, JAWA BARAT",4,180,36,216
117396,https://kawalpemilu.org#32499,"LIMO, LIMO, KOTA DEPOK, JAWA BARAT",26,88,74,162
99996,https://kawalpemilu.org#32138,"TANAH BARU, BOGOR UTARA, KOTA BOGOR, JAWA BARAT",1,66,133,199
111467,https://kawalpemilu.org#32418,"HARAPAN BARU, BEKASI UTARA, KOTA BEKASI, JAWA BARAT",22,80,88,168
50589,https://kawalpemilu.org#28729,"RANCAH, RANCAH, CIAMIS, JAWA BARAT",1,46,173,219
1169,https://kawalpemilu.org#26160,"GUNUNG PUTRI, GUNUNG PUTRI, BOGOR, JAWA BARAT",43,85,62,147
58694,https://kawalpemilu.org#29585,"LURAH, PLUMBON, CIREBON, JAWA BARAT",23,89,97,186
34345,https://kawalpemilu.org#27686,"RAWABOGO, CIWIDEY, BANDUNG, JAWA BARAT",23,60,84,144
34745,https://kawalpemilu.org#35834,"KARANGJATI, WONOSEGORO, BOYOLALI, JAWA TENGAH",11,168,34,202
67916,https://kawalpemilu.org#38677,"KLUMPIT, GEBOG, KUDUS, JAWA TENGAH",12,120,43,163
46552,https://kawalpemilu.org#36864,"NGLEGOK, NGARGOYOSO, KARANGANYAR, JAWA TENGAH",14,142,27,169
3564,https://kawalpemilu.org#87446,"GLEMPANG, MAOS, CILACAP, JAWA TENGAH",17,133,39,172
109165,https://kawalpemilu.org#41664,"WONODRI, SEMARANG SELATAN, KOTA SEMARANG, JAWA TENGAH",25,207,26,233
6458,https://kawalpemilu.org#33021,"TUNJUNG, JATILAWANG, BANYUMAS, JAWA TENGAH",32,98,43,141
32027,https://kawalpemilu.org#35593,"SELODOKO, AMPEL, BOYOLALI, JAWA TENGAH",6,187,3,190
14738,https://kawalpemilu.org#33649,"KARANGANYAR, PURWONEGORO, BANJARNEGARA, JAWA TENGAH",17,159,8,167
83427,https://kawalpemilu.org#39953,"JAMBEARUM, PATEBON, KENDAL, JAWA TENGAH",9,146,42,188
68492,https://kawalpemilu.org#38697,"PIJI, DAWE, KUDUS, JAWA TENGAH",24,141,34,175
99440,https://kawalpemilu.org#41222,"PRUWATAN, BUMIAYU, BREBES, JAWA TENGAH",46,134,5,139
6997,https://kawalpemilu.org#33057,"PAGERALANG, KEMRANJEN, BANYUMAS, JAWA TENGAH",7,145,36,181
70579,https://kawalpemilu.org#38835,"JLEGONG, KELING, JEPARA, JAWA TENGAH",1,100,64,164
109142,https://kawalpemilu.org#41664,"WONODRI, SEMARANG SELATAN, KOTA SEMARANG, JAWA TENGAH",2,166,52,218
13469,https://kawalpemilu.org#33544,"PANUSUPAN, REMBANG, PURBALINGGA, JAWA TENGAH",2,146,11,157
63825,https://kawalpemilu.org#38397,"SOKOKULON, MARGOREJO, PATI, JAWA TENGAH",1,190,16,206
4699,https://kawalpemilu.org#84941,"CIMRUTU, PATIMUAN, CILACAP, JAWA TENGAH",10,145,24,169
25875,https://kawalpemilu.org#35026,"REJOSARI, KALIKAJAR, WONOSOBO, JAWA TENGAH",8,116,16,132
31296,https://kawalpemilu.org#35520,"BANYUURIP, TEGALREJO, MAGELANG, JAWA TENGAH",8,136,36,172
80378,https://kawalpemilu.org#39644,"NGROPOH, KRANGGAN, TEMANGGUNG, JAWA TENGAH",4,158,62,220
15985,https://kawalpemilu.org#33773,"SAMBONG, PUNGGELAN, BANJARNEGARA, JAWA TENGAH",15,95,37,132
4055,https://kawalpemilu.org#87457,"MADURA, WANAREJA, CILACAP, JAWA TENGAH",25,126,70,196
36041,https://kawalpemilu.org#35965,"SAJEN, TRUCUK, KLATEN, JAWA TENGAH",1,153,37,190
37804,https://kawalpemilu.org#36143,"SEGARAN, DELANGGU, KLATEN, JAWA TENGAH",7,134,31,165
24558,https://kawalpemilu.org#34886,"BENER, BENER, PURWOREJO, JAWA TENGAH",10,137,31,168
23975,https://kawalpemilu.org#34807,"PAKISARUM, BRUNO, PURWOREJO, JAWA TENGAH",7,119,22,141
64772,https://kawalpemilu.org#38485,"GULANGPONGGE, GUNUNGWUNGKAL, PATI, JAWA TENGAH",10,117,11,128
54543,https://kawalpemilu.org#37378,"TARUB, TAWANGHARJO, GROBOGAN, JAWA TENGAH",5,194,16,210
78016,https://kawalpemilu.org#39404,"GENUK, UNGARAN BARAT, SEMARANG, JAWA TENGAH",2,187,51,238
36007,https://kawalpemilu.org#35962,"GADEN, TRUCUK, KLATEN, JAWA TENGAH",11,124,32,156
103847,https://kawalpemilu.org#41434,"BUARA, KETANGGUNGAN, BREBES, JAWA TENGAH",17,80,112,192
19351,https://kawalpemilu.org#34142,"KRAKAL, ALIAN, KEBUMEN, JAWA TENGAH",20,125,49,174
105485,https://kawalpemilu.org#41521,"KEMLAYAN, SERENGAN, KOTA SURAKARTA, JAWA TENGAH",10,197,42,239
72808,https://kawalpemilu.org#38964,"TEMUROSO, GUNTUR, DEMAK, JAWA TENGAH",22,151,69,220
100663,https://kawalpemilu.org#41292,"JAGALEMPENI, WANASARI, BREBES, JAWA TENGAH",8,110,62,172
40601,https://kawalpemilu.org#36399,"WIRUN, MOJOLABAN, SUKOHARJO, JAWA TENGAH",11,199,55,254
58257,https://kawalpemilu.org#37690,"JATIKLAMPOK, BANJAREJO, BLORA, JAWA TENGAH",3,127,20,147
3510,https://kawalpemilu.org#84909,"PANISIHAN, MAOS, CILACAP, JAWA TENGAH",2,73,121,194
61006,https://kawalpemilu.org#38081,"KARANGANYAR, KRAGAN, REMBANG, JAWA TENGAH",8,160,28,188
55918,https://kawalpemilu.org#37473,"PAPANREJO, GUBUG, GROBOGAN, JAWA TENGAH",5,146,41,187
92118,https://kawalpemilu.org#40751,"TAMBAKREJO, PEMALANG, PEMALANG, JAWA TENGAH",7,126,48,174
86432,https://kawalpemilu.org#40262,"PANDANSARI, WARUNGASEM, BATANG, JAWA TENGAH",10,221,12,233
64921,https://kawalpemilu.org#38503,"SIRAHAN, CLUWAK, PATI, JAWA TENGAH",7,184,23,207
97683,https://kawalpemilu.org#41116,"KEPUNDUHAN, KRAMAT, TEGAL, JAWA TENGAH",1,126,61,187
82816,https://kawalpemilu.org#39902,"GEMUHBLANTEN, GEMUH, KENDAL, JAWA TENGAH",6,97,66,163
83727,https://kawalpemilu.org#39988,"RANDUSARI, ROWOSARI, KENDAL, JAWA TENGAH",2,90,62,152
19824,https://kawalpemilu.org#34176,"KEDAWUNG, PEJAGOAN, KEBUMEN, JAWA TENGAH",23,158,78,236
51556,https://kawalpemilu.org#37178,"GEMANTAR, MONDOKAN, SRAGEN, JAWA TENGAH",19,127,10,137
32115,https://kawalpemilu.org#35600,"GLADAGSARI, AMPEL, BOYOLALI, JAWA TENGAH",1,191,57,248
48961,https://kawalpemilu.org#37012,"GEDONGAN, PLUPUH, SRAGEN, JAWA TENGAH",9,122,86,208
103138,https://kawalpemilu.org#41413,"LUWUNGRAGI, BULAKAMBA, BREBES, JAWA TENGAH",21,120,28,148
84501,https://kawalpemilu.org#40060,"WONOTUNGGAL, WONOTUNGGAL, BATANG, JAWA TENGAH",8,187,34,221
14988,https://kawalpemilu.org#33668,"WATUURIP, BAWANG, BANJARNEGARA, JAWA TENGAH",3,125,36,161
41599,https://kawalpemilu.org#36463,"MAKAMHAJI, KARTASURA, SUKOHARJO, JAWA TENGAH",23,123,114,237
84206,https://kawalpemilu.org#40034,"JATIREJO, NGAMPEL, KENDAL, JAWA TENGAH",5,146,23,169
9908,https://kawalpemilu.org#33261,"DUKUHWALUH, KEMBARAN, BANYUMAS, JAWA TENGAH",21,156,67,223
86357,https://kawalpemilu.org#40258,"PROYONANGGAN UTARA, BATANG, BATANG, JAWA TENGAH",11,106,98,204
108848,https://kawalpemilu.org#41651,"PLAMONGANSARI, PEDURUNGAN, KOTA SEMARANG, JAWA TENGAH",30,165,86,251
20431,https://kawalpemilu.org#34257,"REDISARI, ROWOKELE, KEBUMEN, JAWA TENGAH",5,110,45,155
105762,https://kawalpemilu.org#41535,"SUDIROPRAJAN, JEBRES, KOTA SURAKARTA, JAWA TENGAH",11,205,3,208
12743,https://kawalpemilu.org#33485,"BANJARSARI, BOBOTSARI, PURBALINGGA, JAWA TENGAH",9,125,51,176
92964,https://kawalpemilu.org#40789,"KENDALDOYONG, PETARUKAN, PEMALANG, JAWA TENGAH",17,138,9,147
4428,https://kawalpemilu.org#87472,"PABERASAN, SAMPANG, CILACAP, JAWA TENGAH",3,77,96,173
105311,https://kawalpemilu.org#41513,"KARANGASEM, LAWEYAN, KOTA SURAKARTA, JAWA TENGAH",6,193,62,255
74156,https://kawalpemilu.org#39081,"KARANGANYAR, KARANGANYAR, DEMAK, JAWA TENGAH",19,165,41,206
44267,https://kawalpemilu.org#36677,"GEDAWUNG, KISMANTORO, WONOGIRI, JAWA TENGAH",13,118,15,133
44135,https://kawalpemilu.org#36666,"JATIREJO, JATIROTO, WONOGIRI, JAWA TENGAH",16,115,8,123
111742,https://kawalpemilu.org#41770,"WATES, NGALIYAN, KOTA SEMARANG, JAWA TENGAH",5,143,50,193
88791,https://kawalpemilu.org#40532,"AMBOKEMBANG, KEDUNGWUNI, PEKALONGAN, JAWA TENGAH",9,149,77,226
15051,https://kawalpemilu.org#33674,"BAWANG, BAWANG, BANJARNEGARA, JAWA TENGAH",15,79,83,162
13514,https://kawalpemilu.org#33547,"GEMBONG, BOJONGSARI, PURBALINGGA, JAWA TENGAH",7,162,81,243
97794,https://kawalpemilu.org#41124,"MUNJUNGAGUNG, KRAMAT, TEGAL, JAWA TENGAH",6,201,35,236
17840,https://kawalpemilu.org#33958,"WETONWETAN, PURING, KEBUMEN, JAWA TENGAH",4,120,20,140
64833,https://kawalpemilu.org#38493,"GUNUNGWUNGKAL, GUNUNGWUNGKAL, PATI, JAWA TENGAH",17,141,20,161
57679,https://kawalpemilu.org#37623,"PALON, JEPON, BLORA, JAWA TENGAH",3,185,53,238
37099,https://kawalpemilu.org#36068,"LEMAHIRENG, PEDAN, KLATEN, JAWA TENGAH",4,144,16,160
25287,https://kawalpemilu.org#34956,"BANYUMUDAL, SAPURAN, WONOSOBO, JAWA TENGAH",8,168,17,185
5566,https://kawalpemilu.org#91447,"KUTAWARU, CILACAP TENGAH, CILACAP, JAWA TENGAH",35,135,17,152
110040,https://kawalpemilu.org#41697,"SENDANGMULYO, TEMBALANG, KOTA SEMARANG, JAWA TENGAH",68,186,68,254
31826,https://kawalpemilu.org#35572,"KALIJOSO, WINDUSARI, MAGELANG, JAWA TENGAH",1,117,102,219
39512,https://kawalpemilu.org#36308,"GENTAN, BULU, SUKOHARJO, JAWA TENGAH",4,156,34,190
70043,https://kawalpemilu.org#38808,"SROBYONG, MLONGGO, JEPARA, JAWA TENGAH",9,193,26,219
110327,https://kawalpemilu.org#41706,"SRONDOL WETAN, BANYUMANIK, KOTA SEMARANG, JAWA TENGAH",34,115,56,171
16551,https://kawalpemilu.org#33831,"PENUSUPAN, PEJAWARAN, BANJARNEGARA, JAWA TENGAH",2,108,87,195
1511,https://kawalpemilu.org#32824,"SIDAURIP, GANDRUNGMANGU, CILACAP, JAWA TENGAH",13,103,49,152
79401,https://kawalpemilu.org#39526,"KWARAKAN, KALORAN, TEMANGGUNG, JAWA TENGAH",1,144,34,178
52367,https://kawalpemilu.org#37247,"MOJOAGUNG, KARANGRAYUNG, GROBOGAN, JAWA TENGAH",19,159,43,202
17162,https://kawalpemilu.org#33894,"GUNUNGJATI, PAGEDONGAN, BANJARNEGARA, JAWA TENGAH",2,178,27,205
84914,https://kawalpemilu.org#40102,"BLADO, BLADO, BATANG, JAWA TENGAH",13,101,22,123
4261,https://kawalpemilu.org#87464,"DAYEUHLUHUR, DAYEUHLUHUR, CILACAP, JAWA TENGAH",4,65,144,209
95976,https://kawalpemilu.org#40995,"DEPOK, PANGKAH, TEGAL, JAWA TENGAH",1,102,87,189
91482,https://kawalpemilu.org#40727,"KREYO, RANDUDONGKAL, PEMALANG, JAWA TENGAH",2,120,63,183
60458,https://kawalpemilu.org#37996,"SENDANGAGUNG, KALIORI, REMBANG, JAWA TENGAH",1,127,37,164
60510,https://kawalpemilu.org#38003,"TAMBAKAGUNG, KALIORI, REMBANG, JAWA TENGAH",2,215,25,240
87018,https://kawalpemilu.org#40328,"LURAGUNG, KANDANGSERANG, PEKALONGAN, JAWA TENGAH",9,174,20,194
59289,https://kawalpemilu.org#37831,"LOGUNG, SUMBER, REMBANG, JAWA TENGAH",3,214,6,220
109374,https://kawalpemilu.org#41673,"JOMBLANG, CANDISARI, KOTA SEMARANG, JAWA TENGAH",57,159,78,237
20601,https://kawalpemilu.org#34270,"SELOKERTO, SEMPOR, KEBUMEN, JAWA TENGAH",6,162,71,233
18969,https://kawalpemilu.org#34107,"PEKUNDEN, KUTOWINANGUN, KEBUMEN, JAWA TENGAH",3,89,24,113
45199,https://kawalpemilu.org#36759,"JENDI, GIRIMARTO, WONOGIRI, JAWA TENGAH",3,172,22,194
28640,https://kawalpemilu.org#35285,"KETEP, SAWANGAN, MAGELANG, JAWA TENGAH",7,102,70,172
12200,https://kawalpemilu.org#33437,"KALIMANAH WETAN, KALIMANAH, PURBALINGGA, JAWA TENGAH",1,171,79,250
95438,https://kawalpemilu.org#40951,"YAMANSARI, LEBAKSIU, TEGAL, JAWA TENGAH",29,134,50,184
12108,https://kawalpemilu.org#33425,"PURBALINGGA LOR, PURBALINGGA, PURBALINGGA, JAWA TENGAH",4,115,131,246
80073,https://kawalpemilu.org#39600,"KERTOSARI, JUMO, TEMANGGUNG, JAWA TENGAH",7,167,23,4
24577,https://kawalpemilu.org#34888,"GUNTUR, BENER, PURWOREJO, JAWA TENGAH",7,129,9,138
96068,https://kawalpemilu.org#41001,"CURUG, PANGKAH, TEGAL, JAWA TENGAH",6,88,120,208
31170,https://kawalpemilu.org#35506,"SUGIHMAS, GRABAG, MAGELANG, JAWA TENGAH",12,117,17,134
20862,https://kawalpemilu.org#34289,"KEMUKUS, GOMBONG, KEBUMEN, JAWA TENGAH",5,118,41,159
32935,https://kawalpemilu.org#35665,"KRAGILAN, MOJOSONGO, BOYOLALI, JAWA TENGAH",10,207,62,269
9808,https://kawalpemilu.org#33254,"KRAMAT, KEMBARAN, BANYUMAS, JAWA TENGAH",2,95,81,176
35320,https://kawalpemilu.org#35896,"CEPORAN, GANTIWARNO, KLATEN, JAWA TENGAH",8,139,45,184
37803,https://kawalpemilu.org#36143,"SEGARAN, DELANGGU, KLATEN, JAWA TENGAH",6,122,25,147
49620,https://kawalpemilu.org#37052,"SAMBI, SAMBIREJO, SRAGEN, JAWA TENGAH",21,120,8,128
81186,https://kawalpemilu.org#39763,"PARAKANSEBARAN, PAGERUYUNG, KENDAL, JAWA TENGAH",4,122,28,150
15424,https://kawalpemilu.org#33708,"KALIBENDA, SIGALUH, BANJARNEGARA, JAWA TENGAH",5,160,19,179
21818,https://kawalpemilu.org#34409,"KALIREJO, GRABAG, PURWOREJO, JAWA TENGAH",3,88,30,118
29744,https://kawalpemilu.org#35349,"TEMPUREJO, TEMPURAN, MAGELANG, JAWA TENGAH",7,122,45,167
79100,https://kawalpemilu.org#39498,"PRINGSURAT, PRINGSURAT, TEMANGGUNG, JAWA TENGAH",4,241,6,247
80029,https://kawalpemilu.org#39593,"PETIREJO, NGADIREJO, TEMANGGUNG, JAWA TENGAH",4,152,52,204
109657,https://kawalpemilu.org#41687,"METESEH, TEMBALANG, KOTA SEMARANG, JAWA TENGAH",19,202,47,249
84156,https://kawalpemilu.org#40027,"CARUBAN, RINGINARUM, KENDAL, JAWA TENGAH",10,88,94,182
95078,https://kawalpemilu.org#40926,"SESEPAN, BALAPULANG, TEGAL, JAWA TENGAH",3,123,55,178
63586,https://kawalpemilu.org#38369,"WUWUR, GABUS, PATI, JAWA TENGAH",4,119,12,131
57058,https://kawalpemilu.org#37568,"TANJUNG, KEDUNGTUBAN, BLORA, JAWA TENGAH",5,110,60,170
42121,https://kawalpemilu.org#36507,"TUKULREJO, GIRIWOYO, WONOGIRI, JAWA TENGAH",9,137,15,152
50048,https://kawalpemilu.org#37078,"KEBONROMO, NGRAMPAL, SRAGEN, JAWA TENGAH",15,150,26,176
57867,https://kawalpemilu.org#37649,"TAMBAHREJO, BLORA, BLORA, JAWA TENGAH",1,153,87,240
34875,https://kawalpemilu.org#35848,"BENGLE, WONOSEGORO, BOYOLALI, JAWA TENGAH",9,208,0,208
55981,https://kawalpemilu.org#37477,"GUBUG, GUBUG, GROBOGAN, JAWA TENGAH",5,116,33,149
63397,https://kawalpemilu.org#38350,"PATI LOR, PATI, PATI, JAWA TENGAH",13,185,54,239
99642,https://kawalpemilu.org#41232,"RAGATUNJUNG, PAGUYANGAN, BREBES, JAWA TENGAH",6,182,49,231
11505,https://kawalpemilu.org#33370,"CIPAWON, BUKATEJA, PURBALINGGA, JAWA TENGAH",18,134,40,174
52192,https://kawalpemilu.org#37236,"SENDANGHARJO, KARANGRAYUNG, GROBOGAN, JAWA TENGAH",26,179,37,216
47318,https://kawalpemilu.org#36908,"DAGEN, JATEN, KARANGANYAR, JAWA TENGAH",13,127,61,188
63874,https://kawalpemilu.org#38402,"LANGENHARJO, MARGOREJO, PATI, JAWA TENGAH",4,166,17,183
18214,https://kawalpemilu.org#34002,"JATIMALANG, KLIRONG, KEBUMEN, JAWA TENGAH",7,106,62,168
30946,https://kawalpemilu.org#35484,"SUMURARUM, GRABAG, MAGELANG, JAWA TENGAH",4,180,23,203
333,https://kawalpemilu.org#32705,"JANGRANA, KESUGIHAN, CILACAP, JAWA TENGAH",8,184,20,204
19997,https://kawalpemilu.org#34193,"SRUWENG, SRUWENG, KEBUMEN, JAWA TENGAH",5,97,103,200
82660,https://kawalpemilu.org#39885,"PESAWAHAN, PEGANDON, KENDAL, JAWA TENGAH",6,115,28,143
101038,https://kawalpemilu.org#41306,"TANJUNGSARI, WANASARI, BREBES, JAWA TENGAH",8,120,63,183
110837,https://kawalpemilu.org#41731,"KRAPYAK, SEMARANG BARAT, KOTA SEMARANG, JAWA TENGAH",18,166,57,223
54627,https://kawalpemilu.org#37382,"KEMADOHBATUR, TAWANGHARJO, GROBOGAN, JAWA TENGAH",11,160,5,165
20309,https://kawalpemilu.org#34240,"KUWARASAN, KUWARASAN, KEBUMEN, JAWA TENGAH",6,127,21,148
10640,https://kawalpemilu.org#33316,"TELUK, PURWOKERTO SELATAN, BANYUMAS, JAWA TENGAH",17,172,54,226
32595,https://kawalpemilu.org#35646,"PULISEN, BOYOLALI, BOYOLALI, JAWA TENGAH",8,148,51,199
84473,https://kawalpemilu.org#40057,"GRINGGINGSARI, WONOTUNGGAL, BATANG, JAWA TENGAH",4,167,59,226
28948,https://kawalpemilu.org#35307,"PUCUNGREJO, MUNTILAN, MAGELANG, JAWA TENGAH",3,119,58,177
29108,https://kawalpemilu.org#35316,"RAMBEANAK, MUNGKID, MAGELANG, JAWA TENGAH",11,188,50,238
70665,https://kawalpemilu.org#38841,"PARANG, KARIMUN JAWA, JEPARA, JAWA TENGAH",3,129,16,145
46361,https://kawalpemilu.org#36850,"TAWANGMANGU, TAWANGMANGU, KARANGANYAR, JAWA TENGAH",26,170,12,182
15806,https://kawalpemilu.org#33758,"LINGGASARI, WANADADI, BANJARNEGARA, JAWA TENGAH",10,85,33,118
45088,https://kawalpemilu.org#36748,"SLOGORETNO, JATIPURNO, WONOGIRI, JAWA TENGAH",10,91,10,101
46342,https://kawalpemilu.org#36850,"TAWANGMANGU, TAWANGMANGU, KARANGANYAR, JAWA TENGAH",7,168,72,240
76085,https://kawalpemilu.org#39235,"SUKOREJO, SURUH, SEMARANG, JAWA TENGAH",12,154,26,180
34897,https://kawalpemilu.org#35850,"REPAKING, WONOSEGORO, BOYOLALI, JAWA TENGAH",8,200,19,219
85582,https://kawalpemilu.org#40182,"SIDOREJO, GRINGSING, BATANG, JAWA TENGAH",6,143,32,175
4439,https://kawalpemilu.org#87473,"KARANGASEM, SAMPANG, CILACAP, JAWA TENGAH",9,178,30,208
69427,https://kawalpemilu.org#38768,"DATAR, MAYONG, JEPARA, JAWA TENGAH",6,209,23,232
26517,https://kawalpemilu.org#35076,"KALIANGET, WONOSOBO, WONOSOBO, JAWA TENGAH",13,135,29,164
56610,https://kawalpemilu.org#37533,"GEMBYUNGAN, RANDUBLATUNG, BLORA, JAWA TENGAH",4,105,34,139
21976,https://kawalpemilu.org#34461,"SRUWOH, NGOMBOL, PURWOREJO, JAWA TENGAH",1,97,40,137
106840,https://kawalpemilu.org#41561,"SIDOREJO LOR, SIDOREJO, KOTA SALATIGA, JAWA TENGAH",38,125,36,161
65228,https://kawalpemilu.org#38532,"DOROREJO, TAYU, PATI, JAWA TENGAH",5,143,40,183
67211,https://kawalpemilu.org#38649,"GOLANTEPUS, MEJOBO, KUDUS, JAWA TENGAH",22,117,47,164
56904,https://kawalpemilu.org#37554,"SUMBER, KRADENAN, BLORA, JAWA TENGAH",6,142,61,203
22425,https://kawalpemilu.org#34563,"CANGKREP KIDUL, PURWOREJO, PURWOREJO, JAWA TENGAH",8,117,39,156
13879,https://kawalpemilu.org#33580,"BEDAGAS, PENGADEGAN, PURBALINGGA, JAWA TENGAH",4,125,54,179
2685,https://kawalpemilu.org#32881,"BOJA, MAJENANG, CILACAP, JAWA TENGAH",22,106,85,191
90668,https://kawalpemilu.org#40663,"BONGAS, WATUKUMPUL, PEMALANG, JAWA TENGAH",24,63,0,63
11384,https://kawalpemilu.org#33360,"KARANGTENGAH, KEMANGKON, PURBALINGGA, JAWA TENGAH",1,90,133,223
4180,https://kawalpemilu.org#84926,"BINGKENG, DAYEUHLUHUR, CILACAP, JAWA TENGAH",10,35,61,96
94855,https://kawalpemilu.org#40906,"PUCANGLUWUK, BOJONG, TEGAL, JAWA TENGAH",7,46,123,169
10048,https://kawalpemilu.org#33272,"KEBANGGAN, SUMBANG, BANYUMAS, JAWA TENGAH",6,115,46,161
96780,https://kawalpemilu.org#41047,"HARJOSARI KIDUL, ADIWERNA, TEGAL, JAWA TENGAH",18,184,43,227
60413,https://kawalpemilu.org#37989,"METESEH, KALIORI, REMBANG, JAWA TENGAH",10,182,18,200
16264,https://kawalpemilu.org#33794,"SAMPANG, KARANGKOBAR, BANJARNEGARA, JAWA TENGAH",3,168,39,207
57966,https://kawalpemilu.org#37656,"JEPANGREJO, BLORA, BLORA, JAWA TENGAH",12,169,29,198
86580,https://kawalpemilu.org#40281,"TEGALSARI, KANDEMAN, BATANG, JAWA TENGAH",3,181,55,236
49658,https://kawalpemilu.org#37055,"TEGALREJO, GONDANG, SRAGEN, JAWA TENGAH",11,130,23,153
61904,https://kawalpemilu.org#38167,"PESAGI, KAYEN, PATI, JAWA TENGAH",7,127,7,134
42088,https://kawalpemilu.org#36503,"NGANCAR, GIRIWOYO, WONOGIRI, JAWA TENGAH",5,47,156,203
34256,https://kawalpemilu.org#35786,"DOLOGAN, KARANGGEDE, BOYOLALI, JAWA TENGAH",4,173,49,222
19667,https://kawalpemilu.org#34164,"BANDUNG, KEBUMEN, KEBUMEN, JAWA TENGAH",10,96,34,130
10621,https://kawalpemilu.org#33315,"KARANGKLESEM, PURWOKERTO SELATAN, BANYUMAS, JAWA TENGAH",34,178,58,236
71045,https://kawalpemilu.org#38865,"NALUMSARI, NALUMSARI, JEPARA, JAWA TENGAH",9,114,39,153
73963,https://kawalpemilu.org#39065,"MLEKANG, GAJAH, DEMAK, JAWA TENGAH",3,113,72,185
64777,https://kawalpemilu.org#38486,"JEPALO, GUNUNGWUNGKAL, PATI, JAWA TENGAH",5,142,8,150
100184,https://kawalpemilu.org#41256,"LINGGAPURA, TONJONG, BREBES, JAWA TENGAH",19,53,73,126
13090,https://kawalpemilu.org#33518,"KALIJARAN, KARANGANYAR, PURBALINGGA, JAWA TENGAH",14,158,25,183
78571,https://kawalpemilu.org#39434,"SIDOMUKTI, BANDUNGAN, SEMARANG, JAWA TENGAH",10,208,39,247
56219,https://kawalpemilu.org#37498,"KEDUNGWUNGU, TEGOWANU, GROBOGAN, JAWA TENGAH",10,116,45,161
96924,https://kawalpemilu.org#41059,"TEGALWANGI, TALANG, TEGAL, JAWA TENGAH",1,129,70,199
60209,https://kawalpemilu.org#37957,"SEGOROMULYO, PAMOTAN, REMBANG, JAWA TENGAH",3,66,32,98
70197,https://kawalpemilu.org#38814,"KEPUK, BANGSRI, JEPARA, JAWA TENGAH",7,178,10,188
49583,https://kawalpemilu.org#37051,"DAWUNG, SAMBIREJO, SRAGEN, JAWA TENGAH",5,101,12,113
111053,https://kawalpemilu.org#41741,"KROBOKAN, SEMARANG BARAT, KOTA SEMARANG, JAWA TENGAH",19,133,37,170
10181,https://kawalpemilu.org#33282,"GANDATAPA, SUMBANG, BANYUMAS, JAWA TENGAH",14,213,25,238
54009,https://kawalpemilu.org#37347,"KALANGDOSARI, NGARINGAN, GROBOGAN, JAWA TENGAH",8,143,20,163
97601,https://kawalpemilu.org#41110,"MEJASEMBARAT, KRAMAT, TEGAL, JAWA TENGAH",16,107,119,226
17163,https://kawalpemilu.org#33894,"GUNUNGJATI, PAGEDONGAN, BANJARNEGARA, JAWA TENGAH",3,192,22,214
24256,https://kawalpemilu.org#34839,"SIDOLEREN, GEBANG, PURWOREJO, JAWA TENGAH",3,132,30,162
36943,https://kawalpemilu.org#36055,"TEMUWANGI, PEDAN, KLATEN, JAWA TENGAH",5,128,26,154
74425,https://kawalpemilu.org#39104,"MANGUNJIWAN, DEMAK, DEMAK, JAWA TENGAH",18,178,61,239
50994,https://kawalpemilu.org#37133,"KALORAN, GEMOLONG, SRAGEN, JAWA TENGAH",9,192,6,198
67700,https://kawalpemilu.org#38668,"GONDANGMANIS, BAE, KUDUS, JAWA TENGAH",2,120,46,166
71009,https://kawalpemilu.org#38862,"JATISARI, NALUMSARI, JEPARA, JAWA TENGAH",3,167,22,189
30636,https://kawalpemilu.org#35452,"KETUNDAN, PAKIS, MAGELANG, JAWA TENGAH",5,176,78,254
106729,https://kawalpemilu.org#41557,"BANYUANYAR, BANJARSARI, KOTA SURAKARTA, JAWA TENGAH",11,209,24,233
15787,https://kawalpemilu.org#33756,"KANDANGWANGI, WANADADI, BANJARNEGARA, JAWA TENGAH",11,162,47,209
34202,https://kawalpemilu.org#35780,"PENGKOL, KARANGGEDE, BOYOLALI, JAWA TENGAH",8,129,9,138
89831,https://kawalpemilu.org#40625,"MANDIRAJA, MOGA, PEMALANG, JAWA TENGAH",13,123,16,139
53039,https://kawalpemilu.org#37292,"BANGSRI, GEYER, GROBOGAN, JAWA TENGAH",7,182,19,201
42789,https://kawalpemilu.org#36571,"PANEKAN, EROMOKO, WONOGIRI, JAWA TENGAH",5,108,10,118
106425,https://kawalpemilu.org#41546,"NUSUKAN, BANJARSARI, KOTA SURAKARTA, JAWA TENGAH",50,119,35,154
109887,https://kawalpemilu.org#41695,"KEDUNGMUNDU, TEMBALANG, KOTA SEMARANG, JAWA TENGAH",7,154,54,208
94479,https://kawalpemilu.org#40879,"SOKASARI, BUMIJAWA, TEGAL, JAWA TENGAH",13,137,51,188
103034,https://kawalpemilu.org#41409,"GRINTING, BULAKAMBA, BREBES, JAWA TENGAH",52,125,23,148
76263,https://kawalpemilu.org#39247,"SUKOHARJO, PABELAN, SEMARANG, JAWA TENGAH",4,161,43,204
64568,https://kawalpemilu.org#38465,"KERTOMULYO, MARGOYOSO, PATI, JAWA TENGAH",5,153,25,178
28961,https://kawalpemilu.org#35307,"PUCUNGREJO, MUNTILAN, MAGELANG, JAWA TENGAH",16,177,46,223
107800,https://kawalpemilu.org#41610,"TANJUNG MAS, SEMARANG UTARA, KOTA SEMARANG, JAWA TENGAH",36,162,19,181
82759,https://kawalpemilu.org#39896,"SEDAYU, GEMUH, KENDAL, JAWA TENGAH",1,109,62,171
23724,https://kawalpemilu.org#34765,"KROYO KULON, KEMIRI, PURWOREJO, JAWA TENGAH",3,136,63,199
2062,https://kawalpemilu.org#32852,"BABAKAN, KARANGPUCUNG, CILACAP, JAWA TENGAH",18,70,69,139
64728,https://kawalpemilu.org#38479,"MARGOYOSO, MARGOYOSO, PATI, JAWA TENGAH",4,132,48,180
94164,https://kawalpemilu.org#40866,"JEMBAYAT, MARGASARI, TEGAL, JAWA TENGAH",20,75,121,196
43899,https://kawalpemilu.org#36644,"KEBONAGUNG, SIDOHARJO, WONOGIRI, JAWA TENGAH",2,151,27,178
55626,https://kawalpemilu.org#37444,"PAHESAN, GODONG, GROBOGAN, JAWA TENGAH",4,147,43,190
77781,https://kawalpemilu.org#39377,"WONOYOSO, PRINGAPUS, SEMARANG, JAWA TENGAH",8,124,24,148
42007,https://kawalpemilu.org#36495,"TLOGOHARJO, GIRITONTRO, WONOGIRI, JAWA TENGAH",3,101,40,141
79645,https://kawalpemilu.org#39553,"KUNDISARI, KEDU, TEMANGGUNG, JAWA TENGAH",3,209,10,219
73857,https://kawalpemilu.org#39053,"KEDONDONG, GAJAH, DEMAK, JAWA TENGAH",14,159,34,193
63901,https://kawalpemilu.org#38404,"SUKOHARJO, MARGOREJO, PATI, JAWA TENGAH",11,155,48,203
50729,https://kawalpemilu.org#37111,"TENGGAK, SIDOHARJO, SRAGEN, JAWA TENGAH",4,125,7,132
65934,https://kawalpemilu.org#38578,"MIJEN, KALIWUNGU, KUDUS, JAWA TENGAH",33,139,61,200
24347,https://kawalpemilu.org#34856,"KALI GLAGAH, LOANO, PURWOREJO, JAWA TENGAH",3,128,29,157
86156,https://kawalpemilu.org#40251,"DENASRI WETAN, BATANG, BATANG, JAWA TENGAH",12,176,29,205
16754,https://kawalpemilu.org#33851,"BANTAR, WANAYASA, BANJARNEGARA, JAWA TENGAH",3,148,83,231
2526,https://kawalpemilu.org#32876,"CIBEUNYING, MAJENANG, CILACAP, JAWA TENGAH",14,162,60,222
84680,https://kawalpemilu.org#40078,"KLUWIH, BANDAR, BATANG, JAWA TENGAH",26,147,18,165
4509,https://kawalpemilu.org#87474,"PEGADINGAN, CIPARI, CILACAP, JAWA TENGAH",5,71,118,189
4079,https://kawalpemilu.org#87462,"PURWASARI, WANAREJA, CILACAP, JAWA TENGAH",1,136,66,202
36089,https://kawalpemilu.org#35968,"SABRANGLOR, TRUCUK, KLATEN, JAWA TENGAH",1,134,32,166
105695,https://kawalpemilu.org#41530,"SANGKRAH, PASAR KLIWON, KOTA SURAKARTA, JAWA TENGAH",5,164,28,192
84516,https://kawalpemilu.org#40061,"BROKOH, WONOTUNGGAL, BATANG, JAWA TENGAH",6,142,81,223
390,https://kawalpemilu.org#32709,"GLEMPANGPASIR, ADIPALA, CILACAP, JAWA TENGAH",1,154,37,191
7289,https://kawalpemilu.org#33080,"GUMELAR KIDUL, TAMBAK, BANYUMAS, JAWA TENGAH",9,107,65,172
44775,https://kawalpemilu.org#36722,"SETREN, SLOGOHIMO, WONOGIRI, JAWA TENGAH",2,110,13,123
52229,https://kawalpemilu.org#37238,"SUMBERJOSARI, KARANGRAYUNG, GROBOGAN, JAWA TENGAH",11,164,16,180
28411,https://kawalpemilu.org#35265,"KETUNGGENG, DUKUN, MAGELANG, JAWA TENGAH",3,66,78,144
91227,https://kawalpemilu.org#40709,"GLANDANG, BANTARBOLANG, PEMALANG, JAWA TENGAH",9,127,25,152
59878,https://kawalpemilu.org#37916,"KARANGMANGU, SARANG, REMBANG, JAWA TENGAH",1,177,43,220
74036,https://kawalpemilu.org#39072,"WONOKETINGAL, KARANGANYAR, DEMAK, JAWA TENGAH",5,143,60,203
100169,https://kawalpemilu.org#41256,"LINGGAPURA, TONJONG, BREBES, JAWA TENGAH",4,60,129,189
100372,https://kawalpemilu.org#41270,"JATIBARANG LOR, JATIBARANG, BREBES, JAWA TENGAH",9,79,101,180
58584,https://kawalpemilu.org#37728,"SEMAWUR, NGAWEN, BLORA, JAWA TENGAH",7,152,46,198
21871,https://kawalpemilu.org#34418,"DUKUHDUNGUS, GRABAG, PURWOREJO, JAWA TENGAH",5,82,68,150
31948,https://kawalpemilu.org#35586,"JERUK, SELO, BOYOLALI, JAWA TENGAH",10,162,8,170
41309,https://kawalpemilu.org#36443,"SANGGUNG, GATAK, SUKOHARJO, JAWA TENGAH",6,209,24,233
17051,https://kawalpemilu.org#33881,"PLORENGAN, KALIBENING, BANJARNEGARA, JAWA TENGAH",11,114,3,117
45361,https://kawalpemilu.org#36772,"JEBLOGAN, KARANGTENGAH, WONOGIRI, JAWA TENGAH",2,186,23,209
22859,https://kawalpemilu.org#34607,"TANJUNGANOM, BANYUURIP, PURWOREJO, JAWA TENGAH",8,81,34,115
111910,https://kawalpemilu.org#41783,"PODOSUGIH, PEKALONGAN BARAT, KOTA PEKALONGAN, JAWA TENGAH",21,126,66,192
73298,https://kawalpemilu.org#39002,"DUKUN, KARANGTENGAH, DEMAK, JAWA TENGAH",2,138,59,197
99591,https://kawalpemilu.org#41230,"PAKUJATI, PAGUYANGAN, BREBES, JAWA TENGAH",2,135,38,173
92001,https://kawalpemilu.org#40745,"SUNGAPAN, PEMALANG, PEMALANG, JAWA TENGAH",4,140,47,187
1569,https://kawalpemilu.org#32826,"LAYANSARI, GANDRUNGMANGU, CILACAP, JAWA TENGAH",23,80,68,148
49573,https://kawalpemilu.org#37050,"BLIMBING, SAMBIREJO, SRAGEN, JAWA TENGAH",11,173,61,234
43615,https://kawalpemilu.org#36627,"MLOKOMANIS KULON, NGADIROJO, WONOGIRI, JAWA TENGAH",10,125,85,210
15083,https://kawalpemilu.org#33677,"GEMURUH, BAWANG, BANJARNEGARA, JAWA TENGAH",10,84,134,218
91300,https://kawalpemilu.org#40718,"PENUSUPAN, RANDUDONGKAL, PEMALANG, JAWA TENGAH",1,91,58,149
94604,https://kawalpemilu.org#40886,"CINTAMANIK, BUMIJAWA, TEGAL, JAWA TENGAH",18,91,59,150
103511,https://kawalpemilu.org#41426,"PAMULIHAN, LARANGAN, BREBES, JAWA TENGAH",30,167,28,195
32831,https://kawalpemilu.org#35658,"TAMBAK, MOJOSONGO, BOYOLALI, JAWA TENGAH",15,180,9,189
12899,https://kawalpemilu.org#33500,"KUTABAWA, KARANGREJA, PURBALINGGA, JAWA TENGAH",18,149,51,200
109177,https://kawalpemilu.org#41665,"PETERONGAN, SEMARANG SELATAN, KOTA SEMARANG, JAWA TENGAH",10,205,16,221
26888,https://kawalpemilu.org#35109,"BLEDERAN, MOJOTENGAH, WONOSOBO, JAWA TENGAH",9,203,11,214
62337,https://kawalpemilu.org#38218,"KARANGKONANG, WINONG, PATI, JAWA TENGAH",2,130,64,194
93223,https://kawalpemilu.org#40802,"WONOGIRI, AMPELGADING, PEMALANG, JAWA TENGAH",4,96,36,132
72579,https://kawalpemilu.org#38948,"BRAMBANG, KARANGAWEN, DEMAK, JAWA TENGAH",13,203,29,232
22861,https://kawalpemilu.org#34608,"SAWIT, BANYUURIP, PURWOREJO, JAWA TENGAH",2,94,45,139
19651,https://kawalpemilu.org#34163,"TANAHSARI, KEBUMEN, KEBUMEN, JAWA TENGAH",6,113,50,163
4215,https://kawalpemilu.org#42827,"PURWOSARI, BABADAN, PONOROGO, JAWA TIMUR",14,151,62,213
116270,https://kawalpemilu.org#51321,"PURWOTENGAH, KRANGGAN, KOTA MOJOKERTO, JAWA TIMUR",4,157,37,194
54729,https://kawalpemilu.org#46077,"KUTOREJO, PANDAAN, PASURUAN, JAWA TIMUR",1,139,77,216
46982,https://kawalpemilu.org#45373,"SUMBER WARU, BINAKAL, BONDOWOSO, JAWA TIMUR",1,53,112,165
35902,https://kawalpemilu.org#44768,"SUCI, PANTI, JEMBER, JAWA TIMUR",5,147,64,211
25940,https://kawalpemilu.org#44254,"JATISARI, PAKISAJI, MALANG, JAWA TIMUR",9,169,40,209
122516,https://kawalpemilu.org#51479,"SEMEMI, BENOWO, KOTA SURABAYA, JAWA TIMUR",51,115,43,158
33128,https://kawalpemilu.org#44669,"KEPANJEN, GUMUKMAS, JEMBER, JAWA TIMUR",22,143,23,166
9486,https://kawalpemilu.org#43239,"NGUNUT, NGUNUT, TULUNGAGUNG, JAWA TIMUR",1,142,21,163
96094,https://kawalpemilu.org#49863,"SUKOMULYO, MANYAR, GRESIK, JAWA TIMUR",11,114,97,211
114902,https://kawalpemilu.org#51250,"MANGUNHARJO, MAYANGAN, KOTA PROBOLINGGO, JAWA TIMUR",20,174,87,261
20222,https://kawalpemilu.org#43945,"JABON, BANYAKAN, KEDIRI, JAWA TIMUR",2,137,47,184
66930,https://kawalpemilu.org#47068,"WONOSALAM, WONOSALAM, JOMBANG, JAWA TIMUR",23,168,33,201
10159,https://kawalpemilu.org#43282,"JOHO, KALIDAWIR, TULUNGAGUNG, JAWA TIMUR",9,177,13,190
74018,https://kawalpemilu.org#47641,"SINGGAHAN, KEBONSARI, MADIUN, JAWA TIMUR",1,118,27,145
18097,https://kawalpemilu.org#91367,"TURUS, GAMPENGREJO, KEDIRI, JAWA TIMUR",5,143,24,167
92869,https://kawalpemilu.org#49465,"LATUKAN, KARANGGENENG, LAMONGAN, JAWA TIMUR",4,150,56,206
72353,https://kawalpemilu.org#47484,"SUMBERKEPUH, TANJUNGANOM, NGANJUK, JAWA TIMUR",34,131,53,184
46913,https://kawalpemilu.org#45363,"SUMBER WRINGIN, SUMBERWRINGIN, BONDOWOSO, JAWA TIMUR",7,58,101,159
49293,https://kawalpemilu.org#45527,"GUDANG, ASEMBAGUS, SITUBONDO, JAWA TIMUR",3,133,50,183
114123,https://kawalpemilu.org#51217,"KARANG BESUKI, SUKUN, KOTA MALANG, JAWA TIMUR",48,105,140,245
112107,https://kawalpemilu.org#51159,"KARANGSARI, SUKOREJO, KOTA BLITAR, JAWA TIMUR",13,154,30,184
77496,https://kawalpemilu.org#47962,"SIDOWAYAH, PANEKAN, MAGETAN, JAWA TIMUR",9,121,104,225
23254,https://kawalpemilu.org#44104,"KEMULAN, TUREN, MALANG, JAWA TIMUR",12,170,43,213
15301,https://kawalpemilu.org#43616,"SIDOMULYO, SELOREJO, BLITAR, JAWA TIMUR",22,151,4,155
95096,https://kawalpemilu.org#49759,"SUMENGKO, DUDUKSAMPEYAN, GRESIK, JAWA TIMUR",1,131,87,218
6673,https://kawalpemilu.org#43015,"GANDUSARI, GANDUSARI, TRENGGALEK, JAWA TIMUR",13,85,145,230
50541,https://kawalpemilu.org#45637,"SEGARAN, TIRIS, PROBOLINGGO, JAWA TIMUR",8,107,56,163
25617,https://kawalpemilu.org#44240,"MANGLIAWAN, PAKIS, MALANG, JAWA TIMUR",22,172,52,224
13196,https://kawalpemilu.org#43489,"KARANGSONO, KANIGORO, BLITAR, JAWA TIMUR",18,141,28,169
68560,https://kawalpemilu.org#47172,"PALREJO, SUMOBITO, JOMBANG, JAWA TIMUR",13,159,18,177
55948,https://kawalpemilu.org#46156,"PEKOREN, REMBANG, PASURUAN, JAWA TIMUR",4,115,85,200
97741,https://kawalpemilu.org#50004,"PUDAKIT TIMUR, SANGKAPURA, GRESIK, JAWA TIMUR",4,35,117,152
53945,https://kawalpemilu.org#46017,"JATI GUNTING, WONOREJO, PASURUAN, JAWA TIMUR",15,100,103,203
15335,https://kawalpemilu.org#43619,"BORO, SELOREJO, BLITAR, JAWA TIMUR",7,121,34,155
51106,https://kawalpemilu.org#45702,"SAMBIRAMPAK KIDUL, KOTAANYAR, PROBOLINGGO, JAWA TIMUR",2,165,81,246
50848,https://kawalpemilu.org#45667,"KERTOSONO, GADING, PROBOLINGGO, JAWA TIMUR",4,0,0,0
93074,https://kawalpemilu.org#49490,"MAOR, KEMBANGBAHU, LAMONGAN, JAWA TIMUR",2,123,51,174
57930,https://kawalpemilu.org#46370,"PORONG, PORONG, SIDOARJO, JAWA TIMUR",4,107,84,191
115952,https://kawalpemilu.org#51314,"SURODINAWAN, PRAJURIT KULON, KOTA MOJOKERTO, JAWA TIMUR",7,148,42,190
73460,https://kawalpemilu.org#47572,"SAMBIKEREP, REJOSO, NGANJUK, JAWA TIMUR",13,134,34,168
67755,https://kawalpemilu.org#47125,"KEDAWONG, DIWEK, JOMBANG, JAWA TIMUR",1,133,61,194
78313,https://kawalpemilu.org#48065,"MRAHU, KARTOHARJO, MAGETAN, JAWA TIMUR",6,137,51,188
75523,https://kawalpemilu.org#47761,"BIBRIK, JIWAN, MADIUN, JAWA TIMUR",15,91,49,140
67475,https://kawalpemilu.org#47108,"WRINGINPITU, MOJOWARNO, JOMBANG, JAWA TIMUR",5,158,14,172
38503,https://kawalpemilu.org#44871,"SUMBERJERUK, KALISAT, JEMBER, JAWA TIMUR",1,126,89,215
110945,https://kawalpemilu.org#51097,"BANDAR LOR, MOJOROTO, KOTA KEDIRI, JAWA TIMUR",4,152,43,195
33846,https://kawalpemilu.org#44701,"SEMBORO, SEMBORO, JEMBER, JAWA TIMUR",15,88,38,126
61022,https://kawalpemilu.org#46586,"TAWANGSARI, TAMAN, SIDOARJO, JAWA TIMUR",6,163,48,211
4018,https://kawalpemilu.org#42810,"KALIMALANG, SUKOREJO, PONOROGO, JAWA TIMUR",3,175,19,194
76139,https://kawalpemilu.org#47818,"PILANGKENCENG, PILANGKENCENG, MADIUN, JAWA TIMUR",7,122,50,172
37900,https://kawalpemilu.org#44838,"TAMANSARI, MUMBULSARI, JEMBER, JAWA TIMUR",16,120,14,134
125051,https://kawalpemilu.org#51568,"GIRIPURNO, BUMIAJI, KOTA BATU, JAWA TIMUR",31,122,18,140
14109,https://kawalpemilu.org#43542,"SUMBERAGUNG, GANDUSARI, BLITAR, JAWA TIMUR",25,154,7,161
64847,https://kawalpemilu.org#46888,"PAKIS, TROWULAN, MOJOKERTO, JAWA TIMUR",3,149,63,212
112423,https://kawalpemilu.org#51174,"POLOWIJEN, BLIMBING, KOTA MALANG, JAWA TIMUR",19,147,74,221
96667,https://kawalpemilu.org#49923,"MOJO TENGAH, MENGANTI, GRESIK, JAWA TIMUR",3,179,31,210
32085,https://kawalpemilu.org#44613,"SUMBERWRINGIN, KLAKAH, LUMAJANG, JAWA TIMUR",7,44,128,172
11418,https://kawalpemilu.org#43388,"SRENGAT, SRENGAT, BLITAR, JAWA TIMUR",11,121,21,142
73216,https://kawalpemilu.org#47551,"NGADIPIRO, WILANGAN, NGANJUK, JAWA TIMUR",9,149,15,164
77262,https://kawalpemilu.org#47941,"PLAOSAN, PLAOSAN, MAGETAN, JAWA TIMUR",4,102,83,185
9414,https://kawalpemilu.org#43232,"SELOREJO, NGUNUT, TULUNGAGUNG, JAWA TIMUR",6,137,39,176
120858,https://kawalpemilu.org#51444,"TEMBOK DUKUH, BUBUTAN, KOTA SURABAYA, JAWA TIMUR",32,135,79,214
66941,https://kawalpemilu.org#47069,"CARANGWULUNG, WONOSALAM, JOMBANG, JAWA TIMUR",10,166,11,177
118386,https://kawalpemilu.org#51391,"PETEMON, SAWAHAN, KOTA SURABAYA, JAWA TIMUR",94,159,39,198
38315,https://kawalpemilu.org#44859,"MRAWAN, MAYANG, JEMBER, JAWA TIMUR",25,102,110,212
59046,https://kawalpemilu.org#46455,"BULUSIDOKARE, SIDOARJO, SIDOARJO, JAWA TIMUR",13,0,0,0
20978,https://kawalpemilu.org#43992,"BLARU, BADAS, KEDIRI, JAWA TIMUR",22,155,15,170
45670,https://kawalpemilu.org#45266,"WONOSARI, WONOSARI, BONDOWOSO, JAWA TIMUR",1,113,49,162
51688,https://kawalpemilu.org#45769,"SIDOPEKSO, KRAKSAAN, PROBOLINGGO, JAWA TIMUR",4,173,53,226
42480,https://kawalpemilu.org#45062,"TAMBONG, KABAT, BANYUWANGI, JAWA TIMUR",2,135,58,193
114457,https://kawalpemilu.org#51228,"TUNJUNGSEKAR, LOWOKWARU, KOTA MALANG, JAWA TIMUR",33,154,30,184
117747,https://kawalpemilu.org#51380,"NGAGEL, WONOKROMO, KOTA SURABAYA, JAWA TIMUR",14,114,60,174
62742,https://kawalpemilu.org#46673,"WEDORO, WARU, SIDOARJO, JAWA TIMUR",36,141,104,245
73249,https://kawalpemilu.org#47553,"NGUDIKAN, WILANGAN, NGANJUK, JAWA TIMUR",14,163,31,194
103759,https://kawalpemilu.org#50510,"KETAPANG TIMUR, KETAPANG, SAMPANG, JAWA TIMUR",7,1,195,196
125171,https://kawalpemilu.org#51574,"JUNREJO, JUNREJO, KOTA BATU, JAWA TIMUR",23,180,24,204
27096,https://kawalpemilu.org#44309,"BATURETNO, SINGOSARI, MALANG, JAWA TIMUR",21,105,86,191
26522,https://kawalpemilu.org#44284,"KALISONGO, DAU, MALANG, JAWA TIMUR",12,168,51,219
3301,https://kawalpemilu.org#42723,"KEPUHRUBUH, SIMAN, PONOROGO, JAWA TIMUR",5,185,41,226
79005,https://kawalpemilu.org#48147,"NGRAYUDAN, JOGOROGO, NGAWI, JAWA TIMUR",14,133,15,148
70852,https://kawalpemilu.org#47377,"PATIHAN, LOCERET, NGANJUK, JAWA TIMUR",9,150,46,196
123468,https://kawalpemilu.org#51512,"GUNUNG ANYAR TAMBAK, GUNUNG ANYAR, KOTA SURABAYA, JAWA TIMUR",18,99,51,150
80151,https://kawalpemilu.org#48251,"JAMBANGAN, PARON, NGAWI, JAWA TIMUR",11,162,57,219
106817,https://kawalpemilu.org#50720,"KERTAGENAH TENGAH, KADUR, PAMEKASAN, JAWA TIMUR",13,78,100,178
103973,https://kawalpemilu.org#50523,"RAGUNG, PANGARENGAN, SAMPANG, JAWA TIMUR",3,25,185,210
52514,https://kawalpemilu.org#45867,"MUNENG, SUMBERASIH, PROBOLINGGO, JAWA TIMUR",5,142,103,245
88529,https://kawalpemilu.org#49053,"JADI, SEMANDING, TUBAN, JAWA TIMUR",12,128,41,169
64137,https://kawalpemilu.org#46819,"AWANG-AWANG, MOJOSARI, MOJOKERTO, JAWA TIMUR",12,189,39,228
44103,https://kawalpemilu.org#45153,"DASRI, TEGALSARI, BANYUWANGI, JAWA TIMUR",2,125,42,167
102220,https://kawalpemilu.org#50417,"KEDUNGDUNG, KEDUNGDUNG, SAMPANG, JAWA TIMUR",8,251,5,256
11387,https://kawalpemilu.org#43385,"BENDOREJO, UDANAWU, BLITAR, JAWA TIMUR",1,112,20,132
118853,https://kawalpemilu.org#51400,"KAPASARI, GENTENG, KOTA SURABAYA, JAWA TIMUR",10,117,61,178
74150,https://kawalpemilu.org#47651,"MLILIR, DOLOPO, MADIUN, JAWA TIMUR",4,138,48,186
60427,https://kawalpemilu.org#46555,"WATESARI, BALONGBENDO, SIDOARJO, JAWA TIMUR",8,157,66,223
5886,https://kawalpemilu.org#42965,"PRAMBON, TUGU, TRENGGALEK, JAWA TIMUR",5,152,29,181
98897,https://kawalpemilu.org#50106,"LERPAK, GEGER, BANGKALAN, JAWA TIMUR",13,130,55,185
92167,https://kawalpemilu.org#49399,"PACIRAN, PACIRAN, LAMONGAN, JAWA TIMUR",22,175,93,268
73392,https://kawalpemilu.org#47566,"MLORAH, REJOSO, NGANJUK, JAWA TIMUR",15,115,13,128
124241,https://kawalpemilu.org#51541,"BABAT JERAWAT, PAKAL, KOTA SURABAYA, JAWA TIMUR",17,110,67,177
93880,https://kawalpemilu.org#49583,"PALANGAN, KARANGBINANGUN, LAMONGAN, JAWA TIMUR",7,129,25,154
73933,https://kawalpemilu.org#47636,"TAMBAKMAS, KEBONSARI, MADIUN, JAWA TIMUR",2,163,34,197
85715,https://kawalpemilu.org#48795,"GONDANG, GONDANG, BOJONEGORO, JAWA TIMUR",4,162,55,217
105496,https://kawalpemilu.org#50643,"PALENGAAN LAOK, PALENGAAN, PAMEKASAN, JAWA TIMUR",12,17,223,240
13440,https://kawalpemilu.org#43500,"SLOROK, GARUM, BLITAR, JAWA TIMUR",28,126,16,142
30212,https://kawalpemilu.org#44475,"SUKOSARI, KUNIR, LUMAJANG, JAWA TIMUR",17,163,51,214
59561,https://kawalpemilu.org#46481,"PANGKEMIRI, TULANGAN, SIDOARJO, JAWA TIMUR",10,157,69,226
59594,https://kawalpemilu.org#46484,"KEPADANGAN, TULANGAN, SIDOARJO, JAWA TIMUR",4,167,50,217
97892,https://kawalpemilu.org#50022,"TAMBAK, TAMBAK, GRESIK, JAWA TIMUR",5,76,90,166
6402,https://kawalpemilu.org#42997,"WATUAGUNG, WATULIMO, TRENGGALEK, JAWA TIMUR",15,120,3,123
122137,https://kawalpemilu.org#51466,"SIDOTOPO WETAN, KENJERAN, KOTA SURABAYA, JAWA TIMUR",145,81,79,160
110995,https://kawalpemilu.org#51098,"BANDAR KIDUL, MOJOROTO, KOTA KEDIRI, JAWA TIMUR",15,121,52,173
1542,https://kawalpemilu.org#42532,"GASANG, TULAKAN, PACITAN, JAWA TIMUR",6,60,103,163
89559,https://kawalpemilu.org#49124,"KETAMBUL, PALANG, TUBAN, JAWA TIMUR",9,127,44,171
37167,https://kawalpemilu.org#44810,"TEGALBESAR, KALIWATES, JEMBER, JAWA TIMUR",55,170,55,225
68398,https://kawalpemilu.org#47160,"MOROSUNGGINGAN, PETERONGAN, JOMBANG, JAWA TIMUR",1,103,45,148
19625,https://kawalpemilu.org#43908,"KANDANGAN, KANDANGAN, KEDIRI, JAWA TIMUR",25,121,44,165
88051,https://kawalpemilu.org#49014,"TLOGOWARU, MERAKURAK, TUBAN, JAWA TIMUR",5,160,70,230
96537,https://kawalpemilu.org#49911,"SUNGON LEGOWO, BUNGAH, GRESIK, JAWA TIMUR",13,115,69,184
9317,https://kawalpemilu.org#43224,"SUMBERDADI, SUMBERGEMPOL, TULUNGAGUNG, JAWA TIMUR",3,128,67,195
13564,https://kawalpemilu.org#43506,"KALIPANG, SUTOJAYAN, BLITAR, JAWA TIMUR",22,117,61,178
118392,https://kawalpemilu.org#51391,"PETEMON, SAWAHAN, KOTA SURABAYA, JAWA TIMUR",101,168,42,210
70214,https://kawalpemilu.org#47315,"PACARPELUK, MEGALUH, JOMBANG, JAWA TIMUR",6,125,49,174
85947,https://kawalpemilu.org#48673,"KATUR, GAYAM, BOJONEGORO, JAWA TIMUR",13,143,32,175
83907,https://kawalpemilu.org#48594,"KABUNAN, BALEN, BOJONEGORO, JAWA TIMUR",10,116,48,164
61724,https://kawalpemilu.org#46629,"KARANGBONG, GEDANGAN, SIDOARJO, JAWA TIMUR",13,133,96,229
25947,https://kawalpemilu.org#44254,"JATISARI, PAKISAJI, MALANG, JAWA TIMUR",16,157,58,215
117429,https://kawalpemilu.org#51374,"PENJARINGAN SARI, RUNGKUT, KOTA SURABAYA, JAWA TIMUR",14,146,74,220
97640,https://kawalpemilu.org#49990,"PEKELINGAN, GRESIK, GRESIK, JAWA TIMUR",6,107,67,174
8776,https://kawalpemilu.org#43173,"NGLURUP, SENDANG, TULUNGAGUNG, JAWA TIMUR",1,117,44,161
36606,https://kawalpemilu.org#44793,"ROWOINDAH, AJUNG, JEMBER, JAWA TIMUR",3,155,63,218
88464,https://kawalpemilu.org#49052,"GEDONGOMBO, SEMANDING, TUBAN, JAWA TIMUR",20,120,70,190
11919,https://kawalpemilu.org#43421,"PLANDIREJO, BAKUNG, BLITAR, JAWA TIMUR",10,124,11,135
105143,https://kawalpemilu.org#50616,"LENTENG, PROPPO, PAMEKASAN, JAWA TIMUR",2,0,0,0
124194,https://kawalpemilu.org#51538,"SUKOLILO BARU, BULAK, KOTA SURABAYA, JAWA TIMUR",19,148,77,225
46802,https://kawalpemilu.org#45358,"SUKOREJO, SUMBERWRINGIN, BONDOWOSO, JAWA TIMUR",1,70,133,203
15573,https://kawalpemilu.org#43635,"SELOPANGGUNG, SEMEN, KEDIRI, JAWA TIMUR",5,160,22,182
13839,https://kawalpemilu.org#43523,"PANGGUNGASRI, PANGGUNGREJO, BLITAR, JAWA TIMUR",7,110,5,115
77829,https://kawalpemilu.org#48000,"KLEDOKAN, BENDO, MAGETAN, JAWA TIMUR",4,157,28,185
108997,https://kawalpemilu.org#50898,"SOGIAN, AMBUNTEN, SUMENEP, JAWA TIMUR",2,66,131,197
88823,https://kawalpemilu.org#49071,"LATSARI, TUBAN, TUBAN, JAWA TIMUR",15,119,73,192
32643,https://kawalpemilu.org#44652,"CAKRU, KENCONG, JEMBER, JAWA TIMUR",9,140,42,182
94205,https://kawalpemilu.org#49635,"JATIRENGGO, GLAGAH, LAMONGAN, JAWA TIMUR",5,92,89,181
42209,https://kawalpemilu.org#45030,"ALIYAN, ROGOJAMPI, BANYUWANGI, JAWA TIMUR",16,99,80,179
61355,https://kawalpemilu.org#46607,"SUKO, SUKODONO, SIDOARJO, JAWA TIMUR",10,109,55,164
65553,https://kawalpemilu.org#46953,"MLIRIP, JETIS, MOJOKERTO, JAWA TIMUR",17,206,41,247
29504,https://kawalpemilu.org#44437,"SUMBERREJO, CANDIPURO, LUMAJANG, JAWA TIMUR",13,151,36,187
905,https://kawalpemilu.org#42490,"KARANGREJO, ARJOSARI, PACITAN, JAWA TIMUR",6,81,78,159
7803,https://kawalpemilu.org#43101,"SOBONTORO, BOYOLANGU, TULUNGAGUNG, JAWA TIMUR",13,130,38,168
86979,https://kawalpemilu.org#48918,"SARINGEMBAT, SINGGAHAN, TUBAN, JAWA TIMUR",7,161,20,181
5842,https://kawalpemilu.org#42961,"TEGAREN, TUGU, TRENGGALEK, JAWA TIMUR",6,135,39,174
120374,https://kawalpemilu.org#51432,"TAMBAKREJO, SIMOKERTO, KOTA SURABAYA, JAWA TIMUR",10,134,30,164
108268,https://kawalpemilu.org#50840,"GALIS, GILI GINTING, SUMENEP, JAWA TIMUR",9,53,72,125
86451,https://kawalpemilu.org#48855,"TENGGERKULON, BANCAR, TUBAN, JAWA TIMUR",2,182,19,201
59886,https://kawalpemilu.org#46512,"SEMAMBUNG, WONOAYU, SIDOARJO, JAWA TIMUR",9,185,59,244
48684,https://kawalpemilu.org#45488,"TREBUNGAN, MANGARAN, SITUBONDO, JAWA TIMUR",17,91,80,171
104720,https://kawalpemilu.org#50576,"KONANG, GALIS, PAMEKASAN, JAWA TIMUR",15,59,167,226
69223,https://kawalpemilu.org#47225,"LOSARI, PLOSO, JOMBANG, JAWA TIMUR",1,135,36,171
15782,https://kawalpemilu.org#43652,"KRANDING, MOJO, KEDIRI, JAWA TIMUR",3,94,19,113
69331,https://kawalpemilu.org#47237,"KLITIH, PLANDAAN, JOMBANG, JAWA TIMUR",2,139,100,239
56526,https://kawalpemilu.org#46232,"WINONGAN KIDUL, WINONGAN, PASURUAN, JAWA TIMUR",1,137,103,240
34632,https://kawalpemilu.org#44728,"BADEAN, BANGSALSARI, JEMBER, JAWA TIMUR",7,149,70,219
112412,https://kawalpemilu.org#51174,"POLOWIJEN, BLIMBING, KOTA MALANG, JAWA TIMUR",8,198,50,248
107351,https://kawalpemilu.org#50752,"KEBONAGONG, KOTA SUMENEP, SUMENEP, JAWA TIMUR",1,83,98,181
14331,https://kawalpemilu.org#43554,"TULUNGREJO, GANDUSARI, BLITAR, JAWA TIMUR",7,160,14,174
13747,https://kawalpemilu.org#43518,"MARGOMULYO, PANGGUNGREJO, BLITAR, JAWA TIMUR",1,137,32,169
106204,https://kawalpemilu.org#50690,"TAMPOJUNG PREGIH, WARU, PAMEKASAN, JAWA TIMUR",17,9,261,270
107382,https://kawalpemilu.org#50755,"KARANGANYAR, KALIANGET, SUMENEP, JAWA TIMUR",5,117,43,160
93051,https://kawalpemilu.org#49487,"KEDUNGASRI, KEMBANGBAHU, LAMONGAN, JAWA TIMUR",1,149,49,198
89285,https://kawalpemilu.org#49104,"KEPOH AGUNG, PLUMPANG, TUBAN, JAWA TIMUR",6,103,41,144
47054,https://kawalpemilu.org#45381,"TAMAN, TAMAN KROCOK, BONDOWOSO, JAWA TIMUR",6,57,107,164
3819,https://kawalpemilu.org#42789,"PAGERUKIR, SAMPUNG, PONOROGO, JAWA TIMUR",7,66,3,69
49257,https://kawalpemilu.org#45525,"MOJOSARI, ASEMBAGUS, SITUBONDO, JAWA TIMUR",4,90,88,178
57633,https://kawalpemilu.org#46340,"KEDUNGWONOKERTO, PRAMBON, SIDOARJO, JAWA TIMUR",13,160,38,198
62931,https://kawalpemilu.org#46691,"GADING, JATIREJO, MOJOKERTO, JAWA TIMUR",1,184,41,225
81878,https://kawalpemilu.org#48396,"SENDANGHARJO, NGASEM, BOJONEGORO, JAWA TIMUR",4,89,93,182
14672,https://kawalpemilu.org#43575,"TEMBALANG, WLINGI, BLITAR, JAWA TIMUR",4,160,24,184
26948,https://kawalpemilu.org#44304,"PAGENTAN, SINGOSARI, MALANG, JAWA TIMUR",36,129,43,172
69166,https://kawalpemilu.org#47219,"KEPUHDOKO, TEMBELANG, JOMBANG, JAWA TIMUR",1,156,48,204
118263,https://kawalpemilu.org#51389,"WONOREJO, TEGALSARI, KOTA SURABAYA, JAWA TIMUR",32,139,52,191
35014,https://kawalpemilu.org#44741,"TAMANSARI, WULUHAN, JEMBER, JAWA TIMUR",23,128,31,159
59986,https://kawalpemilu.org#46523,"KEMASAN, KRIAN, SIDOARJO, JAWA TIMUR",1,119,62,181
24428,https://kawalpemilu.org#44165,"SUKORAHARJO, KEPANJEN, MALANG, JAWA TIMUR",2,151,63,214
88615,https://kawalpemilu.org#49057,"BEKTIHARJO, SEMANDING, TUBAN, JAWA TIMUR",2,160,66,226
78228,https://kawalpemilu.org#48056,"KUWON, KARAS, MAGETAN, JAWA TIMUR",13,112,29,141
49486,https://kawalpemilu.org#45533,"BANYUPUTIH, BANYUPUTIH, SITUBONDO, JAWA TIMUR",13,120,79,199
105860,https://kawalpemilu.org#50661,"BLUMBUNGAN, LARANGAN, PAMEKASAN, JAWA TIMUR",20,45,136,181
83997,https://kawalpemilu.org#48604,"KEDUNGBONDO, BALEN, BOJONEGORO, JAWA TIMUR",2,54,113,167
112062,https://kawalpemilu.org#51156,"BLITAR, SUKOREJO, KOTA BLITAR, JAWA TIMUR",6,131,44,175
73904,https://kawalpemilu.org#47628,"LUMPANGKUWIK, JATIKALEN, NGANJUK, JAWA TIMUR",3,124,56,180
67160,https://kawalpemilu.org#47086,"MANCILAN, MOJOAGUNG, JOMBANG, JAWA TIMUR",14,167,43,210
95980,https://kawalpemilu.org#49856,"MANYAR REJO, MANYAR, GRESIK, JAWA TIMUR",10,151,90,241
53275,https://kawalpemilu.org#45938,"TLOGOSARI, TUTUR, PASURUAN, JAWA TIMUR",6,140,23,163
6737,https://kawalpemilu.org#43020,"SUKORAME, GANDUSARI, TRENGGALEK, JAWA TIMUR",17,158,50,208
14352,https://kawalpemilu.org#43555,"KRISIK, GANDUSARI, BLITAR, JAWA TIMUR",11,198,6,204
69766,https://kawalpemilu.org#47284,"GONDANGMANIS, BANDARKEDUNGMULYO, JOMBANG, JAWA TIMUR",5,130,42,172
106455,https://kawalpemilu.org#50702,"PANGERREMAN, BATUMARMAR, PAMEKASAN, JAWA TIMUR",17,2,260,262
112787,https://kawalpemilu.org#51181,"POLEHAN, BLIMBING, KOTA MALANG, JAWA TIMUR",3,192,37,229
18076,https://kawalpemilu.org#43806,"PLOSOREJO, GAMPENGREJO, KEDIRI, JAWA TIMUR",6,137,50,187
117367,https://kawalpemilu.org#51372,"RUNGKUT KIDUL, RUNGKUT, KOTA SURABAYA, JAWA TIMUR",31,89,98,187
79015,https://kawalpemilu.org#48149,"MACANAN, JOGOROGO, NGAWI, JAWA TIMUR",4,157,29,186
108115,https://kawalpemilu.org#50827,"LEMBUNG TIMUR, LENTENG, SUMENEP, JAWA TIMUR",9,17,96,113
36660,https://kawalpemilu.org#44796,"TEMPUREJO, TEMPUREJO, JEMBER, JAWA TIMUR",5,78,52,130
44631,https://kawalpemilu.org#45182,"MENGEN, TAMANAN, BONDOWOSO, JAWA TIMUR",11,88,57,145
35221,https://kawalpemilu.org#44745,"KESILIR, WULUHAN, JEMBER, JAWA TIMUR",46,101,29,130
40010,https://kawalpemilu.org#44943,"PURWOHARJO, PURWOHARJO, BANYUWANGI, JAWA TIMUR",6,152,49,201
117911,https://kawalpemilu.org#51382,"DARMO, WONOKROMO, KOTA SURABAYA, JAWA TIMUR",25,119,34,153
115445,https://kawalpemilu.org#51284,"TEMBOKREJO, PURWOREJO, KOTA PASURUAN, JAWA TIMUR",21,110,76,186
49028,https://kawalpemilu.org#45510,"SOPET, JANGKAR, SITUBONDO, JAWA TIMUR",35,57,107,164
11835,https://kawalpemilu.org#43414,"PLOSOREJO, KADEMANGAN, BLITAR, JAWA TIMUR",6,136,34,170
97283,https://kawalpemilu.org#49965,"TANJUNGAN, DRIYOREJO, GRESIK, JAWA TIMUR",1,167,55,222
46836,https://kawalpemilu.org#45359,"SUMBER GADING, SUMBERWRINGIN, BONDOWOSO, JAWA TIMUR",13,124,105,229
28156,https://kawalpemilu.org#44358,"JOMBOK, NGANTANG, MALANG, JAWA TIMUR",2,91,29,120
10464,https://kawalpemilu.org#43306,"SAWO, CAMPURDARAT, TULUNGAGUNG, JAWA TIMUR",13,158,16,174
80921,https://kawalpemilu.org#48301,"PARAS, PANGKUR, NGAWI, JAWA TIMUR",2,201,40,241
119503,https://kawalpemilu.org#51416,"SEMOLOWARU, SUKOLILO, KOTA SURABAYA, JAWA TIMUR",10,111,32,143
121882,https://kawalpemilu.org#51465,"TANAH KALI KEDINDING, KENJERAN, KOTA SURABAYA, JAWA TIMUR",15,104,140,244
35393,https://kawalpemilu.org#44750,"AMBULU, AMBULU, JEMBER, JAWA TIMUR",15,49,97,146
114680,https://kawalpemilu.org#51235,"KETAPANG, KADEMANGAN, KOTA PROBOLINGGO, JAWA TIMUR",20,100,124,224
104443,https://kawalpemilu.org#50548,"GUGUL, TLANAKAN, PAMEKASAN, JAWA TIMUR",2,81,101,182
20793,https://kawalpemilu.org#43986,"CANGGU, BADAS, KEDIRI, JAWA TIMUR",1,167,49,216
88318,https://kawalpemilu.org#49039,"SAWAHAN, RENGEL, TUBAN, JAWA TIMUR",4,93,77,170
15638,https://kawalpemilu.org#43640,"TITIK, SEMEN, KEDIRI, JAWA TIMUR",4,150,28,178
18118,https://kawalpemilu.org#43809,"KALIPANG, GROGOL, KEDIRI, JAWA TIMUR",14,123,7,130
3779,https://kawalpemilu.org#42785,"JENANGAN, SAMPUNG, PONOROGO, JAWA TIMUR",8,187,26,213
4902,https://kawalpemilu.org#42901,"KARANGTENGAH, PANGGUL, TRENGGALEK, JAWA TIMUR",4,105,29,134
86367,https://kawalpemilu.org#48845,"BANJARWORO, BANGILAN, TUBAN, JAWA TIMUR",11,71,92,163
64704,https://kawalpemilu.org#46878,"BALONGMOJO, PURI, MOJOKERTO, JAWA TIMUR",9,199,32,231
74130,https://kawalpemilu.org#47648,"KEDONDONG, KEBONSARI, MADIUN, JAWA TIMUR",7,105,51,156
122564,https://kawalpemilu.org#51480,"TAMBAK OSOWILANGUN, BENOWO, KOTA SURABAYA, JAWA TIMUR",1,139,68,207
93226,https://kawalpemilu.org#49509,"LUKREJO, KALITENGAH, LAMONGAN, JAWA TIMUR",1,139,39,178
26544,https://kawalpemilu.org#44285,"KARANGWIDORO, DAU, MALANG, JAWA TIMUR",12,133,23,156
43204,https://kawalpemilu.org#45110,"WATUKEBO, WONGSOREJO, BANYUWANGI, JAWA TIMUR",4,119,146,265
106179,https://kawalpemilu.org#50689,"SUMBER WARU, WARU, PAMEKASAN, JAWA TIMUR",14,2,207,209
56560,https://kawalpemilu.org#46237,"GRATI TUNON, GRATI, PASURUAN, JAWA TIMUR",6,177,29,206
1030,https://kawalpemilu.org#42498,"JETIS LOR, NAWANGAN, PACITAN, JAWA TIMUR",10,85,73,158
20670,https://kawalpemilu.org#43977,"SUKOREJO, NGASEM, KEDIRI, JAWA TIMUR",6,121,65,186
31729,https://kawalpemilu.org#44592,"KALIBOTO KIDUL, JATIROTO, LUMAJANG, JAWA TIMUR",1,83,120,203
89258,https://kawalpemilu.org#49102,"PENIDON, PLUMPANG, TUBAN, JAWA TIMUR",17,112,33,145
12662,https://kawalpemilu.org#43465,"WONOTIRTO, WONOTIRTO, BLITAR, JAWA TIMUR",3,142,6,148
22578,https://kawalpemilu.org#44069,"DAWUHAN, PONCOKUSUMO, MALANG, JAWA TIMUR",5,152,21,173
60796,https://kawalpemilu.org#46576,"WAGE, TAMAN, SIDOARJO, JAWA TIMUR",35,168,77,245
64436,https://kawalpemilu.org#46849,"PACING, BANGSAL, MOJOKERTO, JAWA TIMUR",6,128,93,221
71589,https://kawalpemilu.org#47433,"MOJOKENDIL, NGRONGGOT, NGANJUK, JAWA TIMUR",2,172,26,198
121849,https://kawalpemilu.org#51463,"SIDOTOPO, SEMAMPIR, KOTA SURABAYA, JAWA TIMUR",70,131,82,213
117864,https://kawalpemilu.org#51381,"NGAGEL REJO, WONOKROMO, KOTA SURABAYA, JAWA TIMUR",104,146,43,189
55005,https://kawalpemilu.org#46094,"SUMBER REJO, PANDAAN, PASURUAN, JAWA TIMUR",5,165,42,207
2855,https://kawalpemilu.org#42663,"JURUG, SOOKO, PONOROGO, JAWA TIMUR",18,180,36,216
101865,https://kawalpemilu.org#50396,"RAPA DAYA, OMBEN, SAMPANG, JAWA TIMUR",3,99,146,245
21261,https://kawalpemilu.org#44007,"PANDANREJO, PAGAK, MALANG, JAWA TIMUR",10,120,46,166
68366,https://kawalpemilu.org#47158,"MANCAR, PETERONGAN, JOMBANG, JAWA TIMUR",9,147,54,201
58102,https://kawalpemilu.org#46386,"PLUMBON, PORONG, SIDOARJO, JAWA TIMUR",2,195,77,272
63721,https://kawalpemilu.org#46780,"BANJARTANGGUL, PUNGGING, MOJOKERTO, JAWA TIMUR",1,173,52,225
83112,https://kawalpemilu.org#48509,"SRATUREJO, BAURENO, BOJONEGORO, JAWA TIMUR",10,145,38,183
88929,https://kawalpemilu.org#49078,"KUTOREJO, TUBAN, TUBAN, JAWA TIMUR",11,132,80,212
14754,https://kawalpemilu.org#43580,"SLOROK, DOKO, BLITAR, JAWA TIMUR",17,179,40,219
19339,https://kawalpemilu.org#43894,"KEPUNG, KEPUNG, KEDIRI, JAWA TIMUR",5,111,19,130
48516,https://kawalpemilu.org#45479,"CURAH JERU, PANJI, SITUBONDO, JAWA TIMUR",7,97,80,177
2864,https://kawalpemilu.org#42665,"KARANGPATIHAN, PULUNG, PONOROGO, JAWA TIMUR",4,95,70,165
82258,https://kawalpemilu.org#48430,"KARANGSONO, DANDER, BOJONEGORO, JAWA TIMUR",13,119,60,179
44348,https://kawalpemilu.org#45044,"WATUKEBO, BLIMBINGSARI, BANYUWANGI, JAWA TIMUR",25,185,45,230
68062,https://kawalpemilu.org#47143,"TUNGGORONO, JOMBANG, JOMBANG, JAWA TIMUR",9,144,40,184
93925,https://kawalpemilu.org#49590,"WATANGPANJANG, KARANGBINANGUN, LAMONGAN, JAWA TIMUR",3,93,75,168
21872,https://kawalpemilu.org#44037,"RINGINSARI, SUMBERMANJING WETAN, MALANG, JAWA TIMUR",2,178,48,226
45322,https://kawalpemilu.org#45235,"PENAMBANGAN, CURAHDAMI, BONDOWOSO, JAWA TIMUR",8,107,62,169
12767,https://kawalpemilu.org#43470,"SUMBERASRI, NGLEGOK, BLITAR, JAWA TIMUR",1,142,11,153
17819,https://kawalpemilu.org#43780,"GAYAM, GURAH, KEDIRI, JAWA TIMUR",10,132,25,157
9376,https://kawalpemilu.org#43227,"BUKUR, SUMBERGEMPOL, TULUNGAGUNG, JAWA TIMUR",3,156,40,196
5347,https://kawalpemilu.org#42929,"SIDOMULYO, PULE, TRENGGALEK, JAWA TIMUR",21,95,50,145
100625,https://kawalpemilu.org#50294,"MANGGAAN, MODUNG, BANGKALAN, JAWA TIMUR",2,151,50,201
36896,https://kawalpemilu.org#44804,"MANGLI, KALIWATES, JEMBER, JAWA TIMUR",43,137,108,245
105784,https://kawalpemilu.org#50657,"PASANGGAR, PEGANTENAN, PAMEKASAN, JAWA TIMUR",44,4,191,195
79620,https://kawalpemilu.org#48211,"REJUNO, KARANGJATI, NGAWI, JAWA TIMUR",1,158,55,213
93813,https://kawalpemilu.org#49573,"TAMBAKRIGADUNG, TIKUNG, LAMONGAN, JAWA TIMUR",18,106,63,169
18609,https://kawalpemilu.org#43852,"MUNENG, PURWOASRI, KEDIRI, JAWA TIMUR",9,160,36,196
49583,https://kawalpemilu.org#45541,"ALASTENGAH, SUMBERMALANG, SITUBONDO, JAWA TIMUR",3,54,27,81
73397,https://kawalpemilu.org#47566,"MLORAH, REJOSO, NGANJUK, JAWA TIMUR",20,135,26,161
16446,https://kawalpemilu.org#43698,"WONOREJO, NGADILUWIH, KEDIRI, JAWA TIMUR",6,162,26,188
73096,https://kawalpemilu.org#47541,"KEREPKIDUL, BAGOR, NGANJUK, JAWA TIMUR",4,140,55,195
105,https://kawalpemilu.org#42398,"DONOROJO, DONOROJO, PACITAN, JAWA TIMUR",5,71,87,158
80203,https://kawalpemilu.org#48254,"JEBLOGAN, PARON, NGAWI, JAWA TIMUR",7,144,38,182
7473,https://kawalpemilu.org#43077,"KEPATIHAN, TULUNGAGUNG, TULUNGAGUNG, JAWA TIMUR",4,179,24,203
31631,https://kawalpemilu.org#44583,"GROBOGAN, KEDUNGJAJANG, LUMAJANG, JAWA TIMUR",4,118,63,181
121155,https://kawalpemilu.org#51453,"KREMBANGAN SELATAN, KREMBANGAN, KOTA SURABAYA, JAWA TIMUR",40,91,49,140
29397,https://kawalpemilu.org#44431,"ORO ORO OMBO, PRONOJIWO, LUMAJANG, JAWA TIMUR",14,94,114,208
107366,https://kawalpemilu.org#50754,"PINGGIR PAPAS, KALIANGET, SUMENEP, JAWA TIMUR",7,118,37,155
67208,https://kawalpemilu.org#47089,"MURUKAN, MOJOAGUNG, JOMBANG, JAWA TIMUR",7,166,42,208
6656,https://kawalpemilu.org#43014,"JAJAR, GANDUSARI, TRENGGALEK, JAWA TIMUR",6,133,45,178
62806,https://kawalpemilu.org#46676,"MEDAENG, WARU, SIDOARJO, JAWA TIMUR",7,175,92,267
99200,https://kawalpemilu.org#50140,"MANERON, SEPULU, BANGKALAN, JAWA TIMUR",5,96,118,214
24365,https://kawalpemilu.org#44162,"PANGGUNGREJO, KEPANJEN, MALANG, JAWA TIMUR",8,133,77,210
69554,https://kawalpemilu.org#47261,"MUNUNGKEREP, KABUH, JOMBANG, JAWA TIMUR",2,164,45,209
90484,https://kawalpemilu.org#49226,"SUMURGENUK, BABAT, LAMONGAN, JAWA TIMUR",8,79,83,162
25425,https://kawalpemilu.org#44231,"KEDUNGREJO, PAKIS, MALANG, JAWA TIMUR",5,131,46,177
92296,https://kawalpemilu.org#49407,"KEMANTREN, PACIRAN, LAMONGAN, JAWA TIMUR",7,159,71,230
43055,https://kawalpemilu.org#45101,"GROGOL, GIRI, BANYUWANGI, JAWA TIMUR",14,153,23,176
2640,https://kawalpemilu.org#42646,"TEMPURAN, SAWOO, PONOROGO, JAWA TIMUR",20,165,49,214
15401,https://kawalpemilu.org#43625,"SELOPURO, SELOPURO, BLITAR, JAWA TIMUR",11,115,65,180
42817,https://kawalpemilu.org#45086,"SINGONEGARAN, BANYUWANGI, BANYUWANGI, JAWA TIMUR",3,131,70,201
26025,https://kawalpemilu.org#44258,"KEBONAGUNG, PAKISAJI, MALANG, JAWA TIMUR",4,183,55,238
30057,https://kawalpemilu.org#44466,"PULO, TEMPEH, LUMAJANG, JAWA TIMUR",2,127,69,196
58220,https://kawalpemilu.org#46397,"BALONGTANI, JABON, SIDOARJO, JAWA TIMUR",7,125,94,219
25661,https://kawalpemilu.org#44241,"TIRTOMOYO, PAKIS, MALANG, JAWA TIMUR",22,164,53,217
64475,https://kawalpemilu.org#46854,"PETERONGAN, BANGSAL, MOJOKERTO, JAWA TIMUR",5,178,35,213
96194,https://kawalpemilu.org#49873,"SUKO ANYAR, CERME, GRESIK, JAWA TIMUR",3,143,79,222
111562,https://kawalpemilu.org#51125,"NGRONGGO, KOTA, KOTA KEDIRI, JAWA TIMUR",40,136,61,197
14623,https://kawalpemilu.org#43572,"TANGKIL, WLINGI, BLITAR, JAWA TIMUR",22,119,4,123
32683,https://kawalpemilu.org#44653,"PASEBAN, KENCONG, JEMBER, JAWA TIMUR",17,126,36,162
89558,https://kawalpemilu.org#49124,"KETAMBUL, PALANG, TUBAN, JAWA TIMUR",8,136,45,181
71786,https://kawalpemilu.org#47446,"KALIANYAR, KERTOSONO, NGANJUK, JAWA TIMUR",8,119,30,149
82389,https://kawalpemilu.org#48440,"WEDORO, SUGIHWARAS, BOJONEGORO, JAWA TIMUR",1,103,85,188
102836,https://kawalpemilu.org#50456,"SOMBER, TAMBELANGAN, SAMPANG, JAWA TIMUR",20,67,145,212
90517,https://kawalpemilu.org#49228,"BULUMARGI, BABAT, LAMONGAN, JAWA TIMUR",11,66,71,137
24879,https://kawalpemilu.org#44197,"TAMBAKASRI, TAJINAN, MALANG, JAWA TIMUR",9,153,65,218
62509,https://kawalpemilu.org#46666,"TAMBAKSAWAH, WARU, SIDOARJO, JAWA TIMUR",14,106,61,167
53618,https://kawalpemilu.org#45973,"TEMPURAN, PASREPAN, PASURUAN, JAWA TIMUR",15,72,94,166
111882,https://kawalpemilu.org#51144,"BURENGAN, PESANTREN, KOTA KEDIRI, JAWA TIMUR",21,168,32,200
35353,https://kawalpemilu.org#44749,"SUMBEREJO, AMBULU, JEMBER, JAWA TIMUR",50,159,35,194
6941,https://kawalpemilu.org#43034,"DAWUHAN, TRENGGALEK, TRENGGALEK, JAWA TIMUR",15,159,62,221
90138,https://kawalpemilu.org#49189,"KACANGAN, MODO, LAMONGAN, JAWA TIMUR",5,136,47,183
15715,https://kawalpemilu.org#60318,"OLAK-OLAK KUBU, KUBU, KUBU RAYA, KALIMANTAN BARAT",8,70,103,173
6109,https://kawalpemilu.org#59085,"LANDAU PANJANG, SEPAUK, SINTANG, KALIMANTAN BARAT",2,203,11,214
15522,https://kawalpemilu.org#928385,"SUNGAI MALAYA, SUNGAI AMBAWANG, KUBU RAYA, KALIMANTAN BARAT",3,53,166,219
3104,https://kawalpemilu.org#58632,"KASRO MEGO, BEDUAI, SANGGAU, KALIMANTAN BARAT",6,161,7,168
2210,https://kawalpemilu.org#58531,"SUNGAI KUNYIT DALAM, SUNGAI KUNYIT, MEMPAWAH, KALIMANTAN BARAT",3,49,111,160
12389,https://kawalpemilu.org#60196,"DALAM BUGIS, PONTIANAK TIMUR, KOTA PONTIANAK, KALIMANTAN BARAT",61,16,133,149
7224,https://kawalpemilu.org#59370,"NANGA TUAN, BUNUT HILIR, KAPUAS HULU, KALIMANTAN BARAT",1,108,67,175
5107,https://kawalpemilu.org#58941,"MEKAR SARI, BENUA KAYONG, KETAPANG, KALIMANTAN BARAT",1,23,257,280
13385,https://kawalpemilu.org#60209,"SUNGAI BANGKONG, PONTIANAK KOTA, KOTA PONTIANAK, KALIMANTAN BARAT",70,62,165,227
3967,https://kawalpemilu.org#58730,"SUNGAI MAYAM, MELIAU, SANGGAU, KALIMANTAN BARAT",2,30,133,163
822,https://kawalpemilu.org#58374,"SULUNG, SEJANGKUNG, SAMBAS, KALIMANTAN BARAT",1,44,112,156
12541,https://kawalpemilu.org#60200,"SUNGAI JAWI DALAM, PONTIANAK BARAT, KOTA PONTIANAK, KALIMANTAN BARAT",82,35,66,101
8768,https://kawalpemilu.org#59701,"HILIR KANTOR, NGABANG, LANDAK, KALIMANTAN BARAT",1,147,11,158
1779,https://kawalpemilu.org#58497,"PASIR, MEMPAWAH HILIR, MEMPAWAH, KALIMANTAN BARAT",18,6,194,200
13841,https://kawalpemilu.org#60225,"ROBAN, SINGKAWANG TENGAH, KOTA SINGKAWANG, KALIMANTAN BARAT",42,65,142,207
11464,https://kawalpemilu.org#60129,"BUKIT RAYA, TANAH PINOH BARAT, MELAWI, KALIMANTAN BARAT",2,12,191,203
15474,https://kawalpemilu.org#60287,"KOREK, SUNGAI AMBAWANG, KUBU RAYA, KALIMANTAN BARAT",14,5,238,243
9808,https://kawalpemilu.org#59822,"SEMEDANG, KUALA BEHE, LANDAK, KALIMANTAN BARAT",6,51,131,182
11346,https://kawalpemilu.org#60118,"KAYU BUNGA, BELIMBING HULU, MELAWI, KALIMANTAN BARAT",3,144,3,147
9847,https://kawalpemilu.org#59830,"BENGAWAN AMPAR, KUALA BEHE, LANDAK, KALIMANTAN BARAT",2,186,3,189
16113,https://kawalpemilu.org#60363,"SUNGAI RENGAS, SUNGAI KAKAP, KUBU RAYA, KALIMANTAN BARAT",61,86,95,183
10853,https://kawalpemilu.org#59973,"TANJUNG NIAGA, NANGA PINOH, MELAWI, KALIMANTAN BARAT",4,79,184,263
205,https://kawalpemilu.org#58313,"BERLIMANG, TELUK KERAMAT, SAMBAS, KALIMANTAN BARAT",1,109,46,155
11475,https://kawalpemilu.org#60131,"LAJA, TANAH PINOH BARAT, MELAWI, KALIMANTAN BARAT",5,151,15,166
8396,https://kawalpemilu.org#59616,"MONTERADO, MONTERADO, BENGKAYANG, KALIMANTAN BARAT",6,154,69,223
15471,https://kawalpemilu.org#60287,"KOREK, SUNGAI AMBAWANG, KUBU RAYA, KALIMANTAN BARAT",11,25,221,246
9473,https://kawalpemilu.org#59788,"LADANGAN, MENYUKE, LANDAK, KALIMANTAN BARAT",3,123,1,123
5463,https://kawalpemilu.org#58967,"BATU DAYA, SIMPANG DUA, KETAPANG, KALIMANTAN BARAT",2,64,2,66
2917,https://kawalpemilu.org#58610,"BALAI SEBUT, JANGKANG, SANGGAU, KALIMANTAN BARAT",8,99,2,101
1984,https://kawalpemilu.org#58516,"PENIRAMAN, SUNGAI PINYUH, MEMPAWAH, KALIMANTAN BARAT",3,15,213,228
4559,https://kawalpemilu.org#58829,"RANDAU LIMAT, SUNGAI LAUR, KETAPANG, KALIMANTAN BARAT",1,126,17,143
6867,https://kawalpemilu.org#59272,"KEBONG, KELAM PERMAI, SINTANG, KALIMANTAN BARAT",5,107,38,145
7136,https://kawalpemilu.org#59334,"SELUAN, PUTUSSIBAU UTARA, KAPUAS HULU, KALIMANTAN BARAT",2,225,43,268
4618,https://kawalpemilu.org#58842,"KUALAN TENGAH, SIMPANG HULU, KETAPANG, KALIMANTAN BARAT",11,142,8,150
9411,https://kawalpemilu.org#59778,"PAREK, AIR BESAR, LANDAK, KALIMANTAN BARAT",1,219,45,264
3734,https://kawalpemilu.org#58705,"PADI KAYE, BALAI, SANGGAU, KALIMANTAN BARAT",2,129,11,140
10431,https://kawalpemilu.org#59905,"SUNGAI LAWAK, NANGA TAMAN, SEKADAU, KALIMANTAN BARAT",1,221,15,236
12402,https://kawalpemilu.org#60197,"TAMBELAN SAMPIT, PONTIANAK TIMUR, KOTA PONTIANAK, KALIMANTAN BARAT",12,50,168,218
14353,https://kawalpemilu.org#60251,"SEDAU, SINGKAWANG SELATAN, KOTA SINGKAWANG, KALIMANTAN BARAT",44,111,5,116
117,https://kawalpemilu.org#58301,"LUMBANG, SAMBAS, SAMBAS, KALIMANTAN BARAT",14,95,130,225
7114,https://kawalpemilu.org#59326,"PADUA MENDALAM, PUTUSSIBAU UTARA, KAPUAS HULU, KALIMANTAN BARAT",1,128,4,132
9833,https://kawalpemilu.org#63852,"SEJAHTERA, SIMPANG EMPAT, TANAH BUMBU, KALIMANTAN SELATAN",7,49,130,179
11585,https://kawalpemilu.org#64063,"ALALAK UTARA, BANJARMASIN UTARA, KOTA BANJARMASIN, KALIMANTAN SELATAN",15,98,110,208
865,https://kawalpemilu.org#62079,"TAJAU PECAH, BATU AMPAR, TANAH LAUT, KALIMANTAN SELATAN",6,162,45,207
9267,https://kawalpemilu.org#63786,"SUNGAIDANAU, SATUI, TANAH BUMBU, KALIMANTAN SELATAN",12,113,137,250
11204,https://kawalpemilu.org#64053,"BELITUNG SELATAN, BANJARMASIN BARAT, KOTA BANJARMASIN, KALIMANTAN SELATAN",42,103,149,252
3121,https://kawalpemilu.org#62453,"PADANG PANJANG, KARANG INTAN, BANJAR, KALIMANTAN SELATAN",2,117,117,234
11352,https://kawalpemilu.org#64056,"TELAWANG, BANJARMASIN BARAT, KOTA BANJARMASIN, KALIMANTAN SELATAN",11,74,61,135
11973,https://kawalpemilu.org#64076,"TELUK DALAM, BANJARMASIN TENGAH, KOTA BANJARMASIN, KALIMANTAN SELATAN",6,34,85,119
4561,https://kawalpemilu.org#62760,"PARIMATA, BELAWANG, BARITO KUALA, KALIMANTAN SELATAN",2,30,98,128
7666,https://kawalpemilu.org#63458,"KEBUN SARI, AMUNTAI TENGAH, HULU SUNGAI UTARA, KALIMANTAN SELATAN",11,39,192,231
11469,https://kawalpemilu.org#64059,"KUIN CERUCUK, BANJARMASIN BARAT, KOTA BANJARMASIN, KALIMANTAN SELATAN",32,100,146,246
6749,https://kawalpemilu.org#63239,"BANUA HANYAR, PANDAWAN, HULU SUNGAI TENGAH, KALIMANTAN SELATAN",9,26,153,179
12636,https://kawalpemilu.org#64100,"LANDASAN ULIN SELATAN, LIANG ANGGANG, KOTA BANJARBARU, KALIMANTAN SELATAN",13,108,62,170
9978,https://kawalpemilu.org#63875,"SIRAP, JUAI, BALANGAN, KALIMANTAN SELATAN",3,47,111,158
8332,https://kawalpemilu.org#63628,"BANYU TAJUN, TANJUNG, TABALONG, KALIMANTAN SELATAN",1,34,165,199
8008,https://kawalpemilu.org#63561,"SUNGAI TABUKAN, SUNGAI TABUKAN, HULU SUNGAI UTARA, KALIMANTAN SELATAN",5,57,140,197
12608,https://kawalpemilu.org#64099,"LANDASAN ULIN BARAT, LIANG ANGGANG, KOTA BANJARBARU, KALIMANTAN SELATAN",3,65,148,213
6941,https://kawalpemilu.org#63264,"BARABAI BARAT, BARABAI, HULU SUNGAI TENGAH, KALIMANTAN SELATAN",9,42,166,208
9344,https://kawalpemilu.org#63792,"SEJAHTERA MULIA, SATUI, TANAH BUMBU, KALIMANTAN SELATAN",3,56,119,175
5881,https://kawalpemilu.org#63078,"SUNGAI KUPANG, KANDANGAN, HULU SUNGAI SELATAN, KALIMANTAN SELATAN",8,60,138,192
2820,https://kawalpemilu.org#62418,"PASAYANGAN UTARA, MARTAPURA, BANJAR, KALIMANTAN SELATAN",2,48,139,187
9863,https://kawalpemilu.org#91426,"GUNUNGANTASARI, SIMPANG EMPAT, TANAH BUMBU, KALIMANTAN SELATAN",11,126,64,190
2864,https://kawalpemilu.org#62423,"TANJUNG REMA, MARTAPURA, BANJAR, KALIMANTAN SELATAN",11,43,171,214
7507,https://kawalpemilu.org#63409,"SUNGAI PANDAN TENGAH, SUNGAI PANDAN, HULU SUNGAI UTARA, KALIMANTAN SELATAN",1,31,110,141
5284,https://kawalpemilu.org#62926,"SUNGAI RUTAS, CANDI LARAS SELATAN, TAPIN, KALIMANTAN SELATAN",4,23,200,223
6942,https://kawalpemilu.org#63264,"BARABAI BARAT, BARABAI, HULU SUNGAI TENGAH, KALIMANTAN SELATAN",10,22,115,137
6104,https://kawalpemilu.org#63113,"BANUA HANYAR, DAHA SELATAN, HULU SUNGAI SELATAN, KALIMANTAN SELATAN",10,37,88,125
11214,https://kawalpemilu.org#64054,"PELAMBUAN, BANJARMASIN BARAT, KOTA BANJARMASIN, KALIMANTAN SELATAN",7,123,116,239
8055,https://kawalpemilu.org#63580,"HAPALAH, BANUA LAWAS, TABALONG, KALIMANTAN SELATAN",3,17,69,86
7713,https://kawalpemilu.org#63463,"PASAR SENIN, AMUNTAI TENGAH, HULU SUNGAI UTARA, KALIMANTAN SELATAN",5,51,124,175
5174,https://kawalpemilu.org#62897,"KEPAYANG, TAPIN TENGAH, TAPIN, KALIMANTAN SELATAN",4,22,195,217
7001,https://kawalpemilu.org#63270,"PAJUKUNGAN, BARABAI, HULU SUNGAI TENGAH, KALIMANTAN SELATAN",4,53,143,196
530,https://kawalpemilu.org#62030,"BENTOK DARAT, BATI BATI, TANAH LAUT, KALIMANTAN SELATAN",6,141,56,197
5072,https://kawalpemilu.org#61336,"ASAM BARU, DANAU SELULUK, SERUYAN, KALIMANTAN TENGAH",7,109,36,145
4897,https://kawalpemilu.org#61288,"ULAK BATU, DANAU SEMBULUH, SERUYAN, KALIMANTAN TENGAH",1,104,39,143
4677,https://kawalpemilu.org#61235,"BATU TUKAN, PETAK MALAI, KATINGAN, KALIMANTAN TENGAH",1,95,10,105
7181,https://kawalpemilu.org#61932,"PANARUNG, PAHANDUT, KOTA PALANGKARAYA, KALIMANTAN TENGAH",34,58,87,145
4461,https://kawalpemilu.org#61135,"MIRAH KALANAMAN, KATINGAN TENGAH, KATINGAN, KALIMANTAN TENGAH",12,1,0,1
968,https://kawalpemilu.org#60504,"TANJUNG JARIANGAU, MENTAYA HULU, KOTAWARINGIN TIMUR, KALIMANTAN TENGAH",4,78,48,126
7795,https://kawalpemilu.org#61948,"BUKIT TUNGGAL, JEKAN RAYA, KOTA PALANGKARAYA, KALIMANTAN TENGAH",88,126,91,217
5848,https://kawalpemilu.org#61608,"TEHANG, MAHUNING RAYA, GUNUNG MAS, KALIMANTAN TENGAH",3,111,8,119
7920,https://kawalpemilu.org#61956,"SABARU, SABANGAU, KOTA PALANGKARAYA, KALIMANTAN TENGAH",6,141,45,186
3814,https://kawalpemilu.org#60994,"BATU RAYA II, GUNUNG TIMANG, BARITO UTARA, KALIMANTAN TENGAH",4,156,6,162
3656,https://kawalpemilu.org#60942,"BUNTOK KOTA, DUSUN SELATAN, BARITO SELATAN, KALIMANTAN TENGAH",36,69,113,182
5169,https://kawalpemilu.org#61364,"MENDAWAI, SUKAMARA, SUKAMARA, KALIMANTAN TENGAH",26,86,85,171
4442,https://kawalpemilu.org#61133,"BATU BADINDING, KATINGAN TENGAH, KATINGAN, KALIMANTAN TENGAH",4,156,43,199
1604,https://kawalpemilu.org#60558,"BASIRIH HILIR, MENTAYA HILIR SELATAN, KOTAWARINGIN TIMUR, KALIMANTAN TENGAH",12,27,127,154
4099,https://kawalpemilu.org#61033,"HAJAK, TEWEH BARU, BARITO UTARA, KALIMANTAN TENGAH",3,166,39,205
7651,https://kawalpemilu.org#61947,"MENTENG, JEKAN RAYA, KOTA PALANGKARAYA, KALIMANTAN TENGAH",99,51,93,144
3154,https://kawalpemilu.org#60856,"LAWANG TAMANG, MANDAU TALAWANG, KAPUAS, KALIMANTAN TENGAH",1,157,3,160
3767,https://kawalpemilu.org#60975,"PEPAS, MONTALLAT, BARITO UTARA, KALIMANTAN TENGAH",2,155,29,184
4118,https://kawalpemilu.org#61039,"MALAWAKEN, TEWEH BARU, BARITO UTARA, KALIMANTAN TENGAH",4,122,82,204
5381,https://kawalpemilu.org#61424,"NANGA BULIK, BULIK, LAMANDAU, KALIMANTAN TENGAH",31,152,62,214
2160,https://kawalpemilu.org#64386,"TUNJUNGAN, MUARA KAMAN, KUTAI KARTANEGARA, KALIMANTAN TIMUR",2,71,51,122
2477,https://kawalpemilu.org#64445,"MUARA JAWA ULU, MUARA JAWA, KUTAI KARTANEGARA, KALIMANTAN TIMUR",5,41,104,145
9613,https://kawalpemilu.org#65616,"GUNUNG LINGAI, SUNGAI PINANG, KOTA SAMARINDA, KALIMANTAN TIMUR",24,44,76,120
502,https://kawalpemilu.org#64177,"PAIT, LONG IKIS, PASER, KALIMANTAN TIMUR",1,124,90,214
6843,https://kawalpemilu.org#65556,"SEPINGGAN, BALIKPAPAN SELATAN, KOTA BALIKPAPAN, KALIMANTAN TIMUR",46,38,102,140
1602,https://kawalpemilu.org#64312,"TIMBAU, TENGGARONG, KUTAI KARTANEGARA, KALIMANTAN TIMUR",19,49,137,186
7504,https://kawalpemilu.org#65569,"RAWA MAKMUR, PALARAN, KOTA SAMARINDA, KALIMANTAN TIMUR",11,59,99,158
10437,https://kawalpemilu.org#65670,"TANJUNG LAUT INDAH, BONTANG SELATAN, KOTA BONTANG, KALIMANTAN TIMUR",19,123,115,238
714,https://kawalpemilu.org#88154,"GUNUNG PUTAR, LONG KALI, PASER, KALIMANTAN TIMUR",1,135,68,203
9313,https://kawalpemilu.org#65609,"SAMBUTAN, SAMBUTAN, KOTA SAMARINDA, KALIMANTAN TIMUR",50,52,125,177
7270,https://kawalpemilu.org#65557,"KLANDASAN ILIR, BALIKPAPAN KOTA, KOTA BALIKPAPAN, KALIMANTAN TIMUR",1,117,34,151
2598,https://kawalpemilu.org#64455,"SARI JAYA, SANGA SANGA, KUTAI KARTANEGARA, KALIMANTAN TIMUR",3,68,144,212
8092,https://kawalpemilu.org#65582,"SIDODADI, SAMARINDA ULU, KOTA SAMARINDA, KALIMANTAN TIMUR",35,89,81,170
6797,https://kawalpemilu.org#65552,"SUMBER REJO, BALIKPAPAN TENGAH, KOTA BALIKPAPAN, KALIMANTAN TIMUR",61,87,78,165
971,https://kawalpemilu.org#64274,"JEMBAYAN TENGAH, LOA KULU, KUTAI KARTANEGARA, KALIMANTAN TIMUR",7,117,45,162
9028,https://kawalpemilu.org#65603,"LOK BAHU, SUNGAI KUNJANG, KOTA SAMARINDA, KALIMANTAN TIMUR",13,130,86,216
9621,https://kawalpemilu.org#65616,"GUNUNG LINGAI, SUNGAI PINANG, KOTA SAMARINDA, KALIMANTAN TIMUR",32,82,84,166
9185,https://kawalpemilu.org#65606,"KARANG ANYAR, SUNGAI KUNJANG, KOTA SAMARINDA, KALIMANTAN TIMUR",12,47,95,142
7333,https://kawalpemilu.org#65557,"KLANDASAN ILIR, BALIKPAPAN KOTA, KOTA BALIKPAPAN, KALIMANTAN TIMUR",65,85,60,145
2962,https://kawalpemilu.org#64523,"SAMBALIUNG, SAMBALIUNG, BERAU, KALIMANTAN TIMUR",4,89,75,164
2325,https://kawalpemilu.org#64425,"SUNGAI SELUANG, SAMBOJA, KUTAI KARTANEGARA, KALIMANTAN TIMUR",10,114,85,199
7765,https://kawalpemilu.org#65576,"BAQA, SAMARINDA SEBERANG, KOTA SAMARINDA, KALIMANTAN TIMUR",36,41,71,112
3658,https://kawalpemilu.org#65140,"ASA, BARONG TONGKOK, KUTAI BARAT, KALIMANTAN TIMUR",1,223,11,234
764,https://kawalpemilu.org#88157,"BAI JAYA, BATU ENGAU, PASER, KALIMANTAN TIMUR",1,73,147,220
4138,https://kawalpemilu.org#65328,"MUARA WAHAU, MUARA WAHAU, KUTAI TIMUR, KALIMANTAN TIMUR",13,127,21,148
6026,https://kawalpemilu.org#65542,"BATU AMPAR, BALIKPAPAN UTARA, KOTA BALIKPAPAN, KALIMANTAN TIMUR",21,100,79,179
9852,https://kawalpemilu.org#65626,"SIMPANG TIGA/LOA JANAN ILIR, LOA JANAN ILIR, KOTA SAMARINDA, KALIMANTAN TIMUR",10,55,35,90
10467,https://kawalpemilu.org#65672,"BELIMBING, BONTANG BARAT, KOTA BONTANG, KALIMANTAN TIMUR",7,77,109,186
895,https://kawalpemilu.org#64948,"TANJUNG HARAPAN, NUNUKAN SELATAN, NUNUKAN, KALIMANTAN UTARA",4,137,51,188
579,https://kawalpemilu.org#64726,"NUNUKAN UTARA, NUNUKAN, NUNUKAN, KALIMANTAN UTARA",9,43,53,96
1568,https://kawalpemilu.org#65634,"KARANG REJO, TARAKAN BARAT, KOTA TARAKAN, KALIMANTAN UTARA",11,114,82,196
952,https://kawalpemilu.org#85473,"SUNGAI NYAMUK, SEBATIK TIMUR, NUNUKAN, KALIMANTAN UTARA",13,54,27,81
1785,https://kawalpemilu.org#65641,"SEBENGKOK, TARAKAN TENGAH, KOTA TARAKAN, KALIMANTAN UTARA",27,79,90,169
1070,https://kawalpemilu.org#64911,"MAKMUR, TULIN ONSOI, NUNUKAN, KALIMANTAN UTARA",3,169,23,192
227,https://kawalpemilu.org#929417,"BUKIT BETUNG, SUNGAILIAT, BANGKA, KEPULAUAN BANGKA BELITUNG",14,56,109,165
3081,https://kawalpemilu.org#25334,"LIMBONGAN, GANTUNG, BELITUNG TIMUR, KEPULAUAN BANGKA BELITUNG",3,201,21,222
2275,https://kawalpemilu.org#25224,"TERAK, SIMPANG KATIS, BANGKA TENGAH, KEPULAUAN BANGKA BELITUNG",11,82,117,199
3522,https://kawalpemilu.org#25397,"KERAMAT, RANGKUI, KOTA PANGKALPINANG, KEPULAUAN BANGKA BELITUNG",5,74,160,234
2830,https://kawalpemilu.org#25306,"SEKAR BIRU, PARITTIGA, BANGKA BARAT, KEPULAUAN BANGKA BELITUNG",1,144,102,246
2671,https://kawalpemilu.org#25281,"KELAPA, KELAPA, BANGKA BARAT, KEPULAUAN BANGKA BELITUNG",6,162,48,210
371,https://kawalpemilu.org#931116,"BELINYU, BELINYU, BANGKA, KEPULAUAN BANGKA BELITUNG",6,72,55,127
1885,https://kawalpemilu.org#25173,"TIRAM, TUKAK SADAI, BANGKA SELATAN, KEPULAUAN BANGKA BELITUNG",3,120,68,188
3576,https://kawalpemilu.org#25400,"BUKITMERAPIN, GERUNGGANG, KOTA PANGKALPINANG, KEPULAUAN BANGKA BELITUNG",17,96,152,248
3645,https://kawalpemilu.org#84855,"AIR KEPALA TUJUH, GERUNGGANG, KOTA PANGKALPINANG, KEPULAUAN BANGKA BELITUNG",9,88,151,239
3457,https://kawalpemilu.org#25786,"TANJUNG PIAYU, SEI BEDUK, KOTA BATAM, KEPULAUAN RIAU",10,145,144,289
2641,https://kawalpemilu.org#25756,"SUNGAI JODOH, BATU AMPAR, KOTA BATAM, KEPULAUAN RIAU",20,127,25,152
2717,https://kawalpemilu.org#25760,"TANJUNG RIAU, SEKUPANG, KOTA BATAM, KEPULAUAN RIAU",29,62,85,147
1810,https://kawalpemilu.org#25595,"TANJUNG KILANG, DURAI, KARIMUN, KEPULAUAN RIAU",1,104,31,135
4748,https://kawalpemilu.org#25816,"SUNGAI LANGKAI, SAGULUNG, KOTA BATAM, KEPULAUAN RIAU",44,70,97,167
2154,https://kawalpemilu.org#25685,"DABO, SINGKEP, LINGGA, KEPULAUAN RIAU",21,84,121,205
4126,https://kawalpemilu.org#25808,"BELIAN, BATAM KOTA, KOTA BATAM, KEPULAUAN RIAU",49,111,72,183
2189,https://kawalpemilu.org#25693,"BATU BERDAUN, SINGKEP, LINGGA, KEPULAUAN RIAU",3,90,79,169
790,https://kawalpemilu.org#25478,"KIJANG KOTA, BINTAN TIMUR, BINTAN, KEPULAUAN RIAU",38,123,128,251
368,https://kawalpemilu.org#25420,"KAMPUNG BUGIS, TANJUNG PINANG KOTA, KOTA TANJUNGPINANG, KEPULAUAN RIAU",2,88,144,232
222,https://kawalpemilu.org#25416,"BATU IX, TANJUNG PINANG TIMUR, KOTA TANJUNGPINANG, KEPULAUAN RIAU",2,127,124,251
2375,https://kawalpemilu.org#25738,"BAKONG, SINGKEP BARAT, LINGGA, KEPULAUAN RIAU",1,107,34,141
89,https://kawalpemilu.org#25410,"KAMPUNG BARU, TANJUNG PINANG BARAT, KOTA TANJUNGPINANG, KEPULAUAN RIAU",11,96,124,220
1103,https://kawalpemilu.org#25529,"TANJUNG PERMAI, SERI KUALA LOBAM, BINTAN, KEPULAUAN RIAU",1,87,128,215
23245,https://kawalpemilu.org#24718,"SEPANG JAYA, LABUHAN RATU, KOTA BANDAR LAMPUNG, LAMPUNG",2,76,90,166
13630,https://kawalpemilu.org#23747,"KAGUNGAN RAHAYU, MENGGALA, TULANG BAWANG, LAMPUNG",9,152,29,181
25410,https://kawalpemilu.org#24937,"SANGGI, PADANG CERMIN, PESAWARAN, LAMPUNG",3,128,76,204
6101,https://kawalpemilu.org#22896,"SIDO LUHUR, BANGUN REJO, LAMPUNG TENGAH, LAMPUNG",2,125,34,159
5639,https://kawalpemilu.org#22857,"MULYOSARI, TANJUNG SARI, LAMPUNG SELATAN, LAMPUNG",3,176,56,232
2642,https://kawalpemilu.org#22592,"SUKA JAYA, GUNUNG AGUNG, TULANG BAWANG BARAT, LAMPUNG",9,186,36,222
9071,https://kawalpemilu.org#23128,"NEGARA BUMI UDIK, ANAK TUHA, LAMPUNG TENGAH, LAMPUNG",4,154,46,200
3832,https://kawalpemilu.org#22675,"BANDAR DALAM, SIDOMULYO, LAMPUNG SELATAN, LAMPUNG",9,160,36,196
20506,https://kawalpemilu.org#24566,"CAMPUR ASRI, BARADATU, WAY KANAN, LAMPUNG",5,76,74,150
22850,https://kawalpemilu.org#24737,"WAY LAGA, SUKABUMI, KOTA BANDAR LAMPUNG, LAMPUNG",14,78,119,197
5822,https://kawalpemilu.org#22874,"BALI NURAGA, WAY PANJI, LAMPUNG SELATAN, LAMPUNG",11,92,20,112
24027,https://kawalpemilu.org#24770,"GARUNTANG, BUMI WARAS, KOTA BANDAR LAMPUNG, LAMPUNG",6,85,57,142
16961,https://kawalpemilu.org#24223,"MUARA GADING MAS, LABUHAN MARINGGAI, LAMPUNG TIMUR, LAMPUNG",28,186,36,222
21933,https://kawalpemilu.org#24735,"PANJANG UTARA, PANJANG, KOTA BANDAR LAMPUNG, LAMPUNG",26,105,68,173
21233,https://kawalpemilu.org#24689,"SRI BASUKI, NEGERI BESAR, WAY KANAN, LAMPUNG",4,128,22,150
13862,https://kawalpemilu.org#23775,"GEDUNG MENENG, GEDUNG MENENG, TULANG BAWANG, LAMPUNG",52,85,87,172
9172,https://kawalpemilu.org#23139,"SENDANG ASIH, SENDANG AGUNG, LAMPUNG TENGAH, LAMPUNG",14,203,28,231
3902,https://kawalpemilu.org#22682,"SUAK, SIDOMULYO, LAMPUNG SELATAN, LAMPUNG",12,125,31,156
5375,https://kawalpemilu.org#22831,"MERBAU MATARAM, MERBAU MATARAM, LAMPUNG SELATAN, LAMPUNG",16,113,59,172
863,https://kawalpemilu.org#22382,"CANDI RETNO, PAGELARAN, PRINGSEWU, LAMPUNG",8,86,121,207
5678,https://kawalpemilu.org#22859,"KERTOSARI, TANJUNG SARI, LAMPUNG SELATAN, LAMPUNG",18,137,35,172
8066,https://kawalpemilu.org#23051,"BULU SARI, BUMI RATU NUBAN, LAMPUNG TENGAH, LAMPUNG",1,100,71,171
21903,https://kawalpemilu.org#24734,"SRENGSEM, PANJANG, KOTA BANDAR LAMPUNG, LAMPUNG",20,70,33,103
18630,https://kawalpemilu.org#24369,"GUNUNG SUGIH BESAR, SEKAMPUNG UDIK, LAMPUNG TIMUR, LAMPUNG",17,92,101,193
24165,https://kawalpemilu.org#24827,"HADIMULYO BARAT, METRO PUSAT, KOTA METRO, LAMPUNG",7,71,129,200
12606,https://kawalpemilu.org#23510,"SEBARUS, BALIK BUKIT, LAMPUNG BARAT, LAMPUNG",1,21,170,191
2400,https://kawalpemilu.org#929403,"MULYO JADI, GUNUNG TERANG, TULANG BAWANG BARAT, LAMPUNG",3,140,77,217
10618,https://kawalpemilu.org#23261,"SIMPANG ABUNG, ABUNG BARAT, LAMPUNG UTARA, LAMPUNG",22,26,199,225
2975,https://kawalpemilu.org#22613,"MERAK BATIN, NATAR, LAMPUNG SELATAN, LAMPUNG",4,102,123,225
21507,https://kawalpemilu.org#24716,"SIDODADI, KEDATON, KOTA BANDAR LAMPUNG, LAMPUNG",23,70,64,134
25397,https://kawalpemilu.org#24936,"PADANG CERMIN, PADANG CERMIN, PESAWARAN, LAMPUNG",18,190,10,200
25272,https://kawalpemilu.org#24915,"TANJUNG AGUNG, WAY LIMA, PESAWARAN, LAMPUNG",5,81,167,248
5571,https://kawalpemilu.org#22850,"BAKAUHENI, BAKAUHENI, LAMPUNG SELATAN, LAMPUNG",26,123,38,161
25103,https://kawalpemilu.org#24898,"GEDUNG GUMANTI, TEGINENENG, PESAWARAN, LAMPUNG",13,161,13,174
24671,https://kawalpemilu.org#24860,"KEBAGUSAN, GEDONG TATAAN, PESAWARAN, LAMPUNG",11,78,142,220
7255,https://kawalpemilu.org#22979,"RAMAYANA, SEPUTIH RAMAN, LAMPUNG TENGAH, LAMPUNG",4,145,74,219
16203,https://kawalpemilu.org#24138,"GISTING ATAS, GISTING, TANGGAMUS, LAMPUNG",1,130,81,211
13050,https://kawalpemilu.org#23569,"KOTA BESI, BATU BRAK, LAMPUNG BARAT, LAMPUNG",5,41,117,158
8677,https://kawalpemilu.org#23086,"MATARAM UDIK, BANDAR MATARAM, LAMPUNG TENGAH, LAMPUNG",106,111,43,154
20387,https://kawalpemilu.org#24547,"NEKI, BANJIT, WAY KANAN, LAMPUNG",1,36,98,134
180,https://kawalpemilu.org#22337,"WALUYOJATI, PRINGSEWU, PRINGSEWU, LAMPUNG",3,71,60,131
20055,https://kawalpemilu.org#24497,"UMPU BHAKTI, BLAMBANGAN UMPU, WAY KANAN, LAMPUNG",3,104,67,171
18845,https://kawalpemilu.org#24390,"DONO MULYO, BUMI AGUNG, LAMPUNG TIMUR, LAMPUNG",2,170,44,214
7739,https://kawalpemilu.org#23024,"SUMBER KATON, SEPUTIH SURABAYA, LAMPUNG TENGAH, LAMPUNG",13,112,83,195
20235,https://kawalpemilu.org#24526,"TANGKAS, KASUI, WAY KANAN, LAMPUNG",2,39,53,92
463,https://kawalpemilu.org#22353,"TEGAL SARI, GADING REJO, PRINGSEWU, LAMPUNG",13,83,70,153
21907,https://kawalpemilu.org#24734,"SRENGSEM, PANJANG, KOTA BANDAR LAMPUNG, LAMPUNG",24,88,42,130
22853,https://kawalpemilu.org#24737,"WAY LAGA, SUKABUMI, KOTA BANDAR LAMPUNG, LAMPUNG",17,71,44,115
16565,https://kawalpemilu.org#24188,"BANJARMASIN, BULOK, TANGGAMUS, LAMPUNG",7,114,24,138
19667,https://kawalpemilu.org#24453,"RAJABASA LAMA I, LABUHAN RATU, LAMPUNG TIMUR, LAMPUNG",11,94,72,166
21383,https://kawalpemilu.org#24706,"WONO HARJO, BUMI AGUNG, WAY KANAN, LAMPUNG",1,74,88,162
3467,https://kawalpemilu.org#22638,"TRIMULYO, TANJUNG BINTANG, LAMPUNG SELATAN, LAMPUNG",2,193,25,218
3397,https://kawalpemilu.org#22633,"SERDANG, TANJUNG BINTANG, LAMPUNG SELATAN, LAMPUNG",28,89,55,144
12432,https://kawalpemilu.org#23442,"CAHAYA MAS, SUNGKAI BARAT, LAMPUNG UTARA, LAMPUNG",3,55,85,140
19396,https://kawalpemilu.org#24430,"KEDUNG RINGIN, PASIR SAKTI, LAMPUNG TIMUR, LAMPUNG",11,126,17,143
23890,https://kawalpemilu.org#87276,"KOTA KARANG RAYA, TELUKBETUNG TIMUR, KOTA BANDAR LAMPUNG, LAMPUNG",15,116,126,242
21772,https://kawalpemilu.org#24728,"SEGALAMIDER, TANJUNGKARANG BARAT, KOTA BANDAR LAMPUNG, LAMPUNG",9,66,151,217
16631,https://kawalpemilu.org#24196,"LENGKUKAI, KLUMBAYAN BARAT, TANGGAMUS, LAMPUNG",12,32,29,61
15452,https://kawalpemilu.org#24018,"GUNUNG KASIH, PUGUNG, TANGGAMUS, LAMPUNG",6,49,87,136
5240,https://kawalpemilu.org#22821,"CINTA MULYA, CANDIPURO, LAMPUNG SELATAN, LAMPUNG",5,135,55,190
26072,https://kawalpemilu.org#23482,"PASAR KRUI, PESISIR TENGAH, PESISIR BARAT, LAMPUNG",7,57,120,177
10231,https://kawalpemilu.org#23223,"SIDODADI, SUNGKAI SELATAN, LAMPUNG UTARA, LAMPUNG",50,71,120,191
13200,https://kawalpemilu.org#23677,"SUKA BANJAR II UJUNG REMBUN, LUMBOK SEMINUNG, LAMPUNG BARAT, LAMPUNG",3,130,56,186
16442,https://kawalpemilu.org#24173,"SINAR BANGUN, BANDAR NEGERI SEMUONG, TANGGAMUS, LAMPUNG",1,26,140,166
17857,https://kawalpemilu.org#24300,"BRAJA DEWA, WAY JEPARA, LAMPUNG TIMUR, LAMPUNG",1,108,55,163
20544,https://kawalpemilu.org#24572,"BANJAR BARU, BARADATU, WAY KANAN, LAMPUNG",3,49,129,178
5126,https://kawalpemilu.org#22801,"BETUNG, RAJA BASA, LAMPUNG SELATAN, LAMPUNG",3,59,108,167
8856,https://kawalpemilu.org#23102,"PAYUNG DADI, PUBIAN, LAMPUNG TENGAH, LAMPUNG",5,102,103,205
5025,https://kawalpemilu.org#22790,"BAKTI RASA, SRAGI, LAMPUNG SELATAN, LAMPUNG",1,126,90,216
99,https://kawalpemilu.org#-991144,"Melbourne, Melbourne, Australia, Luar Negeri",1001,655,88,743
425,https://kawalpemilu.org#-991084,"Johor Bahru, Johor Bahru, Malaysia, Luar Negeri",2015,123,37,160
19,https://kawalpemilu.org#-991124,"Los Angeles, Los Angeles, Amerika Serikat, Luar Negeri",1002,577,39,616
934,https://kawalpemilu.org#-990344,"Dili, Dili, Timor Leste, Luar Negeri",5,336,84,420
541,https://kawalpemilu.org#-991084,"Johor Bahru, Johor Bahru, Malaysia, Luar Negeri",2187,110,118,228
587,https://kawalpemilu.org#-991084,"Johor Bahru, Johor Bahru, Malaysia, Luar Negeri",2246,27,87,114
921,https://kawalpemilu.org#-991304,"Taipei, Taipei, Taiwan, Luar Negeri",2002,125,17,142
799,https://kawalpemilu.org#-990784,"Singapura, Singapura, Singapura, Luar Negeri",36,611,93,704
1110,https://kawalpemilu.org#77502,"BOBISINGO, GALELA UTARA, HALMAHERA UTARA, MALUKU UTARA",3,70,139,209
3459,https://kawalpemilu.org#77938,"NUNCA, TALIABU UTARA, PULAU TALIABU, MALUKU UTARA",3,133,27,160
2666,https://kawalpemilu.org#78075,"BASTIONG KARANCE, KOTA TERNATE SELATAN, KOTA TERNATE, MALUKU UTARA",2,59,70,129
2673,https://kawalpemilu.org#78075,"BASTIONG KARANCE, KOTA TERNATE SELATAN, KOTA TERNATE, MALUKU UTARA",9,33,49,82
2579,https://kawalpemilu.org#78065,"BASTIONG TALANGAME, KOTA TERNATE SELATAN, KOTA TERNATE, MALUKU UTARA",12,46,78,124
3071,https://kawalpemilu.org#78131,"GOTO, TIDORE, KOTA TIDORE KEPULAUAN, MALUKU UTARA",1,102,95,197
3155,https://kawalpemilu.org#928250,"GOSALE, OBA UTARA, KOTA TIDORE KEPULAUAN, MALUKU UTARA",2,161,5,166
1100,https://kawalpemilu.org#77497,"SAMUDA, GALELA BARAT, HALMAHERA UTARA, MALUKU UTARA",3,201,1,202
1557,https://kawalpemilu.org#77702,"LALUIN, KAYOA SELATAN, HALMAHERA SELATAN, MALUKU UTARA",4,92,117,209
1991,https://kawalpemilu.org#86130,"KABAU DARAT, SULABESI BARAT, KEPULAUAN SULA, MALUKU UTARA",1,22,97,119
2544,https://kawalpemilu.org#91174,"KAMPUNG BARU, TELUK WARU, SERAM BAGIAN TIMUR, MALUKU",1,95,33,128
3680,https://kawalpemilu.org#77023,"BATU MERAH, SIRIMAU, KOTA AMBON, MALUKU",86,45,205,250
3806,https://kawalpemilu.org#77027,"PASSO, BAGUALA, KOTA AMBON, MALUKU",10,188,12,200
1557,https://kawalpemilu.org#76344,"NAMTO, SERAM UTARA TIMUR SETI, MALUKU TENGAH, MALUKU",1,139,12,151
595,https://kawalpemilu.org#76310,"WATLUDAN, TEON NILA SERUA, MALUKU TENGAH, MALUKU",2,116,17,133
2392,https://kawalpemilu.org#76765,"KILMOY, TUTUK TOLU, SERAM BAGIAN TIMUR, MALUKU",1,51,198,249
3160,https://kawalpemilu.org#76997,"NEGERI NUSANIWE, NUSANIWE, KOTA AMBON, MALUKU",9,178,13,191
2918,https://kawalpemilu.org#76863,"MASAWOI, KEPULAUAN MANIPA, SERAM BAGIAN BARAT, MALUKU",2,34,27,61
2113,https://kawalpemilu.org#76676,"WAEKASAR, WAEAPO, BURU, MALUKU",6,137,43,180
3825,https://kawalpemilu.org#77027,"PASSO, BAGUALA, KOTA AMBON, MALUKU",29,206,8,214
422,https://kawalpemilu.org#76282,"UNETH, FENA FAFAN, BURU SELATAN, MALUKU",2,165,12,177
2498,https://kawalpemilu.org#86074,"JAKARTA BARU, BULA BARAT, SERAM BAGIAN TIMUR, MALUKU",2,130,15,145
400,https://kawalpemilu.org#76271,"LEKSULA, LEKSULA, BURU SELATAN, MALUKU",11,121,29,150
2465,https://kawalpemilu.org#76750,"KILKODA, GOROM TIMUR, SERAM BAGIAN TIMUR, MALUKU",2,72,132,204
13036,https://kawalpemilu.org#54862,"BUGIS, TALIWANG, SUMBAWA BARAT, NUSA TENGGARA BARAT",12,38,185,223
11593,https://kawalpemilu.org#54685,"LEU, BOLO, BIMA, NUSA TENGGARA BARAT",5,21,170,191
3303,https://kawalpemilu.org#54171,"REMBITAN, PUJUT, LOMBOK TENGAH, NUSA TENGGARA BARAT",1,113,86,199
14498,https://kawalpemilu.org#54977,"BERTAIS, SANDUBAYA, KOTA MATARAM, NUSA TENGGARA BARAT",27,55,123,178
3076,https://kawalpemilu.org#54160,"BARABALI, BATUKLIANG, LOMBOK TENGAH, NUSA TENGGARA BARAT",36,24,92,116
12041,https://kawalpemilu.org#54735,"SANGIA, SAPE, BIMA, NUSA TENGGARA BARAT",5,9,198,207
13681,https://kawalpemilu.org#54941,"PAGESANGAN BARAT, MATARAM, KOTA MATARAM, NUSA TENGGARA BARAT",2,62,127,189
11866,https://kawalpemilu.org#54713,"RENDA, BELO, BIMA, NUSA TENGGARA BARAT",6,10,173,183
7784,https://kawalpemilu.org#87728,"PESANGGRAHAN, MONTONG GADING, LOMBOK TIMUR, NUSA TENGGARA BARAT",13,80,89,169
10019,https://kawalpemilu.org#54485,"PRODE SP I, PLAMPANG, SUMBAWA, NUSA TENGGARA BARAT",2,18,148,166
1459,https://kawalpemilu.org#85002,"GELANGSAR, GUNUNGSARI, LOMBOK BARAT, NUSA TENGGARA BARAT",3,66,91,157
3248,https://kawalpemilu.org#54168,"PENGENGAT, PUJUT, LOMBOK TENGAH, NUSA TENGGARA BARAT",12,81,67,148
5987,https://kawalpemilu.org#85031,"PANDAN DURI, TERARA, LOMBOK TIMUR, NUSA TENGGARA BARAT",4,101,79,180
10088,https://kawalpemilu.org#54495,"EMPANG BAWA, EMPANG, SUMBAWA, NUSA TENGGARA BARAT",9,116,97,213
2248,https://kawalpemilu.org#54127,"GERUNUNG, PRAYA, LOMBOK TENGAH, NUSA TENGGARA BARAT",9,47,104,151
1167,https://kawalpemilu.org#54078,"KARANG BONGKOT, LABUAPI, LOMBOK BARAT, NUSA TENGGARA BARAT",18,23,164,187
14173,https://kawalpemilu.org#54962,"TANJUNG KARANG PERMAI, SEKARBELA, KOTA MATARAM, NUSA TENGGARA BARAT",22,52,139,191
287,https://kawalpemilu.org#54035,"KEDIRI, KEDIRI, LOMBOK BARAT, NUSA TENGGARA BARAT",14,12,186,198
14825,https://kawalpemilu.org#55001,"JATIBARU, ASAKOTA, KOTA BIMA, NUSA TENGGARA BARAT",1,33,212,245
5059,https://kawalpemilu.org#54241,"MONTONG SAPAH, PRAYA BARAT DAYA, LOMBOK TENGAH, NUSA TENGGARA BARAT",4,18,178,196
4868,https://kawalpemilu.org#54232,"SASAKE, PRAYA TENGAH, LOMBOK TENGAH, NUSA TENGGARA BARAT",10,45,88,133
9871,https://kawalpemilu.org#54466,"MAMAN, MOYO HULU, SUMBAWA, NUSA TENGGARA BARAT",1,41,162,203
6356,https://kawalpemilu.org#54291,"MASBAGIK SELATAN, MASBAGIK, LOMBOK TIMUR, NUSA TENGGARA BARAT",36,9,86,95
5391,https://kawalpemilu.org#54257,"AIK BERIK, BATUKLIANG UTARA, LOMBOK TENGAH, NUSA TENGGARA BARAT",19,42,98,140
12437,https://kawalpemilu.org#54783,"KARUMBU, LANGGUDU, BIMA, NUSA TENGGARA BARAT",8,16,190,206
11241,https://kawalpemilu.org#54648,"DOROPETI, PEKAT, DOMPU, NUSA TENGGARA BARAT",8,75,57,132
3037,https://kawalpemilu.org#54159,"TAMPAK SIRING, BATUKLIANG, LOMBOK TENGAH, NUSA TENGGARA BARAT",13,18,102,120
1569,https://kawalpemilu.org#54099,"KARANG BAYAN, LINGSAR, LOMBOK BARAT, NUSA TENGGARA BARAT",16,51,113,164
6865,https://kawalpemilu.org#54311,"KELAYU UTARA, SELONG, LOMBOK TIMUR, NUSA TENGGARA BARAT",7,115,88,203
10118,https://kawalpemilu.org#54500,"BUNGA EJA, EMPANG, SUMBAWA, NUSA TENGGARA BARAT",2,76,165,241
507,https://kawalpemilu.org#54049,"KERU, NARMADA, LOMBOK BARAT, NUSA TENGGARA BARAT",6,67,134,201
6223,https://kawalpemilu.org#87729,"GELORA, SIKUR, LOMBOK TIMUR, NUSA TENGGARA BARAT",5,46,127,173
6681,https://kawalpemilu.org#54303,"PANCOR, SELONG, LOMBOK TIMUR, NUSA TENGGARA BARAT",13,120,106,226
4934,https://kawalpemilu.org#54236,"LAJUT, PRAYA TENGAH, LOMBOK TENGAH, NUSA TENGGARA BARAT",8,31,180,211
7015,https://kawalpemilu.org#54319,"BATUYANG, PRINGGABAYA, LOMBOK TIMUR, NUSA TENGGARA BARAT",13,52,168,220
3302,https://kawalpemilu.org#54170,"GAPURA, PUJUT, LOMBOK TENGAH, NUSA TENGGARA BARAT",10,60,158,218
9806,https://kawalpemilu.org#54454,"LABUHAN IJUK, MOYO HILIR, SUMBAWA, NUSA TENGGARA BARAT",1,123,112,235
3618,https://kawalpemilu.org#54183,"KATENG, PRAYA BARAT, LOMBOK TENGAH, NUSA TENGGARA BARAT",2,21,167,188
13706,https://kawalpemilu.org#54941,"PAGESANGAN BARAT, MATARAM, KOTA MATARAM, NUSA TENGGARA BARAT",27,41,184,225
8277,https://kawalpemilu.org#54362,"TEMBENG PUTIK, WANASABA, LOMBOK TIMUR, NUSA TENGGARA BARAT",18,19,221,240
8603,https://kawalpemilu.org#88674,"KALEMBU ANA KAKA, TANA RIGHU, SUMBA BARAT, NUSA TENGGARA TIMUR",1,116,11,127
9038,https://kawalpemilu.org#57477,"LEWOLEBA UTARA, NUBATUKAN, LEMBATA, NUSA TENGGARA TIMUR",8,93,65,158
7883,https://kawalpemilu.org#57172,"KAMALAPUTI, KOTA WAINGAPU, SUMBA TIMUR, NUSA TENGGARA TIMUR",7,181,34,215
8291,https://kawalpemilu.org#57277,"TANDULA JANGGA, KARERA, SUMBA TIMUR, NUSA TENGGARA TIMUR",2,141,2,143
6304,https://kawalpemilu.org#56886,"KOTA RATU, ENDE UTARA, ENDE, NUSA TENGGARA TIMUR",1,149,36,185
3636,https://kawalpemilu.org#56084,"ALAANG, ALOR BARAT LAUT, ALOR, NUSA TENGGARA TIMUR",3,203,16,219
3113,https://kawalpemilu.org#55949,"TENUKIIK, KOTA ATAMBUA, BELU, NUSA TENGGARA TIMUR",13,141,22,163
9450,https://kawalpemilu.org#931345,"LEKUNIK, LOBALAIN, ROTE NDAO, NUSA TENGGARA TIMUR",1,165,31,196
13744,https://kawalpemilu.org#91330,"BENTENG PAU, ELAR SELATAN, MANGGARAI TIMUR, NUSA TENGGARA TIMUR",1,97,9,106
2257,https://kawalpemilu.org#55667,"OEPERIGI, NOEMUTI, TIMOR TENGAH UTARA, NUSA TENGGARA TIMUR",1,176,18,194
5127,https://kawalpemilu.org#56565,"TALIBURA, TALIBURA, SIKKA, NUSA TENGGARA TIMUR",5,179,12,191
6234,https://kawalpemilu.org#56855,"PEMO, KELIMUTU, ENDE, NUSA TENGGARA TIMUR",2,110,21,131
3513,https://kawalpemilu.org#56061,"MUTIARA, TELUK MUTIARA, ALOR, NUSA TENGGARA TIMUR",5,161,17,178
11351,https://kawalpemilu.org#58013,"UMBU NGEDO, KODI BANGEDO, SUMBA BARAT DAYA, NUSA TENGGARA TIMUR",1,136,11,147
13883,https://kawalpemilu.org#58252,"LOBORAI, SABU TIMUR, SABU RAIJUA, NUSA TENGGARA TIMUR",1,152,2,154
1985,https://kawalpemilu.org#55589,"LAKAT, KUATNANA, TIMOR TENGAH SELATAN, NUSA TENGGARA TIMUR",1,229,25,254
3560,https://kawalpemilu.org#56067,"MOTONGBANG, TELUK MUTIARA, ALOR, NUSA TENGGARA TIMUR",1,81,57,138
1840,https://kawalpemilu.org#55551,"TUAPAKAS, KUALIN, TIMOR TENGAH SELATAN, NUSA TENGGARA TIMUR",3,230,14,244
6646,https://kawalpemilu.org#56960,"MASUMELI, SOA, NGADA, NUSA TENGGARA TIMUR",1,229,13,242
10883,https://kawalpemilu.org#85227,"OLE DEWA, MAMBORO, SUMBA TENGAH, NUSA TENGGARA TIMUR",2,137,15,152
343,https://kawalpemilu.org#55167,"APREN, AMARASI, KUPANG, NUSA TENGGARA TIMUR",2,213,8,221
11183,https://kawalpemilu.org#57982,"WEE KOMBAKA, WEWEWA BARAT, SUMBA BARAT DAYA, NUSA TENGGARA TIMUR",4,250,1,251
12298,https://kawalpemilu.org#58065,"KELAPA LIMA, KELAPA LIMA, KOTA KUPANG, NUSA TENGGARA TIMUR",36,143,15,158
10182,https://kawalpemilu.org#927937,"WATU RAMBUNG, LEMBOR SELATAN, MANGGARAI BARAT, NUSA TENGGARA TIMUR",7,87,9,96
4350,https://kawalpemilu.org#56339,"WULUBLOLONG, SOLOR TIMUR, FLORES TIMUR, NUSA TENGGARA TIMUR",3,124,7,131
8652,https://kawalpemilu.org#57366,"DEDE KADU, LOLI, SUMBA BARAT, NUSA TENGGARA TIMUR",6,203,15,218
4558,https://kawalpemilu.org#56417,"WATOONE, WITIHAMA, FLORES TIMUR, NUSA TENGGARA TIMUR",3,217,6,223
532,https://kawalpemilu.org#55240,"OEMASI, NEKAMESE, KUPANG, NUSA TENGGARA TIMUR",2,187,6,193
8604,https://kawalpemilu.org#88674,"KALEMBU ANA KAKA, TANA RIGHU, SUMBA BARAT, NUSA TENGGARA TIMUR",2,130,2,132
10579,https://kawalpemilu.org#85213,"RAJA SELATAN, BOAWAE, NAGEKEO, NUSA TENGGARA TIMUR",3,153,4,157
6198,https://kawalpemilu.org#56839,"LOBONIKI, KOTA BARU, ENDE, NUSA TENGGARA TIMUR",2,213,10,223
4306,https://kawalpemilu.org#56312,"TANAH LEIN, SOLOR BARAT, FLORES TIMUR, NUSA TENGGARA TIMUR",3,89,2,91
2135,https://kawalpemilu.org#55631,"FEMNASI, MIOMAFO TIMUR, TIMOR TENGAH UTARA, NUSA TENGGARA TIMUR",1,233,15,248
10830,https://kawalpemilu.org#85224,"MATA WAIKAJAWI, UMBU RATU NGGAY BARAT, SUMBA TENGAH, NUSA TENGGARA TIMUR",2,164,10,174
9743,https://kawalpemilu.org#57701,"DALENG, LEMBOR, MANGGARAI BARAT, NUSA TENGGARA TIMUR",6,207,12,219
13575,https://kawalpemilu.org#58120,"TOROK GOLO, RANA MESE, MANGGARAI TIMUR, NUSA TENGGARA TIMUR",3,184,1,185
3659,https://kawalpemilu.org#56091,"PROBUR, ALOR BARAT DAYA, ALOR, NUSA TENGGARA TIMUR",6,201,4,205
266,https://kawalpemilu.org#927833,"MAKIRI, AIFAT TIMUR SELATAN, MAYBRAT, PAPUA BARAT",1,67,0,67
185,https://kawalpemilu.org#927683,"ORAIN, AYAMARU JAYA, MAYBRAT, PAPUA BARAT",1,135,5,140
92,https://kawalpemilu.org#81941,"FATEGOMI, AITINYO UTARA, MAYBRAT, PAPUA BARAT",1,166,0,166
932,https://kawalpemilu.org#83141,"AMBUAR, WAMESA, TELUK WONDAMA, PAPUA BARAT",1,114,0,114
515,https://kawalpemilu.org#82350,"MANOKWARI BARAT, MANOKWARI BARAT, MANOKWARI, PAPUA BARAT",68,145,63,208
862,https://kawalpemilu.org#83109,"WASIOR I, WASIOR, TELUK WONDAMA, PAPUA BARAT",11,75,26,101
206,https://kawalpemilu.org#927699,"ASES, AYAMARU SELATAN JAYA, MAYBRAT, PAPUA BARAT",1,183,10,193
232,https://kawalpemilu.org#81987,"SENI, MARE SELATAN, MAYBRAT, PAPUA BARAT",1,144,0,144
759,https://kawalpemilu.org#82859,"RAUKI, SUPNIN, RAJA AMPAT, PAPUA BARAT",1,148,4,152
617,https://kawalpemilu.org#82866,"SAONEK, WAIGEO SELATAN, RAJA AMPAT, PAPUA BARAT",1,156,63,219
3559,https://kawalpemilu.org#81489,"TOLIKAPURA, AMUMA, YAHUKIMO, PAPUA",2,298,0,298
1500,https://kawalpemilu.org#79834,"BAMBU PEMALI, MERAUKE, MERAUKE, PAPUA",8,110,55,165
2080,https://kawalpemilu.org#80146,"SENTANI KOTA, SENTANI, JAYAPURA, PAPUA",44,108,101,209
2136,https://kawalpemilu.org#80148,"DOBONSOLO, SENTANI, JAYAPURA, PAPUA",15,108,99,207
954,https://kawalpemilu.org#89151,"KUYAWAGE, KUYAWAGE, LANNY JAYA, PAPUA",2,171,0,171
3330,https://kawalpemilu.org#86493,"BOB, BIME, PEGUNUNGAN BINTANG, PAPUA",2,272,0,272
86,https://kawalpemilu.org#78589,"BOKONERI, BOKONERI, TOLIKARA, PAPUA",1,155,0,155
1977,https://kawalpemilu.org#79994,"WETAU, WAAN, MERAUKE, PAPUA",1,182,5,187
2620,https://kawalpemilu.org#80879,"BEKO, PANIAI BARAT, PANIAI, PAPUA",2,75,100,175
3301,https://kawalpemilu.org#81306,"ABMISIBIL, OKBIBAB, PEGUNUNGAN BINTANG, PAPUA",2,284,0,284
3613,https://kawalpemilu.org#81604,"NAHOMAS, KOSAREK, YAHUKIMO, PAPUA",5,200,0,200
2197,https://kawalpemilu.org#80189,"SKOAIM, KEMTUK, JAYAPURA, PAPUA",1,92,3,95
244,https://kawalpemilu.org#79008,"ASIKI I, JAIR, BOVEN DIGOEL, PAPUA",37,162,35,197
2954,https://kawalpemilu.org#81015,"TIMIKA JAYA, MIMIKA BARU, MIMIKA, PAPUA",18,168,128,296
680,https://kawalpemilu.org#79443,"YOBE, ABEPURA, KOTA JAYAPURA, PAPUA",32,76,86,162
2319,https://kawalpemilu.org#86230,"YEGEUGI, MENOU, NABIRE, PAPUA",1,225,0,225
3761,https://kawalpemilu.org#81758,"LANGDA, LANGDA, YAHUKIMO, PAPUA",6,300,0,300
3569,https://kawalpemilu.org#81494,"GOLOWEN, AMUMA, YAHUKIMO, PAPUA",1,300,0,300
2305,https://kawalpemilu.org#80316,"OYEHE, NABIRE, NABIRE, PAPUA",18,143,151,294
3142,https://kawalpemilu.org#81175,"ARARE, PANTAI TIMUR BAGIAN BARAT, SARMI, PAPUA",1,271,16,287
1296,https://kawalpemilu.org#929792,"NUMBOKAWI, MELAGI, LANNY JAYA, PAPUA",6,267,0,267
607,https://kawalpemilu.org#79425,"TRIKORA, JAYAPURA UTARA, KOTA JAYAPURA, PAPUA",6,143,40,183
1524,https://kawalpemilu.org#79835,"SERINGGU JAYA, MERAUKE, MERAUKE, PAPUA",9,165,40,205
522,https://kawalpemilu.org#79394,"BAGUSA, MAMBERAMO HILIR, MAMBERAMO RAYA, PAPUA",2,41,1,42
2508,https://kawalpemilu.org#86245,"SWAINOBER, SWANDIWE, BIAK NUMFOR, PAPUA",1,117,0,117
1728,https://kawalpemilu.org#79885,"SUMBER HARAPAN, TANAH MIRING, MERAUKE, PAPUA",5,173,23,196
2818,https://kawalpemilu.org#930532,"TINOU, MUYE, PANIAI, PAPUA",1,200,0,200
3311,https://kawalpemilu.org#81333,"BATOM, BATOM, PEGUNUNGAN BINTANG, PAPUA",1,265,0,265
3425,https://kawalpemilu.org#86571,"SEGAME, BATANI, PEGUNUNGAN BINTANG, PAPUA",2,232,0,232
381,https://kawalpemilu.org#79323,"FANJUR, SUPIORI UTARA, SUPIORI, PAPUA",1,117,2,119
2099,https://kawalpemilu.org#80146,"SENTANI KOTA, SENTANI, JAYAPURA, PAPUA",64,169,16,185
1677,https://kawalpemilu.org#79878,"KUPER, SEMANGGA, MERAUKE, PAPUA",1,124,30,154
1134,https://kawalpemilu.org#929711,"BALIEMPURA, BALINGGA BARAT, LANNY JAYA, PAPUA",1,256,0,256
1108,https://kawalpemilu.org#929698,"PIRAGI, WANO BARAT, LANNY JAYA, PAPUA",1,254,0,254
2572,https://kawalpemilu.org#80863,"AIKAI, PANIAI TIMUR, PANIAI, PAPUA",1,0,243,243
1708,https://kawalpemilu.org#79882,"WANINGGAP KAY, SEMANGGA, MERAUKE, PAPUA",2,53,127,180
159,https://kawalpemilu.org#78496,"WALELO, BOGONUK, TOLIKARA, PAPUA",1,209,0,209
2407,https://kawalpemilu.org#80655,"SUMBINYA, BIAK BARAT, BIAK NUMFOR, PAPUA",1,177,6,183
1901,https://kawalpemilu.org#14315,"SEKIJANG, TAPUNG HILIR, KAMPAR, RIAU",25,63,57,120
527,https://kawalpemilu.org#14149,"MENGKIRAU, TASIK PUTRI PUYU, KEPULAUAN MERANTI, RIAU",6,78,39,117
1335,https://kawalpemilu.org#14229,"PANDAU JAYA, SIAK HULU, KAMPAR, RIAU",11,73,139,212
3270,https://kawalpemilu.org#14496,"SEMELINANG DARAT, PERANAP, INDRAGIRI HULU, RIAU",1,66,165,231
11905,https://kawalpemilu.org#15467,"MERANGKAI, DAYUN, SIAK, RIAU",2,123,48,171
14136,https://kawalpemilu.org#15816,"TANGKERANG UTARA, BUKIT RAYA, KOTA PEKANBARU, RIAU",30,123,122,245
5206,https://kawalpemilu.org#928965,"SIMPANG PADANG, BATHIN SOLAPAN, BENGKALIS, RIAU",33,23,216,239
7207,https://kawalpemilu.org#14947,"Karya Tani, Kempas, INDRAGIRI HILIR, RIAU",3,42,77,119
9023,https://kawalpemilu.org#15186,"RAMBAH, RAMBAH HILIR, ROKAN HULU, RIAU",10,25,127,152
8033,https://kawalpemilu.org#15055,"PANGKALAN TERAP, TELUK MERANTI, PELALAWAN, RIAU",2,65,99,164
1545,https://kawalpemilu.org#14259,"GADING PERMAI, KAMPAR KIRI HILIR, KAMPAR, RIAU",2,24,138,162
14205,https://kawalpemilu.org#931182,"AIRDINGIN, BUKIT RAYA, KOTA PEKANBARU, RIAU",7,41,161,202
8133,https://kawalpemilu.org#15073,"KIAB JAYA, BANDAR SEI KIJANG, PELALAWAN, RIAU",8,76,141,217
2972,https://kawalpemilu.org#14440,"PEKAN HERAN, RENGAT BARAT, INDRAGIRI HULU, RIAU",1,76,180,256
6789,https://kawalpemilu.org#14878,"Keritang, Kemuning, INDRAGIRI HILIR, RIAU",4,138,56,194
5076,https://kawalpemilu.org#14737,"TASIK SERAI, TALANG MUANDAU, BENGKALIS, RIAU",2,227,5,232
13310,https://kawalpemilu.org#15600,"MUARO SENTAJO, SENTAJO RAYA, KUANTAN SINGINGI, RIAU",1,19,231,250
3675,https://kawalpemilu.org#14559,"SEKO LUBUK TIGO, LIRIK, INDRAGIRI HULU, RIAU",4,33,96,129
13120,https://kawalpemilu.org#15736,"RAWANG BINJAI, PANGEAN, KUANTAN SINGINGI, RIAU",1,46,128,174
5628,https://kawalpemilu.org#14776,"Tembilahan Kota, Tembilahan, INDRAGIRI HILIR, RIAU",70,30,110,140
4347,https://kawalpemilu.org#14669,"BUKIT BATU, BUKIT BATU, BENGKALIS, RIAU",2,46,172,218
5089,https://kawalpemilu.org#14738,"MELIBUR, TALANG MUANDAU, BENGKALIS, RIAU",1,92,14,106
7862,https://kawalpemilu.org#15020,"SERING, PELALAWAN, PELALAWAN, RIAU",2,32,185,217
16080,https://kawalpemilu.org#15864,"BULUH KASAP, DUMAI TIMUR, KOTA DUMAI, RIAU",23,36,101,137
2954,https://kawalpemilu.org#14436,"BARANGAN, RENGAT BARAT, INDRAGIRI HULU, RIAU",1,88,98,186
3535,https://kawalpemilu.org#14532,"LAHAI KEMUNING, BATANG CENAKU, INDRAGIRI HULU, RIAU",3,117,78,195
503,https://kawalpemilu.org#14102,"TELUK BUNTAL, TEBING TINGGI TIMUR, KEPULAUAN MERANTI, RIAU",2,65,118,183
12205,https://kawalpemilu.org#15512,"TELAGA SAM-SAM, KANDIS, SIAK, RIAU",7,129,169,298
4703,https://kawalpemilu.org#14698,"TANJUNGKAPAL, RUPAT, BENGKALIS, RIAU",12,125,20,145
15851,https://kawalpemilu.org#15850,"PANGKALAN SESAI, DUMAI BARAT, KOTA DUMAI, RIAU",24,85,170,255
14451,https://kawalpemilu.org#15822,"DELIMA, TAMPAN, KOTA PEKANBARU, RIAU",11,31,164,195
7705,https://kawalpemilu.org#14996,"PANGKALAN LESUNG, PANGKALAN LESUNG, PELALAWAN, RIAU",1,32,223,255
1984,https://kawalpemilu.org#14327,"GERBANG SARI, TAPUNG HILIR, KAMPAR, RIAU",1,114,47,161
14640,https://kawalpemilu.org#931186,"SIALANGMUNGGU, TAMPAN, KOTA PEKANBARU, RIAU",77,35,202,237
14450,https://kawalpemilu.org#15822,"DELIMA, TAMPAN, KOTA PEKANBARU, RIAU",10,26,126,152
9396,https://kawalpemilu.org#15215,"DAYO, TANDUN, ROKAN HULU, RIAU",6,134,87,221
14866,https://kawalpemilu.org#15826,"SIDOMULYO TIMUR, MARPOYAN DAMAI, KOTA PEKANBARU, RIAU",39,30,104,134
10365,https://kawalpemilu.org#15329,"SUKA MAJU, BAGAN SINEMBAH, ROKAN HILIR, RIAU",2,132,109,241
5041,https://kawalpemilu.org#14674,"TENGGAYUN, BANDAR LAKSAMANA, BENGKALIS, RIAU",7,22,190,212
4228,https://kawalpemilu.org#14660,"JANGKANG, BANTAN, BENGKALIS, RIAU",2,69,115,184
470,https://kawalpemilu.org#89479,"PANGKALAN BALAI, PULAUMERBAU, KEPULAUAN MERANTI, RIAU",1,31,107,138
398,https://kawalpemilu.org#14146,"MERANTI BUNTING, MERBAU, KEPULAUAN MERANTI, RIAU",2,91,73,164
10025,https://kawalpemilu.org#15294,"UJUNG TANJUNG, TANAH PUTIH, ROKAN HILIR, RIAU",8,106,83,189
13594,https://kawalpemilu.org#15792,"CINTA RAJA, SAIL, KOTA PEKANBARU, RIAU",13,39,171,210
1260,https://kawalpemilu.org#75724,"TONDOK BAKARU, MAMASA, MAMASA, SULAWESI BARAT",2,227,31,258
496,https://kawalpemilu.org#75507,"RIMUKU, MAMUJU, MAMUJU, SULAWESI BARAT",22,91,135,226
524,https://kawalpemilu.org#75509,"KARAMPUANG, MAMUJU, MAMUJU, SULAWESI BARAT",10,37,70,107
947,https://kawalpemilu.org#75626,"LELING, TOMMO, MAMUJU, SULAWESI BARAT",2,73,23,96
954,https://kawalpemilu.org#75628,"SANDANA, TOMMO, MAMUJU, SULAWESI BARAT",2,172,17,189
536,https://kawalpemilu.org#75511,"BATU PANNU, MAMUJU, MAMUJU, SULAWESI BARAT",1,130,110,240
3542,https://kawalpemilu.org#75557,"PASSAPA, BUDONG-BUDONG, MAMUJU TENGAH, SULAWESI BARAT",5,172,2,174
2318,https://kawalpemilu.org#75933,"TONYAMAN, BINUANG, POLEWALI MANDAR, SULAWESI BARAT",14,130,53,183
301,https://kawalpemilu.org#75477,"PAJALELE, TIKKE RAYA, MAMUJU UTARA, SULAWESI BARAT",5,99,40,139
2464,https://kawalpemilu.org#75959,"UGIBARU, MAPILLI, POLEWALI MANDAR, SULAWESI BARAT",1,106,133,239
3545,https://kawalpemilu.org#69788,"TOGO-TOGO, BATANG, JENEPONTO, SULAWESI SELATAN",11,18,174,192
16339,https://kawalpemilu.org#71439,"BANGKALA, MAIWA, ENREKANG, SULAWESI SELATAN",4,53,133,186
22507,https://kawalpemilu.org#72451,"KASSI-KASSI, RAPPOCINI, KOTA MAKASSAR, SULAWESI SELATAN",7,72,126,198
271,https://kawalpemilu.org#69326,"SA'DAN TIROALLO, SA'DAN, TORAJA UTARA, SULAWESI SELATAN",6,138,20,158
6855,https://kawalpemilu.org#70168,"PALANGKA, SINJAI  SELATAN, SINJAI, SULAWESI SELATAN",7,42,162,204
11044,https://kawalpemilu.org#70799,"KASSI, BALOCCI, PANGKAJENE DAN KEPULAUAN, SULAWESI SELATAN",4,78,142,220
11326,https://kawalpemilu.org#70825,"BONTO BONTO, MARANG, PANGKAJENE DAN KEPULAUAN, SULAWESI SELATAN",11,48,81,129
17065,https://kawalpemilu.org#71577,"TONGKO, BAROKO, ENREKANG, SULAWESI SELATAN",10,36,96,132
5785,https://kawalpemilu.org#70047,"BONTO BONTOA, SOMBA OPU, GOWA, SULAWESI SELATAN",36,81,85,166
2644,https://kawalpemilu.org#69685,"MALLILINGI, BANTAENG, BANTAENG, SULAWESI SELATAN",5,65,188,253
10539,https://kawalpemilu.org#70740,"MATTIRODECENG, LAU, MAROS, SULAWESI SELATAN",5,72,104,176
18527,https://kawalpemilu.org#71902,"PA'TENGKO, MENGKENDEK, TANA TORAJA, SULAWESI SELATAN",1,167,49,216
8605,https://kawalpemilu.org#70461,"MICO, PALAKKA, BONE, SULAWESI SELATAN",6,112,89,201
9311,https://kawalpemilu.org#70576,"MAJANG, TANETE RIATTANG BARAT, BONE, SULAWESI SELATAN",7,161,89,250
16663,https://kawalpemilu.org#71502,"MAMPU, ANGGERAJA, ENREKANG, SULAWESI SELATAN",4,43,159,202
10104,https://kawalpemilu.org#70680,"MINASAUPA, BONTOA, MAROS, SULAWESI SELATAN",4,95,142,237
20687,https://kawalpemilu.org#72307,"PARUMPANAI, WASUPONDA, LUWU TIMUR, SULAWESI SELATAN",5,17,119,136
19542,https://kawalpemilu.org#72121,"MALIMONGAN, SEKO, LUWU UTARA, SULAWESI SELATAN",3,174,5,179
7720,https://kawalpemilu.org#70279,"BUARENG, KAJUARA, BONE, SULAWESI SELATAN",5,57,97,154
13875,https://kawalpemilu.org#71149,"SIWA, PITUMPANUA, WAJO, SULAWESI SELATAN",2,63,101,164
21572,https://kawalpemilu.org#72417,"TAMAMAUNG, PANAKUKKANG, KOTA MAKASSAR, SULAWESI SELATAN",56,71,103,174
2547,https://kawalpemilu.org#69674,"BONTO RITA, BISSAPPU, BANTAENG, SULAWESI SELATAN",8,28,164,192
9043,https://kawalpemilu.org#70545,"WATANG PADACCENGNGA, DUA BOCCOE, BONE, SULAWESI SELATAN",2,122,39,161
16739,https://kawalpemilu.org#71515,"KALOSI, ALLA, ENREKANG, SULAWESI SELATAN",6,22,123,145
14072,https://kawalpemilu.org#71182,"BENTENG, PENRANG, WAJO, SULAWESI SELATAN",1,175,47,222
15852,https://kawalpemilu.org#71396,"BETTENG, LEMBANG, PINRANG, SULAWESI SELATAN",10,39,62,101
7297,https://kawalpemilu.org#70214,"PASIR PUTIH, SINJAI BORONG, SINJAI, SULAWESI SELATAN",1,47,190,237
21352,https://kawalpemilu.org#72391,"WALA-WALAYA, TALLO, KOTA MAKASSAR, SULAWESI SELATAN",1,73,130,203
11090,https://kawalpemilu.org#70803,"SAMALEWA, BUNGORO, PANGKAJENE DAN KEPULAUAN, SULAWESI SELATAN",21,61,164,225
23230,https://kawalpemilu.org#72489,"LUMPUE, BACUKIKI BARAT, KOTA PARE PARE, SULAWESI SELATAN",24,93,107,200
1444,https://kawalpemilu.org#69549,"POLEWALI, GANTARANG, BULUKUMBA, SULAWESI SELATAN",14,85,92,177
292,https://kawalpemilu.org#69332,"LA'BO', SANGGALANGI, TORAJA UTARA, SULAWESI SELATAN",1,135,6,141
3533,https://kawalpemilu.org#69786,"SAPANANG, BINAMU, JENEPONTO, SULAWESI SELATAN",9,10,205,215
12602,https://kawalpemilu.org#70970,"PAROTO, LILIRILAU, SOPPENG, SULAWESI SELATAN",10,81,19,100
8035,https://kawalpemilu.org#70352,"LAPPAUPANG, MARE, BONE, SULAWESI SELATAN",1,129,64,193
18777,https://kawalpemilu.org#71953,"MIALLO, MAPPAK, TANA TORAJA, SULAWESI SELATAN",5,108,4,112
6015,https://kawalpemilu.org#70058,"BONTORAMBA, SOMBA OPU, GOWA, SULAWESI SELATAN",1,50,108,158
15440,https://kawalpemilu.org#71362,"MACCORAWALIE, WATANG SAWITO, PINRANG, SULAWESI SELATAN",13,34,117,151
18399,https://kawalpemilu.org#71875,"ARIANG, MAKALE, TANA TORAJA, SULAWESI SELATAN",1,177,48,225
14806,https://kawalpemilu.org#71285,"MOJONG, WT. SIDENRENG, SIDENRENG RAPPANG, SULAWESI SELATAN",3,116,120,236
22782,https://kawalpemilu.org#72466,"TAMALANREA JAYA, TAMALANREA, KOTA MAKASSAR, SULAWESI SELATAN",31,71,109,180
6857,https://kawalpemilu.org#70168,"PALANGKA, SINJAI  SELATAN, SINJAI, SULAWESI SELATAN",9,18,204,222
8806,https://kawalpemilu.org#70499,"LAMURU, TELLU SIATTINGE, BONE, SULAWESI SELATAN",9,99,73,172
20142,https://kawalpemilu.org#72216,"ASULI, TOWUTI, LUWU TIMUR, SULAWESI SELATAN",8,70,121,191
15870,https://kawalpemilu.org#71398,"RAJANG, LEMBANG, PINRANG, SULAWESI SELATAN",7,68,100,168
17101,https://kawalpemilu.org#71600,"LISSAGA, BASSE SANGTEMPE, LUWU, SULAWESI SELATAN",2,10,59,69
23483,https://kawalpemilu.org#72514,"MANCANI, TELLUWANUA, KOTA PALOPO, SULAWESI SELATAN",1,48,155,203
17046,https://kawalpemilu.org#71576,"BENTENG ALLA UTARA, BAROKO, ENREKANG, SULAWESI SELATAN",1,31,88,119
13848,https://kawalpemilu.org#71144,"SOGI, MANIANGPAJO, WAJO, SULAWESI SELATAN",2,119,81,200
7057,https://kawalpemilu.org#70192,"SAOTENGNGA, SINJAI TENGAH, SINJAI, SULAWESI SELATAN",11,65,114,179
4798,https://kawalpemilu.org#69937,"SOMBALABELLA, PATTALLASSANG, TAKALAR, SULAWESI SELATAN",18,67,160,227
23385,https://kawalpemilu.org#72500,"PAJALESANG, WARA, KOTA PALOPO, SULAWESI SELATAN",9,108,111,219
10073,https://kawalpemilu.org#70677,"TUPPABIRING, BONTOA, MAROS, SULAWESI SELATAN",4,138,119,257
23077,https://kawalpemilu.org#72481,"WATANG SOREANG, SOREANG, KOTA PARE PARE, SULAWESI SELATAN",20,87,85,172
8992,https://kawalpemilu.org#70532,"MELLE, DUA BOCCOE, BONE, SULAWESI SELATAN",6,150,38,188
19765,https://kawalpemilu.org#72171,"SALULEMO, BAEBUNTA, LUWU UTARA, SULAWESI SELATAN",3,33,114,147
14539,https://kawalpemilu.org#71254,"LALEBATA, PANCA RIJANG, SIDENRENG RAPPANG, SULAWESI SELATAN",16,56,93,149
20289,https://kawalpemilu.org#72238,"TAMPINNA, ANGKONA, LUWU TIMUR, SULAWESI SELATAN",6,49,151,200
9681,https://kawalpemilu.org#70631,"MADANRENG PULU, PATIMPENG, BONE, SULAWESI SELATAN",2,93,100,193
12717,https://kawalpemilu.org#70978,"LAPAJUNG, LALABATA, SOPPENG, SULAWESI SELATAN",18,51,73,124
21787,https://kawalpemilu.org#72427,"MANGASA, TAMALATE, KOTA MAKASSAR, SULAWESI SELATAN",37,30,115,145
12111,https://kawalpemilu.org#70919,"KUPA, MALLUSETASI, BARRU, SULAWESI SELATAN",6,79,45,124
305,https://kawalpemilu.org#69333,"BUNTU LA'BO', SANGGALANGI, TORAJA UTARA, SULAWESI SELATAN",3,122,13,135
3850,https://kawalpemilu.org#69823,"BULUSUKA, BONTORAMBA, JENEPONTO, SULAWESI SELATAN",4,62,182,244
20709,https://kawalpemilu.org#72311,"BONTORANNU, MARISO, KOTA MAKASSAR, SULAWESI SELATAN",13,82,149,231
2443,https://kawalpemilu.org#68001,"SAYO, POSO KOTA SELATAN, POSO, SULAWESI TENGAH",7,34,108,142
492,https://kawalpemilu.org#67488,"BANGGA, DOLO SELATAN, SIGI, SULAWESI TENGAH",8,153,8,161
4326,https://kawalpemilu.org#68353,"MULANGATO, PALELEH, BUOL, SULAWESI TENGAH",3,115,59,174
28,https://kawalpemilu.org#67400,"OLOBUJU, SIGI BIROMARU, SIGI, SULAWESI TENGAH",1,40,105,145
4938,https://kawalpemilu.org#68658,"EMEA, WITA PONDA, MOROWALI, SULAWESI TENGAH",2,69,137,206
4640,https://kawalpemilu.org#68529,"MARSAOLEH, BUNGKU TENGAH, MOROWALI, SULAWESI TENGAH",2,46,141,187
4161,https://kawalpemilu.org#68302,"BINONTOAN, TOLI-TOLI UTARA, TOLITOLI, SULAWESI TENGAH",6,133,41,174
3297,https://kawalpemilu.org#68173,"TIBO, SINDUE TOMBUSABORA, DONGGALA, SULAWESI TENGAH",2,109,93,202
7031,https://kawalpemilu.org#69180,"TAKIBANGKE, ULUBONGKA, TOJO UNA-UNA, SULAWESI TENGAH",5,64,64,128
1915,https://kawalpemilu.org#87993,"BOMBONGAN, MANTOH, BANGGAI, SULAWESI TENGAH",3,110,7,117
7591,https://kawalpemilu.org#69249,"PETOBO, PALU SELATAN, KOTA PALU, SULAWESI TENGAH",3,54,170,224
5083,https://kawalpemilu.org#68715,"MANGGALAI, TINANGKUNG, BANGGAI KEPULAUAN, SULAWESI TENGAH",3,103,49,152
305,https://kawalpemilu.org#67440,"PUROO, LINDU, SIGI, SULAWESI TENGAH",1,247,8,255
513,https://kawalpemilu.org#67492,"ROGO, DOLO SELATAN, SIGI, SULAWESI TENGAH",1,48,137,185
7235,https://kawalpemilu.org#69092,"MOLOWAGU, BATUDAKA, TOJO UNA-UNA, SULAWESI TENGAH",1,83,139,222
7264,https://kawalpemilu.org#69123,"KALIA, TALATAKO, TOJO UNA-UNA, SULAWESI TENGAH",5,50,72,122
3447,https://kawalpemilu.org#68201,"MALEI, BALAESANG TANJUNG, DONGGALA, SULAWESI TENGAH",4,116,108,224
2362,https://kawalpemilu.org#67981,"TRI MULYA, POSO PESISIR UTARA, POSO, SULAWESI TENGAH",2,158,9,167
4859,https://kawalpemilu.org#68627,"BERINGIN JAYA, BUMI RAYA, MOROWALI, SULAWESI TENGAH",3,107,23,130
740,https://kawalpemilu.org#67538,"BEKA, MARAWOLA, SIGI, SULAWESI TENGAH",2,61,121,182
1672,https://kawalpemilu.org#67827,"OMBOLU, BATUI SELATAN, BANGGAI, SULAWESI TENGAH",3,142,34,176
523,https://kawalpemilu.org#67494,"BALONGGA, DOLO SELATAN, SIGI, SULAWESI TENGAH",1,76,83,159
5713,https://kawalpemilu.org#928627,"GIO BARAT, MOUTONG, PARIGI MOUTONG, SULAWESI TENGAH",1,101,57,158
7554,https://kawalpemilu.org#73610,"LALOLE, SIOMPU BARAT, BUTON SELATAN, SULAWESI TENGGARA",1,53,54,107
6669,https://kawalpemilu.org#72878,"WAKADAWU, WAWONII TIMUR, KONAWE KEPULAUAN, SULAWESI TENGGARA",1,58,124,182
3136,https://kawalpemilu.org#73975,"RAMBU RAMBU, LAEYA, KONAWE SELATAN, SULAWESI TENGGARA",1,60,177,237
1927,https://kawalpemilu.org#73337,"KONTUMOLEPE, TONGKUNO, MUNA, SULAWESI TENGGARA",2,59,71,130
6951,https://kawalpemilu.org#73409,"KASIMPA JAYA, TIWORO SELATAN, MUNA BARAT, SULAWESI TENGGARA",2,115,82,197
1439,https://kawalpemilu.org#73006,"LAHUTUTU, WONGGEDUKU BARAT, KONAWE, SULAWESI TENGGARA",1,38,110,148
2497,https://kawalpemilu.org#73677,"LAMOEN, ANGATA, KONAWE SELATAN, SULAWESI TENGGARA",1,43,150,193
5146,https://kawalpemilu.org#74614,"ANDONOHU, POASIA, KOTA KENDARI, SULAWESI TENGGARA",4,52,81,133
2328,https://kawalpemilu.org#73629,"WASUEMBA, WABULA, BUTON, SULAWESI TENGGARA",1,64,76,140
3648,https://kawalpemilu.org#74145,"MASALOKA BARAT, KEP. MASALOKA RAYA, BOMBANA, SULAWESI TENGGARA",1,65,76,141
1608,https://kawalpemilu.org#73231,"LAIWORU, BATALAIWARU, MUNA, SULAWESI TENGGARA",24,37,75,3
7274,https://kawalpemilu.org#85823,"KATUKOBARI, MAWASANGKA TENGAH, BUTON TENGAH, SULAWESI TENGGARA",1,57,97,154
1342,https://kawalpemilu.org#73107,"PEREO'A, KAPOIALA, KONAWE, SULAWESI TENGGARA",1,22,107,129
7567,https://kawalpemilu.org#73612,"LAMANINGGARA, SIOMPU BARAT, BUTON SELATAN, SULAWESI TENGGARA",5,42,64,108
416,https://kawalpemilu.org#72681,"MANGOLO, LATAMBAGA, KOLAKA, SULAWESI TENGGARA",4,46,153,199
4571,https://kawalpemilu.org#74519,"KOKAPI, SAWA, KONAWE UTARA, SULAWESI TENGGARA",2,40,104,144
7411,https://kawalpemilu.org#73495,"TIRA, SAMPOLAWA, BUTON SELATAN, SULAWESI TENGGARA",2,77,42,119
1339,https://kawalpemilu.org#73105,"LAMENDORA, KAPOIALA, KONAWE, SULAWESI TENGGARA",1,29,129,158
4801,https://kawalpemilu.org#89825,"LAPANDEWA, KULISUSU BARAT, BUTON UTARA, SULAWESI TENGGARA",1,130,89,219
5595,https://kawalpemilu.org#74650,"KADIA, KADIA, KOTA KENDARI, SULAWESI TENGGARA",23,66,114,180
1431,https://kawalpemilu.org#66073,"WALEURE, LANGOWAN TIMUR, MINAHASA, SULAWESI UTARA",5,129,63,192
326,https://kawalpemilu.org#65800,"KOMBOT, PINOLOSIAN, BOLAANG MONGONDOW SELATAN, SULAWESI UTARA",5,35,141,176
6358,https://kawalpemilu.org#67179,"MALENDENG, PAAL DUA, KOTA MANADO, SULAWESI UTARA",7,169,72,241
547,https://kawalpemilu.org#89878,"AMERTHA SARI, DUMOGA TIMUR, BOLAANG MONGONDOW, SULAWESI UTARA",2,130,34,164
3376,https://kawalpemilu.org#66664,"KAPITU, AMURANG BARAT, MINAHASA SELATAN, SULAWESI UTARA",7,183,22,205
2515,https://kawalpemilu.org#66354,"KOLONGAN MITUNG, TAHUNA BARAT, KEPULAUAN SANGIHE, SULAWESI UTARA",2,183,9,192
6068,https://kawalpemilu.org#67218,"MALALAYANG SATU, MALALAYANG, KOTA MANADO, SULAWESI UTARA",4,162,38,200
4053,https://kawalpemilu.org#66818,"LIKUPANG KAMPUNG AMBONG, LIKUPANG TIMUR, MINAHASA UTARA, SULAWESI UTARA",1,205,45,250
65,https://kawalpemilu.org#928554,"BULAWAN SATU, KOTABUNAN, BOLAANG MONGONDOW TIMUR, SULAWESI UTARA",3,98,154,252
1244,https://kawalpemilu.org#66002,"TANDENGAN, ERIS, MINAHASA, SULAWESI UTARA",4,194,24,218
4371,https://kawalpemilu.org#66895,"BASAAN, RATATOTOK, MINAHASA TENGGARA, SULAWESI UTARA",3,179,59,238
2757,https://kawalpemilu.org#66479,"AMMAT SELATAN, TAMPAN' AMMA, KEPULAUAN TALAUD, SULAWESI UTARA",2,154,6,160
4625,https://kawalpemilu.org#66952,"MOME, BINTAUNA, BOLAANG MONGONDOW UTARA, SULAWESI UTARA",2,154,14,168
1798,https://kawalpemilu.org#66156,"KAMPUNG JAWA, TONDANO UTARA, MINAHASA, SULAWESI UTARA",5,100,134,234
3303,https://kawalpemilu.org#66647,"MALOLA, KUMELEMBUAI, MINAHASA SELATAN, SULAWESI UTARA",1,182,16,198
4668,https://kawalpemilu.org#66969,"BOHABAK I, BOLANGITANG TIMUR, BOLAANG MONGONDOW UTARA, SULAWESI UTARA",1,106,133,239
3900,https://kawalpemilu.org#66777,"TATELU, DIMEMBE, MINAHASA UTARA, SULAWESI UTARA",6,215,28,243
7663,https://kawalpemilu.org#67390,"GOGAGOMAN, KOTAMOBAGU BARAT, KOTA KOTAMOBAGU, SULAWESI UTARA",12,158,71,229
1211,https://kawalpemilu.org#65993,"KINIAR, TONDANO TIMUR, MINAHASA, SULAWESI UTARA",6,189,19,208
4183,https://kawalpemilu.org#66836,"MAPANGET, TALAWAAN, MINAHASA UTARA, SULAWESI UTARA",10,147,21,168
1061,https://kawalpemilu.org#12986,"PUNGGASAN TIMUR, LINGGO SARI BAGANTI, PESISIR SELATAN, SUMATERA BARAT",7,23,191,214
11912,https://kawalpemilu.org#13698,"MUARO KIAWAI, GUNUNG TULEH, PASAMAN BARAT, SUMATERA BARAT",8,12,108,120
15860,https://kawalpemilu.org#13988,"KOTOKOCIAK KUBU TAPAKRAJO, PAYAKUMBUH UTARA, KOTA PAYAKUMBUH, SUMATERA BARAT",2,37,203,240
1407,https://kawalpemilu.org#84413,"SUNGAI SIRAH, SILAUT, PESISIR SELATAN, SUMATERA BARAT",4,67,161,228
1664,https://kawalpemilu.org#13017,"SALIMPAT, LEMBAH GUMANTI, SOLOK, SUMATERA BARAT",24,3,87,90
10912,https://kawalpemilu.org#13653,"PAKAN RABAA, KOTO PARIK GADANG DIATEH, SOLOK SELATAN, SUMATERA BARAT",10,12,180,192
153,https://kawalpemilu.org#84329,"PELANGAI KACIAK, RANAH PESISIR, PESISIR SELATAN, SUMATERA BARAT",1,19,98,117
3301,https://kawalpemilu.org#13151,"SISAWAH, SUMPUR KUDUS, SIJUNJUNG, SUMATERA BARAT",1,13,217,230
15378,https://kawalpemilu.org#13909,"PAKAN KURAI, GUGUAK PANJANG, KOTA BUKITTINGGI, SUMATERA BARAT",17,23,118,141
14439,https://kawalpemilu.org#13819,"KOTO PANJANG IKUA KOTO, KOTO TANGAH, KOTA PADANG, SUMATERA BARAT",17,39,185,224
882,https://kawalpemilu.org#12979,"SURANTIH, SUTERA, PESISIR SELATAN, SUMATERA BARAT",14,14,171,185
4830,https://kawalpemilu.org#13258,"KASANG, BATANG ANAI, PADANG PARIAMAN, SUMATERA BARAT",33,6,171,177
4673,https://kawalpemilu.org#87283,"PASIE LAWEH LUBUK ALUNG, LUBUK ALUNG, PADANG PARIAMAN, SUMATERA BARAT",15,25,183,208
14127,https://kawalpemilu.org#13808,"SURAU GADANG, NANGGALO, KOTA PADANG, SUMATERA BARAT",35,15,143,158
15724,https://kawalpemilu.org#13945,"KOTO TANGAH, PAYAKUMBUH BARAT, KOTA PAYAKUMBUH, SUMATERA BARAT",2,11,190,201
1685,https://kawalpemilu.org#13018,"AIE DINGIN, LEMBAH GUMANTI, SOLOK, SUMATERA BARAT",20,5,166,171
6835,https://kawalpemilu.org#13371,"TABEK PANJANG, BASO, AGAM, SUMATERA BARAT",1,20,95,115
9931,https://kawalpemilu.org#13605,"BULASAT, PAGAI SELATAN, KEPULAUAN MENTAWAI, SUMATERA BARAT",4,122,4,126
14053,https://kawalpemilu.org#13806,"SUNGAI SAPIH, KURANJI, KOTA PADANG, SUMATERA BARAT",1,17,121,138
13865,https://kawalpemilu.org#13802,"KALUMBUK, KURANJI, KOTA PADANG, SUMATERA BARAT",27,12,174,186
2895,https://kawalpemilu.org#13114,"PARU, SIJUNJUNG, SIJUNJUNG, SUMATERA BARAT",6,13,169,182
9113,https://kawalpemilu.org#927850,"PANTI TIMUR, PANTI, PASAMAN, SUMATERA BARAT",33,23,114,137
14362,https://kawalpemilu.org#13817,"AIE PACAH, KOTO TANGAH, KOTA PADANG, SUMATERA BARAT",16,22,159,181
16222,https://kawalpemilu.org#14073,"KAMPUNG GADANG, PARIAMAN TIMUR, KOTA PARIAMAN, SUMATERA BARAT",3,16,184,200
13516,https://kawalpemilu.org#13783,"BANDA BUEK, LUBUK KILANGAN, KOTA PADANG, SUMATERA BARAT",30,16,128,144
5890,https://kawalpemilu.org#931264,"Kp. Tanjuang Koto Mambang, PATAMUAN, PADANG PARIAMAN, SUMATERA BARAT",3,24,140,164
7232,https://kawalpemilu.org#13394,"SUNGAI PUA, SUNGAI PUA, AGAM, SUMATERA BARAT",24,11,155,166
3698,https://kawalpemilu.org#13185,"BALIMBING, RAMBATAN, TANAH DATAR, SUMATERA BARAT",14,17,163,180
1736,https://kawalpemilu.org#13024,"BATU BANYAK, LEMBANG JAYA, SOLOK, SUMATERA BARAT",4,18,143,161
1009,https://kawalpemilu.org#84379,"GANTING MUDIAK SELATAN SURANTIH, SUTERA, PESISIR SELATAN, SUMATERA BARAT",1,17,151,168
14325,https://kawalpemilu.org#13816,"LUBUK MINTURUN, KOTO TANGAH, KOTA PADANG, SUMATERA BARAT",4,16,168,184
12681,https://kawalpemilu.org#13733,"ANDALAS, PADANG TIMUR, KOTA PADANG, SUMATERA BARAT",8,42,193,235
9209,https://kawalpemilu.org#13530,"CUBADAK, DUO KOTO, PASAMAN, SUMATERA BARAT",25,15,117,132
14475,https://kawalpemilu.org#13821,"BATIPUH PANJANG, KOTO TANGAH, KOTA PADANG, SUMATERA BARAT",13,29,224,253
14160,https://kawalpemilu.org#13809,"KAMPUNG OLO, NANGGALO, KOTA PADANG, SUMATERA BARAT",4,10,119,129
5836,https://kawalpemilu.org#13270,"SUNGAI ASAM, 2 X 11 ENAM LINGKUNG, PADANG PARIAMAN, SUMATERA BARAT",3,17,207,224
547,https://kawalpemilu.org#84344,"SUNGAI BUKIK KACIAK LUMPO, IV JURAI, PESISIR SELATAN, SUMATERA BARAT",3,12,221,233
14267,https://kawalpemilu.org#13813,"KAMPUNG LAPAI, NANGGALO, KOTA PADANG, SUMATERA BARAT",18,10,148,158
2031,https://kawalpemilu.org#13040,"MUARO PANEH, BUKIT SUNDI, SOLOK, SUMATERA BARAT",41,21,78,99
15094,https://kawalpemilu.org#13876,"TALAWI MUDIK, TALAWI, KOTA SAWAHLUNTO, SUMATERA BARAT",3,31,192,223
11256,https://kawalpemilu.org#13683,"AIA BANGIH, SUNGAI BEREMAS, PASAMAN BARAT, SUMATERA BARAT",32,10,157,167
11364,https://kawalpemilu.org#13685,"UJUNG GADIANG, LEMBAH MELINTANG, PASAMAN BARAT, SUMATERA BARAT",67,27,216,243
21142,https://kawalpemilu.org#20569,"KUTO BATU, ILIR TIMUR III, KOTA PALEMBANG, SUMATERA SELATAN",17,59,157,216
7323,https://kawalpemilu.org#18929,"PETUNANG, TUAH NEGERI, MUSI RAWAS, SUMATERA SELATAN",1,37,158,195
10238,https://kawalpemilu.org#19360,"SUMBER MULYA, MUARA TELANG, BANYUASIN, SUMATERA SELATAN",6,162,94,256
12536,https://kawalpemilu.org#19624,"MUJO RAHAYU, SEMENDAWAI SUKU III, OGAN KOMERING ULU TIMUR, SUMATERA SELATAN",1,148,85,233
8276,https://kawalpemilu.org#19063,"SRI GUNUNG, SUNGAI LILIN, MUSI BANYUASIN, SUMATERA SELATAN",17,31,77,108
15892,https://kawalpemilu.org#20290,"S. PINANG LAGATI, SUNGAI PINANG, OGAN ILIR, SUMATERA SELATAN",4,104,62,166
718,https://kawalpemilu.org#17504,"PADANG BINDU, SEMIDANG AJI, OGAN KOMERING ULU, SUMATERA SELATAN",9,15,144,159
22941,https://kawalpemilu.org#20799,"TANJUNG RAMAN, PRABUMULIH SELATAN, KOTA PRABUMULIH, SUMATERA SELATAN",14,39,82,121
8018,https://kawalpemilu.org#19006,"PENGATURAN, BATANG HARI LEKO, MUSI BANYUASIN, SUMATERA SELATAN",3,35,103,138
16742,https://kawalpemilu.org#20493,"REMANTAI, TALANG PADANG, EMPAT LAWANG, SUMATERA SELATAN",2,30,132,162
7420,https://kawalpemilu.org#18944,"KAYU ARA, SEKAYU, MUSI BANYUASIN, SUMATERA SELATAN",18,45,231,229
1583,https://kawalpemilu.org#17624,"JUA-JUA, KAYU AGUNG, OGAN KOMERING ILIR, SUMATERA SELATAN",13,72,158,230
2264,https://kawalpemilu.org#17729,"TUGU AGUNG, LEMPUING, OGAN KOMERING ILIR, SUMATERA SELATAN",4,129,80,209
2586,https://kawalpemilu.org#17779,"LINGKIS, JEJAWI, OGAN KOMERING ILIR, SUMATERA SELATAN",1,94,84,178
218,https://kawalpemilu.org#17464,"TANJUNG AGUNG, BATURAJA BARAT, OGAN KOMERING ULU, SUMATERA SELATAN",7,94,158,252
5683,https://kawalpemilu.org#18454,"BUNGA MAS, KIKIM TIMUR, LAHAT, SUMATERA SELATAN",9,35,110,145
13054,https://kawalpemilu.org#19712,"BINA AMARTA, MADANG SUKU III, OGAN KOMERING ULU TIMUR, SUMATERA SELATAN",10,33,105,138
4314,https://kawalpemilu.org#18076,"PAJAR BULAN, SEMENDE DARAT ULU, MUARA ENIM, SUMATERA SELATAN",6,30,186,216
9696,https://kawalpemilu.org#19246,"TANJUNGMENANG, BANYUASIN III, BANYUASIN, SUMATERA SELATAN",2,18,194,212
23795,https://kawalpemilu.org#18737,"KUTO TANJUNG, ULU RAWAS, MUSI RAWAS UTARA, SUMATERA SELATAN",2,10,177,187
15362,https://kawalpemilu.org#20163,"ULAK SEGELUNG, INDRALAYA, OGAN ILIR, SUMATERA SELATAN",1,93,112,205
13158,https://kawalpemilu.org#19723,"MENANGA TENGAH, SEMENDAWAI BARAT, OGAN KOMERING ULU TIMUR, SUMATERA SELATAN",7,129,64,193
12459,https://kawalpemilu.org#19612,"MARGO REJO, SEMENDAWAI SUKU III, OGAN KOMERING ULU TIMUR, SUMATERA SELATAN",5,157,47,204
13703,https://kawalpemilu.org#19810,"BATU BELANG JAYA, MUARA DUA, OGAN KOMERING ULU SELATAN, SUMATERA SELATAN",9,83,158,241
13628,https://kawalpemilu.org#19797,"SRIBUDAYA, BELITANG MULYA, OGAN KOMERING ULU TIMUR, SUMATERA SELATAN",2,66,95,161
3235,https://kawalpemilu.org#17870,"MUARA BURNAI I, LEMPUING JAYA, OGAN KOMERING ILIR, SUMATERA SELATAN",14,105,105,210
9845,https://kawalpemilu.org#19288,"RINGIN HARJO, PULAU RIMAU, BANYUASIN, SUMATERA SELATAN",4,164,16,180
20188,https://kawalpemilu.org#20619,"BAGUS KUNING, PLAJU, KOTA PALEMBANG, SUMATERA SELATAN",16,63,77,140
22568,https://kawalpemilu.org#20770,"GUNUNG IBUL BARAT, PRABUMULIH TIMUR, KOTA PRABUMULIH, SUMATERA SELATAN",14,64,87,151
950,https://kawalpemilu.org#17545,"TIHANG, LENGKITI, OGAN KOMERING ULU, SUMATERA SELATAN",1,11,179,190
1890,https://kawalpemilu.org#91882,"BATU AMPAR BARU, SIRAH PULAU PADANG, OGAN KOMERING ILIR, SUMATERA SELATAN",1,104,100,204
6492,https://kawalpemilu.org#18684,"MUARA KELINGI, MUARA KELINGI, MUSI RAWAS, SUMATERA SELATAN",7,85,190,275
23678,https://kawalpemilu.org#929012,"MEKARSARI, RAWAS ILIR, MUSI RAWAS UTARA, SUMATERA SELATAN",6,34,45,79
1021,https://kawalpemilu.org#17559,"KARYA MUKTI, SINAR PENINJAUAN, OGAN KOMERING ULU, SUMATERA SELATAN",5,104,112,216
1802,https://kawalpemilu.org#17653,"ULAK JERMUN, SIRAH PULAU PADANG, OGAN KOMERING ILIR, SUMATERA SELATAN",5,136,43,179
22491,https://kawalpemilu.org#20769,"GUNUNG IBUL, PRABUMULIH TIMUR, KOTA PRABUMULIH, SUMATERA SELATAN",7,39,104,143
16634,https://kawalpemilu.org#20470,"KARANG TANDING, LINTANG KANAN, EMPAT LAWANG, SUMATERA SELATAN",4,64,71,135
10116,https://kawalpemilu.org#19332,"SUNGAIPINANG, RAMBUTAN, BANYUASIN, SUMATERA SELATAN",7,87,133,220
22881,https://kawalpemilu.org#20795,"MANGGA BESAR, PRABUMULIH UTARA, KOTA PRABUMULIH, SUMATERA SELATAN",26,33,71,104
23293,https://kawalpemilu.org#18105,"RAJA BARAT, TANAH ABANG, PENUKAL ABAB LEMATANG ILIR, SUMATERA SELATAN",2,61,128,189
1636,https://kawalpemilu.org#17630,"KEDATON, KAYU AGUNG, OGAN KOMERING ILIR, SUMATERA SELATAN",8,113,82,195
12025,https://kawalpemilu.org#19555,"KURIPAN, CEMPAKA, OGAN KOMERING ULU TIMUR, SUMATERA SELATAN",4,54,31,85
4943,https://kawalpemilu.org#18136,"MEKAR JAYA, LUBAI ULU, MUARA ENIM, SUMATERA SELATAN",2,87,128,215
874,https://kawalpemilu.org#17529,"KARTA MULYA, LUBUK BATANG, OGAN KOMERING ULU, SUMATERA SELATAN",3,35,131,166
3150,https://kawalpemilu.org#17859,"RANTAU DURIAN I, LEMPUING JAYA, OGAN KOMERING ILIR, SUMATERA SELATAN",11,178,84,262
30,https://kawalpemilu.org#17414,"TUNGKU JAYA, SOSOH BUAY RAYAP, OGAN KOMERING ULU, SUMATERA SELATAN",2,0,0,0
16154,https://kawalpemilu.org#20353,"LUBUK TANJUNG, MUARA PINANG, EMPAT LAWANG, SUMATERA SELATAN",2,72,124,200
23226,https://kawalpemilu.org#18091,"TANAH ABANG UTARA, TANAH ABANG, PENUKAL ABAB LEMATANG ILIR, SUMATERA SELATAN",8,56,114,170
5836,https://kawalpemilu.org#18510,"WANARAYA, KIKIM BARAT, LAHAT, SUMATERA SELATAN",5,109,68,177
24180,https://kawalpemilu.org#18898,"KERTA SARI, KARANG DAPO, MUSI RAWAS UTARA, SUMATERA SELATAN",5,20,137,157
22154,https://kawalpemilu.org#20741,"SIRING AGUNG, LUBUK LINGGAU SELATAN II, KOTA LUBUKLINGGAU, SUMATERA SELATAN",1,32,211,243
18357,https://kawalpemilu.org#20568,"LAWANG KIDUL, ILIR TIMUR II, KOTA PALEMBANG, SUMATERA SELATAN",28,58,134,192
2558,https://kawalpemilu.org#17775,"AIR ITAM, JEJAWI, OGAN KOMERING ILIR, SUMATERA SELATAN",5,103,123,226
2413,https://kawalpemilu.org#17753,"SUNGAI MENANG, SUNGAI MENANG, OGAN KOMERING ILIR, SUMATERA SELATAN",11,0,0,0
8271,https://kawalpemilu.org#19063,"SRI GUNUNG, SUNGAI LILIN, MUSI BANYUASIN, SUMATERA SELATAN",12,69,116,185
19860,https://kawalpemilu.org#20609,"KARANG JAYA, GANDUS, KOTA PALEMBANG, SUMATERA SELATAN",9,49,58,107
20498,https://kawalpemilu.org#20629,"TALANG KELAPA, ALANG-ALANG LEBAR, KOTA PALEMBANG, SUMATERA SELATAN",1,63,111,174
16552,https://kawalpemilu.org#20442,"TANJUNGKUPANG, TEBING TINGGI, EMPAT LAWANG, SUMATERA SELATAN",20,34,156,190
1350,https://kawalpemilu.org#17595,"PEDAMARAN V, PEDAMARAN, OGAN KOMERING ILIR, SUMATERA SELATAN",4,139,40,179
307,https://kawalpemilu.org#17474,"TANJUNG KARANG, BATURAJA BARAT, OGAN KOMERING ULU, SUMATERA SELATAN",2,25,174,199
8004,https://kawalpemilu.org#19002,"BUKIT SELABU, BATANG HARI LEKO, MUSI BANYUASIN, SUMATERA SELATAN",4,79,114,193
15528,https://kawalpemilu.org#20205,"SUKANANTI BARU, RANTAU ALAI, OGAN ILIR, SUMATERA SELATAN",3,34,54,88
16408,https://kawalpemilu.org#20424,"TANJUNG AGUNG, ULU MUSI, EMPAT LAWANG, SUMATERA SELATAN",1,33,142,175
4840,https://kawalpemilu.org#7712,"PANOBASAN LOMBANG, ANGKOLA BARAT, TAPANULI SELATAN, SUMATERA UTARA",4,117,23,140
585,https://kawalpemilu.org#6767,"ASAM JAWA, TORGAMBA, LABUHANBATU SELATAN, SUMATERA UTARA",34,62,94,156
17421,https://kawalpemilu.org#9471,"UJUNG PADANG, UJUNG PADANG, SIMALUNGUN, SUMATERA UTARA",16,39,60,99
33498,https://kawalpemilu.org#11865,"KAMPUNG BARU, MEDAN MAIMUN, KOTA MEDAN, SUMATERA UTARA",44,41,115,156
36646,https://kawalpemilu.org#12073,"TANAH MERAH, BINJAI SELATAN, KOTA BINJAI, SUMATERA UTARA",11,106,144,250
32094,https://kawalpemilu.org#11823,"PANDAU HULU II, MEDAN AREA, KOTA MEDAN, SUMATERA UTARA",9,236,8,244
6701,https://kawalpemilu.org#8172,"TANJUNG JATI, BINJAI, LANGKAT, SUMATERA UTARA",6,70,161,231
21024,https://kawalpemilu.org#9823,"SEI SAKAT, PANAI HILIR, LABUHANBATU, SUMATERA UTARA",1,34,133,167
5011,https://kawalpemilu.org#7752,"PAL XI, ANGKOLA TIMUR, TAPANULI SELATAN, SUMATERA UTARA",1,4,85,89
5333,https://kawalpemilu.org#7833,"BANGUN PURBA, BATANG ANGKOLA, TAPANULI SELATAN, SUMATERA UTARA",1,128,8,136
33583,https://kawalpemilu.org#11870,"SUKADAMAI, MEDAN POLONIA, KOTA MEDAN, SUMATERA UTARA",4,166,21,187
6804,https://kawalpemilu.org#8177,"PEKAN SELESAI, SELESAI, LANGKAT, SUMATERA UTARA",33,68,79,147
13861,https://kawalpemilu.org#9031,"BANDAR KHALIPAH, PERCUT SEI TUAN, DELI SERDANG, SUMATERA UTARA",66,35,109,144
3975,https://kawalpemilu.org#7474,"SIMANAMPANG, SIATAS BARITA, TAPANULI UTARA, SUMATERA UTARA",3,105,3,108
21135,https://kawalpemilu.org#9832,"CINTA MAKMUR, PANAI HULU, LABUHANBATU, SUMATERA UTARA",3,32,218,250
26495,https://kawalpemilu.org#11411,"SUKAJADI, PERBAUNGAN, SERDANG BEDAGAI, SUMATERA UTARA",5,95,115,210
4253,https://kawalpemilu.org#7570,"PSR SIBORONG BORONG, SIBORONG-BORONG, TAPANULI UTARA, SUMATERA UTARA",15,229,4,233
29067,https://kawalpemilu.org#11708,"LABUHAN RUKU, TALAWI, BATU BARA, SUMATERA UTARA",17,37,82,119
9153,https://kawalpemilu.org#8396,"KUTAMBARU, KUTAMBARU, LANGKAT, SUMATERA UTARA",3,93,97,190
24988,https://kawalpemilu.org#11095,"PUSUK I, PARLILITAN, HUMBANG HASUNDUTAN, SUMATERA UTARA",1,117,3,120
6805,https://kawalpemilu.org#8178,"SEI LIMBAT, SELESAI, LANGKAT, SUMATERA UTARA",1,87,150,237
923,https://kawalpemilu.org#6787,"RINTIS, SILANGKITANG, LABUHANBATU SELATAN, SUMATERA UTARA",4,23,117,140
4688,https://kawalpemilu.org#7674,"SIMPANG BOLON, GAROGA, TAPANULI UTARA, SUMATERA UTARA",3,66,10,76
1390,https://kawalpemilu.org#6822,"BANDAR SELAMAT, AEK KUO, LABUHANBATU UTARA, SUMATERA UTARA",2,61,111,172
28657,https://kawalpemilu.org#11676,"TANJUNGKUBAH, AIR PUTIH, BATU BARA, SUMATERA UTARA",8,149,4,153
27721,https://kawalpemilu.org#11575,"KUTA BARU, TEBING TINGGI, SERDANG BEDAGAI, SUMATERA UTARA",5,0,0,175
22697,https://kawalpemilu.org#10230,"KAYU JATI, PANYABUNGAN KOTA, MANDAILING NATAL, SUMATERA UTARA",13,28,162,190
985,https://kawalpemilu.org#6791,"AEK KANOPAN, KUALUH HULU, LABUHANBATU UTARA, SUMATERA UTARA",39,67,107,174
30838,https://kawalpemilu.org#11783,"PULO BERAYAN KOTA, MEDAN BARAT, KOTA MEDAN, SUMATERA UTARA",14,128,51,179
2837,https://kawalpemilu.org#7197,"BAWODESOLO, GUNUNGSITOLI IDANOI, KOTA GUNUNGSITOLI, SUMATERA UTARA",1,162,8,170
13061,https://kawalpemilu.org#9008,"KOTA RANTANG, HAMPARAN PERAK, DELI SERDANG, SUMATERA UTARA",2,42,164,206
21977,https://kawalpemilu.org#10006,"BANJARTOBA, BRAMPU, DAIRI, SUMATERA UTARA",1,147,1,148
20056,https://kawalpemilu.org#9735,"BINARAGA, RANTAU UTARA, LABUHANBATU, SUMATERA UTARA",17,102,3,105
30066,https://kawalpemilu.org#11762,"TANJUNG REJO, MEDAN SUNGGAL, KOTA MEDAN, SUMATERA UTARA",65,35,86,121
10174,https://kawalpemilu.org#8632,"RIH TENGAH, KUTABULUH, KARO, SUMATERA UTARA",2,122,21,143
9248,https://kawalpemilu.org#8411,"LAU CIMBA, KABANJAHE, KARO, SUMATERA UTARA",19,198,11,209
8351,https://kawalpemilu.org#8309,"PELAWI SELATAN, BABALAN, LANGKAT, SUMATERA UTARA",3,41,140,181
14520,https://kawalpemilu.org#9059,"SEKIP, LUBUK PAKAM, DELI SERDANG, SUMATERA UTARA",21,48,125,173
34879,https://kawalpemilu.org#11939,"KAHEAN, SIANTAR UTARA, KOTA PEMATANGSIANTAR, SUMATERA UTARA",20,179,29,209
4474,https://kawalpemilu.org#7613,"LOBUSUNUT, PARMONANGAN, TAPANULI UTARA, SUMATERA UTARA",2,208,4,212
1275,https://kawalpemilu.org#6815,"SEI SENTANG, KUALUH HILIR, LABUHANBATU UTARA, SUMATERA UTARA",5,67,58,125
1892,https://kawalpemilu.org#6879,"LOBU HUALA, KUALUH SELATAN, LABUHANBATU UTARA, SUMATERA UTARA",3,29,239,268
39090,https://kawalpemilu.org#12797,"HANDANG KOPO, ULU BARUMUN, PADANG LAWAS, SUMATERA UTARA",1,34,124,158
750,https://kawalpemilu.org#6775,"SABUNGAN, SUNGAI KANAN, LABUHANBATU SELATAN, SUMATERA UTARA",10,80,79,159
7281,https://kawalpemilu.org#8210,"KEBUN BALOK, WAMPU, LANGKAT, SUMATERA UTARA",9,74,116,190
24759,https://kawalpemilu.org#10696,"FANEDANU SIBOHOU, ULU IDANOTAE, NIAS SELATAN, SUMATERA UTARA",1,129,3,132
3748,https://kawalpemilu.org#7426,"LUMUT, LUMUT, TAPANULI TENGAH, SUMATERA UTARA",8,91,90,181
31482,https://kawalpemilu.org#11802,"MANGGA, MEDAN TUNTUNGAN, KOTA MEDAN, SUMATERA UTARA",29,106,61,167
16075,https://kawalpemilu.org#9270,"BUNTU TURUNAN, HATONDUHAN, SIMALUNGUN, SUMATERA UTARA",10,191,25,216
4052,https://kawalpemilu.org#7501,"HUTAURUK, SIPOHOLON, TAPANULI UTARA, SUMATERA UTARA",3,231,9,240
7570,https://kawalpemilu.org#8239,"SUKA MULIA, SECANGGANG, LANGKAT, SUMATERA UTARA",10,54,127,181
6611,https://kawalpemilu.org#8163,"PASAR VIII.NAMO TERASI, SEI BINGEI, LANGKAT, SUMATERA UTARA",6,115,41,156
13534,https://kawalpemilu.org#9026,"TEMBUNG, PERCUT SEI TUAN, DELI SERDANG, SUMATERA UTARA",5,21,117,138
17071,https://kawalpemilu.org#9408,"SERIBU DOLOK, SILIMAKUTA, SIMALUNGUN, SUMATERA UTARA",18,146,1,147
732,https://kawalpemilu.org#6774,"BATANG NADENGGAN, SUNGAI KANAN, LABUHANBATU SELATAN, SUMATERA UTARA",5,14,182,0
38268,https://kawalpemilu.org#12415,"GUNUNG TUA BARU, PADANG BOLAK, PADANG LAWAS UTARA, SUMATERA UTARA",1,27,141,168
36116,https://kawalpemilu.org#12042,"NANGKA, BINJAI UTARA, KOTA BINJAI, SUMATERA UTARA",11,34,171,205
33020,https://kawalpemilu.org#11847,"BESAR, MEDAN LABUHAN, KOTA MEDAN, SUMATERA UTARA",27,22,111,133
7765,https://kawalpemilu.org#8257,"PEMATANG TENGAH, TANJUNG PURA, LANGKAT, SUMATERA UTARA",3,91,145,236
21080,https://kawalpemilu.org#9828,"TANJUNG SARANG ELANG, PANAI HULU, LABUHANBATU, SUMATERA UTARA",4,36,150,186
13898,https://kawalpemilu.org#9031,"BANDAR KHALIPAH, PERCUT SEI TUAN, DELI SERDANG, SUMATERA UTARA",123,29,123,152
38102,https://kawalpemilu.org#12299,"SUNGAI DATAR, DOLOK, PADANG LAWAS UTARA, SUMATERA UTARA",2,71,155,226
26504,https://kawalpemilu.org#11412,"SEI BULUH, PERBAUNGAN, SERDANG BEDAGAI, SUMATERA UTARA",2,81,89,170
35940,https://kawalpemilu.org#12030,"PAHANG, DATUK BANDAR, KOTA TANJUNG BALAI, SUMATERA UTARA",3,127,37,164
28303,https://kawalpemilu.org#87769,"PAGURAWAN, MEDANG DERAS, BATU BARA, SUMATERA UTARA",3,32,94,126
11744,https://kawalpemilu.org#8924,"GALANG SUKA, GALANG, DELI SERDANG, SUMATERA UTARA",9,55,148,203
30236,https://kawalpemilu.org#11767,"HELVETIA TIMUR, MEDAN HELVETIA, KOTA MEDAN, SUMATERA UTARA",47,40,138,178
7021,https://kawalpemilu.org#8193,"KWALA BINGAI, STABAT, LANGKAT, SUMATERA UTARA",14,43,217,260
35445,https://kawalpemilu.org#11993,"AEK MUARA PINANG, SIBOLGA SELATAN, KOTA SIBOLGA, SUMATERA UTARA",3,197,4,201
29680,https://kawalpemilu.org#11750,"KOTAMATSUM III, MEDAN KOTA, KOTA MEDAN, SUMATERA UTARA",15,35,103,138
22561,https://kawalpemilu.org#84268,"LIAT TONDUNG, NASSAU, TOBA SAMOSIR, SUMATERA UTARA",1,186,6,192
16713,https://kawalpemilu.org#9375,"BANDAR TONGAH, BANDAR HULUAN, SIMALUNGUN, SUMATERA UTARA",1,111,63,174
7741,https://kawalpemilu.org#8255,"PEKAN TJ. PURA, TANJUNG PURA, LANGKAT, SUMATERA UTARA",19,20,180,200
7877,https://kawalpemilu.org#8266,"PEMATANG CENGAL, TANJUNG PURA, LANGKAT, SUMATERA UTARA",22,90,97,187
8721,https://kawalpemilu.org#8339,"SEI BILAH TIMUR, SEI LEPAN, LANGKAT, SUMATERA UTARA",3,54,132,186
22048,https://kawalpemilu.org#10023,"BALIGE III, BALIGE, TOBA SAMOSIR, SUMATERA UTARA",2,154,7,161
16038,https://kawalpemilu.org#9265,"MARUBUN BAYU, TANAH JAWA, SIMALUNGUN, SUMATERA UTARA",2,177,52,229
6279,https://kawalpemilu.org#8112,"TIMBANG JAYA, BAHOROK, LANGKAT, SUMATERA UTARA",7,125,85,210
8605,https://kawalpemilu.org#8329,"BUKIT MAS, BESITANG, LANGKAT, SUMATERA UTARA",15,96,17,113
2761,https://kawalpemilu.org#7173,"ONOZITOLI TABALOHO, GUNUNGSITOLI SELATAN, KOTA GUNUNGSITOLI, SUMATERA UTARA",2,76,6,82
10446,https://kawalpemilu.org#8706,"LIMAU MANIS, TANJUNG MORAWA, DELI SERDANG, SUMATERA UTARA",44,71,83,154
8262,https://kawalpemilu.org#8305,"BRANDAN TIMUR BARU, BABALAN, LANGKAT, SUMATERA UTARA",14,33,63,96
37188,https://kawalpemilu.org#12112,"PINANG MANCUNG, BAJENIS, KOTA TEBING TINGGI, SUMATERA UTARA",8,67,109,176
24585,https://kawalpemilu.org#10705,"HILIDOHONA, SIDUA'ORI, NIAS SELATAN, SUMATERA UTARA",2,109,2,1
33825,https://kawalpemilu.org#11885,"SIDORAME TIMUR, MEDAN PERJUANGAN, KOTA MEDAN, SUMATERA UTARA",25,59,175,234
26592,https://kawalpemilu.org#11420,"MATA PAO, TELUK MENGKUDU, SERDANG BEDAGAI, SUMATERA UTARA",1,66,140,206
30457,https://kawalpemilu.org#11774,"TEGAL S MANDALA II, MEDAN DENAI, KOTA MEDAN, SUMATERA UTARA",25,184,0,184
26161,https://kawalpemilu.org#11385,"PEMATANG KASIH, PANTAI CERMIN, SERDANG BEDAGAI, SUMATERA UTARA",2,108,85,193
21733,https://kawalpemilu.org#9944,"SIGAMBIR-GAMBIR, SIEMPAT NEMPU HULU, DAIRI, SUMATERA UTARA",3,53,113,166
36403,https://kawalpemilu.org#12059,"LIMAU MUNGKUR, BINJAI BARAT, KOTA BINJAI, SUMATERA UTARA",14,58,100,158
16507,https://kawalpemilu.org#9342,"MOHO, JAWA MARAJA BAH JAMBI, SIMALUNGUN, SUMATERA UTARA",7,43,158,201
23533,https://kawalpemilu.org#10486,"SIMPANG GAMBIR, LINGGA BAYU, MANDAILING NATAL, SUMATERA UTARA",2,16,186,202
35916,https://kawalpemilu.org#12029,"SIJAMBI, DATUK BANDAR, KOTA TANJUNG BALAI, SUMATERA UTARA",4,59,77,136
151,https://kawalpemilu.org#6736,"HADUNDUNG, KOTAPINANG, LABUHANBATU SELATAN, SUMATERA UTARA",5,51,118,169
24687,https://kawalpemilu.org#10747,"SAERU MELAYU, TANAH MASA, NIAS SELATAN, SUMATERA UTARA",1,62,4,66
1692,https://kawalpemilu.org#6859,"PASANG LELA, NA IX - X, LABUHANBATU UTARA, SUMATERA UTARA",5,23,192,215
5718,https://kawalpemilu.org#7950,"SANGKUNUR, ANGKOLA SANGKUNUR, TAPANULI SELATAN, SUMATERA UTARA",16,163,2,165
31152,https://kawalpemilu.org#11789,"TANJUNG MULIA, MEDAN DELI, KOTA MEDAN, SUMATERA UTARA",73,36,132,168
31983,https://kawalpemilu.org#11815,"HARJOSARI II, MEDAN AMPLAS, KOTA MEDAN, SUMATERA UTARA",52,46,129,175
26740,https://kawalpemilu.org#11432,"FIRDAUS, SEI. RAMPAH, SERDANG BEDAGAI, SUMATERA UTARA",13,66,95,161
34752,https://kawalpemilu.org#11932,"BANJAR, SIANTAR BARAT, KOTA PEMATANGSIANTAR, SUMATERA UTARA",12,65,51,116
24643,https://kawalpemilu.org#11002,"SIHOLI, BORONADU, NIAS SELATAN, SUMATERA UTARA",1,126,35,161
20117,https://kawalpemilu.org#9737,"PADANG BULAN, RANTAU UTARA, LABUHANBATU, SUMATERA UTARA",29,32,108,140
30876,https://kawalpemilu.org#11784,"SEI AGUL, MEDAN BARAT, KOTA MEDAN, SUMATERA UTARA",39,22,217,239
18622,https://kawalpemilu.org#9592,"SEI KOPAS, BANDAR PASIR MANDOGE, ASAHAN, SUMATERA UTARA",7,135,13,148
